contig	position	variantID	refAllele	altAllele	refCount	altCount	totalCount	lowMAPQDepth	lowBaseQDepth	rawDepth	otherBases	improperPairs
1	14464	rs546169444	A	T	5	14	19	0	0	19	0	0
1	14907	.	A	G	34	98	132	0	3	135	0	0
1	14930	rs6682385	A	G	35	121	156	0	1	157	0	0
1	14933	rs199856693	G	A	31	122	153	0	2	155	0	0
1	14976	.	G	A	117	87	204	0	1	205	0	0
1	15447	.	A	G	8	16	24	0	0	24	0	0
1	16288	.	C	G	54	20	74	0	1	75	0	0
1	16298	.	C	T	27	34	61	0	0	61	0	0
1	16378	.	T	C	38	53	91	0	0	91	0	0
1	16495	.	G	C	64	53	117	0	1	118	0	0
1	16534	.	C	T	39	20	59	0	0	59	0	0
1	16571	.	G	A	13	12	25	0	0	25	0	0
1	135465	.	C	T	20	0	20	0	0	20	0	0
1	136635	.	T	G	75	0	75	0	4	79	0	0
1	137563	.	T	C	44	3	47	0	4	51	0	0
1	138156	.	G	T	0	118	118	0	0	118	0	0
1	138593	rs375595668	G	T	0	155	155	0	0	155	0	0
1	139213	.	A	G	0	155	155	0	2	157	0	0
1	139233	.	C	A	0	151	151	0	1	152	0	0
1	237185	.	C	A	7	1	8	0	0	8	0	0
1	237272	.	T	A	7	0	7	0	0	7	0	0
1	237763	.	G	A	11	0	11	0	0	11	0	0
1	237881	.	G	T	7	0	7	0	0	7	0	0
1	662029	.	G	A	41	41	82	0	2	84	0	0
1	662201	.	G	A	5	4	9	0	2	11	0	0
1	662414	rs371628865	C	T	5	2	7	0	0	7	0	0
1	662622	rs61769339	G	A	16	7	23	0	0	23	0	0
1	731718	rs58276399	T	C	2	4	6	0	0	6	0	0
1	736289	rs79010578	T	A	1	6	7	0	0	7	0	0
1	762273	rs3115849	G	A	6	5	11	0	2	13	0	0
1	762472	.	C	T	15	1	16	0	0	16	0	0
1	762485	rs12095200	C	A	14	4	18	0	0	18	0	0
1	762589	rs3115848	G	C	7	8	15	0	0	15	0	0
1	762592	rs3131950	C	G	8	8	16	0	0	16	0	0
1	762601	rs3131949	T	C	10	7	17	0	0	17	0	0
1	762632	rs3131948	T	A	8	7	15	0	0	15	0	0
1	777122	rs2980319	A	T	7	5	12	0	0	12	0	0
1	777232	rs112618790	C	T	10	13	23	0	0	23	0	0
1	778745	rs1055606	A	G	12	8	20	0	1	21	0	0
1	779322	rs4040617	A	G	9	4	13	0	0	13	0	0
1	787399	rs2905055	G	T	5	2	7	0	0	7	0	0
1	790465	rs61768207	G	A	9	5	14	0	1	15	0	0
1	791191	rs111818025	G	A	7	4	11	0	1	12	0	0
1	791853	rs6684487	G	A	16	22	38	0	0	38	0	0
1	848738	rs3829741	C	T	5	1	6	0	0	6	0	0
1	851190	rs28609852	G	A	7	2	9	0	0	9	0	0
1	851204	rs28552953	G	C	4	2	6	0	0	6	0	0
1	852664	rs28605311	C	T	9	7	16	0	0	16	0	0
1	852758	rs4970462	G	C	10	11	21	0	1	23	1	0
1	852964	rs4970461	T	G	10	14	24	0	0	24	0	0
1	853239	rs4970380	A	G	7	9	16	0	0	16	0	0
1	854250	rs7537756	A	G	2	4	6	0	0	6	0	0
1	856041	rs61769717	G	A	10	7	17	0	0	17	0	0
1	856329	rs7414599	C	G	6	2	8	0	0	8	0	0
1	909309	rs3829738	T	C	3	5	8	0	0	8	0	0
1	910868	.	C	T	5	3	8	0	0	8	0	0
1	910903	rs4970429	T	C	4	2	6	0	1	7	0	0
1	932618	rs3128112	C	G	3	4	7	0	0	7	0	0
1	948870	rs4615788	C	G	10	6	16	0	0	16	0	0
1	948921	rs15842	T	C	905	744	1649	0	13	1662	0	0
1	949235	rs2465124	G	A	253	292	545	0	0	545	0	0
1	949654	rs8997	A	G	1596	1312	2908	0	33	2942	1	0
1	984302	rs9442391	T	C	4	5	9	0	0	9	0	0
1	990280	rs4275402	C	T	8	4	12	0	0	12	0	0
1	990380	rs3121561	C	T	4	11	15	0	0	15	0	0
1	990417	rs2465136	T	C	6	14	20	0	0	20	0	0
1	996248	rs28479311	C	T	5	7	12	0	0	12	0	0
1	997265	.	G	T	7	10	17	0	0	17	0	0
1	998501	rs3813193	G	C	5	11	16	0	2	18	0	0
1	998582	rs3813194	G	C	19	7	26	0	0	26	0	0
1	1000910	rs79750022	C	T	16	15	31	0	0	31	0	0
1	1002387	rs74048003	A	G	7	2	9	0	0	9	0	0
1	1002434	rs11260596	C	T	2	7	9	0	0	9	0	0
1	1003053	rs4074992	C	T	5	6	11	0	0	11	0	0
1	1017587	rs3766191	C	T	40	23	63	0	0	63	0	0
1	1018144	rs9442395	T	C	21	15	36	0	0	36	0	0
1	1019180	rs9442396	T	C	1	8	9	0	0	9	0	0
1	1021346	rs10907177	A	G	9	18	27	0	1	28	0	0
1	1158631	rs6603781	A	G	124	124	248	0	0	248	0	0
1	1322868	.	C	T	502	499	1001	0	7	1008	0	0
1	1325157	rs113617566	G	A	13	7	20	0	0	20	0	0
1	1336006	rs111876693	C	T	20	7	27	0	0	27	0	0
1	1372617	.	A	G	5	11	16	0	0	16	0	0
1	1412049	rs189214814	C	T	16	11	27	0	0	27	0	0
1	1430516	rs113215852	G	A	11	6	17	0	1	18	0	0
1	1480492	.	C	T	6	6	12	0	0	12	0	0
1	1571640	rs61774909	G	T	18	11	29	0	0	29	0	0
1	1575836	.	C	G	6	2	8	0	0	8	0	0
1	1575929	rs542435001	T	G	4	5	9	0	0	9	0	0
1	1576636	rs3765908	G	A	9	5	14	0	0	14	0	0
1	1581096	.	C	T	21	34	55	0	2	57	0	0
1	1581713	rs76922129	A	C	18	7	25	0	1	28	2	0
1	1584102	rs28525262	G	A	14	12	26	0	0	26	0	0
1	1584504	.	C	T	10	0	10	0	0	10	0	0
1	1584517	.	G	A	11	0	11	0	0	11	0	0
1	1584535	.	A	G	6	0	6	0	0	6	0	0
1	1584541	.	A	T	6	0	6	0	0	6	0	0
1	1608229	rs61776790	C	T	3	5	8	0	1	9	0	0
1	1635108	rs11488590	G	A	40	14	54	0	0	54	0	0
1	1635193	rs11486026	T	C	50	29	79	0	1	80	0	0
1	1635565	rs11488591	C	T	28	15	43	0	1	44	0	0
1	1635749	rs1136997	C	A	208	65	273	0	3	276	0	0
1	1635928	rs2072922	G	A	165	53	218	0	3	221	0	0
1	1635943	rs1534950	A	C	181	38	219	0	0	219	0	0
1	1635979	rs1534951	G	C	178	82	260	0	2	262	0	0
1	1636112	rs4288535	G	A	71	23	94	0	0	94	0	0
1	1636274	rs2179381	C	T	53	152	205	0	1	206	0	0
1	1636355	.	A	G	206	20	226	0	2	228	0	0
1	1636400	rs1059825	G	A	199	16	215	0	2	217	0	0
1	1637466	rs112328991	G	A	1	8	9	0	0	9	0	0
1	1637580	rs112830236	C	T	1	6	7	0	0	7	0	0
1	1637927	rs113642628	C	G	14	4	18	0	0	18	0	0
1	1638187	rs140227771	C	T	3	8	11	0	0	11	0	0
1	1638925	rs200982240	C	T	99	69	168	0	0	168	0	0
1	1638994	rs6658335	C	T	75	48	123	0	0	123	0	0
1	1642027	.	C	T	53	0	53	0	0	53	0	0
1	1644908	rs2179383	C	T	16	13	29	0	0	29	0	0
1	1646371	rs61776850	G	T	26	21	47	0	0	47	0	0
1	1646427	rs61776851	T	G	32	13	45	0	0	45	0	0
1	1646450	rs3820004	G	A	32	18	50	0	1	51	0	0
1	1646574	rs760925	T	C	28	14	42	0	0	42	0	0
1	1646789	rs760927	T	C	34	5	39	0	0	39	0	0
1	1646980	rs7534835	A	C	25	9	34	0	0	34	0	0
1	1646985	.	C	T	27	8	35	0	0	35	0	0
1	1646992	.	G	A	27	7	34	0	0	34	0	0
1	1647277	rs4437818	C	T	35	26	61	0	2	63	0	0
1	1647299	rs760928	C	T	28	29	57	0	0	57	0	0
1	1647301	rs760929	G	A	29	29	58	0	0	58	0	0
1	1647524	rs760930	C	T	27	14	41	0	0	41	0	0
1	1647528	rs760931	G	C	28	14	42	0	0	42	0	0
1	1647686	rs909823	A	C	36	14	50	0	0	50	0	0
1	1648027	rs61776857	T	C	11	14	25	0	0	25	0	0
1	1648405	rs28669101	A	G	8	11	19	0	0	19	0	0
1	1648946	rs909824	T	C	15	30	45	0	0	45	0	0
1	1649639	rs36141200	G	A	14	21	35	0	1	36	0	0
1	1649740	rs36135823	C	T	24	18	42	0	2	44	0	0
1	1649750	rs34963151	A	T	22	15	37	0	1	38	0	0
1	1649752	rs36137888	T	G	23	15	38	0	1	39	0	0
1	1650032	rs61777469	A	C	17	12	29	0	0	29	0	0
1	1650033	rs61777470	T	C	17	12	29	0	0	29	0	0
1	1650102	rs61777471	C	T	9	7	16	0	1	17	0	0
1	1650263	rs1967676	G	T	6	1	7	0	1	8	0	0
1	1650410	rs1967677	T	C	17	13	30	0	0	30	0	0
1	1650807	rs1137005	T	C	119	81	200	0	2	202	0	0
1	1650845	rs1059831	G	A	190	92	282	0	0	282	0	0
1	1654731	.	G	A	4	4	8	0	0	8	0	0
1	1655474	rs11486024	G	A	3	3	6	0	0	6	0	0
1	1658343	rs4648785	T	C	2	4	6	0	0	6	0	0
1	1658945	.	T	C	44	12	56	0	0	56	0	0
1	1660110	rs1801781	C	A	6	11	17	0	0	17	0	0
1	1660726	rs1061884	T	C	0	23	23	0	0	23	0	0
1	1660735	.	T	C	0	24	24	0	1	25	0	0
1	1660812	.	A	G	3	12	15	0	0	15	0	0
1	1661298	.	A	G	21	9	30	0	1	31	0	0
1	1661844	rs61777505	G	C	1	6	7	0	0	7	0	0
1	1663402	rs34298494	A	C	3	3	6	0	0	6	0	0
1	1666615	rs2076325	C	T	4	2	6	0	0	6	0	0
1	1667253	rs1474648	T	C	5	8	13	0	0	13	0	0
1	1667371	rs1474649	A	G	10	17	27	0	0	27	0	0
1	1667419	rs2377208	A	C	9	16	25	0	0	25	0	0
1	1668168	rs28718827	G	T	5	9	14	0	0	14	0	0
1	1668275	.	A	G	6	3	9	0	1	10	0	0
1	1668943	rs28537345	A	C	5	3	8	0	1	9	0	0
1	1669228	rs11485870	T	C	2	10	12	0	0	12	0	0
1	1683420	rs8841	A	T	53	19	72	0	1	73	0	0
1	1683900	rs1062090	G	A	122	125	247	0	0	247	0	0
1	1684169	rs7796	C	G	178	146	324	0	4	328	0	0
1	1684758	rs2072926	G	A	28	23	51	0	0	51	0	0
1	1684800	rs2072927	G	A	28	20	48	0	1	49	0	0
1	1685213	rs2072928	C	G	34	36	70	0	0	70	0	0
1	1686943	rs2072929	T	C	30	20	50	0	0	50	0	0
1	1687152	rs4648815	G	A	25	17	42	0	0	42	0	0
1	1687482	rs2076328	G	T	21	25	46	0	2	48	0	0
1	1688192	rs2281173	A	G	25	23	48	0	2	50	0	0
1	1688469	rs4648623	C	G	27	23	50	0	0	50	0	0
1	1690793	rs2235538	G	A	11	6	17	0	0	17	0	0
1	1691050	rs35672141	C	T	6	14	20	0	0	20	0	0
1	1692321	rs1107910	T	C	6	6	12	0	2	14	0	0
1	1693726	rs17162854	A	G	3	6	9	0	0	9	0	0
1	1694103	rs2011384	A	G	3	5	8	0	0	8	0	0
1	1752955	rs4648726	C	T	4	6	10	0	0	10	0	0
1	1792157	rs915292	A	C	0	6	6	0	0	6	0	0
1	1793111	rs10907192	A	G	4	3	7	0	0	7	0	0
1	1812521	rs6603802	C	T	4	2	6	0	0	6	0	0
1	1849529	rs28640257	A	G	4	4	8	0	0	8	0	0
1	1849530	rs4459050	T	C	4	4	8	0	0	8	0	0
1	2143491	rs143314458	G	A	5	3	8	0	1	9	0	0
1	2143503	.	A	G	7	2	9	0	0	9	0	0
1	2170060	rs12067359	G	A	4	2	6	0	0	6	0	0
1	2170472	rs56765029	T	C	5	1	6	0	0	6	0	0
1	2173504	rs263526	T	C	5	2	7	0	0	7	0	0
1	2208751	rs12725264	A	C	4	2	6	0	0	6	0	0
1	2324008	rs2840533	C	T	19	9	28	0	0	28	0	0
1	2324321	rs68103143	G	T	16	22	38	0	0	38	0	0
1	2324336	rs3820010	T	C	17	18	35	0	0	35	0	0
1	2325371	rs16825102	G	A	8	7	15	0	0	15	0	0
1	2326009	rs1123571	G	A	7	12	19	0	0	19	0	0
1	2326812	rs903911	A	G	5	13	18	0	0	18	0	0
1	2326918	rs10910063	G	A	8	8	16	0	0	16	0	0
1	2327075	rs3736330	C	T	11	14	25	0	0	25	0	0
1	2327815	rs2840532	C	T	4	8	12	0	0	12	0	0
1	2329661	rs6698680	A	G	6	5	11	0	1	12	0	0
1	2330016	rs6685829	C	T	7	5	12	0	0	12	0	0
1	2330190	rs6693447	T	G	6	7	13	0	0	13	0	0
1	2332391	rs12037485	C	T	16	11	27	0	0	27	0	0
1	2335969	rs12085089	C	G	9	13	22	0	0	22	0	0
1	2336210	rs1129332	C	T	17	17	34	0	0	34	0	0
1	2337032	rs1129171	C	T	14	19	33	0	0	33	0	0
1	2340212	rs1143016	G	A	5	3	8	0	0	8	0	0
1	2441358	rs2494620	T	C	16	17	33	0	0	33	0	0
1	2448764	rs2494596	A	G	6	2	8	0	0	8	0	0
1	2452569	rs2985862	T	C	10	9	19	0	0	19	0	0
1	2458010	rs143275045	G	C	8	4	12	0	0	12	0	0
1	2490898	rs2257763	C	A	28	6	34	0	12	46	0	0
1	2490942	rs2281852	C	A	59	38	97	0	0	97	0	0
1	2491205	rs2234161	C	T	68	75	143	0	0	143	0	0
1	2494785	rs8725	G	A	219	179	398	0	0	398	0	0
1	2496214	rs10910090	C	T	3	3	6	0	1	7	0	0
1	2513055	rs4486391	A	T	5	2	7	0	0	7	0	0
1	2520302	rs6667564	T	C	6	8	14	0	0	14	0	0
1	2520500	rs6701238	G	A	6	5	11	0	1	12	0	0
1	2520527	rs6670198	T	C	6	4	10	0	0	10	0	0
1	2522392	rs2296443	G	A	29	32	61	0	1	62	0	0
1	2523212	rs876938	G	C	3	6	9	0	0	9	0	0
1	2524205	rs745368	C	T	15	4	19	0	0	19	0	0
1	2981841	rs6665853	G	A	4	5	9	0	0	9	0	0
1	2983963	rs2297828	G	A	14	16	30	0	0	30	0	0
1	2991808	rs2993482	T	G	3	3	6	0	0	6	0	0
1	3004788	rs2981880	T	C	5	4	9	0	0	9	0	0
1	3413868	rs4648506	C	G	17	9	26	0	0	26	0	0
1	3414105	rs10909951	C	T	2	6	8	0	0	8	0	0
1	3418391	rs4648508	C	T	14	23	37	0	0	37	0	0
1	3440753	rs41307039	G	A	19	8	27	0	0	27	0	0
1	3519603	rs12025426	T	C	3	9	12	0	0	12	0	0
1	3524143	rs2821021	A	G	4	2	6	0	0	6	0	0
1	3548136	rs2760321	T	C	17	66	83	0	1	84	0	0
1	3659657	rs2298222	G	A	12	8	20	0	1	21	0	0
1	3659742	rs2298223	C	T	9	6	15	0	0	15	0	0
1	3662845	rs3737589	A	G	7	6	13	0	1	14	0	0
1	3663057	rs3737590	A	T	4	4	8	0	0	8	0	0
1	3663641	rs75438821	C	T	1	6	7	0	0	7	0	0
1	3696890	rs8379	A	C	100	106	206	0	0	206	0	0
1	3697291	rs2996428	C	T	81	78	159	0	1	160	0	0
1	3703337	rs2368537	G	C	11	7	18	0	0	18	0	0
1	3745924	rs2275831	G	A	3	6	9	0	0	9	0	0
1	3755675	rs1891941	T	C	5	2	7	0	0	7	0	0
1	3764216	rs10492942	C	T	3	6	9	0	0	9	0	0
1	3766587	rs61768933	G	A	8	6	14	0	0	14	0	0
1	3767598	rs3765779	A	G	5	4	9	0	1	10	0	0
1	3773718	rs4648428	A	G	3	5	8	0	0	8	0	0
1	3786189	rs1141070	G	A	4	9	13	0	0	13	0	0
1	3800242	rs3205087	A	G	13	3	16	0	1	17	0	0
1	3800480	rs7555538	G	T	7	1	8	0	0	8	0	0
1	3801320	rs45463695	A	T	7	7	14	0	0	14	0	0
1	3806074	rs4075974	G	A	103	88	191	0	2	193	0	0
1	3808171	rs6701422	T	C	9	16	25	0	0	25	0	0
1	3809110	.	C	A	3	4	7	0	0	7	0	0
1	6067640	rs806114	C	G	4	2	6	0	0	6	0	0
1	6077061	rs1295108	A	G	4	2	6	0	0	6	0	0
1	6136680	rs6577485	C	T	5	1	6	0	0	6	0	0
1	6136692	rs6577486	T	G	5	1	6	0	0	6	0	0
1	6141325	rs3789541	G	A	2	4	6	0	0	6	0	0
1	6145812	rs3747979	G	A	5	2	7	0	0	7	0	0
1	6154589	rs41279458	C	T	50	18	68	0	1	69	0	0
1	6155332	rs1555144	T	C	24	23	47	0	0	47	0	0
1	6156915	rs2235792	G	A	4	7	11	0	0	11	0	0
1	6158995	rs11542389	G	A	218	225	443	0	3	446	0	0
1	6159032	rs4908772	A	G	235	229	464	0	2	466	0	0
1	6160115	rs34324678	G	A	252	243	495	0	9	504	0	0
1	6160609	rs3789528	C	T	416	545	961	0	20	982	1	0
1	6165419	rs1883768	C	T	1	7	8	0	0	8	0	0
1	6259130	rs3827723	A	G	15	22	37	0	0	37	0	0
1	6284092	.	C	G	5	7	12	0	0	12	0	0
1	6523430	rs3138156	T	C	18	9	27	0	0	27	0	0
1	6523578	rs3138155	T	A	11	14	25	0	0	25	0	0
1	6523725	rs3138153	G	A	6	10	16	0	1	17	0	0
1	6524501	rs11800462	T	C	22	37	59	0	0	59	0	0
1	6527333	rs14708	A	G	5	1	6	0	0	6	0	0
1	6640116	rs17029626	A	G	3	14	17	0	0	17	0	0
1	6644723	rs731024	G	A	18	12	30	0	0	30	0	0
1	6645867	rs6682920	G	A	17	15	32	0	2	34	0	0
1	6651093	rs201171	G	A	100	93	193	0	0	193	0	0
1	6654589	rs140688679	C	T	9	11	20	0	1	21	0	0
1	6655053	rs2235566	G	A	8	5	13	0	0	13	0	0
1	6659505	rs2232460	G	A	28	26	54	0	0	54	0	0
1	6681744	rs3747994	C	T	34	32	66	0	1	67	0	0
1	6683240	rs14057	G	A	76	77	153	0	1	154	0	0
1	6690112	rs77810659	A	G	5	8	13	0	0	13	0	0
1	6690140	rs742394	A	G	8	3	11	0	1	12	0	0
1	6692837	rs76280583	C	T	15	5	20	0	0	20	0	0
1	6693097	rs3174820	A	G	77	49	126	0	1	127	0	0
1	6694574	rs6804	G	A	42	56	98	0	0	98	0	0
1	6694980	rs1043683	G	A	45	43	88	0	0	88	0	0
1	6695123	rs1043681	C	T	52	44	96	0	0	96	0	0
1	6695244	rs10523	A	G	54	36	90	0	1	91	0	0
1	6695331	rs11892	G	T	42	38	80	0	1	81	0	0
1	6704635	rs200458	A	G	30	27	57	0	1	58	0	0
1	6713282	rs200440	A	G	4	8	12	0	0	12	0	0
1	6726269	rs56150786	T	C	7	4	11	0	0	11	0	0
1	6726401	rs200449	G	A	4	3	7	0	0	7	0	0
1	8412935	rs8627	C	T	471	625	1096	0	10	1106	0	0
1	8419629	rs7525559	T	C	4	7	11	0	0	11	0	0
1	8420757	.	G	A	70	49	119	0	6	125	0	0
1	8421092	rs2784735	C	T	23	21	44	0	3	47	0	0
1	8421203	rs13596	T	C	40	51	91	0	2	93	0	0
1	8422676	rs2252865	T	C	6	10	16	0	0	16	0	0
1	8423510	rs10779702	A	G	10	8	18	0	0	18	0	0
1	8928125	rs2071412	G	T	53	63	116	0	1	117	0	0
1	8928811	rs7540170	C	T	9	17	26	0	0	26	0	0
1	8931149	rs2274971	C	T	32	24	56	0	2	58	0	0
1	8932413	rs4908519	C	T	3	5	8	0	0	8	0	0
1	9095229	rs12068539	G	A	3	5	8	0	0	8	0	0
1	9095444	rs11121304	C	T	3	4	7	0	0	7	0	0
1	9095494	rs10864381	G	A	1	6	7	0	1	8	0	0
1	9095847	rs11121305	C	T	5	3	8	0	0	8	0	0
1	9095962	rs12125486	G	C	8	4	12	0	0	12	0	0
1	9096050	rs10864383	C	A	5	3	8	0	1	9	0	0
1	9097241	rs5840	C	T	117	98	215	0	1	216	0	0
1	9097251	rs1063137	A	G	108	90	198	0	2	200	0	0
1	9098272	rs875995	C	T	5	2	7	0	0	7	0	0
1	9100479	rs1060998	G	A	8	4	12	0	0	12	0	0
1	9101155	rs34488100	T	G	11	6	17	0	0	17	0	0
1	9324213	rs17368528	C	T	2	4	6	0	0	6	0	0
1	9326179	rs72641816	A	T	3	4	7	0	0	7	0	0
1	9327177	rs72641817	C	T	2	5	7	0	0	7	0	0
1	9327344	rs45491397	G	T	4	9	13	0	0	13	0	0
1	9327387	rs1294015	T	G	3	10	13	0	0	13	0	0
1	9327949	rs12314	A	C	0	7	7	0	0	7	0	0
1	9331244	rs1138467	T	C	8	12	20	0	0	20	0	0
1	9331277	rs9435163	G	T	7	10	17	0	0	17	0	0
1	9741193	rs6660363	A	G	7	9	16	0	0	16	0	0
1	9781412	rs12735071	C	G	12	8	20	0	0	20	0	0
1	9787840	rs1135427	G	T	95	66	161	0	7	168	0	0
1	9790995	rs10779729	A	G	13	28	41	0	0	41	0	0
1	9830586	rs76606485	C	T	5	8	13	0	1	14	0	0
1	10318652	rs12402052	C	G	28	51	79	0	1	80	0	0
1	10366692	rs4623	C	G	3	5	8	0	0	8	0	0
1	10435324	rs11121552	C	A	8	6	14	0	1	15	0	0
1	10438687	rs1536262	C	T	4	3	7	0	0	7	0	0
1	10438892	rs1002076	G	A	4	7	11	0	0	11	0	0
1	10440556	rs1138791	A	G	6	1	7	0	0	7	0	0
1	10460485	rs1049887	T	C	262	299	561	0	3	564	0	0
1	10466040	rs35859381	G	A	1	5	6	0	0	6	0	0
1	10466046	rs34075302	A	G	1	5	6	0	0	6	0	0
1	10467074	rs6541094	G	A	2	5	7	0	0	7	0	0
1	10471789	rs2236678	A	T	12	13	25	0	0	25	0	0
1	10472026	rs4846221	C	A	21	22	43	0	0	43	0	0
1	10472848	rs11121566	C	G	43	28	71	0	0	71	0	0
1	10473196	rs2229687	C	T	544	447	991	0	6	997	0	0
1	10474430	rs35759975	A	T	6	3	9	0	1	10	0	0
1	10474457	rs58014725	T	A	5	2	7	0	0	9	2	0
1	10478586	rs3762287	C	T	45	53	98	0	0	98	0	0
1	10478727	rs3762286	G	A	77	44	121	0	1	122	0	0
1	10479635	rs2298570	C	G	9	2	11	0	0	11	0	0
1	10479678	rs1889309	G	A	10	5	15	0	0	15	0	0
1	10517273	rs11121572	T	C	4	7	11	0	0	11	0	0
1	10583169	rs35895150	T	C	3	4	7	0	0	7	0	0
1	10596341	rs12375	C	T	21	22	43	0	0	43	0	0
1	10597024	rs17035189	A	G	3	3	6	0	0	6	0	0
1	10598216	rs2506892	G	A	4	8	12	0	0	12	0	0
1	10605796	rs11580264	C	A	4	7	11	0	0	11	0	0
1	10606607	rs6674521	C	T	6	1	7	0	0	7	0	0
1	10606969	.	C	A	9	16	25	0	0	25	0	0
1	10607394	rs710130	C	T	23	9	32	0	0	32	0	0
1	10713765	rs284294	T	C	23	31	54	0	0	54	0	0
1	10724236	rs284324	G	A	5	4	9	0	0	9	0	0
1	11072885	rs4133584	C	T	6	0	6	0	1	7	0	0
1	11074250	rs3765895	A	G	6	2	8	0	0	8	0	0
1	11081210	rs1922991	T	A	7	4	11	0	1	12	0	0
1	11081880	rs1474891	G	T	7	14	21	0	1	22	0	0
1	11086717	rs1033638	A	G	18	11	29	0	0	29	0	0
1	11087524	rs1782455	G	A	12	17	29	0	2	31	0	0
1	11087835	rs1782454	T	C	16	18	34	0	0	34	0	0
1	11088769	rs56142504	T	G	7	7	14	0	1	15	0	0
1	11088773	rs12743634	T	G	7	7	14	0	1	15	0	0
1	11088777	rs28731187	T	G	9	5	14	0	1	15	0	0
1	11089463	rs1782457	T	A	24	23	47	0	0	47	0	0
1	11719435	rs145818193	C	T	8	0	8	0	0	8	0	0
1	11719438	rs3117063	C	A	7	1	8	0	0	8	0	0
1	11723019	.	T	C	9	2	11	0	0	11	0	0
1	11728952	rs7514198	C	T	19	23	42	0	0	42	0	0
1	11731823	rs75765219	A	C	1	7	8	0	0	8	0	0
1	11733075	rs747862	T	C	4	4	8	0	0	8	0	0
1	11737551	rs2233018	C	T	11	11	22	0	0	22	0	0
1	11860731	rs34846084	G	T	5	1	6	0	0	6	0	0
1	11969917	rs926271	A	G	8	5	13	0	0	13	0	0
1	11979909	rs3209284	T	C	11	7	18	0	0	18	0	0
1	11982373	rs1137777	A	G	2	8	10	0	0	10	0	0
1	11982544	rs2639453	T	C	7	6	13	0	1	14	0	0
1	11983206	rs3795408	A	G	16	18	34	0	0	34	0	0
1	12009955	rs7529452	C	T	6	4	10	0	0	10	0	0
1	12024235	rs1130529	C	T	5	7	12	0	0	12	0	0
1	12052405	rs6675934	G	A	6	5	11	0	1	12	0	0
1	12059412	rs2295281	C	T	35	19	54	0	0	54	0	0
1	12060336	rs12066842	A	G	11	6	17	0	0	17	0	0
1	12060565	rs6676963	T	C	21	14	35	0	1	36	0	0
1	12062361	rs2236058	C	G	5	1	6	0	0	6	0	0
1	12062507	rs11121847	T	G	2	4	6	0	0	6	0	0
1	12067044	rs7550536	T	G	12	6	18	0	1	19	0	0
1	12068941	rs6686734	T	C	6	2	8	0	0	8	0	0
1	12071680	rs1042842	A	G	198	144	342	0	4	346	0	0
1	12072518	rs3088064	G	C	269	272	541	0	3	544	0	0
1	12082334	rs11553925	A	T	48	40	88	0	2	90	0	0
1	12267265	rs1061624	A	G	17	12	29	0	0	29	0	0
1	12267999	rs1061628	C	T	37	25	62	0	0	62	0	0
1	12423276	.	A	T	12	9	21	0	0	21	0	0
1	12628770	rs4846119	C	T	8	0	8	0	0	8	0	0
1	12629178	rs4525052	A	G	6	2	8	0	0	8	0	0
1	12629265	.	T	A	6	3	9	0	0	9	0	0
1	12629769	rs6541040	A	T	9	3	12	0	1	13	0	0
1	12630634	rs4846120	T	G	4	5	9	0	0	9	0	0
1	12630700	rs4846121	C	T	3	3	6	0	0	6	0	0
1	12630786	rs4845905	T	C	3	4	7	0	1	8	0	0
1	12638964	rs2275875	T	C	144	107	251	0	3	254	0	0
1	12639168	rs3128461	A	G	3	3	6	0	0	6	0	0
1	12639596	rs2358737	C	T	35	16	51	0	1	52	0	0
1	12640127	rs3128458	G	A	22	17	39	0	0	39	0	0
1	12649614	rs75568038	C	T	4	3	7	0	0	7	0	0
1	15466130	.	A	C	10	0	10	0	5	15	0	0
1	15752716	rs3765369	C	T	5	1	6	0	0	6	0	0
1	15755676	rs6695499	G	A	397	447	844	0	11	855	0	0
1	15816562	rs1991031	T	C	6	13	19	0	0	19	0	0
1	15817090	rs12045879	C	T	12	6	18	0	0	18	0	0
1	15817318	rs4646110	A	T	16	13	29	0	1	30	0	0
1	15817319	rs4646109	T	C	16	13	29	0	1	30	0	0
1	15817334	rs1129347	G	A	14	17	31	0	1	32	0	0
1	15818149	rs4646106	T	A	8	11	19	0	0	19	0	0
1	15820758	rs4646096	A	G	15	12	27	0	0	27	0	0
1	15821051	rs10803387	C	A	6	2	8	0	1	9	0	0
1	15821164	rs9700738	G	C	9	5	14	0	0	14	0	0
1	15821400	rs4646093	C	A	8	9	17	0	0	17	0	0
1	15821673	rs4646092	C	T	7	9	16	0	0	16	0	0
1	15822043	rs4646091	T	C	3	3	6	0	0	6	0	0
1	15822073	rs4646090	A	G	6	4	10	0	0	10	0	0
1	15822404	rs4646087	A	G	5	2	7	0	0	7	0	0
1	15827136	rs4646077	C	T	4	2	6	0	0	6	0	0
1	15850603	rs4645983	G	A	38	39	77	0	0	77	0	0
1	15892415	rs2236215	A	C	10	6	16	0	2	18	0	0
1	15894959	rs1467513	T	C	5	14	19	0	0	19	0	0
1	15896199	rs2145397	G	A	7	5	12	0	0	12	0	0
1	15896984	rs6656907	A	G	8	6	14	0	0	14	0	0
1	15897020	rs9298	C	T	6	6	12	0	0	12	0	0
1	15986547	rs3766163	T	C	4	3	7	0	0	7	0	0
1	15988702	rs10492986	T	C	6	2	8	0	0	8	0	0
1	15988878	rs41270279	A	G	2	4	6	0	0	6	0	0
1	15989141	rs7536654	C	G	6	5	11	0	0	11	0	0
1	15990552	rs927207	A	G	4	5	9	0	0	9	0	0
1	15991645	rs55913949	T	C	8	2	10	0	0	10	0	0
1	15993208	rs34453754	G	C	9	10	19	0	0	19	0	0
1	15993514	rs35509554	C	T	6	7	13	0	0	13	0	0
1	15993603	rs10927823	G	A	5	6	11	0	0	11	0	0
1	16050335	.	C	A	3	6	9	0	0	9	0	0
1	16160773	rs4661342	C	G	11	9	20	0	0	20	0	0
1	16173814	rs6668183	G	C	4	3	7	0	0	7	0	0
1	16175317	rs10927866	C	T	43	33	76	0	0	76	0	0
1	16200163	rs904910	A	G	19	17	36	0	0	36	0	0
1	16256007	rs848209	T	C	29	35	64	0	0	64	0	0
1	16259813	rs848210	A	G	65	35	100	0	0	100	0	0
1	16265422	rs848214	A	G	8	10	18	0	0	18	0	0
1	16271260	rs9661939	G	A	61	73	134	0	0	134	0	0
1	16272250	rs848217	A	G	72	68	140	0	1	142	1	0
1	16360137	rs12746751	C	T	4	2	6	0	0	6	0	0
1	16383742	.	C	G	0	6	6	0	0	6	0	0
1	16524653	rs221030	A	G	3	6	9	0	0	9	0	0
1	16524869	rs221031	T	C	23	17	40	0	1	41	0	0
1	16525056	rs451260	G	T	32	9	41	0	0	41	0	0
1	16525966	rs221034	T	C	3	5	8	0	0	8	0	0
1	16526529	rs221035	G	A	5	5	10	0	0	10	0	0
1	16532803	rs221050	G	A	6	2	8	0	0	8	0	0
1	16542835	rs2273314	A	G	5	3	8	0	0	8	0	0
1	16542876	rs2273313	A	T	5	6	11	0	0	11	0	0
1	16542937	rs2273312	T	G	8	10	18	0	0	18	0	0
1	16551373	rs35649921	A	G	6	3	9	0	0	9	0	0
1	16555566	rs1985782	A	G	9	4	13	0	0	13	0	0
1	16555882	rs12748676	C	T	13	7	20	0	0	20	0	0
1	16574316	rs3738632	T	C	51	34	85	0	2	87	0	0
1	16574382	rs6693451	A	C	46	35	81	0	0	81	0	0
1	16575030	rs17369676	T	C	25	17	42	0	0	42	0	0
1	16576836	rs7536390	A	G	22	22	44	0	0	44	0	0
1	16577794	rs35196193	C	T	47	40	87	0	1	88	0	0
1	16577908	rs12069239	G	C	62	45	107	0	1	108	0	0
1	16607969	.	T	G	10	1	11	0	0	11	0	0
1	16643056	rs11583267	T	C	8	7	15	0	0	15	0	0
1	16676050	rs34899543	T	C	2	4	6	0	0	6	0	0
1	16720399	rs12567262	T	G	5	2	7	0	0	7	0	0
1	16723084	rs3738605	G	A	241	238	479	0	5	484	0	0
1	16781447	rs279786	A	G	4	2	6	0	0	6	0	0
1	16785564	rs11543230	C	T	36	51	87	0	0	87	0	0
1	16788184	rs698866	A	G	3	3	6	0	0	6	0	0
1	16788515	rs279025	T	C	5	5	10	0	0	10	0	0
1	16797756	rs157134	T	C	5	4	9	0	0	9	0	0
1	16840730	.	C	T	14	1	15	0	0	15	0	0
1	16841357	.	G	A	7	0	7	0	0	7	0	0
1	16842114	.	G	A	15	8	23	0	0	23	0	0
1	16889044	.	T	A	17	4	21	0	0	21	0	0
1	16889158	.	A	C	14	8	22	0	0	22	0	0
1	16889663	.	A	G	2	6	8	0	0	8	0	0
1	16890130	.	A	C	9	6	15	0	0	15	0	0
1	16890176	rs3868814	A	C	10	5	15	0	1	16	0	0
1	16890598	.	T	A	12	11	23	0	0	23	0	0
1	16890639	.	C	T	23	2	25	0	0	25	0	0
1	16890644	.	C	T	14	9	23	0	0	23	0	0
1	16890671	rs2419526	T	C	11	10	21	0	0	21	0	0
1	16890672	rs2419525	G	A	11	10	21	0	0	21	0	0
1	16926980	.	T	C	2	4	6	0	0	6	0	0
1	16932809	.	C	T	5	5	10	0	0	10	0	0
1	16944809	.	G	C	56	52	108	0	1	109	0	0
1	16945673	.	A	G	9	5	14	0	0	14	0	0
1	16945738	.	A	G	9	1	10	0	1	11	0	0
1	16945780	.	C	T	4	3	7	0	1	8	0	0
1	16946535	.	T	C	34	5	39	0	1	40	0	0
1	16946630	.	G	A	32	2	34	0	0	34	0	0
1	16946723	rs375097	G	A	38	3	41	0	0	41	0	0
1	16946740	rs399721	C	T	36	1	37	0	0	37	0	0
1	16948000	.	C	T	11	7	18	0	0	18	0	0
1	16948178	.	G	A	7	5	12	0	0	12	0	0
1	16948189	.	A	G	9	4	13	0	0	13	0	0
1	16948473	rs446948	C	T	9	4	13	0	1	14	0	0
1	16948722	.	C	T	8	6	14	0	0	14	0	0
1	16949917	.	T	C	4	3	7	0	1	8	0	0
1	16950708	.	T	G	3	3	6	0	0	6	0	0
1	16950880	.	T	C	6	5	11	0	0	11	0	0
1	16952481	rs915311	A	G	22	27	49	0	0	49	0	0
1	16952993	rs942268	C	G	11	19	30	0	0	30	0	0
1	16958833	.	T	A	37	19	56	0	0	56	0	0
1	16959602	.	C	T	29	22	51	0	0	51	0	0
1	16961588	.	A	G	19	27	46	0	0	46	0	0
1	16972134	.	C	T	6	1	7	0	0	7	0	0
1	16976193	.	C	T	5	1	6	0	0	6	0	0
1	16976679	.	G	A	6	2	8	0	0	8	0	0
1	17216080	rs3738618	T	C	9	7	16	0	1	17	0	0
1	17222722	.	A	G	6	2	8	0	0	8	0	0
1	17222723	.	A	G	6	2	8	0	0	8	0	0
1	17222748	rs9325651	G	C	6	2	8	0	0	8	0	0
1	17222768	.	C	G	5	3	8	0	0	8	0	0
1	17301448	rs2235933	C	T	20	14	34	0	0	34	0	0
1	17301780	rs761422	A	G	28	27	55	0	0	55	0	0
1	17312743	rs3170740	C	T	67	84	151	0	1	152	0	0
1	17313157	rs2076605	G	A	20	11	31	0	0	31	0	0
1	17313343	rs9435659	G	A	60	62	122	0	0	122	0	0
1	17313654	rs761421	C	T	45	52	97	0	0	97	0	0
1	17314942	rs9435662	G	A	63	64	127	0	0	127	0	0
1	17325955	rs6684770	G	A	4	5	9	0	0	9	0	0
1	17345905	rs2871775	A	G	6	6	12	0	1	13	0	0
1	17348544	rs2746474	T	G	7	6	13	0	0	13	0	0
1	17348687	rs61769185	C	T	7	5	12	0	0	12	0	0
1	17349830	rs2746472	C	T	6	8	14	0	0	14	0	0
1	17350143	rs2235930	G	A	5	3	8	0	1	9	0	0
1	17350243	rs2647162	T	C	5	1	6	0	0	6	0	0
1	17350931	rs12142244	G	A	10	10	20	0	0	20	0	0
1	17352055	rs58499652	C	G	2	8	10	0	0	10	0	0
1	17353988	rs11203282	T	G	4	6	10	0	0	10	0	0
1	17394046	rs2746533	A	G	14	16	30	0	0	30	0	0
1	17394048	rs35058101	T	A	17	14	31	0	0	31	0	0
1	17394374	rs12133334	C	A	6	9	15	0	0	15	0	0
1	17394613	rs10157828	T	C	12	20	32	0	0	32	0	0
1	17394623	rs10157387	C	T	12	18	30	0	0	30	0	0
1	17394834	.	G	A	13	14	27	0	0	27	0	0
1	17395480	rs2076599	G	A	7	10	17	0	0	17	0	0
1	17395521	rs2076598	G	A	9	13	22	0	0	22	0	0
1	17396592	rs11581590	G	A	10	7	17	0	0	17	0	0
1	17396703	rs2076595	T	C	14	6	20	0	1	21	0	0
1	17635396	rs1886302	A	G	4	4	8	0	0	8	0	0
1	17668509	rs41265995	G	A	9	8	17	0	0	17	0	0
1	17733564	rs7191	T	G	647	692	1339	0	7	1346	0	0
1	17735266	rs750636	G	A	143	115	258	0	15	273	0	0
1	17736578	rs2762890	A	G	62	47	109	0	0	109	0	0
1	17739313	rs942458	T	G	19	18	37	0	0	37	0	0
1	17739586	rs942457	G	A	190	191	381	0	0	381	0	0
1	17739820	rs1075535	T	C	35	42	77	0	0	77	0	0
1	17741044	rs2019622	G	A	10	13	23	0	5	28	0	0
1	17743613	rs6586538	T	C	3	6	9	0	0	9	0	0
1	17743669	rs6586539	C	T	5	3	8	0	0	8	0	0
1	17744536	rs57142672	A	G	1	5	6	0	0	6	0	0
1	17748027	rs1535874	A	G	9	3	12	0	0	12	0	0
1	17749504	rs730153	G	A	1	6	7	0	0	7	0	0
1	17750685	rs6681150	G	A	3	4	7	0	0	7	0	0
1	17752873	rs6702471	A	C	5	2	7	0	0	7	0	0
1	17753191	rs11203383	T	C	5	4	9	0	0	9	0	0
1	17753340	rs60387933	C	A	4	2	6	0	0	6	0	0
1	17753639	rs6688886	G	A	5	2	7	0	0	7	0	0
1	17754815	rs1408420	G	A	3	3	6	0	0	6	0	0
1	17765469	.	C	A	3	8	11	0	1	12	0	0
1	17765484	rs3121622	T	C	7	2	9	0	0	9	0	0
1	17765505	rs3094883	G	C	6	3	9	0	0	9	0	0
1	19199448	rs61757683	G	T	38	29	67	0	0	67	0	0
1	19201283	rs74056665	G	A	9	3	12	0	0	12	0	0
1	19202896	rs2230707	G	A	17	9	26	0	0	26	0	0
1	19205494	rs76815595	G	A	3	5	8	0	0	8	0	0
1	19220442	rs28709274	T	A	4	2	6	0	0	6	0	0
1	19401968	rs1886024	G	A	6	7	13	0	0	13	0	0
1	19402242	rs78695089	C	A	3	8	11	0	0	11	0	0
1	19581467	rs1774081	C	T	4	3	7	0	0	7	0	0
1	19581715	rs761306	T	C	4	3	7	0	0	7	0	0
1	19581934	rs947532	G	T	4	8	12	0	0	12	0	0
1	19582338	rs6694099	C	A	3	5	8	0	0	8	0	0
1	19582563	rs1557133	G	A	3	3	6	0	0	6	0	0
1	19584004	rs1042380	G	A	26	23	49	0	0	49	0	0
1	19585545	rs761305	G	A	26	34	60	0	0	60	0	0
1	19585903	rs9426684	G	A	21	20	41	0	0	41	0	0
1	19585933	rs9426685	G	A	23	22	45	0	0	45	0	0
1	19586015	rs9426686	G	T	27	21	48	0	1	49	0	0
1	19586294	rs1063984	A	G	38	27	65	0	0	65	0	0
1	19586360	rs1063985	T	C	30	17	47	0	0	47	0	0
1	19586571	rs1063986	T	C	8	5	13	0	0	13	0	0
1	19593748	rs116049134	A	C	7	8	15	0	0	15	0	0
1	19595194	rs75616155	A	G	5	6	11	0	0	11	0	0
1	19609254	rs1738025	T	C	6	7	13	0	0	13	0	0
1	19611241	rs1738023	T	C	11	6	17	0	0	17	0	0
1	19635011	rs1043657	C	T	20	17	37	0	0	37	0	0
1	19647578	rs12410435	T	G	0	6	6	0	1	7	0	0
1	19647884	rs72651455	G	A	5	6	11	0	0	11	0	0
1	19648287	rs6669824	G	C	4	3	7	0	0	7	0	0
1	19649129	rs9661390	G	A	5	3	8	0	0	8	0	0
1	19649166	rs9661396	G	T	5	1	6	0	0	6	0	0
1	19649243	rs9661399	G	A	2	4	6	0	0	6	0	0
1	19650545	rs7544368	A	G	3	3	6	0	0	6	0	0
1	19652063	rs11558390	G	A	17	27	44	0	0	44	0	0
1	19652874	rs41264079	G	A	24	24	48	0	0	48	0	0
1	19653256	rs7553611	A	G	5	4	9	0	0	9	0	0
1	19655734	rs41302028	G	A	22	30	52	0	0	52	0	0
1	19669117	rs214326	A	G	12	5	17	0	0	17	0	0
1	19669618	rs72651461	A	G	7	13	20	0	0	20	0	0
1	19669956	rs17477411	G	A	7	7	14	0	0	14	0	0
1	19671361	rs742686	T	C	13	8	21	0	0	21	0	0
1	19672539	rs67559618	C	A	5	2	7	0	0	7	0	0
1	19677088	rs214331	T	C	3	3	6	0	0	6	0	0
1	19701015	rs3748753	G	A	4	4	8	0	1	9	0	0
1	19934724	rs61740467	C	T	9	4	13	0	0	13	0	0
1	19934900	rs61740466	G	A	13	8	21	0	0	21	0	0
1	19943823	rs2294629	C	A	17	6	23	0	0	23	0	0
1	19950062	rs1737428	T	C	101	123	224	0	0	224	0	0
1	19951535	rs1770481	A	G	15	25	40	0	0	40	0	0
1	19972586	rs11810271	A	G	3	3	6	0	0	6	0	0
1	19973358	rs7522389	G	T	4	5	9	0	0	9	0	0
1	19974794	rs3790741	T	C	5	2	7	0	0	7	0	0
1	19974981	rs2745241	G	T	5	4	9	0	0	9	0	0
1	19975045	rs3790742	G	C	4	5	9	0	0	9	0	0
1	19975445	rs71645456	T	G	3	5	8	0	0	8	0	0
1	19976782	rs1115163	A	G	12	4	16	0	0	16	0	0
1	19978299	rs71645457	C	T	6	6	12	0	1	13	0	0
1	19978504	rs12046364	A	G	3	9	12	0	0	12	0	0
1	19978665	rs753613	G	A	1	6	7	0	0	7	0	0
1	19979608	rs11587840	G	A	5	5	10	0	0	10	0	0
1	19981023	rs7546665	T	C	16	6	22	0	0	22	0	0
1	19981451	rs3828101	A	G	11	7	18	0	0	18	0	0
1	19981791	rs2294630	A	G	7	5	12	0	0	12	0	0
1	19984346	rs1049959	A	G	392	390	782	0	8	790	0	0
1	20008880	rs9064	G	T	7	7	14	0	1	15	0	0
1	20020993	rs4370779	A	G	3	3	6	0	0	6	0	0
1	20020994	rs4515815	C	T	3	3	6	0	0	6	0	0
1	20233405	rs41264117	A	G	5	5	10	0	1	11	0	0
1	20486451	rs10799610	C	T	4	5	9	0	0	9	0	0
1	20945055	rs1048977	C	T	132	113	245	0	0	245	0	0
1	20965013	rs10916842	A	G	5	1	6	0	0	6	0	0
1	20965942	rs3121680	G	A	4	4	8	0	0	8	0	0
1	20969551	rs7550319	C	T	2	5	7	0	0	7	0	0
1	20969829	rs7521885	T	G	4	4	8	0	0	8	0	0
1	20970160	rs7530085	G	A	3	6	9	0	0	9	0	0
1	20970595	rs7522679	T	C	9	6	15	0	0	15	0	0
1	20972340	rs3131714	G	A	10	15	25	0	0	25	0	0
1	20973752	rs7532202	A	G	20	6	26	0	0	26	0	0
1	20973786	rs111354972	G	A	9	15	24	0	0	24	0	0
1	20973872	rs7532296	A	G	14	7	21	0	0	21	0	0
1	20974802	rs2298299	A	G	14	26	40	0	0	40	0	0
1	20975278	rs144719866	C	T	26	19	45	0	0	46	1	0
1	20976020	rs11576911	G	A	9	4	13	0	0	13	0	0
1	20977000	rs1043424	A	C	22	37	59	0	1	60	0	0
1	20977380	rs1043443	T	C	24	33	57	0	1	58	0	0
1	20977449	rs512550	G	T	27	30	57	0	1	58	0	0
1	20977599	rs8064	C	G	27	37	64	0	0	64	0	0
1	20977748	rs1043502	T	G	16	11	27	0	0	27	0	0
1	20977856	rs2078073	T	C	12	6	18	0	0	18	0	0
1	20978024	rs1573132	C	A	8	2	10	0	0	10	0	0
1	20978058	rs650616	G	A	2	8	10	0	0	10	0	0
1	20978115	rs17406145	G	A	1	7	8	0	0	8	0	0
1	20978137	rs10916843	C	T	10	1	11	0	0	11	0	0
1	20979573	rs36110575	C	T	15	4	19	0	0	19	0	0
1	20979580	rs12410193	T	G	15	4	19	0	0	19	0	0
1	20980450	rs2070660	G	T	4	5	9	0	1	10	0	0
1	20982405	rs3738141	G	A	3	6	9	0	0	9	0	0
1	20982631	rs4704	G	A	369	308	677	0	9	686	0	0
1	20983460	rs10916844	T	C	8	5	13	0	1	14	0	0
1	20983625	rs9662033	C	T	3	4	7	0	0	7	0	0
1	20983863	rs10799657	C	A	5	4	9	0	0	9	0	0
1	20984254	rs10799658	C	T	2	7	9	0	0	9	0	0
1	21082074	rs10916856	A	C	26	6	32	0	1	33	0	0
1	21083435	rs113919494	G	A	12	5	17	0	0	17	0	0
1	21087956	rs10916859	A	G	4	4	8	0	0	8	0	0
1	21091861	rs1985278	G	T	6	2	8	0	0	8	0	0
1	21194510	rs2167811	A	G	3	3	6	0	0	6	0	0
1	21234252	rs61781099	T	C	5	5	10	0	0	10	0	0
1	21477940	rs9729251	C	T	13	7	20	0	0	20	0	0
1	21544247	rs74343247	T	A	55	42	97	0	1	98	0	0
1	21544791	rs6701077	T	C	30	23	53	0	0	53	0	0
1	21671943	rs2072654	T	G	4	2	6	0	0	6	0	0
1	21795288	rs61740199	C	T	1	5	6	0	0	6	0	0
1	21795388	rs1827293	A	G	5	1	6	0	0	6	0	0
1	21798249	rs72872297	C	G	1	8	9	0	0	9	0	0
1	21808159	rs71512991	G	A	8	0	8	0	0	8	0	0
1	21904374	rs1772719	A	C	4	2	6	0	0	6	0	0
1	22006579	rs61496627	C	T	12	16	28	0	0	28	0	0
1	22020152	rs3767133	G	T	22	15	37	0	0	37	0	0
1	22048982	rs535911	C	T	2	4	6	0	0	6	0	0
1	22049667	rs6426724	A	G	4	2	6	0	0	6	0	0
1	22050264	rs900488	C	G	6	0	6	0	0	6	0	0
1	22050649	rs2275668	C	A	17	13	30	0	0	30	0	0
1	22051873	rs4654981	G	A	8	11	19	0	0	19	0	0
1	22052070	rs12130039	C	A	7	9	16	0	0	16	0	0
1	22052387	rs7554400	T	C	10	12	22	0	0	22	0	0
1	22052814	rs6702312	A	G	8	11	19	0	0	19	0	0
1	22054427	rs16825896	C	A	40	24	64	0	0	64	0	0
1	22076638	rs7538354	C	T	4	4	8	0	0	8	0	0
1	22077672	rs333195	C	A	4	4	8	0	0	8	0	0
1	22082566	rs146016524	G	C	10	5	15	0	0	15	0	0
1	22082664	rs10917040	T	A	5	6	11	0	0	11	0	0
1	22082794	rs10458383	T	C	5	4	9	0	0	9	0	0
1	22150118	rs1138469	C	T	50	61	111	0	0	111	0	0
1	22150120	rs3736360	C	T	64	49	113	0	1	114	0	0
1	22150160	.	G	T	65	50	115	0	1	116	0	0
1	22158120	rs2270701	G	T	3	3	6	0	0	6	0	0
1	22159008	rs2229487	C	A	27	31	58	0	0	58	0	0
1	22161275	rs2229492	G	A	31	23	54	0	0	54	0	0
1	22163402	rs41310390	G	A	13	12	25	0	4	29	0	0
1	22165901	rs2291826	A	G	16	8	24	0	1	25	0	0
1	22165987	rs2291827	G	A	16	12	28	0	0	28	0	0
1	22191454	rs897471	G	A	3	3	6	0	0	6	0	0
1	22214127	rs2229478	A	G	11	6	17	0	0	17	0	0
1	22216574	rs2254358	C	A	4	4	8	0	1	9	0	0
1	22216604	rs2254357	C	G	6	5	11	0	0	11	0	0
1	22350834	rs2473307	T	C	4	5	9	0	0	9	0	0
1	22352040	rs2255282	G	T	5	5	10	0	0	10	0	0
1	22352108	rs11801382	C	T	20	21	41	0	0	41	0	0
1	22353327	rs2473304	C	A	6	2	8	0	0	8	0	0
1	22353986	rs2501290	C	G	17	6	23	0	0	23	0	0
1	22353989	rs2501289	C	G	18	6	24	0	0	24	0	0
1	22354246	rs2473300	A	T	19	7	26	0	0	26	0	0
1	22354277	rs2473298	C	T	15	6	21	0	0	21	0	0
1	22354327	rs3768571	T	C	6	11	17	0	0	17	0	0
1	22354537	rs2473297	A	G	10	3	13	0	1	14	0	0
1	22354587	rs2473296	C	T	9	2	11	0	0	11	0	0
1	22354797	rs2501288	C	T	11	3	14	0	0	14	0	0
1	22354866	rs2473295	T	C	15	2	17	0	0	17	0	0
1	22356809	rs1063116	A	T	42	24	66	0	0	66	0	0
1	22356888	rs1063117	G	A	43	28	71	0	0	71	0	0
1	22356905	rs1063118	G	A	43	33	76	0	0	76	0	0
1	22357217	rs760923	G	T	47	54	101	0	0	101	0	0
1	22357549	rs2473291	G	T	41	16	57	0	1	58	0	0
1	22389388	rs16826309	A	G	10	4	14	0	0	14	0	0
1	22401538	rs10917139	G	A	1	5	6	0	0	6	0	0
1	22414070	rs11800014	C	T	11	5	16	0	0	16	0	0
1	22817114	rs6659222	G	A	5	4	9	0	0	9	0	0
1	22852880	rs45502998	G	C	7	12	19	0	0	19	0	0
1	22853896	.	T	C	15	12	27	0	0	27	0	0
1	23419283	rs35917050	G	A	87	82	169	0	0	169	0	0
1	23640314	.	G	C	5	2	7	0	0	7	0	0
1	23653041	rs114241021	G	A	1	8	9	0	0	9	0	0
1	23654085	rs143938231	A	T	4	3	7	0	0	7	0	0
1	23659568	rs619375	A	G	3	6	9	0	0	9	0	0
1	23686246	rs13523	C	T	34	28	62	0	0	62	0	0
1	23688178	rs646193	A	G	6	12	18	0	0	18	0	0
1	23688933	rs2849028	A	G	16	11	27	0	0	27	0	0
1	23696152	rs665977	G	A	3	6	9	0	0	9	0	0
1	23833611	rs12026768	G	T	162	99	261	0	3	264	0	0
1	23833993	rs12027599	G	A	55	62	117	0	8	125	0	0
1	23834486	rs3820028	G	A	63	76	139	0	3	142	0	0
1	23835794	rs3218211	A	G	44	46	90	0	0	90	0	0
1	23836364	rs2075993	A	G	45	34	79	0	2	81	0	0
1	23847464	rs2075995	C	A	38	41	79	0	0	79	0	0
1	23884661	rs1050096	G	A	21	19	40	0	1	41	0	0
1	23885498	rs11574	T	C	32	24	56	0	0	56	0	0
1	24022437	rs2280437	A	G	19	30	49	0	0	49	0	0
1	24785393	rs2272935	C	T	5	5	10	0	0	10	0	0
1	24798383	rs195729	C	T	6	1	7	0	0	7	0	0
1	24859617	rs196429	G	A	5	3	8	0	0	8	0	0
1	24978406	rs11249151	G	A	6	6	12	0	0	12	0	0
1	24993101	rs111281328	A	T	4	6	10	0	0	10	0	0
1	25093473	rs1981195	C	T	3	5	8	0	0	8	0	0
1	25226208	rs111628829	G	A	322	335	657	0	3	660	0	0
1	25231562	rs9438875	G	T	4	2	6	0	0	6	0	0
1	25233232	.	C	T	2	4	6	0	0	6	0	0
1	25234062	rs34878696	T	G	4	3	7	0	0	7	0	0
1	25234489	rs113470029	T	C	4	3	7	0	1	8	0	0
1	25234515	rs72874394	G	A	4	2	6	0	1	7	0	0
1	25234781	rs12082398	T	C	4	3	7	0	0	7	0	0
1	25554129	rs41310393	G	A	6	1	7	0	0	7	0	0
1	25554139	rs41302026	G	A	6	1	7	0	0	7	0	0
1	25717365	rs609320	C	G	7	1	8	0	0	8	0	0
1	25780961	.	G	A	6	2	8	0	1	9	0	0
1	25889632	rs6687605	T	C	8	6	14	0	0	14	0	0
1	25890189	rs28969504	A	G	7	9	16	0	0	16	0	0
1	25894853	rs11563	G	T	21	11	32	0	0	32	0	0
1	25895238	rs7491	C	T	11	14	25	0	0	25	0	0
1	26287563	rs2012311	T	C	33	13	46	0	1	47	0	0
1	26313708	rs11247838	G	A	3	4	7	0	0	7	0	0
1	26314411	rs6598937	C	T	2	5	7	0	0	7	0	0
1	26314564	rs2245979	T	C	9	7	16	0	0	16	0	0
1	26314625	rs2257255	G	A	5	8	13	0	0	13	0	0
1	26324520	rs11247841	T	C	5	2	7	0	1	8	0	0
1	26869994	rs138127199	C	T	3	5	8	0	0	8	0	0
1	26872346	rs71640330	C	T	10	1	11	0	1	12	0	0
1	26879376	rs7543005	T	C	5	4	9	0	1	10	0	0
1	26883511	rs2229712	A	C	68	82	150	0	1	151	0	0
1	26884039	rs35245195	C	G	24	2	26	0	0	26	0	0
1	26884416	rs12726439	T	C	16	0	16	0	1	17	0	0
1	26887592	rs1064196	T	C	90	81	171	0	2	173	0	0
1	26888563	rs9971001	G	C	3	3	6	0	0	6	0	0
1	26889726	rs188743940	C	G	4	8	12	0	0	12	0	0
1	26890850	rs374007	C	T	5	2	7	0	0	7	0	0
1	26890904	rs447743	C	T	3	4	7	0	0	7	0	0
1	26891360	rs3127013	T	G	8	8	16	0	0	16	0	0
1	26891697	rs389548	C	A	4	11	15	0	0	15	0	0
1	26895802	rs282175	A	G	4	4	8	0	0	8	0	0
1	26898956	rs282176	T	C	16	43	59	0	1	60	0	0
1	26899125	rs282177	C	T	5	5	10	0	0	10	0	0
1	26899671	rs2296399	C	G	5	9	14	0	0	14	0	0
1	26899687	rs282178	C	A	10	5	15	0	0	15	0	0
1	26900735	rs282179	C	G	130	151	281	0	0	281	0	0
1	27181184	.	C	T	101	96	197	0	0	197	0	0
1	27205330	rs190405958	G	A	6	6	12	0	0	12	0	0
1	27222597	rs4378228	A	G	4	2	6	0	0	6	0	0
1	27248273	rs41311274	C	A	45	40	85	0	1	86	0	0
1	27462655	.	C	T	5	3	8	0	0	8	0	0
1	27465657	rs35159463	G	A	3	7	10	0	0	10	0	0
1	27466490	rs12751830	A	T	2	4	6	0	0	6	0	0
1	27480757	rs34306208	A	G	38	32	70	0	0	70	0	0
1	27659989	rs35397588	G	A	6	0	6	0	0	6	0	0
1	27660340	rs12758154	T	C	3	4	7	0	0	7	0	0
1	27661707	rs4539159	T	C	3	3	6	0	0	6	0	0
1	27662235	rs3813792	G	T	103	85	188	0	3	191	0	0
1	27662666	rs9203	A	G	120	83	203	0	0	203	0	0
1	27670862	rs75195611	G	T	7	4	11	0	0	11	0	0
1	27676925	rs6702341	G	A	130	105	235	0	18	253	0	0
1	27677066	rs41291092	A	C	19	13	32	0	0	32	0	0
1	27679692	rs11247639	A	G	9	5	14	0	0	14	0	0
1	27679797	rs3813795	A	G	150	148	298	0	3	301	0	0
1	27679954	rs1128918	G	A	221	179	400	0	2	402	0	0
1	27688633	rs1138294	G	A	2	4	6	0	0	6	0	0
1	27731529	rs41291104	C	T	235	246	481	0	3	485	1	0
1	27736354	rs187961403	G	A	106	106	212	0	2	214	0	0
1	27956140	rs143525701	T	C	5	1	6	0	0	6	0	0
1	28176927	rs191813798	C	A	47	65	112	0	1	113	0	0
1	28282206	rs3813804	C	T	11	9	20	0	1	21	0	0
1	28282292	rs3813803	T	C	7	15	22	0	0	22	0	0
1	28285394	rs150999214	C	T	16	18	34	0	0	34	0	0
1	28298951	rs6699701	C	T	4	2	6	0	0	6	0	0
1	28476788	.	G	T	9	4	13	0	1	14	0	0
1	28608338	rs10494394	A	G	228	212	440	0	4	445	1	0
1	28608628	rs116651280	G	A	275	250	525	0	7	532	0	0
1	28793149	rs61748637	C	G	104	105	209	0	2	212	1	0
1	28892760	rs13373966	G	A	6	2	8	0	0	8	0	0
1	29044946	rs936645	T	C	2	6	8	0	1	10	1	0
1	29045123	rs11578325	A	G	2	5	7	0	0	7	0	0
1	29379992	rs2788888	G	A	2	4	6	0	0	6	0	0
1	29381594	rs3003631	T	G	1	5	6	0	0	6	0	0
1	29389696	rs3003627	T	C	3	3	6	0	0	6	0	0
1	29391396	rs12070152	A	G	2	5	7	0	0	7	0	0
1	29440102	rs488113	C	T	2	4	6	0	0	6	0	0
1	29442783	rs531668	C	T	3	6	9	0	0	9	0	0
1	29443675	rs502393	T	C	38	30	68	0	0	68	0	0
1	29443723	rs2249138	A	G	47	46	93	0	0	93	0	0
1	29445514	rs553253	C	A	97	85	182	0	0	182	0	0
1	29475341	rs2230678	C	T	305	306	611	0	7	618	0	0
1	29475394	rs2230677	C	G	317	313	630	0	3	633	0	0
1	29475648	rs2230679	T	G	259	217	476	0	9	485	0	0
1	29475975	rs10915233	G	A	4	6	10	0	0	10	0	0
1	29489691	rs114632849	C	T	7	2	9	0	0	9	0	0
1	29492225	rs2493845	T	C	4	4	8	0	0	8	0	0
1	29493866	rs4654391	T	C	37	34	71	0	0	71	0	0
1	29497820	rs1994859	C	T	47	39	86	0	1	87	0	0
1	29499425	rs2483714	T	G	10	6	16	0	0	16	0	0
1	29500422	rs3003629	T	C	5	4	9	0	1	10	0	0
1	29500449	rs2428559	C	T	7	0	7	0	0	7	0	0
1	29500815	rs2428558	T	C	23	17	40	0	0	40	0	0
1	29500995	rs2486204	T	C	7	15	22	0	1	23	0	0
1	29505070	rs2483715	A	G	3	6	9	0	1	10	0	0
1	29507100	rs493564	A	C	9	8	17	0	0	17	0	0
1	29529699	rs1062924	T	C	6	8	14	0	0	14	0	0
1	29542637	rs1128400	A	G	7	10	17	0	0	17	0	0
1	29549670	rs2640470	A	G	6	3	9	0	0	9	0	0
1	31206539	.	G	A	491	487	978	0	10	988	0	0
1	31221991	rs3790496	A	T	3	3	6	0	0	6	0	0
1	31225678	rs34854980	T	A	3	3	6	0	0	6	0	0
1	31226340	rs1188347	T	C	4	5	9	0	0	9	0	0
1	31226375	rs1188346	A	T	5	6	11	0	0	11	0	0
1	31227027	rs12137058	T	G	1	7	8	0	0	8	0	0
1	31227441	rs1951782	C	T	5	2	7	0	0	7	0	0
1	31228198	rs6685295	G	C	7	5	12	0	0	12	0	0
1	31229883	rs1407885	A	G	2	4	6	0	0	6	0	0
1	31230007	rs2377488	G	C	3	8	11	0	0	11	0	0
1	31230099	rs1407884	G	A	3	5	8	0	0	8	0	0
1	31230195	rs1407882	T	C	6	5	11	0	0	11	0	0
1	31435772	rs76691366	T	C	6	5	11	0	0	11	0	0
1	32608987	.	T	C	4	5	9	0	0	9	0	0
1	32674119	.	C	T	25	24	49	0	0	49	0	0
1	32689857	rs589034	A	G	32	33	65	0	0	65	0	0
1	32690551	.	C	T	3	3	6	0	0	6	0	0
1	32693244	rs114105432	A	G	8	7	15	0	0	15	0	0
1	33032855	rs28490395	A	G	5	1	6	0	0	6	0	0
1	33066299	rs2294815	C	A	34	22	56	0	2	58	0	0
1	33475687	.	C	G	112	0	112	0	0	112	0	0
1	33475750	.	A	G	186	0	186	0	1	187	0	0
1	33475767	.	G	A	191	0	191	0	2	193	0	0
1	33475879	.	C	T	158	0	158	0	1	159	0	0
1	33475967	.	G	A	166	0	166	0	1	167	0	0
1	33476032	.	T	C	120	0	120	0	1	121	0	0
1	33476065	.	G	A	94	0	94	0	2	96	0	0
1	33476074	.	A	T	91	0	91	0	1	92	0	0
1	33476090	.	T	C	104	0	104	0	0	104	0	0
1	33476143	.	G	A	72	0	72	0	0	72	0	0
1	33476165	.	G	A	68	0	68	0	1	69	0	0
1	33476239	.	T	C	37	0	37	0	0	37	0	0
1	33476292	.	A	G	28	0	28	0	0	28	0	0
1	33476353	.	C	T	37	0	37	0	1	38	0	0
1	33476385	.	C	G	53	0	53	0	2	55	0	0
1	33476387	.	C	T	53	0	53	0	1	54	0	0
1	33476396	.	G	A	59	0	59	0	0	59	0	0
1	33476404	.	T	G	65	0	65	0	0	65	0	0
1	33611890	rs689187	C	T	14	14	28	0	1	29	0	0
1	33612508	rs3766813	G	A	16	14	30	0	0	30	0	0
1	33646950	rs622407	A	G	3	4	7	0	0	7	0	0
1	33758206	rs12726791	C	T	6	3	9	0	0	9	0	0
1	33775506	rs12734172	G	A	0	7	7	0	0	7	0	0
1	33789520	rs5861	C	A	292	534	826	0	9	835	0	0
1	33789588	rs1130804	T	C	239	454	693	0	6	699	0	0
1	33789670	rs11061	G	A	284	445	729	0	9	738	0	0
1	33789968	rs1130800	G	T	185	356	541	0	3	544	0	0
1	33790496	rs11554674	G	A	151	270	421	0	5	426	0	0
1	33792698	rs34874995	G	C	3	3	6	0	0	6	0	0
1	33809437	rs10798939	A	G	3	4	7	0	0	7	0	0
1	33820134	rs12026290	C	T	2	6	8	0	0	8	0	0
1	35260929	rs3543	G	A	8	8	16	0	0	16	0	0
1	35261232	rs705193	C	G	4	5	9	0	0	9	0	0
1	35315073	rs56037122	G	C	7	5	12	0	1	13	0	0
1	35315919	rs11263919	A	G	4	2	6	0	0	6	0	0
1	35316050	rs3012	G	A	5	7	12	0	0	12	0	0
1	35316058	rs1054950	A	C	6	7	13	0	0	13	0	0
1	35316175	rs1054949	C	A	11	8	19	0	0	19	0	0
1	35316497	rs12076918	G	A	6	7	13	0	0	13	0	0
1	35317414	rs2025004	C	G	3	8	11	0	0	11	0	0
1	35317472	rs2025005	T	C	2	7	9	0	0	9	0	0
1	35319550	rs11263953	C	T	8	14	22	0	1	23	0	0
1	35323086	rs78210234	T	G	5	7	12	0	0	12	0	0
1	35323550	rs7548854	C	T	13	6	19	0	2	21	0	0
1	35480128	rs530040924	A	G	13	16	29	0	2	31	0	0
1	36067822	.	A	C	104	100	204	0	0	204	0	0
1	36637309	rs191766793	G	A	14	11	25	0	0	25	0	0
1	36641380	rs181662664	G	C	3	5	8	0	0	8	0	0
1	36791919	rs111362452	G	C	5	7	12	0	0	12	0	0
1	36810309	rs184704764	C	T	6	3	9	0	0	9	0	0
1	36851398	.	G	C	8	7	15	0	0	15	0	0
1	36859046	.	G	A	23	12	35	0	0	35	0	0
1	36860732	rs6672948	A	G	5	4	9	0	0	9	0	0
1	36863456	rs1126984	G	A	50	80	130	0	0	130	0	0
1	36921371	rs1538634	G	T	6	3	9	0	0	9	0	0
1	36922959	rs12048722	T	C	3	3	6	0	0	6	0	0
1	36923009	rs12023003	G	A	4	2	6	0	0	6	0	0
1	36923974	rs4652915	C	T	4	4	8	0	0	8	0	0
1	36924676	rs6425987	A	G	5	8	13	0	0	13	0	0
1	36934667	rs2275472	T	C	40	38	78	0	0	78	0	0
1	36936662	rs3917983	T	C	5	2	7	0	0	7	0	0
1	36937059	rs3917981	A	G	422	409	831	0	0	831	0	0
1	36939903	rs3917963	T	G	5	5	10	0	0	10	0	0
1	36940574	rs3917960	G	C	6	4	10	0	0	10	0	0
1	36941751	rs3917950	A	G	213	188	401	0	4	405	0	0
1	36943140	rs3917938	C	T	90	60	150	0	0	150	0	0
1	36943141	rs3917937	A	G	78	70	148	0	0	148	0	0
1	36943484	rs3917934	C	T	24	6	30	0	0	30	0	0
1	36944301	rs3917928	C	A	24	18	42	0	0	42	0	0
1	37948212	rs215205	C	G	14	18	32	0	0	32	0	0
1	37948912	rs41267299	C	T	126	140	266	0	0	266	0	0
1	37958389	rs12133933	A	G	3	4	7	0	0	7	0	0
1	37958813	rs9253	C	G	7	4	11	0	0	11	0	0
1	37959499	rs215212	G	C	149	106	255	0	2	257	0	0
1	37961613	rs2294873	A	G	5	8	13	0	0	13	0	0
1	38002068	rs41267303	C	T	4	2	6	0	0	6	0	0
1	38007121	rs12035095	G	C	13	10	23	0	0	23	0	0
1	38007770	rs4652958	A	G	4	14	18	0	0	18	0	0
1	38008523	rs61776184	C	T	8	5	13	0	0	13	0	0
1	38010651	rs61776185	G	A	9	4	13	0	0	13	0	0
1	38010751	rs6704190	C	T	2	8	10	0	0	10	0	0
1	38012706	rs6662367	C	G	4	6	10	0	0	10	0	0
1	38013346	rs7518026	C	T	2	17	19	0	0	19	0	0
1	38014478	rs11264069	A	G	4	20	24	0	0	24	0	0
1	38014601	rs10908354	A	G	6	1	7	0	0	7	0	0
1	38019747	rs2273013	C	T	29	24	53	0	0	53	0	0
1	38035286	rs10908355	G	T	5	4	9	0	0	9	0	0
1	38042926	rs58284750	C	A	6	5	11	0	0	11	0	0
1	38045125	rs10752599	G	C	3	4	7	0	0	7	0	0
1	38045274	rs7530630	G	A	5	2	7	0	0	7	0	0
1	38049373	rs3753372	C	T	7	3	10	0	0	10	0	0
1	38147606	rs14307	T	A	13	4	17	0	0	17	0	0
1	38158211	rs2306625	C	T	4	6	10	0	0	10	0	0
1	38166327	rs661460	A	T	6	1	7	0	0	7	0	0
1	38174185	rs557897	G	T	53	24	77	0	2	79	0	0
1	38174366	rs7526362	G	T	54	40	94	0	2	96	0	0
1	38174380	rs72659465	G	A	50	40	90	0	1	91	0	0
1	38268836	rs12395	T	C	128	121	249	0	3	252	0	0
1	38397369	rs35267671	C	T	11	26	37	0	0	37	0	0
1	38411445	rs871524	G	A	6	11	17	0	0	17	0	0
1	38423055	.	C	A	176	110	286	0	170	456	0	0
1	38434306	rs28428561	G	A	7	12	19	0	0	19	0	0
1	38445654	rs10890238	T	A	4	3	7	0	0	7	0	0
1	38454553	.	A	G	5	4	9	0	0	9	0	0
1	38454567	.	A	T	4	5	9	0	0	9	0	0
1	38455891	rs4360494	G	C	248	175	423	0	1	424	0	0
1	38456106	rs4072980	G	A	134	141	275	0	4	279	0	0
1	38463504	rs7366048	C	T	262	241	503	0	6	510	1	0
1	39311617	rs11549874	T	G	47	46	93	0	0	93	0	0
1	39329700	rs11538784	G	T	14	21	35	0	0	35	0	0
1	39457006	rs12043492	C	T	5	5	10	0	0	10	0	0
1	39457016	rs11547138	C	T	6	8	14	0	0	14	0	0
1	39457851	rs4660650	T	A	7	3	10	0	0	10	0	0
1	39457854	rs4660651	C	T	7	3	10	0	0	10	0	0
1	39457859	rs4660652	A	G	7	2	9	0	0	9	0	0
1	39458100	rs12133179	G	A	7	7	14	0	1	15	0	0
1	39459155	rs60452427	T	G	2	5	7	0	1	8	0	0
1	39459720	rs75647177	T	C	1	6	7	0	0	7	0	0
1	39461570	rs76222953	G	A	9	1	10	0	0	10	0	0
1	39461881	rs7368120	C	G	3	4	7	0	0	7	0	0
1	39462369	rs4370759	A	T	3	4	7	0	0	7	0	0
1	39462597	rs12145908	C	G	6	4	10	0	0	10	0	0
1	39463438	rs4147763	C	T	10	13	23	0	0	23	0	0
1	39465139	rs11205522	A	C	5	2	7	0	0	7	0	0
1	39467615	rs4147761	A	G	3	3	6	0	0	6	0	0
1	39470364	rs4147753	A	G	274	262	536	0	3	539	0	0
1	39914363	rs668556	G	C	65	76	141	0	3	144	0	0
1	39988034	.	C	T	27	0	27	0	0	27	0	0
1	39988084	.	G	A	33	6	39	0	0	39	0	0
1	39988145	.	T	C	7	16	23	0	0	23	0	0
1	40212957	rs476494	T	C	0	6	6	0	0	6	0	0
1	40219054	.	C	T	81	77	158	0	0	158	0	0
1	40221464	rs506333	T	C	3	4	7	0	0	7	0	0
1	40306898	rs7315	T	C	78	77	155	0	1	156	0	0
1	40308397	rs3768310	G	A	6	6	12	0	1	13	0	0
1	40308918	rs1974206	T	C	8	7	15	0	0	15	0	0
1	40315888	rs3738671	A	T	10	14	24	0	0	24	0	0
1	40349131	rs3845570	G	A	3	5	8	0	0	8	0	0
1	40432159	rs41301060	C	T	3	7	10	0	0	10	0	0
1	40773149	rs2228564	T	C	2	7	9	0	0	9	0	0
1	40775937	rs2228565	G	A	8	9	17	0	0	17	0	0
1	40780989	rs209920	G	A	3	3	6	0	0	6	0	0
1	40840272	.	T	C	5	1	6	0	1	7	0	0
1	40840353	rs1003710	A	G	4	2	6	0	0	6	0	0
1	40841914	rs209576	T	G	2	4	6	0	1	7	0	0
1	40843819	rs11207973	C	T	4	5	9	0	0	9	0	0
1	40844036	rs209577	A	G	7	9	16	0	0	16	0	0
1	40844702	rs209578	C	T	3	5	8	0	0	8	0	0
1	40845981	rs209580	T	C	2	9	11	0	0	11	0	0
1	40845992	rs209581	C	T	1	6	7	0	0	7	0	0
1	40846422	rs209582	G	C	0	9	9	0	0	9	0	0
1	40847491	rs209583	A	C	8	8	16	0	0	16	0	0
1	40848830	rs1909074	T	A	21	12	33	0	1	34	0	0
1	40853331	rs10437077	G	A	21	14	35	0	0	35	0	0
1	40855590	rs3766413	C	T	13	5	18	0	1	19	0	0
1	40855604	rs432240	C	T	22	11	33	0	2	35	0	0
1	40856776	rs66536184	C	T	4	4	8	0	0	8	0	0
1	40857530	rs383228	A	C	4	6	10	0	0	10	0	0
1	40859893	rs141863507	C	T	9	9	18	0	0	18	0	0
1	40862831	rs209598	G	A	9	8	17	0	0	17	0	0
1	40881247	rs72637911	A	G	3	4	7	0	0	7	0	0
1	40930624	rs2982502	A	G	6	0	6	0	0	6	0	0
1	40932189	rs13177	C	T	7	1	8	0	0	8	0	0
1	40980668	rs35672330	T	C	23	22	45	0	0	45	0	0
1	41151332	rs12145212	T	A	5	9	14	0	0	14	0	0
1	41151333	rs12144403	A	C	5	9	14	0	0	14	0	0
1	41152609	rs2780950	C	T	3	3	6	0	0	6	0	0
1	41156491	rs10789191	C	G	3	6	9	0	0	9	0	0
1	41204569	rs1057925	C	T	24	26	50	0	0	50	0	0
1	41224008	rs16827552	C	T	2	7	9	0	0	9	0	0
1	41229122	rs35262530	G	T	14	6	20	0	0	20	0	0
1	41233213	rs3767950	G	T	5	4	9	0	0	9	0	0
1	41234136	rs3754179	G	T	4	2	6	0	0	6	0	0
1	41494532	rs148424741	G	C	6	5	11	0	0	11	0	0
1	41972198	rs2492082	A	T	5	11	16	0	0	16	0	0
1	41972251	rs7542858	C	T	14	4	18	0	0	18	0	0
1	41972880	rs11210344	G	T	24	8	32	0	0	32	0	0
1	41973095	rs2810587	A	G	11	6	17	0	0	17	0	0
1	41973349	rs3738577	G	A	6	5	11	0	0	11	0	0
1	41973908	rs1969749	C	T	6	8	14	0	0	14	0	0
1	41974484	rs12076179	G	A	7	3	10	0	0	10	0	0
1	41976217	rs72669005	G	A	5	4	9	0	0	9	0	0
1	42046613	rs12132697	G	T	3	3	6	0	0	6	0	0
1	42643525	rs11554182	T	C	123	157	280	0	2	282	0	0
1	42644770	rs686247	C	T	88	106	194	0	1	195	0	0
1	42647914	rs624614	A	G	10	8	18	0	0	18	0	0
1	42650622	rs11210606	G	A	7	5	12	0	0	12	0	0
1	42655376	rs17376918	C	T	6	8	14	0	0	14	0	0
1	42656819	rs16829212	T	A	4	3	7	0	0	7	0	0
1	42657196	rs1139978	T	G	51	55	106	0	1	107	0	0
1	43139659	rs61775603	T	A	18	10	28	0	0	28	0	0
1	43139878	rs59665447	A	G	10	12	22	0	0	22	0	0
1	43159705	rs12126887	T	G	33	18	51	0	0	51	0	0
1	43163546	rs12044179	C	T	19	17	36	0	1	37	0	0
1	43166227	rs3850847	T	G	39	35	74	0	0	74	0	0
1	43212111	rs6882	C	T	34	39	73	0	1	74	0	0
1	43213499	rs3738499	C	T	7	3	10	0	0	10	0	0
1	43214683	rs1006518	C	T	5	3	8	0	0	8	0	0
1	43245324	rs1570431	A	G	4	10	14	0	0	14	0	0
1	43245536	rs1570433	C	T	7	10	17	0	0	17	0	0
1	43245560	rs10493114	A	G	7	11	18	0	0	18	0	0
1	43247192	rs2760076	T	C	16	12	28	0	0	28	0	0
1	43254253	rs2014272	G	T	4	3	7	0	0	7	0	0
1	43273064	rs12402142	A	T	124	120	244	0	3	247	0	0
1	43278242	rs1108734	C	T	6	7	13	0	0	13	0	0
1	43279094	rs323714	T	C	1	5	6	0	1	7	0	0
1	43279132	rs323713	C	T	4	6	10	0	0	10	0	0
1	43296173	rs33950227	C	T	12	7	19	0	0	19	0	0
1	43296195	rs33953680	C	T	11	8	19	0	0	19	0	0
1	43392250	rs4658	C	G	123	141	264	0	0	264	0	0
1	43395635	rs2229682	C	T	54	55	109	0	1	110	0	0
1	43396414	rs11537641	G	A	35	36	71	0	1	72	0	0
1	44680796	.	C	T	8	11	19	0	1	20	0	0
1	44681113	rs1291169	T	C	21	23	44	0	0	44	0	0
1	44684995	rs2799480	T	C	4	7	11	0	1	12	0	0
1	44818635	rs80152700	C	G	4	11	15	0	0	15	0	0
1	44819375	rs226065	A	G	12	12	24	0	0	24	0	0
1	44878685	rs10890299	C	T	25	26	51	0	0	51	0	0
1	44878688	rs6690445	A	G	27	23	50	0	0	50	0	0
1	44878738	rs76638263	G	A	27	35	62	0	0	62	0	0
1	44879221	rs4660794	A	C	33	38	71	0	0	71	0	0
1	44881993	rs10890300	G	C	25	17	42	0	0	42	0	0
1	44885123	rs3866643	C	A	7	3	10	0	0	10	0	0
1	44892324	rs6680114	G	A	5	1	6	0	0	6	0	0
1	44926562	.	C	T	2	8	10	0	0	10	0	0
1	44974796	rs12138940	A	G	3	3	6	0	0	6	0	0
1	44975886	rs12747060	G	A	2	7	9	0	0	9	0	0
1	45028041	rs17386574	G	C	2	4	6	0	0	6	0	0
1	45101296	rs77829471	G	A	115	24	139	0	2	141	0	0
1	45110557	rs41269055	C	T	10	10	20	0	0	20	0	0
1	45112717	rs3768440	G	A	3	3	6	0	0	6	0	0
1	45187511	rs10127448	T	C	18	15	33	0	0	33	0	0
1	45196770	rs7536146	A	G	19	6	25	0	0	25	0	0
1	45241113	rs11211031	T	C	4	6	10	0	0	10	0	0
1	45241374	rs3806398	G	A	3	5	8	0	0	8	0	0
1	45269333	rs17886354	A	G	108	81	189	0	2	191	0	0
1	45270733	rs4520451	G	T	22	14	36	0	0	36	0	0
1	45285648	rs41269085	C	T	2	4	6	0	0	6	0	0
1	45292866	rs2295996	G	A	4	5	9	0	0	9	0	0
1	45469155	rs11548990	C	T	35	29	64	0	0	64	0	0
1	45469586	rs41312020	G	A	42	45	87	0	3	90	0	0
1	45470130	rs7528534	T	C	4	6	10	0	0	10	0	0
1	45472047	rs146576128	G	A	4	6	10	0	1	11	0	0
1	45472169	rs7521006	C	T	2	6	8	0	0	8	0	0
1	45474157	rs2298006	G	A	4	2	6	0	0	6	0	0
1	45475909	.	G	A	12	16	28	0	1	29	0	0
1	45479499	rs2234480	G	C	38	55	93	0	0	93	0	0
1	45479709	rs2228084	A	G	149	153	302	0	1	303	0	0
1	45771065	rs4451587	G	C	6	0	6	0	0	6	0	0
1	45797505	rs3219489	C	G	29	16	45	0	0	45	0	0
1	45810091	rs9429072	A	G	5	9	14	0	0	14	0	0
1	45810923	rs3893383	G	A	9	8	17	0	0	17	0	0
1	46016687	rs9147	T	C	46	67	113	0	0	113	0	0
1	46500993	rs1052610	A	G	9	13	22	0	0	22	0	0
1	46659104	rs7527668	T	C	1	5	6	0	0	6	0	0
1	46660295	rs2292487	T	C	4	3	7	0	0	7	0	0
1	46768408	rs1547180	T	C	2	4	6	0	0	6	0	0
1	46772619	rs6429596	A	G	2	4	6	0	0	6	0	0
1	46779514	rs146007813	A	G	4	3	7	0	0	7	0	0
1	46781462	rs4660920	G	C	4	4	8	0	0	8	0	0
1	46781602	rs4660921	G	T	7	2	9	0	0	9	0	0
1	46807597	rs10489770	G	A	3	3	6	0	0	6	0	0
1	46810530	rs3737744	A	G	21	19	40	0	0	40	0	0
1	46870761	rs324420	C	A	6	2	8	0	0	8	0	0
1	47023090	rs80336472	T	G	5	9	14	0	0	14	0	0
1	47023531	rs8602	C	A	57	71	128	0	0	128	0	0
1	47050333	rs1060478	T	C	12	23	35	0	0	35	0	0
1	47050655	rs55680528	G	A	6	16	22	0	0	22	0	0
1	47055948	rs956526	G	A	5	7	12	0	0	12	0	0
1	47055992	rs956527	T	C	5	6	11	0	0	11	0	0
1	47056227	rs764803	T	C	2	6	8	0	0	8	0	0
1	47057412	rs537569802	G	A	3	3	6	0	0	6	0	0
1	47078637	rs4660947	T	C	1	6	7	0	0	7	0	0
1	47080741	rs12029680	C	T	1	5	6	0	0	6	0	0
1	47100159	rs1139758	C	T	2	6	8	0	0	8	0	0
1	47118168	rs2289447	C	T	4	2	6	0	0	6	0	0
1	47118189	rs620431	G	T	6	3	9	0	0	9	0	0
1	47128715	rs7541868	T	C	16	22	38	0	2	40	0	0
1	47141718	rs12794	T	C	39	31	70	0	2	72	0	0
1	47142538	rs1048380	G	A	21	26	47	0	1	48	0	0
1	47143480	rs1048351	C	T	13	14	27	0	0	27	0	0
1	47143547	rs13417	A	G	15	13	28	0	0	28	0	0
1	47158266	rs61782563	A	G	1	6	7	0	0	7	0	0
1	47158486	rs4660956	C	T	4	5	9	0	0	9	0	0
1	47159084	rs78266057	T	C	5	2	7	0	0	7	0	0
1	47159109	rs3766217	G	T	5	3	8	0	0	8	0	0
1	47182206	rs3737731	C	T	6	4	10	0	0	10	0	0
1	47182468	rs1866770	G	T	22	23	45	0	0	45	0	0
1	47184181	rs3766212	C	T	19	15	34	0	1	35	0	0
1	47184196	rs3766211	A	G	19	15	34	0	0	34	0	0
1	47184569	rs8851	G	C	5	6	11	0	0	11	0	0
1	47682017	rs7664	T	G	91	74	165	0	2	167	0	0
1	47683607	rs2070929	G	C	56	66	122	0	2	125	1	0
1	47684677	rs977747	T	G	60	71	131	0	2	133	0	0
1	47689842	rs34087210	C	G	2	8	10	0	0	10	0	0
1	47690438	rs2984618	G	T	7	1	8	0	0	8	0	0
1	47694167	rs11211481	A	G	15	34	49	0	0	49	0	0
1	47696581	rs12141363	C	A	13	9	22	0	0	22	0	0
1	47717189	rs2758735	A	G	34	32	66	0	0	66	0	0
1	47726087	rs13376679	T	C	14	19	33	0	0	33	0	0
1	47766234	rs12406951	G	A	4	9	13	0	0	13	0	0
1	47766647	rs12141060	C	T	9	7	16	0	0	16	0	0
1	47766870	rs72686209	T	C	5	8	13	0	0	13	0	0
1	47767141	rs6689687	C	A	2	8	10	0	0	10	0	0
1	47767914	rs3125630	G	A	13	14	27	0	0	27	0	0
1	47799639	rs7543016	G	C	9	13	22	0	0	22	0	0
1	47834209	rs35687416	G	T	47	63	110	0	1	111	0	0
1	47835150	rs6698717	C	G	4	3	7	0	0	7	0	0
1	47842777	rs1044457	C	T	75	76	151	0	0	151	0	0
1	47844464	rs6795	G	A	13	6	19	0	0	19	0	0
1	51121198	rs11205753	T	C	40	45	85	0	1	86	0	0
1	51820990	rs7308	T	G	141	114	255	0	1	256	0	0
1	51826921	rs17567	T	C	94	86	180	0	1	181	0	0
1	51867561	rs147238231	A	G	2	5	7	0	0	7	0	0
1	51888376	rs79829963	T	C	7	2	9	0	0	9	0	0
1	51900870	rs7532090	C	A	3	3	6	0	0	6	0	0
1	51912651	.	T	C	29	32	61	0	0	61	0	0
1	51912760	rs34704431	T	G	35	46	81	0	1	82	0	0
1	51916702	rs74743056	A	G	4	3	7	0	0	7	0	0
1	51921168	rs1475269	A	G	8	0	8	0	0	8	0	0
1	51985730	rs4926895	A	G	5	6	11	0	0	11	0	0
1	52252006	rs856614	A	G	5	1	6	0	0	6	0	0
1	52252835	.	T	A	6	6	12	0	0	12	0	0
1	52256129	rs41293247	G	A	4	4	8	0	0	8	0	0
1	52264064	rs1770791	A	G	77	60	137	0	2	139	0	0
1	52266242	rs8375	G	A	62	76	138	0	0	138	0	0
1	52273657	rs2982847	T	C	11	7	18	0	0	18	0	0
1	52274078	rs7551758	T	G	9	18	27	0	0	27	0	0
1	52290984	rs11205896	T	G	30	35	65	0	0	65	0	0
1	52338824	rs114337846	G	A	9	8	17	0	0	17	0	0
1	52342427	rs1890946	T	C	7	12	19	0	0	19	0	0
1	52343297	rs6663305	A	G	3	5	8	0	0	8	0	0
1	52486104	rs7512076	C	T	172	186	358	0	2	360	0	0
1	52498370	rs2809917	C	T	72	80	152	0	0	152	0	0
1	52499939	rs17106988	G	A	7	11	18	0	0	18	0	0
1	52501152	rs76511642	G	A	4	4	8	0	0	8	0	0
1	52504176	rs12406969	G	T	4	3	7	0	0	7	0	0
1	52811581	rs7517338	C	T	13	18	31	0	0	31	0	0
1	52814170	rs7546223	G	A	8	1	9	0	0	9	0	0
1	52815162	rs34115295	A	C	5	5	10	0	0	10	0	0
1	52816959	rs17364363	T	C	13	8	21	0	0	21	0	0
1	52818188	rs7513934	G	A	10	4	14	0	0	14	0	0
1	52820567	.	C	T	65	48	113	0	0	113	0	0
1	52826532	rs7339941	G	A	11	17	28	0	0	28	0	0
1	52828384	rs11555349	A	G	17	23	40	0	0	40	0	0
1	52841152	.	T	G	75	68	143	0	0	143	0	0
1	52853892	rs189568154	C	T	5	4	9	0	1	10	0	0
1	52877130	rs10128030	G	C	8	3	11	0	0	11	0	0
1	52882406	rs6677047	A	G	50	72	122	0	4	126	0	0
1	52885165	rs17364517	T	G	11	16	27	0	0	27	0	0
1	52889891	rs17107217	A	C	4	3	7	0	0	7	0	0
1	52903256	rs12411173	C	T	9	7	16	0	2	18	0	0
1	52904410	rs12407818	T	C	18	22	40	0	0	40	0	0
1	52906583	rs1136915	T	G	4	11	15	0	0	15	0	0
1	52908280	rs970917	C	T	8	8	16	0	0	16	0	0
1	52908283	rs1542779	A	G	9	8	17	0	0	17	0	0
1	52908747	rs12406115	G	A	4	4	8	0	0	8	0	0
1	52910109	rs72903609	C	T	9	4	13	0	0	13	0	0
1	52910974	rs7525340	A	C	3	10	13	0	0	13	0	0
1	52929339	rs41294510	G	A	5	12	17	0	0	17	0	0
1	52945241	rs80050286	C	T	1	5	6	0	0	6	0	0
1	52948750	rs72903653	T	C	6	6	12	0	0	12	0	0
1	52949594	rs72903655	A	C	4	3	7	0	0	7	0	0
1	52950551	rs57663833	G	A	6	5	11	0	0	11	0	0
1	52951323	rs17107246	A	G	3	5	8	0	0	8	0	0
1	52952869	rs12402446	G	A	4	5	9	0	0	9	0	0
1	52953766	rs6682550	T	C	4	8	12	0	0	12	0	0
1	52954033	rs7534130	A	C	3	5	8	0	0	8	0	0
1	52979822	rs17365027	T	A	5	2	7	0	0	7	0	0
1	52980317	rs12407960	T	C	3	8	11	0	0	11	0	0
1	52991638	rs12123698	C	T	47	36	83	0	1	84	0	0
1	52991983	rs57766167	A	G	18	26	44	0	0	44	0	0
1	53073242	rs35226390	G	A	3	5	8	0	0	8	0	0
1	53073397	rs946155	G	T	7	0	7	0	0	7	0	0
1	53074412	rs1047619	A	G	79	92	171	0	0	171	0	0
1	53074532	rs1047635	C	A	39	23	62	0	0	62	0	0
1	53453714	rs7538935	G	T	6	6	12	0	0	12	0	0
1	53513768	rs4599997	C	G	6	7	13	0	0	13	0	0
1	53513837	rs4348672	G	C	5	7	12	0	0	12	0	0
1	53514066	rs11206081	C	G	3	4	7	0	0	7	0	0
1	53514350	rs6664654	C	T	2	8	10	0	0	10	0	0
1	53514628	rs6677541	A	G	3	5	8	0	0	8	0	0
1	53515305	rs3766764	G	A	3	5	8	0	0	8	0	0
1	53515596	rs7534827	A	G	6	0	6	0	0	6	0	0
1	53516017	rs17107756	G	C	7	2	9	0	0	9	0	0
1	53759072	rs958825	G	A	5	2	7	0	0	7	0	0
1	54295139	rs72662332	C	G	7	2	9	0	0	9	0	0
1	54295292	rs1181174	T	C	5	1	6	0	0	6	0	0
1	54318411	rs7519869	G	A	1	7	8	0	0	8	0	0
1	54318725	rs67497340	G	C	4	4	8	0	0	8	0	0
1	54318765	rs1936835	T	C	6	2	8	0	0	8	0	0
1	54355105	rs10749693	A	G	6	9	15	0	0	15	0	0
1	54387577	rs12090789	T	C	6	5	11	0	1	12	0	0
1	54387857	rs10888822	T	C	4	4	8	0	0	8	0	0
1	54389200	rs10047036	A	G	5	5	10	0	0	10	0	0
1	54412181	rs1063162	T	C	14	18	32	0	0	32	0	0
1	54432019	rs2294514	G	A	50	52	102	0	4	106	0	0
1	54498754	rs34370448	C	T	3	3	6	0	0	6	0	0
1	54501826	rs12041928	G	C	4	3	7	0	0	7	0	0
1	54513827	rs914722	T	A	2	4	6	0	0	6	0	0
1	54514223	rs41294772	T	C	2	4	6	0	0	6	0	0
1	54690954	rs3088379	T	C	52	50	102	0	1	103	0	0
1	54691465	rs9012	C	T	71	101	172	0	2	174	0	0
1	54702225	rs10127740	G	T	2	6	8	0	0	8	0	0
1	54703197	rs664696	A	C	6	4	10	0	0	10	0	0
1	54703198	rs644660	T	A	5	4	9	0	1	10	0	0
1	54704510	rs2274662	A	C	8	11	19	0	0	19	0	0
1	54704629	rs2274664	C	T	3	5	8	0	0	8	0	0
1	54779243	rs7524749	G	A	4	2	6	0	0	6	0	0
1	54786856	rs12026238	T	C	4	2	6	0	0	6	0	0
1	55074922	rs2289016	G	A	6	3	9	0	0	9	0	0
1	55116891	rs752467	C	T	4	3	7	0	0	7	0	0
1	55119289	rs9332417	G	C	13	9	22	0	0	22	0	0
1	55119515	rs1655519	T	G	14	15	29	0	0	29	0	0
1	55119534	rs17399810	C	T	17	14	31	0	0	31	0	0
1	55125417	rs652245	T	C	2	6	8	0	0	8	0	0
1	55136529	rs480963	T	C	3	5	8	0	0	8	0	0
1	55139618	rs571199	G	A	4	2	6	0	0	6	0	0
1	55167773	rs646356	T	A	10	18	28	0	0	28	0	0
1	55315941	rs11555500	G	T	11	1	12	0	0	12	0	0
1	55538552	rs10493176	T	G	1	6	7	0	0	7	0	0
1	55631782	rs1759499	G	T	3	3	6	0	0	6	0	0
1	56961756	rs4628	A	G	5	9	14	0	1	15	0	0
1	59041220	rs7333	C	T	4	8	12	0	1	13	0	0
1	59041577	rs3551	A	G	8	10	18	0	0	18	0	0
1	59042181	rs14008	G	T	6	5	11	0	0	11	0	0
1	59121036	rs10789069	A	C	86	89	175	0	1	176	0	0
1	59122871	rs232851	C	T	55	52	107	0	2	109	0	0
1	59123655	rs10889108	C	T	55	48	103	0	2	105	0	0
1	59123995	rs6682078	A	G	39	22	61	0	1	62	0	0
1	59124223	rs12080369	G	A	47	44	91	0	1	92	0	0
1	59124546	rs232775	A	G	37	27	64	0	0	64	0	0
1	59124803	rs232776	C	T	53	40	93	0	0	93	0	0
1	59125319	rs12562490	C	T	49	26	75	0	0	75	0	0
1	59125515	rs12737926	C	T	34	30	64	0	0	64	0	0
1	59126107	rs12742701	C	T	2	4	6	0	0	6	0	0
1	59127086	rs7523134	G	A	34	39	73	0	1	74	0	0
1	59127193	rs7525365	C	T	5	4	9	0	0	9	0	0
1	59127705	rs17118041	C	G	5	2	7	0	0	7	0	0
1	59133339	rs6673162	C	T	2	4	6	0	0	6	0	0
1	59142713	rs579110	T	C	52	46	98	0	0	98	0	0
1	59147926	rs12139511	T	C	23	19	42	0	0	42	0	0
1	59155683	rs2223698	T	C	3	6	9	0	0	9	0	0
1	59158161	rs2746081	A	G	2	4	6	0	0	6	0	0
1	59163540	rs12078684	C	A	5	1	6	0	0	6	0	0
1	59163553	rs6680750	A	G	1	5	6	0	0	6	0	0
1	62146778	rs41289420	G	C	6	1	7	0	0	7	0	0
1	62163715	rs12143420	C	A	8	6	14	0	0	14	0	0
1	62902874	rs646179	A	G	35	30	65	0	2	67	0	0
1	63836513	rs34542411	C	G	4	4	8	0	0	8	0	0
1	64097432	rs1126728	C	T	21	20	41	0	0	41	0	0
1	65297240	rs1048007	A	G	31	28	59	0	0	59	0	0
1	65297983	rs1556561	A	T	35	29	64	0	0	64	0	0
1	65298791	rs2780889	A	T	81	79	160	0	0	160	0	0
1	65311262	rs2230587	G	A	53	58	111	0	0	111	0	0
1	65313682	rs2780824	C	A	4	3	7	0	0	7	0	0
1	65314078	rs3790535	C	T	8	11	19	0	1	20	0	0
1	65338745	rs55869683	C	T	13	8	21	0	0	21	0	0
1	65338775	rs17127117	C	T	11	4	15	0	0	15	0	0
1	65523519	rs521188	A	G	6	5	11	0	0	11	0	0
1	65693976	rs1062446	C	T	2	5	7	0	0	7	0	0
1	65694080	rs13483	C	T	5	6	11	0	0	11	0	0
1	65694819	rs1062445	G	A	2	5	7	0	0	7	0	0
1	65694834	rs78465619	A	T	4	2	6	0	0	6	0	0
1	65695853	rs1855982	A	G	2	5	7	0	0	7	0	0
1	65695930	rs1336472	G	A	4	2	6	0	0	6	0	0
1	65696034	rs1855981	G	C	4	2	6	0	0	6	0	0
1	65879252	rs10493377	A	G	9	10	19	0	0	19	0	0
1	65886398	rs3790435	T	C	109	103	212	0	3	215	0	0
1	65887013	rs12145690	A	C	6	6	12	0	0	12	0	0
1	65888085	rs10889549	C	A	3	4	7	0	0	7	0	0
1	65888231	rs4655802	G	A	4	2	6	0	0	6	0	0
1	65891901	rs9436740	A	T	7	2	9	0	0	9	0	0
1	65901345	rs113256767	C	T	191	168	359	0	0	359	0	0
1	66806953	rs2788646	T	C	3	4	7	0	0	7	0	0
1	66807544	rs475826	G	A	7	1	8	0	0	8	0	0
1	66809344	rs501997	A	G	1	6	7	0	0	7	0	0
1	66831370	rs783036	G	A	56	86	142	0	0	142	0	0
1	66837859	rs783068	G	A	6	8	14	0	0	14	0	0
1	66838733	rs783067	A	C	131	121	252	0	4	256	0	0
1	67092248	rs5008753	A	G	4	2	6	0	0	6	0	0
1	67092935	rs7512692	C	T	2	4	6	0	0	6	0	0
1	67093018	rs7524851	T	C	2	4	6	0	0	6	0	0
1	67221387	rs2274987	T	C	4	7	11	0	0	11	0	0
1	67239576	rs7548496	C	G	5	6	11	0	0	11	0	0
1	67243024	rs2133173	C	A	16	11	27	0	0	27	0	0
1	67243252	rs2133172	G	A	15	7	22	0	0	22	0	0
1	67244243	rs7524784	A	T	7	8	15	0	0	15	0	0
1	67390999	rs3008859	G	C	8	0	8	0	0	8	0	0
1	67391003	rs3008860	G	C	8	1	9	0	0	9	0	0
1	67396739	rs12562761	C	T	2	5	7	0	1	8	0	0
1	67398916	rs2985818	G	A	1	5	6	0	0	6	0	0
1	67402596	rs4655659	T	C	2	5	7	0	0	7	0	0
1	67402838	rs3008865	T	C	5	5	10	0	0	10	0	0
1	67402953	rs4655660	G	A	5	14	19	0	0	19	0	0
1	67403787	rs2985821	G	A	5	1	6	0	0	6	0	0
1	67412822	rs2985825	T	G	12	13	25	0	0	25	0	0
1	67412918	rs2985826	G	C	10	10	20	0	0	20	0	0
1	67413478	rs912797	A	G	27	42	69	0	1	70	0	0
1	67434602	rs12041926	C	T	3	3	6	0	0	6	0	0
1	67438900	rs35365746	G	A	3	5	8	0	0	8	0	0
1	67440116	rs115578081	T	G	2	5	7	0	0	7	0	0
1	67442210	rs11208978	C	T	3	6	9	0	0	9	0	0
1	67442275	rs11208979	C	T	3	9	12	0	1	13	0	0
1	67443751	rs58680688	C	G	2	4	6	0	0	6	0	0
1	67444043	rs12130046	G	A	7	4	11	0	0	11	0	0
1	67445321	rs34367328	T	C	13	11	24	0	0	24	0	0
1	67447450	rs12039172	A	G	3	6	9	0	0	9	0	0
1	67451602	rs1137656	A	C	46	38	84	0	3	87	0	0
1	67451922	rs12117131	C	T	80	46	126	0	1	127	0	0
1	67451924	rs12132068	G	T	83	47	130	0	0	130	0	0
1	67452322	rs17497828	G	A	254	258	512	0	9	521	0	0
1	67453035	rs7516251	A	G	401	386	787	0	3	790	0	0
1	67465988	.	A	T	21	15	36	0	0	36	0	0
1	67468124	rs2065000	G	C	24	27	51	0	0	51	0	0
1	67470843	rs2755253	C	T	2	5	7	0	0	7	0	0
1	67470855	rs2755254	C	T	2	5	7	0	0	7	0	0
1	67471692	rs2755256	A	T	4	3	7	0	0	7	0	0
1	67471706	rs12738583	C	A	3	3	6	0	0	6	0	0
1	67875104	rs35746287	C	A	33	38	71	0	3	74	0	0
1	67875203	rs72678562	C	T	37	42	79	0	1	80	0	0
1	67876484	rs1058074	C	T	22	9	31	0	1	32	0	0
1	67888763	rs11209066	A	G	3	5	8	0	0	8	0	0
1	67888876	rs11209067	A	G	6	1	7	0	0	7	0	0
1	67888931	rs112588573	G	A	6	4	10	0	0	10	0	0
1	67889571	rs12566098	C	G	4	6	10	0	1	11	0	0
1	67891029	rs57690154	A	C	4	3	7	0	0	7	0	0
1	68151980	rs2759219	T	G	9	4	13	0	0	13	0	0
1	68152363	rs3783468	G	A	8	6	14	0	0	14	0	0
1	68152388	rs681673	T	C	8	5	13	0	1	14	0	0
1	68152438	rs532446	C	T	9	8	17	0	0	17	0	0
1	70611208	rs676753	A	T	21	24	45	0	1	46	0	0
1	70623530	rs56200611	T	C	3	3	6	0	0	6	0	0
1	70690540	rs56299138	C	T	38	45	83	0	0	83	0	0
1	70692642	.	G	A	82	83	165	0	1	166	0	0
1	70696116	rs531881821	C	T	133	115	248	0	2	250	0	0
1	70766863	rs3795694	T	C	4	5	9	0	1	10	0	0
1	70768865	.	C	T	8	6	14	0	0	14	0	0
1	70769906	rs11209603	C	T	8	7	15	0	1	16	0	0
1	70818576	rs12036256	T	G	9	12	21	0	0	21	0	0
1	70904800	rs1021737	G	T	5	5	10	0	0	10	0	0
1	71523377	rs79827913	A	G	5	6	11	0	0	11	0	0
1	71529401	rs7411	C	T	76	55	131	0	2	133	0	0
1	71531596	rs17090778	A	G	20	9	29	0	1	30	0	0
1	71533287	rs66461782	A	T	4	5	9	0	0	9	0	0
1	71535608	rs1138177	T	C	16	22	38	0	0	38	0	0
1	71541327	rs77943746	A	G	6	8	14	0	0	14	0	0
1	71541524	rs12030413	G	C	4	5	9	0	0	9	0	0
1	76258184	rs111724906	T	C	14	18	32	0	0	32	0	0
1	78415132	rs536275807	C	A	6	2	8	0	0	8	0	0
1	78416945	rs74942344	T	C	5	5	10	0	0	10	0	0
1	79111142	rs1333972	A	C	5	14	19	0	1	20	0	0
1	79117713	rs17394028	A	G	11	16	27	0	0	27	0	0
1	79123094	rs7514391	G	A	105	87	192	0	3	195	0	0
1	79128914	rs3766325	G	A	127	129	256	0	1	257	0	0
1	84944989	rs2292191	A	G	75	87	162	0	1	163	0	0
1	84956780	rs12136756	C	T	10	6	16	0	0	16	0	0
1	84956858	rs12126584	A	G	6	6	12	0	0	12	0	0
1	84957998	rs4907077	T	C	5	10	15	0	0	15	0	0
1	84958561	rs312401	G	A	3	13	16	0	0	16	0	0
1	84958788	rs36069412	G	A	6	3	9	0	0	9	0	0
1	84959001	rs3922538	G	T	4	3	7	0	0	7	0	0
1	84963000	rs1246159	A	G	5	4	9	0	0	9	0	0
1	84965623	rs56212819	C	T	8	3	11	0	0	11	0	0
1	84968749	rs17110519	G	T	4	3	7	0	0	7	0	0
1	84970107	rs3813607	A	G	3	5	8	0	0	8	0	0
1	84970947	rs3813605	C	T	1	5	6	0	1	7	0	0
1	84972099	rs2271620	G	T	9	8	17	0	0	17	0	0
1	85029077	rs15911	C	T	37	37	74	0	0	74	0	0
1	85031630	rs2994953	G	A	25	31	56	0	0	56	0	0
1	85039828	rs41299545	G	A	4	2	6	0	0	6	0	0
1	85039955	rs2303307	G	A	10	12	22	0	1	23	0	0
1	85040069	rs2911592	G	A	4	5	9	0	0	9	0	0
1	85040070	rs115347546	C	A	4	5	9	0	0	9	0	0
1	85111124	rs2911613	C	A	27	18	45	0	2	47	0	0
1	85112709	.	G	A	9	5	14	0	0	14	0	0
1	85113229	rs1057746	A	G	37	38	75	0	2	77	0	0
1	85121255	rs4537578	A	G	1	5	6	0	0	6	0	0
1	86119296	rs821399	C	A	37	40	77	0	2	79	0	0
1	86119898	rs2274738	A	G	6	4	10	0	0	10	0	0
1	86120116	rs821401	A	C	4	2	6	0	0	6	0	0
1	86194997	rs1047895	C	T	8	2	10	0	0	10	0	0
1	86195047	rs1047893	T	C	2	6	8	0	0	8	0	0
1	86195066	rs1047892	A	C	7	4	11	0	0	11	0	0
1	86375654	rs1502657	C	G	15	5	20	0	0	20	0	0
1	86488232	rs641712	G	A	4	2	6	0	0	6	0	0
1	86557967	rs11161732	G	A	5	2	7	0	0	7	0	0
1	86816987	rs272494	T	A	35	36	71	0	0	71	0	0
1	86817084	rs12031536	G	A	33	21	54	0	0	54	0	0
1	86817397	rs7515651	C	T	26	22	48	0	0	48	0	0
1	86822231	rs385437	A	G	20	15	35	0	0	35	0	0
1	86822809	rs17372196	T	G	5	5	10	0	0	10	0	0
1	86823503	rs17363646	A	G	5	10	15	0	0	15	0	0
1	86823769	rs11161803	C	T	7	8	15	0	0	15	0	0
1	86838523	rs11161806	A	C	4	4	8	0	0	8	0	0
1	86842675	rs2390099	A	T	3	4	7	0	0	7	0	0
1	86842812	rs2390098	T	G	1	5	6	0	0	6	0	0
1	86844308	rs4332330	C	T	3	3	6	0	0	6	0	0
1	86844309	rs4638096	A	G	3	3	6	0	0	6	0	0
1	86847955	rs272516	G	A	10	10	20	0	0	20	0	0
1	86851420	rs1407719	A	G	2	5	7	0	0	7	0	0
1	86852042	rs1407720	A	G	5	4	9	0	0	9	0	0
1	86852621	rs2390096	A	G	8	8	16	0	0	16	0	0
1	87799951	rs112451068	C	G	3	3	6	0	0	6	0	0
1	89294890	rs148055083	G	A	57	43	100	0	0	100	0	0
1	89301040	rs144889137	A	T	65	59	124	0	0	124	0	0
1	89401613	rs14490	T	G	30	30	60	0	0	60	0	0
1	89418231	rs1409151	G	A	11	6	17	0	0	17	0	0
1	89418403	rs1409152	C	T	7	13	20	0	0	20	0	0
1	89426902	rs3738055	G	A	22	11	33	0	1	34	0	0
1	89430245	rs41288367	G	A	5	3	8	0	0	8	0	0
1	89445551	rs76109623	A	G	100	128	228	0	1	229	0	0
1	89446508	rs11542207	C	G	44	24	68	0	0	68	0	0
1	89447978	rs10754258	T	A	35	52	87	0	1	88	0	0
1	89473134	rs2077694	C	T	34	24	58	0	0	58	0	0
1	89473175	rs1409150	T	C	31	31	62	0	1	63	0	0
1	89475230	rs4142706	T	G	8	12	20	0	0	20	0	0
1	89476094	rs60788429	C	T	3	4	7	0	0	7	0	0
1	89518065	rs1048848	C	G	12	9	21	0	1	22	0	0
1	89518120	rs7911	A	G	15	9	24	0	0	24	0	0
1	89518173	rs2296882	T	A	13	8	21	0	0	21	0	0
1	89518195	rs2296883	G	A	13	9	22	0	0	22	0	0
1	89521346	rs2281981	A	T	6	8	14	0	0	14	0	0
1	89523911	rs75161612	C	T	39	30	69	0	1	70	0	0
1	89569973	rs7513609	G	C	87	65	152	0	3	155	0	0
1	89570087	rs61745620	G	A	80	74	154	0	0	154	0	0
1	89572015	rs4655900	A	G	56	35	91	0	0	91	0	0
1	89572726	rs77223402	G	A	91	86	177	0	0	177	0	0
1	89572787	rs997160	G	C	11	5	16	0	0	16	0	0
1	89573262	rs1056550	C	T	13	10	23	0	0	23	0	0
1	89573353	rs114437299	C	T	16	15	31	0	0	31	0	0
1	89576188	rs78812407	C	A	6	10	16	0	0	16	0	0
1	89576445	rs6700871	A	G	9	2	11	0	0	11	0	0
1	89576917	rs7518894	G	A	3	4	7	0	0	7	0	0
1	89579941	rs2230338	T	C	263	184	447	0	0	447	0	0
1	89582690	rs1803632	G	C	240	139	379	0	2	381	0	0
1	89583544	rs2209956	T	C	7	4	11	0	0	11	0	0
1	89584565	rs1329120	A	G	3	5	8	0	0	8	0	0
1	89585305	rs2183159	G	T	2	7	9	0	0	9	0	0
1	89587984	rs7529400	T	C	28	40	68	0	1	69	0	0
1	89588647	rs74503847	G	T	14	23	37	0	0	37	0	0
1	89588729	rs78594840	A	G	27	26	53	0	1	54	0	0
1	89589033	rs79087203	C	A	28	17	45	0	1	46	0	0
1	89589383	rs10922574	T	C	17	14	31	0	1	32	0	0
1	89589556	rs10922575	T	C	47	27	74	0	1	75	0	0
1	89590190	rs79494675	C	A	23	34	57	0	1	58	0	0
1	89591082	rs10754261	T	G	34	21	55	0	1	56	0	0
1	89592446	rs181130167	G	T	5	17	22	0	0	22	0	0
1	89592455	rs74367406	C	T	4	16	20	0	0	20	0	0
1	89592901	rs10922576	G	A	29	3	32	0	0	32	0	0
1	89593037	rs61798958	G	T	21	1	22	0	0	22	0	0
1	89650099	rs2181861	G	A	25	18	43	0	0	43	0	0
1	89655787	rs41305862	T	C	51	60	111	0	1	112	0	0
1	89655994	rs1410871	C	T	43	39	82	0	0	82	0	0
1	89663851	rs585525	T	A	5	3	8	0	0	8	0	0
1	89728739	rs144341165	A	T	15	26	41	0	0	41	0	0
1	90011038	rs138805750	G	A	3	3	6	0	0	6	0	0
1	90015719	rs1885746	A	C	5	3	8	0	0	8	0	0
1	90015786	rs17491895	C	A	6	4	10	0	0	10	0	0
1	90019713	rs12752582	G	T	2	4	6	0	0	6	0	0
1	90021989	rs61799532	G	A	1	6	7	0	0	7	0	0
1	90022799	rs4658279	G	A	0	6	6	0	0	6	0	0
1	90023756	rs12119009	G	C	6	3	9	0	0	9	0	0
1	90023768	rs6699344	G	A	6	4	10	0	0	10	0	0
1	90024094	rs10922661	T	C	5	12	17	0	0	17	0	0
1	90024774	rs17130828	T	C	5	2	7	0	0	7	0	0
1	90025689	rs12140018	G	A	3	4	7	0	0	7	0	0
1	90032047	rs12116782	G	A	3	7	10	0	0	10	0	0
1	90040361	rs12760395	A	G	5	5	10	0	0	10	0	0
1	90040758	rs1459637	A	G	4	2	6	0	0	6	0	0
1	90041187	rs12118131	T	C	5	1	6	0	0	6	0	0
1	90048248	rs12130207	C	T	24	14	38	0	0	38	0	0
1	90049040	rs36084789	A	G	14	26	40	0	1	41	0	0
1	90053245	rs12135419	C	T	0	6	6	0	0	6	0	0
1	90057394	rs61801424	C	T	3	3	6	0	0	6	0	0
1	90059575	rs12129433	G	T	39	31	70	0	0	70	0	0
1	91853096	rs573592293	G	A	26	0	26	0	1	27	0	0
1	91966445	rs13447455	A	G	5	4	9	0	0	9	0	0
1	91980447	rs483532	A	G	5	9	14	0	0	14	0	0
1	91990487	rs12125947	T	C	15	14	29	0	0	29	0	0
1	92148227	rs902	C	G	3	5	8	0	0	8	0	0
1	92720279	rs143996608	G	C	5	1	6	0	0	6	0	0
1	92790717	rs137966606	T	C	5	2	7	0	0	7	0	0
1	92940850	rs1325432	G	T	128	129	257	0	0	257	0	0
1	93307302	rs41286819	A	G	10	5	15	0	0	15	0	0
1	93591162	rs12064785	A	G	5	2	7	0	0	7	0	0
1	93592577	rs490153	T	A	1	5	6	0	0	6	0	0
1	93598677	rs114972434	T	C	4	3	7	0	0	7	0	0
1	93600630	rs12736775	A	G	2	6	8	0	0	8	0	0
1	93601231	rs36057148	G	A	16	0	16	0	1	17	0	0
1	93604136	rs12062154	T	C	39	33	72	0	1	74	1	0
1	93616202	rs1572343	T	C	29	18	47	0	0	47	0	0
1	93617477	rs3171	A	G	21	67	88	0	1	89	0	0
1	93617546	rs546	T	C	36	67	103	0	2	105	0	0
1	93622789	rs2783506	A	G	3	6	9	0	1	10	0	0
1	93624139	rs2749735	G	T	12	13	25	0	0	25	0	0
1	93624374	rs12130734	T	C	21	34	55	0	0	55	0	0
1	93646523	rs76205214	G	A	5	6	11	0	0	11	0	0
1	93646620	rs2815408	C	T	3	4	7	0	0	7	0	0
1	93647106	rs1414367	T	G	3	4	7	0	0	7	0	0
1	93672723	rs2815413	A	C	5	10	15	0	0	15	0	0
1	93683543	rs506556	C	G	3	3	6	0	0	6	0	0
1	93685923	rs671559	T	C	6	5	11	0	1	12	0	0
1	93698072	rs77458693	G	A	15	8	23	0	0	23	0	0
1	93704952	rs41292127	A	G	5	16	21	0	0	21	0	0
1	93727579	rs602204	A	G	29	4	33	0	0	33	0	0
1	93728758	rs535760	T	A	17	2	19	0	0	19	0	0
1	93729008	rs559397	C	A	14	1	15	0	0	15	0	0
1	93744055	rs10874767	G	A	6	6	12	0	0	12	0	0
1	93777071	rs7413775	C	T	7	14	21	0	0	21	0	0
1	93791437	rs4847408	G	C	5	26	31	0	0	31	0	0
1	93797963	rs77016151	C	A	6	12	18	0	0	18	0	0
1	93799002	rs10874774	C	T	7	11	18	0	1	19	0	0
1	93803716	rs55838267	C	T	2	7	9	0	1	10	0	0
1	93804177	rs6664886	C	G	9	39	48	0	0	48	0	0
1	93804783	rs10874775	A	G	9	27	36	0	0	36	0	0
1	93804952	rs1535699	G	A	15	30	45	0	0	45	0	0
1	93804987	rs1535700	C	G	15	34	49	0	0	49	0	0
1	93811569	rs10782959	A	G	28	28	56	0	0	56	0	0
1	93827456	rs771457	T	A	81	77	158	0	3	161	0	0
1	93828523	rs7525248	T	A	15	6	21	0	0	21	0	0
1	93828907	rs771456	C	T	31	25	56	0	0	56	0	0
1	93829248	rs4847412	C	G	54	44	98	0	2	100	0	0
1	93829869	rs698926	A	G	10	12	22	0	1	23	0	0
1	93830480	rs771455	G	C	22	19	41	0	0	41	0	0
1	93831694	rs771453	A	C	88	51	139	0	0	139	0	0
1	93831707	rs771452	G	A	95	52	147	0	0	147	0	0
1	93832565	rs7535214	A	T	8	10	18	0	0	18	0	0
1	93833101	rs771450	G	A	9	19	28	0	0	28	0	0
1	93833181	rs771449	A	G	10	18	28	0	0	28	0	0
1	93833526	rs771448	A	C	13	10	23	0	0	23	0	0
1	93833537	rs6680022	C	T	13	10	23	0	1	24	0	0
1	93833994	rs76187824	G	A	6	30	36	0	0	36	0	0
1	94018031	rs41292649	G	C	7	3	10	0	0	10	0	0
1	94339683	rs4847193	C	T	9	5	14	0	0	14	0	0
1	94339844	rs3789460	A	C	9	5	14	0	0	14	0	0
1	94339975	rs3789459	C	T	6	4	10	0	0	10	0	0
1	94340556	rs4847264	G	T	5	5	10	0	0	10	0	0
1	94341267	rs2273165	A	G	209	207	416	0	5	421	0	0
1	94342564	rs3747965	C	A	171	169	340	0	0	342	2	0
1	94343023	rs2391322	A	G	111	141	252	0	0	252	0	0
1	94344110	rs4141737	G	A	4	6	10	0	0	10	0	0
1	94344716	rs2235971	C	T	30	28	58	0	0	58	0	0
1	94361152	rs6667121	C	G	5	1	6	0	0	6	0	0
1	94983208	rs183336788	T	G	20	26	46	0	1	47	0	0
1	94995616	rs187452932	C	T	3	5	8	0	0	8	0	0
1	97145162	rs61759529	T	G	43	1	44	0	6	50	0	0
1	97245200	rs10489797	T	G	3	8	11	0	0	11	0	0
1	97245894	rs273870	G	A	5	1	6	0	0	6	0	0
1	97249796	rs17115733	G	A	5	10	15	0	2	17	0	0
1	97249952	rs12083632	G	T	7	9	16	0	0	16	0	0
1	97251845	rs273875	A	C	7	6	13	0	0	13	0	0
1	97252839	rs11165721	A	C	7	3	10	0	0	10	0	0
1	97258468	rs6699242	G	A	7	11	18	0	0	18	0	0
1	97259118	rs273863	A	G	4	4	8	0	0	8	0	0
1	97260514	rs12024107	C	T	6	5	11	0	0	11	0	0
1	97262041	rs3748783	C	T	9	14	23	0	0	23	0	0
1	97262716	rs3791010	C	T	8	17	25	0	0	25	0	0
1	97263676	rs273865	T	G	6	3	9	0	0	9	0	0
1	97265063	rs113658986	A	G	5	4	9	0	0	9	0	0
1	97267793	rs2391781	C	G	8	3	11	0	2	14	1	0
1	97272456	rs6699932	A	G	97	151	248	0	5	253	0	0
1	97279692	rs273885	C	T	294	332	626	0	3	629	0	0
1	97286510	rs479424	T	C	5	3	8	0	0	8	0	0
1	97288628	rs10875036	T	C	17	18	35	0	0	35	0	0
1	100316589	rs2307130	A	G	9	14	23	0	1	24	0	0
1	100343254	rs141043166	G	A	10	7	17	0	0	17	0	0
1	100358083	.	C	G	14	10	24	0	1	25	0	0
1	100358103	rs3753494	C	T	16	11	27	0	1	28	0	0
1	100385309	rs11166375	T	C	4	5	9	0	1	10	0	0
1	100388503	rs1804809	A	C	22	18	40	0	0	40	0	0
1	100388748	rs3766603	T	C	37	38	75	0	0	75	0	0
1	100490086	rs192189070	G	A	3	4	7	0	1	8	0	0
1	100541420	rs114024103	G	T	3	3	6	0	0	6	0	0
1	100547994	rs5876	T	C	154	150	304	0	2	306	0	0
1	100575933	rs13375867	G	A	12	7	19	0	0	19	0	0
1	100612675	rs499479	A	G	4	7	11	0	0	11	0	0
1	100818178	rs529224	G	C	4	4	8	0	0	8	0	0
1	100885419	rs7517704	A	G	6	3	9	0	0	9	0	0
1	100887616	rs479269	A	G	9	9	18	0	1	19	0	0
1	100889098	.	A	G	10	8	18	0	0	18	0	0
1	100965287	rs115422169	G	A	4	5	9	0	0	9	0	0
1	100965942	rs12042531	G	A	2	7	9	0	0	9	0	0
1	101407139	rs61780317	T	C	3	3	6	0	0	6	0	0
1	101408933	rs3850453	T	C	4	11	15	0	0	15	0	0
1	101441775	rs3087816	T	C	4	4	8	0	0	8	0	0
1	101442367	rs17449022	T	G	10	8	18	0	0	18	0	0
1	101443431	rs41312670	C	T	20	16	36	0	1	37	0	0
1	101443582	rs41312668	C	T	14	19	33	0	0	33	0	0
1	101443701	rs17100939	A	G	16	21	37	0	0	37	0	0
1	101540999	rs17450029	T	C	4	3	7	0	0	7	0	0
1	101704532	rs3737577	G	T	47	40	87	0	0	87	0	0
1	101706246	rs114115083	T	C	31	41	72	0	1	73	0	0
1	104116413	rs17851840	T	C	50	22	72	0	0	72	0	0
1	107599918	rs2232016	C	T	5	2	7	0	0	7	0	0
1	108121323	rs1410404	C	A	13	30	43	0	0	43	0	0
1	108149229	rs943755	C	T	8	10	18	0	0	18	0	0
1	108149646	rs7514117	G	A	6	9	15	0	0	15	0	0
1	108185301	rs12403266	C	G	96	53	149	0	0	149	0	0
1	108185309	rs12410676	G	A	96	52	148	0	1	149	0	0
1	108210799	rs7538840	T	C	5	3	8	0	0	8	0	0
1	108212849	rs2504452	T	G	5	1	6	0	0	6	0	0
1	108212860	rs2494047	T	C	5	1	6	0	0	6	0	0
1	108232390	rs7527291	A	G	12	7	19	0	0	19	0	0
1	108251323	rs12403629	C	T	4	3	7	0	0	7	0	0
1	108259067	rs61471569	C	G	5	2	7	0	0	7	0	0
1	108259775	rs6662886	A	G	5	3	8	0	0	8	0	0
1	108260014	rs55759434	T	C	4	5	9	0	0	9	0	0
1	108267215	rs17019798	G	A	6	6	12	0	0	12	0	0
1	108267322	rs2494045	C	G	5	7	12	0	0	12	0	0
1	108267620	rs72705627	T	A	2	8	10	0	0	10	0	0
1	108267732	rs17019802	A	G	2	4	6	0	0	6	0	0
1	108272595	rs12403627	A	T	2	7	9	0	0	9	0	0
1	108296508	rs4531312	T	G	1	8	9	0	0	9	0	0
1	108313258	rs6583048	C	T	36	20	56	0	1	57	0	0
1	108677973	rs12065664	A	C	4	3	7	0	0	7	0	0
1	108678361	rs575371	T	C	24	17	41	0	0	41	0	0
1	108679151	rs17021096	A	G	24	11	35	0	0	35	0	0
1	109167966	rs76417197	A	G	4	3	7	0	0	7	0	0
1	109193733	rs144705350	T	G	46	53	99	0	0	99	0	0
1	109235177	.	C	A	46	38	84	0	1	85	0	0
1	109242392	rs34748332	A	G	200	209	409	0	9	418	0	0
1	109289353	rs1124427	C	G	34	15	49	0	0	49	0	0
1	109289487	rs6604120	C	T	6	0	6	0	0	6	0	0
1	109319928	rs1759480	A	G	6	1	7	0	0	7	0	0
1	109321824	rs1759481	G	T	7	1	8	0	0	8	0	0
1	109324584	rs1296615	T	C	1	5	6	0	0	6	0	0
1	109324591	rs12726859	C	T	1	5	6	0	0	6	0	0
1	109325028	rs1277051	T	C	8	5	13	0	0	13	0	0
1	109327862	rs1690728	G	A	5	1	6	0	0	6	0	0
1	109346151	rs1277035	T	C	3	3	6	0	0	6	0	0
1	109346166	rs1277036	A	G	4	3	7	0	0	7	0	0
1	109346597	rs1277038	A	G	5	1	6	0	0	6	0	0
1	109349019	rs1149155	T	C	6	2	8	0	0	8	0	0
1	109349613	rs1303465	T	C	9	4	13	0	0	13	0	0
1	109351501	rs1149154	A	G	77	74	151	0	0	151	0	0
1	109446750	rs61754640	G	A	20	13	33	0	0	33	0	0
1	109481313	.	C	T	4	4	8	0	0	8	0	0
1	109606364	rs28663119	T	G	29	38	67	0	2	69	0	0
1	109637229	rs551001	C	G	142	144	286	0	1	287	0	0
1	109639190	rs6765	G	T	246	286	532	0	5	537	0	0
1	110091447	rs2230350	G	A	87	109	196	0	10	206	0	0
1	110167128	rs186458929	C	T	15	13	28	0	0	28	0	0
1	110167129	rs142083647	C	T	15	13	28	0	0	28	0	0
1	110212293	rs3819350	C	A	121	100	221	0	4	225	0	0
1	110212534	rs687643	T	C	108	67	175	0	1	176	0	0
1	110212916	rs1149177	G	A	76	52	128	0	0	128	0	0
1	110213000	rs1149178	T	A	90	57	147	0	2	149	0	0
1	110455305	rs333952	G	A	5	5	10	0	0	10	0	0
1	110455433	rs915357	A	G	3	7	10	0	0	10	0	0
1	110459773	rs333967	C	T	6	3	9	0	1	10	0	0
1	110469411	rs333974	A	G	13	7	20	0	0	20	0	0
1	110470184	rs3093041	C	T	11	22	33	0	1	34	0	0
1	110470424	rs3093040	G	A	7	23	30	0	0	30	0	0
1	110470592	rs333948	G	A	33	7	40	0	0	40	0	0
1	110472956	rs2050462	T	G	206	114	320	0	11	331	0	0
1	110530995	rs3768480	G	C	3	4	7	0	0	7	0	0
1	110581780	rs1834	T	G	2	4	6	0	0	6	0	0
1	110585137	rs6537651	A	G	5	5	10	0	0	10	0	0
1	110587956	rs7545139	G	A	2	4	6	0	0	6	0	0
1	110589579	rs1965990	G	A	5	6	11	0	0	11	0	0
1	110590816	rs12042401	C	T	4	7	11	0	1	12	0	0
1	110593204	rs530483460	G	T	5	2	7	0	0	7	0	0
1	110601797	rs10857810	C	G	4	2	6	0	0	6	0	0
1	110880945	rs15651	G	C	7	18	25	0	0	25	0	0
1	110908672	rs113300388	A	T	6	1	7	0	0	7	0	0
1	110949810	rs35836705	A	C	93	138	231	0	0	231	0	0
1	111199205	rs2797520	T	C	4	6	10	0	1	11	0	0
1	111215472	rs1058184	A	C	5	4	9	0	0	9	0	0
1	111427656	rs11102172	A	C	5	1	6	0	0	6	0	0
1	111430297	rs12117546	T	C	6	1	7	0	0	7	0	0
1	111432792	rs6687308	A	C	8	3	11	0	0	11	0	0
1	111432845	rs6674671	C	G	9	2	11	0	0	11	0	0
1	111433622	rs4839583	C	T	5	3	8	0	0	8	0	0
1	111434351	rs2070747	G	A	13	5	18	0	0	18	0	0
1	111434711	rs2070748	C	T	24	17	41	0	1	42	0	0
1	111435335	rs3790722	C	T	19	5	24	0	0	24	0	0
1	111435816	rs12119975	G	T	17	7	24	0	0	24	0	0
1	111436360	rs12405367	C	T	36	15	51	0	2	53	0	0
1	111436857	rs1578956	T	G	32	8	40	0	0	40	0	0
1	111436858	rs1936943	C	T	30	8	38	0	0	38	0	0
1	111437129	rs1343817	A	C	41	16	57	0	1	58	0	0
1	111437421	rs2070749	C	A	50	18	68	0	0	68	0	0
1	111438416	rs12743284	T	C	9	10	19	0	0	19	0	0
1	111439527	rs2070750	A	G	56	21	77	0	2	79	0	0
1	111439902	rs4839586	C	T	79	30	109	0	1	110	0	0
1	111440873	rs2070751	C	T	56	23	79	0	0	79	0	0
1	111441485	rs11102175	A	G	133	54	187	0	1	188	0	0
1	111441829	rs1803259	C	T	519	141	660	0	3	663	0	0
1	111489901	rs1046260	A	C	8	3	11	0	0	11	0	0
1	111667745	rs629437	A	G	4	5	9	0	0	9	0	0
1	111686497	rs325925	A	C	5	2	7	0	0	7	0	0
1	111709112	rs2490334	A	G	4	3	7	0	0	7	0	0
1	111726869	rs3795823	G	A	52	41	93	0	0	93	0	0
1	111731158	rs2297703	A	G	4	6	10	0	0	10	0	0
1	111960826	rs17528242	G	A	8	5	13	0	0	13	0	0
1	111970045	rs149678505	G	A	20	6	26	0	0	26	0	0
1	112026198	rs9025	T	A	3	3	6	0	1	7	0	0
1	112211777	rs569504	A	G	7	7	14	0	0	14	0	0
1	112247965	rs519412	G	T	3	6	9	0	1	10	0	0
1	112249883	rs579008	C	T	5	6	11	0	0	11	0	0
1	112254674	rs543081	C	T	4	2	6	0	0	6	0	0
1	112258545	rs552802	G	T	4	4	8	0	0	8	0	0
1	112266300	rs197426	A	G	2	7	9	0	0	9	0	0
1	112266366	rs197427	T	C	6	7	13	0	0	13	0	0
1	112267354	rs11800513	C	T	3	7	10	0	0	10	0	0
1	112268284	rs11102327	G	A	3	9	12	0	0	12	0	0
1	112268480	rs197432	A	G	3	4	7	0	0	7	0	0
1	112269510	rs74400511	C	T	13	5	18	0	0	18	0	0
1	112269872	rs197434	G	A	10	15	25	0	1	26	0	0
1	112298829	rs197393	T	C	18	11	29	0	2	31	0	0
1	112308953	rs197412	T	C	87	76	163	0	1	164	0	0
1	112308972	rs197413	G	A	72	65	137	0	2	139	0	0
1	113068577	rs35147679	C	T	15	11	26	0	0	26	0	0
1	113083439	rs10745330	C	T	20	3	23	0	0	23	0	0
1	113154364	rs9308256	C	T	5	4	9	0	0	9	0	0
1	113154400	rs7546094	C	T	2	4	6	0	0	6	0	0
1	113160170	rs11102513	C	T	6	5	11	0	0	11	0	0
1	113160343	.	A	T	7	3	10	0	0	10	0	0
1	113160419	rs11102514	C	T	6	4	10	0	0	10	0	0
1	113161350	rs11102516	G	A	5	5	10	0	0	10	0	0
1	113195789	rs3013440	G	A	85	67	152	0	3	155	0	0
1	113200671	rs3013439	T	G	6	6	12	0	0	12	0	0
1	113202417	rs2932536	G	A	4	2	6	0	0	6	0	0
1	113205367	rs12025785	C	T	2	6	8	0	0	8	0	0
1	113207243	rs12756815	C	A	10	4	14	0	0	14	0	0
1	113207531	rs12046329	T	C	6	8	14	0	0	14	0	0
1	113208039	rs12046466	T	C	7	3	10	0	0	10	0	0
1	113231286	rs12126971	T	C	21	16	37	0	1	38	0	0
1	113231503	rs12129649	G	T	18	16	34	0	0	34	0	0
1	113236087	rs902289	C	T	5	7	12	0	0	12	0	0
1	113236230	rs2009056	G	A	3	6	9	0	0	9	0	0
1	113236421	rs1110043	G	A	6	3	9	0	0	9	0	0
1	113236534	rs1110042	A	T	1	6	7	0	0	7	0	0
1	113236681	rs3748656	C	T	30	37	67	0	0	67	0	0
1	113237171	rs883593	A	G	36	41	77	0	2	79	0	0
1	113239382	rs17030651	G	A	44	46	90	0	2	92	0	0
1	113241052	rs2306940	T	C	85	65	150	0	0	150	0	0
1	113242122	rs1106287	T	G	82	55	137	0	1	138	0	0
1	113242488	rs3013431	C	T	15	20	35	0	0	35	0	0
1	113243048	rs6679	C	T	270	210	480	0	2	482	0	0
1	113246506	rs2306937	C	T	7	9	16	0	0	16	0	0
1	113247127	rs2999156	G	C	6	4	10	0	0	10	0	0
1	113248365	rs954679	A	G	5	7	12	0	0	12	0	0
1	114242122	rs3752954	T	C	6	4	10	0	0	10	0	0
1	114242250	rs3752953	C	T	5	5	10	0	0	10	0	0
1	114255975	rs61730007	G	T	136	121	257	0	1	258	0	0
1	114256139	rs3789597	C	T	33	24	57	0	0	57	0	0
1	114261479	rs115584284	A	G	30	21	51	0	1	52	0	0
1	114261576	rs12734625	C	A	22	12	34	0	0	34	0	0
1	114304521	rs74764444	A	G	3	8	11	0	0	11	0	0
1	114389748	rs12760457	C	T	12	7	19	0	1	20	0	0
1	114396280	rs1217408	T	C	2	4	6	0	1	7	0	0
1	114397799	rs3789609	C	T	6	8	14	0	1	15	0	0
1	114438951	rs1217401	A	G	64	81	145	0	0	145	0	0
1	114439522	rs1310183	T	C	12	8	20	0	1	21	0	0
1	114447565	rs1217397	G	A	12	9	21	0	0	21	0	0
1	114512939	rs3811018	A	T	7	8	15	0	0	15	0	0
1	114513488	rs7522987	G	T	10	8	18	0	0	18	0	0
1	114515717	rs2358996	G	A	105	121	226	0	6	232	0	0
1	114519351	rs10732635	T	G	212	190	402	0	1	403	0	0
1	114943348	rs72693901	G	T	8	6	14	0	0	14	0	0
1	115110683	rs8128	A	C	304	288	592	0	1	593	0	0
1	115115971	rs12138665	T	C	5	5	10	0	0	10	0	0
1	115116434	rs3789624	A	G	6	7	13	0	0	13	0	0
1	115124203	rs62621917	T	C	79	79	158	0	1	159	0	0
1	115263685	rs10489525	G	A	12	4	16	0	0	16	0	0
1	115263791	rs6692870	C	T	11	4	15	0	0	15	0	0
1	115266306	rs2007231	C	T	4	5	9	0	0	9	0	0
1	115271871	rs1985867	T	C	5	4	9	0	1	10	0	0
1	115272254	rs6663115	G	A	5	6	11	0	0	11	0	0
1	115286359	.	T	A	2	8	10	0	0	10	0	0
1	115291978	rs4140445	T	C	3	4	7	0	0	7	0	0
1	115458208	rs360575	C	A	6	0	6	0	0	6	0	0
1	115591053	rs7553371	T	G	9	7	16	0	0	16	0	0
1	115591058	rs1052480	T	C	7	9	16	0	0	16	0	0
1	115591163	rs7551034	A	G	5	6	11	0	0	11	0	0
1	115592145	rs41274142	T	C	14	20	34	0	0	34	0	0
1	115592820	rs3738706	T	C	10	14	24	0	0	24	0	0
1	115617406	rs1286364	A	G	6	8	14	0	0	14	0	0
1	116206423	rs4839469	G	A	11	7	18	0	0	18	0	0
1	116534852	rs4046190	C	T	8	7	15	0	0	15	0	0
1	116549896	rs2488452	T	C	4	2	6	0	0	6	0	0
1	116550086	rs2488453	A	G	5	3	8	0	0	8	0	0
1	116569530	rs2488429	G	C	6	2	8	0	0	8	0	0
1	116576458	rs75119142	C	T	9	6	15	0	0	15	0	0
1	116605423	rs3748743	C	T	6	3	9	0	0	9	0	0
1	116608903	rs1281745	G	A	4	2	6	0	0	6	0	0
1	116610227	rs1281744	G	A	15	13	28	0	0	28	0	0
1	116611705	rs1045757	T	C	76	58	134	0	0	134	0	0
1	117058389	rs871493	G	C	8	4	12	0	0	12	0	0
1	117617705	rs998532	A	G	79	55	134	0	1	135	0	0
1	117618067	rs1289673	C	T	94	92	186	0	7	193	0	0
1	117625394	rs2997330	T	C	4	4	8	0	0	8	0	0
1	117656088	rs1289658	A	G	7	10	17	0	0	17	0	0
1	117659352	rs3738413	C	T	9	8	17	0	0	17	0	0
1	117660754	rs749902	C	T	11	8	19	0	0	19	0	0
1	117663913	rs3795655	C	T	8	4	12	0	0	12	0	0
1	118165691	rs1630312	C	T	38	40	78	0	1	80	1	0
1	118165973	rs1627787	C	T	60	64	124	0	0	124	0	0
1	118166096	rs2884587	C	T	79	86	165	0	0	165	0	0
1	118166750	rs2066411	A	G	81	82	163	0	3	166	0	0
1	118166877	rs10923360	C	T	83	90	173	0	3	176	0	0
1	118167199	rs826403	A	G	131	138	269	0	1	270	0	0
1	118168234	rs11580608	C	T	28	22	50	0	1	51	0	0
1	118168826	rs11581122	C	T	27	18	45	0	0	45	0	0
1	118169463	rs2282456	G	A	31	28	59	0	1	60	0	0
1	118482149	rs34973445	C	T	8	8	16	0	0	16	0	0
1	119573860	rs12086	T	C	3	4	7	0	0	7	0	0
1	119574289	rs12030972	G	A	0	6	6	0	0	6	0	0
1	119683390	rs12096448	G	A	10	1	11	0	0	11	0	0
1	119704320	rs6693584	A	T	7	4	11	0	0	11	0	0
1	120285546	rs543703	G	A	113	101	214	0	2	216	0	0
1	120536913	.	G	C	0	6	6	0	0	6	0	0
1	120548095	rs143195893	C	A	6	11	17	0	0	17	0	0
1	120572547	.	T	C	14	1	15	0	0	15	0	0
1	120572572	.	C	T	18	3	21	0	0	21	0	0
1	120594223	.	T	C	47	8	55	0	0	55	0	0
1	120596847	.	C	T	8	1	9	0	0	9	0	0
1	120611964	.	G	C	9	2	11	0	1	12	0	0
1	120693474	.	C	T	125	0	125	0	2	127	0	0
1	120694071	rs61789909	T	C	22	0	22	0	0	22	0	0
1	120695362	.	A	G	0	9	9	0	0	9	0	0
1	120695827	.	A	C	0	23	23	0	0	23	0	0
1	120695831	.	A	C	0	22	22	0	0	22	0	0
1	120695845	.	A	C	21	0	21	0	1	22	0	0
1	120695867	.	T	C	22	0	22	0	0	22	0	0
1	120695911	.	T	C	20	0	20	0	0	20	0	0
1	120927008	.	T	C	7	0	7	0	0	7	0	0
1	120927081	.	C	T	7	7	14	0	0	14	0	0
1	121115958	rs2289361	T	C	6	1	7	0	0	7	0	0
1	121121451	.	A	G	9	2	11	0	0	11	0	0
1	121124362	.	C	G	4	5	9	0	0	9	0	0
1	121132722	rs1137590	T	A	10	2	12	0	0	12	0	0
1	121132825	.	T	C	10	4	14	0	0	14	0	0
1	121132854	.	G	A	4	3	7	0	0	7	0	0
1	121133066	.	A	G	6	3	9	0	0	9	0	0
1	121133376	.	A	T	16	1	17	0	0	17	0	0
1	121133392	.	T	C	16	2	18	0	0	18	0	0
1	121133574	.	T	C	9	3	12	0	0	12	0	0
1	121133733	.	G	A	23	7	30	0	0	30	0	0
1	121133779	.	C	G	23	5	28	0	0	28	0	0
1	121134049	.	T	C	32	0	32	0	1	33	0	0
1	143190096	.	A	G	10	0	10	0	0	10	0	0
1	143743625	.	C	A	22	1	23	0	2	25	0	0
1	143743783	.	G	C	9	2	11	0	0	11	0	0
1	143744160	.	G	A	78	92	170	0	1	171	0	0
1	143744356	.	C	G	5	14	19	0	1	20	0	0
1	143744411	.	G	C	24	3	27	0	0	27	0	0
1	143744508	.	G	T	8	22	30	0	0	30	0	0
1	143744513	.	C	T	6	21	27	0	0	27	0	0
1	143745242	.	C	T	5	3	8	0	0	8	0	0
1	143984919	.	G	A	2	6	8	0	0	8	0	0
1	143985102	rs715466	T	C	3	10	13	0	3	16	0	0
1	144014068	.	T	C	15	44	59	0	0	59	0	0
1	144014253	.	A	T	1	5	6	0	0	6	0	0
1	144014672	.	T	C	5	1	6	0	0	6	0	0
1	144015141	rs56064064	C	G	6	4	10	0	0	10	0	0
1	144015174	rs6688767	G	A	5	4	9	0	0	9	0	0
1	144015180	.	T	C	5	4	9	0	0	9	0	0
1	144015222	.	G	A	5	4	9	0	0	9	0	0
1	144015565	.	G	T	2	13	15	0	0	15	0	0
1	144015730	.	T	A	4	9	13	0	0	13	0	0
1	144015863	rs1476380	A	G	3	16	19	0	0	19	0	0
1	144015980	.	A	G	1	21	22	0	0	22	0	0
1	144016042	.	T	C	2	27	29	0	0	29	0	0
1	144016222	.	T	A	13	10	23	0	0	23	0	0
1	144016245	.	A	G	10	8	18	0	0	18	0	0
1	144016280	.	T	G	5	5	10	0	0	10	0	0
1	144481235	.	A	G	69	23	92	0	2	94	0	0
1	144481334	.	G	A	29	8	37	0	0	37	0	0
1	144593886	rs71527377	G	A	12	1	13	0	0	13	0	0
1	144593903	rs187246257	C	A	12	1	13	0	1	14	0	0
1	144596438	.	T	C	11	0	11	0	0	11	0	0
1	144598641	.	C	T	26	1	27	0	0	27	0	0
1	144598659	.	C	T	31	1	32	0	1	33	0	0
1	144598755	rs2660554;rs75487090	G	A	40	5	45	0	0	45	0	0
1	144612613	rs3009751	A	G	4	3	7	0	0	7	0	0
1	144614931	.	G	A	52	1	53	0	1	54	0	0
1	144615080	rs3896864	A	G	29	0	29	0	0	29	0	0
1	144619903	.	T	A	56	0	56	0	0	56	0	0
1	144620009	rs879994305	T	C	17	0	17	0	0	17	0	0
1	144620091	rs61810898	C	T	17	1	18	0	0	18	0	0
1	144828764	.	G	T	10	45	55	0	1	56	0	0
1	144828765	rs1043478	A	T	10	45	55	0	0	56	1	0
1	144828784	.	A	G	10	66	76	0	0	76	0	0
1	144828845	.	A	T	71	7	78	0	1	79	0	0
1	144828857	.	C	G	71	4	75	0	1	76	0	0
1	144828910	.	A	T	5	34	39	0	0	39	0	0
1	144830021	.	C	T	22	2	24	0	0	24	0	0
1	144830160	rs61807992	C	G	42	2	44	0	0	44	0	0
1	144830164	.	T	A	2	41	43	0	0	43	0	0
1	144851506	.	C	G	13	1	14	0	0	14	0	0
1	144851537	rs10943	A	G	14	5	19	0	0	19	0	0
1	144851848	.	G	A	13	8	21	0	0	21	0	0
1	144851903	.	G	A	16	8	24	0	0	24	0	0
1	144851999	.	A	C	10	9	19	0	0	19	0	0
1	144852080	.	T	C	9	3	12	0	0	12	0	0
1	144852167	.	G	T	5	1	6	0	0	6	0	0
1	144852249	.	C	T	4	2	6	0	0	6	0	0
1	144852321	.	C	A	6	5	11	0	0	11	0	0
1	144852390	.	C	T	6	5	11	0	1	12	0	0
1	144852476	rs1616066	T	C	9	6	15	0	0	15	0	0
1	144854180	.	T	C	10	0	10	0	0	10	0	0
1	144854537	.	T	C	6	3	9	0	0	9	0	0
1	144854597	rs3851873	T	C	7	4	11	0	0	11	0	0
1	144854598	.	C	T	7	4	11	0	0	11	0	0
1	144855812	.	T	C	7	2	9	0	0	9	0	0
1	144855866	.	A	G	6	2	8	0	0	8	0	0
1	144864277	.	G	A	10	3	13	0	0	13	0	0
1	144865850	.	G	T	4	3	7	0	0	7	0	0
1	144866643	.	G	A	5	4	9	0	0	9	0	0
1	144866662	.	T	C	4	3	7	0	0	7	0	0
1	144868170	.	C	T	4	3	7	0	0	7	0	0
1	144873887	.	C	T	4	2	6	0	0	6	0	0
1	144879375	.	T	C	5	1	6	0	0	6	0	0
1	144890833	.	T	C	18	3	21	0	0	21	0	0
1	144891582	.	G	T	9	2	11	0	0	11	0	0
1	144891803	.	G	A	5	5	10	0	0	10	0	0
1	144892089	.	G	T	5	1	6	0	0	6	0	0
1	144892149	.	G	A	6	3	9	0	0	9	0	0
1	144909956	.	G	A	1	16	17	0	0	17	0	0
1	144912233	.	C	T	17	4	21	0	0	21	0	0
1	144915561	.	G	A	16	2	18	0	0	18	0	0
1	144915624	rs1778112	G	A	17	1	18	0	0	18	0	0
1	144916748	.	C	G	16	1	17	0	0	17	0	0
1	144917546	.	A	G	10	2	12	0	0	12	0	0
1	144917841	.	T	C	6	3	9	0	0	9	0	0
1	144918957	.	T	A	13	2	15	0	0	15	0	0
1	144922583	.	G	A	8	3	11	0	1	12	0	0
1	144925977	.	G	A	7	1	8	0	0	8	0	0
1	144930596	.	C	A	5	5	10	0	0	10	0	0
1	144931330	.	C	T	5	3	8	0	0	8	0	0
1	144931392	.	G	A	6	3	9	0	0	9	0	0
1	144952220	.	C	T	13	1	14	0	0	14	0	0
1	145004953	.	T	C	0	21	21	0	0	21	0	0
1	145014718	rs1611951	A	G	9	2	11	0	1	12	0	0
1	145014965	rs2442648	C	G	12	0	12	0	0	12	0	0
1	145015224	.	T	G	7	4	11	0	0	11	0	0
1	145015442	.	C	A	6	3	9	0	0	9	0	0
1	145016479	.	T	C	4	7	11	0	0	11	0	0
1	145017347	rs2252126	G	A	5	3	8	0	0	8	0	0
1	145018023	.	G	T	9	2	11	0	0	11	0	0
1	145018480	.	A	G	3	4	7	0	0	7	0	0
1	145018581	.	G	C	7	1	8	0	0	8	0	0
1	145018788	.	T	C	5	3	8	0	1	9	0	0
1	145027760	.	T	C	0	7	7	0	0	7	0	0
1	145029033	.	T	C	5	1	6	0	0	6	0	0
1	145031942	rs201982897	T	G	6	0	6	0	0	6	0	0
1	145031951	rs199586085	T	G	6	0	6	0	0	6	0	0
1	145032069	rs1778674	T	C	12	0	12	0	0	12	0	0
1	145034263	.	C	A	6	0	6	0	0	6	0	0
1	145035210	.	C	T	5	2	7	0	0	7	0	0
1	145036274	.	A	T	11	0	11	0	0	11	0	0
1	145036346	.	G	T	22	2	24	0	0	24	0	0
1	145036572	.	T	C	12	0	12	0	0	12	0	0
1	145036603	rs2266043	C	T	15	0	15	0	0	15	0	0
1	145036672	.	G	C	13	0	13	0	0	13	0	0
1	145036956	.	T	C	19	1	20	0	0	20	0	0
1	145037041	.	G	C	9	0	9	0	0	9	0	0
1	145037660	.	C	A	15	0	15	0	0	15	0	0
1	145037735	.	C	T	14	1	15	0	0	15	0	0
1	145037757	.	T	G	13	1	14	0	0	14	0	0
1	145037766	rs2442662	C	T	13	1	14	0	0	14	0	0
1	145037893	.	A	G	15	0	15	0	1	16	0	0
1	145037903	.	G	A	16	0	16	0	1	17	0	0
1	145037984	rs2489136	T	G	17	1	18	0	0	18	0	0
1	145038132	.	G	T	26	0	26	0	0	26	0	0
1	145038736	.	C	G	23	3	26	0	1	27	0	0
1	145038952	rs1663881	C	T	25	2	27	0	0	27	0	0
1	145039562	.	C	T	8	0	8	0	0	8	0	0
1	145039866	.	A	G	45	10	55	0	0	55	0	0
1	145039922	.	G	C	9	14	23	0	0	23	0	0
1	145101750	.	G	A	0	11	11	0	0	11	0	0
1	145101767	.	A	G	0	10	10	0	0	10	0	0
1	145103947	.	T	C	0	30	30	0	0	30	0	0
1	145109583	.	C	A	1	26	27	0	1	28	0	0
1	145109809	.	T	A	0	8	8	0	0	8	0	0
1	145110213	.	G	A	0	6	6	0	0	6	0	0
1	145110367	.	C	A	0	16	16	0	0	16	0	0
1	145110574	.	G	T	0	11	11	0	0	11	0	0
1	145111366	.	T	A	20	0	20	0	0	20	0	0
1	145111485	.	A	G	0	19	19	0	0	19	0	0
1	145111545	.	C	T	0	18	18	0	0	18	0	0
1	145111839	.	T	C	0	13	13	0	0	13	0	0
1	145112914	.	A	G	0	7	7	0	0	7	0	0
1	145113144	.	A	T	0	7	7	0	0	7	0	0
1	145114475	rs4269725	A	G	12	0	12	0	0	12	0	0
1	145114487	rs4396070	C	T	14	0	14	0	0	14	0	0
1	145114779	.	G	A	0	7	7	0	0	7	0	0
1	145115810	.	A	G	0	45	45	0	0	45	0	0
1	145116798	.	G	A	0	43	43	0	0	43	0	0
1	145116920	.	T	C	14	0	14	0	0	14	0	0
1	145209366	.	A	G	56	8	64	0	0	64	0	0
1	145230356	.	A	C	29	0	29	0	9	38	0	0
1	145230367	.	A	C	20	0	20	0	12	32	0	0
1	145230372	.	A	G	20	0	20	0	11	31	0	0
1	145247692	.	T	G	6	0	6	0	0	6	0	0
1	145248601	.	G	C	6	0	6	0	0	6	0	0
1	145273520	.	G	A	6	1	7	0	0	7	0	0
1	145281543	.	C	T	199	105	304	0	0	304	0	0
1	145284432	.	G	A	5	3	8	0	0	8	0	0
1	145285826	.	A	G	2	6	8	0	0	8	0	0
1	145288896	.	T	C	6	8	14	0	0	14	0	0
1	145288967	.	G	A	11	11	22	0	1	23	0	0
1	145289096	.	T	C	13	12	25	0	0	25	0	0
1	145289753	.	C	T	15	3	18	0	0	18	0	0
1	145289804	.	T	G	13	7	20	0	0	20	0	0
1	145290083	.	T	C	9	5	14	0	1	15	0	0
1	145290346	.	A	G	4	3	7	0	0	7	0	0
1	145292442	.	G	T	8	5	13	0	0	13	0	0
1	145292721	.	G	A	12	1	13	0	0	13	0	0
1	145296372	.	A	G	4	2	6	0	0	6	0	0
1	145296478	.	G	T	10	3	13	0	0	13	0	0
1	145298186	.	C	G	16	1	17	0	0	17	0	0
1	145301793	.	A	G	8	2	10	0	0	10	0	0
1	145301802	.	C	G	8	2	10	0	0	10	0	0
1	145366857	.	G	T	24	2	26	0	0	26	0	0
1	145369322	.	A	T	29	26	55	0	0	55	0	0
1	145369339	rs199531492	A	G	29	22	51	0	0	51	0	0
1	145369340	rs199803686	A	T	30	22	52	0	0	52	0	0
1	145369354	.	C	T	31	23	54	0	0	54	0	0
1	145369589	.	T	C	20	31	51	0	0	51	0	0
1	145500801	.	G	A	11	12	23	0	0	23	0	0
1	145586048	rs17352344	T	C	62	58	120	0	2	122	0	0
1	145588184	rs2004659	T	C	4	9	13	0	0	13	0	0
1	145588536	rs9286836	C	T	9	13	22	0	0	22	0	0
1	145597417	rs9728345	C	A	12	5	17	0	1	18	0	0
1	145597943	rs12143555	T	G	5	9	14	0	0	14	0	0
1	145688893	rs12119151	G	A	13	12	25	0	1	26	0	0
1	145690999	rs10910842	G	C	10	8	18	0	0	18	0	0
1	145691112	rs10910843	A	G	8	12	20	0	0	20	0	0
1	145691919	rs66475980	C	T	19	13	32	0	0	32	0	0
1	145691986	.	A	G	23	12	35	0	0	35	0	0
1	145692139	rs111231329	G	A	14	19	33	0	0	33	0	0
1	146057292	rs57784339	T	C	7	0	7	0	0	7	0	0
1	146215189	.	G	C	10	61	71	0	2	73	0	0
1	146217182	.	C	G	5	4	9	0	1	10	0	0
1	146400820	.	T	A	9	0	9	0	0	9	0	0
1	146409969	rs587721117	A	C	5	9	14	0	0	14	0	0
1	146410018	.	C	T	6	9	15	0	0	15	0	0
1	146465636	.	C	G	6	0	6	0	0	6	0	0
1	146466146	rs880002535	G	T	33	36	69	0	1	70	0	0
1	146466322	rs1284539	A	G	115	17	132	0	0	132	0	0
1	146466641	.	G	A	7	10	17	0	0	17	0	0
1	146491003	rs78615071	T	C	7	0	7	0	0	7	0	0
1	146494511	rs11587748	G	A	6	0	6	0	0	6	0	0
1	146646107	rs72708513	T	C	7	13	20	0	0	20	0	0
1	146649186	rs75262949	G	A	8	3	11	0	0	11	0	0
1	146731813	rs41295829	C	T	11	12	23	0	0	23	0	0
1	146746409	.	C	T	47	52	99	0	2	101	0	0
1	147091972	rs3820129	C	T	9	15	24	0	0	24	0	0
1	147131553	rs143920833	T	C	6	8	14	0	0	14	0	0
1	148003856	.	G	A	38	54	92	0	1	93	0	0
1	148004422	.	T	A	26	8	34	0	0	34	0	0
1	148004567	rs79517418	C	A	49	27	76	0	0	76	0	0
1	148004568	rs78765201	C	A	48	27	75	0	1	76	0	0
1	148004584	.	G	A	43	26	69	0	0	69	0	0
1	148004625	.	C	A	29	33	62	0	2	65	1	0
1	148005064	.	C	A	6	0	6	0	0	6	0	0
1	148009510	rs1127394	G	A	44	15	59	0	0	59	0	0
1	148010911	.	G	A	27	2	29	0	1	30	0	0
1	148023124	.	T	G	26	0	26	0	0	26	0	0
1	148558220	.	G	A	6	4	10	0	0	10	0	0
1	149576741	.	C	T	6	14	20	0	1	21	0	0
1	149576745	.	C	T	5	12	17	0	1	18	0	0
1	149576754	.	T	C	4	12	16	0	2	18	0	0
1	149576904	.	C	A	0	8	8	0	1	9	0	0
1	149605981	.	G	A	19	40	59	0	2	61	0	0
1	149605986	.	A	G	20	42	62	0	0	62	0	0
1	149606032	rs3863673	T	C	24	53	77	0	0	77	0	0
1	149606033	rs879967705	G	C	23	53	76	0	1	77	0	0
1	149606043	.	T	C	22	57	79	0	1	80	0	0
1	149606094	.	T	C	19	41	60	0	0	60	0	0
1	149606129	.	C	T	14	18	32	0	0	32	0	0
1	149614738	.	C	T	5	1	6	0	0	6	0	0
1	149614750	.	C	A	5	1	6	0	0	6	0	0
1	149614761	.	T	C	6	1	7	0	0	7	0	0
1	149614771	.	C	T	6	1	7	0	0	7	0	0
1	149859151	.	C	A	12	10	22	0	0	22	0	0
1	149875620	rs149443420	G	A	119	124	243	0	1	244	0	0
1	149876124	rs7534365	T	C	70	58	128	0	1	129	0	0
1	149889339	rs12131104	C	T	18	14	32	0	2	34	0	0
1	150123762	rs72694954	G	T	4	8	12	0	0	12	0	0
1	150124615	rs58426216	T	C	20	16	36	0	1	37	0	0
1	150127104	rs6693817	A	T	16	19	35	0	0	35	0	0
1	150128425	rs1545762	C	T	5	4	9	0	0	9	0	0
1	150129335	rs3208509	G	A	11	15	26	0	0	26	0	0
1	150129998	rs56349882	T	C	6	9	15	0	1	16	0	0
1	150130081	rs59607464	C	T	10	6	16	0	0	16	0	0
1	150130835	rs10888573	G	A	3	14	17	0	0	17	0	0
1	150130983	rs34773647	G	T	24	6	30	0	0	30	0	0
1	150132324	rs1382573	G	A	12	26	38	0	0	38	0	0
1	150132430	rs1824850	A	G	10	6	16	0	0	16	0	0
1	150132627	rs1824849	T	C	12	14	26	0	0	26	0	0
1	150135164	.	C	T	2	4	6	0	0	6	0	0
1	150526270	rs41317517	C	T	48	22	70	0	2	72	0	0
1	150526406	rs6681639	C	T	19	33	52	0	1	53	0	0
1	150530274	rs375427068	C	A	6	6	12	0	0	12	0	0
1	150549849	rs148874038	G	A	729	615	1344	0	8	1352	0	0
1	150582438	rs1355637	C	T	18	9	27	0	0	27	0	0
1	150584103	rs4970966	G	T	7	6	13	0	0	13	0	0
1	150584837	.	T	C	2	5	7	0	0	7	0	0
1	150587388	rs56661631	C	T	5	4	9	0	0	9	0	0
1	150737220	rs41271951	A	G	122	108	230	0	0	230	0	0
1	150782797	rs10847	C	T	27	32	59	0	0	59	0	0
1	150902941	rs11204744	A	G	4	10	14	0	0	14	0	0
1	150932696	rs12143614	T	A	20	22	42	0	0	42	0	0
1	150940625	rs267738	T	G	68	23	91	0	0	91	0	0
1	150966197	rs539118	G	A	3	5	8	0	0	8	0	0
1	150969592	rs75172050	C	T	10	12	22	0	1	23	0	0
1	150969992	rs2925740	T	C	5	5	10	0	0	10	0	0
1	151028929	rs2864700	C	T	3	4	7	0	0	7	0	0
1	151038135	rs16832976	T	C	3	3	6	0	0	6	0	0
1	151104950	rs10788800	G	A	7	3	10	0	0	10	0	0
1	151110832	rs72708441	G	A	3	5	8	0	0	8	0	0
1	151131091	rs41305062	A	G	4	4	8	0	0	8	0	0
1	151337703	rs72710112	C	T	11	14	25	0	0	25	0	0
1	151668295	rs1308137	A	C	4	11	15	0	0	15	0	0
1	151669442	rs1308139	C	T	16	10	26	0	1	27	0	0
1	151669555	rs3204344	C	A	13	14	27	0	0	27	0	0
1	151669997	rs1048694	C	A	3	10	13	0	0	13	0	0
1	151732700	rs10888433	A	G	2	4	6	0	0	6	0	0
1	151733335	rs8480	T	G	246	269	515	0	4	519	0	0
1	151778683	rs9017	C	T	1	5	6	0	0	6	0	0
1	151778899	rs9826	T	C	6	3	9	0	0	9	0	0
1	151846517	rs13320	C	T	13	11	24	0	0	24	0	0
1	151847126	rs12045899	T	C	24	18	42	0	0	42	0	0
1	151847193	rs11204907	A	C	24	17	41	0	0	41	0	0
1	151879676	rs61817695	G	T	1	7	8	0	0	8	0	0
1	151879761	rs28415528	G	A	8	4	12	0	0	12	0	0
1	151879939	rs58087484	C	T	13	10	23	0	0	23	0	0
1	151958144	rs3791153	A	G	4	3	7	0	0	7	0	0
1	153331849	rs2916193	G	A	38	28	66	0	0	66	0	0
1	153362824	rs199736559	C	G	75	81	156	0	0	156	0	0
1	153363351	rs189102135	G	C	283	198	481	0	4	485	0	0
1	153507959	rs659403	G	C	13	14	27	0	0	27	0	0
1	153516733	rs79399329	G	A	2	4	6	0	0	6	0	0
1	153517172	rs1050923	T	C	1002	885	1887	0	10	1897	0	0
1	153517519	rs11488669	G	A	5	2	7	0	0	7	0	0
1	153534027	rs1047325	C	T	4	3	7	0	0	7	0	0
1	153591652	rs9726753	G	A	7	4	11	0	0	11	0	0
1	153604029	rs1046379	C	T	7	1	8	0	0	8	0	0
1	153604112	rs1046381	G	A	4	3	7	0	0	7	0	0
1	153604519	rs3818632	G	A	100	54	154	0	1	155	0	0
1	153605260	rs28700217	G	A	6	2	8	0	0	8	0	0
1	153609886	rs28510471	C	G	36	25	61	0	0	61	0	0
1	153610017	rs28613361	A	G	34	28	62	0	1	63	0	0
1	153611563	rs4845558	T	C	5	2	7	0	0	7	0	0
1	153612053	rs2274740	A	G	8	10	18	0	0	18	0	0
1	153612133	rs2274739	G	A	8	9	17	0	0	17	0	0
1	153612425	rs10908746	T	G	8	6	14	0	1	15	0	0
1	153613215	rs11580122	T	C	5	6	11	0	0	11	0	0
1	153613545	rs12564925	G	A	12	12	24	0	0	24	0	0
1	153613783	rs10797056	A	G	8	9	17	0	0	17	0	0
1	153616857	rs3790412	T	C	13	31	44	0	1	45	0	0
1	153617132	rs3828031	C	A	26	30	56	0	1	57	0	0
1	153618766	rs7934	C	T	14	14	28	0	0	28	0	0
1	153634058	rs7345	G	T	23	22	45	0	0	45	0	0
1	153635425	rs3795396	G	A	64	67	131	0	2	133	0	0
1	153637404	rs6427671	A	G	20	11	31	0	1	32	0	0
1	153637617	rs3862047	G	A	24	22	46	0	0	46	0	0
1	153701012	.	T	C	4	5	9	0	0	9	0	0
1	153751869	.	G	T	39	48	87	0	0	87	0	0
1	153752065	rs12067325	A	G	18	38	56	0	1	57	0	0
1	153752139	rs10158450	T	C	32	22	54	0	1	55	0	0
1	153777669	rs4451582	G	T	8	10	18	0	1	19	0	0
1	153777848	rs1139620	C	T	14	10	24	0	1	25	0	0
1	153779412	rs1127091	A	G	84	95	179	0	6	185	0	0
1	153780298	rs9426938	C	T	53	53	106	0	0	106	0	0
1	153781888	rs6700115	G	A	32	26	58	0	0	58	0	0
1	153786182	rs6668066	G	A	9	10	19	0	0	19	0	0
1	153786314	rs6677794	C	T	10	6	16	0	0	16	0	0
1	153787279	rs113422987	C	T	3	8	11	0	0	11	0	0
1	153903883	rs1572788	T	C	19	15	34	0	0	34	0	0
1	153904214	rs11586593	T	C	13	13	26	0	0	26	0	0
1	153904338	rs11264619	G	A	12	8	20	0	0	20	0	0
1	153904574	rs11264620	T	C	7	8	15	0	0	15	0	0
1	153906397	rs11264621	A	G	10	24	34	0	0	34	0	0
1	153908309	rs11586075	G	A	4	7	11	0	0	11	0	0
1	153909069	rs1043608	G	C	53	61	114	0	1	115	0	0
1	153920286	rs8450	G	A	420	425	845	0	10	855	0	0
1	153920564	rs10559	A	G	735	635	1370	0	14	1384	0	0
1	153923276	rs10127983	C	T	13	9	22	0	0	22	0	0
1	153926078	rs11264680	T	C	218	199	417	0	1	418	0	0
1	153927052	rs10908557	C	G	83	62	145	0	1	146	0	0
1	153927270	rs10908558	T	C	36	48	84	0	2	86	0	0
1	153932212	rs6724	G	C	56	62	118	0	1	119	0	0
1	153939130	rs11264736	C	T	5	3	8	0	0	8	0	0
1	153941514	rs11264743	C	T	9	20	29	0	0	29	0	0
1	153948705	rs11264763	C	T	9	6	15	0	0	15	0	0
1	154129265	rs1051370	A	G	1351	1487	2838	0	19	2857	0	0
1	154133316	rs4433384	T	C	7	5	12	0	1	13	0	0
1	154134557	rs3196889	A	C	9	3	12	0	0	12	0	0
1	154135445	rs4446955	T	C	10	2	12	0	0	12	0	0
1	154141260	rs34128679	C	A	6	4	10	0	0	10	0	0
1	154142265	rs12028949	T	C	5	1	6	0	0	6	0	0
1	154144681	rs34335016	A	T	73	63	136	0	0	136	0	0
1	154146095	rs7517127	G	A	6	5	11	0	0	11	0	0
1	154149240	rs10797047	G	A	34	25	59	0	0	59	0	0
1	154149767	rs11265238	T	C	18	16	34	0	3	37	0	0
1	154150448	rs4620534	C	A	33	26	59	0	0	59	0	0
1	154154194	rs35761479	G	A	12	4	16	0	0	16	0	0
1	154179679	rs6719	T	C	271	315	586	0	6	592	0	0
1	154186918	rs12408458	G	C	4	4	8	0	0	8	0	0
1	154205556	rs9943093	C	G	5	3	8	0	0	8	0	0
1	154227019	rs12733060	T	A	14	9	23	0	1	24	0	0
1	154232610	rs3828077	A	G	13	16	29	0	0	29	0	0
1	154232768	rs3790614	G	A	21	20	41	0	0	41	0	0
1	154239283	rs1212352	T	A	3	3	6	0	0	6	0	0
1	154243097	rs2282227	G	A	49	50	99	0	0	99	0	0
1	154243115	rs1044013	C	T	49	50	99	0	2	101	0	0
1	154245142	rs11265425	T	G	22	16	38	0	0	38	0	0
1	154245512	rs1194593	A	G	9	20	29	0	0	29	0	0
1	154303976	rs6702754	T	C	20	18	38	0	0	38	0	0
1	154317153	rs1194587	C	T	28	28	56	0	0	56	0	0
1	154317281	rs9660850	G	A	9	8	17	0	0	17	0	0
1	154317418	rs1194586	T	C	8	10	18	0	0	18	0	0
1	154318172	rs1979575	A	G	3	3	6	0	0	6	0	0
1	154318564	rs1194585	G	A	4	2	6	0	0	6	0	0
1	154426970	rs2228145	A	C	3	5	8	0	0	8	0	0
1	154437896	rs2229238	T	C	6	6	12	0	0	12	0	0
1	154438084	rs7514452	C	T	3	4	7	0	0	7	0	0
1	154438880	rs4072391	T	C	5	3	8	0	0	8	0	0
1	154439865	rs4379670	T	A	6	10	16	0	0	16	0	0
1	154521584	rs41269915	T	A	14	14	28	0	0	28	0	0
1	154559876	rs144412359	T	C	3	3	6	0	3	9	0	0
1	154579994	rs145558655	G	A	9	6	15	0	0	15	0	0
1	154904840	rs1891805	T	C	26	14	40	0	3	43	0	0
1	154935253	rs3766921	G	C	87	81	168	0	3	171	0	0
1	154938235	rs1131397	G	C	71	78	149	0	0	149	0	0
1	154938662	rs8191979	T	C	117	109	226	0	5	231	0	0
1	154943881	rs12075984	A	G	22	29	51	0	0	51	0	0
1	154944156	rs12076073	A	G	17	32	49	0	0	49	0	0
1	154945047	rs16836580	G	A	25	38	63	0	1	64	0	0
1	154946517	rs11264293	A	G	38	58	96	0	0	96	0	0
1	154959882	rs7525580	A	G	5	4	9	0	0	9	0	0
1	154960019	rs7528060	T	G	8	7	15	0	0	15	0	0
1	154961448	rs2089247	T	G	3	4	7	0	0	7	0	0
1	154961458	rs2878517	A	G	4	4	8	0	0	8	0	0
1	154965113	rs7535144	G	T	17	26	43	0	0	43	0	0
1	154988957	rs2242195	A	G	105	75	180	0	4	184	0	0
1	154989595	rs6673081	T	C	56	80	136	0	4	140	0	0
1	155026871	rs11548311	G	T	115	114	229	0	0	229	0	0
1	155027082	rs145815601	G	T	5	8	13	0	0	13	0	0
1	155027123	.	C	T	10	6	16	0	1	17	0	0
1	155033308	rs11589479	G	A	258	173	431	0	4	435	0	0
1	155033317	rs11264304	T	C	32	25	57	0	0	57	0	0
1	155033572	rs11264305	A	G	18	18	36	0	0	36	0	0
1	155059851	rs2306124	A	G	18	6	24	0	0	24	0	0
1	155142210	rs4421576	A	G	8	12	20	0	0	20	0	0
1	155142229	rs4276914	G	A	8	13	21	0	0	21	0	0
1	155142883	rs4971088	T	A	11	10	21	0	1	22	0	0
1	155142927	rs4971089	A	G	10	11	21	0	0	21	0	0
1	155143768	rs4971091	G	T	1	6	7	0	0	7	0	0
1	155149718	rs3814316	G	A	8	2	10	0	0	10	0	0
1	155152212	.	G	A	6	2	8	0	0	8	0	0
1	155162067	rs4072037	C	T	21	38	59	0	0	59	0	0
1	155181843	rs2974935	G	T	17	22	39	0	0	39	0	0
1	155182164	rs2075570	C	T	4	5	9	0	0	9	0	0
1	155184704	rs527713857	C	T	6	0	6	0	0	6	0	0
1	155184975	rs2990223	A	G	3	5	8	0	0	8	0	0
1	155201190	rs4043	G	A	55	64	119	0	0	119	0	0
1	155201235	rs1045253	G	A	64	74	138	0	1	139	0	0
1	155201993	rs28595322	A	G	29	28	57	0	0	57	0	0
1	155202689	rs10796940	A	C	20	27	47	0	0	48	1	0
1	155203060	rs11264344	G	A	14	18	32	0	0	32	0	0
1	155205331	rs1800473	T	C	6	0	6	0	0	6	0	0
1	155205581	.	C	T	46	49	95	0	0	95	0	0
1	155206341	rs9628662	T	G	7	4	11	0	1	12	0	0
1	155227707	rs148722887	C	T	5	9	14	0	2	16	0	0
1	155228046	rs12042020	A	G	7	12	19	0	0	19	0	0
1	155229222	rs9729564	G	A	3	4	7	0	0	7	0	0
1	155230131	rs1142287	C	T	65	65	130	0	1	131	0	0
1	155232074	rs1046188	C	T	42	49	91	0	1	92	0	0
1	155259323	rs8847	C	T	9	4	13	0	0	13	0	0
1	155280164	rs11264358	T	C	21	26	47	0	0	47	0	0
1	155282829	rs11264359	A	G	5	6	11	0	0	11	0	0
1	155284261	rs10796941	C	T	6	5	11	0	1	12	0	0
1	155284586	rs11264360	T	A	5	4	9	0	0	9	0	0
1	155285854	rs10908462	T	C	6	13	19	0	0	19	0	0
1	155286258	rs10908463	C	T	7	3	10	0	0	10	0	0
1	155289545	rs11264361	T	G	2	9	11	0	0	11	0	0
1	155306440	rs41264229	T	C	49	57	106	0	2	108	0	0
1	155640115	rs41264945	C	T	267	248	515	0	0	515	0	0
1	155653735	.	T	C	9	9	18	0	0	18	0	0
1	155868309	.	A	T	15	6	21	0	2	23	0	0
1	156165881	rs55675376	C	T	7	6	13	0	0	13	0	0
1	156169610	rs2072499	A	G	10	7	17	0	0	17	0	0
1	156171296	rs2253677	C	G	3	4	7	0	0	7	0	0
1	156173082	rs2241109	C	T	1	5	6	0	0	6	0	0
1	156181007	rs2241108	C	G	35	26	61	0	0	61	0	0
1	156181770	rs2853641	A	G	80	69	149	0	0	149	0	0
1	156192028	rs909269	C	T	5	1	6	0	0	6	0	0
1	156195971	rs2248080	T	A	4	2	6	0	0	6	0	0
1	156196407	rs2842868	T	G	5	1	6	0	0	6	0	0
1	156197614	rs3001789	T	G	3	3	6	0	0	6	0	0
1	156200445	rs2758605	G	C	7	2	9	0	0	9	0	0
1	156200671	rs2842870	T	C	6	5	11	0	0	11	0	0
1	156202173	rs1052053	A	G	238	207	445	0	2	447	0	0
1	156204047	rs2251847	G	A	3	3	6	0	0	6	0	0
1	156205383	rs2736611	A	C	7	4	11	0	0	11	0	0
1	156208230	rs10908491	A	G	4	12	16	0	0	16	0	0
1	156208472	rs139977885	C	T	8	15	23	0	0	23	0	0
1	156215899	rs2075165	G	A	20	15	35	0	1	36	0	0
1	156219450	rs1804999	A	G	181	160	341	0	2	343	0	0
1	156220056	rs1043165	T	C	116	108	224	0	13	237	0	0
1	156233189	rs2273833	C	T	66	67	133	0	2	136	1	0
1	156243821	rs12128955	C	T	3	3	6	0	0	6	0	0
1	156260301	rs12130361	C	T	4	2	6	0	0	6	0	0
1	156262653	rs6800	A	C	50	24	74	0	0	74	0	0
1	156263940	rs10908495	T	C	18	14	32	0	1	33	0	0
1	156264000	rs10908496	G	A	36	26	62	0	0	62	0	0
1	156282224	rs2985711	A	G	6	3	9	0	0	9	0	0
1	156434703	rs1050316	G	T	188	189	377	0	0	377	0	0
1	156439000	rs1109751	T	C	28	17	45	0	0	45	0	0
1	156442745	rs181026006	G	A	8	7	15	0	1	16	0	0
1	156442956	rs6700679	C	T	12	8	20	0	1	21	0	0
1	156446242	rs2274316	C	A	7	20	27	0	1	28	0	0
1	156446450	rs12131289	C	T	7	12	19	0	0	19	0	0
1	156446903	rs2274317	T	C	244	253	497	0	1	499	1	0
1	156450719	rs1185700	G	A	205	185	390	0	3	393	0	0
1	156450740	rs1925950	G	A	188	194	382	0	2	385	1	0
1	156451264	rs1171557	C	T	5	3	8	0	0	8	0	0
1	156451349	rs3790454	T	G	2	4	6	0	0	6	0	0
1	156452093	rs1171558	G	A	3	3	6	0	0	6	0	0
1	156452870	rs2282286	G	A	2	4	6	0	0	6	0	0
1	156455898	rs1171561	G	A	3	9	12	0	1	13	0	0
1	156456529	rs1171563	T	G	3	4	7	0	0	7	0	0
1	156503947	rs6661934	G	A	14	13	27	0	0	27	0	0
1	156567735	rs147789528	G	A	5	4	9	0	0	9	0	0
1	156698265	rs3806415	C	T	15	7	22	0	0	22	0	0
1	156713558	rs4399146	G	A	563	566	1129	0	9	1138	0	0
1	156718438	rs77665650	G	A	2	5	7	0	0	7	0	0
1	156718448	rs11264533	G	C	2	4	6	0	0	6	0	0
1	156758864	rs1758186	C	T	7	9	16	0	0	16	0	0
1	156760036	rs6700964	G	C	6	16	22	0	0	22	0	0
1	156760887	rs11264554	C	A	40	41	81	0	1	82	0	0
1	156761540	rs17850664	C	A	173	151	324	0	4	328	0	0
1	156765973	rs3765783	C	T	7	4	11	0	0	11	0	0
1	156776717	rs928391	T	C	16	12	28	0	0	28	0	0
1	156777845	rs2644606	G	T	9	8	17	0	0	17	0	0
1	156778122	rs877097	G	T	11	9	20	0	1	21	0	0
1	156784982	rs926103	T	C	26	20	46	0	0	46	0	0
1	156884103	rs703156	T	A	3	8	11	0	0	11	0	0
1	156884584	rs56260937	C	T	50	60	110	0	2	112	0	0
1	156885491	rs4661012	T	G	71	74	145	0	1	146	0	0
1	156885767	rs12139641	A	G	62	42	104	0	0	104	0	0
1	156904818	rs6676	G	A	23	14	37	0	1	38	0	0
1	156905584	rs3819973	A	G	14	13	27	0	1	28	0	0
1	156907115	rs868188	T	C	19	15	34	0	0	34	0	0
1	156909695	rs2275199	G	A	5	8	13	0	1	14	0	0
1	157101925	rs2182464	C	G	56	76	132	0	0	132	0	0
1	157108240	rs535781889	G	A	14	7	21	0	0	21	0	0
1	158069787	rs1058271	T	A	8	12	20	0	0	20	0	0
1	158592781	rs75931146	G	A	13	6	19	0	0	19	0	0
1	158592847	rs78394850	G	A	16	8	24	0	0	24	0	0
1	158592901	rs77877855	C	G	18	4	22	0	1	23	0	0
1	158592935	rs3753068	G	A	22	6	28	0	0	28	0	0
1	158604391	rs16830483	T	C	12	7	19	0	0	19	0	0
1	158606449	rs3738791	G	T	8	7	15	0	0	15	0	0
1	158612236	rs863931	A	G	6	7	13	0	0	13	0	0
1	158647522	rs703121	A	G	2	4	6	0	0	6	0	0
1	158979950	rs2276404	A	G	60	81	141	0	0	141	0	0
1	158982477	rs12727764	G	T	1	7	8	0	0	8	0	0
1	158983285	rs856064	T	C	6	0	6	0	0	6	0	0
1	158983593	rs856066	C	G	14	0	14	0	0	14	0	0
1	158983599	rs856067	G	A	13	0	13	0	0	13	0	0
1	158983606	rs7526724	G	A	0	11	11	0	0	11	0	0
1	158984149	rs12755219	A	T	1	5	6	0	0	6	0	0
1	158984322	rs12738378	G	A	1	16	17	0	0	17	0	0
1	158985831	rs66519738	C	T	7	11	18	0	0	18	0	0
1	158986225	rs856042	T	C	6	4	10	0	0	10	0	0
1	158986477	rs866484	G	C	101	74	175	0	2	177	0	0
1	158987241	rs856043	A	G	4	5	9	0	1	10	0	0
1	158987463	rs139033371	T	C	7	8	15	0	0	15	0	0
1	158987878	rs72704976	C	G	6	6	12	0	0	12	0	0
1	158987941	rs856046	A	G	9	8	17	0	0	17	0	0
1	158988270	rs11539423	T	C	67	80	147	0	2	149	0	0
1	158988927	rs1956	G	A	4	8	12	0	0	12	0	0
1	158989301	rs856047	C	T	4	4	8	0	0	8	0	0
1	158999996	rs2157695	C	T	5	1	6	0	0	6	0	0
1	159000027	rs2840312	T	C	5	2	7	0	0	7	0	0
1	159001039	rs56390355	C	G	6	0	6	0	0	6	0	0
1	159001292	rs856051	T	C	1	5	6	0	0	6	0	0
1	159002155	rs856058	T	A	7	5	12	0	0	12	0	0
1	159002377	rs1057027	C	A	92	73	165	0	0	165	0	0
1	159002389	rs1057028	T	A	86	76	162	0	0	162	0	0
1	159020142	rs72709548	T	C	5	5	10	0	0	10	0	0
1	159020366	rs72709549	A	G	3	4	7	0	0	7	0	0
1	159021506	rs62621173	C	T	59	61	120	0	1	121	0	0
1	159023008	rs41264447	T	G	7	6	13	0	0	13	0	0
1	159277868	rs7549785	G	A	33	31	64	0	0	64	0	0
1	159752066	rs1129923	G	A	65	65	130	0	1	131	0	0
1	159825061	rs2501339	G	C	4	3	7	0	0	7	0	0
1	159842379	rs34241039	A	G	1	6	7	0	0	7	0	0
1	159842684	rs79596930	C	A	10	0	10	0	0	10	0	0
1	159843385	rs112418089	C	T	5	9	14	0	0	14	0	0
1	159844058	rs2501329	C	T	5	5	10	0	0	10	0	0
1	159844672	rs74367572	A	C	6	6	12	0	0	12	0	0
1	159844819	rs7521729	C	A	4	6	10	0	1	11	0	0
1	159845737	rs2494520	T	G	6	4	10	0	0	10	0	0
1	159846091	rs74381625	C	T	3	3	6	0	0	6	0	0
1	159854392	rs2501325	C	A	7	1	8	0	0	8	0	0
1	159863028	rs41264831	C	T	33	29	62	0	0	62	0	0
1	159889686	rs2252815	G	A	10	13	23	0	0	23	0	0
1	159890459	rs11265297	T	C	5	7	12	0	0	12	0	0
1	159890969	rs55633025	G	A	5	6	11	0	0	11	0	0
1	159891917	rs6427499	C	T	6	6	12	0	0	12	0	0
1	159892088	rs2789422	G	A	8	4	12	0	0	12	0	0
1	159892780	rs7551141	G	A	5	7	12	0	0	12	0	0
1	159896891	.	G	C	2	4	6	0	0	6	0	0
1	159897638	rs77570237	T	C	8	7	15	0	0	15	0	0
1	159995633	rs6659129	G	A	4	2	6	0	0	6	0	0
1	160173901	rs2795070	C	T	3	3	6	0	0	6	0	0
1	160180906	rs680083	G	A	5	8	13	0	0	13	0	0
1	160187173	rs11265357	A	G	154	118	272	0	0	272	0	0
1	160189500	rs1061511	C	A	36	33	69	0	0	69	0	0
1	160189772	rs10908770	G	C	37	20	57	0	0	57	0	0
1	160209273	rs16831677	C	T	24	23	47	0	1	48	0	0
1	160247185	rs10594	G	C	54	45	99	0	0	99	0	0
1	160260233	rs2298104	T	C	8	10	18	0	0	18	0	0
1	160266667	rs11265371	C	G	6	5	11	0	0	11	0	0
1	160270054	rs11265372	C	T	4	2	6	0	1	7	0	0
1	160302444	rs4656897	G	A	4	9	13	0	0	13	0	0
1	160302983	rs12130366	G	A	4	5	9	0	0	9	0	0
1	160303416	rs1802778	G	A	60	37	97	0	0	97	0	0
1	160304231	rs10908774	G	A	2	4	6	0	0	6	0	0
1	160307662	rs6700892	T	C	2	6	8	0	0	8	0	0
1	160307676	rs6685911	C	T	2	5	7	0	0	7	0	0
1	160308963	rs61801298	G	A	7	10	17	0	0	17	0	0
1	160308970	rs2369609	C	T	8	10	18	0	0	18	0	0
1	160309450	rs1886421	G	C	6	8	14	0	0	14	0	0
1	160309509	rs1886420	T	A	4	5	9	0	0	9	0	0
1	160309664	rs1886419	T	G	7	5	12	0	1	13	0	0
1	160312265	rs10752637	T	G	4	2	6	0	0	6	0	0
1	160318940	rs6669689	A	G	2	4	6	0	0	6	0	0
1	160320850	rs7540865	G	T	5	3	8	0	0	8	0	0
1	160324681	rs6700962	G	T	10	8	18	0	0	18	0	0
1	160454943	rs12144359	C	T	6	14	20	0	1	21	0	0
1	160468292	rs11811889	G	C	5	1	6	0	0	6	0	0
1	160468321	rs7537100	T	C	1	5	6	0	0	6	0	0
1	160468863	rs12123772	C	T	5	2	7	0	0	7	0	0
1	160510182	rs80195053	T	C	7	4	11	0	0	11	0	0
1	160654758	rs2295615	C	G	29	34	63	0	1	64	0	0
1	160654786	rs1980606	G	A	30	25	55	0	0	55	0	0
1	160771761	rs1556517	C	A	5	5	10	0	0	10	0	0
1	160787705	rs2271967	T	C	4	2	6	0	0	6	0	0
1	160797323	rs577453	T	G	6	1	7	0	0	7	0	0
1	160797684	rs574610	A	G	4	4	8	0	0	8	0	0
1	160800480	rs485618	T	C	104	101	205	0	2	207	0	0
1	160800559	rs3766377	A	G	70	70	140	0	1	141	0	0
1	160965335	rs61803665	G	A	10	1	11	0	0	11	0	0
1	160965688	rs3737785	A	G	11	1	12	0	0	12	0	0
1	160966432	rs41267947	C	T	215	198	413	0	3	416	0	0
1	160966532	rs41267949	G	A	215	204	419	0	4	423	0	0
1	160966599	rs41267951	T	C	177	150	327	0	0	327	0	0
1	160966844	rs1062827	C	T	194	171	365	0	0	365	0	0
1	160966963	rs1044478	C	T	177	189	366	0	4	370	0	0
1	160967455	rs12565932	T	C	121	153	274	0	6	280	0	0
1	160968005	rs1062826	G	C	138	134	272	0	0	272	0	0
1	160968224	rs836	G	A	169	178	347	0	3	350	0	0
1	160968609	rs41269993	G	A	156	160	316	0	4	320	0	0
1	160969110	rs2297222	T	C	9	5	14	0	0	14	0	0
1	160969964	.	T	C	125	131	256	0	5	261	0	0
1	160970089	rs72712862	C	T	116	135	251	0	2	253	0	0
1	160970968	rs2297221	G	A	4	2	6	0	0	6	0	0
1	160971015	rs2297220	G	C	4	5	9	0	0	9	0	0
1	160971146	rs790055	A	G	3	3	6	0	0	6	0	0
1	160990906	rs2481085	G	A	25	29	54	0	1	55	0	0
1	161009523	rs3737787	G	A	515	557	1072	0	4	1077	1	0
1	161010762	rs2073658	C	T	25	27	52	0	1	53	0	0
1	161010774	rs2516841	A	G	24	25	49	0	0	49	0	0
1	161010791	rs2073657	C	T	19	28	47	0	0	47	0	0
1	161011317	rs2516840	A	G	9	6	15	0	0	15	0	0
1	161011355	rs2073656	G	C	6	5	11	0	0	11	0	0
1	161011716	rs2774276	G	C	9	4	13	0	0	13	0	0
1	161013121	rs2516839	C	T	227	209	436	0	5	441	0	0
1	161013985	rs2774273	G	C	13	15	28	0	0	28	0	0
1	161014727	rs2516837	A	G	8	18	26	0	0	26	0	0
1	161019040	rs3813609	G	C	125	118	243	0	3	246	0	0
1	161022639	.	C	G	4	9	13	0	0	13	0	0
1	161037979	rs12118313	C	A	2	4	6	0	0	6	0	0
1	161038767	rs6671492	T	C	2	4	6	0	0	6	0	0
1	161186217	.	T	G	7	1	8	0	0	8	0	0
1	161476204	rs9427397	C	T	46	32	78	0	5	83	0	0
1	161476205	rs9427398	A	G	33	37	70	0	7	77	0	0
1	161479745	rs1801274	A	G	53	62	115	0	2	117	0	0
1	161480649	rs11810143	A	G	50	43	93	0	1	94	0	0
1	161481036	rs2165088	G	A	2	4	6	0	0	6	0	0
1	161481530	rs113590334	G	A	3	4	7	0	0	7	0	0
1	161481561	rs10800357	C	T	3	3	6	0	0	6	0	0
1	161482934	rs4233372	C	G	6	0	6	0	0	6	0	0
1	161487452	rs72717040	T	C	5	5	10	0	0	10	0	0
1	161488587	.	T	A	30	31	61	0	0	61	0	0
1	161488943	rs75131185	G	A	79	50	129	0	0	129	0	0
1	161496530	rs1042881	C	G	7	4	11	0	0	11	0	0
1	161593718	rs61803006	C	A	4	4	8	0	1	9	0	0
1	161593958	rs67167367	C	T	2	6	8	0	0	8	0	0
1	161593962	rs67411091	G	A	3	6	9	0	0	9	0	0
1	161751741	rs1058405	A	G	53	37	90	0	1	91	0	0
1	161793612	rs11581556	G	A	4	8	12	0	1	13	0	0
1	161834580	rs10918092	T	A	12	11	23	0	0	23	0	0
1	161930730	rs2499853	A	G	10	18	28	0	1	29	0	0
1	161930954	rs11579627	G	A	13	17	30	0	0	30	0	0
1	161931260	rs2499851	T	C	18	20	38	0	1	39	0	0
1	161931562	rs3795649	G	A	16	23	39	0	1	40	0	0
1	161932193	rs10737521	C	T	29	29	58	0	0	58	0	0
1	162356487	rs1047802	G	T	3	3	6	0	0	6	0	0
1	162470191	rs2342714	C	T	3	3	6	0	1	7	0	0
1	162470503	rs905718	G	A	19	14	33	0	2	35	0	0
1	162493009	rs1062174	C	T	40	19	59	0	0	59	0	0
1	162493123	rs2236581	A	G	35	44	79	0	2	81	0	0
1	162493665	rs9405	T	G	29	34	63	0	1	64	0	0
1	162494683	rs3820486	G	T	51	35	86	0	0	86	0	0
1	162497663	rs4657201	G	A	75	78	153	0	8	161	0	0
1	162498599	rs10737484	T	C	89	64	153	0	2	155	0	0
1	162498946	rs1045901	A	G	338	350	688	0	5	694	1	0
1	162562148	rs12562775	C	T	2	5	7	0	0	7	0	0
1	162564835	rs12040665	A	G	2	5	7	0	0	7	0	0
1	162565221	rs12040754	A	G	6	1	7	0	0	7	0	0
1	162567225	rs16863833	T	C	8	5	13	0	0	13	0	0
1	163304474	rs1533025	G	T	6	0	6	0	0	6	0	0
1	163305424	rs7530829	T	G	4	2	6	0	0	6	0	0
1	163305430	rs7530830	T	C	4	2	6	0	0	6	0	0
1	163309219	rs1509022	A	T	54	52	106	0	0	106	0	0
1	165619079	rs6681	C	T	33	48	81	0	0	81	0	0
1	165623114	rs9333483	G	A	3	3	6	0	0	6	0	0
1	165623355	rs4147603	C	T	2	4	6	0	0	6	0	0
1	165623386	rs4147604	C	G	2	4	6	0	0	6	0	0
1	165624281	rs10800122	C	G	5	1	6	0	0	6	0	0
1	165631670	rs12670	T	G	150	143	293	0	1	294	0	0
1	165636446	rs72698055	G	A	2	5	7	0	0	7	0	0
1	165648710	rs1143660	G	A	43	37	80	0	0	80	0	0
1	165652273	rs1143659	A	G	36	29	65	0	0	65	0	0
1	165676606	rs2090281	T	C	2	5	7	0	1	8	0	0
1	165879622	rs6426943	A	C	8	5	13	0	0	13	0	0
1	166820104	rs10800268	G	A	6	2	8	0	0	8	0	0
1	166820731	rs3738209	G	T	14	18	32	0	0	32	0	0
1	166821633	rs2232521	C	T	12	9	21	0	1	22	0	0
1	166822183	rs10918585	G	A	26	25	51	0	0	51	0	0
1	166824176	rs742006	C	G	1	6	7	0	0	7	0	0
1	166825837	rs6718	A	G	19	18	37	0	0	37	0	0
1	166826655	rs6675033	C	T	34	37	71	0	0	71	0	0
1	166826773	rs6675153	C	T	30	39	69	0	0	69	0	0
1	166827224	rs6675750	G	A	3	7	10	0	0	10	0	0
1	166827674	rs6691431	T	C	2	6	8	0	0	8	0	0
1	166828307	rs4657607	C	A	2	9	11	0	0	11	0	0
1	166828464	rs4657608	C	T	6	13	19	0	0	19	0	0
1	166828869	rs10918586	C	G	6	16	22	0	0	22	0	0
1	166830873	rs12122547	A	G	2	4	6	0	0	6	0	0
1	166831872	rs760537	G	A	1	5	6	0	1	7	0	0
1	166832368	rs1476348	C	T	4	3	7	0	0	7	0	0
1	166832841	rs12032642	G	C	1	5	6	0	0	6	0	0
1	166838075	rs7532247	C	G	4	7	11	0	0	11	0	0
1	167022262	rs11736	T	G	4	3	7	0	1	8	0	0
1	167022381	rs12461	A	G	5	3	8	0	0	8	0	0
1	167022701	rs3753914	A	G	7	1	8	0	0	8	0	0
1	167389619	rs4657657	G	T	8	5	13	0	0	13	0	0
1	167389761	rs2902147	G	T	6	3	9	0	0	9	0	0
1	167389821	rs1773541	A	G	1	5	6	0	1	7	0	0
1	167391498	rs2949663	G	A	11	14	25	0	0	25	0	0
1	167392702	rs2949666	A	G	13	21	34	0	0	34	0	0
1	167393128	rs4233416	T	C	16	15	31	0	0	31	0	0
1	167393635	rs885458	G	A	25	23	48	0	0	48	0	0
1	167427557	rs1214595	G	A	2	4	6	0	0	6	0	0
1	167512098	rs12048110	C	T	29	32	61	0	0	61	0	0
1	167513011	rs1473690	T	G	18	18	36	0	0	36	0	0
1	167513159	rs3753921	T	C	12	26	38	0	0	38	0	0
1	167513418	rs1229430	C	T	18	20	38	0	0	38	0	0
1	167513723	rs12042693	G	A	20	26	46	0	2	48	0	0
1	167514197	rs12022039	C	G	13	14	27	0	1	28	0	0
1	167514575	rs12035288	A	T	14	15	29	0	0	29	0	0
1	167514705	rs4657668	G	A	14	18	32	0	1	33	0	0
1	167515132	rs10918711	C	T	5	5	10	0	0	10	0	0
1	167515272	rs7513428	T	C	16	27	43	0	0	43	0	0
1	167515797	rs7516079	T	C	4	3	7	0	0	7	0	0
1	167600842	rs11579633	C	T	13	12	25	0	0	25	0	0
1	167600864	rs4657689	A	G	11	11	22	0	1	23	0	0
1	167601061	rs4657690	G	A	13	10	23	0	0	23	0	0
1	167758651	rs10125	C	T	5	14	19	0	0	19	0	0
1	167758901	rs3088322	A	G	4	12	16	0	0	16	0	0
1	167759281	rs7605	T	C	17	19	36	0	1	37	0	0
1	167759573	rs14212	T	C	25	28	53	0	2	55	0	0
1	168011132	.	G	A	0	6	6	0	0	6	0	0
1	168013850	rs11558511	T	C	51	45	96	0	0	96	0	0
1	168148829	rs10918838	G	A	50	21	71	0	0	71	0	0
1	168153090	rs2038035	A	T	8	8	16	0	0	16	0	0
1	168168750	rs2072778	A	G	2	5	7	0	0	7	0	0
1	168169345	rs145150142	G	A	31	25	56	0	1	57	0	0
1	169100169	rs2901029	G	A	2	4	6	0	0	6	0	0
1	169102223	rs61803315	G	C	4	7	11	0	0	11	0	0
1	169102313	rs61803316	C	G	2	6	8	0	0	8	0	0
1	169103195	rs1200160	A	G	4	4	8	0	0	8	0	0
1	169435027	rs2678166	C	T	25	15	40	0	0	40	0	0
1	169660002	rs7553	G	T	50	20	70	0	0	70	0	0
1	169660665	rs909628	A	G	12	26	38	0	1	39	0	0
1	169660781	rs12938	A	G	41	20	61	0	0	61	0	0
1	169676486	rs1131498	A	G	33	12	45	0	1	46	0	0
1	169677709	rs1051091	A	G	11	28	39	0	0	39	0	0
1	169768080	rs6668114	C	A	7	8	15	0	0	15	0	0
1	169799880	rs2272920	G	T	7	5	12	0	0	12	0	0
1	169819605	rs6664099	A	G	3	6	9	0	0	9	0	0
1	169819670	rs12131444	G	A	4	4	8	0	0	8	0	0
1	169822543	rs1046058	A	G	13	12	25	0	0	25	0	0
1	169823660	rs1062976	C	T	15	5	20	0	0	20	0	0
1	169823718	rs4656197	T	C	15	10	25	0	0	25	0	0
1	169823790	rs12143301	C	G	8	9	17	0	0	17	0	0
1	169824068	rs12132384	A	G	9	7	16	0	0	16	0	0
1	169824104	rs12135726	G	A	10	6	16	0	0	16	0	0
1	169828327	rs17602701	G	A	9	4	13	0	0	13	0	0
1	169842292	rs10737551	A	G	4	6	10	0	0	10	0	0
1	169890574	rs4519	T	A	58	50	108	0	0	108	0	0
1	169890933	rs518928	A	G	9	15	24	0	0	24	0	0
1	169892117	rs576225	C	T	4	4	8	0	0	8	0	0
1	169892661	rs590181	T	C	5	3	8	0	0	8	0	0
1	169951997	rs33943686	C	T	19	18	37	0	0	37	0	0
1	170004508	rs12750962	A	T	6	6	12	0	1	13	0	0
1	171509327	rs760644	G	A	99	58	157	0	1	158	0	0
1	171511039	rs1687064	C	G	111	83	194	0	1	195	0	0
1	171514731	rs235468	C	G	102	79	181	0	6	187	0	0
1	171516785	.	G	T	8	10	18	0	1	19	0	0
1	171526570	rs1687057	G	A	178	125	303	0	5	308	0	0
1	171527322	rs235482	A	G	124	71	195	0	0	195	0	0
1	171527525	rs235483	T	A	29	22	51	0	1	52	0	0
1	171555049	rs235497	A	T	2	4	6	0	0	6	0	0
1	171556165	rs235501	G	C	80	106	186	0	2	188	0	0
1	171558516	rs235503	C	T	4	7	11	0	0	11	0	0
1	171559073	rs235905	G	A	4	3	7	0	0	7	0	0
1	171559634	rs235906	C	T	8	3	11	0	0	11	0	0
1	171561225	rs235907	C	T	76	78	154	0	1	155	0	0
1	171561250	rs235908	G	A	62	56	118	0	0	118	0	0
1	171561307	rs13722	A	G	82	78	160	0	2	162	0	0
1	171669823	rs236894	G	A	34	43	77	0	1	78	0	0
1	171766580	rs12140193	T	G	2	6	8	0	0	8	0	0
1	172363524	rs10752944	C	T	4	5	9	0	0	9	0	0
1	172410967	rs1063412	G	A	103	76	179	0	2	181	0	0
1	172411066	.	G	A	85	54	139	0	0	139	0	0
1	172411768	rs13932	T	C	54	64	118	0	0	118	0	0
1	172412845	rs60302909	C	A	2	4	6	0	0	6	0	0
1	172502479	rs2285144	T	C	22	19	41	0	0	41	0	0
1	172522891	rs2516064	A	G	5	2	7	0	0	7	0	0
1	172524376	rs77582998	A	C	8	8	16	0	0	16	0	0
1	172541379	rs145055485	T	C	10	3	13	0	1	14	0	0
1	172558524	rs41264546	A	G	80	77	157	0	1	158	0	0
1	172571467	rs79032593	T	C	9	3	12	0	0	12	0	0
1	172576274	rs74553230	A	G	7	5	12	0	0	12	0	0
1	172580537	rs1053381	A	G	115	100	215	0	2	217	0	0
1	173153228	rs16845536	A	T	4	8	12	0	0	12	0	0
1	173153468	rs16845543	A	G	3	7	10	0	0	10	0	0
1	173154237	rs60818642	A	G	6	4	10	0	0	10	0	0
1	173154304	rs7514229	G	T	4	4	8	0	0	8	0	0
1	173901300	.	A	C	121	141	262	0	0	262	0	0
1	175161849	rs2272784	G	T	23	13	36	0	1	37	0	0
1	175889627	rs2030558	C	A	5	6	11	0	0	11	0	0
1	179010099	rs11584723	C	T	1	5	6	0	2	8	0	0
1	179010116	rs144278787	C	G	0	6	6	0	0	6	0	0
1	179010119	rs140145237	C	G	2	6	8	0	0	8	0	0
1	179010155	rs140062423	A	G	4	5	9	0	0	9	0	0
1	179010544	rs11581223	G	C	12	3	15	0	0	15	0	0
1	179041391	rs4456058	G	A	10	5	15	0	0	15	0	0
1	179041398	rs2025584	A	G	10	6	16	0	0	16	0	0
1	179042090	rs116234027	C	A	9	7	16	0	0	16	0	0
1	179042227	rs9725887	T	C	11	10	21	0	1	22	0	0
1	179042300	rs4652352	C	A	10	7	17	0	0	17	0	0
1	179042450	rs4652353	T	G	4	4	8	0	0	8	0	0
1	179043539	rs3766626	T	G	14	8	22	0	0	22	0	0
1	179044723	rs16853621	A	G	15	16	31	0	0	31	0	0
1	179052002	rs2274228	T	G	4	4	8	0	0	8	0	0
1	179053993	rs12116579	C	A	8	13	21	0	0	21	0	0
1	179054692	rs912758	T	G	5	7	12	0	0	12	0	0
1	179056558	rs74454815	C	T	5	6	11	0	0	11	0	0
1	179068851	rs9662858	A	G	52	45	97	0	0	97	0	0
1	179069429	rs3210839	C	T	24	21	45	0	0	45	0	0
1	179070120	rs3813642	C	T	32	22	54	0	1	55	0	0
1	179070334	rs3813643	C	G	30	19	49	0	1	50	0	0
1	179071037	rs17361990	A	G	13	17	30	0	1	31	0	0
1	179071756	rs1325195	G	A	23	14	37	0	0	37	0	0
1	179071865	rs4651012	G	A	18	12	30	0	0	30	0	0
1	179072728	rs3829794	T	C	6	6	12	0	0	12	0	0
1	179072966	rs4651013	C	T	7	5	12	0	0	12	0	0
1	179074869	rs10913692	T	G	3	8	11	0	0	11	0	0
1	179084080	rs2274230	T	G	8	9	17	0	0	17	0	0
1	179084779	rs28913568	A	G	2	4	6	0	0	6	0	0
1	179311494	rs6673354	G	A	9	8	17	0	0	17	0	0
1	179311602	rs3753525	T	G	6	3	9	0	0	9	0	0
1	179312009	rs143910632	T	C	36	36	72	0	0	72	0	0
1	179315299	rs2152320	G	C	6	7	13	0	0	13	0	0
1	179315357	rs2152319	C	A	4	2	6	0	0	6	0	0
1	179315738	rs7518843	C	T	6	7	13	0	0	13	0	0
1	179315898	rs4421551	C	A	5	2	7	0	1	8	0	0
1	179316320	rs6425535	G	C	6	5	11	0	0	11	0	0
1	179323738	rs1044925	C	A	6	4	10	0	0	10	0	0
1	179323919	rs4652366	A	G	13	18	31	0	1	32	0	0
1	179325633	rs2065761	A	G	3	4	7	0	0	7	0	0
1	179326065	rs56149964	A	C	2	4	6	0	0	6	0	0
1	179326323	rs7548288	A	G	6	12	18	0	0	18	0	0
1	179326397	rs7536854	C	G	9	4	13	0	0	13	0	0
1	179326747	rs7537139	C	A	5	11	16	0	0	18	2	0
1	179327017	rs45471092	A	G	10	19	29	0	0	29	0	0
1	179811504	rs11546310	G	C	18	18	36	0	0	36	0	0
1	179813352	rs2794583	C	T	17	16	33	0	0	33	0	0
1	179813499	rs1281408	G	A	15	15	30	0	1	31	0	0
1	179813613	rs1281410	T	C	16	15	31	0	0	31	0	0
1	179814457	rs1281411	A	C	17	14	31	0	1	32	0	0
1	179828484	rs6666510	C	T	8	10	18	0	0	18	0	0
1	179830012	rs3737813	A	C	4	2	6	0	0	6	0	0
1	179832638	rs55706288	T	C	211	192	403	0	5	408	0	0
1	179838407	.	G	A	18	4	22	0	5	27	0	0
1	179852074	rs1281378	T	C	60	65	125	0	1	126	0	0
1	179852552	rs605807	T	G	3	3	6	0	0	6	0	0
1	179876988	rs609521	C	G	115	121	236	0	1	237	0	0
1	179879604	rs480377	T	A	5	2	7	0	0	7	0	0
1	179882370	rs77337762	A	G	4	5	9	0	0	9	0	0
1	179883494	rs555270	G	A	4	7	11	0	0	11	0	0
1	179885939	rs612215	A	G	6	1	7	0	0	7	0	0
1	179887681	rs530854	G	C	140	104	244	0	2	246	0	0
1	179887788	rs531814	C	T	112	111	223	0	2	225	0	0
1	179888228	rs549650	G	C	136	98	234	0	0	234	0	0
1	179888510	rs72708674	A	G	211	209	420	0	3	423	0	0
1	179891092	rs522534	C	T	19	6	25	0	1	26	0	0
1	179938305	rs539324	G	C	2	6	8	0	0	8	0	0
1	179938798	rs2762859	A	G	4	3	7	0	0	7	0	0
1	179983665	rs2501607	G	A	19	18	37	0	0	37	0	0
1	179989742	rs2477120	G	C	24	19	43	0	0	43	0	0
1	180080629	rs79555092	C	T	11	12	23	0	0	23	0	0
1	180082885	rs556476069	C	T	49	34	83	0	0	83	0	0
1	180146041	rs17371678	G	A	13	17	30	0	0	30	0	0
1	180151709	rs61809061	C	T	6	13	19	0	0	19	0	0
1	180167774	rs17299812	C	T	8	7	15	0	0	15	0	0
1	180173101	rs61809096	C	T	9	7	16	0	0	16	0	0
1	180239535	rs1043744	T	C	4	7	11	0	0	11	0	0
1	180239636	rs2794963	C	T	3	5	8	0	0	8	0	0
1	180239670	rs119465	G	A	1	5	6	0	0	6	0	0
1	180240510	rs2764449	T	C	3	3	6	0	0	6	0	0
1	180340706	rs1418102	C	T	2	4	6	0	0	6	0	0
1	180358457	rs9729219	A	G	14	2	16	0	0	16	0	0
1	180358547	rs9729819	T	G	8	1	9	0	0	9	0	0
1	180359150	.	T	C	6	3	9	0	0	9	0	0
1	180359213	rs61811600	A	G	7	10	17	0	0	17	0	0
1	180359282	rs12128560	A	C	5	6	11	0	0	11	0	0
1	180359517	.	G	A	9	3	12	0	0	12	0	0
1	180359603	rs12129511	A	G	6	3	9	0	0	9	0	0
1	180393207	rs4420052	T	C	9	1	10	0	0	10	0	0
1	180393330	rs4424469	T	C	5	3	8	0	0	8	0	0
1	180470867	rs12121043	T	C	4	8	12	0	0	12	0	0
1	180471054	rs12723183	C	A	7	1	8	0	0	8	0	0
1	180471066	rs61811621	C	T	2	8	10	0	0	10	0	0
1	180857520	.	G	A	6	0	6	0	0	6	0	0
1	180857533	.	T	A	6	0	6	0	0	6	0	0
1	181058191	rs61809229	G	T	66	49	115	0	0	115	0	0
1	181058313	rs3747955	G	A	13	20	33	0	1	34	0	0
1	181058618	rs1416829	C	G	5	1	6	0	0	6	0	0
1	182352621	rs7734	T	C	2720	2924	5644	0	40	5685	1	0
1	182353198	rs9347	A	T	1548	1579	3127	0	8	3135	0	0
1	182354850	rs2296520	A	G	729	916	1645	0	5	1651	1	0
1	182355046	rs2296519	A	G	30	24	54	0	1	55	0	0
1	182356079	rs12735664	A	C	23	15	38	0	0	38	0	0
1	182356247	rs17462824	T	C	10	17	27	0	0	27	0	0
1	182356399	rs1058111	A	G	1487	1744	3231	0	13	3244	0	0
1	182358437	rs4652705	T	C	7	11	18	0	0	18	0	0
1	182359578	rs3895340	A	C	13	17	30	0	2	32	0	0
1	182360169	rs4075940	T	G	4	2	6	0	0	6	0	0
1	182360202	rs4075941	A	C	9	1	10	0	0	10	0	0
1	182360223	rs7539686	G	T	11	3	14	0	0	14	0	0
1	182360315	rs12403634	C	T	45	26	71	0	1	72	0	0
1	182855679	.	G	A	2	4	6	0	0	6	0	0
1	182993025	rs10911194	C	T	6	3	9	0	0	9	0	0
1	183072590	rs2296288	T	C	2	4	6	0	0	6	0	0
1	183072701	rs2296289	C	T	4	5	9	0	0	9	0	0
1	183085755	rs20563	A	G	5	7	12	0	0	12	0	0
1	183086757	rs2296292	A	C	5	3	8	0	0	8	0	0
1	183093875	rs20557	T	C	5	3	8	0	0	8	0	0
1	183094547	rs20558	T	C	8	4	12	0	0	12	0	0
1	183105534	rs20560	T	C	21	13	34	0	0	34	0	0
1	183112041	rs3359	G	C	23	22	45	0	0	45	0	0
1	183112412	rs1062044	A	G	4	3	7	0	0	7	0	0
1	183112505	rs944971	T	C	3	4	7	0	0	7	0	0
1	183112566	rs944970	T	C	5	1	6	0	1	7	0	0
1	183113862	rs3738829	C	T	6	7	13	0	0	13	0	0
1	183113952	rs1547715	A	G	9	2	11	0	0	11	0	0
1	183114119	rs1547714	C	T	13	5	18	0	0	18	0	0
1	183114146	rs1051473	T	C	12	5	17	0	1	18	0	0
1	183114634	rs7473	G	A	10	3	13	0	0	13	0	0
1	183515428	rs2298083	G	A	104	101	205	0	4	209	0	0
1	183521283	rs699245	C	T	97	112	209	0	4	213	0	0
1	183525620	rs789180	A	T	34	33	67	0	1	68	0	0
1	183527103	rs789182	T	C	14	14	28	0	0	28	0	0
1	183527258	rs789183	C	T	7	13	20	0	0	20	0	0
1	183527990	rs789184	G	C	8	4	12	0	1	13	0	0
1	183533910	rs11811630	C	T	7	10	17	0	0	17	0	0
1	183534142	rs34015031	T	C	13	10	23	0	0	23	0	0
1	183534935	rs2296164	C	T	23	22	45	0	0	45	0	0
1	183536983	rs193283181	C	T	51	55	106	0	2	108	0	0
1	183537474	rs3845462	T	G	32	32	64	0	2	66	0	0
1	183537478	rs3845463	G	T	33	37	70	0	1	71	0	0
1	183537859	rs2236384	G	C	48	43	91	0	0	91	0	0
1	183538025	rs2236385	A	G	33	36	69	0	1	70	0	0
1	183538725	rs3768583	T	A	9	16	25	0	0	25	0	0
1	183539125	rs3820691	A	G	17	22	39	0	2	41	0	0
1	183539449	rs3843293	G	T	21	30	51	0	0	51	0	0
1	183542387	rs2274064	T	C	101	101	202	0	0	202	0	0
1	183542747	rs3818364	G	T	3	11	14	0	0	14	0	0
1	183543053	rs10911359	C	T	9	1	10	0	0	10	0	0
1	183553560	rs12740417	C	T	9	6	15	0	0	15	0	0
1	183555370	rs35049461	A	G	8	16	24	0	0	24	0	0
1	183555373	rs34715440	C	G	8	17	25	0	0	25	0	0
1	183555406	rs789189	C	T	5	16	21	0	0	21	0	0
1	183555454	rs35304105	A	C	8	13	21	0	0	21	0	0
1	183555757	rs789190	T	C	8	21	29	0	0	29	0	0
1	183555779	rs11578964	C	T	10	22	32	0	1	33	0	0
1	183556291	rs789192	A	G	3	6	9	0	0	9	0	0
1	183556395	rs11588654	T	C	7	6	13	0	0	13	0	0
1	183556620	rs3903837	T	C	1	10	11	0	0	11	0	0
1	183566913	rs41439047	C	T	11	6	17	0	0	17	0	0
1	183567085	rs35682376	G	A	8	7	15	0	0	15	0	0
1	183592570	rs17488675	C	T	3	26	29	0	0	29	0	0
1	183593512	rs4084535	G	A	3	5	8	0	0	8	0	0
1	183595037	rs2761574	G	A	3	3	6	0	0	6	0	0
1	183595069	rs3856127	C	G	4	3	7	0	0	7	0	0
1	183596136	rs11755	A	G	79	94	173	0	1	174	0	0
1	183602795	rs2254972	A	G	5	4	9	0	0	9	0	0
1	184020945	rs2274432	G	A	7	17	24	0	0	24	0	0
1	184023529	rs1046934	A	C	14	24	38	0	1	39	0	0
1	184660205	rs1046239	T	A	12	5	17	0	1	18	0	0
1	184661642	rs6663178	G	A	17	12	29	0	0	29	0	0
1	184662063	rs9425342	C	T	12	5	17	0	0	17	0	0
1	184662181	rs1061508	C	T	10	10	20	0	0	20	0	0
1	184663537	rs9425343	A	C	15	13	28	0	0	28	0	0
1	184663581	rs9425634	T	C	12	10	22	0	0	22	0	0
1	184675814	rs1062994	G	A	12	9	21	0	0	21	0	0
1	184677464	rs3736757	G	A	7	13	20	0	0	20	0	0
1	184760433	rs7360	C	T	100	98	198	0	0	198	0	0
1	184761186	rs492126	G	A	42	43	85	0	2	87	0	0
1	184761365	rs682331	A	G	47	36	83	0	1	84	0	0
1	184762603	rs526024	T	A	25	25	50	0	0	50	0	0
1	184763525	rs14426	A	G	29	42	71	0	0	71	0	0
1	184763596	rs14023	C	T	39	52	91	0	0	91	0	0
1	184764067	rs581100	C	G	21	30	51	0	0	51	0	0
1	184765898	rs636095	A	T	4	4	8	0	0	8	0	0
1	184797087	.	G	T	1	5	6	0	0	6	0	0
1	184804718	rs495530	C	T	4	2	6	0	0	6	0	0
1	184852226	rs234659	A	G	3	3	6	0	0	6	0	0
1	184913958	rs7537119	G	A	5	4	9	0	0	9	0	0
1	184914002	rs7539438	G	C	5	2	7	0	0	7	0	0
1	184924638	rs6424968	A	T	13	13	26	0	0	26	0	0
1	184930496	rs7511856	C	G	5	2	7	0	0	7	0	0
1	184931029	rs234095	A	G	2	4	6	0	0	6	0	0
1	184933770	rs3890655	T	G	24	13	37	0	0	37	0	0
1	185056709	.	C	T	24	20	44	0	0	44	0	0
1	185088697	rs1053166	T	C	3	9	12	0	0	12	0	0
1	185135745	rs950327	A	G	4	4	8	0	1	9	0	0
1	185143721	rs10489579	A	G	3	4	7	0	0	7	0	0
1	185171869	rs6698109	A	G	3	3	6	0	0	6	0	0
1	185206384	rs10218496	A	G	4	4	8	0	0	8	0	0
1	185240474	rs12041704	A	G	2	6	8	0	0	8	0	0
1	185265711	rs7123	T	C	71	107	178	0	0	178	0	0
1	185267114	rs10174	A	G	368	437	805	0	8	813	0	0
1	185271129	rs113756096	T	A	38	38	76	0	1	77	0	0
1	185272594	rs10911702	T	G	45	38	83	0	0	83	0	0
1	185276933	.	T	C	36	23	59	0	3	62	0	0
1	185280712	rs149008024	A	G	4	7	11	0	1	12	0	0
1	186293757	rs2178214	T	C	4	3	7	0	0	7	0	0
1	186305747	.	C	A	76	82	158	0	0	158	0	0
1	186321242	rs61744267	C	T	62	28	90	0	0	90	0	0
1	186375044	rs115148843	G	A	4	4	8	0	0	8	0	0
1	186643058	rs5275	A	G	49	56	105	0	1	106	0	0
1	186645488	rs4648276	A	G	5	4	9	0	0	9	0	0
1	186648197	rs5277	C	G	145	128	273	0	1	274	0	0
1	186918433	rs12720634	G	C	3	3	6	0	0	6	0	0
1	186919239	rs10911971	G	C	2	4	6	0	0	6	0	0
1	186933555	rs932476	A	G	3	4	7	0	0	7	0	0
1	192127637	rs4495675	T	G	6	6	12	0	0	12	0	0
1	192130276	rs10921097	C	T	4	2	6	0	0	6	0	0
1	192131949	rs9660001	C	T	13	12	25	0	1	26	0	0
1	192133270	rs12141770	T	C	25	26	51	0	1	52	0	0
1	192133915	rs10921099	T	C	70	79	149	0	0	149	0	0
1	192134053	rs10921100	T	G	99	112	211	0	1	212	0	0
1	192134307	rs12145398	G	A	124	100	224	0	2	226	0	0
1	192134447	rs1937236	C	T	175	154	329	0	0	329	0	0
1	192547052	rs10921202	G	T	3	8	11	0	0	11	0	0
1	192685665	rs33970247	A	G	0	6	6	0	0	6	0	0
1	192779615	.	G	C	43	20	63	0	0	63	0	0
1	192982233	.	C	T	12	10	22	0	0	22	0	0
1	192984059	rs10489686	C	T	0	7	7	0	0	7	0	0
1	193054154	rs10921309	G	A	82	51	133	0	2	135	0	0
1	193054485	rs10801173	T	C	50	52	102	0	1	103	0	0
1	193054769	rs12136893	T	C	14	17	31	0	0	31	0	0
1	193208397	rs17593414	T	C	4	3	7	0	0	7	0	0
1	197070442	rs3762271	G	T	5	11	16	0	0	16	0	0
1	197070697	rs41310927	T	C	6	11	17	0	0	17	0	0
1	197070707	rs41308365	G	A	6	12	18	0	0	18	0	0
1	197070776	rs10922162	C	T	12	6	18	0	0	18	0	0
1	197072420	rs41310925	T	C	2	4	6	0	0	6	0	0
1	197123043	rs1127661	T	C	7	10	17	0	0	17	0	0
1	197126649	rs4639796	G	A	5	1	6	0	0	6	0	0
1	197127491	rs12028827	A	C	2	4	6	0	0	6	0	0
1	197128726	rs12128631	G	A	14	13	27	0	0	27	0	0
1	197474654	rs12133659	G	A	17	16	33	0	2	35	0	0
1	197478285	rs12132165	G	A	19	13	32	0	0	32	0	0
1	198619759	rs1326271	G	A	2	4	6	0	0	6	0	0
1	198622043	rs16843591	A	G	6	6	12	0	0	12	0	0
1	198622961	rs56272733	C	T	3	5	8	0	0	8	0	0
1	198632356	rs1998843	C	T	4	3	7	0	0	7	0	0
1	198663410	rs115040777	G	A	4	3	7	0	0	7	0	0
1	198679093	rs10753834	G	A	2	9	11	0	0	11	0	0
1	198680015	rs12733073	G	A	25	96	121	0	0	121	0	0
1	198699793	rs12120762	C	T	7	5	12	0	0	12	0	0
1	198722841	rs17670373	A	G	3	3	6	0	0	6	0	0
1	198838090	rs10919598	A	G	3	6	9	0	0	9	0	0
1	198868084	rs10800597	G	A	4	3	7	0	0	7	0	0
1	198869514	rs10800598	T	C	2	4	6	0	0	6	0	0
1	200375209	rs1128817	G	A	101	117	218	0	2	220	0	0
1	200940180	rs3198583	G	A	71	61	132	0	2	134	0	0
1	200941423	rs56368827	C	A	30	27	57	0	0	57	0	0
1	200941716	rs3738255	G	A	30	48	78	0	0	78	0	0
1	200956288	rs2275485	A	G	52	43	95	0	0	95	0	0
1	200959302	rs2297911	G	A	26	27	53	0	2	55	0	0
1	200968879	rs16847508	G	A	13	9	22	0	0	22	0	0
1	201104318	rs3087914	T	C	191	148	339	0	6	345	0	0
1	201104589	rs1059625	A	G	125	157	282	0	5	287	0	0
1	201105904	rs10920127	G	A	8	2	10	0	0	10	0	0
1	201109903	rs10920129	C	T	5	1	6	0	0	6	0	0
1	201113397	rs7526291	C	G	8	9	17	0	0	17	0	0
1	201114667	rs11581233	T	G	3	7	10	0	0	10	0	0
1	201115288	rs3752975	C	T	4	4	8	0	0	8	0	0
1	201502592	rs6672166	A	G	5	4	9	0	0	9	0	0
1	201928926	.	C	A	7	11	18	0	0	19	1	0
1	201959455	rs16849483	G	T	12	18	30	0	0	30	0	0
1	201960269	rs6691498	G	A	2	6	8	0	0	8	0	0
1	201960320	rs6667090	A	G	7	7	14	0	0	14	0	0
1	201960453	rs6691690	G	A	7	1	8	0	0	8	0	0
1	201961711	rs4950811	G	A	15	9	24	0	1	25	0	0
1	201964147	rs55689308	C	T	13	14	27	0	0	27	0	0
1	201964631	rs34505332	C	T	5	2	7	0	0	7	0	0
1	201965661	rs10920298	A	G	9	6	15	0	1	16	0	0
1	201965855	rs59698324	C	T	8	18	26	0	0	26	0	0
1	201966238	rs4950756	C	T	29	25	54	0	1	55	0	0
1	201966273	rs4950757	G	A	30	25	55	0	1	56	0	0
1	201966985	rs4950814	G	A	5	2	7	0	0	7	0	0
1	201967453	rs12143997	G	A	5	3	8	0	1	9	0	0
1	201967669	rs61821542	C	T	6	4	10	0	0	10	0	0
1	201967922	rs10920301	G	T	9	5	14	0	0	14	0	0
1	201969082	rs1130790	G	A	108	96	204	0	1	205	0	0
1	201970078	rs12022347	G	A	23	22	45	0	1	46	0	0
1	201970748	rs4131469	G	A	30	27	57	0	0	57	0	0
1	201973565	rs3820439	G	A	161	169	330	0	4	334	0	0
1	201981215	.	T	C	4	5	9	0	0	9	0	0
1	201981218	rs11543979	C	G	4	4	8	0	0	8	0	0
1	201981862	rs2819362	T	C	2	6	8	0	0	8	0	0
1	202103802	rs4342901	G	A	7	20	27	0	0	27	0	0
1	202106797	rs16849710	A	G	2	6	8	0	0	8	0	0
1	202109041	rs12402757	G	T	13	11	24	0	0	24	0	0
1	202110522	.	C	T	9	4	13	0	0	13	0	0
1	202111945	rs60471116	C	T	5	8	13	0	0	13	0	0
1	202112899	rs3934809	C	A	10	9	19	0	1	20	0	0
1	202116238	rs9077	G	A	425	346	771	0	5	776	0	0
1	202116957	rs4623766	T	A	290	226	516	0	8	524	0	0
1	202119052	rs61250341	C	T	10	12	22	0	1	23	0	0
1	202119205	rs55813259	C	A	15	18	33	0	2	35	0	0
1	202122613	rs10920338	C	T	6	1	7	0	0	7	0	0
1	202287813	rs788793	T	C	1	6	7	0	0	7	0	0
1	202288462	rs788792	C	A	2	7	9	0	0	9	0	0
1	202302232	rs17490864	A	G	2	6	8	0	0	8	0	0
1	202741592	rs115150017	T	C	12	9	21	0	1	22	0	0
1	202827191	rs6663182	G	A	5	9	14	0	0	14	0	0
1	202848587	rs4950885	G	A	4	5	9	0	0	9	0	0
1	202849723	rs1131906	G	A	6	16	22	0	0	22	0	0
1	202849770	rs1131905	T	C	14	12	26	0	0	26	0	0
1	202861342	rs12089566	A	G	32	34	66	0	0	66	0	0
1	202861566	rs1042990	A	G	37	39	76	0	2	78	0	0
1	202876085	rs10753926	C	T	2	7	9	0	0	9	0	0
1	202878454	rs1539357	T	A	10	3	13	0	0	13	0	0
1	202878492	rs3820152	T	A	8	4	12	0	0	12	0	0
1	202878808	rs7536140	C	T	9	14	23	0	0	23	0	0
1	202888947	rs3182429	T	C	32	33	65	0	0	65	0	0
1	203034955	rs3737882	C	G	8	3	11	0	0	11	0	0
1	203035097	rs3737881	C	T	5	3	8	0	0	8	0	0
1	203035340	rs10800897	C	T	4	5	9	0	0	9	0	0
1	203035365	rs6694477	A	G	4	4	8	0	0	8	0	0
1	203035551	rs6670637	G	A	9	3	12	0	0	12	0	0
1	203035897	rs10920560	G	A	3	3	6	0	0	6	0	0
1	203152801	rs880633	T	C	38	43	81	0	0	81	0	0
1	203274901	.	C	A	7	7	14	0	0	14	0	0
1	203275407	rs17534048	C	G	7	7	14	0	0	14	0	0
1	203711457	rs75921042	G	A	11	5	16	0	0	16	0	0
1	204520044	rs71633514	A	T	23	21	44	0	0	46	2	0
1	205056525	rs1130311	C	T	21	21	42	0	1	43	0	0
1	205111761	rs2836	A	C	94	119	213	0	14	227	0	0
1	205112911	rs3795556	T	C	82	102	184	0	3	187	0	0
1	205113833	rs3183297	A	G	37	33	70	0	2	72	0	0
1	205114665	rs12137465	G	T	10	26	36	0	1	37	0	0
1	205114873	rs12048743	C	G	35	42	77	0	0	77	0	0
1	205115099	rs11240369	G	A	28	23	51	0	0	51	0	0
1	205115150	rs1061132	C	A	26	31	57	0	1	58	0	0
1	205115739	rs11808879	G	A	21	13	34	0	0	34	0	0
1	205116598	.	T	C	28	44	72	0	1	73	0	0
1	205129319	rs1062715	G	A	23	19	42	0	0	42	0	0
1	205210709	.	G	A	5	3	8	0	0	8	0	0
1	205272926	rs1106201	C	T	5	3	8	0	0	8	0	0
1	205272983	rs1106202	C	G	5	2	7	0	0	7	0	0
1	205273100	rs56091501	G	A	6	9	15	0	0	15	0	0
1	205320428	rs55962699	A	T	86	0	86	0	1	87	0	0
1	205320469	rs4951205	G	A	87	0	87	0	0	87	0	0
1	205578980	rs116507898	T	C	10	9	19	0	0	19	0	0
1	205580316	rs4573566	T	C	8	13	21	0	0	21	0	0
1	205581853	rs11240540	C	T	9	8	17	0	0	17	0	0
1	205582167	rs115625671	A	G	5	2	7	0	0	7	0	0
1	205582916	rs77636349	C	T	5	5	10	0	0	10	0	0
1	205584660	rs79614693	A	G	3	5	8	0	0	8	0	0
1	205588637	rs3789461	C	T	11	10	21	0	0	21	0	0
1	205632419	.	A	G	5	6	11	0	0	11	0	0
1	205683355	rs3805	T	G	77	79	156	0	1	157	0	0
1	205686768	.	C	T	21	92	113	0	3	117	1	0
1	205701078	rs823110	G	C	3	3	6	0	0	6	0	0
1	205737739	rs11557080	G	A	12	13	25	0	0	25	0	0
1	205738302	rs823137	G	A	11	21	32	0	0	32	0	0
1	205744138	rs708725	G	T	4	9	13	0	1	14	0	0
1	205759195	rs1772159	G	A	15	9	24	0	0	24	0	0
1	205779231	rs11240569	G	A	4	2	6	0	0	6	0	0
1	206285235	.	C	T	6	1	7	0	0	7	0	0
1	206566904	rs2919105	T	C	19	5	24	0	0	24	0	0
1	206579798	.	T	C	6	0	6	0	0	6	0	0
1	206580084	.	C	G	2	5	7	0	0	7	0	0
1	206603535	rs2297539	G	A	8	8	16	0	0	16	0	0
1	206619526	.	C	T	13	16	29	0	1	30	0	0
1	206626607	rs11120575	G	A	17	10	27	0	0	27	0	0
1	206637395	rs9242	C	T	3	7	10	0	0	10	0	0
1	206648378	rs1059704	G	A	13	7	20	0	0	20	0	0
1	206825605	rs10863766	T	C	7	2	9	0	0	9	0	0
1	206825643	rs7554274	A	G	7	4	11	0	0	11	0	0
1	206893344	rs61815628	A	C	5	4	9	0	1	10	0	0
1	206895798	rs115424752	C	T	5	4	9	0	0	9	0	0
1	206896255	rs28394820	T	C	5	7	12	0	0	12	0	0
1	207192180	rs10877	C	T	7	4	11	0	0	11	0	0
1	207217359	rs1044145	T	C	143	159	302	0	2	304	0	0
1	207221612	rs2054780	C	T	50	54	104	0	0	104	0	0
1	207249855	rs11120148	G	A	16	13	29	0	0	29	0	0
1	207250456	rs1060287	C	T	18	14	32	0	0	32	0	0
1	207250570	rs1565	A	G	13	10	23	0	0	23	0	0
1	207250631	rs1560	A	G	18	14	32	0	0	32	0	0
1	207252647	rs17258746	T	A	8	4	12	0	0	12	0	0
1	207253487	rs6673422	A	G	7	3	10	0	0	10	0	0
1	207495427	rs7533852	G	T	5	3	8	0	0	8	0	0
1	207500293	rs4844591	C	T	23	29	52	0	0	52	0	0
1	207501211	rs4844592	T	A	10	9	19	0	0	19	0	0
1	207501527	rs6691942	C	T	25	16	41	0	0	41	0	0
1	207501866	rs6692273	C	G	14	26	40	0	0	40	0	0
1	207501872	rs6700079	T	C	14	25	39	0	0	39	0	0
1	207501965	rs6699517	A	G	21	16	37	0	1	38	0	0
1	207502347	rs6702997	T	C	23	37	60	0	0	60	0	0
1	207502372	rs6703002	T	G	14	32	46	0	0	46	0	0
1	207502534	rs6700168	A	C	16	30	46	0	0	46	0	0
1	207502891	rs7548463	C	T	16	18	34	0	0	34	0	0
1	207503208	rs1395969	C	G	25	18	43	0	0	43	0	0
1	207503432	rs925130	G	A	20	20	40	0	0	40	0	0
1	207503721	rs925131	G	A	21	14	35	0	1	36	0	0
1	207504669	rs2184476	G	A	0	6	6	0	0	6	0	0
1	207510548	rs10746462	A	G	134	26	160	0	0	160	0	0
1	207510596	rs10746463	G	A	29	31	60	0	0	60	0	0
1	207519137	rs6673138	A	G	3	8	11	0	0	11	0	0
1	207519522	rs1257728	G	A	8	16	24	0	0	24	0	0
1	207519523	rs1588143	T	G	16	8	24	0	0	24	0	0
1	207520788	rs1257729	G	A	6	3	9	0	0	9	0	0
1	207521434	rs12140999	C	T	8	4	12	0	0	12	0	0
1	207522558	rs11120746	C	T	1	6	7	0	0	7	0	0
1	207526593	rs2135923	G	A	7	7	14	0	0	14	0	0
1	207813601	rs4844385	T	C	5	4	9	0	0	9	0	0
1	207813726	rs4844386	T	C	5	3	8	0	0	8	0	0
1	207851611	rs2296158	A	G	4	3	7	0	0	7	0	0
1	207940853	rs11118555	T	A	8	13	21	0	0	21	0	0
1	207941539	rs2488254	A	G	14	17	31	0	0	31	0	0
1	207941741	rs2488255	C	T	24	23	47	0	0	47	0	0
1	207941927	rs2796271	A	G	28	24	52	0	0	52	0	0
1	207943112	.	C	T	17	11	28	0	0	28	0	0
1	207957555	rs7541230	T	C	5	4	9	0	0	9	0	0
1	207962270	rs859706	G	A	1	6	7	0	0	7	0	0
1	207965427	rs1142469	G	A	14	10	24	0	0	24	0	0
1	207966393	rs12568382	G	A	13	13	26	0	0	26	0	0
1	207967719	rs7144	T	C	129	165	294	0	1	295	0	0
1	207976205	rs12410786	T	A	7	1	8	0	0	8	0	0
1	207976276	rs12401619	G	C	4	3	7	0	0	7	0	0
1	207976666	rs1474742	C	A	3	4	7	0	0	7	0	0
1	208038547	rs72729080	T	C	3	7	10	0	0	10	0	0
1	209788514	rs2566	G	A	9	7	16	0	0	16	0	0
1	209929579	rs2272867	C	A	14	8	22	0	0	22	0	0
1	209933331	rs6685077	A	G	23	6	29	0	0	29	0	0
1	209933540	rs2076150	A	G	18	9	27	0	0	27	0	0
1	209934133	rs11119337	A	G	5	4	9	0	0	9	0	0
1	209936914	rs17015169	C	T	26	15	41	0	0	41	0	0
1	209950486	rs648349	A	G	5	3	8	0	0	8	0	0
1	209950681	rs649275	T	C	3	6	9	0	0	9	0	0
1	209950760	rs669694	C	G	43	54	97	0	1	98	0	0
1	209952865	rs623360	C	G	36	26	62	0	0	62	0	0
1	209955848	rs651141	A	C	8	6	14	0	0	14	0	0
1	210004199	rs585627	C	G	3	4	7	0	0	7	0	0
1	210006603	rs656566	C	T	8	1	9	0	0	9	0	0
1	211547366	rs58510761	C	A	68	65	133	0	1	134	0	0
1	211605697	rs1055565	G	A	11	8	19	0	0	19	0	0
1	211745154	rs11277	C	G	80	66	146	0	1	147	0	0
1	212190116	rs2993531	A	C	5	1	6	0	0	6	0	0
1	212224946	rs113106720	G	T	92	0	92	0	0	92	0	0
1	212277107	rs1387815	T	G	34	24	58	0	0	58	0	0
1	212277304	rs1387814	C	G	10	13	23	0	0	23	0	0
1	212459257	rs351409	A	G	8	4	12	0	0	12	0	0
1	212459615	rs75232123	C	G	62	50	112	0	0	112	0	0
1	212515613	rs1774249	C	T	110	85	195	0	0	195	0	0
1	212516245	rs2252044	A	C	4	3	7	0	1	8	0	0
1	212526288	rs792442	C	T	6	7	13	0	0	13	0	0
1	212533082	rs72754308	C	G	13	7	20	0	0	20	0	0
1	212534377	rs10019	T	A	155	128	283	0	2	285	0	0
1	212548723	rs72754324	A	G	17	15	32	0	0	32	0	0
1	212549357	rs1774247	C	T	12	3	15	0	0	15	0	0
1	212584261	rs72754339	G	A	5	6	11	0	0	11	0	0
1	212587320	rs4951595	T	C	9	18	27	0	0	27	0	0
1	212588190	rs2297306	C	A	12	15	27	0	0	27	0	0
1	212617396	rs7519771	A	C	3	3	6	0	0	6	0	0
1	212617423	rs12567517	T	G	2	4	6	0	0	6	0	0
1	212617520	rs66912346	G	T	6	4	10	0	0	10	0	0
1	212619339	rs4804	T	C	392	395	787	0	1	788	0	0
1	212785460	rs10735510	G	C	2	4	6	0	0	6	0	0
1	212793613	rs10475	T	C	458	498	956	0	2	958	0	0
1	212793849	rs1126700	A	G	685	549	1234	0	8	1242	0	0
1	212799870	rs3122713	A	G	5	8	13	0	0	13	0	0
1	212799949	rs3795842	C	T	3	5	8	0	0	8	0	0
1	213031948	rs11120047	G	C	4	3	7	0	0	7	0	0
1	213032568	rs12023052	T	A	3	4	7	0	0	7	0	0
1	213034356	rs10864009	C	T	4	2	6	0	0	6	0	0
1	213034449	rs10779585	G	A	3	3	6	0	0	6	0	0
1	213034506	rs10779586	A	C	2	4	6	0	0	6	0	0
1	213035573	rs10779587	A	T	4	5	9	0	0	9	0	0
1	213037624	rs963327	C	A	4	2	6	0	0	6	0	0
1	213037661	rs963328	G	T	3	3	6	0	0	6	0	0
1	213040774	rs10864015	A	G	2	4	6	0	0	6	0	0
1	213060906	rs10779594	C	G	4	3	7	0	0	7	0	0
1	213061030	rs2291773	G	T	5	2	7	0	0	7	0	0
1	213062067	rs10864022	T	C	8	1	9	0	0	9	0	0
1	213062158	rs10779595	T	C	8	5	13	0	0	13	0	0
1	213062180	rs11120060	G	A	6	2	8	0	0	8	0	0
1	213068595	rs3207090	C	T	41	47	88	0	1	89	0	0
1	213069258	rs11582817	T	A	4	7	11	0	0	11	0	0
1	213069420	rs6670064	C	T	8	10	18	0	0	18	0	0
1	213069783	rs6682947	A	G	15	18	33	0	0	33	0	0
1	213070425	rs12567975	C	T	8	1	9	0	0	9	0	0
1	213070458	rs12567976	C	T	11	5	16	0	0	16	0	0
1	213071051	rs10864027	G	A	13	19	32	0	1	33	0	0
1	214492286	rs1134647	G	A	6	9	15	0	0	15	0	0
1	214787130	rs2070064	G	A	4	2	6	0	0	6	0	0
1	214814571	rs3795521	C	T	2	5	7	0	0	7	0	0
1	214820099	rs3748697	A	G	8	11	19	0	0	19	0	0
1	214826196	rs335524	G	A	21	27	48	0	0	48	0	0
1	215741053	rs2275768	T	G	4	4	8	0	0	8	0	0
1	215753355	rs11803705	T	G	10	7	17	0	0	17	0	0
1	215781574	rs3767255	A	G	6	3	9	0	0	9	0	0
1	215793834	rs14137	G	A	53	57	110	0	0	110	0	0
1	216321372	.	G	A	8	0	8	0	0	8	0	0
1	217604124	rs166449	T	C	11	13	24	0	0	24	0	0
1	217753698	rs12097653	T	C	3	3	6	0	0	6	0	0
1	217776566	rs17723132	C	T	4	2	6	0	0	6	0	0
1	218467852	rs61823381	A	C	3	4	7	0	0	7	0	0
1	218511041	rs952817	A	C	3	5	8	0	0	8	0	0
1	219370603	rs11118235	C	T	5	4	9	0	0	9	0	0
1	219382614	rs1474374	C	T	3	5	8	0	0	8	0	0
1	219383192	rs6692892	T	C	6	10	16	0	1	17	0	0
1	220142023	rs1061248	C	T	48	46	94	0	0	94	0	0
1	220142070	rs1061242	C	T	64	60	124	0	0	124	0	0
1	220142671	rs3816993	T	C	4	4	8	0	0	8	0	0
1	220143553	rs1874811	T	C	3	4	7	0	0	7	0	0
1	220154768	rs1061160	C	T	42	48	90	0	0	90	0	0
1	220967683	rs1389742	A	G	2	4	6	0	0	6	0	0
1	220970028	rs2642438	A	G	2	6	8	0	0	8	0	0
1	220987155	rs2807840	A	G	8	9	17	0	0	17	0	0
1	221044966	rs12131897	T	C	11	9	20	0	0	20	0	0
1	221050400	rs2738750	G	A	5	3	8	0	0	8	0	0
1	221052640	rs2807857	T	C	5	7	12	0	0	12	0	0
1	221052937	rs2738754	A	C	25	8	33	0	1	34	0	0
1	221053545	rs12141189	T	C	150	116	266	0	1	267	0	0
1	221054761	rs17597773	C	G	3	7	10	0	0	10	0	0
1	221056390	rs868058	A	T	13	5	18	0	0	18	0	0
1	221056674	rs2491259	C	G	10	7	17	0	0	17	0	0
1	221908908	rs61823529	G	A	17	7	24	0	1	25	0	0
1	221912017	rs4846349	C	T	21	22	43	0	0	43	0	0
1	221912361	rs1141714	T	C	161	171	332	0	3	335	0	0
1	221912808	rs1136448	T	C	140	154	294	0	0	294	0	0
1	221915205	rs12043337	A	T	2	5	7	0	0	7	0	0
1	222734803	rs1134898	G	C	5	8	13	0	1	14	0	0
1	222794864	rs74145511	G	A	5	2	7	0	0	7	0	0
1	222795243	rs4846769	C	T	4	2	6	0	0	6	0	0
1	222795569	rs4846770	C	G	3	6	9	0	0	9	0	0
1	222796127	rs75328711	A	C	3	3	6	0	0	6	0	0
1	222802803	rs3748626	T	G	19	20	39	0	0	40	1	0
1	222802926	rs3008620	C	T	21	26	47	0	0	47	0	0
1	222806113	rs17163343	C	G	6	6	12	0	0	12	0	0
1	222829550	rs35158675	G	A	7	1	8	0	0	8	0	0
1	222830362	rs17163373	G	A	7	7	14	0	0	14	0	0
1	222831232	rs17531300	A	G	3	3	6	0	0	6	0	0
1	222832295	rs2291834	T	C	6	10	16	0	0	16	0	0
1	222834503	rs4575092	A	T	9	9	18	0	0	18	0	0
1	222835222	rs17163384	A	C	4	8	12	0	0	12	0	0
1	222836996	rs17465940	A	G	28	16	44	0	1	45	0	0
1	222837608	rs79024999	G	A	4	3	7	0	0	7	0	0
1	222837939	rs17465982	G	A	5	4	9	0	0	9	0	0
1	222839838	rs1053316	A	G	9	17	26	0	0	26	0	0
1	222840153	rs75711036	T	G	7	1	8	0	0	8	0	0
1	222841614	rs36079339	G	A	4	6	10	0	1	11	0	0
1	222886588	rs3748631	G	A	11	15	26	0	0	26	0	0
1	222887907	rs35762933	C	T	4	3	7	0	0	7	0	0
1	222887917	rs78981528	G	T	4	2	6	0	0	6	0	0
1	222895069	rs17532610	T	C	2	4	6	0	0	6	0	0
1	222896209	rs74367745	G	C	6	2	8	0	0	8	0	0
1	222906294	rs12043288	A	G	43	48	91	0	1	92	0	0
1	224374270	rs111611390	C	T	1	5	6	0	0	6	0	0
1	224380234	rs908804	A	G	115	129	244	0	4	248	0	0
1	224380478	rs1060386	A	G	87	66	153	0	1	154	0	0
1	224380549	rs1810346	A	G	91	84	175	0	1	176	0	0
1	224380921	rs1060394	A	T	14	10	24	0	1	25	0	0
1	224381107	rs908803	C	T	7	7	14	0	0	14	0	0
1	224415116	rs149971576	T	C	25	31	56	0	0	56	0	0
1	224579191	rs115836139	T	C	4	3	7	0	0	7	0	0
1	224614807	.	A	T	6	0	6	0	0	6	0	0
1	225142710	rs41267347	A	T	6	5	11	0	0	11	0	0
1	225156997	rs77345779	G	A	4	6	10	0	0	10	0	0
1	225157012	rs2501151	T	C	5	5	10	0	0	10	0	0
1	225318144	rs112595465	G	A	4	5	9	0	0	9	0	0
1	225578107	rs76051365	A	G	0	7	7	0	0	7	0	0
1	225585022	.	T	G	3	3	6	0	0	6	0	0
1	225589473	rs7406	C	T	520	530	1050	0	9	1059	0	0
1	225590675	rs16844841	A	C	42	43	85	0	0	86	1	0
1	225590750	rs11551874	G	C	136	130	266	0	1	267	0	0
1	225592927	rs16844846	T	G	58	51	109	0	0	109	0	0
1	225593651	rs74876325	T	G	57	51	108	0	2	110	0	0
1	225593858	rs16844847	C	A	67	49	116	0	1	117	0	0
1	225595690	rs4653635	A	G	34	43	77	0	1	78	0	0
1	225595748	rs74664817	A	G	53	52	105	0	1	106	0	0
1	225596485	rs114753357	C	T	42	36	78	0	2	80	0	0
1	225596509	rs112670158	T	C	36	28	64	0	5	70	1	0
1	225597846	rs1011319	A	G	36	25	61	0	0	61	0	0
1	225598855	rs17557867	G	A	12	15	27	0	1	28	0	0
1	225600169	rs112582692	C	T	240	206	446	0	3	449	0	0
1	225600815	rs16844853	T	C	3	6	9	0	0	9	0	0
1	225602238	rs77351919	G	A	6	1	7	0	0	7	0	0
1	225607144	rs2230419	C	T	215	190	405	0	2	407	0	0
1	225611661	rs1056607	C	T	145	150	295	0	1	296	0	0
1	225612738	rs6684787	T	C	7	3	10	0	0	10	0	0
1	225613976	rs11588279	T	C	3	3	6	0	0	6	0	0
1	226025690	rs2671267	G	A	4	2	6	0	0	6	0	0
1	226026406	rs2234922	A	G	4	5	9	0	1	10	0	0
1	226029079	rs188679861	G	A	30	38	68	0	0	68	0	0
1	226029557	rs2854452	A	G	22	28	50	0	0	50	0	0
1	226032229	rs1051741	C	T	21	23	44	0	0	44	0	0
1	226033969	rs2740174	A	G	8	8	16	0	0	16	0	0
1	226037318	rs2292558	C	G	5	5	10	0	0	10	0	0
1	226053805	rs7515156	G	A	8	10	18	0	0	18	0	0
1	226054714	rs2292563	G	A	4	9	13	0	0	13	0	0
1	226055595	rs2292564	G	A	12	12	24	0	0	24	0	0
1	226109284	rs56362902	G	A	51	39	90	0	1	91	0	0
1	226110243	rs10915898	G	A	29	26	55	0	0	55	0	0
1	226183357	rs2816324	G	A	7	7	14	0	0	14	0	0
1	226184438	rs1998273	C	T	4	2	6	0	0	6	0	0
1	226253926	rs3768543	T	C	15	17	32	0	0	32	0	0
1	226258009	rs6678547	C	T	28	30	58	0	1	59	0	0
1	226258270	rs12096468	C	T	21	23	44	0	0	44	0	0
1	226258431	rs12086044	G	A	31	21	52	0	0	52	0	0
1	226258605	.	T	C	54	51	105	0	0	105	0	0
1	226336890	rs142250059	C	T	7	6	13	0	0	13	0	0
1	226555302	rs1136410	A	G	116	87	203	0	1	204	0	0
1	226570840	rs1805415	T	C	51	68	119	0	4	123	0	0
1	226573364	rs1805414	A	G	70	48	118	0	1	119	0	0
1	226589958	rs1805404	G	A	56	36	92	0	0	92	0	0
1	226595647	rs907187	C	G	21	11	32	0	0	32	0	0
1	227156620	rs28534769	T	A	7	1	8	0	0	8	0	0
1	227156621	rs28660358	A	C	7	1	8	0	0	8	0	0
1	227157608	rs7553837	C	A	4	2	6	0	0	6	0	0
1	227162524	rs11583489	G	T	6	9	15	0	0	15	0	0
1	227165097	rs3806263	G	A	9	6	15	0	0	15	0	0
1	227170298	rs2297412	A	G	25	30	55	0	0	55	0	0
1	227170543	rs2297413	C	G	12	8	20	0	0	20	0	0
1	227171737	rs1574184	G	T	4	14	18	0	2	20	0	0
1	227172290	rs12593	C	T	294	262	556	0	3	559	0	0
1	227172935	rs2297416	C	G	3	3	6	0	0	6	0	0
1	227173537	rs3768420	C	T	4	5	9	0	0	9	0	0
1	227173892	rs17592479	T	A	4	7	11	0	0	11	0	0
1	227174145	rs7552783	T	C	3	4	7	0	0	7	0	0
1	227174210	rs3738725	T	C	331	411	742	0	3	745	0	0
1	227174902	rs8159	G	A	502	424	926	0	7	933	0	0
1	227177731	rs1186	A	T	11	10	21	0	0	21	0	0
1	227178127	rs3768425	A	G	7	8	15	0	0	15	0	0
1	227178700	rs1045290	A	G	5	2	7	0	0	7	0	0
1	227179037	rs1045286	G	T	3	3	6	0	0	6	0	0
1	227179054	rs1045285	G	A	4	3	7	0	0	7	0	0
1	227181554	rs1062908	C	G	10	4	14	0	0	14	0	0
1	227181555	rs1045252	A	G	9	4	13	0	0	13	0	0
1	227181838	rs3795449	T	G	8	7	15	0	0	15	0	0
1	227181923	rs3795451	C	T	7	4	11	0	0	11	0	0
1	227214566	rs7549586	A	G	16	6	22	0	0	22	0	0
1	227214745	rs61834039	C	G	10	4	14	0	0	14	0	0
1	227215537	rs7555621	T	C	7	4	11	0	0	11	0	0
1	227216662	rs1929861	T	C	5	5	10	0	0	10	0	0
1	227216775	rs1929860	C	T	11	3	14	0	0	14	0	0
1	227845952	rs6699448	G	A	2	4	6	0	0	6	0	0
1	227920061	rs1060295	T	G	16	16	32	0	1	33	0	0
1	227920103	rs3087908	G	A	20	17	37	0	0	37	0	0
1	227935444	rs2236359	A	G	7	3	10	0	0	10	0	0
1	227968033	rs9786978	T	C	3	6	9	0	0	9	0	0
1	227968107	rs10799448	G	A	2	5	7	0	0	7	0	0
1	228275671	rs78044256	T	A	4	5	9	0	0	9	0	0
1	228277247	rs112401439	A	G	3	8	11	0	0	11	0	0
1	228279248	.	T	C	3	6	9	0	1	10	0	0
1	228330525	rs111433618	G	A	10	8	18	0	1	19	0	0
1	228471379	rs56168609	G	C	7	2	9	0	0	9	0	0
1	228681095	rs151188248	C	T	3	3	6	0	0	6	0	0
1	228681749	rs3795817	C	T	123	201	324	0	5	329	0	0
1	228682330	rs12542	C	G	171	212	383	0	3	386	0	0
1	229426985	rs237767	A	T	4	3	7	0	0	7	0	0
1	229439581	rs9069	A	T	187	194	381	0	1	382	0	0
1	229457639	rs237797	G	C	35	47	82	0	0	82	0	0
1	229458456	rs1088	G	A	23	30	53	0	0	53	0	0
1	229458632	rs237799	T	C	44	66	110	0	1	111	0	0
1	229460323	rs237800	G	C	19	25	44	0	0	44	0	0
1	229460356	rs2282082	C	T	22	25	47	0	0	47	0	0
1	229729769	rs41309641	C	T	16	20	36	0	0	36	0	0
1	229729777	rs41315605	C	T	18	20	38	0	0	38	0	0
1	230227094	rs10864683	T	G	5	6	11	0	0	11	0	0
1	230227101	rs2038395	G	A	5	6	11	0	0	11	0	0
1	230227208	rs12029443	C	G	4	7	11	0	0	11	0	0
1	231111477	rs11122172	C	G	8	1	9	0	0	9	0	0
1	231111922	rs7525753	A	C	8	0	8	0	0	8	0	0
1	231488524	rs2437150	C	T	27	32	59	0	0	59	0	0
1	231490105	rs2437149	C	T	24	24	48	0	0	48	0	0
1	231502245	rs1435167	T	A	8	5	13	0	0	13	0	0
1	231502310	rs1435166	T	C	10	11	21	0	1	22	0	0
1	231504311	rs2066140	G	C	1	5	6	0	0	6	0	0
1	231505527	rs2739516	G	A	7	7	14	0	1	15	0	0
1	231527787	rs2248652	G	A	7	3	10	0	0	10	0	0
1	231527805	rs2248649	G	A	8	2	10	0	0	10	0	0
1	231528415	rs2024878	C	A	5	5	10	0	0	11	1	0
1	231528638	rs2024879	A	G	11	6	17	0	0	17	0	0
1	231529183	rs2739506	T	G	8	1	9	0	0	9	0	0
1	231529491	rs2790886	A	C	9	8	17	0	0	17	0	0
1	231529610	rs2749708	G	A	6	4	10	0	0	10	0	0
1	231529925	rs2790885	C	T	5	3	8	0	0	8	0	0
1	231530098	rs11582413	C	G	3	4	7	0	0	7	0	0
1	231530415	rs2474629	A	G	4	2	6	0	0	6	0	0
1	231530723	rs2808596	A	G	5	3	8	0	0	8	0	0
1	231531166	rs2883799	C	G	5	1	6	0	0	6	0	0
1	231531232	rs743120	C	T	6	2	8	0	0	8	0	0
1	231531627	rs480902	T	C	4	2	6	0	0	6	0	0
1	231532351	rs2808597	T	C	7	1	8	0	0	8	0	0
1	231532725	rs2808598	C	T	3	5	8	0	0	8	0	0
1	231532726	rs2790883	A	G	3	5	8	0	0	8	0	0
1	231532783	rs2790882	C	T	3	3	6	0	0	6	0	0
1	231534389	rs2790879	A	C	9	0	9	0	0	9	0	0
1	231534390	rs2790878	T	C	9	0	9	0	0	9	0	0
1	231537543	rs2749711	G	A	5	2	7	0	0	7	0	0
1	231658301	rs1059595	A	G	7	9	16	0	0	16	0	0
1	231906589	rs2492367	C	T	10	8	18	0	0	18	0	0
1	232176195	rs980989	G	T	11	6	17	0	0	17	0	0
1	232176306	rs9308481	G	A	9	6	15	0	1	16	0	0
1	232534957	rs12043251	T	C	16	13	29	0	0	29	0	0
1	233515071	rs963982	C	T	3	4	7	0	0	7	0	0
1	233515102	rs963981	T	G	3	5	8	0	0	8	0	0
1	233518291	rs34794284	C	T	4	8	12	0	0	12	0	0
1	233519825	rs1294230	C	T	2	4	6	0	0	6	0	0
1	233520199	rs1294228	T	G	2	4	6	0	0	6	0	0
1	233520845	rs1294227	T	C	1	7	8	0	0	8	0	0
1	234508956	rs11549817	A	C	66	140	206	0	1	207	0	0
1	234509259	rs10910420	G	C	22	17	39	0	0	39	0	0
1	234541124	rs12137933	C	A	7	8	15	0	0	15	0	0
1	234543878	rs74147465	T	C	13	6	19	0	0	19	0	0
1	234546014	rs72763876	G	A	6	3	9	0	1	10	0	0
1	234546354	rs41266235	C	T	8	13	21	0	0	21	0	0
1	234565176	rs111283864	C	T	48	31	79	0	0	79	0	0
1	234569192	rs3754311	T	C	32	22	54	0	0	54	0	0
1	234582720	rs139816698	C	T	41	11	52	0	1	53	0	0
1	234584288	rs114916639	G	A	29	17	46	0	0	46	0	0
1	234609113	rs271776	A	C	5	1	6	0	0	6	0	0
1	234740141	rs8823	G	A	19	21	40	0	0	40	0	0
1	234740549	rs1329126	A	C	57	74	131	0	1	132	0	0
1	234740880	rs1329125	C	T	86	69	155	0	3	158	0	0
1	234743237	rs7543281	G	A	2458	2252	4710	0	6	4717	1	0
1	234745009	rs7545855	A	G	1	6	7	0	0	7	0	0
1	235273525	.	G	A	191	177	368	0	3	371	0	0
1	235299787	rs77968671	G	A	8	1	9	0	0	9	0	0
1	235302256	rs4659549	T	C	13	11	24	0	0	24	0	0
1	235303232	rs79902876	C	T	5	3	8	0	0	8	0	0
1	235305217	rs67736021	G	A	4	3	7	0	0	8	1	0
1	235317741	rs4660042	C	T	7	1	8	0	0	8	0	0
1	235319373	rs4659601	C	G	12	5	17	0	0	17	0	0
1	235322660	rs6429293	T	C	4	5	9	0	0	9	0	0
1	235337761	rs7339935	T	C	4	3	7	0	0	7	0	0
1	235377979	rs6677573	T	G	6	3	9	0	0	9	0	0
1	235378344	rs10925125	G	A	12	8	20	0	1	21	0	0
1	235378659	rs10925127	C	T	10	3	13	0	0	13	0	0
1	235378767	rs10925128	T	G	7	2	9	0	0	9	0	0
1	235378896	rs7531921	A	G	4	3	7	0	1	8	0	0
1	235378898	rs7531922	A	G	5	3	8	0	0	8	0	0
1	235379186	rs4659647	G	A	4	3	7	0	1	8	0	0
1	235381955	rs113046585	G	C	4	5	9	0	0	9	0	0
1	235382775	rs4659653	T	C	2	5	7	0	0	7	0	0
1	235383188	rs4659654	A	G	102	100	202	0	0	202	0	0
1	235385934	rs12027832	A	G	21	8	29	0	0	29	0	0
1	235389233	rs12743844	T	C	3	4	7	0	0	7	0	0
1	235389998	rs12027647	G	A	6	5	11	0	0	11	0	0
1	235390396	rs10495362	T	C	3	3	6	0	0	6	0	0
1	235391264	rs10925162	C	T	12	11	23	0	0	23	0	0
1	235391446	rs1933246	T	C	11	12	23	0	1	24	0	0
1	235392083	rs4659673	A	C	7	19	26	0	0	26	0	0
1	235392354	rs4659674	T	A	3	5	8	0	0	8	0	0
1	235392546	rs12731746	T	C	88	65	153	0	7	160	0	0
1	235399332	rs12034913	C	T	5	3	8	0	0	8	0	0
1	235464620	rs12736498	A	C	5	2	7	0	0	7	0	0
1	235492546	rs3806393	T	G	5	6	11	0	0	11	0	0
1	235492972	rs12044028	T	G	14	8	22	0	0	22	0	0
1	235493804	rs10754614	G	A	14	6	20	0	0	20	0	0
1	235611285	rs6429095	G	C	11	5	16	0	0	16	0	0
1	235611293	rs6429096	G	A	9	4	13	0	0	13	0	0
1	236139817	rs1048316	C	T	8	10	18	0	0	18	0	0
1	236139894	rs1048311	T	G	12	4	16	0	0	16	0	0
1	236140266	rs1048253	A	C	9	6	15	0	0	15	0	0
1	236140739	rs873	G	A	2	5	7	0	0	7	0	0
1	236141174	rs3213190	T	C	6	6	12	0	1	13	0	0
1	236144951	rs3738525	A	G	6	3	9	0	0	9	0	0
1	236208773	rs10733133	C	T	5	3	8	0	0	8	0	0
1	236227408	rs7534529	G	C	2	4	6	0	0	6	0	0
1	236380077	rs6428948	G	A	4	7	11	0	0	11	0	0
1	237048500	rs1805087	A	G	10	6	16	0	0	16	0	0
1	237054569	rs2229276	A	G	11	13	24	0	0	24	0	0
1	237056436	rs3845567	G	A	5	1	6	0	0	6	0	0
1	237056519	rs113686118	A	G	3	5	8	0	0	8	0	0
1	237056601	rs11802532	C	T	3	3	6	0	0	6	0	0
1	237056710	rs72762130	A	G	1	8	9	0	0	9	0	0
1	237056713	rs72762132	C	A	1	9	10	0	0	10	0	0
1	237058744	rs12070777	C	A	19	16	35	0	0	35	0	0
1	237061849	rs1131450	G	A	5	9	14	0	0	14	0	0
1	237062628	rs1804742	C	T	17	27	44	0	0	44	0	0
1	237063504	rs9779	A	G	22	23	45	0	1	46	0	0
1	239567159	.	A	G	4	6	10	0	0	10	0	0
1	239814783	rs16832154	C	T	1	5	6	0	0	6	0	0
1	239868385	rs10737838	C	T	0	6	6	0	0	6	0	0
1	239877537	rs6684622	G	C	0	6	6	0	0	6	0	0
1	241793186	rs1062226	C	G	14	17	31	0	0	31	0	0
1	242011534	rs1776178	A	G	4	2	6	0	0	6	0	0
1	242012033	rs1635517	G	A	11	15	26	0	1	27	0	0
1	242030151	rs735943	A	G	33	26	59	0	0	59	0	0
1	242031369	rs111636594	C	T	4	5	9	0	1	10	0	0
1	242031934	rs12138714	C	T	6	4	10	0	0	10	0	0
1	242033643	rs2298931	T	C	4	3	7	0	0	7	0	0
1	242033783	rs851782	A	G	2	7	9	0	0	9	0	0
1	242035382	rs4149963	C	T	30	21	51	0	0	51	0	0
1	242035722	rs851780	G	A	18	14	32	0	0	32	0	0
1	242042301	rs1047840	G	A	17	3	20	0	0	20	0	0
1	242042545	rs1776148	A	G	7	10	17	0	1	18	0	0
1	242053838	rs4150027	T	C	7	5	12	0	0	12	0	0
1	243348854	rs10803122	A	T	30	52	82	0	0	82	0	0
1	243355204	rs10926961	G	A	6	4	10	0	0	10	0	0
1	243368709	rs12067429	G	C	4	3	7	0	0	7	0	0
1	243374815	rs12072595	T	G	42	32	74	0	1	75	0	0
1	243390825	rs4634890	A	C	4	2	6	0	0	6	0	0
1	243396119	rs6669104	C	T	6	7	13	0	0	13	0	0
1	243396326	rs10926974	C	T	4	2	6	0	0	6	0	0
1	243416525	rs3904683	T	C	7	9	16	0	0	16	0	0
1	243416792	rs6668649	T	C	6	4	10	0	1	11	0	0
1	243419429	rs3904682	T	A	32	13	45	0	2	47	0	0
1	243469029	rs12758920	G	A	5	8	13	0	0	13	0	0
1	243471192	rs953492	A	G	4	3	7	0	0	7	0	0
1	243481431	rs2783972	A	G	56	40	96	0	0	96	0	0
1	243481556	rs2636323	C	G	63	52	115	0	0	115	0	0
1	243493907	rs2275155	A	T	7	9	16	0	1	17	0	0
1	243579112	rs10927011	G	A	11	10	21	0	1	22	0	0
1	243663893	rs14403	C	T	4	3	7	0	0	7	0	0
1	243667216	rs67027895	C	T	3	3	6	0	0	6	0	0
1	243982709	rs6681863	C	G	5	16	21	0	0	21	0	0
1	243983723	rs7552659	T	C	16	16	32	0	0	32	0	0
1	243983830	rs10927078	C	T	12	20	32	0	0	32	0	0
1	243983877	rs7552820	T	C	20	11	31	0	1	32	0	0
1	243985979	rs113085028	C	G	6	6	12	0	0	12	0	0
1	243986344	rs28869008	C	A	5	6	11	0	0	11	0	0
1	244002773	rs4590656	C	T	6	5	11	0	0	11	0	0
1	244003446	rs10803162	C	T	3	7	10	0	0	10	0	0
1	244585203	rs6669301	A	G	3	3	6	0	0	6	0	0
1	244605036	rs3003214	G	A	8	5	13	0	0	13	0	0
1	244605781	rs74698979	A	G	6	4	10	0	0	10	0	0
1	244608181	rs3003213	A	C	8	3	11	0	1	12	0	0
1	244609092	rs3006004	G	A	9	8	17	0	0	17	0	0
1	244609323	rs61843978	C	T	5	3	8	0	0	8	0	0
1	244612252	rs3003212	A	G	8	5	13	0	1	14	0	0
1	244612984	rs3003211	T	C	4	2	6	0	0	6	0	0
1	244613791	rs6667957	T	C	6	2	8	0	0	8	0	0
1	245005085	rs12058012	G	C	39	53	92	0	1	93	0	0
1	245005373	rs10927335	A	G	22	14	36	0	0	36	0	0
1	245005713	rs12095737	A	C	21	24	45	0	3	48	0	0
1	245005828	rs12070200	C	T	26	21	47	0	0	47	0	0
1	245005841	rs12096894	T	A	26	18	44	0	1	45	0	0
1	245005874	rs55872760	C	G	18	13	31	0	3	34	0	0
1	245006827	rs1053700	A	G	29	40	69	0	2	71	0	0
1	245012509	rs12146095	T	G	3	7	10	0	0	10	0	0
1	245013807	rs1495946	G	A	5	7	12	0	1	13	0	0
1	245018624	rs10927336	C	A	30	13	43	0	0	43	0	0
1	245020285	rs1874393	T	C	3	3	6	0	0	6	0	0
1	245023311	rs12069105	G	A	26	16	42	0	2	44	0	0
1	245023365	rs12079538	C	T	18	14	32	0	1	33	0	0
1	245025692	rs12124462	A	T	22	22	44	0	0	44	0	0
1	245245402	rs10927387	C	T	9	2	11	0	0	11	0	0
1	245251020	rs1047707	G	T	7	7	14	0	0	14	0	0
1	245252343	rs11806396	G	A	6	2	8	0	0	8	0	0
1	245254044	rs10927390	T	C	6	3	9	0	0	9	0	0
1	245254522	rs41267523	A	G	2	11	13	0	0	13	0	0
1	245255022	rs2945	C	T	6	5	11	0	0	11	0	0
1	246021941	rs2362587	T	C	35	39	74	0	0	74	0	0
1	246670481	rs7520453	C	G	4	14	18	0	0	18	0	0
1	246704563	rs764243	C	T	5	4	9	0	1	10	0	0
1	246704684	rs3124107	G	A	4	7	11	0	0	11	0	0
1	246704690	rs3129566	A	G	4	7	11	0	0	11	0	0
1	246705165	rs3120697	A	C	5	6	11	0	0	11	0	0
1	246705277	rs3129567	A	G	7	7	14	0	0	14	0	0
1	246705935	rs3124112	C	T	3	4	7	0	0	7	0	0
1	246707569	rs1999849	C	T	2	4	6	0	0	6	0	0
1	246707858	rs3129568	A	G	107	87	194	0	2	196	0	0
1	246712292	rs3129575	C	T	17	6	23	0	1	24	0	0
1	246712409	rs3129576	G	C	14	15	29	0	0	29	0	0
1	246713736	rs3120705	A	G	9	6	15	0	0	15	0	0
1	246714022	rs3120706	C	T	10	11	21	0	0	21	0	0
1	246714728	rs9426201	G	A	7	4	11	0	0	11	0	0
1	246714799	rs3124069	G	A	4	6	10	0	0	10	0	0
1	246714837	rs3124070	T	C	8	6	14	0	0	14	0	0
1	246714878	rs3129577	G	C	9	6	15	0	0	15	0	0
1	246715647	rs10465617	A	G	4	6	10	0	0	10	0	0
1	246715961	rs2340791	A	G	6	2	8	0	0	8	0	0
1	246716019	rs12138869	T	C	8	3	11	0	0	11	0	0
1	246716048	rs2340792	T	A	6	3	9	0	0	9	0	0
1	246716393	rs12742618	G	A	3	6	9	0	0	9	0	0
1	246716501	rs12742513	C	T	1	6	7	0	1	8	0	0
1	246716505	rs55873125	A	G	6	2	8	0	0	8	0	0
1	246716517	rs56177973	C	T	6	2	8	0	0	8	0	0
1	246716604	rs4654291	C	T	4	2	6	0	0	6	0	0
1	246716730	rs4654292	A	G	7	3	10	0	0	10	0	0
1	246716949	rs56263741	G	A	9	0	9	0	0	9	0	0
1	246717298	rs12082288	T	C	5	9	14	0	0	14	0	0
1	246717371	rs10465618	C	T	7	9	16	0	1	17	0	0
1	246717391	rs55741541	A	G	10	7	17	0	0	17	0	0
1	246717466	rs56367289	G	A	7	7	14	0	0	14	0	0
1	246717673	rs35452631	G	A	5	6	11	0	0	11	0	0
1	246717818	rs61852366	C	T	3	7	10	0	0	10	0	0
1	246718977	rs7536768	G	A	3	5	8	0	0	8	0	0
1	246722561	rs3124072	T	C	8	2	10	0	0	10	0	0
1	246723313	rs2341679	C	T	4	8	12	0	0	12	0	0
1	246724195	rs114242021	C	T	5	3	8	0	0	8	0	0
1	246730205	.	C	T	8	8	16	0	0	16	0	0
1	246821599	rs4402097	A	G	3	8	11	0	0	11	0	0
1	246931057	rs3314	A	G	10	11	21	0	1	22	0	0
1	246954297	rs6680122	G	A	7	4	11	0	0	11	0	0
1	246954313	rs10924831	A	G	5	6	11	0	0	11	0	0
1	246954502	rs12117291	G	A	4	3	7	0	0	7	0	0
1	246954925	rs12080111	C	T	4	7	11	0	0	11	0	0
1	246955392	rs1130067	C	T	33	26	59	0	0	59	0	0
1	247004031	rs1047080	T	C	105	109	214	0	1	215	0	0
1	247004705	rs12127941	C	T	6	2	8	0	0	8	0	0
1	247006160	rs5021094	G	T	16	7	23	0	0	23	0	0
1	247006173	rs181009716	A	C	14	9	23	0	0	23	0	0
1	247008439	rs7549408	C	T	6	2	8	0	0	8	0	0
1	247008860	rs7528980	G	A	5	2	7	0	0	7	0	0
1	247009346	rs80110842	G	A	3	5	8	0	0	8	0	0
1	247009885	rs12127681	C	A	4	3	7	0	0	7	0	0
1	247010734	rs6688227	C	T	4	3	7	0	0	7	0	0
1	247010926	rs111816815	C	T	5	2	7	0	0	7	0	0
1	247021085	rs41308162	G	C	135	112	247	0	1	248	0	0
1	247027779	rs1691251	T	C	6	7	13	0	1	14	0	0
1	247043604	rs141097043	C	A	6	3	9	0	0	9	0	0
1	247044692	rs2642984	A	C	4	3	7	0	0	7	0	0
1	247046568	rs116252630	T	G	5	9	14	0	0	14	0	0
1	247048834	rs2642990	T	C	51	45	96	0	1	97	0	0
1	247081904	rs10924865	C	T	5	3	8	0	0	8	0	0
1	247083302	.	G	A	5	3	8	0	0	8	0	0
1	247092780	rs1619941	T	A	5	1	6	0	0	6	0	0
1	247149918	rs4971306	G	A	6	2	8	0	0	8	0	0
1	247149996	rs4971310	A	G	5	4	9	0	0	9	0	0
1	247150740	rs3749427	T	C	9	7	16	0	0	16	0	0
1	247151557	rs2642992	A	G	5	3	8	0	0	8	0	0
1	247350690	rs1132779	G	C	2	4	6	0	0	6	0	0
1	247350700	rs1053388	A	T	3	4	7	0	0	7	0	0
1	247351474	rs6426226	G	A	1	5	6	0	0	6	0	0
1	247351643	rs6704274	C	A	6	5	11	0	0	11	0	0
1	247351679	rs6670847	T	C	7	8	15	0	0	15	0	0
1	247353355	rs1115201	G	A	79	97	176	0	0	176	0	0
1	247353783	rs12071728	T	C	77	68	145	0	0	145	0	0
1	247354072	rs6663099	C	A	55	38	93	0	0	93	0	0
1	247354581	rs6678604	A	C	2	5	7	0	0	7	0	0
1	247355029	rs12131404	A	G	5	2	7	0	0	7	0	0
1	247359065	rs10802475	C	T	6	2	8	0	0	8	0	0
1	247362215	rs72770363	A	G	8	4	12	0	0	12	0	0
1	247362287	rs10924961	G	A	3	7	10	0	0	10	0	0
1	247364063	rs17720872	C	A	26	24	50	0	0	50	0	0
1	247365430	rs10754539	A	G	1	6	7	0	0	7	0	0
1	247366435	rs11811599	C	A	4	8	12	0	0	12	0	0
1	247370225	rs10924965	C	T	5	2	7	0	0	7	0	0
1	247372672	rs6691539	C	T	46	103	149	0	0	149	0	0
1	247372875	rs72770374	G	A	27	38	65	0	1	66	0	0
1	247373628	rs4314914	T	C	9	11	20	0	4	24	0	0
1	247373894	rs56338561	T	C	14	5	19	0	0	19	0	0
1	247374243	rs56123640	C	A	5	7	12	0	0	12	0	0
1	247389874	rs72770388	T	A	3	3	6	0	0	6	0	0
1	247588053	rs34298354	C	T	30	32	62	0	1	64	1	0
1	247594890	rs12564791	C	T	2	4	6	0	0	6	0	0
1	247612036	rs10754558	G	C	49	67	116	0	0	116	0	0
1	247737928	rs12401701	A	T	22	35	57	0	2	59	0	0
1	247739213	rs12402077	A	G	13	29	42	0	0	42	0	0
1	247740764	rs12405268	C	A	30	33	63	0	0	63	0	0
1	248023966	rs3737277	C	T	14	11	25	0	0	25	0	0
1	248027152	rs4925572	T	C	3	3	6	0	0	6	0	0
1	248028219	rs946696	G	A	15	36	51	0	0	51	0	0
1	248039451	rs3811444	C	T	13	9	22	0	0	22	0	0
1	248040018	rs4925574	A	G	3	7	10	0	0	10	0	0
1	248041417	rs45445998	A	T	15	5	20	0	0	20	0	0
1	248041821	rs66858280	C	G	14	26	40	0	0	40	0	0
1	248042937	rs72774616	C	T	36	34	70	0	3	73	0	0
1	248043238	rs61855717	C	T	39	29	68	0	0	68	0	0
1	248043646	rs11204537	G	A	5	2	7	0	0	7	0	0
1	248059456	rs12135078	G	A	11	9	20	0	0	20	0	0
1	248059476	rs12139390	A	C	12	11	23	0	0	23	0	0
1	248059703	rs11204545	T	A	20	36	56	0	1	57	0	0
1	248059712	rs11204546	T	C	21	41	62	0	0	62	0	0
1	248059856	rs10888268	T	C	17	32	49	0	0	49	0	0
1	248059896	.	T	C	19	31	50	0	0	50	0	0
1	248060230	rs10888269	C	T	25	33	58	0	0	58	0	0
1	248060279	rs10888270	C	T	21	46	67	0	0	67	0	0
1	248060380	rs946697	C	G	13	18	31	0	9	40	0	0
1	248084511	.	T	C	18	3	21	0	1	22	0	0
1	248436805	.	T	G	6	0	6	0	0	6	0	0
1	249141454	rs11555324	C	T	14	16	30	0	0	30	0	0
10	856918	rs4229	A	T	9	9	18	0	0	18	0	0
10	858394	rs7703	C	T	34	25	59	0	0	59	0	0
10	889323	rs11253462	T	G	1	6	7	0	0	7	0	0
10	953874	rs34254874	G	T	43	47	90	0	0	90	0	0
10	1056169	rs71494945	C	T	9	12	21	0	1	22	0	0
10	1058032	rs11253573	G	C	8	6	14	0	0	14	0	0
10	1098426	rs184920178	T	C	4	3	7	0	0	7	0	0
10	1142750	rs10794718	C	T	7	3	10	0	0	10	0	0
10	1143104	rs72760943	G	A	4	2	6	0	0	6	0	0
10	1143435	rs34034003	G	A	2	5	7	0	0	7	0	0
10	1143827	rs12784270	C	T	5	5	10	0	1	11	0	0
10	1144630	rs3793774	G	A	8	5	13	0	0	13	0	0
10	1145284	rs34964132	C	A	5	5	10	0	1	11	0	0
10	1146556	rs183316888	A	C	4	2	6	0	0	6	0	0
10	1147045	rs4880763	G	A	8	3	11	0	0	11	0	0
10	1170974	.	C	T	5	2	7	0	0	7	0	0
10	3144607	rs12773602	T	A	7	1	8	0	1	9	0	0
10	3145541	rs2892550	G	T	43	24	67	0	0	67	0	0
10	3145885	rs10903966	T	C	12	26	38	0	1	39	0	0
10	3145906	rs11251719	A	C	17	25	42	0	0	42	0	0
10	3146155	rs2306293	C	G	25	25	50	0	1	51	0	0
10	3147010	rs4269839	G	T	25	46	71	0	0	71	0	0
10	3147501	rs4881081	C	T	14	7	21	0	1	22	0	0
10	3147518	rs2388576	G	C	8	12	20	0	0	20	0	0
10	3147519	rs2892549	G	C	7	11	18	0	2	20	0	0
10	3154461	rs2306302	G	A	93	95	188	0	1	189	0	0
10	3155620	rs1052309	A	G	57	53	110	0	0	110	0	0
10	3155698	rs4881086	C	T	82	71	153	0	0	153	0	0
10	3155770	rs4881088	G	A	8	13	21	0	1	22	0	0
10	3155790	rs4881089	C	T	5	15	20	0	1	21	0	0
10	3156168	rs2388567	C	T	19	5	24	0	0	24	0	0
10	3156642	rs4281389	T	C	12	5	17	0	1	18	0	0
10	3156699	rs4881090	A	G	4	14	18	0	2	20	0	0
10	3156877	rs4881092	C	A	5	14	19	0	0	19	0	0
10	3156900	rs11251723	T	C	19	3	22	0	0	22	0	0
10	3156901	rs11251724	G	A	19	3	22	0	0	22	0	0
10	3157078	rs4881095	G	A	2	15	17	0	0	17	0	0
10	3157094	rs35375917	C	A	18	2	20	0	0	20	0	0
10	3157109	rs34260521	T	C	19	5	24	0	0	24	0	0
10	3157131	rs12250915	A	T	27	5	32	0	0	32	0	0
10	3157218	rs74112075	G	A	7	29	36	0	0	36	0	0
10	3157230	rs34795068	C	T	28	7	35	0	0	35	0	0
10	3157498	.	T	C	0	16	16	0	1	17	0	0
10	3157507	rs71502280	A	G	7	10	17	0	1	18	0	0
10	3157895	rs9423680	A	T	3	24	27	0	1	28	0	0
10	3158646	rs7916889	A	G	19	5	24	0	0	24	0	0
10	3158848	rs7086902	C	T	65	6	71	0	0	71	0	0
10	3159777	rs7915264	C	G	3	3	6	0	0	6	0	0
10	3162486	rs3814589	G	A	4	2	6	0	0	6	0	0
10	3183185	rs10903975	G	A	22	35	57	0	2	59	0	0
10	3183747	rs7094698	A	G	21	37	58	0	0	58	0	0
10	3184507	rs7898695	A	G	12	12	24	0	0	24	0	0
10	3189380	rs3740607	C	T	46	49	95	0	1	96	0	0
10	3214942	rs11818724	T	C	5	5	10	0	0	10	0	0
10	3818497	rs2129439	C	T	33	38	71	0	3	74	0	0
10	3819714	rs1043009	C	T	943	895	1838	0	9	1847	0	0
10	3820787	rs1043003	T	C	393	434	827	0	8	835	0	0
10	3821561	rs17731	G	A	438	394	832	0	6	838	0	0
10	3825343	rs10795076	G	T	5	4	9	0	0	9	0	0
10	5319882	rs34066814	A	G	4	2	6	0	0	6	0	0
10	5680842	rs2386649	C	T	11	8	19	0	0	19	0	0
10	5680884	rs1132305	G	A	32	35	67	0	0	67	0	0
10	5680896	rs1573	A	G	38	34	72	0	0	72	0	0
10	5680914	rs2386648	T	A	45	35	80	0	0	80	0	0
10	5681783	rs11256474	C	T	29	31	60	0	0	60	0	0
10	5682070	rs3750645	C	T	30	18	48	0	0	48	0	0
10	5682304	rs12414278	C	G	27	25	52	0	1	53	0	0
10	5781628	rs2254067	T	G	2	6	8	0	0	8	0	0
10	5781969	rs2797486	A	T	11	8	19	0	0	19	0	0
10	5784151	rs45575338	A	G	4	9	13	0	0	13	0	0
10	5788608	rs2797491	G	C	6	2	8	0	0	8	0	0
10	5791578	rs45596231	G	T	15	10	25	0	0	25	0	0
10	5799613	rs2275774	A	G	31	24	55	0	0	55	0	0
10	5804531	rs2797501	G	A	31	26	57	0	0	57	0	0
10	5808086	rs1129614	G	A	261	243	504	0	5	509	0	0
10	5810458	rs61836362	C	A	5	1	6	0	1	7	0	0
10	5844392	rs11599810	T	C	5	4	9	0	0	9	0	0
10	5845061	rs74116316	A	G	3	6	9	0	0	9	0	0
10	5848838	rs7095103	T	C	6	2	8	0	1	9	0	0
10	5855225	rs3736460	G	A	55	81	136	0	2	138	0	0
10	5920121	rs1052420	T	C	5	4	9	0	0	9	0	0
10	5925971	rs631947	C	A	5	9	14	0	0	14	0	0
10	5958072	rs668498	A	G	11	9	20	0	1	21	0	0
10	5959602	rs11553630	C	T	15	35	50	0	1	51	0	0
10	5964726	rs17404756	G	A	6	3	9	0	0	9	0	0
10	5967158	rs2669126	C	T	7	5	12	0	0	12	0	0
10	5972130	rs622758	A	G	4	2	6	0	0	6	0	0
10	5972168	rs664577	C	A	3	3	6	0	0	6	0	0
10	5977935	rs633930	T	C	13	7	20	0	0	20	0	0
10	5978411	rs646406	T	C	7	3	10	0	0	10	0	0
10	5979497	rs2387091	A	T	16	14	30	0	0	30	0	0
10	5985625	rs10752157	C	A	5	12	17	0	1	18	0	0
10	5990979	.	C	T	9	8	17	0	0	17	0	0
10	5994694	rs2296135	A	C	35	21	56	0	0	56	0	0
10	5995434	rs3136631	C	G	8	3	11	0	0	11	0	0
10	5998285	rs3136627	G	A	3	3	6	0	0	6	0	0
10	6000409	rs12260233	T	C	1	5	6	0	0	6	0	0
10	6001483	rs3136619	A	G	4	3	7	0	0	7	0	0
10	6002368	rs2228059	T	G	45	24	69	0	1	70	0	0
10	6019015	rs8177633	C	G	4	2	6	0	0	6	0	0
10	6138153	rs7100767	T	A	5	4	9	0	0	9	0	0
10	6141942	rs7902931	A	G	6	4	10	0	1	11	0	0
10	6145634	rs77010471	A	T	3	3	6	0	0	6	0	0
10	6148897	rs7904213	C	T	12	12	24	0	0	24	0	0
10	6155806	rs2274359	T	C	4	9	13	0	1	14	0	0
10	6155847	rs2274358	A	G	5	11	16	0	1	17	0	0
10	6155870	rs2274357	T	C	9	6	15	0	0	15	0	0
10	6268422	rs943117	A	G	6	10	16	0	0	16	0	0
10	6269855	rs7071157	T	C	8	11	19	0	0	19	0	0
10	6270465	rs3793721	G	T	8	7	15	0	0	15	0	0
10	6270511	rs12357847	A	G	12	9	21	0	0	21	0	0
10	6270618	rs56341765	A	T	11	18	29	0	0	29	0	0
10	6274511	rs11257456	T	G	9	23	32	0	0	32	0	0
10	6275145	rs1539232	T	C	135	114	249	0	0	249	0	0
10	6275602	rs3750667	C	T	163	135	298	0	2	300	0	0
10	6275776	rs55643411	T	C	165	161	326	0	2	328	0	0
10	6275784	rs3829148	C	G	145	149	294	0	3	297	0	0
10	6276574	rs1064891	T	C	182	170	352	0	3	355	0	0
10	6276743	rs1539234	G	A	304	309	613	0	2	615	0	0
10	6469324	rs4750439	C	T	62	77	139	0	1	140	0	0
10	6469673	rs2453	C	T	49	45	94	0	5	99	0	0
10	6469817	rs2236380	A	G	36	40	76	0	1	77	0	0
10	6472891	rs11258747	G	T	20	21	41	0	0	41	0	0
10	6473041	rs34157770	C	A	6	5	11	0	0	11	0	0
10	6474678	rs629321	T	C	3	3	6	0	0	6	0	0
10	6474683	rs11258762	G	A	3	3	6	0	0	6	0	0
10	6475296	rs631968	T	C	4	3	7	0	0	7	0	0
10	6492903	rs11517376	A	G	4	2	6	0	0	6	0	0
10	6493906	rs1090701	T	G	2	6	8	0	0	8	0	0
10	6495630	rs186687946	C	G	4	2	6	0	1	7	0	0
10	6495642	rs549269374	A	T	4	2	6	0	0	6	0	0
10	6495643	rs370663732	A	C	4	2	6	0	0	6	0	0
10	6498723	rs11258943	G	A	48	30	78	0	0	78	0	0
10	6632391	rs2435588	G	A	4	5	9	0	0	9	0	0
10	7390612	rs77832620	C	T	2	4	6	0	0	6	0	0
10	7809075	rs11596873	G	A	6	2	8	0	0	8	0	0
10	7841582	rs1244425	G	T	44	21	65	0	0	65	0	0
10	7842900	rs12770829	C	T	3	5	8	0	0	8	0	0
10	7844195	rs932971	C	T	3	3	6	0	0	6	0	0
10	7844906	rs1244431	T	G	6	5	11	0	1	12	0	0
10	7845298	rs1244432	T	A	9	10	19	0	1	20	0	0
10	7845769	rs762453	G	A	5	7	12	0	0	12	0	0
10	7846974	rs1244434	C	T	13	10	23	0	0	23	0	0
10	7847441	rs1244435	G	T	7	6	13	0	0	13	0	0
10	7847666	rs1139105	C	T	8	3	11	0	0	11	0	0
10	7847701	rs112605338	C	T	5	1	6	0	0	6	0	0
10	7847802	rs1137807	C	T	12	7	19	0	0	19	0	0
10	7848481	rs1244438	G	A	16	16	32	0	0	32	0	0
10	7848604	rs1244439	A	G	13	8	21	0	0	21	0	0
10	7849688	rs4655	T	C	380	393	773	0	0	773	0	0
10	7938507	rs12572952	C	T	11	10	21	0	0	21	0	0
10	7938508	rs12569620	A	G	11	10	21	0	0	21	0	0
10	7938830	rs10905242	C	T	10	8	18	0	0	18	0	0
10	8006798	rs4747647	A	G	15	18	33	0	0	33	0	0
10	8007559	rs10795583	G	C	33	30	63	0	1	64	0	0
10	8007560	rs1244229	T	C	33	28	61	0	1	62	0	0
10	8097368	rs10905277	G	A	13	1	14	0	0	14	0	0
10	8116598	rs1058240	G	A	19	10	29	0	0	29	0	0
10	11205719	rs606139	A	G	3	3	6	0	1	7	0	0
10	11231831	rs624964	A	G	2	7	9	0	0	9	0	0
10	11232579	rs622981	T	A	26	71	97	0	1	98	0	0
10	11234850	rs1998859	C	T	5	2	7	0	0	7	0	0
10	11234859	rs1998860	A	G	5	2	7	0	0	7	0	0
10	11235174	rs7084916	A	G	17	17	34	0	1	35	0	0
10	11237032	rs6602481	C	T	5	1	6	0	0	6	0	0
10	11237928	rs3243	G	A	21	3	24	0	0	24	0	0
10	11242471	rs17452064	G	C	5	1	6	0	0	6	0	0
10	11242780	rs7085721	G	A	3	3	6	0	0	6	0	0
10	11242806	rs530242536	G	C	3	3	6	0	0	6	0	0
10	11245951	rs10752215	G	A	3	6	9	0	0	9	0	0
10	11246269	rs1109861	C	A	6	5	11	0	0	11	0	0
10	11248549	rs10905918	C	T	6	7	13	0	0	13	0	0
10	11250990	rs56170700	A	G	12	14	26	0	0	26	0	0
10	11258812	rs11596782	G	A	2	4	6	0	0	6	0	0
10	11258834	rs4750029	G	A	4	2	6	0	0	6	0	0
10	11267303	rs11594733	C	T	4	4	8	0	0	8	0	0
10	11268348	rs74582934	A	G	6	5	11	0	0	11	0	0
10	11272938	rs76527036	T	C	3	7	10	0	1	11	0	0
10	11273393	rs7913575	G	A	12	12	24	0	0	24	0	0
10	11273752	rs7091391	C	T	12	1	13	0	0	13	0	0
10	11299735	rs2277212	A	T	99	134	233	0	3	236	0	0
10	11310498	rs56251303	C	T	2	11	13	0	0	13	0	0
10	11317502	.	C	T	11	2	13	0	0	13	0	0
10	11355993	rs11257056	G	A	6	3	9	0	0	9	0	0
10	11356160	rs2246449	C	T	100	98	198	0	0	198	0	0
10	11357267	rs2938016	G	A	3	9	12	0	0	12	0	0
10	11361182	rs11596315	A	T	9	11	20	0	0	20	0	0
10	11361186	rs11596316	A	G	10	12	22	0	0	22	0	0
10	11362317	rs10795860	G	A	4	6	10	0	0	10	0	0
10	11363811	rs2134360	T	C	15	8	23	0	1	24	0	0
10	11364202	rs4750043	G	A	22	19	41	0	0	41	0	0
10	11364336	rs4747901	G	T	21	10	31	0	0	31	0	0
10	11364607	rs75669541	T	G	14	9	23	0	0	23	0	0
10	11376211	.	G	A	43	39	82	0	0	82	0	0
10	11377611	rs117045678	T	G	92	89	181	0	1	182	0	0
10	11499355	rs112681524	T	C	9	7	16	0	0	16	0	0
10	11501270	rs80033310	C	A	3	9	12	0	0	12	0	0
10	11916375	rs189637716	A	C	21	4	25	0	0	25	0	0
10	11936298	rs10906034	G	A	4	2	6	0	0	6	0	0
10	11936311	rs11257396	A	G	2	4	6	0	0	6	0	0
10	11936420	rs12356904	C	T	8	1	9	0	0	9	0	0
10	11936590	rs11257397	G	A	5	2	7	0	0	7	0	0
10	12059469	rs12415895	T	C	2	4	6	0	0	6	0	0
10	12061576	rs10906049	A	G	4	7	11	0	0	11	0	0
10	12062814	rs10906050	T	C	4	4	8	0	0	8	0	0
10	12062899	rs11257486	C	T	2	4	6	0	0	6	0	0
10	12063253	rs7072138	A	G	3	4	7	0	0	7	0	0
10	12068542	rs12415637	C	T	17	14	31	0	0	31	0	0
10	12069562	rs7079622	T	C	4	7	11	0	0	11	0	0
10	12081623	.	T	C	15	3	18	0	1	19	0	0
10	12081910	rs7090241	G	T	3	5	8	0	0	8	0	0
10	12081920	rs7090246	G	T	3	4	7	0	0	7	0	0
10	12803627	rs4750256	C	T	4	13	17	0	0	17	0	0
10	12803670	rs4237428	G	A	6	15	21	0	0	21	0	0
10	13142153	rs71492279	T	C	3	6	9	0	1	10	0	0
10	13152400	rs11258194	T	A	64	47	111	0	0	111	0	0
10	13159197	rs599557	T	C	5	2	7	0	0	7	0	0
10	13159362	rs58505537	G	A	1	7	8	0	0	8	0	0
10	13160035	rs57057378	G	A	6	4	10	0	0	10	0	0
10	13160103	rs10752286	A	T	3	3	6	0	0	6	0	0
10	13160212	rs57199113	T	C	4	3	7	0	0	7	0	0
10	13164596	rs489040	A	G	5	15	20	0	0	20	0	0
10	13165481	rs2043947	C	G	16	13	29	0	0	29	0	0
10	13174759	rs67121368	A	T	11	13	24	0	0	24	0	0
10	13178057	rs12766076	C	T	2	4	6	0	0	6	0	0
10	13230950	rs2296222	C	T	6	8	14	0	1	15	0	0
10	13243688	rs11258249	C	T	4	8	12	0	0	12	0	0
10	13243898	rs10796037	C	T	5	6	11	0	0	11	0	0
10	13244086	rs2399951	T	C	5	6	11	0	0	11	0	0
10	13244255	rs118168867	G	T	8	4	12	0	0	12	0	0
10	13251973	.	T	G	5	3	8	0	0	8	0	0
10	13333621	rs487041	A	G	4	3	7	0	0	7	0	0
10	13678192	rs12358828	C	T	4	2	6	0	0	6	0	0
10	13680726	rs4393223	G	A	5	5	10	0	0	10	0	0
10	13694443	rs10752313	C	G	4	3	7	0	0	7	0	0
10	13695245	rs7912538	A	G	4	3	7	0	0	7	0	0
10	13697651	rs73588485	C	G	23	29	52	0	0	52	0	0
10	14562201	rs72784927	G	A	68	98	166	0	3	169	0	0
10	14562793	rs11259151	C	T	67	61	128	0	6	134	0	0
10	14562980	rs12774550	G	A	105	109	214	0	0	214	0	0
10	14567254	rs11259153	T	C	11	25	36	0	1	37	0	0
10	14567265	rs11259154	A	G	11	25	36	0	0	36	0	0
10	14567412	rs11259155	A	G	15	11	26	0	0	26	0	0
10	14568839	.	A	T	9	3	12	0	1	13	0	0
10	14569088	rs12779738	G	A	5	5	10	0	0	10	0	0
10	14571363	rs7918464	C	T	15	14	29	0	0	29	0	0
10	14596685	rs7919989	C	T	5	3	8	0	0	8	0	0
10	14597668	rs11259182	A	G	2	5	7	0	0	7	0	0
10	14608429	rs71485519	C	T	5	6	11	0	0	11	0	0
10	14608701	rs876653	T	C	6	1	7	0	0	7	0	0
10	14610626	.	T	C	4	6	10	0	3	13	0	0
10	14629880	rs4750533	G	A	7	14	21	0	0	21	0	0
10	14630742	rs17155529	T	C	8	4	12	0	0	13	1	0
10	14630979	rs10906708	G	A	9	1	10	0	0	10	0	0
10	14632092	rs7907299	T	C	5	7	12	0	0	12	0	0
10	14634382	rs77610675	T	G	3	4	7	0	0	7	0	0
10	14642116	.	C	T	4	4	8	0	0	8	0	0
10	14880394	rs45622935	G	T	63	67	130	0	2	132	0	0
10	14880395	rs45480695	C	T	64	68	132	0	0	132	0	0
10	14909255	rs61751214	T	C	192	160	352	0	0	352	0	0
10	15902303	rs2297882	A	G	20	29	49	0	0	49	0	0
10	15902425	rs71493236	G	A	13	12	25	0	0	25	0	0
10	16796919	rs1049632	C	A	32	30	62	0	0	62	0	0
10	17362094	rs3167993	T	C	4	9	13	0	0	13	0	0
10	17362487	rs11254523	A	G	4	3	7	0	0	7	0	0
10	17395849	rs3740161	C	G	9	7	16	0	0	16	0	0
10	17396003	rs7897402	C	T	10	5	15	0	0	15	0	0
10	17396016	rs3740159	T	C	8	4	12	0	0	12	0	0
10	17396680	rs17140695	T	C	6	0	6	0	0	6	0	0
10	17396842	rs41309393	G	A	9	3	12	0	0	12	0	0
10	17397202	rs45539934	C	G	4	2	6	0	1	7	0	0
10	17397228	rs17140702	T	C	4	4	8	0	1	9	0	0
10	17397323	rs17140705	T	C	3	3	6	0	0	6	0	0
10	17409513	rs17140876	T	G	5	1	6	0	0	6	0	0
10	17428774	rs371210	C	T	12	7	19	0	0	19	0	0
10	17428781	rs436491	C	T	11	8	19	0	0	19	0	0
10	17428782	rs436489	C	T	11	8	19	0	0	19	0	0
10	17428910	rs436299	C	G	20	5	25	0	1	26	0	0
10	17481318	rs12252590	A	G	4	2	6	0	0	6	0	0
10	17482625	rs11254598	G	C	7	2	9	0	0	9	0	0
10	17484160	rs7917628	T	C	20	4	24	0	0	24	0	0
10	17484620	rs7901548	A	G	7	4	11	0	0	11	0	0
10	17486038	rs11254602	G	A	7	9	16	0	0	16	0	0
10	17487328	rs10508542	A	G	8	4	12	0	0	12	0	0
10	17487663	rs61564840	G	C	2	6	8	0	0	8	0	0
10	17487900	rs59320988	G	A	5	10	15	0	0	15	0	0
10	17491652	rs3928773	T	C	3	4	7	0	0	7	0	0
10	17492134	rs60184208	G	A	4	4	8	0	0	8	0	0
10	17492619	rs11254604	C	T	2	4	6	0	0	6	0	0
10	17654492	rs4237346	A	G	3	7	10	0	0	10	0	0
10	17654585	rs4237347	A	G	7	19	26	0	1	27	0	0
10	17655981	rs2461891	T	C	7	12	19	0	0	19	0	0
10	18941677	rs45528733	C	T	4	3	7	0	0	7	0	0
10	20155618	rs61842779	C	T	4	3	7	0	0	7	0	0
10	20156372	rs7910510	G	A	8	3	11	0	0	11	0	0
10	20361079	rs9663749	G	A	4	2	6	0	0	6	0	0
10	20577204	rs118186859	T	A	3	4	7	0	0	7	0	0
10	20577412	rs2297490	C	T	10	4	14	0	0	14	0	0
10	21783634	rs12770228	G	A	2	4	6	0	0	6	0	0
10	21827796	rs1802669	G	A	39	38	77	0	0	77	0	0
10	22019212	rs10828265	C	T	2	5	7	0	0	7	0	0
10	22255599	rs2666761	A	G	13	10	23	0	1	24	0	0
10	22255701	rs2666762	G	A	6	2	8	0	0	8	0	0
10	22276819	rs4146689	A	C	4	2	6	0	0	6	0	0
10	22725413	rs7073797	G	T	21	7	28	0	0	28	0	0
10	22727279	rs77396787	A	G	4	10	14	0	0	14	0	0
10	23408278	rs7427	C	T	38	36	74	0	1	75	0	0
10	24873369	rs1127893	C	G	53	41	94	0	2	96	0	0
10	24880712	rs10828678	G	A	3	3	6	0	0	6	0	0
10	25008363	rs10764491	C	T	3	3	6	0	0	6	0	0
10	25137772	rs1045873	A	C	9	3	12	0	0	12	0	0
10	26879174	rs1775238	C	T	2	9	11	0	0	11	0	0
10	27400861	rs9833	G	A	339	288	627	0	2	629	0	0
10	27405331	rs7901976	C	T	5	1	6	0	0	6	0	0
10	27405763	rs1755401	A	C	12	5	17	0	2	19	0	0
10	27405969	rs4142123	T	C	17	6	23	0	0	23	0	0
10	27414778	rs11015549	G	A	19	3	22	0	0	22	0	0
10	27416747	rs6482596	T	G	18	28	46	0	0	46	0	0
10	27417670	rs11015557	C	T	17	6	23	0	0	27	4	0
10	27420185	rs7901653	T	G	19	14	33	0	0	33	0	0
10	27434968	rs11015570	G	T	18	7	25	0	0	25	0	0
10	27436295	rs3780926	A	C	4	6	10	0	0	10	0	0
10	27443623	rs3758403	C	G	12	15	27	0	0	27	0	0
10	27444303	rs3824593	G	A	6	13	19	0	0	19	0	0
10	27444328	rs7919803	C	A	10	23	33	0	0	33	0	0
10	27444329	rs7907981	T	C	10	23	33	0	0	33	0	0
10	27444344	rs7907988	T	G	11	32	43	0	0	43	0	0
10	27444763	rs7900024	C	A	6	2	8	0	0	8	0	0
10	27445726	rs1253045	G	A	4	3	7	0	0	7	0	0
10	27449062	rs10764678	G	C	2	5	7	0	0	7	0	0
10	27457932	rs788237	C	T	7	3	10	0	0	10	0	0
10	27459670	rs1981296	C	T	71	104	175	0	0	175	0	0
10	27469101	rs10829201	T	C	3	7	10	0	0	10	0	0
10	27469165	rs10829202	T	A	4	5	9	0	0	9	0	0
10	27469503	rs11015589	T	A	5	4	9	0	0	10	1	0
10	27469678	rs11015590	G	T	5	11	16	0	1	17	0	0
10	27472110	rs1557167	T	A	6	4	10	0	0	10	0	0
10	27473235	rs788219	G	A	3	5	8	0	0	8	0	0
10	27473901	rs1557168	A	G	11	7	18	0	1	19	0	0
10	27474078	rs1557169	A	G	5	3	8	0	0	8	0	0
10	27475010	rs10764685	C	T	5	6	11	0	0	11	0	0
10	27475444	rs10741130	T	C	83	132	215	0	6	221	0	0
10	27475494	rs10764686	T	C	89	119	208	0	4	212	0	0
10	27475693	rs1338	T	C	11	24	35	0	0	35	0	0
10	27508758	rs10764690	T	C	44	42	86	0	0	86	0	0
10	27810575	rs61843363	A	G	3	6	9	0	0	9	0	0
10	27820742	rs2763308	C	G	7	3	10	0	0	10	0	0
10	27821004	rs11598492	A	G	7	5	12	0	0	12	0	0
10	27830433	rs11015861	G	A	10	20	30	0	0	30	0	0
10	28812059	rs2993991	A	G	64	45	109	0	0	109	0	0
10	28812066	rs2998283	C	T	67	43	110	0	2	112	0	0
10	28812519	.	T	G	33	32	65	0	2	67	0	0
10	28813672	rs2491252	G	C	17	28	45	0	0	45	0	0
10	28814237	rs2993992	C	T	11	1	12	0	0	12	0	0
10	28814292	rs2491251	A	G	16	11	27	0	0	27	0	0
10	28828526	rs2790442	T	C	16	9	25	0	0	25	0	0
10	28840114	rs332119	A	C	3	4	7	0	0	7	0	0
10	28841214	rs332121	G	A	1	5	6	0	0	6	0	0
10	28842474	rs332124	C	T	5	4	9	0	0	9	0	0
10	28843022	rs2012189	C	T	11	8	19	0	0	19	0	0
10	28874226	rs332150	A	G	5	2	7	0	0	7	0	0
10	28874260	rs332151	G	T	4	2	6	0	0	6	0	0
10	28880394	rs332154	C	A	5	1	6	0	0	6	0	0
10	28893614	rs332165	G	A	3	3	6	0	0	6	0	0
10	28899099	rs332171	C	T	4	2	6	0	0	6	0	0
10	28902261	rs332173	C	T	9	6	15	0	0	15	0	0
10	28902618	rs2532744	T	G	6	4	10	0	0	10	0	0
10	28903771	rs332174	G	A	16	9	25	0	1	26	0	0
10	28910715	rs332182	C	T	3	3	6	0	0	6	0	0
10	28910924	rs332183	G	A	8	2	10	0	0	10	0	0
10	28910979	rs167967	T	C	8	5	13	0	0	13	0	0
10	29710788	rs16930212	C	T	0	19	19	0	0	19	0	0
10	29711903	rs4749422	T	G	0	15	15	0	0	15	0	0
10	29714336	rs16930216	G	A	0	9	9	0	0	9	0	0
10	29715181	rs12770932	G	A	0	12	12	0	0	12	0	0
10	29715292	rs12770626	A	G	0	7	7	0	0	7	0	0
10	29715442	rs12770852	A	G	0	7	7	0	0	7	0	0
10	29716353	rs8317	C	T	33	0	33	0	0	33	0	0
10	29746931	.	A	G	44	33	77	0	3	80	0	0
10	29757491	rs4747659	A	G	2	4	6	0	0	6	0	0
10	29758819	rs16930249	C	G	5	5	10	0	0	10	0	0
10	29779936	rs45519332	G	A	13	17	30	0	1	31	0	0
10	29783885	.	A	G	18	16	34	0	1	35	0	0
10	29784072	.	G	C	11	12	23	0	0	23	0	0
10	29784489	rs12775988	T	C	2	7	9	0	1	10	0	0
10	29784569	rs6481606	C	T	3	5	8	0	0	8	0	0
10	29799404	rs7909205	T	C	6	0	6	0	0	6	0	0
10	29800468	rs16930343	G	A	1	5	6	0	0	6	0	0
10	29812602	rs7070678	G	T	11	5	16	0	0	16	0	0
10	30013333	rs943693	C	T	3	18	21	0	3	24	0	0
10	30013785	rs7075682	C	T	1	9	10	0	0	10	0	0
10	30019868	rs12359769	C	T	0	17	17	0	0	17	0	0
10	30626003	rs12221163	C	T	23	12	35	0	0	35	0	0
10	30626669	rs10826782	C	T	13	5	18	0	0	18	0	0
10	30626802	rs17295122	G	C	7	14	21	0	0	21	0	0
10	30628014	rs112454617	T	A	12	14	26	0	0	26	0	0
10	30628326	rs2254837	G	C	8	8	16	0	0	16	0	0
10	30723831	rs306589	A	G	37	34	71	0	0	71	0	0
10	30727084	rs303448	G	T	65	63	128	0	0	128	0	0
10	30727454	rs928620	G	A	132	116	248	0	6	254	0	0
10	30728101	rs1042058	T	C	553	731	1284	0	2	1286	0	0
10	30728250	rs2907	A	G	521	593	1114	0	6	1120	0	0
10	30728489	rs303446	C	T	141	112	253	0	0	253	0	0
10	32094768	rs12770195	T	A	3	3	6	0	0	6	0	0
10	32094890	rs1023207	C	A	1	5	6	0	0	6	0	0
10	32095249	rs1044795	T	G	5	3	8	0	0	8	0	0
10	32095666	rs2799002	T	C	4	7	11	0	0	11	0	0
10	32128611	rs2808096	A	G	5	1	6	0	1	7	0	0
10	32181320	rs2998362	C	T	3	3	6	0	0	6	0	0
10	32328526	rs1251363	G	C	3	4	7	0	0	7	0	0
10	32391505	rs211403	T	C	0	8	8	0	0	8	0	0
10	33207144	rs137894702	G	A	2	4	6	0	0	6	0	0
10	33222583	.	T	G	7	16	23	0	0	23	0	0
10	35302141	rs61841047	T	C	5	2	7	0	1	8	0	0
10	35768261	.	A	G	1	5	6	0	0	6	0	0
10	36812251	rs41276114	C	T	12	0	12	0	0	12	0	0
10	38240207	rs41306330	G	A	6	5	11	0	0	11	0	0
10	38410329	.	T	A	7	5	12	0	0	12	0	0
10	43010627	rs210233	C	T	11	9	20	0	1	21	0	0
10	43012693	rs210236	T	C	5	7	12	0	0	12	0	0
10	43014780	rs210238	T	C	5	3	8	0	0	8	0	0
10	43031479	rs210255	G	T	2	7	9	0	0	9	0	0
10	43085513	rs210284	G	C	4	2	6	0	0	6	0	0
10	43281089	rs7074877	T	C	34	33	67	0	1	68	0	0
10	43309435	rs56178200	C	T	4	2	6	0	0	6	0	0
10	43309516	rs11239782	G	A	3	5	8	0	0	8	0	0
10	43311389	rs11239785	A	G	8	7	15	0	2	17	0	0
10	43311489	rs12770094	G	C	6	2	8	0	1	9	0	0
10	43312227	rs3867298	A	G	10	5	15	0	0	15	0	0
10	43312413	rs787796	T	C	3	4	7	0	0	7	0	0
10	43325593	rs112097011	C	T	6	10	16	0	0	16	0	0
10	43325606	rs10900276	A	G	5	10	15	0	0	15	0	0
10	43326627	rs7133	A	C	233	195	428	0	3	431	0	0
10	43881094	rs1126709	T	G	3	5	8	0	0	8	0	0
10	43883342	rs1126487	T	A	224	182	406	0	4	410	0	0
10	43892947	rs574356591	G	C	6	5	11	0	0	11	0	0
10	43893347	rs7918726	G	T	9	3	12	0	0	12	0	0
10	43893544	rs10732897	T	C	6	2	8	0	0	8	0	0
10	43894339	rs7084706	A	T	1	5	6	0	0	6	0	0
10	43978087	rs3750890	A	G	1	5	6	0	0	6	0	0
10	44142292	rs3128246	G	A	6	4	10	0	0	10	0	0
10	44142583	rs3123672	C	T	4	7	11	0	0	11	0	0
10	45472045	rs7013	A	G	87	98	185	0	2	187	0	0
10	45499799	rs11471	T	C	83	79	162	0	0	162	0	0
10	45869700	rs72561472	G	C	14	6	20	0	1	21	0	0
10	45869713	rs4987106	C	G	16	9	25	0	0	25	0	0
10	45869748	rs4987105	C	T	19	18	37	0	2	39	0	0
10	45921754	rs72796477	C	T	3	6	9	0	1	10	0	0
10	45923511	rs74130823	T	C	2	4	6	0	0	6	0	0
10	45923528	rs2279435	C	A	4	2	6	0	0	6	0	0
10	45923739	.	A	G	7	5	12	0	0	12	0	0
10	45937992	rs10751383	A	C	42	26	68	0	0	68	0	0
10	45938239	rs2242332	T	C	24	43	67	0	2	69	0	0
10	45938301	rs2242334	G	T	39	46	85	0	0	85	0	0
10	45938677	rs28395868	G	A	26	32	58	0	0	58	0	0
10	45938746	rs1051713	C	T	21	27	48	0	1	49	0	0
10	45939617	rs2229136	A	G	54	60	114	0	2	116	0	0
10	45939991	rs56145077	C	T	5	2	7	0	0	7	0	0
10	45951081	rs3740109	T	C	83	160	243	0	3	246	0	0
10	45951716	rs3740111	G	A	70	136	206	0	2	208	0	0
10	45952433	rs3824618	C	T	42	96	138	0	0	138	0	0
10	45952745	rs3802548	T	A	60	34	94	0	0	94	0	0
10	45952929	rs3824616	T	C	42	72	114	0	2	116	0	0
10	45956828	rs3764990	G	A	33	60	93	0	0	93	0	0
10	45958676	rs17157825	G	A	3	3	6	0	0	6	0	0
10	45961020	rs34731408	C	T	2	5	7	0	0	7	0	0
10	46016975	rs80222863	C	T	3	4	7	0	0	7	0	0
10	46018831	rs11239549	A	G	3	4	7	0	0	7	0	0
10	46087519	rs78766622	A	G	4	2	6	0	0	6	0	0
10	46089047	rs35047800	C	T	0	17	17	0	0	17	0	0
10	46089925	rs112035106	C	T	9	15	24	0	0	24	0	0
10	46120766	rs113334563	A	C	5	1	6	0	0	6	0	0
10	46120790	rs112161062	T	C	3	3	6	0	0	6	0	0
10	46120794	rs111993247	T	C	3	3	6	0	0	6	0	0
10	46143958	rs17854567	T	G	51	39	90	0	0	90	0	0
10	46222724	rs10793625	C	G	4	2	6	0	1	7	0	0
10	46223203	rs61855809	C	T	4	6	10	0	0	10	0	0
10	46223222	rs111623877	C	G	4	3	7	0	0	7	0	0
10	46245557	rs112842230	T	C	67	42	109	0	1	110	0	0
10	46246300	rs2805163	A	G	5	1	6	0	0	6	0	0
10	46252268	rs183435787	T	C	5	4	9	0	0	9	0	0
10	46252933	.	C	A	6	2	8	0	0	8	0	0
10	46253590	.	A	T	5	1	6	0	0	6	0	0
10	46282365	.	G	A	12	5	17	0	0	17	0	0
10	47420614	rs61843707	G	A	4	2	6	0	1	7	0	0
10	47911590	rs201265056	G	A	7	0	7	0	0	7	0	0
10	47911591	rs61843879	T	G	7	0	7	0	0	7	0	0
10	48425993	rs9860	C	T	4	4	8	0	0	8	0	0
10	48426347	rs3007	T	A	3	8	11	0	0	11	0	0
10	48902368	.	C	T	18	13	31	0	0	31	0	0
10	48902651	.	G	C	3	4	7	0	0	7	0	0
10	49564143	rs117384438	A	G	15	1	16	0	0	16	0	0
10	49565231	rs111373649	C	G	15	1	16	0	0	16	0	0
10	49581415	rs2590383	T	A	2	12	14	0	0	14	0	0
10	49581550	rs116982594	G	A	11	23	34	0	0	34	0	0
10	49631564	rs17698086	G	A	3	3	6	0	0	6	0	0
10	49647267	rs11598320	T	A	43	48	91	0	0	91	0	0
10	49659351	rs1867587	C	T	7	4	11	0	0	11	0	0
10	49659559	rs10776601	C	T	8	8	16	0	0	16	0	0
10	49701873	rs10745277	G	A	8	3	11	0	0	11	0	0
10	49704732	rs10857585	T	C	0	6	6	0	0	6	0	0
10	50020323	rs2250389	T	C	6	2	8	0	0	8	0	0
10	50020326	rs2377655	C	A	6	2	8	0	0	8	0	0
10	50022040	rs41283275	G	A	3	3	6	0	0	6	0	0
10	50034833	rs6537579	G	A	6	3	9	0	0	9	0	0
10	50038800	rs3747874	A	G	6	7	13	0	0	13	0	0
10	50038878	rs41283281	G	C	9	7	16	0	0	16	0	0
10	50098739	rs41283283	G	C	5	3	8	0	0	8	0	0
10	50362930	rs12198	C	T	20	16	36	0	0	36	0	0
10	50363454	rs7081097	C	A	5	5	10	0	0	10	0	0
10	51026705	rs8474	C	G	17	24	41	0	1	42	0	0
10	51028791	rs17776131	G	T	6	0	6	0	0	6	0	0
10	51464993	.	G	T	8	2	10	0	0	10	0	0
10	51465333	.	T	G	7	2	9	0	0	9	0	0
10	51573788	rs7922121	T	C	7	4	11	0	0	11	0	0
10	51580467	rs78937603	C	G	1	5	6	0	1	7	0	0
10	51586514	rs11597667	T	A	6	10	16	0	0	16	0	0
10	51588177	rs10995571	G	A	3	7	10	0	0	10	0	0
10	51607633	.	C	T	4	5	9	0	0	9	0	0
10	51607952	.	T	C	2	4	6	0	0	6	0	0
10	51607980	.	G	A	3	3	6	0	0	6	0	0
10	51623147	.	C	T	0	6	6	0	0	6	0	0
10	51623174	.	C	A	1	6	7	0	0	7	0	0
10	51623190	.	T	C	1	6	7	0	0	7	0	0
10	51631812	.	A	G	4	3	7	0	0	7	0	0
10	51632971	.	A	G	7	3	10	0	0	10	0	0
10	51633027	.	T	C	11	4	15	0	0	15	0	0
10	51723270	rs12778942	C	T	8	6	14	0	0	14	0	0
10	51723277	rs12764268	A	T	7	6	13	0	0	13	0	0
10	51724692	.	C	T	7	3	10	0	1	11	0	0
10	51725731	rs543874228	G	A	4	3	7	0	0	7	0	0
10	51726017	rs2490916	C	T	7	5	12	0	1	13	0	0
10	51726823	rs7098724	G	T	3	5	8	0	0	8	0	0
10	51728101	rs61847131;rs75513388	A	G	7	9	16	0	1	17	0	0
10	51733508	.	A	G	24	15	39	0	0	39	0	0
10	51748584	.	A	G	6	4	10	0	0	10	0	0
10	51748684	rs61848260	G	A	1	7	8	0	0	8	0	0
10	51769579	rs201531094	G	A	42	42	84	0	0	84	0	0
10	51769799	rs61848275	C	T	11	11	22	0	0	22	0	0
10	51770130	.	C	T	49	5	54	0	0	54	0	0
10	51827763	rs4935425	A	G	5	5	10	0	0	10	0	0
10	51885927	.	G	A	74	0	74	0	0	74	0	0
10	54507233	rs7914226	G	T	2	4	6	0	0	6	0	0
10	60121976	rs11006120	C	G	4	5	9	0	0	9	0	0
10	60156584	rs11006133	G	A	15	17	32	0	4	36	0	0
10	60156595	rs16912200	A	G	19	17	36	0	2	38	0	0
10	60156864	rs41283696	C	T	20	23	43	0	1	44	0	0
10	60157339	rs7089361	C	T	15	20	35	0	1	36	0	0
10	62554500	rs1060373	G	A	54	56	110	0	1	111	0	0
10	64564892	rs2236295	G	T	6	2	8	0	0	8	0	0
10	64564934	rs10995311	C	G	6	4	10	0	0	10	0	0
10	64566258	rs224082	C	T	37	26	63	0	0	63	0	0
10	64914372	rs13095	G	C	63	51	114	0	0	114	0	0
10	64927823	rs1935	C	G	289	269	558	0	2	560	0	0
10	64932777	rs72829157	G	C	12	5	17	0	0	17	0	0
10	64934548	rs10822145	C	T	9	8	17	0	0	17	0	0
10	64937314	rs35854283	G	A	5	1	6	0	0	6	0	0
10	64942111	rs34119992	T	C	5	2	7	0	0	7	0	0
10	64953959	rs2306264	C	G	1	5	6	0	0	6	0	0
10	65188318	rs10761763	T	C	19	7	26	0	0	26	0	0
10	65188403	rs17740989	C	T	4	10	14	0	0	14	0	0
10	65225450	rs1054693	C	T	3	5	8	0	0	8	0	0
10	65380587	rs1133386	A	G	7	6	13	0	1	14	0	0
10	67331219	rs12763767	T	C	4	2	6	0	0	6	0	0
10	67345248	rs7096393	G	C	2	7	9	0	0	9	0	0
10	69649495	rs34234131	G	A	4	3	7	0	0	7	0	0
10	69655960	rs116843273	G	T	3	4	7	0	0	7	0	0
10	69661358	rs33955981	T	C	5	2	7	0	0	7	0	0
10	69673245	rs7091896	C	G	12	9	21	0	0	21	0	0
10	69773841	rs866255	G	A	5	2	7	0	0	7	0	0
10	69828210	rs471341	C	T	4	9	13	0	0	13	0	0
10	69829397	rs608300	C	T	10	11	21	0	0	21	0	0
10	69830250	rs148073945	C	T	7	9	16	0	0	16	0	0
10	69833347	rs534611	C	A	7	3	10	0	0	10	0	0
10	70661532	rs10998478	C	T	19	12	31	0	0	31	0	0
10	70661571	rs10998479	C	T	14	6	20	0	1	21	0	0
10	70664200	rs74146504	C	T	3	7	10	0	0	10	0	0
10	70666068	rs118051852	G	C	35	26	61	0	0	61	0	0
10	70700944	rs5030900	A	G	126	145	271	0	2	273	0	0
10	70730628	rs12411932	C	T	5	8	13	0	0	13	0	0
10	70731286	rs74139951	G	T	15	4	19	0	0	19	0	0
10	70732545	rs10998511	C	T	13	9	22	0	0	22	0	0
10	70739921	rs2394503	G	A	5	2	7	0	0	7	0	0
10	70742931	rs12412103	A	G	75	91	166	0	0	166	0	0
10	70743422	rs4554	G	A	93	76	169	0	4	173	0	0
10	70749644	rs79521970	G	A	7	8	15	0	0	15	0	0
10	70751127	rs2255855	G	A	4	2	6	0	0	6	0	0
10	70776594	rs6864	A	C	10	6	16	0	1	17	0	0
10	70848771	rs7910971	C	T	9	9	18	0	0	18	0	0
10	70848902	rs17473271	G	A	8	10	18	0	0	18	0	0
10	70849892	rs11815080	G	A	12	10	22	0	0	22	0	0
10	70849933	rs11815086	G	A	13	11	24	0	0	24	0	0
10	70849959	rs2855022	G	A	11	11	22	0	0	22	0	0
10	70850048	rs11817109	T	C	10	6	16	0	0	16	0	0
10	70850138	rs11815117	G	A	16	17	33	0	0	33	0	0
10	70850195	rs2805906	C	G	12	10	22	0	0	22	0	0
10	70850280	rs11815118	C	T	7	11	18	0	0	18	0	0
10	70850676	rs17558167	A	G	14	17	31	0	0	31	0	0
10	70850791	rs17558195	C	T	14	27	41	0	0	41	0	0
10	70851873	rs17558246	T	C	36	33	69	0	0	69	0	0
10	70852417	rs34046436	G	A	6	6	12	0	0	12	0	0
10	70852831	rs3998843	G	A	223	50	273	0	3	276	0	0
10	70855404	rs11817899	C	A	4	2	6	0	0	6	0	0
10	70856455	rs2805907	G	A	5	8	13	0	0	13	0	0
10	70857810	rs17558323	C	G	8	6	14	0	0	14	0	0
10	70859204	rs10998572	C	A	7	4	11	0	0	11	0	0
10	70860046	rs77898236	C	G	6	4	10	0	0	10	0	0
10	70860848	rs35935154	C	T	11	3	14	0	0	14	0	0
10	70861859	rs12412035	T	C	7	3	10	0	0	10	0	0
10	70864397	rs7377	G	T	2229	1819	4048	0	12	4061	1	0
10	70884013	rs5030909	G	A	44	63	107	0	1	108	0	0
10	70892791	rs5030932	C	T	110	102	212	0	1	213	0	0
10	70930186	rs114755790	A	G	60	26	86	0	1	87	0	0
10	70930360	rs12256853	A	G	56	61	117	0	2	119	0	0
10	70931199	rs34811737	G	A	66	75	141	0	1	142	0	0
10	70931640	rs11552062	G	T	74	74	148	0	2	150	0	0
10	70952031	rs10823312	A	G	10	10	20	0	0	20	0	0
10	70953315	rs2135587	A	G	10	7	17	0	0	17	0	0
10	70953419	rs2135588	G	A	13	9	22	0	0	22	0	0
10	70954234	rs12244906	A	C	6	15	21	0	0	21	0	0
10	70954375	rs12267611	T	G	11	16	27	0	0	27	0	0
10	70955056	rs5018859	A	G	17	7	24	0	0	24	0	0
10	70956108	rs34566525	C	T	5	3	8	0	0	8	0	0
10	70957484	rs35346079	C	G	12	11	23	0	0	23	0	0
10	70957525	rs7904007	G	A	11	8	19	0	0	19	0	0
10	70958327	rs5030911	C	T	13	9	22	0	0	22	0	0
10	70959027	rs2271096	A	C	14	18	32	0	2	34	0	0
10	70959543	rs1506768	A	G	24	17	41	0	1	42	0	0
10	70960529	rs10823315	C	T	2	4	6	0	0	6	0	0
10	70967232	rs12780778	A	G	2	4	6	0	0	6	0	0
10	71103597	rs1133189	C	G	38	39	77	0	0	77	0	0
10	71144256	rs5030915	A	G	15	25	40	0	1	41	0	0
10	71144324	rs2305196	G	A	16	16	32	0	0	32	0	0
10	71144869	rs749108	C	T	2	4	6	0	0	6	0	0
10	71145047	rs1867975	C	T	5	3	8	0	0	8	0	0
10	71152091	rs2278745	T	C	4	4	8	0	0	8	0	0
10	71152563	rs61173401	C	T	5	3	8	0	0	8	0	0
10	71153066	rs28510843	C	T	5	4	9	0	0	9	0	0
10	71169915	rs4644560	C	G	2	6	8	0	0	8	0	0
10	71170287	rs7911347	C	A	3	4	7	0	1	8	0	0
10	71170381	rs10762294	T	C	3	7	10	0	0	10	0	0
10	71170443	rs10740320	C	G	6	8	14	0	0	14	0	0
10	71267010	rs1052179	G	A	2	6	8	0	0	8	0	0
10	71393025	rs1132075	A	G	2	4	6	0	0	6	0	0
10	71899440	rs79175235	G	A	16	21	37	0	0	37	0	0
10	71907200	rs7087051	T	G	13	39	52	0	0	52	0	0
10	71909418	rs114611136	C	T	8	11	19	0	0	19	0	0
10	71909898	rs74139278	C	T	3	13	16	0	0	16	0	0
10	71909957	rs75294498	G	A	3	5	8	0	0	8	0	0
10	71910888	rs7919647	C	T	249	188	437	0	1	438	0	0
10	71913822	rs2271691	T	C	4	5	9	0	0	9	0	0
10	71914471	rs79964735	C	A	9	6	15	0	1	16	0	0
10	71918527	.	G	A	3	3	6	0	3	9	0	0
10	71922900	rs7094581	C	T	38	43	81	0	1	82	0	0
10	71923686	rs151131756	A	T	60	48	108	0	0	108	0	0
10	71924252	rs79918134	C	T	48	40	88	0	0	88	0	0
10	71926288	rs7093644	T	C	26	26	52	0	2	54	0	0
10	71930243	rs3812693	G	T	46	28	74	0	0	74	0	0
10	71966819	rs9415004	C	T	7	4	11	0	0	11	0	0
10	71967145	rs7903396	A	G	5	1	6	0	0	6	0	0
10	71969062	rs9415006	G	A	7	5	12	0	0	12	0	0
10	71970791	rs10740330	T	G	4	7	11	0	0	11	0	0
10	71970792	rs10740331	T	A	4	7	11	0	0	11	0	0
10	71971032	rs7897538	A	C	4	6	10	0	0	10	0	0
10	71971469	rs6480446	A	T	4	7	11	0	0	11	0	0
10	71971554	rs2184334	G	A	4	12	16	0	0	16	0	0
10	71971979	rs2184333	T	C	6	7	13	0	0	13	0	0
10	71972435	rs4746977	C	T	11	0	11	0	0	11	0	0
10	71972828	rs2151834	T	C	5	3	8	0	0	8	0	0
10	72059004	rs1043884	A	C	2	4	6	0	0	6	0	0
10	72059091	rs1043867	G	A	4	3	7	0	0	7	0	0
10	72059506	rs10762360	G	C	7	1	8	0	0	8	0	0
10	72166333	rs10740345	T	C	8	8	16	0	0	16	0	0
10	72167350	rs10999322	G	A	7	0	7	0	0	7	0	0
10	72169625	rs7918386	G	A	10	8	18	0	0	18	0	0
10	72169888	rs12245060	C	G	1	9	10	0	0	10	0	0
10	72170942	rs189839866	C	T	4	12	16	0	0	16	0	0
10	72171010	rs10823537	G	A	5	18	23	0	0	23	0	0
10	72171779	rs189435592	G	A	12	10	22	0	0	22	0	0
10	72172992	rs7078987	A	G	5	7	12	0	0	12	0	0
10	72174390	rs10999323	A	G	3	3	6	0	0	6	0	0
10	72176774	rs4558092	A	G	9	12	21	0	1	22	0	0
10	72177053	rs7906800	T	C	13	8	21	0	1	22	0	0
10	72179406	rs10999324	G	A	11	17	28	0	0	28	0	0
10	72179746	rs1043098	C	T	76	91	167	0	0	167	0	0
10	72182975	rs14761	G	A	142	147	289	0	4	293	0	0
10	72185224	rs10999326	G	C	4	3	7	0	0	7	0	0
10	72186319	rs7906903	C	G	1	7	8	0	0	8	0	0
10	72186524	rs3088383	T	C	8	9	17	0	0	17	0	0
10	72186794	rs7463	G	C	6	11	17	0	0	17	0	0
10	72289778	rs2275060	C	T	6	2	8	0	0	8	0	0
10	72327715	rs4746053	G	C	8	9	17	0	0	17	0	0
10	72358577	rs885822	G	A	7	9	16	0	0	16	0	0
10	72358655	rs885821	G	A	12	11	23	0	0	23	0	0
10	72500863	rs10999500	C	G	6	4	10	0	0	10	0	0
10	72503344	rs10999502	G	A	5	5	10	0	2	12	0	0
10	72509321	rs2541230	A	G	3	3	6	0	0	6	0	0
10	72513635	rs12774070	C	A	5	1	6	0	0	6	0	0
10	72517837	rs6480463	C	T	12	14	26	0	0	26	0	0
10	72520259	rs61573157	C	T	12	10	22	0	0	22	0	0
10	72520944	rs45542543	T	C	21	20	41	0	0	41	0	0
10	72520956	rs7074569	A	G	22	24	46	0	0	46	0	0
10	72521155	rs2587469	G	A	12	17	29	0	0	29	0	0
10	72521175	rs2688769	T	C	11	18	29	0	0	29	0	0
10	72521309	rs3740440	C	G	23	25	48	0	0	48	0	0
10	72521422	rs2587468	T	C	25	24	49	0	0	49	0	0
10	72521651	rs3740438	C	T	17	20	37	0	0	37	0	0
10	72522088	rs11572	C	T	22	20	42	0	0	42	0	0
10	72522189	rs3740434	A	G	5	2	7	0	0	7	0	0
10	72604263	rs12770335	G	T	17	12	29	0	0	29	0	0
10	72622912	rs12780016	T	A	7	4	11	0	0	11	0	0
10	72631626	rs865832	C	T	9	6	15	0	0	15	0	0
10	72639800	rs2881	A	G	27	23	50	0	1	51	0	0
10	72643671	rs9712	C	T	38	29	67	0	1	68	0	0
10	73082563	rs2277257	A	G	1	5	6	0	0	6	0	0
10	73498644	rs1227059	A	G	7	7	14	0	0	14	0	0
10	73498910	rs10823837	C	T	10	9	19	0	0	19	0	0
10	73499068	rs1227058	T	C	6	5	11	0	0	11	0	0
10	73499561	rs10762474	C	G	3	4	7	0	0	7	0	0
10	73499827	rs1227057	G	A	6	5	11	0	0	11	0	0
10	73500114	rs72817954	C	G	3	4	7	0	0	7	0	0
10	73500155	rs1227055	C	T	5	2	7	0	0	7	0	0
10	73500184	rs1227054	G	A	4	3	7	0	0	7	0	0
10	73500861	rs1227053	C	T	6	1	7	0	0	7	0	0
10	73501374	rs1227052	C	T	2	5	7	0	0	7	0	0
10	73501556	rs1227051	G	A	7	5	12	0	0	12	0	0
10	73502214	rs11599787	G	A	3	3	6	0	0	6	0	0
10	73504776	rs9415991	T	C	2	7	9	0	0	9	0	0
10	73504901	rs7922948	C	A	3	16	19	0	0	19	0	0
10	73506272	rs12255880	T	C	2	5	7	0	0	7	0	0
10	73506514	rs12248205	C	A	3	4	7	0	0	7	0	0
10	73507183	rs10740388	G	A	5	1	6	0	0	6	0	0
10	73507645	rs1055518	T	C	177	227	404	0	9	413	0	0
10	73509201	rs12771006	G	T	53	52	105	0	1	106	0	0
10	73509705	rs748504	G	A	42	33	75	0	0	75	0	0
10	73509766	rs748505	T	C	35	17	52	0	1	53	0	0
10	73512933	rs3747857	G	A	12	8	20	0	0	20	0	0
10	73513902	rs10999983	C	G	3	3	6	0	0	6	0	0
10	73514554	rs7908979	A	G	5	5	10	0	0	10	0	0
10	73515678	rs10999984	T	C	11	6	17	0	0	17	0	0
10	73516778	.	G	T	6	5	11	0	0	11	0	0
10	73516813	rs149158938	G	A	5	2	7	0	0	7	0	0
10	73516853	rs10999985	C	T	7	6	13	0	0	13	0	0
10	73517520	rs10823840	G	A	4	5	9	0	0	9	0	0
10	73520511	rs41305045	G	A	2	5	7	0	0	7	0	0
10	73522768	rs9415040	G	A	22	24	46	0	0	46	0	0
10	73523711	rs12415269	C	T	18	22	40	0	2	42	0	0
10	73524368	rs9415996	G	A	9	9	18	0	1	19	0	0
10	73525525	rs7919533	T	C	5	4	9	0	1	10	0	0
10	73527707	rs3747864	C	T	5	8	13	0	0	13	0	0
10	73527925	rs7075746	T	C	4	7	11	0	0	11	0	0
10	73528301	rs7076317	T	C	3	4	7	0	0	7	0	0
10	73528898	rs10999992	T	C	4	2	6	0	0	6	0	0
10	73530939	rs7905535	G	A	6	5	11	0	0	11	0	0
10	73530977	rs10762476	C	A	5	6	11	0	0	11	0	0
10	73531069	rs10762477	A	G	4	7	11	0	0	11	0	0
10	73533177	rs3747862	A	G	101	90	191	0	5	196	0	0
10	73576307	rs7869	C	T	655	627	1282	0	6	1289	1	0
10	73577267	rs4747202	G	A	39	50	89	0	0	89	0	0
10	73577626	rs9415054	A	T	17	15	32	0	0	32	0	0
10	73578152	rs762573	T	A	25	21	46	0	0	46	0	0
10	73578503	rs885828	G	A	12	8	20	0	1	21	0	0
10	73578882	rs4747203	T	C	14	23	37	0	1	38	0	0
10	73582752	rs727415	T	A	8	6	14	0	0	14	0	0
10	73584426	rs1015193	T	C	6	11	17	0	1	18	0	0
10	73585526	rs2593163	A	G	6	4	10	0	0	10	0	0
10	73586793	rs9416010	C	T	4	4	8	0	0	8	0	0
10	73819012	rs41282248	G	A	105	64	169	0	1	170	0	0
10	73820001	rs1049269	A	G	50	44	94	0	2	96	0	0
10	73820548	rs15256	T	C	45	68	113	0	2	115	0	0
10	73820622	rs3180	A	G	48	62	110	0	1	111	0	0
10	73822025	rs1049246	A	G	15	21	36	0	2	38	0	0
10	73822343	rs3088251	T	C	58	46	104	0	2	106	0	0
10	73848075	rs2306324	C	T	6	7	13	0	0	13	0	0
10	73856644	rs1133381	A	T	67	63	130	0	2	132	0	0
10	73975593	rs12218638	T	C	11	6	17	0	0	17	0	0
10	74035041	rs1053639	T	A	910	857	1767	0	20	1787	0	0
10	74035297	rs8316	C	T	748	702	1450	0	13	1463	0	0
10	74097235	rs117977752	C	T	7	7	14	0	1	15	0	0
10	74100279	rs9416017	T	C	2	4	6	0	0	6	0	0
10	74113333	rs9415068	T	C	14	15	29	0	0	29	0	0
10	74127853	rs4262652	G	A	43	43	86	0	0	86	0	0
10	74647331	.	G	C	28	29	57	0	1	58	0	0
10	74813317	.	C	T	50	31	81	0	2	83	0	0
10	74894526	rs35331959	A	C	82	93	175	0	1	176	0	0
10	75430874	rs7908630	C	T	4	3	7	0	0	7	0	0
10	75471750	rs10762557	T	C	2	5	7	0	0	7	0	0
10	75472218	rs11000755	G	A	3	4	7	0	0	7	0	0
10	75473052	rs10762558	G	A	8	6	14	0	0	14	0	0
10	75478824	rs2127365	A	G	3	5	8	0	0	8	0	0
10	75483592	rs3849968	A	C	4	3	7	0	0	7	0	0
10	75489843	rs28553894	C	A	5	4	9	0	1	10	0	0
10	75489844	rs28718766	C	A	6	4	10	0	0	10	0	0
10	75490217	rs11814282	T	C	7	5	12	0	0	12	0	0
10	75493610	rs11000758	A	T	2	4	6	0	0	6	0	0
10	75493726	rs11000759	G	A	2	5	7	0	0	7	0	0
10	75493734	rs11000760	G	A	2	5	7	0	0	7	0	0
10	75494450	rs12264025	A	G	2	5	7	0	0	7	0	0
10	75495405	rs10762560	T	G	9	6	15	0	1	16	0	0
10	75495956	rs12253408	G	T	2	4	6	0	0	6	0	0
10	75496130	rs12253482	G	A	12	8	20	0	0	20	0	0
10	75496161	rs12253429	C	G	9	11	20	0	0	20	0	0
10	75524759	rs12413039	C	G	4	2	6	0	0	6	0	0
10	75524802	rs10762563	C	A	4	7	11	0	0	11	0	0
10	75525999	rs3849969	A	G	17	18	35	0	0	35	0	0
10	75528130	rs10824032	G	A	28	18	46	0	0	46	0	0
10	75534488	rs4746148	C	T	2	5	7	0	0	7	0	0
10	75538651	rs1134777	C	G	6	13	19	0	0	19	0	0
10	75554541	rs7908825	C	G	3	3	6	0	0	6	0	0
10	75558867	rs2271271	G	A	55	67	122	0	0	122	0	0
10	75561916	rs4691	T	C	130	129	259	0	3	262	0	0
10	75562161	rs13013	C	A	142	155	297	0	1	298	0	0
10	75575963	rs11000785	T	C	8	7	15	0	0	15	0	0
10	75576366	rs12262649	C	T	5	3	8	0	0	8	0	0
10	75576374	rs12262650	C	A	5	3	8	0	0	8	0	0
10	75577843	rs7080350	G	A	4	4	8	0	0	8	0	0
10	75579510	rs2306328	C	T	10	12	22	0	0	22	0	0
10	75580014	rs7098573	G	A	18	13	31	0	1	32	0	0
10	75580042	rs7098444	C	T	14	14	28	0	1	29	0	0
10	75633239	rs35257352	T	C	24	14	38	0	0	38	0	0
10	75898571	.	C	T	20	13	33	0	1	34	0	0
10	75965269	.	A	C	4	2	6	0	0	6	0	0
10	76854564	rs3088142	C	T	2	6	8	0	0	8	0	0
10	76937881	.	T	C	24	20	44	0	1	45	0	0
10	76939773	rs2135164	C	G	31	24	55	0	5	72	12	0
10	76940216	rs1989667	A	G	35	32	67	0	0	67	0	0
10	76970613	rs11543	G	C	99	63	162	0	0	162	0	0
10	76982895	rs60622683	C	A	4	2	6	0	0	6	0	0
10	76986741	rs1259498	T	C	4	3	7	0	0	7	0	0
10	76988066	rs1259499	T	G	6	6	12	0	0	12	0	0
10	76988135	rs10824292	C	A	6	4	10	0	0	10	0	0
10	76989295	rs11001334	C	T	12	4	16	0	0	16	0	0
10	76990113	rs1259500	A	G	14	10	24	0	0	24	0	0
10	76990185	rs1259501	G	A	17	12	29	0	0	29	0	0
10	76990837	rs11527434	A	C	161	108	269	0	1	270	0	0
10	77807027	rs1898071	T	C	13	6	19	0	0	19	0	0
10	79551640	rs2165047	C	T	10	3	13	0	0	13	0	0
10	79552092	rs2165046	C	T	3	7	10	0	0	10	0	0
10	79552107	rs1058203	G	A	5	2	7	0	0	7	0	0
10	79566632	rs1058198	G	A	3	7	10	0	0	10	0	0
10	79579222	rs1248634	G	A	7	4	11	0	0	11	0	0
10	79580976	rs41274586	G	A	4	4	8	0	0	8	0	0
10	79769647	rs34588967	C	A	10	4	14	0	0	14	0	0
10	79794073	rs7071351	C	A	2	5	7	0	0	7	0	0
10	79796089	rs3824717	T	C	7	3	10	0	0	10	0	0
10	79796726	rs2395507	G	C	23	22	45	0	0	45	0	0
10	80852101	rs1124440	G	A	3	4	7	0	0	7	0	0
10	80852113	rs1124439	G	T	4	4	8	0	0	8	0	0
10	80853508	rs1250013	C	T	2	6	8	0	0	8	0	0
10	80962113	rs58273541	C	T	7	1	8	0	0	8	0	0
10	81017095	rs1250533	G	C	3	3	6	0	0	6	0	0
10	81017467	rs1250530	T	C	3	5	8	0	0	8	0	0
10	81020402	rs7908992	T	G	4	4	8	0	0	8	0	0
10	81072523	rs2802359	G	C	46	49	95	0	0	95	0	0
10	81073763	rs2997468	G	C	75	71	146	0	1	147	0	0
10	81073764	rs2985841	G	A	75	69	144	0	1	145	0	0
10	81074125	rs1782652	T	A	80	62	142	0	2	144	0	0
10	81109708	rs2000404	T	C	28	19	47	0	0	47	0	0
10	81109727	rs41274620	G	A	27	20	47	0	2	49	0	0
10	81110417	rs1316312	G	C	22	14	36	0	1	37	0	0
10	81110589	rs111456847	C	T	19	18	37	0	4	41	0	0
10	81111036	rs876678	G	T	6	6	12	0	0	12	0	0
10	81114813	rs8837	C	G	113	145	258	0	3	261	0	0
10	81142245	rs11002951	C	T	11	6	17	0	0	17	0	0
10	81145535	rs1063119	T	C	6	5	11	0	0	11	0	0
10	81145701	rs1046444	G	C	3	5	8	0	0	8	0	0
10	81147631	rs113523894	G	A	3	3	6	0	0	6	0	0
10	81437253	rs369666750	G	A	10	0	10	0	0	10	0	0
10	81443778	rs61863474	A	G	6	1	7	0	0	7	0	0
10	81443833	rs61863475	C	T	6	2	8	0	0	8	0	0
10	81472221	.	A	C	7	0	7	0	0	7	0	0
10	81507286	rs148430393	C	G	2	10	12	0	0	12	0	0
10	81807118	rs12253371	T	C	2	5	7	0	0	7	0	0
10	81851120	rs1046707	C	T	3	6	9	0	0	9	0	0
10	81852059	rs3156	G	A	5	5	10	0	0	10	0	0
10	81902655	rs56196124	A	T	6	3	9	0	0	9	0	0
10	81902767	rs2789649	C	T	1	8	9	0	0	9	0	0
10	81903517	rs2819875	C	T	2	4	6	0	0	6	0	0
10	81911725	rs1953600	C	T	4	3	7	0	0	7	0	0
10	81912397	rs35014047	A	C	7	7	14	0	0	14	0	0
10	81913337	rs17100316	A	G	12	13	25	0	0	25	0	0
10	81913561	rs7091565	C	T	8	12	20	0	0	20	0	0
10	81913984	rs7069100	T	A	8	6	14	0	0	14	0	0
10	81915889	rs61860016	G	C	32	24	56	0	1	57	0	0
10	81916055	rs36073865	C	T	28	28	56	0	0	56	0	0
10	81916355	rs12779139	T	C	26	26	52	0	2	54	0	0
10	81916566	rs12768613	C	T	23	21	44	0	1	45	0	0
10	81917113	rs12769764	C	G	34	23	57	0	0	57	0	0
10	81917708	rs1079242	A	G	12	10	22	0	0	22	0	0
10	81917957	rs3862518	T	C	7	12	19	0	0	19	0	0
10	81918041	rs2573346	G	A	13	9	22	0	0	22	0	0
10	81918128	rs12781912	G	T	18	13	31	0	0	31	0	0
10	81918129	rs3890076	C	T	17	13	30	0	0	30	0	0
10	81918362	rs3889823	T	C	12	12	24	0	1	25	0	0
10	81923959	rs12762098	G	C	3	6	9	0	0	9	0	0
10	81924403	rs35074774	A	G	6	5	11	0	0	11	0	0
10	81926171	rs71481556	A	G	17	10	27	0	2	29	0	0
10	81927059	rs2229554	C	T	196	184	380	0	6	386	0	0
10	81927446	rs4633405	G	T	0	10	10	0	0	10	0	0
10	81928168	rs78683437	C	T	7	4	11	0	0	11	0	0
10	81932261	rs34523152	T	C	2	4	6	0	0	6	0	0
10	81941179	rs34613979	T	C	3	3	6	0	0	6	0	0
10	81965227	rs11542747	C	A	21	17	38	0	0	38	0	0
10	82264813	rs9633739	A	G	4	3	7	0	0	7	0	0
10	82266805	rs12269333	C	T	9	4	13	0	0	13	0	0
10	82269238	rs10785897	C	T	7	23	30	0	0	30	0	0
10	82275795	rs36113069	G	T	2	5	7	0	0	7	0	0
10	82278180	rs11553840	T	C	72	55	127	0	2	129	0	0
10	82279070	rs1052631	T	C	102	70	172	0	3	175	0	0
10	82281249	rs73305195	T	G	33	29	62	0	1	64	1	0
10	82285533	rs17106495	T	G	5	4	9	0	0	9	0	0
10	82292724	rs72824335	G	A	3	6	9	0	0	9	0	0
10	82292776	rs12240624	T	C	3	4	7	0	0	7	0	0
10	85899347	rs1136944	G	T	96	64	160	0	1	161	0	0
10	85900245	rs12570814	G	A	33	25	58	0	0	58	0	0
10	85900410	rs10887239	T	C	38	27	65	0	0	65	0	0
10	85900580	rs10887240	T	G	11	15	26	0	0	26	0	0
10	85900834	rs11200880	T	C	22	30	52	0	0	52	0	0
10	85901811	rs7092538	T	C	6	5	11	0	0	11	0	0
10	85901857	rs7070587	G	A	8	4	12	0	0	12	0	0
10	85901942	rs11200881	A	G	6	4	10	0	0	10	0	0
10	85902394	rs3816716	G	C	11	5	16	0	0	16	0	0
10	85905115	rs12768331	A	G	5	7	12	0	0	12	0	0
10	85905705	rs12413307	G	A	5	1	6	0	0	6	0	0
10	85906102	rs12412411	T	A	8	6	14	0	0	14	0	0
10	85907983	rs4601702	C	G	14	9	23	0	0	23	0	0
10	86131059	rs3814205	A	G	6	2	8	0	0	8	0	0
10	86141570	rs61865044	G	A	7	7	14	0	0	14	0	0
10	86273249	rs11557865	T	C	15	10	25	0	0	25	0	0
10	86276956	rs1050943	C	T	7	5	12	0	0	12	0	0
10	88203667	rs4934210	G	A	3	4	7	0	1	8	0	0
10	88203735	rs4934211	C	T	4	3	7	0	0	7	0	0
10	88204877	rs11202038	C	T	9	4	13	0	0	13	0	0
10	88729314	rs11202278	C	T	4	2	6	0	0	6	0	0
10	88729379	rs12768022	G	A	2	6	8	0	0	8	0	0
10	88822822	rs4933427	T	G	9	3	12	0	1	13	0	0
10	88911841	rs77879311	A	G	27	8	35	0	0	35	0	0
10	88947384	rs71475322	T	C	9	9	18	0	0	18	0	0
10	88947473	rs11816262	G	A	9	5	14	0	1	15	0	0
10	88951001	rs9553	G	A	28	26	54	0	1	55	0	0
10	89000225	rs182760104	C	G	3	3	6	0	0	6	0	0
10	89001438	rs181091310	A	C	8	8	16	0	0	16	0	0
10	89001549	rs12257942	A	G	5	3	8	0	0	8	0	0
10	89005930	rs4040134	G	A	22	10	32	0	0	32	0	0
10	89048157	.	C	T	8	5	13	0	1	14	0	0
10	89079209	rs3128138	A	C	15	6	21	0	0	21	0	0
10	89087404	.	C	T	8	0	8	0	0	8	0	0
10	89103030	rs372768039	A	G	12	10	22	0	1	23	0	0
10	89114449	.	C	T	11	0	11	0	0	11	0	0
10	89274645	rs10887724	T	G	3	3	6	0	0	6	0	0
10	89505388	rs76957876	G	A	1	11	12	0	0	12	0	0
10	89507288	rs1058798	C	A	3	5	8	0	0	8	0	0
10	89513118	rs7481	G	A	31	34	65	0	0	65	0	0
10	89513452	rs7480	C	T	16	7	23	0	0	23	0	0
10	89515046	rs11202538	C	T	4	2	6	0	0	6	0	0
10	89515522	rs12768487	C	T	4	4	8	0	0	8	0	0
10	89515818	rs12775041	T	C	7	1	8	0	0	8	0	0
10	89519880	rs66863455	C	A	4	3	7	0	0	7	0	0
10	89520138	rs34325090	T	A	2	4	6	0	0	6	0	0
10	89520907	rs34878240	A	C	6	2	8	0	0	8	0	0
10	89520948	rs10082347	T	G	7	1	8	0	0	8	0	0
10	89521206	rs35254974	C	G	4	4	8	0	1	9	0	0
10	89521535	rs12413371	C	T	5	2	7	0	0	7	0	0
10	89525860	rs9664653	C	T	10	8	18	0	0	18	0	0
10	89537605	rs9651491	C	T	3	5	8	0	0	8	0	0
10	89650759	rs1234218	C	T	3	5	8	0	0	8	0	0
10	89694616	rs184184924	G	A	16	13	29	0	0	29	0	0
10	89699209	rs2673803	C	T	5	5	10	0	0	10	0	0
10	89705429	rs2735343	G	C	2	7	9	0	0	9	0	0
10	89706857	rs35667411	T	C	5	2	7	0	0	7	0	0
10	89707265	rs2248293	T	C	4	5	9	0	0	9	0	0
10	89720907	rs555895	T	G	17	15	32	0	0	32	0	0
10	89727414	rs11202607	C	T	53	50	103	0	1	104	0	0
10	89727644	rs34761252	C	G	16	18	34	0	1	35	0	0
10	90771829	rs2234978	T	C	4	11	15	0	0	15	0	0
10	91007360	rs1051338	T	G	9	14	23	0	0	23	0	0
10	91062690	rs7070001	C	T	1	6	7	0	0	7	0	0
10	91064508	rs6586180	A	C	4	6	10	0	0	10	0	0
10	91064512	rs72814786	G	T	5	6	11	0	0	11	0	0
10	91066460	rs954439	T	A	935	908	1843	0	5	1848	0	0
10	91067595	rs4933504	C	G	1100	925	2025	0	3	2031	3	0
10	91091790	rs6586184	A	C	1	5	6	0	0	6	0	0
10	91097554	rs11203078	C	T	6	5	11	0	0	11	0	0
10	91098200	rs4934475	T	C	9	4	13	0	0	13	0	0
10	91099943	rs10749607	C	G	930	781	1711	0	13	1725	1	0
10	91100068	rs10887948	C	A	675	695	1370	0	9	1379	0	0
10	91100258	rs1141862	T	A	578	510	1088	0	13	1103	2	0
10	91143529	rs304494	T	A	3	4	7	0	0	7	0	0
10	91152593	rs303218	G	A	3	8	11	0	0	11	0	0
10	91155186	rs303216	C	T	6	10	16	0	1	17	0	0
10	91158237	rs304483	T	C	5	7	12	0	0	12	0	0
10	91159323	rs304484	G	T	3	6	9	0	0	9	0	0
10	91161082	rs303213	T	C	3	8	11	0	0	11	0	0
10	91161355	rs303212	T	C	6	12	18	0	0	18	0	0
10	91162677	rs303210	C	T	180	250	430	0	3	434	1	0
10	91172336	rs304440	G	A	2	4	6	0	0	6	0	0
10	91172663	rs304439	C	G	15	11	26	0	0	26	0	0
10	91178000	rs304448	C	T	88	50	138	0	0	138	0	0
10	91178804	rs304447	T	C	24	25	49	0	0	49	0	0
10	91179295	rs184236	A	C	96	51	147	0	2	149	0	0
10	91179545	rs1802845	T	A	64	84	148	0	1	149	0	0
10	91179829	rs303172	T	C	21	13	34	0	0	34	0	0
10	91180492	rs41317036	G	A	27	20	47	0	0	47	0	0
10	91479211	rs17484219	G	T	13	8	21	0	0	21	0	0
10	91498127	rs1886996	T	C	31	29	60	0	0	60	0	0
10	91505768	rs12414650	C	T	6	3	9	0	0	9	0	0
10	91522548	rs34354493	A	G	59	48	107	0	1	108	0	0
10	93594841	rs1772179	T	A	3	7	10	0	0	10	0	0
10	93595110	rs1770475	A	G	9	10	19	0	0	19	0	0
10	93595853	rs12220444	G	A	4	9	13	0	2	15	0	0
10	93596361	rs7912927	C	A	14	16	30	0	0	30	0	0
10	93602457	rs10881981	G	T	7	2	9	0	0	9	0	0
10	93602605	rs1772183	G	A	5	1	6	0	0	6	0	0
10	93603470	rs946896	C	T	11	4	15	0	0	15	0	0
10	93604133	rs10786019	C	G	6	5	11	0	0	11	0	0
10	93604600	rs2297960	A	T	4	2	6	0	0	6	0	0
10	93605405	rs1770466	A	G	6	3	9	0	0	9	0	0
10	93608142	rs3758499	G	A	56	58	114	0	0	114	0	0
10	93613894	rs7913999	G	T	3	3	6	0	0	6	0	0
10	93617306	rs1340420	A	G	2	7	9	0	0	9	0	0
10	93624017	rs1539042	C	G	100	97	197	0	1	198	0	0
10	94108815	rs138495627	A	C	12	5	17	0	0	17	0	0
10	95043935	rs2797567	G	A	6	0	6	0	0	6	0	0
10	95262890	rs61865305	T	A	3	3	6	0	0	6	0	0
10	95278683	rs75139274	G	A	3	6	9	0	0	9	0	0
10	95279506	rs2293277	A	T	4	4	8	0	0	8	0	0
10	95279771	rs3817482	C	T	5	3	8	0	0	8	0	0
10	96093632	rs1678	C	G	4	2	6	0	0	6	0	0
10	96369266	rs1065026	C	T	5	5	10	0	0	10	0	0
10	96370853	rs1047625	T	G	21	14	35	0	0	35	0	0
10	96997589	rs1049961	A	G	1066	899	1965	0	12	1977	0	0
10	96997670	rs1049921	A	G	936	835	1771	0	6	1778	1	0
10	96997820	rs1049814	A	G	872	807	1679	0	6	1685	0	0
10	96998519	rs2860998	T	C	6	12	18	0	0	18	0	0
10	96998591	rs2901833	G	A	3	7	10	0	0	10	0	0
10	96998648	rs2860999	G	A	4	4	8	0	0	8	0	0
10	96998688	rs12778797	T	C	8	7	15	0	0	15	0	0
10	96998743	rs12777195	A	G	8	7	15	0	2	17	0	0
10	96998744	rs12778837	T	C	7	8	15	0	2	17	0	0
10	96998853	rs11188243	A	G	8	7	15	0	0	15	0	0
10	96999006	rs11188244	C	T	5	5	10	0	0	10	0	0
10	96999046	rs11188245	G	A	5	6	11	0	1	12	0	0
10	96999484	rs61868350	C	T	6	6	12	0	0	12	0	0
10	96999787	rs7909905	C	T	4	2	6	0	0	6	0	0
10	97000010	rs7910040	A	G	1	6	7	0	0	7	0	0
10	97000206	rs2026680	G	C	5	2	7	0	0	7	0	0
10	97000360	rs2026681	A	G	3	3	6	0	0	6	0	0
10	97001343	rs12415795	C	T	5	2	7	0	0	7	0	0
10	97009230	rs143164218	G	A	5	3	8	0	0	8	0	0
10	97009306	rs17110556	A	T	6	6	12	0	0	12	0	0
10	97009657	rs10882573	G	A	10	9	19	0	0	19	0	0
10	97010631	rs11188250	C	G	6	3	9	0	1	10	0	0
10	97011104	rs900786	T	C	3	4	7	0	0	7	0	0
10	97011407	rs12776258	C	G	4	6	10	0	0	10	0	0
10	97023630	rs2296961	T	C	595	574	1169	0	12	1181	0	0
10	97072008	rs3193970	T	C	3	4	7	0	0	7	0	0
10	97072727	rs1053417	A	C	31	10	41	0	2	43	0	0
10	97073670	rs3814156	G	A	12	10	22	0	0	22	0	0
10	97074129	rs17849148	A	G	5	6	11	0	0	11	0	0
10	97106165	rs726176	T	C	3	5	8	0	0	8	0	0
10	97141523	rs2274490	G	A	4	2	6	0	0	6	0	0
10	97371146	rs1804934	G	A	29	26	55	0	0	55	0	0
10	97392969	rs3750701	G	A	3	3	6	0	0	6	0	0
10	97392993	rs3750700	T	C	4	3	7	0	0	7	0	0
10	97447373	rs10786229	A	T	28	18	46	0	0	46	0	0
10	97630523	rs10736094	C	T	5	5	10	0	0	10	0	0
10	97631051	rs2153914	T	C	2	5	7	0	0	7	0	0
10	97631247	rs7098750	T	C	4	5	9	0	0	9	0	0
10	97632082	rs2051052	C	T	8	7	15	0	0	15	0	0
10	97633021	rs11188513	C	T	21	20	41	0	1	42	0	0
10	97635516	rs2096219	C	T	4	3	7	0	0	7	0	0
10	97658718	rs17111195	C	A	5	7	12	0	0	12	0	0
10	97772496	rs10748652	T	A	6	3	9	0	0	9	0	0
10	97814761	rs11188575	G	A	2	9	11	0	0	11	0	0
10	97820339	rs1047370	G	T	43	45	88	0	3	91	0	0
10	98219456	.	A	T	6	0	6	0	2	8	0	0
10	98278823	rs1044029	A	G	99	88	187	0	0	187	0	0
10	98279053	rs9093	A	G	103	95	198	0	2	200	0	0
10	98282160	rs17391197	A	G	9	18	27	0	0	27	0	0
10	98283111	rs60471672	T	C	11	15	26	0	0	26	0	0
10	98283258	rs4919030	C	T	9	7	16	0	0	16	0	0
10	98284894	rs10509711	C	A	6	2	8	0	0	8	0	0
10	98285951	rs7915046	G	C	7	9	16	0	0	16	0	0
10	98287261	rs3789957	G	C	15	8	23	0	0	23	0	0
10	98289250	rs10882811	A	C	14	11	25	0	1	26	0	0
10	98289951	rs79353623	T	C	5	4	9	0	0	9	0	0
10	98291627	rs11592108	T	C	7	4	11	0	0	11	0	0
10	98319815	rs17392013	T	C	11	4	15	0	0	15	0	0
10	98327266	rs9633703	T	C	3	6	9	0	0	9	0	0
10	98328368	rs9633704	A	C	2	5	7	0	0	7	0	0
10	98334182	rs2861555	C	T	3	3	6	0	0	6	0	0
10	98353213	rs7448	C	T	75	52	127	0	0	127	0	0
10	98354812	rs11592969	A	G	48	50	98	0	1	99	0	0
10	98380277	rs3748234	C	T	27	26	53	0	1	54	0	0
10	98406362	rs78573405	T	C	4	6	10	0	0	10	0	0
10	98982749	rs3814164	G	A	39	35	74	0	0	74	0	0
10	98983955	rs10748691	G	A	9	12	21	0	0	21	0	0
10	99006083	rs13439	G	A	6	6	12	0	0	12	0	0
10	99080585	rs3781373	C	T	52	67	119	0	0	119	0	0
10	99080981	rs1334892	G	T	27	26	53	0	1	54	0	0
10	99094436	rs1890966	G	A	4	5	9	0	0	9	0	0
10	99098537	rs10786334	C	T	6	6	12	0	0	12	0	0
10	99098702	rs10786335	C	T	5	8	13	0	0	13	0	0
10	99099021	rs2861879	C	T	3	4	7	0	0	7	0	0
10	99116903	rs1048445	C	T	219	336	555	0	6	561	0	0
10	99117097	rs7923385	T	A	5	2	7	0	0	7	0	0
10	99118382	rs2297988	T	C	10	26	36	0	0	36	0	0
10	99118929	rs66531566	G	A	15	13	28	0	1	29	0	0
10	99120925	rs7924254	C	T	5	14	19	0	0	19	0	0
10	99121361	rs11189163	C	T	13	10	23	0	0	23	0	0
10	99121697	rs7905026	C	A	4	4	8	0	0	8	0	0
10	99121734	rs7921585	T	C	3	4	7	0	0	7	0	0
10	99122178	rs17112674	T	C	5	10	15	0	0	15	0	0
10	99122288	rs17112676	G	A	8	12	20	0	0	20	0	0
10	99122936	rs954149	G	A	12	10	22	0	1	23	0	0
10	99123006	rs954148	T	C	11	10	21	0	0	21	0	0
10	99123332	rs11817846	G	C	7	3	10	0	0	10	0	0
10	99123457	rs11189165	A	G	8	8	16	0	0	16	0	0
10	99124389	rs61863815	A	G	12	8	20	0	0	20	0	0
10	99124975	rs7918948	G	A	3	11	14	0	0	14	0	0
10	99125070	rs7918742	A	G	2	5	7	0	0	7	0	0
10	99125722	rs11189167	A	G	2	14	16	0	1	17	0	0
10	99125769	rs11189168	T	C	2	10	12	0	1	13	0	0
10	99125788	rs10882907	G	C	1	11	12	0	0	12	0	0
10	99125949	rs2275580	C	T	191	144	335	0	3	338	0	0
10	99126249	rs2275581	G	A	133	159	292	0	3	295	0	0
10	99132083	rs6584123	C	T	4	3	7	0	0	7	0	0
10	99132701	rs3818908	A	G	2	4	6	0	1	7	0	0
10	99134923	rs12412478	C	T	3	3	6	0	0	6	0	0
10	99135215	rs11189172	T	C	4	8	12	0	0	12	0	0
10	99135262	rs7084654	G	A	2	6	8	0	0	8	0	0
10	99136359	rs12359257	A	T	6	9	15	0	0	15	0	0
10	99136403	rs61863818	C	T	5	11	16	0	0	16	0	0
10	99137048	rs12258560	T	C	1	5	6	0	0	6	0	0
10	99137839	rs4635018	G	C	2	5	7	0	0	7	0	0
10	99137998	rs10882909	G	C	4	2	6	0	0	6	0	0
10	99138064	rs10882911	A	C	4	4	8	0	0	8	0	0
10	99138077	rs10882912	C	T	4	4	8	0	0	8	0	0
10	99138792	rs11189173	T	C	4	5	9	0	0	9	0	0
10	99141205	rs2275089	A	G	35	40	75	0	0	75	0	0
10	99141484	rs12218483	C	T	30	46	76	0	1	77	0	0
10	99155984	rs3814553	G	A	28	32	60	0	0	60	0	0
10	99160152	rs1048442	A	G	21	43	64	0	2	66	0	0
10	99225645	rs12360068	G	A	21	20	41	0	0	41	0	0
10	99434274	rs1046198	G	A	7	6	13	0	0	13	0	0
10	99434760	rs10882983	C	T	19	12	31	0	0	31	0	0
10	99435006	rs11189321	G	T	17	19	36	0	0	36	0	0
10	99435263	.	C	A	22	26	48	0	0	48	0	0
10	99435487	rs1046221	A	C	23	40	63	0	0	63	0	0
10	99435629	rs1046237	A	G	31	40	71	0	0	71	0	0
10	99435730	rs1046249	A	G	18	27	45	0	1	46	0	0
10	99439541	rs2275047	G	C	15	9	24	0	0	24	0	0
10	99477358	rs11551585	A	G	33	20	53	0	0	53	0	0
10	99498234	rs3818876	G	A	24	15	39	0	0	39	0	0
10	99504595	rs75060573	G	A	18	13	31	0	1	32	0	0
10	99504630	rs10882993	G	T	10	20	30	0	0	30	0	0
10	99504781	rs7077725	C	T	4	2	6	0	0	6	0	0
10	99507806	rs11591898	T	A	11	7	18	0	0	18	0	0
10	99507869	rs11189352	T	C	14	8	22	0	0	22	0	0
10	99508825	rs10786371	T	C	2	4	6	0	0	6	0	0
10	99509457	rs946778	T	G	9	7	16	0	0	16	0	0
10	99509696	rs946777	C	G	11	7	18	0	1	19	0	0
10	99509719	rs883324	C	G	11	8	19	0	1	20	0	0
10	99509969	rs3750615	T	C	6	2	8	0	0	8	0	0
10	99510068	rs3750614	G	T	5	5	10	0	1	11	0	0
10	99510284	rs3829137	T	C	6	6	12	0	0	12	0	0
10	99510331	rs10786372	A	G	3	6	9	0	0	9	0	0
10	99510962	rs11189353	C	T	3	4	7	0	0	7	0	0
10	99511429	rs3814558	C	T	12	10	22	0	0	22	0	0
10	99511933	rs2027376	G	C	6	8	14	0	0	14	0	0
10	99512472	rs1538723	T	C	4	4	8	0	0	8	0	0
10	99514645	rs7922907	A	G	8	5	13	0	0	13	0	0
10	99514789	rs11189355	G	C	20	10	30	0	0	30	0	0
10	99514818	rs11189356	C	T	14	7	21	0	0	21	0	0
10	99515020	rs11189357	T	A	16	16	32	0	0	32	0	0
10	99516955	rs10882995	G	A	28	17	45	0	0	45	0	0
10	99517355	rs3750612	A	G	12	8	20	0	0	20	0	0
10	99518384	rs7099540	T	G	4	4	8	0	0	8	0	0
10	99519097	rs1981237	A	G	68	64	132	0	0	132	0	0
10	99519305	rs3814559	T	C	81	59	140	0	0	140	0	0
10	99519424	rs3814560	G	A	76	73	149	0	1	150	0	0
10	99519753	rs4244329	G	A	130	125	255	0	0	255	0	0
10	99526668	rs2039826	G	A	3	6	9	0	1	10	0	0
10	99912399	rs7079382	A	G	3	6	9	0	0	9	0	0
10	99912544	rs7083160	C	T	4	6	10	0	0	10	0	0
10	99913132	rs11189494	T	A	4	5	9	0	0	9	0	0
10	99918976	rs4468282	A	G	6	5	11	0	1	12	0	0
10	99969507	rs35122894	C	T	37	40	77	0	1	78	0	0
10	99983310	rs12781480	T	C	10	11	21	0	0	21	0	0
10	100000625	rs7899632	A	G	8	2	10	0	0	10	0	0
10	100003785	rs1359508	T	C	5	9	14	0	0	14	0	0
10	100004441	rs1048757	G	C	80	74	154	0	0	154	0	0
10	100189138	rs1061135	A	G	122	85	207	0	2	209	0	0
10	100189568	rs11592273	C	A	112	128	240	0	7	249	2	0
10	100190920	rs1801287	G	A	91	78	169	0	1	170	0	0
10	100191495	rs11189602	C	G	4	2	6	0	0	6	0	0
10	100191970	rs11599152	G	A	4	2	6	0	0	6	0	0
10	100193883	rs11591594	C	T	3	4	7	0	0	7	0	0
10	100193958	rs10748731	A	G	5	3	8	0	0	8	0	0
10	100194602	rs17535384	A	G	8	3	11	0	0	11	0	0
10	100194627	rs17456874	A	G	7	3	10	0	0	10	0	0
10	100194716	rs11594404	T	C	3	3	6	0	0	6	0	0
10	100194829	rs11594426	T	C	7	1	8	0	0	8	0	0
10	100194909	rs11594443	T	C	7	1	8	0	0	8	0	0
10	100201707	rs7909297	A	G	9	1	10	0	0	10	0	0
10	100205107	rs1804689	G	T	74	71	145	0	1	146	0	0
10	101166544	rs2234971	C	T	16	13	29	0	0	29	0	0
10	101286480	rs6584281	A	G	4	2	6	0	0	6	0	0
10	101287314	rs11596008	C	T	5	1	6	0	0	6	0	0
10	101287764	rs10883365	G	A	5	2	7	0	0	7	0	0
10	101287785	rs10883366	G	A	4	2	6	0	0	6	0	0
10	101288347	rs7085798	C	A	7	6	13	0	0	13	0	0
10	101289653	rs1548964	G	C	3	5	8	0	0	8	0	0
10	101289703	rs1548963	C	G	2	5	7	0	1	8	0	0
10	101289735	rs1548962	G	C	2	5	7	0	0	7	0	0
10	101290027	rs77114732	G	A	6	4	10	0	0	10	0	0
10	101293035	rs41290504	C	A	27	16	43	0	0	43	0	0
10	101293318	rs7908704	G	A	3	4	7	0	0	7	0	0
10	101293341	rs7893840	T	C	4	4	8	0	0	8	0	0
10	101293468	rs7911680	A	C	3	7	10	0	0	10	0	0
10	101293921	rs77927889	T	C	6	7	13	0	0	13	0	0
10	101372043	rs888209	G	A	34	22	56	0	0	56	0	0
10	101372411	rs880568	T	C	223	173	396	0	5	401	0	0
10	101374337	rs7076270	C	T	4	4	8	0	0	8	0	0
10	101374671	rs10159508	C	T	6	3	9	0	1	10	0	0
10	101375581	rs1412324	A	G	8	5	13	0	0	13	0	0
10	101375896	rs1332103	A	G	4	6	10	0	0	10	0	0
10	101376357	rs7909979	A	G	7	5	12	0	0	12	0	0
10	101376898	rs4919368	C	A	4	2	6	0	0	6	0	0
10	101379280	rs11190190	A	G	11	17	28	0	0	28	0	0
10	101445591	rs3740078	A	C	5	6	11	0	0	11	0	0
10	101451259	rs11190245	T	C	4	9	13	0	0	13	0	0
10	101465708	rs7903514	T	C	4	5	9	0	0	9	0	0
10	101465780	rs7918619	G	A	6	5	11	0	0	11	0	0
10	101469605	rs2300983	G	A	4	7	11	0	0	11	0	0
10	101469903	rs1056844	T	G	9	9	18	0	0	18	0	0
10	101471695	rs1128642	C	T	14	11	25	0	0	25	0	0
10	101473218	rs2231687	A	G	5	2	7	0	0	7	0	0
10	101473535	rs7073616	C	T	9	6	15	0	0	15	0	0
10	101474499	rs11190255	T	C	5	5	10	0	0	10	0	0
10	101604207	rs3740066	C	T	7	6	13	0	1	14	0	0
10	101635461	rs7652	T	A	92	89	181	0	0	181	0	0
10	101636163	rs12769233	C	G	52	28	80	0	3	83	0	0
10	101636648	rs2002109	T	C	47	41	88	0	1	89	0	0
10	101639796	rs2255901	G	A	38	34	72	0	0	72	0	0
10	101639877	rs11190305	A	C	38	37	75	0	0	75	0	0
10	101645498	rs2490763	T	C	32	35	67	0	2	70	1	0
10	101657880	rs7919323	G	A	15	12	27	0	0	27	0	0
10	101715899	rs2862923	G	A	10	7	17	0	0	17	0	0
10	101937194	rs17112705	T	C	5	3	8	0	0	8	0	0
10	102011147	rs61286369	T	A	11	4	15	0	0	15	0	0
10	102014506	rs663123	C	A	4	5	9	0	0	9	0	0
10	102251772	rs12268460	A	G	5	5	10	0	0	10	0	0
10	102287282	rs58930655	C	A	3	7	10	0	0	10	0	0
10	102308818	.	C	A	33	26	59	0	0	61	2	0
10	102310702	.	T	C	20	19	39	0	1	40	0	0
10	102673063	rs3802725	G	T	4	8	12	0	0	12	0	0
10	102673292	rs4917916	G	A	11	6	17	0	0	17	0	0
10	102722428	rs11190773	G	C	6	6	12	0	0	12	0	0
10	102722916	rs927302	G	C	10	17	27	0	0	27	0	0
10	102746231	rs7184	C	T	37	39	76	0	1	77	0	0
10	102746503	rs2863095	C	T	69	52	121	0	1	122	0	0
10	102754033	rs3740488	A	T	7	16	23	0	0	23	0	0
10	102761458	rs750866	A	G	5	10	15	0	0	15	0	0
10	102761801	rs701834	C	T	9	5	14	0	0	14	0	0
10	102762127	rs701835	A	G	6	7	13	0	0	13	0	0
10	102762256	rs752974	C	T	25	35	60	0	0	60	0	0
10	102764047	rs807029	C	T	32	46	78	0	1	79	0	0
10	102764607	rs807027	T	A	34	28	62	0	0	62	0	0
10	102764821	rs807025	C	T	54	31	85	0	0	85	0	0
10	102767117	rs701836	C	A	300	282	582	0	1	583	0	0
10	102767155	rs14177	C	G	321	264	585	0	4	589	0	0
10	103294479	.	C	T	7	3	10	0	0	10	0	0
10	103313546	rs4919551	C	G	19	15	34	0	0	34	0	0
10	103313599	rs3127242	C	T	21	16	37	0	0	37	0	0
10	103313620	rs1045324	A	G	20	16	36	0	1	37	0	0
10	103315801	rs1045232	C	T	4	7	11	0	0	11	0	0
10	103338730	rs1055364	C	A	24	31	55	0	1	56	0	0
10	103338733	rs1055362	A	G	26	33	59	0	1	60	0	0
10	103340056	rs3730477	G	A	25	23	48	0	2	50	0	0
10	103340144	rs3730476	A	G	16	12	28	0	0	28	0	0
10	103361088	rs7874	C	T	17	11	28	0	0	28	0	0
10	103368654	rs7006	T	C	22	17	39	0	0	39	0	0
10	103373463	rs141998785	C	T	7	9	16	0	0	16	0	0
10	103373593	rs12255066	G	A	11	11	22	0	0	22	0	0
10	103374233	rs10883665	G	A	12	5	17	0	0	17	0	0
10	103375112	rs10883666	T	G	2	5	7	0	0	7	0	0
10	103378309	rs74926559	G	A	7	1	8	0	0	8	0	0
10	103379882	rs11191067	G	T	3	3	6	0	1	7	0	0
10	103400066	rs11191072	G	T	4	5	9	0	0	9	0	0
10	103548866	rs1008013	T	A	32	27	59	0	3	62	0	0
10	103550604	rs1124714	T	C	17	10	27	0	0	27	0	0
10	103554087	rs75254166	T	A	87	79	166	0	5	171	0	0
10	103554777	rs149714075	G	C	95	125	220	0	3	223	0	0
10	103560186	rs2305194	A	C	4	2	6	0	0	6	0	0
10	103577629	rs35402016	C	T	40	43	83	0	0	83	0	0
10	103606543	rs11191129	C	T	28	22	50	0	0	50	0	0
10	103774431	rs56407876	G	C	1	9	10	0	0	10	0	0
10	103825929	rs36078476	T	G	22	26	48	0	1	49	0	0
10	103827737	rs3816	T	G	35	29	64	0	1	65	0	0
10	103867391	rs1046399	G	A	302	295	597	0	12	609	0	0
10	103867418	.	T	C	302	304	606	0	1	607	0	0
10	103870247	rs56892378	C	A	11	8	19	0	0	19	0	0
10	103873536	.	C	A	5	4	9	0	1	10	0	0
10	103873539	rs115703265	T	C	4	4	8	0	2	10	0	0
10	103905779	rs4919613	A	G	5	8	13	0	0	13	0	0
10	103906612	rs118161359	G	A	22	17	39	0	0	39	0	0
10	103907247	.	C	T	6	4	10	0	0	10	0	0
10	103920475	rs1049455	T	C	60	53	113	0	1	114	0	0
10	104005386	rs1541046	G	A	22	15	37	0	0	37	0	0
10	104064885	rs772010	C	G	2	5	7	0	0	7	0	0
10	104140355	rs112809254	C	T	124	130	254	0	0	254	0	0
10	104140602	rs3781295	G	A	5	3	8	0	0	8	0	0
10	104157727	rs4919632	C	T	7	11	18	0	0	18	0	0
10	104158933	rs3740418	C	G	64	65	129	0	3	132	0	0
10	104161475	rs11574852	A	C	18	40	58	0	1	59	0	0
10	104161796	rs11574853	T	A	13	27	40	0	0	40	0	0
10	104161967	rs7077329	T	C	52	72	124	0	0	124	0	0
10	104181006	rs111522958	G	C	12	27	39	0	1	40	0	0
10	104184081	rs1044476	G	A	136	127	263	0	4	267	0	0
10	104184953	rs11597439	C	G	58	41	99	0	4	104	1	0
10	104211058	rs3740417	G	C	3	9	12	0	0	12	0	0
10	104575870	rs6892	A	G	22	29	51	0	1	52	0	0
10	104837556	rs138807273	A	G	3	4	7	0	0	7	0	0
10	104953007	rs1141095	C	G	28	44	72	0	1	73	0	0
10	105063279	rs41287490	T	C	28	36	64	0	1	65	0	0
10	105135319	rs7905968	C	T	3	4	7	0	0	7	0	0
10	105149547	rs7093039	A	G	6	1	7	0	0	7	0	0
10	105154089	rs7911488	A	G	2	8	10	0	0	10	0	0
10	105155645	rs2292807	T	C	8	12	20	0	0	20	0	0
10	105194086	rs2986014	C	T	15	12	27	0	0	27	0	0
10	105205302	rs7831	A	C	34	14	48	0	0	48	0	0
10	105206874	rs6580	T	C	13	14	27	0	1	28	0	0
10	105207505	rs2296513	C	T	5	5	10	0	0	10	0	0
10	105333127	rs12360357	C	T	9	14	23	0	0	23	0	0
10	105333242	rs1077016	T	G	13	11	24	0	1	25	0	0
10	105333613	rs12411463	C	T	6	8	14	0	0	14	0	0
10	105345327	rs7100958	C	T	7	4	11	0	0	11	0	0
10	105360279	rs569561253	G	A	12	8	20	0	0	20	0	0
10	105360293	.	G	C	8	9	17	0	1	18	0	0
10	105445588	rs12413931	C	T	1	8	9	0	0	9	0	0
10	105657363	rs11191853	C	G	56	56	112	0	0	112	0	0
10	106022789	rs4925	C	A	255	288	543	0	6	549	0	0
10	106025258	rs1147611	G	T	3	6	9	0	0	9	0	0
10	106039185	rs156697	A	G	8	3	11	0	0	11	0	0
10	106042502	rs1865926	G	T	4	3	7	0	0	7	0	0
10	106053641	rs156699	A	G	1	5	6	0	0	6	0	0
10	106072527	rs276209	T	C	361	311	672	0	7	679	0	0
10	106073566	rs505701	T	C	181	151	332	0	3	335	0	0
10	106081549	rs276231	G	A	2	5	7	0	0	7	0	0
10	111635099	rs141929832	G	A	9	10	19	0	0	19	0	0
10	111647738	rs472049	C	T	5	3	8	0	0	8	0	0
10	112010830	rs11195047	C	T	3	4	7	0	0	7	0	0
10	112045171	rs14401	C	T	54	60	114	0	1	115	0	0
10	112046150	rs17658	T	C	87	100	187	0	0	187	0	0
10	112052689	rs10787227	C	G	6	2	8	0	0	8	0	0
10	112053599	rs1050755	C	T	170	121	291	0	6	297	0	0
10	112061085	rs4918491	A	G	10	9	19	0	0	19	0	0
10	112061248	rs4918492	G	C	7	5	12	0	0	12	0	0
10	112061725	rs10749027	C	A	7	4	11	0	0	11	0	0
10	112266771	rs1889567	C	T	87	71	158	0	1	159	0	0
10	112270675	rs1042606	A	C	156	160	316	0	2	318	0	0
10	112271288	rs3750811	A	G	18	16	34	0	0	34	0	0
10	112634682	rs79783816	A	G	2	12	14	0	0	14	0	0
10	112635411	rs141772067	G	T	11	6	17	0	0	17	0	0
10	112639957	rs139330058	G	C	13	25	38	0	0	38	0	0
10	114187787	rs8624	T	C	13	12	25	0	0	25	0	0
10	114192285	rs2306158	G	A	5	7	12	0	0	12	0	0
10	114200355	rs2306159	G	A	16	9	25	0	0	25	0	0
10	114205389	rs4918752	G	A	57	32	89	0	0	89	0	0
10	114206837	rs2277206	T	C	5	2	7	0	0	7	0	0
10	114207480	rs10885348	A	G	4	5	9	0	0	9	0	0
10	114208276	rs7075980	A	T	2	7	9	0	0	9	0	0
10	114209703	rs7476679	G	T	60	84	144	0	5	149	0	0
10	114210352	rs41292620	G	C	154	111	265	0	0	265	0	0
10	114833850	rs3750804	C	T	3	5	8	0	0	8	0	0
10	114834632	rs7908628	G	C	0	7	7	0	0	7	0	0
10	114926333	rs7099964	G	C	72	51	123	0	0	123	0	0
10	115472113	rs3127075	G	C	7	9	16	0	0	16	0	0
10	115472719	rs10749141	G	A	4	6	10	0	0	10	0	0
10	115473256	rs7099033	C	G	9	16	25	0	0	25	0	0
10	115489087	.	A	C	65	39	104	0	0	104	0	0
10	115489650	rs10787498	T	G	59	56	115	0	0	115	0	0
10	115490060	rs12247479	G	A	126	87	213	0	6	219	0	0
10	115609915	rs3750898	C	G	10	5	15	0	0	16	1	0
10	115670813	rs17775775	T	C	4	2	6	0	0	6	0	0
10	115675025	rs7895609	G	A	17	12	29	0	0	29	0	0
10	115881536	rs73354387	A	G	29	21	50	0	0	50	0	0
10	115883250	rs11596871	C	T	10	18	28	0	0	28	0	0
10	115883520	rs35807494	C	T	3	10	13	0	0	13	0	0
10	115910928	rs7095762	G	T	19	14	33	0	0	33	0	0
10	115922774	rs1061159	G	A	31	23	54	0	0	54	0	0
10	116193687	rs1064266	C	G	32	20	52	0	0	52	0	0
10	116193917	rs10787530	A	G	19	18	37	0	1	38	0	0
10	116194780	rs4751906	C	G	22	13	35	0	0	35	0	0
10	116195155	rs1057144	T	C	15	16	31	0	1	32	0	0
10	116195156	rs1057143	G	A	15	16	31	0	1	32	0	0
10	116195599	rs10978	T	A	7	10	17	0	0	17	0	0
10	116195776	rs1057139	C	G	10	18	28	0	0	28	0	0
10	116582560	rs758585	C	A	3	3	6	0	0	6	0	0
10	116593175	rs11196939	C	T	13	13	26	0	0	26	0	0
10	116593532	rs10490909	C	T	19	15	34	0	0	34	0	0
10	116593791	rs11196940	T	G	14	21	35	0	0	35	0	0
10	116594760	rs78713046	G	A	14	6	20	0	0	20	0	0
10	116594934	rs11819372	A	G	18	6	24	0	0	24	0	0
10	116601372	rs11196947	G	A	0	6	6	0	0	6	0	0
10	116603198	rs7079877	G	A	9	11	20	0	0	20	0	0
10	116607261	rs11196951	T	G	3	3	6	0	0	6	0	0
10	116609098	rs10885614	C	T	6	5	11	0	0	11	0	0
10	116615045	rs3180654	T	C	131	132	263	0	0	263	0	0
10	116621154	rs34064819	C	A	18	13	31	0	0	31	0	0
10	116622339	rs41284358	A	G	96	77	173	0	1	174	0	0
10	116624067	rs1046492	C	T	105	90	195	0	0	195	0	0
10	116719498	rs62623677	T	C	29	32	61	0	0	61	0	0
10	116719543	rs7099565	G	A	28	28	56	0	1	57	0	0
10	116736985	rs1045657	A	T	5	3	8	0	0	8	0	0
10	119010412	rs363339	C	T	5	3	8	0	0	8	0	0
10	119010413	rs363340	T	C	5	3	8	0	0	8	0	0
10	119014929	rs363419	C	T	2	8	10	0	0	10	0	0
10	119014931	rs363420	C	T	9	2	11	0	0	11	0	0
10	119014948	rs363343	C	A	9	2	11	0	0	11	0	0
10	119038140	.	C	G	62	73	135	0	0	135	0	0
10	119134707	rs78645354	G	A	20	10	30	0	0	30	0	0
10	119765851	rs11198226	T	C	6	8	14	0	0	14	0	0
10	120067450	rs17618810	G	A	5	14	19	0	0	19	0	0
10	120071078	rs118160970	G	A	13	9	22	0	0	22	0	0
10	120071546	rs853907	C	T	4	4	8	0	0	8	0	0
10	120444678	rs139302985	T	G	46	37	83	0	1	84	0	0
10	120448235	rs11594672	C	T	6	4	10	0	0	10	0	0
10	120810623	rs669964	A	C	8	12	20	0	1	21	0	0
10	120822033	rs2152240	T	G	4	4	8	0	0	8	0	0
10	120822914	rs12263494	A	G	1	5	6	0	0	6	0	0
10	120864601	rs2271359	G	A	11	4	15	0	0	15	0	0
10	120864781	rs1511034	C	A	8	14	22	0	0	22	0	0
10	120865187	rs11198775	T	A	6	0	6	0	0	6	0	0
10	120866972	rs10787916	G	C	2	4	6	0	0	6	0	0
10	120869807	rs10886386	C	T	14	10	24	0	0	24	0	0
10	120869834	rs6585534	C	T	4	3	7	0	0	7	0	0
10	120896927	rs4752252	G	A	40	44	84	0	0	84	0	0
10	120897063	rs4751697	C	T	66	83	149	0	2	151	0	0
10	120897151	rs1048713	C	T	42	18	60	0	0	60	0	0
10	120897179	rs10886401	T	C	16	27	43	0	0	43	0	0
10	121188664	rs933048	T	C	6	1	7	0	0	7	0	0
10	121336248	rs12356865	T	C	480	524	1004	0	6	1010	0	0
10	121338702	rs7098960	G	A	61	38	99	0	1	100	0	0
10	121340908	rs4752335	A	G	6	3	9	0	0	9	0	0
10	121345949	rs11199028	C	T	1	5	6	0	0	6	0	0
10	121347832	rs11199031	C	A	14	11	25	0	1	26	0	0
10	121352029	rs12252751	T	C	19	15	34	0	0	34	0	0
10	121356382	rs7919868	C	T	21	22	43	0	3	46	0	0
10	121436362	rs196295	A	G	27	28	55	0	1	56	0	0
10	121551581	rs2289306	A	C	5	7	12	0	0	12	0	0
10	121586827	rs56055506	A	G	17	19	36	0	0	36	0	0
10	121588038	rs1063224	A	C	29	33	62	0	0	62	0	0
10	121588201	rs1129793	T	C	39	30	69	0	1	70	0	0
10	121588537	rs1048120	A	G	54	23	77	0	1	78	0	0
10	121589274	rs41287946	C	A	9	5	14	0	0	14	0	0
10	121589402	rs6881	T	G	11	8	19	0	3	22	0	0
10	121596498	rs34118671	C	T	67	66	133	0	3	136	0	0
10	121653399	rs61870583	A	C	6	2	8	0	0	8	0	0
10	121700255	rs1052289	C	T	19	21	40	0	0	40	0	0
10	122114196	rs12776110	T	A	99	0	99	0	1	100	0	0
10	122114550	.	T	A	15	0	15	0	2	17	0	0
10	122557599	rs10430636	G	A	1	6	7	0	0	7	0	0
10	122620616	rs11199604	A	C	3	4	7	0	0	7	0	0
10	122622121	rs3816173	A	C	3	3	6	0	0	6	0	0
10	122624679	rs10886789	G	A	25	23	48	0	0	48	0	0
10	122634099	rs11199619	G	T	5	9	14	0	0	14	0	0
10	122634104	rs11199620	T	G	5	9	14	0	0	14	0	0
10	122634955	rs12784249	A	G	0	7	7	0	1	8	0	0
10	122635088	rs12247484	C	G	5	1	6	0	0	6	0	0
10	122635117	rs1972859	G	A	4	2	6	0	0	6	0	0
10	122635406	rs17508494	A	G	3	5	8	0	0	8	0	0
10	122638836	rs3758508	G	A	5	3	8	0	0	8	0	0
10	122638860	rs3758509	G	A	6	3	9	0	0	9	0	0
10	122639170	rs3758510	A	C	4	4	8	0	0	8	0	0
10	122639901	rs4751804	G	A	6	3	9	0	0	9	0	0
10	122642950	rs7921767	A	G	3	4	7	0	0	7	0	0
10	122644850	rs4626994	T	C	5	1	6	0	0	6	0	0
10	122644887	rs4408243	C	T	6	1	7	0	0	7	0	0
10	122645376	rs7899928	A	T	22	20	42	0	0	42	0	0
10	122645649	rs7903356	A	G	3	3	6	0	0	6	0	0
10	122646113	rs7079527	C	T	8	2	10	0	0	10	0	0
10	122646126	rs7079781	G	A	7	2	9	0	1	10	0	0
10	122659078	rs11199634	T	C	2	4	6	0	0	6	0	0
10	122663585	rs1652727	G	A	34	45	79	0	1	80	0	0
10	122664967	rs1866516	C	T	4	7	11	0	0	11	0	0
10	122665310	rs3740306	T	A	9	10	19	0	0	19	0	0
10	122665758	rs2420894	T	C	13	19	32	0	1	33	0	0
10	122665844	rs41309992	C	T	20	18	38	0	1	39	0	0
10	122667022	rs1530116	T	G	6	9	15	0	0	15	0	0
10	122667844	rs10788128	G	A	16	17	33	0	0	33	0	0
10	122668296	rs7077126	G	A	86	96	182	0	2	184	0	0
10	122668604	rs1045154	G	A	40	48	88	0	0	88	0	0
10	122668782	rs1045170	G	T	98	121	219	0	1	220	0	0
10	122668801	rs1045179	A	C	99	138	237	0	1	238	0	0
10	123501170	rs1696834	C	G	12	4	16	0	0	16	0	0
10	123501880	.	G	A	5	3	8	0	0	8	0	0
10	123502932	rs1219497	G	A	2	8	10	0	1	11	0	0
10	123587732	rs4752606	C	T	4	2	6	0	0	6	0	0
10	123596254	rs4237536	T	C	13	10	23	0	0	23	0	0
10	123648591	rs4752616	C	T	22	29	51	0	0	51	0	0
10	123648739	rs7077052	G	A	4	3	7	0	0	7	0	0
10	123649254	rs4752617	G	A	3	4	7	0	0	7	0	0
10	123658228	rs10788221	G	A	2	5	7	0	0	7	0	0
10	123673339	rs10749435	T	C	14	21	35	0	0	35	0	0
10	123687456	rs79570924	G	A	9	8	17	0	0	17	0	0
10	123726877	rs2420974	A	G	4	5	9	0	0	9	0	0
10	124742858	rs45498396	G	A	19	22	41	0	0	41	0	0
10	124754529	rs9423242	T	C	8	2	10	0	0	10	0	0
10	124755057	rs9423243	A	G	17	18	35	0	1	36	0	0
10	124755111	rs9423244	G	T	21	14	35	0	0	35	0	0
10	124757500	rs4980242	T	A	7	4	11	0	0	11	0	0
10	124758693	rs9423245	A	G	8	4	12	0	0	12	0	0
10	124758988	rs61863177	C	T	9	11	20	0	0	20	0	0
10	124759408	rs9328841	C	T	1	5	6	0	0	6	0	0
10	124763196	rs9423306	A	G	2	5	7	0	0	7	0	0
10	124765146	rs10902857	T	C	6	8	14	0	0	14	0	0
10	124765314	rs10902858	C	A	3	5	8	0	0	8	0	0
10	124765857	rs9328842	T	C	5	47	52	0	0	52	0	0
10	124768034	rs2277249	A	G	3	4	7	0	0	7	0	0
10	124768292	rs2277250	G	A	14	11	25	0	1	26	0	0
10	124800853	rs1140591	C	T	9	4	13	0	0	13	0	0
10	124813543	rs12248515	C	T	3	4	7	0	1	8	0	0
10	124813826	rs1140593	G	A	7	3	10	0	0	10	0	0
10	124815612	rs7079265	C	G	7	5	12	0	0	12	0	0
10	124817707	rs7732	T	C	8	2	10	0	0	10	0	0
10	125843019	rs7900094	C	T	9	7	16	0	0	16	0	0
10	125843462	rs4929815	G	A	7	6	13	0	0	13	0	0
10	125843539	rs4929814	T	C	11	10	21	0	1	22	0	0
10	126085976	rs8182	A	G	5	3	8	0	0	8	0	0
10	126089434	rs11461	G	A	33	57	90	0	0	90	0	0
10	126303580	rs11245318	C	T	4	3	7	0	0	7	0	0
10	126309448	rs10751601	C	G	44	35	79	0	2	81	0	0
10	126309618	rs11555451	G	A	21	27	48	0	0	48	0	0
10	126310042	rs3740537	G	A	32	27	59	0	0	59	0	0
10	126310781	rs3802701	C	T	30	17	47	0	0	47	0	0
10	126435598	rs10901815	G	A	13	6	19	0	0	19	0	0
10	126446592	rs1055256	A	G	3	3	6	0	0	6	0	0
10	126447545	rs4962697	G	C	2	4	6	0	0	6	0	0
10	126461368	rs2363340	C	A	5	1	6	0	0	6	0	0
10	126517989	rs2303611	G	A	46	35	81	0	0	81	0	0
10	126674852	.	G	A	36	211	247	0	9	256	0	0
10	126674854	rs148576335	G	A	19	246	265	0	5	271	1	0
10	126675765	rs78159028	G	C	15	17	32	0	1	33	0	0
10	126790334	rs1152687	C	T	8	8	16	0	1	17	0	0
10	126794677	rs71488651	A	G	2	4	6	0	0	6	0	0
10	126821501	rs74573605	T	A	4	2	6	0	0	6	0	0
10	126840272	rs1041191	C	T	3	4	7	0	0	7	0	0
10	126843367	rs1693656	G	A	8	1	9	0	1	10	0	0
10	126843661	rs1693655	C	T	5	1	6	0	0	6	0	0
10	127436774	rs11244632	T	C	7	1	8	0	1	9	0	0
10	127482764	rs41315014	T	C	7	6	13	0	0	13	0	0
10	127482950	rs2149019	G	A	4	5	9	0	0	9	0	0
10	127511756	rs4256900	C	T	4	2	6	0	0	6	0	0
10	127518538	rs11244667	G	A	3	7	10	0	0	10	0	0
10	127520313	rs11596442	A	G	4	2	6	0	0	6	0	0
10	127522572	rs3740206	T	G	6	5	11	0	0	11	0	0
10	127522988	rs2185740	A	T	4	7	11	0	0	11	0	0
10	127523959	rs1891361	T	C	9	4	13	0	0	13	0	0
10	127523964	rs10901452	C	T	4	9	13	0	0	13	0	0
10	127524156	rs113387133	A	C	14	8	22	0	0	22	0	0
10	127524168	rs1891360	C	A	8	9	17	0	1	18	0	0
10	127524612	rs4075326	C	T	29	16	45	0	0	45	0	0
10	127525072	rs7320	A	C	20	19	39	0	1	40	0	0
10	127530325	rs3208565	T	C	53	64	117	0	0	117	0	0
10	127536562	rs10794027	C	T	5	1	6	0	0	6	0	0
10	127584798	.	G	C	15	0	15	0	0	15	0	0
10	127584806	.	T	G	12	0	12	0	0	12	0	0
10	128931362	rs117478737	C	T	17	6	23	0	0	23	0	0
10	128990908	rs116898437	G	A	5	2	7	0	0	7	0	0
10	129160458	rs2296635	G	A	4	5	9	0	0	9	0	0
10	129245684	rs869801	G	A	3	6	9	0	0	9	0	0
10	129249676	rs2229604	C	T	4	2	6	0	0	6	0	0
10	129249693	rs2229605	G	A	4	3	7	0	0	7	0	0
10	129249914	rs3824814	T	C	5	4	9	0	0	9	0	0
10	129249925	rs10765104	T	C	5	4	9	0	0	9	0	0
10	129250075	rs3740543	A	G	2	4	6	0	0	6	0	0
10	129250603	rs1051039	G	C	2	5	7	0	1	8	0	0
10	129845902	rs71474240	G	A	79	90	169	0	3	172	0	0
10	129847120	rs11016036	G	T	3	3	6	0	0	6	0	0
10	129847143	rs11016037	T	A	4	3	7	0	0	7	0	0
10	129849141	rs75969782	C	T	3	5	8	0	0	8	0	0
10	129850031	rs35466784	G	A	6	10	16	0	1	17	0	0
10	129850468	rs79609033	A	G	11	8	19	0	0	19	0	0
10	129851621	rs10829321	A	G	9	6	15	0	0	15	0	0
10	129852019	rs3935271	T	A	1	5	6	0	0	6	0	0
10	129852023	rs3935272	T	A	1	5	6	0	0	6	0	0
10	129852604	rs4072674	C	T	12	10	22	0	0	22	0	0
10	129854145	rs11016039	C	T	13	6	19	0	0	19	0	0
10	129854170	rs147627764	C	T	12	6	18	0	0	18	0	0
10	129854507	rs41282862	C	T	10	4	14	0	0	14	0	0
10	129855795	rs12249657	G	A	8	7	15	0	0	15	0	0
10	129856766	rs78631845	C	T	15	8	23	0	0	23	0	0
10	129858250	rs11016045	G	A	17	18	35	0	1	36	0	0
10	129859408	rs55962763	T	C	8	12	20	0	0	20	0	0
10	129859424	rs9943415	C	A	13	10	23	0	0	23	0	0
10	129859769	rs9943332	G	A	17	8	25	0	0	25	0	0
10	129860197	rs4462252	A	G	2	6	8	0	0	8	0	0
10	129861497	rs56204987	G	A	3	3	6	0	1	7	0	0
10	129865164	rs71474242	G	A	3	5	8	0	0	8	0	0
10	129865173	rs71474243	T	C	3	6	9	0	0	9	0	0
10	129866449	rs7100666	C	G	191	208	399	0	2	401	0	0
10	129870293	rs11016049	G	C	6	8	14	0	0	14	0	0
10	129871747	rs2275802	C	T	5	5	10	0	0	10	0	0
10	129871748	rs78196136	G	A	5	4	9	0	0	9	0	0
10	129871795	rs11016053	C	T	4	4	8	0	0	8	0	0
10	129872292	rs75417958	C	T	11	9	20	0	0	20	0	0
10	129872306	rs74515350	A	G	10	10	20	0	0	20	0	0
10	129872422	rs74901619	A	G	5	6	11	0	0	11	0	0
10	129873034	rs77833927	C	T	2	4	6	0	0	6	0	0
10	129873716	rs12240505	C	A	3	7	10	0	0	10	0	0
10	129876650	rs7080285	T	C	12	32	44	0	0	44	0	0
10	129877659	rs3763790	G	T	32	19	51	0	2	53	0	0
10	129879250	rs75569731	G	A	7	8	15	0	0	15	0	0
10	129880141	rs12252890	T	C	7	15	22	0	0	22	0	0
10	129880546	rs71474244	T	C	3	3	6	0	0	6	0	0
10	129880619	rs115853816	G	T	6	11	17	0	1	18	0	0
10	129881701	rs7085589	A	G	87	105	192	0	0	192	0	0
10	129881778	rs3210509	T	A	97	125	222	0	0	222	0	0
10	129881990	rs71474245	C	G	115	200	315	0	0	315	0	0
10	129882119	rs1127299	A	G	116	161	277	0	2	279	0	0
10	129882401	rs4278435	C	T	94	119	213	0	7	220	0	0
10	129882553	rs4548544	G	A	76	101	177	0	0	177	0	0
10	129882573	rs35359629	T	C	87	101	188	0	3	191	0	0
10	129882640	rs4568912	A	G	85	148	233	0	4	237	0	0
10	129882699	rs4367863	A	G	96	148	244	0	2	246	0	0
10	129883110	rs4237449	T	C	150	234	384	0	0	384	0	0
10	129883121	rs3186827	C	A	133	191	324	0	1	325	0	0
10	129883291	rs4750684	G	T	212	259	471	0	5	476	0	0
10	129883370	rs1129205	A	G	202	246	448	0	4	452	0	0
10	129883933	rs6911	C	T	57	94	151	0	4	155	0	0
10	129895452	rs2071497	G	C	70	86	156	0	2	158	0	0
10	129899629	rs16912247	G	A	131	112	243	0	1	244	0	0
10	129899778	rs11106	G	C	88	92	180	0	1	181	0	0
10	129901066	rs114687140	C	A	69	76	145	0	1	146	0	0
10	129901393	rs11016071	T	C	68	70	138	0	0	138	0	0
10	129901722	rs10082432	G	A	54	56	110	0	0	110	0	0
10	129901726	rs10082533	C	T	53	57	110	0	1	111	0	0
10	129901825	rs10082391	T	C	45	59	104	0	0	104	0	0
10	129901946	rs1050767	T	G	56	49	105	0	1	106	0	0
10	129902158	rs12777740	C	T	42	40	82	0	0	82	0	0
10	129902368	rs79661992	T	A	45	63	108	0	0	108	0	0
10	129904477	rs11591817	C	T	25	29	54	0	0	54	0	0
10	129906427	rs41306015	C	A	21	10	31	0	1	32	0	0
10	129906468	rs4750936	C	T	16	25	41	0	0	41	0	0
10	129906674	rs41300566	T	C	26	20	46	0	0	46	0	0
10	129907489	rs2853344	G	A	20	18	38	0	0	38	0	0
10	129907544	rs2240	G	C	16	16	32	0	0	32	0	0
10	129911856	.	C	G	15	17	32	0	0	32	0	0
10	131973459	rs7918967	T	G	5	2	7	0	0	7	0	0
10	131973554	rs4751171	C	T	4	7	11	0	0	11	0	0
10	131974419	rs75454187	C	T	4	4	8	0	0	8	0	0
10	131975342	rs10829699	A	G	3	5	8	0	0	8	0	0
10	131977270	rs76087798	A	G	9	5	14	0	0	14	0	0
10	131979445	rs12765885	A	G	7	9	16	0	0	16	0	0
10	131979574	rs11017118	G	A	7	6	13	0	1	14	0	0
10	131979825	rs11017119	T	C	5	9	14	0	0	14	0	0
10	131979932	rs34926437	A	C	7	12	19	0	0	19	0	0
10	133752150	rs34536919	T	A	5	3	8	0	0	8	0	0
10	133752420	rs67378218	A	C	4	2	6	0	0	6	0	0
10	133758358	rs9419387	G	A	7	7	14	0	0	14	0	0
10	133758379	rs9419217	A	G	8	6	14	0	0	14	0	0
10	133758441	rs11813081	G	C	8	4	12	0	0	12	0	0
10	133761285	rs34473884	G	A	20	30	50	0	0	50	0	0
10	133767445	rs11146324	A	C	5	3	8	0	0	8	0	0
10	133767529	rs11146325	A	G	7	5	12	0	0	12	0	0
10	133768629	rs142165811	G	T	4	4	8	0	0	8	0	0
10	133769482	rs7894	G	C	65	54	119	0	2	121	0	0
10	133769568	rs11146336	G	A	75	52	127	0	0	127	0	0
10	133769848	rs7199	C	G	49	46	95	0	0	95	0	0
10	133770201	rs7077744	C	T	3	4	7	0	0	7	0	0
10	133771196	rs112610682	G	A	8	1	9	0	0	9	0	0
10	134021149	rs1046577	T	C	5	4	9	0	0	9	0	0
10	134021506	rs79220014	G	A	2	4	6	0	0	6	0	0
10	134021634	rs146688423	G	C	4	4	8	0	0	8	0	0
10	134218269	rs11146363	C	T	8	4	12	0	1	13	0	0
10	134219852	rs12242690	A	C	6	3	9	0	0	9	0	0
10	134220016	rs72863868	C	T	2	4	6	0	0	6	0	0
10	134220137	rs34941889	C	T	4	2	6	0	0	6	0	0
10	134220175	rs34487453	G	A	4	4	8	0	0	8	0	0
10	134233608	rs10781573	C	A	3	3	6	0	0	6	0	0
10	134540603	rs55746003	C	A	14	15	29	0	0	29	0	0
10	134540672	rs55969099	G	A	14	17	31	0	1	32	0	0
10	134593766	.	G	A	2	4	6	0	0	6	0	0
10	134595820	rs117781339	G	C	15	6	21	0	0	21	0	0
10	135088595	rs112711355	G	A	12	5	17	0	0	17	0	0
10	135093673	rs12778349	C	T	23	27	50	0	0	50	0	0
10	135094374	rs111239039	G	T	11	3	14	0	0	14	0	0
10	135094466	.	T	C	8	7	15	0	0	15	0	0
10	135108541	.	C	T	35	32	67	0	0	67	0	0
10	135176853	rs7076650	G	A	0	14	14	0	0	14	0	0
10	135176855	rs377176254	G	A	14	0	14	0	1	15	0	0
10	135176859	rs7076652	G	A	1	10	11	0	0	11	0	0
10	135176888	.	C	T	7	6	13	0	1	14	0	0
10	135176965	rs7076835	G	A	10	10	20	0	0	20	0	0
10	135178319	rs11818389	T	C	20	13	33	0	0	33	0	0
10	135213263	rs2814206	T	C	4	2	6	0	0	6	0	0
10	135213466	rs2253097	G	A	1	6	7	0	0	7	0	0
10	135213854	rs7913420	C	T	1	6	7	0	0	7	0	0
10	135227797	rs4437955	G	A	5	2	7	0	0	7	0	0
10	135227835	rs4628602	G	A	4	3	7	0	0	7	0	0
10	135229239	rs7921041	G	C	7	1	8	0	0	8	0	0
10	135230128	rs71484072	A	G	15	3	18	0	0	18	0	0
10	135233840	rs1052582	C	G	36	52	88	0	0	88	0	0
10	135234580	rs2297032	C	T	9	1	10	0	0	10	0	0
10	135234848	rs2297033	C	T	5	6	11	0	0	11	0	0
10	135235321	rs12253520	C	A	5	5	10	0	0	10	0	0
10	135235551	rs550824196	C	T	4	3	7	0	0	7	0	0
11	135029	.	C	T	1	25	26	0	1	27	0	0
11	138956	.	C	T	14	1	15	0	0	15	0	0
11	138985	.	C	A	7	8	15	0	0	15	0	0
11	190650	.	A	G	6	0	6	0	0	6	0	0
11	204680	rs11245997	G	A	38	21	59	0	0	59	0	0
11	211786	.	A	G	28	19	47	0	0	47	0	0
11	243817	rs17156013	T	C	10	10	20	0	0	20	0	0
11	247906	rs3020899	C	G	24	19	43	0	0	43	0	0
11	248100	rs146218938	G	A	8	7	15	0	0	15	0	0
11	248804	.	G	A	374	303	677	0	2	679	0	0
11	250877	rs12793187	C	T	22	22	44	0	0	44	0	0
11	289507	.	G	C	14	16	30	0	0	30	0	0
11	307912	rs7480474	T	C	3	4	7	0	0	7	0	0
11	308059	rs117325804	T	C	4	2	6	0	0	6	0	0
11	308065	rs9704108	T	C	4	2	6	0	0	6	0	0
11	308290	rs1058900	T	C	875	721	1596	0	5	1601	0	0
11	308363	rs1058935	G	C	884	789	1673	0	16	1690	1	0
11	308426	rs1058964	G	C	664	229	893	0	7	900	0	0
11	308555	rs4990600	G	C	11	11	22	0	0	22	0	0
11	320115	rs3835195	G	A	5	11	16	0	0	16	0	0
11	320166	rs28655829	T	C	6	7	13	0	0	13	0	0
11	320237	.	C	G	11	2	13	0	0	13	0	0
11	324630	rs6598043	G	C	2	5	7	0	0	7	0	0
11	324699	rs6598041	C	T	2	9	11	0	1	12	0	0
11	324864	.	G	C	5	15	20	0	1	21	0	0
11	324880	rs7395116	G	C	4	13	17	0	0	17	0	0
11	325244	rs11246066	C	A	14	4	18	0	2	20	0	0
11	325249	rs7931303	A	G	16	5	21	0	1	22	0	0
11	325386	rs9666598	C	G	16	11	27	0	0	27	0	0
11	325418	rs61876250	G	C	10	8	18	0	0	18	0	0
11	330061	rs9666761	A	G	2	19	21	0	0	21	0	0
11	372157	rs34063493	C	T	6	7	13	0	0	13	0	0
11	372700	rs35475866	G	C	7	8	15	0	0	15	0	0
11	378801	rs139300802	A	G	3	4	7	0	0	7	0	0
11	378847	rs12360752	A	G	4	6	10	0	0	10	0	0
11	379097	rs12361394	T	C	3	3	6	0	0	6	0	0
11	379598	rs1134699	A	G	3	3	6	0	0	6	0	0
11	403980	rs11748	G	A	12	2	14	0	0	14	0	0
11	404317	rs1134578	C	T	9	4	13	0	0	13	0	0
11	405890	rs149327987	T	C	355	380	735	0	2	737	0	0
11	411667	.	A	G	7	0	7	0	1	8	0	0
11	411681	.	T	G	4	3	7	0	0	7	0	0
11	413324	rs7948644	C	A	1	7	8	0	1	9	0	0
11	413330	rs7931467	G	A	1	8	9	0	0	9	0	0
11	415524	rs73400598	C	T	8	6	14	0	0	14	0	0
11	418025	rs7228	G	C	8	8	16	0	0	16	0	0
11	419994	rs12418575	C	A	3	5	8	0	0	8	0	0
11	420139	rs150653380	C	A	10	2	12	0	0	12	0	0
11	420311	rs139768617	C	T	4	2	6	0	0	6	0	0
11	499412	rs59653473	G	T	43	35	78	0	1	79	0	0
11	500278	rs7131513	C	T	5	4	9	0	0	9	0	0
11	554659	rs11246184	G	A	1	6	7	0	0	7	0	0
11	554798	rs12277611	T	C	2	6	8	0	0	8	0	0
11	558884	rs2061586	C	T	4	3	7	0	0	7	0	0
11	644302	rs112961503	A	C	50	52	102	0	0	102	0	0
11	703595	rs71469814	C	T	4	8	12	0	0	12	0	0
11	767443	.	T	C	32	26	58	0	0	58	0	0
11	866133	rs11246335	G	A	3	5	8	0	0	8	0	0
11	1491096	rs9440	G	A	75	53	128	0	0	128	0	0
11	1492994	rs7945160	C	G	3	6	9	0	0	9	0	0
11	1493609	rs11029890	A	G	3	3	6	0	0	6	0	0
11	1501670	rs10742185	G	C	26	24	50	0	0	50	0	0
11	1502097	rs10767696	A	G	10	15	25	0	0	25	0	0
11	1576005	rs59483236	T	C	27	15	42	0	0	42	0	0
11	1576008	rs61869676	G	A	29	17	46	0	0	46	0	0
11	1576079	rs1982827	C	T	26	40	66	0	1	67	0	0
11	1576137	rs11604635	C	T	38	53	91	0	0	91	0	0
11	1576283	rs11603496	G	A	31	25	56	0	1	57	0	0
11	1579018	rs113161544	T	C	17	17	34	0	0	34	0	0
11	1583340	rs12419687	G	T	4	3	7	0	0	7	0	0
11	1588851	rs11033802	C	T	2	8	10	0	0	10	0	0
11	1588871	rs11033805	G	A	1	9	10	0	0	10	0	0
11	1588981	rs7927941	C	T	4	6	10	0	0	10	0	0
11	1589989	rs12295766	G	A	3	5	8	0	0	8	0	0
11	1949664	rs142433698	C	T	2	6	8	0	0	8	0	0
11	2317951	rs12800998	C	T	70	28	98	0	0	98	0	0
11	2322415	rs756921	G	T	24	11	35	0	0	35	0	0
11	2322434	.	C	A	25	14	39	0	1	40	0	0
11	2322561	rs756922	A	G	16	5	21	0	0	21	0	0
11	2322662	rs756923	T	C	16	5	21	0	1	22	0	0
11	2322829	rs11022157	C	A	17	12	29	0	0	29	0	0
11	2323022	rs12276847	C	T	43	21	64	0	2	66	0	0
11	2323029	rs756924	T	C	42	21	63	0	0	63	0	0
11	2323528	rs2074021	T	C	5	2	7	0	0	7	0	0
11	2323619	rs2234290	G	T	16	11	27	0	0	27	0	0
11	2324041	rs2074022	A	G	38	32	70	0	3	73	0	0
11	2329995	rs11554947	C	T	52	54	106	0	1	107	0	0
11	2338240	rs11022258	A	T	10	6	16	0	2	18	0	0
11	2338256	rs11022259	A	G	15	12	27	0	0	27	0	0
11	2357563	rs2106606	T	C	7	4	11	0	0	11	0	0
11	2386600	rs808964	G	A	2	5	7	0	0	7	0	0
11	2408624	rs731909	G	C	3	6	9	0	0	9	0	0
11	2409173	rs800334	T	G	4	5	9	0	0	9	0	0
11	2409250	rs2283148	G	A	4	2	6	0	0	6	0	0
11	2410099	rs708564	C	T	4	3	7	0	0	7	0	0
11	2410901	rs2522012	G	T	5	2	7	0	0	7	0	0
11	2410902	rs2522013	C	A	5	2	7	0	0	7	0	0
11	2410941	rs800335	C	T	6	4	10	0	0	10	0	0
11	2414702	rs800349	T	G	23	26	49	0	1	50	0	0
11	2415964	rs800350	G	A	15	9	24	0	0	24	0	0
11	2423545	rs11555995	A	G	90	64	154	0	3	157	0	0
11	2936200	rs11024555	G	A	4	2	6	0	0	6	0	0
11	2977523	rs117781940	G	A	11	8	19	0	0	19	0	0
11	2983937	rs74792784	A	G	7	2	9	0	0	9	0	0
11	3108535	rs117001564	C	T	16	41	57	0	0	57	0	0
11	3114190	rs35733103	C	T	36	31	67	0	1	68	0	0
11	3141744	rs34950527	C	T	9	6	15	0	0	15	0	0
11	3381707	.	A	G	59	78	137	0	0	137	0	0
11	3392811	rs72848292	G	A	31	26	57	0	0	57	0	0
11	3723561	.	T	A	6	0	6	0	0	6	0	0
11	3847293	rs1055640	A	G	52	49	101	0	0	101	0	0
11	3876457	rs61899393	C	T	6	1	7	0	0	7	0	0
11	3877074	rs10835206	C	T	16	11	27	0	0	27	0	0
11	3913476	rs74050940	A	G	10	14	24	0	0	24	0	0
11	3913663	rs10835252	G	T	10	14	24	0	0	24	0	0
11	3913738	rs10767684	A	G	10	12	22	0	0	22	0	0
11	3913861	rs10458895	T	G	12	12	24	0	1	25	0	0
11	3914033	rs10767685	C	A	14	10	24	0	0	24	0	0
11	4088356	rs2920142	G	A	4	2	6	0	0	6	0	0
11	4105273	rs67065286	A	C	5	4	9	0	0	9	0	0
11	4105296	rs7104462	G	C	5	4	9	0	0	9	0	0
11	4105953	.	A	C	5	7	12	0	0	12	0	0
11	4106416	rs10835601	G	A	4	4	8	0	0	8	0	0
11	4108060	.	G	A	11	15	26	0	0	26	0	0
11	4116885	.	C	T	4	3	7	0	0	7	0	0
11	4117155	rs1662172	T	C	4	6	10	0	0	10	0	0
11	4117730	rs10835611	G	C	7	1	8	0	0	8	0	0
11	4118956	rs7111104	G	C	3	7	10	0	0	10	0	0
11	4119667	.	C	T	6	2	8	0	0	8	0	0
11	4142172	rs2056853	C	T	6	3	9	0	0	9	0	0
11	4149214	rs2284450	A	T	7	3	10	0	0	10	0	0
11	4153231	rs4910889	T	C	4	5	9	0	0	9	0	0
11	4153407	rs4910890	C	T	4	5	9	0	0	9	0	0
11	4153408	rs4910891	A	G	4	5	9	0	0	9	0	0
11	4406479	rs4144331	G	T	171	144	315	0	2	318	1	0
11	4408567	rs2599586	A	G	6	6	12	0	0	12	0	0
11	4408942	rs10835992	A	C	4	3	7	0	0	7	0	0
11	4408985	rs10835993	C	T	5	3	8	0	0	8	0	0
11	4409191	rs2599587	A	C	2	4	6	0	0	6	0	0
11	4409386	rs2554933	C	T	4	3	7	0	0	7	0	0
11	4620861	rs4910638	C	A	18	15	33	0	0	33	0	0
11	5247141	rs1609812	G	A	8	4	12	0	0	12	0	0
11	5247726	rs7946748	G	A	3	6	9	0	0	9	0	0
11	5248243	rs713040	A	G	2413	2363	4776	0	20	4796	0	0
11	5269584	rs1065686	T	A	94	0	94	0	15	235	126	0
11	5625784	rs3751005	A	G	7	9	16	0	0	16	0	0
11	5625847	rs3751006	A	G	3	6	9	0	0	9	0	0
11	5632212	rs10769124	G	A	9	22	31	0	1	32	0	0
11	5664831	rs3740998	C	A	5	7	12	0	0	12	0	0
11	5684887	rs6578672	A	G	3	8	11	0	0	11	0	0
11	5685619	rs55723753	C	A	16	11	27	0	2	29	0	0
11	5688940	rs11038628	C	T	3	16	19	0	0	19	0	0
11	5701409	rs3824949	G	C	11	3	14	0	0	14	0	0
11	5705354	rs1814722	C	T	5	2	7	0	0	7	0	0
11	5718101	rs10838544	G	A	23	21	44	0	1	45	0	0
11	5718151	rs11038746	A	G	17	25	42	0	0	42	0	0
11	5718213	rs10838546	C	A	11	29	40	0	1	41	0	0
11	5718517	rs7935564	G	A	89	76	165	0	1	166	0	0
11	5718712	rs7936676	C	T	39	55	94	0	2	96	0	0
11	5718742	rs7935903	G	A	39	62	101	0	1	102	0	0
11	5718817	rs7935929	G	A	55	75	130	0	2	132	0	0
11	5718975	rs12421805	A	C	42	48	90	0	1	91	0	0
11	5719095	rs10838548	A	G	43	36	79	0	1	80	0	0
11	5719750	rs1063303	G	C	152	129	281	0	1	283	1	0
11	5727167	rs10769188	A	C	4	4	8	0	0	8	0	0
11	5728212	rs12282048	G	A	4	3	7	0	0	7	0	0
11	5737641	rs11038824	G	T	17	0	17	0	0	17	0	0
11	5737663	rs12280066	G	A	16	0	16	0	0	16	0	0
11	5739224	rs12270724	C	G	12	12	24	0	0	24	0	0
11	5739623	rs77414950	T	C	7	8	15	0	0	15	0	0
11	5822849	rs1453421	T	C	2	6	8	0	0	8	0	0
11	5822926	rs1453420	C	T	3	5	8	0	0	8	0	0
11	5822927	rs10838655	T	A	3	5	8	0	0	8	0	0
11	5823198	rs4758100	A	C	4	3	7	0	0	7	0	0
11	6234753	rs11040807	T	C	6	2	8	0	0	8	0	0
11	6237565	rs4758400	G	C	10	17	27	0	1	28	0	0
11	6238960	rs3750943	C	A	5	2	7	0	1	8	0	0
11	6239344	rs3750944	G	A	60	58	118	0	0	118	0	0
11	6412931	rs7951904	T	C	15	14	29	0	0	29	0	0
11	6414117	rs72896270	G	A	5	2	7	0	0	7	0	0
11	6415392	rs11601088	C	T	35	16	51	0	1	52	0	0
11	6415882	rs8164	G	A	108	84	192	0	2	194	0	0
11	6416959	rs1800606	C	T	7	1	8	0	0	8	0	0
11	6418298	rs72896284	A	T	11	11	22	0	0	22	0	0
11	6420261	rs2723656	T	C	3	10	13	0	0	13	0	0
11	6513059	rs61876821	G	A	10	14	24	0	0	24	0	0
11	6536323	rs144560104	A	G	5	7	12	0	0	12	0	0
11	6653747	rs111781030	C	T	7	13	20	0	0	20	0	0
11	8009241	rs12421289	C	T	288	301	589	0	3	592	0	0
11	8009420	rs12278319	G	A	7	4	11	0	0	11	0	0
11	8010282	rs77787920	C	T	5	4	9	0	0	9	0	0
11	8012077	rs7951923	A	C	5	9	14	0	0	14	0	0
11	8012284	rs10839958	A	T	7	6	13	0	0	13	0	0
11	8016499	rs56392532	C	T	12	20	32	0	0	32	0	0
11	8018591	rs11041703	G	T	11	7	18	0	0	18	0	0
11	8019687	rs11041704	A	G	5	9	14	0	0	14	0	0
11	8019790	rs6578918	C	A	10	13	23	0	0	23	0	0
11	8020344	rs922062	G	A	4	6	10	0	0	10	0	0
11	8020627	rs6578919	A	G	8	10	18	0	0	18	0	0
11	8021226	rs74610841	G	A	15	11	26	0	0	26	0	0
11	8022014	rs4758038	C	T	16	24	40	0	0	40	0	0
11	8022345	rs11041705	A	G	16	32	48	0	2	50	0	0
11	8022889	rs1132659	C	T	55	27	82	0	0	82	0	0
11	8022892	rs1132660	G	A	28	55	83	0	0	83	0	0
11	8486310	rs1446464	C	A	1	5	6	0	0	6	0	0
11	8645510	rs10160373	C	T	4	6	10	0	2	12	0	0
11	8705480	rs7951084	T	C	10	16	26	0	0	26	0	0
11	8706628	rs2073685	G	A	34	29	63	0	0	63	0	0
11	8707083	rs2073686	G	A	58	55	113	0	1	114	0	0
11	8707233	rs6735	C	T	5993	4843	10836	0	49	10885	0	0
11	8708527	rs35957960	C	T	49	52	101	0	2	103	0	0
11	8709241	rs7945657	T	G	5	8	13	0	0	13	0	0
11	8709551	rs10840111	T	C	14	18	32	0	0	32	0	0
11	8710244	rs10769941	G	T	7	15	22	0	0	22	0	0
11	8719955	rs4929930	T	C	4	5	9	0	0	9	0	0
11	8720615	rs2270958	C	A	2	6	8	0	1	9	0	0
11	8933064	rs1133833	G	A	5	13	18	0	0	18	0	0
11	8941197	rs4910156	T	G	15	10	25	0	0	25	0	0
11	8941215	rs4910157	A	G	17	14	31	0	0	31	0	0
11	8941260	rs4910158	T	C	22	21	43	0	0	43	0	0
11	8971133	rs2742491	T	A	1	5	6	0	0	6	0	0
11	8994715	rs2568020	C	T	4	3	7	0	0	7	0	0
11	9002147	rs2653609	G	A	18	46	64	0	0	64	0	0
11	9002824	rs2742473	A	G	23	70	93	0	1	94	0	0
11	9002932	rs10769978	A	G	66	20	86	0	2	88	0	0
11	9003306	rs1123936	A	G	38	70	108	0	1	109	0	0
11	9003953	rs2742471	C	T	23	57	80	0	0	80	0	0
11	9004002	rs2742470	C	T	19	48	67	0	1	68	0	0
11	9004060	rs2568045	T	C	33	69	102	0	0	102	0	0
11	9161521	rs7396705	C	T	11	20	31	0	0	31	0	0
11	9162868	rs10769993	C	T	7	15	22	0	0	22	0	0
11	9163100	rs10769994	C	T	5	19	24	0	0	24	0	0
11	9163948	rs7395151	C	T	7	7	14	0	0	14	0	0
11	9165126	rs555430698	T	C	7	9	16	0	0	16	0	0
11	9166835	rs1039210	T	C	13	10	23	0	3	26	0	0
11	9168118	rs17256375	A	G	3	3	6	0	0	6	0	0
11	9192702	rs7930507	A	G	51	48	99	0	1	100	0	0
11	9193506	rs7945759	G	A	33	23	56	0	1	57	0	0
11	9195380	rs7120239	A	G	11	13	24	0	0	24	0	0
11	9197926	rs10840186	T	G	5	5	10	0	0	10	0	0
11	9198010	rs7925308	A	G	6	9	15	0	0	15	0	0
11	9198076	rs11607384	A	G	11	13	24	0	0	24	0	0
11	9198276	rs7394878	T	C	7	9	16	0	0	16	0	0
11	9200299	rs7949349	A	G	2	4	6	0	1	7	0	0
11	9252120	rs11042228	G	A	14	1	15	0	0	15	0	0
11	9285736	rs11042252	C	A	5	1	6	0	0	6	0	0
11	9303787	rs7358313	C	T	10	9	19	0	0	19	0	0
11	9303788	rs4910446	G	A	9	10	19	0	1	20	0	0
11	9304120	rs4369406	T	C	2	6	8	0	0	8	0	0
11	9304423	rs4343026	G	A	3	6	9	0	0	9	0	0
11	9304702	rs7939704	T	C	5	7	12	0	0	12	0	0
11	9309759	rs10770006	C	T	33	42	75	0	0	75	0	0
11	9310169	rs10770007	C	A	6	14	20	0	0	20	0	0
11	9310812	rs11042265	G	A	16	24	40	0	0	40	0	0
11	9310840	rs11042266	G	A	16	11	27	0	5	32	0	0
11	9310982	rs11042267	C	T	17	29	46	0	2	48	0	0
11	9311096	rs72861360	G	A	46	30	76	0	0	76	0	0
11	9311128	rs10770008	A	G	32	41	73	0	1	74	0	0
11	9311703	rs10840199	G	A	22	35	57	0	1	58	0	0
11	9311797	rs10770009	A	G	17	21	38	0	0	38	0	0
11	9311843	rs10840200	G	A	20	26	46	0	1	47	0	0
11	9312034	rs10770010	C	A	4	16	20	0	0	20	0	0
11	9312287	rs11042268	T	C	23	12	35	0	1	36	0	0
11	9312836	rs11042269	G	A	3	4	7	0	0	7	0	0
11	9313814	rs7103472	T	C	22	18	40	0	0	40	0	0
11	9313972	rs7115373	G	T	10	5	15	0	0	15	0	0
11	9315322	rs72850512	G	T	5	4	9	0	0	9	0	0
11	9336071	rs4325312	A	G	16	13	29	0	0	29	0	0
11	9336093	rs72850544	C	T	11	13	24	0	0	24	0	0
11	9468367	rs4810	A	G	18	17	35	0	0	35	0	0
11	9468454	rs8785	G	A	53	50	103	0	1	104	0	0
11	9539663	rs10770037	G	A	2	5	7	0	0	7	0	0
11	9606639	rs7113837	T	C	6	3	9	0	0	9	0	0
11	9737755	rs56235379	G	A	5	2	7	0	0	7	0	0
11	9763161	rs75461869	A	T	3	7	10	0	0	10	0	0
11	9764832	rs10840298	C	A	9	2	11	0	0	11	0	0
11	9769562	rs415895	C	G	89	80	169	0	0	170	1	0
11	9771687	rs6483656	G	C	51	35	86	0	1	87	0	0
11	9772840	rs1056593	G	A	152	129	281	0	3	284	0	0
11	9773560	rs75650009	C	G	30	17	47	0	1	48	0	0
11	9800450	rs1045634	C	T	17	8	25	0	0	25	0	0
11	9800601	rs10118	G	A	9	4	13	0	0	13	0	0
11	9801451	rs3829252	G	A	15	17	32	0	0	32	0	0
11	10521749	rs114718879	C	T	6	15	21	0	1	22	0	0
11	10525919	rs11826750	A	G	4	2	6	0	0	6	0	0
11	10533952	rs12448	T	C	73	49	122	0	1	123	0	0
11	10534555	rs56785085	A	C	44	35	79	0	0	79	0	0
11	10535349	rs7929890	G	A	29	28	57	0	0	57	0	0
11	10536116	rs4146830	A	G	13	22	35	0	0	35	0	0
11	10536298	rs1047730	T	C	13	21	34	0	0	34	0	0
11	10541613	rs4909938	C	T	6	4	10	0	0	10	0	0
11	10595075	rs117479720	G	T	4	7	11	0	0	11	0	0
11	10772555	rs2279696	A	G	20	15	35	0	0	35	0	0
11	10829106	rs16908327	C	T	6	16	22	0	0	22	0	0
11	10878223	rs12292697	T	C	15	16	31	0	1	32	0	0
11	10878341	rs56391524	T	C	13	13	26	0	0	26	0	0
11	10900584	rs11042997	C	A	8	5	13	0	0	13	0	0
11	11893217	rs12418890	G	A	0	10	10	0	0	10	0	0
11	11943169	rs7483552	G	C	2	5	7	0	0	7	0	0
11	11968496	rs79175349	A	G	5	8	13	0	0	13	0	0
11	11970971	rs10741563	T	C	3	9	12	0	0	12	0	0
11	11971165	rs10741564	G	A	21	24	45	0	1	46	0	0
11	11972846	rs72857644	A	T	9	6	15	0	0	15	0	0
11	11976628	rs7933089	G	A	252	282	534	0	1	535	0	0
11	11980397	rs13903	T	C	5	12	17	0	0	17	0	0
11	12166863	rs1485959	C	G	5	2	7	0	0	7	0	0
11	12167319	rs11022199	A	G	3	3	6	0	0	6	0	0
11	12167761	rs11022203	C	T	5	1	6	0	0	6	0	0
11	12168082	rs11022206	C	T	4	2	6	0	0	6	0	0
11	12168548	rs12362349	G	A	5	4	9	0	0	9	0	0
11	12225946	rs3763823	T	G	6	24	30	0	0	30	0	0
11	12229655	rs2279390	T	G	12	23	35	0	0	35	0	0
11	12240019	rs12292611	G	A	5	6	11	0	0	11	0	0
11	12240720	rs12294182	C	T	4	5	9	0	0	9	0	0
11	12240944	rs12281126	A	G	7	7	14	0	0	14	0	0
11	12241626	rs7101833	A	G	4	8	12	0	0	12	0	0
11	12302515	rs2403612	G	C	3	5	8	0	0	8	0	0
11	12302528	rs2403613	A	G	4	4	8	0	0	8	0	0
11	12302606	rs4265585	A	G	4	12	16	0	0	16	0	0
11	12315186	rs10741578	G	A	10	7	17	0	0	17	0	0
11	12315848	.	C	T	3	10	13	0	0	13	0	0
11	12315915	rs1493954	A	G	5	10	15	0	0	15	0	0
11	12316389	rs3812754	A	C	2	5	7	0	1	8	0	0
11	13011003	rs61878849	C	A	1	7	8	0	0	8	0	0
11	13396517	rs10832028	T	C	2	7	9	0	0	9	0	0
11	13396909	rs11022780	C	T	5	5	10	0	0	10	0	0
11	13396952	rs10766079	A	G	4	5	9	0	0	9	0	0
11	13399791	rs10832030	A	G	0	6	6	0	0	6	0	0
11	13399878	.	T	C	13	8	21	0	0	21	0	0
11	13400843	.	C	A	6	3	9	0	0	9	0	0
11	13401803	rs3897902	C	A	2	4	6	0	0	6	0	0
11	13402409	rs11022781	A	G	4	6	10	0	0	10	0	0
11	13416396	rs12419639	G	A	3	4	7	0	0	7	0	0
11	13695712	rs112537400	C	T	3	3	6	0	0	6	0	0
11	13695724	rs567170526	C	T	4	2	6	0	0	6	0	0
11	13716530	rs7130943	A	G	2	7	9	0	0	9	0	0
11	13716619	rs71482916	C	A	1	7	8	0	0	8	0	0
11	13719412	rs1406692	T	A	4	6	10	0	0	10	0	0
11	13722680	rs7103760	A	T	1	9	10	0	0	10	0	0
11	13723497	rs7943330	G	T	16	14	30	0	0	30	0	0
11	13725540	rs11022940	A	G	7	3	10	0	0	10	0	0
11	13726909	rs6486137	C	G	22	27	49	0	0	49	0	0
11	13726910	rs1023772	T	G	21	27	48	0	0	48	0	0
11	13728011	rs7128784	A	G	3	4	7	0	0	7	0	0
11	13739556	rs7926942	T	C	6	12	18	0	0	18	0	0
11	13740795	rs78506075	T	G	10	11	21	0	0	21	0	0
11	13742804	rs12275525	G	C	8	11	19	0	2	21	0	0
11	13751505	rs10766106	A	G	12	16	28	0	0	28	0	0
11	14481017	rs2597204	C	T	8	5	13	0	0	13	0	0
11	14499536	rs10766182	A	G	15	5	20	0	0	20	0	0
11	14500334	rs11023237	G	A	17	18	35	0	1	36	0	0
11	14516003	rs10832279	T	A	6	3	9	0	0	9	0	0
11	14516004	rs10832280	T	A	4	4	8	0	0	8	0	0
11	14516906	rs2597188	G	A	3	5	8	0	0	8	0	0
11	14521354	rs2575823	C	A	21	29	50	0	0	50	0	0
11	14524333	rs2597184	G	A	11	19	30	0	0	30	0	0
11	14524366	rs2597183	T	C	14	17	31	0	0	31	0	0
11	14525650	rs1011538	G	A	14	10	24	0	0	24	0	0
11	14527075	rs2597221	C	T	6	14	20	0	0	20	0	0
11	14529874	rs6486197	C	G	3	4	7	0	0	7	0	0
11	14530866	rs2597219	C	G	3	3	6	0	0	6	0	0
11	14532883	rs2597217	A	G	9	24	33	0	0	33	0	0
11	14533368	rs2575852	G	A	4	20	24	0	0	24	0	0
11	14533916	rs2597216	G	A	8	10	18	0	1	19	0	0
11	14533963	rs2575853	T	C	7	11	18	0	0	18	0	0
11	14534378	rs2597215	A	T	7	15	22	0	1	23	0	0
11	14534825	rs1548074	A	G	13	54	67	0	0	67	0	0
11	14542577	rs10766184	A	G	5	6	11	0	0	11	0	0
11	14543325	rs2575839	C	A	3	3	6	0	0	6	0	0
11	14632570	rs1403247	A	C	34	47	81	0	0	81	0	0
11	14669496	rs10832289	A	T	24	16	40	0	4	44	0	0
11	14669802	rs4757261	C	A	12	11	23	0	0	23	0	0
11	14672230	rs10832290	T	C	111	116	227	0	1	228	0	0
11	14672984	rs1403249	G	A	145	155	300	0	3	303	0	0
11	14683001	rs11023295	G	A	5	4	9	0	0	9	0	0
11	14683621	rs10832291	C	T	4	3	7	0	1	8	0	0
11	14684950	rs11023298	C	T	10	2	12	0	0	12	0	0
11	14685343	rs11023299	T	A	7	7	14	0	0	14	0	0
11	14685886	rs6486200	T	C	6	8	14	0	1	15	0	0
11	14686743	rs78474492	T	G	11	6	17	0	0	17	0	0
11	14686952	rs145497491	A	T	16	20	36	0	0	36	0	0
11	14688165	.	T	C	9	11	20	0	0	20	0	0
11	14688747	.	A	G	22	12	34	0	0	34	0	0
11	14727284	rs117698737	A	G	4	5	9	0	0	9	0	0
11	14810762	rs4757268	A	G	6	4	10	0	0	10	0	0
11	14823877	.	G	T	2	4	6	0	0	6	0	0
11	14910234	rs1993116	A	G	2	4	6	0	0	6	0	0
11	14913131	rs10766196	A	G	10	13	23	0	0	23	0	0
11	14913575	rs12794714	G	A	5	2	7	0	0	7	0	0
11	16761806	rs7928675	A	C	6	7	13	0	0	13	0	0
11	16771525	rs72862562	T	C	7	7	14	0	0	14	0	0
11	16772357	rs10766343	G	A	5	12	17	0	0	17	0	0
11	16772590	rs11024031	T	C	6	7	13	0	0	13	0	0
11	16774716	rs12361242	G	A	3	4	7	0	0	7	0	0
11	16775862	rs4757430	A	G	2	5	7	0	0	7	0	0
11	16777132	rs6677	T	G	243	260	503	0	1	504	0	0
11	17097695	rs10832731	G	T	37	33	70	0	1	71	0	0
11	17097866	rs11024149	G	A	40	28	68	0	1	69	0	0
11	17118687	rs11604561	T	C	17	17	34	0	0	34	0	0
11	17144554	rs150345530	T	C	2	7	9	0	0	9	0	0
11	17212375	rs644419	T	C	4	5	9	0	0	9	0	0
11	17298365	rs214087	G	C	100	88	188	0	1	189	0	0
11	17298656	rs214085	C	T	26	13	39	0	0	39	0	0
11	17351683	rs757081	C	G	510	467	977	0	4	982	1	0
11	17364751	rs181066203	T	A	2	4	6	0	0	6	0	0
11	17981047	rs211146	C	T	4	4	8	0	0	8	0	0
11	18039560	rs10832872	G	A	1	11	12	0	0	12	0	0
11	18102232	rs10500831	C	T	1	5	6	0	0	6	0	0
11	18103702	rs56001925	A	C	14	7	21	0	0	21	0	0
11	18104023	rs11024467	T	C	5	1	6	0	0	6	0	0
11	18104328	rs11024468	G	A	11	5	16	0	0	16	0	0
11	18104454	rs11024469	A	G	5	4	9	0	0	9	0	0
11	18108492	rs12363226	T	C	72	62	134	0	0	134	0	0
11	18300625	rs1046628	G	A	12	15	27	0	1	28	0	0
11	18308612	rs4756938	T	C	4	3	7	0	0	7	0	0
11	18318467	.	G	A	14	5	19	0	0	19	0	0
11	18319180	rs7128017	G	T	8	9	17	0	0	17	0	0
11	18327684	rs1140047	G	T	7	8	15	0	0	15	0	0
11	18343694	rs4150530	G	T	5	6	11	0	0	11	0	0
11	18348186	rs117296741	C	T	2	4	6	0	0	6	0	0
11	18348581	rs12293544	T	C	6	1	7	0	0	7	0	0
11	18354995	rs4150562	A	G	6	8	14	0	0	14	0	0
11	18355308	rs4150564	G	A	16	18	34	0	0	34	0	0
11	18355599	rs4150566	C	G	12	12	24	0	0	24	0	0
11	18355907	rs4150572	C	T	18	15	33	0	0	33	0	0
11	18420440	rs7101840	C	T	3	6	9	0	0	9	0	0
11	18421452	rs1969562	A	G	22	26	48	0	0	48	0	0
11	18421455	rs1969563	T	C	22	25	47	0	0	47	0	0
11	18423656	rs117978027	C	G	1	5	6	0	0	6	0	0
11	18424451	rs4687	C	T	925	733	1658	0	20	1678	0	0
11	18424487	rs4820	A	G	975	795	1770	0	19	1791	2	0
11	18424590	rs3758680	T	A	4	2	6	0	0	6	0	0
11	18425018	rs1881716	T	C	4	3	7	0	0	7	0	0
11	18505632	rs2279902	G	A	6	6	12	0	0	12	0	0
11	18524208	rs2658552	C	T	16	19	35	0	1	36	0	0
11	18524490	rs3925781	G	T	17	22	39	0	0	39	0	0
11	18525008	rs11024690	T	C	5	5	10	0	0	10	0	0
11	18525318	rs12419063	C	T	8	7	15	0	0	15	0	0
11	18528792	rs4298881	C	T	4	2	6	0	0	6	0	0
11	18531674	rs2658564	C	T	2	4	6	0	0	6	0	0
11	18535331	rs16935504	A	C	6	7	13	0	0	13	0	0
11	18542246	rs56151849	T	A	2	6	8	0	0	8	0	0
11	18543790	rs55964013	T	C	6	2	8	0	0	8	0	0
11	18546644	rs9633899	C	T	2	4	6	0	0	6	0	0
11	18555949	rs55999230	T	C	4	2	6	0	0	6	0	0
11	18600322	rs10500835	T	G	1	5	6	0	0	6	0	0
11	18630232	rs117049505	G	A	71	74	145	0	2	147	0	0
11	18633897	rs35411689	T	C	76	75	151	0	1	152	0	0
11	18636504	rs61884737	T	C	40	33	73	0	0	73	0	0
11	18723454	rs141369005	G	A	6	3	9	0	1	10	0	0
11	19167850	rs2271001	A	G	6	2	8	0	0	8	0	0
11	19246042	rs61876765	G	A	9	10	19	0	0	19	0	0
11	22842995	rs11543287	G	A	26	33	59	0	0	59	0	0
11	22843220	rs1019216	T	C	11	8	19	0	0	19	0	0
11	27362359	rs17244028	T	G	4	6	10	0	0	10	0	0
11	30344725	rs4071559	C	T	34	25	59	0	0	59	0	0
11	30356420	rs12272134	T	C	2	4	6	0	0	6	0	0
11	30359225	rs117185309	A	G	33	34	67	0	0	67	0	0
11	30359231	rs7116893	A	G	35	34	69	0	1	70	0	0
11	32115085	rs116938806	A	G	6	4	10	0	0	10	0	0
11	32117819	rs223074	C	T	4	6	10	0	0	10	0	0
11	32119030	rs223072	T	C	7	2	9	0	0	9	0	0
11	32119063	rs223071	A	G	6	4	10	0	0	10	0	0
11	32119174	rs223070	A	C	9	2	11	0	0	11	0	0
11	32119193	rs223069	T	C	8	2	10	0	0	10	0	0
11	32119413	rs223068	A	G	7	8	15	0	0	15	0	0
11	32119501	rs223067	T	G	7	10	17	0	0	17	0	0
11	32120258	rs618206	G	A	7	5	12	0	0	12	0	0
11	32121020	rs11031588	G	A	3	3	6	0	0	6	0	0
11	32121040	rs11031589	C	T	4	3	7	0	0	7	0	0
11	32121303	rs11031591	G	A	8	5	13	0	0	13	0	0
11	32121392	rs4922890	A	G	3	7	10	0	1	11	0	0
11	32121581	rs223066	G	A	8	6	14	0	0	14	0	0
11	32122003	rs2281411	C	A	5	7	12	0	0	12	0	0
11	32122020	rs2073223	T	G	5	7	12	0	0	12	0	0
11	32123016	rs10835840	A	G	3	7	10	0	0	10	0	0
11	32123672	rs4922891	G	A	8	8	16	0	0	16	0	0
11	32123846	rs61878815	C	T	10	10	20	0	0	20	0	0
11	32124579	rs223060	C	T	20	20	40	0	0	40	0	0
11	32124978	rs4876	T	C	81	65	146	0	1	147	0	0
11	32125961	rs11529889	C	T	77	28	105	0	0	105	0	0
11	32409472	rs5030328	T	A	21	18	39	0	1	40	0	0
11	32410002	rs5030320	T	C	27	26	53	0	0	53	0	0
11	32410337	rs5030317	C	G	22	36	58	0	0	58	0	0
11	32417945	rs16754	T	C	24	16	40	0	0	40	0	0
11	32449417	rs5030171	C	G	3	8	11	0	0	11	0	0
11	32449420	rs5030170	C	A	3	8	11	0	0	11	0	0
11	32457138	rs2234580	A	G	4	5	9	0	0	9	0	0
11	32457560	.	T	C	5	4	9	0	0	9	0	0
11	32457675	rs2301254	A	G	6	5	11	0	0	11	0	0
11	32457774	rs2301253	G	A	1	5	6	0	0	6	0	0
11	32457985	rs2301251	G	T	1	6	7	0	0	7	0	0
11	32458219	rs2301250	G	A	2	10	12	0	1	13	0	0
11	32458507	rs3886325	G	A	11	14	25	0	0	25	0	0
11	32607549	rs11031884	G	A	8	3	11	0	0	11	0	0
11	32610467	rs11031885	G	C	7	6	13	0	0	13	0	0
11	32625854	rs11031895	A	G	12	15	27	0	0	27	0	0
11	32626912	rs33992831	G	C	17	20	37	0	0	37	0	0
11	32852167	rs61889489	C	T	5	4	9	0	0	9	0	0
11	32875597	rs7933966	T	C	7	4	11	0	0	11	0	0
11	32877862	rs761284	C	T	5	4	9	0	0	9	0	0
11	32931030	rs11032056	G	C	5	1	6	0	0	6	0	0
11	32956620	rs7481878	A	G	14	14	28	0	1	29	0	0
11	32996805	rs11032076	C	T	21	23	44	0	0	44	0	0
11	33065394	rs1064005	C	T	11	10	21	0	1	22	0	0
11	33076191	rs2273544	T	C	10	3	13	0	0	13	0	0
11	33096627	rs11032142	C	T	3	3	6	0	0	6	0	0
11	33097828	rs2273552	G	A	3	6	9	0	0	9	0	0
11	33106616	rs3758741	C	T	26	20	46	0	0	46	0	0
11	33113653	rs7950763	T	C	5	2	7	0	0	7	0	0
11	33316735	rs11032223	G	C	6	3	9	0	0	9	0	0
11	33376095	rs4755571	A	G	44	47	91	0	1	92	0	0
11	33378209	rs10600	A	G	29	43	72	0	1	73	0	0
11	33724780	rs704697	T	C	4	5	9	0	0	9	0	0
11	33724992	rs1047581	T	C	0	6	6	0	0	6	0	0
11	33726980	rs7046	A	G	37	64	101	0	0	101	0	0
11	33728614	rs831618	T	G	11	12	23	0	0	23	0	0
11	33729674	.	A	T	18	11	29	0	1	30	0	0
11	33730060	rs11032350	A	C	5	5	10	0	0	10	0	0
11	33730261	rs7357	G	T	19	19	38	0	0	38	0	0
11	33731406	rs842	C	T	116	109	225	0	1	226	0	0
11	33757941	rs13614	A	G	48	30	78	0	1	79	0	0
11	33763193	rs831592	A	G	26	25	51	0	0	51	0	0
11	33765213	rs831594	T	C	14	18	32	0	0	32	0	0
11	33765257	rs831595	T	A	11	15	26	0	0	26	0	0
11	33765683	rs11032363	T	C	17	19	36	0	0	36	0	0
11	33765897	rs704702	G	C	89	88	177	0	1	178	0	0
11	33766495	rs704703	G	A	96	84	180	0	0	180	0	0
11	33766630	rs831596	A	G	47	44	91	0	2	93	0	0
11	33779415	rs1112840	T	G	4	2	6	0	0	6	0	0
11	33779565	rs1578986	C	A	5	2	7	0	0	7	0	0
11	33779673	rs1112841	G	A	4	4	8	0	0	8	0	0
11	33780819	rs2901376	G	C	13	18	31	0	0	31	0	0
11	33792951	rs4348870	C	T	5	7	12	0	1	13	0	0
11	33792977	rs1464487	G	A	4	6	10	0	0	10	0	0
11	33793165	rs1464486	T	C	12	7	19	0	0	19	0	0
11	33793951	rs11032374	T	C	2	4	6	0	0	6	0	0
11	33880429	rs7447	T	C	812	759	1571	0	5	1576	0	0
11	33880896	rs3740616	T	A	458	477	935	0	5	940	0	0
11	33881016	rs3740617	T	C	584	563	1147	0	12	1159	0	0
11	33882172	rs10836122	C	T	13	13	26	0	1	27	0	0
11	33882469	rs10836123	T	G	17	17	34	0	0	34	0	0
11	33883658	rs879414	G	A	8	7	15	0	2	17	0	0
11	33884703	rs12364163	C	T	3	6	9	0	0	9	0	0
11	33885268	rs3781574	A	G	9	6	15	0	0	15	0	0
11	33885390	rs17690328	T	C	7	10	17	0	0	17	0	0
11	33886080	rs2273797	C	T	6	11	17	0	1	18	0	0
11	33886294	rs2038602	A	G	276	274	550	0	11	561	0	0
11	33887768	rs7932232	C	T	8	1	9	0	0	9	0	0
11	33892049	rs2273798	G	A	4	15	19	0	0	19	0	0
11	33892258	rs182018392	C	A	46	14	60	0	0	60	0	0
11	33892656	rs11606830	G	T	18	45	63	0	1	64	0	0
11	33892934	rs11606849	C	T	14	6	20	0	0	20	0	0
11	33895527	rs11032433	T	C	3	17	20	0	0	20	0	0
11	33896780	rs7111491	T	C	6	5	11	0	0	11	0	0
11	33897084	rs7129330	G	A	3	4	7	0	0	7	0	0
11	33897278	rs10768032	A	G	4	14	18	0	0	18	0	0
11	33897791	rs10734420	T	G	8	9	17	0	0	17	0	0
11	33898583	rs932662	T	G	3	8	11	0	0	11	0	0
11	33903814	rs1885523	C	T	4	6	10	0	0	10	0	0
11	33912790	rs11032440	C	T	4	12	16	0	0	16	0	0
11	33913568	rs2273799	T	C	5	6	11	0	0	11	0	0
11	34104792	rs7113413	C	G	7	8	15	0	0	15	0	0
11	34122057	rs11032512	A	G	245	225	470	0	1	471	0	0
11	34460541	rs1049982	T	C	84	42	126	0	1	128	1	0
11	34466779	rs543701	A	G	1	5	6	0	0	6	0	0
11	34467272	rs484214	A	G	3	6	9	0	0	9	0	0
11	34467490	rs482322	T	C	4	4	8	0	0	8	0	0
11	34469775	rs1408036	A	C	5	2	7	0	0	7	0	0
11	34470679	rs769218	G	A	3	4	7	0	0	7	0	0
11	34477876	rs2073059	G	C	2	4	6	0	0	6	0	0
11	34482908	rs769217	C	T	239	227	466	0	3	469	0	0
11	34492443	rs17881488	C	A	5	4	9	0	0	9	0	0
11	34874734	rs2941041	A	C	4	3	7	0	1	8	0	0
11	34874780	rs2941040	C	A	4	2	6	0	0	6	0	0
11	34874906	rs7111695	T	G	2	4	6	0	0	6	0	0
11	34874971	rs12284844	G	A	2	4	6	0	0	6	0	0
11	34875097	rs12272820	A	T	3	4	7	0	0	7	0	0
11	34876176	rs11032903	C	T	2	7	9	0	0	9	0	0
11	34877491	rs185423981	A	G	1	5	6	0	0	6	0	0
11	34895812	rs9804643	A	G	3	8	11	0	0	11	0	0
11	34904399	rs2288667	C	T	14	13	27	0	0	27	0	0
11	34909926	rs1571133	T	G	54	28	82	0	0	82	0	0
11	34910077	rs1571134	G	A	11	3	14	0	0	14	0	0
11	34910217	rs1571135	T	A	10	4	14	0	0	14	0	0
11	34910397	rs1977420	C	T	46	35	81	0	0	81	0	0
11	34912289	rs2915224	T	A	16	3	19	0	0	19	0	0
11	34912861	rs1430856	C	A	12	11	23	0	0	23	0	0
11	34912908	rs1430855	T	C	11	8	19	0	0	19	0	0
11	34913164	rs2985389	C	G	7	5	12	0	0	12	0	0
11	34913265	rs2985388	G	A	6	7	13	0	0	13	0	0
11	34914137	rs2915223	C	T	4	6	10	0	0	10	0	0
11	34914650	rs2915220	T	G	6	0	6	0	0	6	0	0
11	34915370	rs2986423	C	A	5	1	6	0	0	6	0	0
11	34916484	rs1326940	A	G	2	4	6	0	0	6	0	0
11	34919901	rs78421708	C	T	4	3	7	0	0	7	0	0
11	34922378	rs2985384	T	C	2	4	6	0	0	6	0	0
11	34922438	rs7102259	A	G	2	4	6	0	0	6	0	0
11	34937813	rs2956114	G	A	18	6	24	0	1	25	0	0
11	34937884	rs2956113	G	A	8	3	11	0	0	11	0	0
11	34938269	rs1049306	C	T	1	9	10	0	0	10	0	0
11	34938310	rs1049307	T	C	1	9	10	0	0	10	0	0
11	34979095	rs79170416	C	T	8	8	16	0	1	17	0	0
11	34988343	rs61760973	T	C	10	17	27	0	0	27	0	0
11	34991727	rs497582	T	C	11	6	17	0	0	17	0	0
11	35017205	rs9326	G	T	16	15	31	0	0	31	0	0
11	35221910	rs11033024	T	C	4	6	10	0	0	10	0	0
11	35224018	rs10836341	G	A	5	3	8	0	0	8	0	0
11	35224531	rs75199214	G	A	5	5	10	0	0	10	0	0
11	35225044	rs79685344	T	A	4	8	12	0	0	12	0	0
11	35238459	rs1547059	A	G	3	3	6	0	0	6	0	0
11	35243434	rs55927167	C	G	4	2	6	0	0	6	0	0
11	35244044	rs7116739	G	C	69	27	96	0	0	96	0	0
11	35245287	rs10836344	G	T	14	15	29	0	0	29	0	0
11	35246865	rs2421825	A	G	2	5	7	0	0	7	0	0
11	35248780	rs4756199	T	G	4	5	9	0	0	9	0	0
11	35249434	rs77030418	C	T	3	4	7	0	0	7	0	0
11	35249670	rs12419062	A	G	5	12	17	0	1	18	0	0
11	35253272	rs13347	C	T	340	296	636	0	3	639	0	0
11	35289240	rs10836360	C	T	8	0	8	0	0	8	0	0
11	35307148	rs3763888	T	C	11	6	17	0	1	18	0	0
11	35307568	rs7108747	G	A	8	7	15	0	0	15	0	0
11	35317712	rs10742340	T	C	5	2	7	0	0	7	0	0
11	35317717	rs10742341	G	C	5	2	7	0	0	7	0	0
11	35318394	rs11524863	T	C	3	10	13	0	0	13	0	0
11	36253463	rs11603810	G	A	8	2	10	0	0	10	0	0
11	36291138	rs935407	C	T	17	7	24	0	0	24	0	0
11	36291139	rs11605376	G	A	7	16	23	0	0	23	0	0
11	36292231	rs59060923	C	G	1	7	8	0	0	8	0	0
11	36293048	rs7107433	G	A	3	3	6	0	0	6	0	0
11	36294034	rs7933884	C	G	49	40	89	0	1	90	0	0
11	36294052	rs3812766	A	G	39	48	87	0	2	89	0	0
11	36295256	rs7101885	T	G	5	8	13	0	0	13	0	0
11	36298101	rs2305169	C	G	6	4	10	0	0	10	0	0
11	36298555	rs2289986	C	T	2	8	10	0	0	10	0	0
11	36399514	rs1425936	C	T	10	12	22	0	0	22	0	0
11	36399929	rs4756308	C	A	7	9	16	0	0	16	0	0
11	36422701	rs78731804	C	T	4	3	7	0	0	7	0	0
11	36422792	rs330261	G	A	4	3	7	0	0	7	0	0
11	36509146	rs5030486	T	C	9	9	18	0	1	19	0	0
11	36509189	rs5030485	G	T	9	9	18	0	0	18	0	0
11	36510026	rs5030482	T	C	61	59	120	0	1	121	0	0
11	36510547	rs1046864	G	A	37	27	64	0	0	64	0	0
11	36515446	rs5030470	A	G	6	1	7	0	0	7	0	0
11	43346026	rs5743226	G	A	6	2	8	0	0	8	0	0
11	43358480	rs61883515	C	T	4	4	8	0	0	8	0	0
11	43365275	rs5743257	T	C	51	47	98	0	1	99	0	0
11	43411677	rs61883554	C	T	13	15	28	0	0	28	0	0
11	43417903	rs16937478	A	G	23	20	43	0	1	44	0	0
11	43439363	rs3781803	C	T	4	10	14	0	0	14	0	0
11	43450927	rs17594050	C	T	2	5	7	0	0	7	0	0
11	43454840	rs61883559	C	T	8	5	13	0	0	13	0	0
11	43511268	rs2009537	A	G	4	2	6	0	0	6	0	0
11	43511407	rs900465	A	G	2	6	8	0	0	8	0	0
11	43702530	rs56168061	A	G	3	6	9	0	0	9	0	0
11	43776481	rs7115919	C	T	7	0	7	0	0	7	0	0
11	43828759	rs11037654	G	A	5	2	7	0	0	7	0	0
11	43876698	rs11555762	C	T	39	22	61	0	0	61	0	0
11	43877934	rs1061810	C	A	58	54	112	0	0	112	0	0
11	43902681	rs34239319	G	T	21	45	66	0	1	67	0	0
11	43902836	rs34070018	A	G	5	1	6	0	0	6	0	0
11	43919694	rs2460130	C	T	5	4	9	0	0	9	0	0
11	43919778	rs2434474	C	T	9	10	19	0	0	19	0	0
11	43919786	rs2460131	C	G	8	10	18	0	0	18	0	0
11	43940566	rs7926534	T	C	3	4	7	0	0	7	0	0
11	43940644	rs1048928	G	T	78	52	130	0	0	130	0	0
11	43965378	rs151042204	A	G	16	12	28	0	0	28	0	0
11	44098985	rs2074043	G	A	11	7	18	0	0	18	0	0
11	44099588	rs3134907	A	C	16	9	25	0	0	25	0	0
11	44099998	rs178526	T	A	18	19	37	0	0	37	0	0
11	44100021	rs3094391	T	C	23	15	38	0	0	38	0	0
11	44100542	rs2074044	G	T	3	7	10	0	0	10	0	0
11	44100846	rs178527	G	A	5	3	8	0	1	9	0	0
11	44102081	rs178529	A	G	2	4	6	0	0	6	0	0
11	44104885	rs3107274	T	G	5	3	8	0	0	8	0	0
11	44104981	rs3107275	C	T	48	28	76	0	0	76	0	0
11	44601286	rs55954253	G	A	4	2	6	0	0	6	0	0
11	44640640	rs7107335	C	G	544	544	1088	0	6	1094	0	0
11	44951592	rs35906924	C	A	4	3	7	0	0	7	0	0
11	44951617	rs860694	G	C	5	2	7	0	0	7	0	0
11	45832935	rs1139266	G	A	6	2	8	0	0	8	0	0
11	45834044	rs4756027	C	T	5	2	7	0	0	7	0	0
11	45834198	rs7943306	T	C	10	4	14	0	1	15	0	0
11	45903613	rs2292910	A	C	103	97	200	0	2	202	0	0
11	45904477	rs6798	T	C	201	170	371	0	0	371	0	0
11	45904635	rs143409790	C	T	203	162	365	0	1	366	0	0
11	45912350	rs4756039	A	T	5	2	7	0	0	7	0	0
11	47187067	rs7117346	G	A	26	18	44	0	1	45	0	0
11	47380593	rs3740689	G	A	13	12	25	0	0	25	0	0
11	47434986	rs2293576	G	A	45	44	89	0	0	89	0	0
11	47437033	rs11602837	C	T	62	73	135	0	0	135	0	0
11	47491870	.	A	C	30	22	52	0	2	55	1	0
11	47500267	rs2242081	T	C	12	13	25	0	0	25	0	0
11	47500400	rs12224672	C	T	7	10	17	0	0	17	0	0
11	47555679	rs11602333	C	G	4	2	6	0	0	6	0	0
11	47587452	rs11537751	C	T	20	5	25	0	0	25	0	0
11	47600438	rs2280231	C	T	15	10	25	0	0	25	0	0
11	47604639	rs12798028	C	T	9	4	13	0	0	13	0	0
11	47639063	rs9089	G	A	6	5	11	0	1	12	0	0
11	47640201	rs79845520	G	A	4	2	6	0	0	6	0	0
11	47740662	rs2869534	G	A	5	1	6	0	0	6	0	0
11	47746962	rs11039358	A	G	19	14	33	0	0	33	0	0
11	47748019	rs11605681	G	A	46	28	74	0	1	75	0	0
11	47753370	rs2290851	C	T	26	48	74	0	1	75	0	0
11	47773226	rs6485774	C	T	6	6	12	0	0	12	0	0
11	47773518	rs6485775	A	G	4	6	10	0	0	10	0	0
11	47774238	rs12577383	C	T	12	4	16	0	0	16	0	0
11	47800628	rs80090905	C	T	81	47	128	0	0	128	0	0
11	47805418	rs7925211	G	C	6	3	9	0	0	9	0	0
11	47805856	rs12226431	G	A	4	2	6	0	0	6	0	0
11	47828404	rs3837374	C	T	4	2	6	0	0	6	0	0
11	47857253	rs3816605	T	C	29	28	57	0	0	57	0	0
11	57071305	rs183407033	C	T	6	5	11	0	0	11	0	0
11	57075392	rs10896601	A	C	1	6	7	0	0	7	0	0
11	57077464	rs10896602	T	C	27	21	48	0	0	48	0	0
11	57081197	rs4939134	G	C	19	9	28	0	0	28	0	0
11	57146202	rs1940145	G	A	4	10	14	0	0	14	0	0
11	57156438	rs3741089	A	G	35	50	85	0	2	87	0	0
11	57157405	rs490358	A	G	2785	2477	5262	0	44	5308	2	0
11	57158320	rs519628	G	A	33	47	80	0	0	80	0	0
11	57159189	rs548854	T	C	11	7	18	0	0	18	0	0
11	57159376	rs550729	T	C	10	16	26	0	0	26	0	0
11	57159543	rs1151051	C	T	9	18	27	0	1	28	0	0
11	57159638	rs650455	G	A	13	19	32	0	1	33	0	0
11	57160838	rs634737	A	G	8	9	17	0	0	17	0	0
11	57160930	rs634322	G	A	10	9	19	0	0	19	0	0
11	57161882	rs526572	T	A	8	9	17	0	0	17	0	0
11	57162634	rs554277	T	C	9	7	16	0	0	16	0	0
11	57162716	rs555097	A	C	6	9	15	0	0	15	0	0
11	57175798	rs3781889	G	A	10	10	20	0	0	20	0	0
11	57175993	rs3781888	T	C	4	5	9	0	0	9	0	0
11	57176332	rs61888921	C	T	4	7	11	0	0	11	0	0
11	57176628	rs2241899	C	T	2	6	8	0	0	8	0	0
11	57177593	rs62640922	A	G	92	57	149	0	4	153	0	0
11	57184964	rs7948027	T	C	4	3	7	0	0	7	0	0
11	57193653	rs12422015	A	G	41	43	84	0	0	84	0	0
11	57252328	rs2848634	G	A	34	30	64	0	0	64	0	0
11	57268252	rs112450479	C	T	10	11	21	0	0	21	0	0
11	57309933	rs2729382	C	T	8	14	22	0	0	22	0	0
11	57319339	rs5847	T	C	123	110	233	0	0	233	0	0
11	58306872	rs1944052	G	C	4	3	7	0	0	7	0	0
11	58310587	rs11229519	C	T	2	4	6	0	0	6	0	0
11	58318619	rs1047979	C	G	11	8	19	0	0	19	0	0
11	58378424	rs8373	A	G	79	75	154	0	2	156	0	0
11	58381548	rs12419118	C	T	1	6	7	0	0	7	0	0
11	58386177	rs3168135	G	A	111	96	207	0	1	208	0	0
11	58386650	rs11229545	A	G	132	121	253	0	2	255	0	0
11	58389691	rs2509914	C	T	3	3	6	0	0	6	0	0
11	58392951	rs2515362	T	C	7	7	14	0	0	14	0	0
11	58725797	rs530180	G	C	5	2	7	0	0	7	0	0
11	59352522	.	G	A	5	2	7	0	0	7	0	0
11	59356322	rs10896985	A	G	5	2	7	0	0	7	0	0
11	59406860	rs76129882	C	T	8	4	12	0	0	12	0	0
11	59537180	.	A	G	2	7	9	0	0	9	0	0
11	59569210	rs76410717	T	C	37	38	75	0	2	77	0	0
11	59939307	rs610932	T	G	2	4	6	0	0	6	0	0
11	59940599	rs7232	T	A	49	51	100	0	1	101	0	0
11	59944580	rs72918674	C	T	2	5	7	0	0	7	0	0
11	59944810	rs7946992	T	C	3	3	6	0	0	6	0	0
11	59945745	rs12453	T	C	37	43	80	0	0	80	0	0
11	60152563	rs950803	T	A	4	4	8	0	0	8	0	0
11	60157166	rs2233253	C	T	2	5	7	0	0	7	0	0
11	60161527	rs1062167	A	G	1	7	8	0	0	8	0	0
11	60162000	rs140975197	G	A	5	3	8	0	0	8	0	0
11	60609972	rs2074422	A	G	9	7	16	0	0	16	0	0
11	60617834	rs530963	C	A	15	16	31	0	0	31	0	0
11	60617913	rs7125995	A	G	13	10	23	0	0	23	0	0
11	60617942	rs493176	G	A	13	11	24	0	0	24	0	0
11	60619078	rs41465646	G	A	5	7	12	0	0	12	0	0
11	60660152	rs7105089	T	C	15	21	36	0	0	36	0	0
11	60660157	rs7116665	C	A	14	21	35	0	0	35	0	0
11	60660997	rs12576127	T	C	11	10	21	0	1	22	0	0
11	60663409	rs4939473	C	G	5	6	11	0	0	11	0	0
11	60663878	rs4938990	G	C	13	8	21	0	0	21	0	0
11	60664562	rs3885382	C	T	7	6	13	0	0	13	0	0
11	60666341	rs3763840	G	A	305	258	563	0	1	564	0	0
11	60673868	rs17155470	T	C	69	81	150	0	5	155	0	0
11	60689445	rs555835	T	C	23	31	54	0	0	54	0	0
11	60706815	rs555157	T	C	6	5	11	0	0	11	0	0
11	60776307	rs79848107	G	C	6	4	10	0	0	10	0	0
11	60777073	rs12360861	G	A	3	6	9	0	0	9	0	0
11	60785463	rs12417503	C	T	14	16	30	0	0	30	0	0
11	60886913	rs2241002	C	T	11	8	19	0	0	19	0	0
11	60893235	rs2229177	C	T	11	12	23	0	1	24	0	0
11	60894492	rs2186409	G	T	12	8	20	0	0	20	0	0
11	60897912	rs7876	A	G	8	7	15	0	0	15	0	0
11	60899767	rs754382	A	G	5	5	10	0	0	10	0	0
11	61109305	rs117064389	G	A	18	9	27	0	1	28	0	0
11	61111346	rs35723406	C	G	17	17	34	0	0	34	0	0
11	61133980	rs112830700	G	A	3	7	10	0	1	11	0	0
11	61134532	rs1037448	T	C	10	14	24	0	0	24	0	0
11	61165280	rs3741265	G	A	31	32	63	0	1	64	0	0
11	61165741	rs10897158	G	C	1	32	33	0	0	33	0	0
11	61179006	rs3018727	T	C	4	6	10	0	0	10	0	0
11	61179285	rs3019198	G	A	84	94	178	0	1	179	0	0
11	61179728	rs2860519	G	A	28	33	61	0	2	63	0	0
11	61204361	rs896831	A	C	1	7	8	0	0	8	0	0
11	61213920	rs17702	T	C	82	101	183	0	2	185	0	0
11	61253200	rs3019187	G	A	1	8	9	0	0	9	0	0
11	61253973	rs2957858	A	G	1	7	8	0	0	8	0	0
11	61557868	rs740006	T	C	26	44	70	0	3	73	0	0
11	61731233	rs2668897	C	A	7	8	15	0	1	16	0	0
11	61733765	rs4963438	A	G	197	207	404	0	10	414	0	0
11	61895741	rs1675131	A	G	12	13	25	0	0	25	0	0
11	61897359	rs1675133	C	T	6	8	14	0	0	14	0	0
11	61908440	rs2277283	T	C	16	21	37	0	0	37	0	0
11	61913196	rs7129085	G	T	16	16	32	0	0	32	0	0
11	61919515	rs1047738	C	G	21	21	42	0	1	43	0	0
11	62334096	rs7124057	A	G	6	6	12	0	0	12	0	0
11	62334908	rs1061093	G	C	5763	4270	10033	0	49	10084	2	0
11	62362293	rs11231154	A	G	7	9	16	0	1	17	0	0
11	62365619	rs11231155	A	G	68	89	157	0	0	157	0	0
11	62365665	rs2849031	G	A	92	62	154	0	0	154	0	0
11	62368557	rs12223627	G	C	2	5	7	0	0	7	0	0
11	62369018	rs12226821	C	G	20	15	35	0	1	36	0	0
11	62369881	rs35156678	G	A	71	74	145	0	12	157	0	0
11	62369884	rs35880596	C	G	68	67	135	0	7	142	0	0
11	62370155	rs71490394	G	A	2	7	9	0	0	9	0	0
11	62371087	.	A	G	23	14	37	0	0	37	0	0
11	62371773	rs2516633	A	C	48	53	101	0	1	102	0	0
11	62371938	rs34065644	C	T	33	16	49	0	0	49	0	0
11	62374821	rs34894392	A	G	16	26	42	0	3	45	0	0
11	62377359	rs67308910	G	A	11	8	19	0	0	19	0	0
11	62378221	rs11231161	A	G	8	5	13	0	1	14	0	0
11	62378660	rs12808829	G	A	86	85	171	0	1	172	0	0
11	62378801	rs11553576	T	C	91	90	181	0	2	183	0	0
11	62380119	rs12798970	C	G	5	2	7	0	0	7	0	0
11	62381483	rs72927237	T	C	4	2	6	0	0	6	0	0
11	62381808	rs1801144	G	C	16	16	32	0	0	32	0	0
11	62383715	rs12794886	G	C	6	1	7	0	3	10	0	0
11	62383928	.	C	T	1	7	8	0	0	8	0	0
11	62385368	rs7122950	C	T	15	18	33	0	2	35	0	0
11	62386472	rs10897288	A	T	6	4	10	0	0	10	0	0
11	62387222	rs4264155	C	T	9	6	15	0	0	15	0	0
11	62401620	rs11231168	C	T	23	21	44	0	2	46	0	0
11	62429563	rs71490396	A	T	4	2	6	0	0	6	0	0
11	62430335	rs7386	G	A	61	74	135	0	0	135	0	0
11	62430659	rs597259	T	A	14	14	28	0	2	30	0	0
11	62432815	rs4489748	T	C	11	11	22	0	0	22	0	0
11	62437647	rs489778	G	C	40	24	64	0	0	64	0	0
11	62438498	rs11231182	G	T	15	13	28	0	1	29	0	0
11	62438750	rs17637597	T	C	18	21	39	0	1	40	0	0
11	62438819	rs693698	G	T	24	24	48	0	0	48	0	0
11	62438846	rs3809079	G	A	23	25	48	0	0	48	0	0
11	62439569	rs13941	G	A	45	35	80	0	1	81	0	0
11	62444798	rs644616	T	G	35	44	79	0	1	80	0	0
11	62531660	.	C	T	9	7	16	0	0	16	0	0
11	63274768	rs1404504	T	G	2	7	9	0	0	9	0	0
11	63275563	rs10897430	C	T	6	4	10	0	0	10	0	0
11	63275900	rs139900558	A	G	4	3	7	0	0	7	0	0
11	63278330	rs2269400	C	T	12	7	19	0	1	20	0	0
11	63279752	rs7106153	T	C	5	5	10	0	0	10	0	0
11	63280001	rs6591808	A	G	7	8	15	0	0	15	0	0
11	63281273	rs933187	A	T	7	6	13	0	0	13	0	0
11	63281594	rs933186	C	T	6	8	14	0	0	14	0	0
11	63283512	rs60912926	A	G	5	2	7	0	0	7	0	0
11	63284035	rs3781604	A	G	79	75	154	0	1	155	0	0
11	63284054	rs3781603	G	C	86	70	156	0	1	157	0	0
11	63395617	rs1404500	G	A	18	12	30	0	0	30	0	0
11	63397920	.	A	G	7	5	12	0	3	15	0	0
11	63487386	rs542998	T	C	5	6	11	0	1	12	0	0
11	63530231	rs11551215	C	T	5	9	14	0	0	14	0	0
11	63585804	rs643634	C	A	82	66	148	0	1	151	2	0
11	63593435	.	C	G	1	5	6	0	1	7	0	0
11	63724175	rs1055933	G	A	27	24	51	0	0	51	0	0
11	63724667	.	T	C	4	3	7	0	0	7	0	0
11	63952759	rs7941773	C	T	2	5	7	0	0	7	0	0
11	63954370	rs2845597	G	A	4	2	6	0	0	6	0	0
11	63959259	rs4980524	A	C	4	3	7	0	1	8	0	0
11	63959356	rs6591838	A	G	4	5	9	0	0	9	0	0
11	63961433	rs55970968	C	T	7	4	11	0	0	11	0	0
11	63964605	rs2236647	C	T	25	13	38	0	0	38	0	0
11	63964657	rs2236648	C	T	19	13	32	0	0	32	0	0
11	63971474	.	A	G	28	12	40	0	1	41	0	0
11	63975331	rs2515241	C	T	41	31	72	0	2	74	0	0
11	63976027	rs11600628	C	T	16	20	36	0	1	37	0	0
11	63976183	rs11600667	C	T	20	31	51	0	2	53	0	0
11	63976689	rs882147	T	A	28	49	77	0	0	77	0	0
11	63977546	rs12787945	G	A	8	21	29	0	0	29	0	0
11	63978067	rs78038516	C	G	22	45	67	0	0	67	0	0
11	63986713	rs11603538	C	A	8	14	22	0	0	22	0	0
11	63987339	rs11231726	C	T	46	43	89	0	0	89	0	0
11	63994692	rs1860368	T	C	3	8	11	0	0	11	0	0
11	64003843	rs11603042	G	T	6	2	8	0	1	9	0	0
11	64026639	rs12146487	G	A	9	9	18	0	0	18	0	0
11	64039175	rs2286615	G	A	74	68	142	0	2	144	0	0
11	64042997	rs660442	G	A	2	4	6	0	0	6	0	0
11	64082823	rs41294418	T	C	2	7	9	0	1	10	0	0
11	64120451	rs61886887	C	T	82	61	143	0	0	143	0	0
11	64124622	rs61886888	G	A	385	369	754	0	3	757	0	0
11	64508716	rs559772838	C	A	48	150	198	0	4	202	0	0
11	64561901	.	G	A	3	3	6	0	0	6	0	0
11	64572602	rs2071313	G	A	12	14	26	0	0	26	0	0
11	64623835	rs372359613	C	T	10	4	14	0	0	14	0	0
11	64672292	rs61886114	C	T	6	5	11	0	0	11	0	0
11	64697507	rs11231903	C	T	4	2	6	0	0	6	0	0
11	64701295	rs185359743	C	T	43	43	86	0	0	86	0	0
11	64973772	rs17883561	G	A	16	10	26	0	0	26	0	0
11	64977424	rs2271448	C	T	5	4	9	0	0	9	0	0
11	65206172	rs117554853	C	T	4	4	8	0	1	9	0	0
11	65293819	rs75169347	G	A	94	78	172	0	1	173	0	0
11	65382244	rs140704417	G	A	3	3	6	0	0	6	0	0
11	65394322	rs10896024	A	G	5	3	8	0	0	8	0	0
11	65399895	rs570637576	G	A	5	3	8	0	0	8	0	0
11	65418285	rs145995596	C	G	137	181	318	0	2	320	0	0
11	65430398	rs139081674	G	A	1	6	7	0	0	7	0	0
11	65482827	rs4645927	C	T	18	17	35	0	0	35	0	0
11	65485507	.	G	A	48	53	101	0	0	101	0	0
11	65543421	rs522800	G	C	25	36	61	0	0	61	0	0
11	65543827	rs10896043	T	C	41	42	83	0	0	83	0	0
11	65546857	rs610037	A	C	62	63	125	0	1	126	0	0
11	65547333	rs12146493	G	A	42	31	73	0	0	73	0	0
11	65621057	rs656040	T	C	9	1	10	0	0	10	0	0
11	65623347	rs652021	G	A	25	14	39	0	0	39	0	0
11	65623519	rs4621	G	A	1706	1871	3577	0	8	3585	0	0
11	65623739	rs11227332	A	G	6	40	46	0	1	47	0	0
11	65624025	rs665306	T	C	42	10	52	0	0	52	0	0
11	65624562	rs667555	A	C	24	4	28	0	0	28	0	0
11	65628334	rs13817	G	A	7	12	19	0	0	19	0	0
11	65629932	rs659857	T	C	28	29	57	0	0	57	0	0
11	65629934	rs545500	G	C	28	29	57	0	0	57	0	0
11	65631167	rs648732	C	T	19	20	39	0	0	39	0	0
11	65631973	rs630303	G	A	44	39	83	0	0	83	0	0
11	65632262	rs558114	G	T	44	49	93	0	0	93	0	0
11	65638719	rs633800	G	A	25	9	34	0	0	34	0	0
11	65639374	rs2234458	C	T	5	5	10	0	0	10	0	0
11	65639634	rs144352725	C	T	2	5	7	0	0	7	0	0
11	65640562	rs2303385	G	A	7	8	15	0	0	15	0	0
11	65640906	rs7940691	C	T	6	1	7	0	0	7	0	0
11	65649984	rs687672	T	C	50	254	304	0	3	307	0	0
11	65653242	rs568617	C	T	8	2	10	0	0	10	0	0
11	65655393	rs641018	G	C	3	4	7	0	0	7	0	0
11	65661291	rs10791830	C	T	1	6	7	0	0	7	0	0
11	65661656	rs507062	T	C	18	14	32	0	0	32	0	0
11	65662436	rs608616	T	C	6	2	8	0	1	9	0	0
11	65662752	rs588114	G	A	2	7	9	0	0	9	0	0
11	65662788	rs538268	G	T	4	8	12	0	0	12	0	0
11	65662985	rs58568715	A	G	10	8	18	0	0	18	0	0
11	65663239	rs622614	T	C	15	6	21	0	0	21	0	0
11	65663547	rs585557	A	G	8	5	13	0	0	13	0	0
11	65744265	rs2276016	C	T	3	5	8	0	0	8	0	0
11	65821973	rs1642958	G	C	4	4	8	0	0	8	0	0
11	65822016	rs33988687	T	C	4	4	8	0	0	8	0	0
11	65823569	rs576836	G	C	1	5	6	0	1	7	0	0
11	65825525	.	A	C	240	190	430	0	4	434	0	0
11	65825951	rs491618	T	A	12	5	17	0	1	18	0	0
11	65826704	rs1049872	G	A	331	311	642	0	4	646	0	0
11	65828392	rs570887	T	C	4	4	8	0	0	8	0	0
11	65828625	rs535752	A	C	5	5	10	0	1	11	0	0
11	65833631	rs570760	C	T	4	6	10	0	0	10	0	0
11	65835251	rs477280	C	A	15	7	22	0	0	22	0	0
11	66031660	rs1151539	C	T	10	18	28	0	1	29	0	0
11	66040049	rs555853	G	C	10	24	34	0	0	34	0	0
11	66040940	rs72936699	C	T	36	15	51	0	0	51	0	0
11	66041807	rs1151540	A	C	10	35	45	0	0	45	0	0
11	66043253	rs55931871	T	C	42	31	73	0	0	73	0	0
11	66043898	rs2508657	G	A	185	137	322	0	5	327	0	0
11	66052635	rs2282567	C	A	5	2	7	0	0	7	0	0
11	66052636	rs57579741	C	T	5	2	7	0	0	7	0	0
11	66099987	rs1784029	C	T	55	61	116	0	0	116	0	0
11	66101978	rs10896110	G	A	3	3	6	0	0	6	0	0
11	66102807	rs10444359	G	A	13	10	23	0	0	23	0	0
11	66104981	.	T	C	235	368	603	0	0	603	0	0
11	66104993	rs3116068	C	T	353	223	576	0	5	581	0	0
11	66105194	rs1052566	G	A	272	272	544	0	6	551	1	0
11	66105817	rs2276106	C	T	7	7	14	0	0	14	0	0
11	66107319	.	C	T	10	11	21	0	0	21	0	0
11	66107527	rs1785633	C	A	3	4	7	0	0	7	0	0
11	66108660	rs947978	C	T	21	15	36	0	0	36	0	0
11	66108894	rs2236679	G	C	6	11	17	0	0	17	0	0
11	66130358	rs3177514	T	G	29	18	47	0	0	47	0	0
11	66130548	rs1047029	C	T	16	18	34	0	1	35	0	0
11	66206169	rs11110	C	T	78	44	122	0	2	124	0	0
11	66247696	rs2279863	G	T	3	5	8	0	0	8	0	0
11	66272142	rs1671063	A	G	18	18	36	0	0	36	0	0
11	66299515	rs8432	A	G	6	6	12	0	1	13	0	0
11	66300463	rs1791686	G	A	13	14	27	0	0	27	0	0
11	66305111	rs1189338	C	G	7	14	21	0	0	21	0	0
11	66305127	rs11227521	T	C	7	15	22	0	0	22	0	0
11	66305274	rs1201433	C	A	15	21	36	0	0	36	0	0
11	66310380	rs610293	C	T	4	5	9	0	0	9	0	0
11	66328095	rs1815739	T	C	4	5	9	0	0	9	0	0
11	66329732	rs540874	A	G	3	3	6	0	0	6	0	0
11	66331458	rs572846	A	G	39	67	106	0	0	106	0	0
11	66333598	rs545009	C	T	29	30	59	0	1	60	0	0
11	66335548	rs1127894	A	G	2	5	7	0	0	7	0	0
11	66372066	rs503250	C	T	3	6	9	0	0	9	0	0
11	66372390	rs556759	C	T	1	9	10	0	0	10	0	0
11	66399681	rs484262	G	A	4	5	9	0	0	9	0	0
11	66402333	rs580910	C	T	2	5	7	0	0	7	0	0
11	66402956	rs574546203	C	T	10	6	16	0	0	16	0	0
11	66414818	rs474602	T	A	6	4	10	0	1	11	0	0
11	66414915	rs624561	C	T	7	6	13	0	0	13	0	0
11	66610645	rs7570	G	C	20	20	40	0	0	40	0	0
11	66612234	rs75404994	C	T	6	4	10	0	0	10	0	0
11	66626234	rs3741194	T	C	12	12	24	0	0	24	0	0
11	67009740	rs75665092	G	A	4	3	7	0	0	7	0	0
11	67039478	rs61759813	A	G	9	11	20	0	1	21	0	0
11	67079303	.	G	A	65	56	121	0	0	121	0	0
11	67160933	rs2066490	G	A	17	8	25	0	0	25	0	0
11	67163780	.	G	A	69	66	135	0	1	136	0	0
11	67177471	rs15578	T	C	281	293	574	0	2	576	0	0
11	67250676	.	G	A	68	51	119	0	1	120	0	0
11	67351531	rs1079719	G	A	8	3	11	0	0	11	0	0
11	67351585	rs4147581	C	G	13	28	41	0	1	42	0	0
11	67351674	rs8191445	G	A	30	13	43	0	0	43	0	0
11	67351774	rs2370143	C	T	16	33	49	0	0	49	0	0
11	67352256	rs762803	C	A	5	17	22	0	0	22	0	0
11	67352689	rs1695	A	G	1034	1247	2281	0	35	2316	0	0
11	67353253	rs749174	G	A	10	17	27	0	0	27	0	0
11	67353844	rs1871042	C	T	63	20	83	0	1	85	1	0
11	67353970	rs4891	T	C	1234	1326	2560	0	12	2573	1	0
11	67374581	rs1871043	T	C	12	13	25	0	0	25	0	0
11	67375184	rs7948073	T	G	74	76	150	0	4	154	0	0
11	67393734	rs2514017	A	C	11	10	21	0	0	21	0	0
11	67394655	rs10896188	G	A	7	6	13	0	0	13	0	0
11	67758771	rs10896285	G	T	109	84	193	0	8	201	0	0
11	67758895	rs7932	G	C	119	144	263	0	0	263	0	0
11	67759254	rs7149	G	C	43	5	48	0	0	48	0	0
11	67759293	.	C	T	34	15	49	0	0	49	0	0
11	67760971	rs11602727	G	C	5	3	8	0	0	8	0	0
11	67763224	rs12660	G	A	52	54	106	0	2	108	0	0
11	67789138	rs2286168	C	T	17	8	25	0	0	25	0	0
11	67790243	rs3764818	C	T	2	4	6	0	0	6	0	0
11	67793509	rs2286163	C	T	7	10	17	0	1	18	0	0
11	67795299	rs308341	G	A	8	5	13	0	0	13	0	0
11	67795353	rs3751082	G	A	6	2	8	0	0	8	0	0
11	67796414	rs4646815	C	T	33	41	74	0	0	74	0	0
11	67796632	rs15518	T	C	31	20	51	0	1	52	0	0
11	67798567	rs1122731	G	A	1	5	6	0	0	6	0	0
11	67799266	rs999571	G	A	5	6	11	0	0	11	0	0
11	67799926	rs2075626	T	C	27	47	74	0	1	75	0	0
11	67802907	rs1104739	A	C	12	13	25	0	0	25	0	0
11	67803215	rs2075627	G	A	15	13	28	0	0	28	0	0
11	67803453	rs140602229	T	G	10	14	24	0	0	24	0	0
11	67804074	rs1051806	C	T	67	92	159	0	1	160	0	0
11	67808116	rs79557925	G	A	4	5	9	0	0	9	0	0
11	67813723	rs142404804	C	T	21	15	36	0	1	37	0	0
11	67814863	rs3888690	G	T	18	18	36	0	0	36	0	0
11	67816092	rs72926470	G	C	17	10	27	0	1	28	0	0
11	67816175	rs112754197	G	A	10	8	18	0	0	18	0	0
11	67817876	rs11228127	C	T	11	25	36	0	0	36	0	0
11	67820335	rs11481	T	A	35	21	56	0	0	56	0	0
11	67821036	rs3794186	G	A	279	222	501	0	0	501	0	0
11	67821127	rs11538783	T	C	250	249	499	0	2	501	0	0
11	67826193	rs78528297	A	G	16	12	28	0	1	29	0	0
11	67828136	rs117459824	A	C	17	14	31	0	0	31	0	0
11	67853339	.	T	G	4	2	6	0	0	6	0	0
11	67854035	rs2511439	T	C	2	6	8	0	0	8	0	0
11	67861742	rs4337046	T	C	3	3	6	0	0	6	0	0
11	68035991	rs111570379	C	G	3	4	7	0	0	7	0	0
11	68089104	rs4988301	C	T	5	5	10	0	0	10	0	0
11	68094741	rs634008	C	T	4	8	12	0	0	12	0	0
11	68177510	rs2306862	C	T	4	3	7	0	0	7	0	0
11	68192690	rs556442	G	A	10	7	17	0	0	17	0	0
11	68201295	rs3736228	C	T	8	5	13	0	0	13	0	0
11	68240241	rs7106339	C	T	3	6	9	0	0	9	0	0
11	68241833	rs643609	A	G	7	5	12	0	0	12	0	0
11	68273626	rs66752716	C	T	1	14	15	0	0	15	0	0
11	68300955	rs67605986	C	T	4	2	6	0	0	6	0	0
11	68347870	rs7108376	A	G	10	5	15	0	0	15	0	0
11	68348354	rs73506204	C	T	2	5	7	0	0	7	0	0
11	68348695	rs871212	T	A	10	7	17	0	0	17	0	0
11	68349754	rs11228287	A	G	12	12	24	0	0	24	0	0
11	68349757	rs139775907	A	G	12	12	24	0	0	24	0	0
11	68375120	rs55767696	C	G	1	6	7	0	0	7	0	0
11	68376241	rs17603185	C	T	1	9	10	0	0	10	0	0
11	68377602	rs7104877	A	C	10	7	17	0	0	17	0	0
11	68378045	rs2236708	G	A	9	11	20	0	1	21	0	0
11	68379772	rs11228292	G	A	17	7	24	0	0	24	0	0
11	68381415	rs3740628	A	G	44	70	114	0	2	116	0	0
11	68381607	rs4988291	G	A	153	139	292	0	4	296	0	0
11	68382193	rs12941	C	T	267	237	504	0	7	511	0	0
11	68507582	.	G	T	5	1	6	0	0	6	0	0
11	68565915	rs184055188	C	T	10	11	21	0	2	23	0	0
11	68659488	rs660614	G	A	3	3	6	0	0	6	0	0
11	68662076	rs602805	A	T	3	4	7	0	0	7	0	0
11	68662167	rs602364	C	T	5	3	8	0	0	8	0	0
11	68664250	rs3802749	C	T	4	6	10	0	1	11	0	0
11	68697336	rs3794027	T	C	9	48	57	0	2	59	0	0
11	68698663	rs627731	A	C	1	5	6	0	0	6	0	0
11	68698762	rs674654	G	T	3	5	8	0	0	8	0	0
11	68698996	rs513476	C	T	6	3	9	0	0	9	0	0
11	68699417	rs61887154	G	T	9	9	18	0	1	19	0	0
11	68699775	rs653264	G	A	5	9	14	0	0	14	0	0
11	68700424	rs478647	C	T	7	3	10	0	0	10	0	0
11	68700701	rs645436	G	C	6	4	10	0	0	10	0	0
11	68701118	rs2282504	C	T	5	1	6	0	0	6	0	0
11	68702632	rs737386	C	T	6	6	12	0	0	12	0	0
11	68703959	rs622082	A	G	32	31	63	0	0	63	0	0
11	68704264	rs546382	C	T	46	35	81	0	1	82	0	0
11	68705674	rs17612126	C	A	38	38	76	0	2	78	0	0
11	68707626	rs3750980	C	T	79	69	148	0	1	149	0	0
11	69481969	rs1789165	G	A	10	6	16	0	0	16	0	0
11	69482068	rs61360017	A	G	15	15	30	0	0	30	0	0
11	69482091	rs1789166	C	A	13	15	28	0	0	28	0	0
11	69486244	rs1789167	A	G	3	3	6	0	0	6	0	0
11	69489163	rs1789164	C	G	1	5	6	0	0	6	0	0
11	70051949	rs7105001	T	C	3	3	6	0	0	6	0	0
11	70051966	rs10793035	A	G	4	2	6	0	0	6	0	0
11	70117473	rs66803755	G	A	9	5	14	0	0	14	0	0
11	70118251	rs670012	T	G	22	20	42	0	0	42	0	0
11	70165505	rs627079	G	T	1	8	9	0	0	9	0	0
11	70168006	rs7130893	G	A	5	6	11	0	0	11	0	0
11	70168248	rs6592534	C	G	12	10	22	0	0	22	0	0
11	70185325	rs1061328	C	T	25	32	57	0	0	57	0	0
11	70195161	rs12099016	C	G	4	3	7	0	0	7	0	0
11	70195182	rs7109643	T	G	3	3	6	0	0	6	0	0
11	70200529	rs17853270	C	T	46	53	99	0	1	100	0	0
11	70208917	rs190632785	G	A	7	4	11	0	0	11	0	0
11	70209169	rs947812	C	T	3	5	8	0	0	8	0	0
11	70227824	rs7940090	C	G	3	6	9	0	0	9	0	0
11	70228615	rs7943840	C	A	4	4	8	0	0	8	0	0
11	70229171	rs552282	G	A	42	44	86	0	3	89	0	0
11	70230030	rs57810426	G	A	96	75	171	0	1	172	0	0
11	71162858	rs72954301	G	T	30	32	62	0	0	62	0	0
11	71187858	rs7947153	G	A	22	11	33	0	0	33	0	0
11	71709751	.	C	T	5	3	8	0	0	8	0	0
11	71796713	rs72951702	G	A	5	11	16	0	0	16	0	0
11	71797637	rs61889198	T	C	13	10	23	0	0	23	0	0
11	71935440	rs57191897	A	C	9	7	16	0	0	16	0	0
11	71936576	rs77987571	G	T	9	12	21	0	0	21	0	0
11	71938846	rs12288631	T	C	13	14	27	0	0	27	0	0
11	71941212	rs2276048	A	G	95	89	184	0	0	184	0	0
11	71941381	rs2276047	A	G	10	11	21	0	0	21	0	0
11	71941812	rs12361913	C	T	4	6	10	0	0	10	0	0
11	71945332	rs61736312	A	G	259	224	483	0	4	487	0	0
11	71946333	rs2276046	T	C	1	7	8	0	0	8	0	0
11	71948536	rs11548491	C	G	304	223	527	0	2	529	0	0
11	71949665	rs9886	G	C	375	358	733	0	11	744	0	0
11	71950012	rs70940824	T	G	120	101	221	0	2	223	0	0
11	72003767	rs526344	C	A	4	5	9	0	0	9	0	0
11	72290629	rs392565	G	A	5	1	6	0	0	6	0	0
11	72396800	rs12802369	A	G	13	12	25	0	0	25	0	0
11	72396990	rs12805218	G	A	14	13	27	0	0	27	0	0
11	72399607	rs2306609	G	A	9	12	21	0	0	21	0	0
11	72400596	rs900615	A	G	5	6	11	0	0	11	0	0
11	72400857	rs900614	A	T	3	3	6	0	0	6	0	0
11	72400958	rs900613	G	T	5	8	13	0	0	13	0	0
11	72402389	rs7943602	A	G	3	6	9	0	0	9	0	0
11	72403595	rs2306607	T	C	6	3	9	0	0	9	0	0
11	72405545	rs11235569	A	C	8	5	13	0	0	13	0	0
11	72405570	rs73529662	C	T	4	8	12	0	0	12	0	0
11	72405785	rs3816777	A	C	5	1	6	0	0	6	0	0
11	72405868	rs2306608	C	T	8	4	12	0	0	12	0	0
11	72408077	rs73529668	A	C	82	77	159	0	0	159	0	0
11	72408657	rs2291289	C	T	69	56	125	0	4	129	0	0
11	72415528	rs2306616	G	T	4	2	6	0	0	6	0	0
11	72528781	rs77541177	C	T	4	3	7	0	0	7	0	0
11	72528973	rs891655	C	T	2	5	7	0	0	7	0	0
11	72529582	rs140791287	A	G	10	8	18	0	0	18	0	0
11	72532133	rs7120156	A	C	17	8	25	0	0	25	0	0
11	72532569	rs1864651	G	T	12	17	29	0	0	29	0	0
11	72534131	rs78095359	A	T	5	7	12	0	0	12	0	0
11	72659207	rs1835644	C	G	6	3	9	0	0	9	0	0
11	72660790	rs10898892	G	T	10	4	14	0	0	14	0	0
11	72662920	rs114634336	A	G	4	3	7	0	0	7	0	0
11	72788823	rs6592510	C	T	10	11	21	0	0	21	0	0
11	72793251	rs112614512	G	A	15	10	25	0	0	25	0	0
11	72808433	rs77754605	T	A	8	5	13	0	0	13	0	0
11	72943584	.	G	A	5	1	6	0	0	6	0	0
11	72946020	rs1783596	C	T	14	13	27	0	0	27	0	0
11	72946204	rs1626154	C	T	32	21	53	0	1	54	0	0
11	72953005	rs147418313	C	A	5	5	10	0	0	10	0	0
11	73020633	rs78465712	G	C	7	6	13	0	1	14	0	0
11	73021084	rs3741149	C	T	11	9	20	0	0	20	0	0
11	73059339	rs7105679	G	T	18	10	28	0	0	28	0	0
11	73059341	rs7105681	G	A	17	10	27	0	0	27	0	0
11	73064416	rs3933402	A	G	2	5	7	0	0	7	0	0
11	73065979	rs10898917	G	A	4	2	6	0	0	6	0	0
11	73074058	rs56363880	A	G	6	2	8	0	0	8	0	0
11	73088494	rs60576099	G	A	24	18	42	0	1	43	0	0
11	73089893	rs74791512	T	C	54	46	100	0	0	100	0	0
11	73090097	rs78504473	A	G	39	34	73	0	1	74	0	0
11	73090194	rs74996190	G	A	40	36	76	0	0	76	0	0
11	73090265	rs56801796	A	G	22	22	44	0	0	44	0	0
11	73091913	rs7122560	G	A	46	34	80	0	1	81	0	0
11	73093135	rs7951174	G	C	40	48	88	0	1	89	0	0
11	73093279	rs57727431	T	G	39	37	76	0	3	79	0	0
11	73093827	rs79755881	C	T	44	32	76	0	1	77	0	0
11	73095010	.	G	A	68	56	124	0	0	124	0	0
11	73096015	rs60038108	C	T	19	8	27	0	1	28	0	0
11	73096046	rs116679768	C	T	7	2	9	0	0	9	0	0
11	73097447	rs74894239	C	T	50	49	99	0	3	102	0	0
11	73098326	rs11235729	G	A	99	85	184	0	2	186	0	0
11	73099659	rs75226028	T	C	109	133	242	0	3	245	0	0
11	73100232	rs11826896	C	T	12	7	19	0	0	19	0	0
11	73100320	rs11826909	C	G	18	7	25	0	0	25	0	0
11	73104046	rs75886732	C	T	67	63	130	0	3	133	0	0
11	73104145	rs9888218	A	C	42	43	85	0	1	86	0	0
11	73104196	rs1002126	A	C	51	59	110	0	1	111	0	0
11	73106088	rs28641751	C	G	38	57	95	0	1	96	0	0
11	73106690	rs7101831	T	C	298	279	577	0	4	581	0	0
11	73108276	rs880317	A	G	79	72	151	0	0	151	0	0
11	73111848	rs574619525	G	A	10	3	13	0	0	13	0	0
11	73114723	rs3741148	A	G	15	14	29	0	0	29	0	0
11	73115314	rs7114009	A	G	16	15	31	0	0	31	0	0
11	73116132	rs11235738	T	A	17	25	42	0	0	42	0	0
11	73116361	rs12290835	C	T	14	22	36	0	0	36	0	0
11	73116513	rs116787528	T	C	13	18	31	0	0	31	0	0
11	73116610	rs117687430	G	T	22	12	34	0	0	34	0	0
11	73120653	rs10793060	A	G	19	12	31	0	3	34	0	0
11	73133030	rs2298469	T	C	4	3	7	0	0	7	0	0
11	73388363	rs10898931	A	T	44	43	87	0	0	87	0	0
11	73388589	rs10898932	C	G	36	38	74	0	0	74	0	0
11	73516094	rs115268961	C	T	24	11	35	0	0	35	0	0
11	73585230	rs112899403	T	C	3	3	6	0	0	6	0	0
11	73592195	rs7105293	A	G	1	6	7	0	0	7	0	0
11	73597930	.	G	C	5	2	7	0	0	7	0	0
11	73603797	rs7934784	T	C	12	16	28	0	0	28	0	0
11	73680063	rs599277	G	A	15	4	19	0	0	19	0	0
11	73689104	rs660339	G	A	33	49	82	0	0	82	0	0
11	73713960	rs3741135	G	A	6	6	12	0	0	12	0	0
11	73781714	rs4944036	G	A	6	1	7	0	0	7	0	0
11	73785326	rs4453265	T	C	23	17	40	0	1	41	0	0
11	73796917	rs826058	C	T	13	15	28	0	0	28	0	0
11	73963741	rs500608	C	A	2	4	6	0	1	7	0	0
11	73965554	rs74726376	T	C	79	89	168	0	2	170	0	0
11	74042241	rs655719	A	G	9	6	15	0	0	15	0	0
11	74042787	rs3168173	A	G	4	4	8	0	1	9	0	0
11	74043708	rs596976	G	A	9	9	18	0	0	18	0	0
11	74053547	rs592644	C	T	9	6	15	0	0	15	0	0
11	74109258	rs115479879	G	A	3	6	9	0	0	9	0	0
11	74166278	rs9516	G	A	12	16	28	0	0	28	0	0
11	74167630	rs12271177	A	G	5	6	11	0	0	11	0	0
11	74203004	rs3741128	G	A	5	3	8	0	0	8	0	0
11	74203308	rs586088	T	A	7	8	15	0	0	15	0	0
11	74329615	rs4944052	T	C	21	15	36	0	1	37	0	0
11	74333739	rs12807398	A	C	4	4	8	0	0	8	0	0
11	74352201	rs1051058	C	G	12	27	39	0	0	39	0	0
11	74457056	rs61734374	A	G	64	0	64	0	5	69	0	0
11	74548261	rs1866562	G	A	2	13	15	0	0	15	0	0
11	74548487	rs57970100	T	C	12	15	27	0	0	27	0	0
11	74549391	rs1821352	G	A	24	24	48	0	2	50	0	0
11	74549520	rs79438912	G	T	31	12	43	0	0	43	0	0
11	74550616	rs11825021	T	C	25	18	43	0	0	43	0	0
11	74594991	rs12270712	G	C	2	4	6	0	0	6	0	0
11	74679480	rs60654371	C	G	3	3	6	0	0	6	0	0
11	74688040	rs200719046	A	G	11	9	20	0	0	20	0	0
11	74705696	rs544115	T	C	15	17	32	0	0	32	0	0
11	74716143	rs11603294	G	A	3	6	9	0	0	9	0	0
11	74720593	rs7483351	G	T	46	52	98	0	2	100	0	0
11	74721673	rs10899054	G	A	71	109	180	0	0	180	0	0
11	74721702	rs685116	C	G	54	94	148	0	0	149	1	0
11	75113954	.	C	G	10	4	14	0	0	14	0	0
11	75114547	rs76715388	A	G	12	13	25	0	0	25	0	0
11	75114813	.	T	G	8	17	25	0	0	25	0	0
11	75116959	rs4348932	G	A	22	28	50	0	1	51	0	0
11	75119073	rs12269908	G	T	4	3	7	0	0	7	0	0
11	75146384	rs1043638	A	G	9	6	15	0	1	16	0	0
11	75152243	rs571353	C	T	16	6	22	0	0	22	0	0
11	75154067	rs532454	C	T	5	1	6	0	0	6	0	0
11	75160575	rs518611	G	A	5	2	7	0	0	7	0	0
11	75853013	rs11540514	T	C	85	100	185	0	2	187	0	0
11	76257215	rs3753051	T	C	19	19	38	0	1	39	0	0
11	76369913	rs11236839	G	A	11	5	16	0	0	16	0	0
11	76370088	rs1320645	C	A	2	7	9	0	0	9	0	0
11	76370187	rs1320644	G	A	3	9	12	0	0	12	0	0
11	76733313	rs17135325	C	A	9	4	13	0	0	13	0	0
11	76737245	rs1945085	A	G	9	2	11	0	0	11	0	0
11	77033699	rs2729762	A	G	40	21	61	0	0	61	0	0
11	77033708	rs2844337	A	C	36	23	59	0	0	59	0	0
11	77473597	rs76498871	G	A	3	6	9	0	0	9	0	0
11	77780092	.	G	A	9	4	13	0	0	13	0	0
11	77823791	rs61995925	C	T	10	8	18	0	0	18	0	0
11	82400713	rs55868869	C	T	345	0	345	0	15	360	0	0
11	82535461	rs7272	G	A	45	41	86	0	0	86	0	0
11	82549213	rs78574771	G	A	2	7	9	0	0	9	0	0
11	82554232	rs3793982	T	A	13	7	20	0	1	21	0	0
11	82564294	rs2229437	T	G	63	48	111	0	7	118	0	0
11	82644904	rs7130899	G	A	24	6	30	0	1	31	0	0
11	82645477	rs79291652	G	A	14	13	27	0	1	28	0	0
11	82690630	rs11233397	A	C	5	2	7	0	1	8	0	0
11	82875359	rs7130527	G	A	9	7	16	0	0	16	0	0
11	82880341	rs12284052	G	A	54	47	101	0	1	102	0	0
11	82891743	rs7123661	A	G	4	5	9	0	1	10	0	0
11	82891849	rs7123899	C	G	2	7	9	0	0	9	0	0
11	82891932	rs11233509	C	T	2	4	6	0	0	6	0	0
11	82895634	rs12272947	T	C	5	4	9	0	0	9	0	0
11	82895657	rs17144746	A	G	6	4	10	0	0	10	0	0
11	82895826	rs118001085	A	G	157	132	289	0	1	290	0	0
11	82905679	rs11233519	C	T	4	7	11	0	0	11	0	0
11	82924358	rs617170	T	C	33	28	61	0	0	61	0	0
11	82926091	rs588888	C	G	5	4	9	0	0	9	0	0
11	82973004	rs8789	C	T	34	26	60	0	2	62	0	0
11	82996986	rs494791	A	C	18	15	33	0	1	34	0	0
11	85347008	rs75480347	C	T	2	8	10	0	0	10	0	0
11	85456703	rs647912	T	C	2	4	6	0	0	6	0	0
11	85674046	rs10898427	A	G	3	4	7	0	0	7	0	0
11	85690012	rs7131120	C	G	6	8	14	0	0	14	0	0
11	85690041	rs615887	G	A	10	6	16	0	0	16	0	0
11	85697685	rs2942821	G	A	6	1	7	0	0	7	0	0
11	85757133	rs1941375	T	C	3	3	6	0	0	6	0	0
11	85773247	rs10898432	T	C	6	4	10	0	0	10	0	0
11	85966542	rs7950820	A	C	3	3	6	0	0	6	0	0
11	85968623	rs974144	C	T	43	22	65	0	0	65	0	0
11	85972478	rs10792843	C	T	3	5	8	0	0	8	0	0
11	85972939	rs10898459	T	C	3	9	12	0	0	12	0	0
11	86055472	rs12289477	A	G	5	2	7	0	0	7	0	0
11	86146001	rs1452133	T	C	3	3	6	0	0	6	0	0
11	86153911	rs7548	G	A	211	79	290	0	2	292	0	0
11	86157998	rs4944580	T	C	12	4	16	0	0	16	0	0
11	86160071	rs12271571	A	G	7	1	8	0	0	8	0	0
11	86160358	rs10898484	T	C	4	2	6	0	0	6	0	0
11	86161388	rs1042780	C	G	96	43	139	0	1	140	0	0
11	86162568	rs7109853	A	G	9	2	11	0	0	11	0	0
11	86163988	rs189119506	G	A	3	8	11	0	0	11	0	0
11	86164048	rs4944582	G	T	7	1	8	0	0	8	0	0
11	86164301	rs4944583	G	C	7	0	7	0	1	8	0	0
11	86165814	rs6592296	A	G	2	4	6	0	0	6	0	0
11	86165942	rs1563682	A	G	4	5	9	0	0	9	0	0
11	86166847	rs3819227	G	A	5	1	6	0	0	6	0	0
11	86167136	rs2125362	G	A	8	3	11	0	0	11	0	0
11	86167202	rs2125363	C	G	5	4	9	0	0	9	0	0
11	86267678	rs4943943	G	A	21	9	30	0	0	30	0	0
11	86376341	rs11607554	G	A	14	14	28	0	0	28	0	0
11	86749775	rs3133361	A	G	4	6	10	0	0	10	0	0
11	87013438	rs2276102	G	A	3	3	6	0	0	6	0	0
11	88030157	rs170083	A	T	2	5	7	0	0	7	0	0
11	88030457	rs217109	C	T	4	5	9	0	0	9	0	0
11	88030785	rs217111	G	A	4	9	13	0	0	13	0	0
11	88031232	rs217113	C	T	4	2	6	0	0	6	0	0
11	88045583	rs217086	A	G	49	62	111	0	0	111	0	0
11	88064982	rs217068	A	C	33	34	67	0	0	67	0	0
11	88066714	rs55897509	A	C	5	3	8	0	0	8	0	0
11	88070858	rs11019400	A	G	13	19	32	0	0	32	0	0
11	89922230	rs11018904	A	G	16	12	28	0	0	28	0	0
11	89922417	rs61903695	A	G	9	6	15	0	0	15	0	0
11	89922423	rs4382864	C	G	7	8	15	0	0	15	0	0
11	89923282	rs10501711	G	T	7	4	11	0	0	11	0	0
11	89925179	rs11018905	C	G	2	5	7	0	0	7	0	0
11	89925762	rs1061470	C	T	6	5	11	0	0	11	0	0
11	89939437	.	A	G	50	63	113	0	4	117	0	0
11	89939569	rs723715	T	C	6	1	7	0	0	7	0	0
11	89941327	rs10741327	G	A	4	4	8	0	0	8	0	0
11	89942645	rs11018912	C	T	2	6	8	0	0	8	0	0
11	89942655	rs11018913	G	C	2	6	8	0	0	8	0	0
11	89942659	rs11018914	C	A	2	6	8	0	0	8	0	0
11	89943221	rs11018916	G	A	3	5	8	0	1	9	0	0
11	89944964	rs10765275	C	T	10	11	21	0	0	21	0	0
11	89945358	rs10765276	C	A	22	24	46	0	0	46	0	0
11	89945647	rs11018917	A	C	15	10	25	0	0	25	0	0
11	89945668	rs2226571	C	T	19	11	30	0	0	30	0	0
11	89946354	rs11601793	T	G	11	9	20	0	0	20	0	0
11	89947772	rs7105979	T	C	8	3	11	0	0	11	0	0
11	89950035	rs10830444	G	T	3	4	7	0	0	7	0	0
11	89956206	rs72958748	G	A	10	18	28	0	0	28	0	0
11	92298513	.	C	A	11	0	11	0	0	11	0	0
11	92878666	rs76935911	A	C	8	5	13	0	0	13	0	0
11	92880243	rs12574282	G	A	2	4	6	0	0	6	0	0
11	92881044	rs1062050	T	G	58	49	107	0	1	108	0	0
11	93862493	rs1138800	A	C	4	9	13	0	0	13	0	0
11	93914451	rs1046805	G	A	6	5	11	0	0	11	0	0
11	93914709	rs1046812	T	C	24	15	39	0	0	39	0	0
11	93914956	rs1070	A	G	19	18	37	0	0	37	0	0
11	93921742	rs7927496	C	T	8	0	8	0	2	10	0	0
11	94181692	rs117963478	G	A	5	3	8	0	0	8	0	0
11	94193020	rs496190	A	G	4	4	8	0	0	8	0	0
11	94205747	rs639311	C	T	4	2	6	0	0	6	0	0
11	94226952	rs1805363	C	T	4	7	11	0	0	11	0	0
11	94231257	rs2509943	C	G	58	51	109	0	1	110	0	0
11	94231847	rs1046654	G	A	28	24	52	0	0	52	0	0
11	94281182	rs117324437	G	A	13	3	16	0	1	17	0	0
11	94282014	rs10741490	G	A	43	77	120	0	3	123	0	0
11	94320237	rs7110167	T	C	5	7	12	0	0	12	0	0
11	94322352	rs11020845	A	T	4	11	15	0	0	15	0	0
11	94322353	rs11020846	G	A	4	11	15	0	0	15	0	0
11	94326765	rs57607909	G	C	7	7	14	0	0	14	0	0
11	94501610	rs17608451	G	A	8	4	12	0	0	12	0	0
11	94533373	rs2303960	C	T	10	11	21	0	1	22	0	0
11	94610577	rs498376	G	C	2	4	6	0	0	6	0	0
11	94703564	rs6483382	T	C	19	22	41	0	1	42	0	0
11	94704037	rs3737505	C	G	9	12	21	0	2	23	0	0
11	94906111	rs684856	G	A	8	8	16	0	0	16	0	0
11	94964931	rs2077510	T	C	1	5	6	0	0	6	0	0
11	94965293	rs4753659	T	C	5	3	8	0	0	8	0	0
11	94967106	rs10831322	C	T	7	3	10	0	0	10	0	0
11	95559841	rs186790873	C	T	2	6	8	0	0	8	0	0
11	95606174	rs1144674	C	T	5	3	8	0	0	8	0	0
11	96119797	rs149938791	C	A	8	13	21	0	0	21	0	0
11	102207851	rs1055088	G	A	14	17	31	0	0	31	0	0
11	102208390	rs3460	G	C	45	47	92	0	1	93	0	0
11	102209172	rs3903273	C	G	20	19	39	0	0	39	0	0
11	102209737	rs13711	A	C	24	23	47	0	1	48	0	0
11	102230255	rs4385869	G	A	3	5	8	0	0	8	0	0
11	102231922	rs1840447	T	C	5	4	9	0	0	9	0	0
11	102268527	rs484068	T	A	297	263	560	0	5	565	0	0
11	102269679	rs655139	T	G	16	13	29	0	0	29	0	0
11	102271718	rs74805852	G	C	6	8	14	0	0	14	0	0
11	102582941	rs7934972	G	A	14	9	23	0	0	23	0	0
11	102583033	rs1939017	T	A	9	11	20	0	0	20	0	0
11	102583075	rs7925438	T	C	12	11	23	0	0	23	0	0
11	102583680	rs12284255	C	A	10	2	12	0	0	12	0	0
11	102925966	rs116941261	A	G	13	9	22	0	0	22	0	0
11	102949969	rs2513996	A	G	4	2	6	0	0	6	0	0
11	102951612	rs2513994	A	G	11	2	13	0	0	13	0	0
11	102951654	rs139072082	C	T	14	2	16	0	0	16	0	0
11	104814538	rs55743104	A	G	19	9	28	0	0	28	0	0
11	104896613	rs1790203	G	A	16	22	38	0	1	39	0	0
11	104896844	rs1977989	A	G	7	10	17	0	0	17	0	0
11	104897437	rs2282659	A	G	1	5	6	0	0	6	0	0
11	104908416	rs526118	T	G	4	2	6	0	0	6	0	0
11	105960562	rs17393463	A	G	2	5	7	0	0	7	0	0
11	107197319	rs512574	T	C	11	9	20	0	0	20	0	0
11	107197536	rs630782	C	T	6	15	21	0	0	21	0	0
11	107374531	rs10502092	C	T	10	5	15	0	0	15	0	0
11	107662790	rs518852	A	G	7	13	20	0	0	20	0	0
11	107662841	rs518073	A	G	9	14	23	0	0	23	0	0
11	107663103	rs516091	C	G	17	7	24	0	0	24	0	0
11	107917087	rs7117111	A	G	85	71	156	0	2	158	0	0
11	107940042	rs4575229	A	G	4	4	8	0	0	8	0	0
11	107953557	rs11605878	T	A	3	8	11	0	0	11	0	0
11	107954011	rs10890808	T	C	5	2	7	0	0	7	0	0
11	107954128	rs74634300	C	T	3	3	6	0	0	6	0	0
11	107967736	rs75500101	C	T	5	2	7	0	0	7	0	0
11	107967874	rs4109081	A	G	3	5	8	0	0	8	0	0
11	107976450	rs3781870	C	T	16	8	24	0	0	24	0	0
11	107977059	rs78891752	T	C	23	21	44	0	0	44	0	0
11	107986344	rs4550189	G	A	4	5	9	0	0	9	0	0
11	107992312	rs3741054	C	G	6	14	20	0	0	20	0	0
11	107992325	rs3741055	T	A	25	6	31	0	0	31	0	0
11	107992346	rs3741056	G	C	29	7	36	0	0	36	0	0
11	108006466	rs1550608	A	G	9	2	11	0	0	11	0	0
11	108008302	rs7926222	G	A	7	4	11	0	0	11	0	0
11	108009174	rs9734846	A	T	5	1	6	0	0	6	0	0
11	108009381	rs10789654	T	C	8	4	12	0	0	12	0	0
11	108009660	rs35188041	C	A	60	70	130	0	1	131	0	0
11	108043988	rs2070661	C	T	4	3	7	0	0	7	0	0
11	108077181	rs12272183	A	G	9	3	12	0	0	12	0	0
11	108077536	rs148753515	C	T	5	11	16	0	0	16	0	0
11	108077857	rs11605442	G	A	6	4	10	0	0	10	0	0
11	108136890	rs228605	C	T	6	3	9	0	0	9	0	0
11	108237839	rs227091	C	T	7	11	18	0	0	18	0	0
11	108239628	rs4585	G	T	14	9	23	0	0	23	0	0
11	108344081	rs7943203	G	A	11	14	25	0	1	26	0	0
11	110035262	rs1026608	A	G	7	8	15	0	0	15	0	0
11	110035301	rs1026607	A	G	6	9	15	0	0	15	0	0
11	110040812	rs55808598	A	G	6	6	12	0	0	12	0	0
11	110042157	rs4754425	G	A	10	22	32	0	0	32	0	0
11	110091471	rs145582712	C	T	6	3	9	0	0	9	0	0
11	110091645	rs11213316	A	T	8	5	13	0	0	13	0	0
11	110091774	rs7943647	T	G	4	4	8	0	0	8	0	0
11	110097811	rs10749957	A	G	3	6	9	0	1	10	0	0
11	110097851	rs10749958	A	G	3	5	8	0	2	10	0	0
11	110109702	rs12575162	G	A	10	14	24	0	1	25	0	0
11	110317347	rs146768862	C	T	9	6	15	0	0	15	0	0
11	111483185	rs1784784	G	A	1	6	7	0	0	7	0	0
11	111483306	rs1784785	A	G	9	16	25	0	0	25	0	0
11	111536190	rs9734135	G	A	2	4	6	0	0	6	0	0
11	111536670	rs7926485	G	A	3	4	7	0	0	7	0	0
11	111595166	rs605923	G	C	16	13	29	0	0	29	0	0
11	111654648	.	T	A	4	2	6	0	1	7	0	0
11	111747297	rs7124696	A	G	5	5	10	0	0	10	0	0
11	111754574	rs1045282	A	C	103	76	179	0	4	184	1	0
11	111933484	.	A	G	18	26	44	0	1	45	0	0
11	113952837	rs2735201	A	C	6	10	16	0	0	16	0	0
11	113982321	rs73000965	T	A	10	8	18	0	0	18	0	0
11	113995405	rs238891	T	C	5	1	6	0	0	6	0	0
11	114019632	rs4938075	G	A	2	4	6	0	0	6	0	0
11	114121640	rs35728782	A	G	51	32	83	0	0	83	0	0
11	114125260	rs566775	C	T	105	82	187	0	1	188	0	0
11	114280741	rs13725	C	G	37	21	58	0	0	58	0	0
11	114302800	rs528747	A	G	6	5	11	0	0	11	0	0
11	114307469	rs145745525	C	T	4	3	7	0	0	7	0	0
11	114315188	rs540712	A	G	10	10	20	0	0	20	0	0
11	114316534	rs79008673	T	C	10	13	23	0	0	23	0	0
11	114317622	rs11824249	G	A	5	1	6	0	0	6	0	0
11	114319571	rs11214995	A	G	5	9	14	0	1	15	0	0
11	114319607	rs78095522	T	C	5	7	12	0	0	12	0	0
11	114320036	rs577976	G	C	4	4	8	0	0	8	0	0
11	116629949	rs4938310	C	T	7	4	11	0	0	11	0	0
11	116630600	rs918143	C	T	9	2	11	0	0	11	0	0
11	116631391	rs3741301	T	C	6	5	11	0	1	12	0	0
11	116633825	rs918144	C	T	31	41	72	0	0	72	0	0
11	116715784	rs142174850	G	A	31	26	57	0	0	57	0	0
11	116737093	rs548638	T	G	4	2	6	0	0	6	0	0
11	116738046	rs518547	A	G	3	3	6	0	0	6	0	0
11	116748169	rs12278117	G	A	9	7	16	0	0	16	0	0
11	116748221	rs12279433	G	T	7	5	12	0	0	12	0	0
11	116748515	rs12292614	A	G	7	2	9	0	0	9	0	0
11	116748744	rs12286581	T	C	7	2	9	0	1	10	0	0
11	116749072	rs75294699	C	A	6	0	6	0	0	6	0	0
11	116763799	rs138624117	G	C	29	7	36	0	1	37	0	0
11	116764582	rs4938316	C	T	9	6	15	0	0	15	0	0
11	116788837	rs1135663	C	T	13	12	25	0	0	25	0	0
11	116791307	rs78692246	G	A	8	9	17	0	1	18	0	0
11	116792961	rs7948838	A	G	19	18	37	0	0	37	0	0
11	116793231	rs12225187	G	A	17	20	37	0	0	37	0	0
11	116793693	rs10892047	C	T	6	2	8	0	0	8	0	0
11	116795948	rs12292371	G	C	6	9	15	0	1	16	0	0
11	116796065	rs12292434	G	A	13	8	21	0	0	21	0	0
11	116796846	rs7121898	A	T	10	8	18	0	0	18	0	0
11	116797475	rs12285956	G	A	4	12	16	0	0	16	0	0
11	116797684	rs11216190	T	C	5	4	9	0	0	9	0	0
11	116815891	rs11216195	G	A	8	4	12	0	0	12	0	0
11	116815892	rs11216196	T	G	8	4	12	0	0	12	0	0
11	116816394	rs10892050	C	A	4	2	6	0	0	6	0	0
11	116824796	.	G	T	42	39	81	0	2	83	0	0
11	116902372	rs7481286	G	T	6	10	16	0	0	16	0	0
11	116902616	rs12804122	C	G	5	2	7	0	0	7	0	0
11	116936871	rs56751865	C	T	2	4	6	0	0	6	0	0
11	116946238	rs12274388	C	T	7	4	11	0	0	11	0	0
11	116946533	rs35192698	T	C	8	10	18	0	0	18	0	0
11	116946652	rs7130213	C	A	12	6	18	0	0	18	0	0
11	116946853	rs12274725	C	T	12	5	17	0	0	17	0	0
11	116946890	rs7484045	C	T	8	8	16	0	0	16	0	0
11	117029785	rs78166985	A	T	3	3	6	0	0	6	0	0
11	117034729	rs10790175	T	C	6	4	10	0	0	10	0	0
11	117038741	rs77171490	T	A	46	38	84	0	0	84	0	0
11	117039154	rs190482111	G	A	42	17	59	0	17	77	1	0
11	117039461	rs116773440	A	C	135	146	281	0	1	282	0	0
11	117040505	rs77678768	G	C	102	85	187	0	0	187	0	0
11	117042238	rs10750103	C	T	11	10	21	0	0	21	0	0
11	117042949	rs7120565	T	C	4	3	7	0	0	7	0	0
11	117056059	rs11606672	C	T	4	2	6	0	0	6	0	0
11	117058062	rs2306472	C	T	5	8	13	0	0	13	0	0
11	117059552	rs474339	G	A	0	8	8	0	0	8	0	0
11	117062489	rs3213459	T	C	5	2	7	0	0	7	0	0
11	117063709	rs2301174	C	G	8	6	14	0	1	15	0	0
11	117064693	rs521171	C	G	12	22	34	0	0	34	0	0
11	117064776	rs11605883	C	G	18	10	28	0	0	28	0	0
11	117065066	rs3781985	G	C	10	4	14	0	0	14	0	0
11	117065153	rs80183569	G	A	11	3	14	0	0	14	0	0
11	117065533	rs11606480	G	A	10	3	13	0	0	13	0	0
11	117065772	rs112712475	C	A	4	6	10	0	0	10	0	0
11	117065779	rs1794116	T	C	5	3	8	0	1	9	0	0
11	117066353	rs2269399	G	C	7	9	16	0	0	16	0	0
11	117067699	rs8521	C	T	57	40	97	0	0	97	0	0
11	117070596	rs2239678	C	T	12	11	23	0	0	23	0	0
11	117070740	rs2170317	A	C	1	7	8	0	0	8	0	0
11	117070857	rs664971	G	A	7	3	10	0	0	10	0	0
11	117070895	rs664922	C	A	5	4	9	0	0	9	0	0
11	117071070	rs664082	C	G	6	3	9	0	0	9	0	0
11	117071449	rs652455	C	T	3	11	14	0	0	14	0	0
11	117072525	rs488962	C	T	7	8	15	0	0	15	0	0
11	117072963	rs634960	T	C	12	9	21	0	0	21	0	0
11	117074109	rs12970	G	A	43	45	88	0	2	90	0	0
11	117076564	rs1242127	A	G	61	15	76	0	0	76	0	0
11	117076708	rs35186251	T	C	18	13	31	0	0	31	0	0
11	117077034	rs28590104	A	G	39	58	97	0	0	97	0	0
11	117080120	.	C	T	8	4	12	0	0	12	0	0
11	117080640	rs11216315	C	G	10	8	18	0	2	20	0	0
11	117081763	rs171052	C	G	6	8	14	0	0	14	0	0
11	117081974	rs236910	A	G	7	15	22	0	0	22	0	0
11	117082109	rs12417682	G	A	5	6	11	0	0	11	0	0
11	117082966	rs76169968	G	A	5	4	9	0	0	9	0	0
11	117083373	rs111765459	T	C	7	6	13	0	0	13	0	0
11	117084091	rs4938358	C	T	11	17	28	0	0	28	0	0
11	117084396	rs12418705	C	T	6	8	14	0	0	14	0	0
11	117084537	rs12418744	G	A	7	4	11	0	0	11	0	0
11	117085121	rs36055668	T	C	9	8	17	0	0	17	0	0
11	117085210	rs77683187	A	C	7	12	19	0	0	19	0	0
11	117094591	rs17120523	A	G	18	7	25	0	0	25	0	0
11	117096652	rs2277287	G	A	16	22	38	0	0	38	0	0
11	117101120	rs36066272	T	C	11	16	27	0	0	27	0	0
11	117119552	rs523366	A	G	10	4	14	0	0	14	0	0
11	117120027	rs605531	T	G	4	3	7	0	0	7	0	0
11	117120473	rs509565	T	C	10	9	19	0	0	19	0	0
11	117283091	rs2279013	C	T	15	14	29	0	0	29	0	0
11	117283808	rs9163	C	T	21	18	39	0	1	40	0	0
11	117707937	rs3087563	T	C	50	61	111	0	2	113	0	0
11	117858983	rs4252248	G	A	5	5	10	0	0	10	0	0
11	117860582	rs2512143	A	G	2	4	6	0	0	6	0	0
11	117863829	rs2508450	T	C	3	4	7	0	0	7	0	0
11	117864047	rs2256111	A	G	89	76	165	0	0	165	0	0
11	117864063	rs3135932	A	G	80	74	154	0	0	154	0	0
11	117867397	rs2508454	T	C	2	4	6	0	0	6	0	0
11	117869670	rs2229113	A	G	56	80	136	0	1	137	0	0
11	118068752	rs2298831	T	C	2	13	15	0	0	15	0	0
11	118098890	rs1793156	T	C	12	5	17	0	0	17	0	0
11	118098962	rs1793155	G	A	8	4	12	0	2	14	0	0
11	118099186	rs3802863	C	T	10	1	11	0	0	11	0	0
11	118099617	rs11216825	G	A	7	12	19	0	0	19	0	0
11	118099713	rs11216826	A	T	6	6	12	0	0	12	0	0
11	118120802	rs61900655	G	C	12	2	14	0	0	14	0	0
11	118178007	rs1126924	C	T	10	7	17	0	0	17	0	0
11	118235490	rs12576486	T	C	3	4	7	0	0	7	0	0
11	118240715	rs12792929	G	C	7	15	22	0	0	22	0	0
11	118258056	rs1079118	G	A	2	6	8	0	0	8	0	0
11	118261736	rs57702967	C	A	2	4	6	0	0	6	0	0
11	118263054	rs73613959	G	A	8	7	15	0	0	15	0	0
11	118268613	rs7108613	A	G	63	64	127	0	0	127	0	0
11	118273019	rs17122154	G	A	10	6	16	0	0	16	0	0
11	118276116	rs9666463	C	G	14	9	23	0	0	23	0	0
11	118276246	rs7483081	T	C	5	7	12	0	1	13	0	0
11	118276492	rs17122157	G	A	16	11	27	0	0	27	0	0
11	118320553	rs629470	G	A	182	142	324	0	2	326	0	0
11	118393396	rs573971	A	G	64	42	106	0	1	107	0	0
11	118405068	rs12289253	A	G	14	8	22	0	0	22	0	0
11	118405305	rs45505501	G	A	4	2	6	0	0	6	0	0
11	118405453	rs45474901	T	C	2	4	6	0	0	6	0	0
11	118405641	rs3741323	A	G	2	4	6	0	0	6	0	0
11	118405835	rs3741324	G	A	1	6	7	0	0	7	0	0
11	118405989	rs3741325	A	G	1	6	7	0	0	7	0	0
11	118411713	rs7932700	G	T	0	8	8	0	0	8	0	0
11	118412358	rs61290697	C	T	7	34	41	0	0	41	0	0
11	118413604	rs58270621	G	A	1	13	14	0	0	14	0	0
11	118430519	rs11552421	C	T	5	34	39	0	0	39	0	0
11	118435756	rs2277291	C	T	3	19	22	0	0	22	0	0
11	118436079	rs11216900	G	C	1	9	10	0	0	10	0	0
11	118436618	.	G	C	6	0	6	0	0	6	0	0
11	118449746	rs11216909	C	T	2	4	6	0	0	6	0	0
11	118450046	rs11216910	A	G	4	4	8	0	0	8	0	0
11	118450260	rs7122547	G	A	5	3	8	0	0	8	0	0
11	118471423	rs11216925	T	C	43	52	95	0	2	97	0	0
11	118471996	rs11216926	C	T	56	45	101	0	1	102	0	0
11	118472354	rs10892245	C	A	100	90	190	0	2	192	0	0
11	118473231	rs1047079	T	C	184	182	366	0	1	367	0	0
11	118473385	rs17742	T	C	210	208	418	0	5	423	0	0
11	118528466	rs7389	T	G	5	1	6	0	0	6	0	0
11	118630532	rs35888235	G	T	9	3	12	0	0	12	0	0
11	118767077	rs581063	T	C	44	34	78	0	0	78	0	0
11	118769442	rs7104819	A	G	15	7	22	0	1	23	0	0
11	118773438	rs35346926	C	T	5	6	11	0	0	11	0	0
11	118875618	.	A	G	4	2	6	0	0	6	0	0
11	118914998	rs35588561	A	G	25	15	40	0	0	40	0	0
11	118915755	rs13929	G	C	64	53	117	0	0	117	0	0
11	118915944	rs1043314	A	G	56	64	120	0	2	122	0	0
11	118917587	rs45510602	C	T	5	6	11	0	1	12	0	0
11	118919206	rs568922	T	C	25	20	45	0	0	45	0	0
11	118922200	rs1804690	G	A	21	23	44	0	0	44	0	0
11	118925341	rs538478	G	A	13	18	31	0	0	31	0	0
11	118938880	rs584115	A	G	35	38	73	0	0	73	0	0
11	118938882	rs670526	C	T	36	34	70	0	4	74	0	0
11	118941996	.	C	T	4	2	6	0	0	6	0	0
11	118947634	rs540261	C	T	75	83	158	0	1	159	0	0
11	118955679	rs589925	C	T	11	11	22	0	1	23	0	0
11	118963750	rs1799997	G	A	4	3	7	0	0	7	0	0
11	118978319	rs7936924	C	T	4	4	8	0	0	8	0	0
11	118986630	rs608444	G	A	6	7	13	0	0	13	0	0
11	118986659	rs608793	C	T	6	7	13	0	0	13	0	0
11	118987971	rs571445	G	A	19	21	40	0	0	40	0	0
11	118989098	rs1129013	C	G	6	4	10	0	0	10	0	0
11	118995325	rs7123630	T	C	4	3	7	0	0	7	0	0
11	118995353	rs624588	C	G	5	3	8	0	0	8	0	0
11	118995481	rs1786142	C	T	5	7	12	0	0	12	0	0
11	119004009	rs672189	G	T	3	4	7	0	0	7	0	0
11	119004026	rs537153	C	T	2	4	6	0	0	6	0	0
11	119004686	rs658922	T	A	6	7	13	0	0	13	0	0
11	119005132	rs100803	C	T	8	13	21	0	0	21	0	0
11	119005485	rs7234	C	T	11	10	21	0	0	21	0	0
11	119006300	rs641382	C	A	0	10	10	0	0	10	0	0
11	119006462	rs617290	A	G	1	6	7	0	0	7	0	0
11	119040463	rs7483350	G	C	8	2	10	0	0	10	0	0
11	119041535	rs76997481	G	A	8	0	8	0	0	8	0	0
11	119041659	rs626984	C	T	9	0	9	0	0	9	0	0
11	119043656	rs643423	C	T	25	23	48	0	0	48	0	0
11	119052826	rs4245191	C	A	46	43	89	0	0	89	0	0
11	119054488	rs10790286	C	T	113	94	207	0	1	208	0	0
11	119064558	rs12417928	G	A	5	1	6	0	0	6	0	0
11	119145274	rs2276083	A	G	23	21	44	0	0	44	0	0
11	119180316	rs7914	G	A	12	15	27	0	0	27	0	0
11	119205735	rs12797083	T	C	75	71	146	0	1	147	0	0
11	119205830	rs12795576	A	G	66	58	124	0	0	124	0	0
11	119206375	rs2511841	G	A	63	48	111	0	0	111	0	0
11	119229964	rs2241646	G	A	8	1	9	0	0	9	0	0
11	121176185	rs139131517	C	T	4	2	6	0	0	6	0	0
11	121178302	rs1061332	A	C	30	31	61	0	1	62	0	0
11	121328954	rs661057	T	C	32	44	76	0	0	76	0	0
11	121349111	rs11218304	A	G	6	4	10	0	0	10	0	0
11	121367626	rs12364988	T	C	35	38	73	0	1	74	0	0
11	121411041	rs3781827	A	G	0	6	6	0	0	6	0	0
11	121411112	rs688503	G	A	9	0	9	0	0	9	0	0
11	121416828	rs7933552	T	G	4	4	8	0	0	8	0	0
11	121417124	rs11218326	G	A	4	6	10	0	0	10	0	0
11	121418806	rs7103597	C	T	9	5	14	0	0	14	0	0
11	121420155	rs10790446	G	T	2	4	6	0	0	6	0	0
11	121420184	rs11218335	C	T	3	3	6	0	0	6	0	0
11	122585573	rs4016788	T	G	1	5	6	0	0	6	0	0
11	122585598	rs4016787	T	A	1	5	6	0	0	6	0	0
11	122596271	rs55905145	C	A	7	0	7	0	0	7	0	0
11	122600620	rs73018236	G	C	3	3	6	0	0	6	0	0
11	122665437	rs872414	A	G	18	15	33	0	0	33	0	0
11	122742807	rs67366392	C	A	4	3	7	0	0	7	0	0
11	122742879	rs57422890	G	C	4	5	9	0	0	9	0	0
11	123598941	rs2282644	T	C	4	3	7	0	0	7	0	0
11	123606029	rs6590005	A	C	4	11	15	0	0	15	0	0
11	123609634	rs1557429	G	A	12	13	25	0	0	25	0	0
11	123609762	rs1557428	G	C	5	13	18	0	0	18	0	0
11	123994894	rs73030862	T	A	1	5	6	0	0	6	0	0
11	124618197	.	T	A	10	10	20	0	0	20	0	0
11	124620238	rs626260	G	A	4	2	6	0	0	6	0	0
11	124747333	rs10790713	A	G	1	8	9	0	0	9	0	0
11	124750028	rs10790714	A	T	2	4	6	0	0	6	0	0
11	124754611	rs12823	T	A	9	9	18	0	0	18	0	0
11	124767067	rs59648931	T	C	6	1	7	0	0	7	0	0
11	124857708	rs4936966	G	A	4	2	6	0	0	6	0	0
11	124857757	rs61912661	T	C	2	4	6	0	0	6	0	0
11	124863136	rs7951202	C	A	6	2	8	0	1	9	0	0
11	124908352	rs7107487	T	C	2	4	6	0	0	6	0	0
11	124910860	rs56403202	T	C	1	5	6	0	0	6	0	0
11	125452313	rs4627097	A	G	77	44	121	0	0	121	0	0
11	125493879	rs491741	T	C	4	5	9	0	0	9	0	0
11	125495022	rs2298483	C	T	14	10	24	0	0	24	0	0
11	125495264	rs558351	C	T	17	16	33	0	0	33	0	0
11	125527202	rs566866	G	A	4	3	7	0	0	7	0	0
11	125766044	rs549990	C	A	3	9	12	0	0	12	0	0
11	125766173	rs622756	A	C	4	8	12	0	0	12	0	0
11	125766204	rs600761	G	C	1	6	7	0	0	7	0	0
11	126278203	rs2298475	T	C	101	64	165	0	0	165	0	0
11	126327778	rs11220501	G	A	8	0	8	0	0	8	0	0
11	126327999	rs2155307	C	G	3	6	9	0	0	9	0	0
11	126328859	rs751195	G	C	13	15	28	0	1	29	0	0
11	128328913	rs8705	G	A	44	21	65	0	1	66	0	0
11	128330520	rs4937333	T	C	28	23	51	0	1	52	0	0
11	128333503	rs2230004	T	C	29	16	45	0	0	45	0	0
11	128390364	rs4430527	A	T	5	3	8	0	0	8	0	0
11	128560276	rs56369005	T	C	4	6	10	0	0	10	0	0
11	128560626	rs2155132	C	T	5	4	9	0	1	10	0	0
11	128563141	rs45525840	C	A	8	2	10	0	0	10	0	0
11	128567876	rs11221439	G	A	7	2	9	0	0	9	0	0
11	128571710	rs594479	T	C	2	5	7	0	0	7	0	0
11	128575132	rs7128819	G	A	4	5	9	0	0	9	0	0
11	128584765	rs4936066	A	C	4	2	6	0	0	6	0	0
11	128585617	rs189696997	G	C	5	6	11	0	0	11	0	0
11	128586155	rs654723	C	A	4	3	7	0	0	7	0	0
11	128587411	rs663503	C	T	6	6	12	0	0	12	0	0
11	128589472	rs606707	C	T	6	3	9	0	0	9	0	0
11	128593546	rs12225478	G	T	7	12	19	0	0	19	0	0
11	128594161	rs684150	C	T	14	17	31	0	0	31	0	0
11	128594875	rs615671	G	A	48	34	82	0	0	82	0	0
11	128595173	rs587862	A	G	67	50	117	0	1	118	0	0
11	128637056	rs663461	A	G	4	2	6	0	0	6	0	0
11	128655777	rs565888	A	C	10	5	15	0	0	15	0	0
11	128655820	rs75701166	C	T	9	3	12	0	0	12	0	0
11	128681223	rs41302401	C	A	46	68	114	0	1	115	0	0
11	128839405	rs78856194	C	T	14	4	18	0	0	18	0	0
11	129729775	rs74238128	C	T	13	12	25	0	0	25	0	0
11	129752991	rs2293664	G	C	5	2	7	0	0	7	0	0
11	129754644	rs1131972	A	G	36	35	71	0	0	71	0	0
11	129758327	rs1650823	G	A	9	9	18	0	0	18	0	0
11	129763769	rs7116648	C	G	4	4	8	0	0	8	0	0
11	129764526	rs1783919	C	T	4	6	10	0	0	10	0	0
11	129764568	rs3829264	C	T	4	4	8	0	0	8	0	0
11	129764865	rs1733453	C	G	3	3	6	0	0	6	0	0
11	129764879	rs1623873	A	T	4	3	7	0	0	7	0	0
11	129764953	rs7120896	A	G	5	3	8	0	0	8	0	0
11	129769926	rs1043654	T	C	36	45	81	0	1	82	0	0
11	129772013	rs3734078	C	T	15	10	25	0	0	25	0	0
11	129785594	rs3734073	G	A	5	2	7	0	1	8	0	0
11	129794950	rs2241571	T	C	5	7	12	0	0	12	0	0
11	129801043	rs2277033	C	T	7	4	11	0	1	12	0	0
11	130066261	rs17667603	C	A	6	0	6	0	0	6	0	0
11	130066335	rs476106	C	T	1	5	6	0	0	6	0	0
11	130080017	rs704624	C	T	11	9	20	0	1	21	0	0
11	130080037	rs704625	C	G	8	9	17	0	0	17	0	0
11	130080065	rs5852	G	A	16	12	28	0	0	28	0	0
11	130097778	rs143017730	G	A	33	31	64	0	0	64	0	0
11	130714613	rs10894265	T	C	0	6	6	0	0	6	0	0
11	130714633	rs10894266	T	C	1	6	7	0	0	7	0	0
11	130714861	rs10894267	C	T	2	9	11	0	0	11	0	0
11	130738946	rs10791100	T	A	4	2	6	0	0	6	0	0
11	130739284	rs2236711	G	A	1	5	6	0	0	6	0	0
11	130739480	rs2236713	T	G	4	2	6	0	0	6	0	0
11	130746146	rs1050078	T	C	17	21	38	0	1	39	0	0
11	130747231	rs1050071	C	G	21	9	30	0	0	30	0	0
11	130747386	rs6590520	C	G	14	9	23	0	0	23	0	0
11	130748131	rs3190331	A	G	7	8	15	0	1	16	0	0
11	130751094	rs2155749	G	T	5	1	6	0	0	6	0	0
11	130751261	rs2155750	A	C	5	3	8	0	0	8	0	0
11	130751308	rs7942621	C	G	8	2	10	0	2	12	0	0
11	130777886	rs2276098	G	A	27	26	53	0	1	54	0	0
11	130779646	rs4508210	A	G	5	2	7	0	0	7	0	0
11	130779668	rs7107568	T	C	2	5	7	0	0	7	0	0
11	130779674	rs4403816	C	T	5	2	7	0	0	7	0	0
11	130781475	rs3751038	C	G	0	7	7	0	0	7	0	0
11	130781675	rs12420822	C	T	3	5	8	0	0	8	0	0
11	130781685	rs12420847	G	C	2	5	7	0	1	8	0	0
11	130783543	rs73028898	C	A	3	4	7	0	0	7	0	0
11	130783697	rs73028899	A	G	8	9	17	0	0	17	0	0
11	130783728	rs73028900	G	A	5	7	12	0	1	13	0	0
11	130783765	rs73028901	T	C	3	5	8	0	0	8	0	0
11	130784396	rs62621284	G	A	9	17	26	0	0	26	0	0
11	130784488	rs61734874	A	G	14	21	35	0	1	36	0	0
11	130784616	rs3190345	T	C	6	19	25	0	0	25	0	0
11	130784647	rs1050081	G	C	8	12	20	0	0	20	0	0
11	130784694	rs61736758	C	T	6	8	14	0	0	14	0	0
11	130784707	rs61736752	C	T	5	9	14	0	0	14	0	0
11	130785205	rs3751035	G	A	7	12	19	0	1	20	0	0
11	130785304	rs3751034	T	C	9	10	19	0	0	19	0	0
11	134020222	rs11223716	T	G	6	7	13	0	0	13	0	0
11	134020353	.	G	C	3	10	13	0	0	13	0	0
11	134021859	rs655627	G	A	2	6	8	0	0	8	0	0
11	134022087	rs6590735	G	T	5	3	8	0	0	8	0	0
11	134108059	rs61703311	G	T	4	3	7	0	0	7	0	0
11	134111547	rs10894788	A	G	11	7	18	0	0	18	0	0
11	134112033	rs4362160	G	A	7	3	10	0	0	10	0	0
11	134112662	rs2282562	G	A	10	6	16	0	0	16	0	0
11	134116125	rs12180	G	A	66	69	135	0	0	135	0	0
11	134122250	rs570113	C	T	4	6	10	0	0	10	0	0
11	134122296	rs12278812	A	C	8	5	13	0	0	13	0	0
11	134122461	rs12292140	C	T	5	7	12	0	0	12	0	0
11	134124124	rs1048761	C	A	7	0	7	0	0	7	0	0
11	134124818	rs1551183	T	C	3	3	6	0	0	6	0	0
11	134125351	rs3758925	C	A	3	3	6	0	0	6	0	0
11	134128313	rs11223738	G	T	12	4	16	0	0	16	0	0
11	134130189	rs12226809	C	T	48	26	74	0	1	75	0	0
11	134132559	rs561945	G	A	14	33	47	0	0	47	0	0
11	134246067	rs78173727	C	T	2	5	7	0	0	7	0	0
12	80008	.	T	C	9	0	9	0	0	9	0	0
12	80030	.	A	C	5	4	9	0	0	9	0	0
12	80118	.	A	G	13	5	18	0	0	18	0	0
12	80171	.	C	T	9	5	14	0	0	14	0	0
12	80311	.	A	G	3	7	10	0	0	10	0	0
12	80315	rs372123746	A	G	3	7	10	0	0	10	0	0
12	80562	.	T	C	12	8	20	0	0	20	0	0
12	80572	.	C	G	11	8	19	0	0	19	0	0
12	80657	.	T	G	4	7	11	0	0	11	0	0
12	80666	.	A	G	6	6	12	0	0	12	0	0
12	80674	.	T	C	6	6	12	0	0	12	0	0
12	80675	.	G	A	6	6	12	0	0	12	0	0
12	80697	.	T	C	12	4	16	0	0	16	0	0
12	80729	.	A	G	6	11	17	0	0	17	0	0
12	80779	.	G	A	5	6	11	0	0	11	0	0
12	80803	.	T	C	5	4	9	0	0	9	0	0
12	80813	.	G	A	1	5	6	0	0	6	0	0
12	80834	.	C	T	2	7	9	0	0	9	0	0
12	80838	rs377448472	G	C	2	7	9	0	0	9	0	0
12	81148	.	T	G	7	9	16	0	0	16	0	0
12	81183	.	G	A	8	6	14	0	1	15	0	0
12	82811	.	G	A	4	3	7	0	0	7	0	0
12	83011	rs370570891	T	C	6	3	9	0	0	9	0	0
12	83012	rs374646339	C	G	6	3	9	0	0	9	0	0
12	83263	.	C	T	9	0	9	0	0	9	0	0
12	83360	.	G	A	11	1	12	0	0	12	0	0
12	83508	.	T	G	13	2	15	0	0	15	0	0
12	83560	rs368663404	G	T	10	1	11	0	0	11	0	0
12	83757	.	G	C	19	4	23	0	0	23	0	0
12	83801	rs367621886	T	A	14	3	17	0	0	17	0	0
12	83802	rs371798112	G	A	14	3	17	0	0	17	0	0
12	83865	.	T	C	17	8	25	0	0	25	0	0
12	83979	.	T	C	20	4	24	0	0	24	0	0
12	84000	.	C	G	22	4	26	0	0	26	0	0
12	84096	.	C	G	28	13	41	0	0	41	0	0
12	84286	rs376266576	G	T	24	7	31	0	1	32	0	0
12	84433	.	C	A	10	3	13	0	1	14	0	0
12	84552	.	G	T	25	3	28	0	0	28	0	0
12	84568	.	G	A	27	3	30	0	0	30	0	0
12	84588	.	C	T	29	2	31	0	1	32	0	0
12	84590	.	A	G	29	3	32	0	0	32	0	0
12	84598	.	T	G	27	2	29	0	1	30	0	0
12	84650	.	G	A	35	5	40	0	0	40	0	0
12	84668	.	T	C	31	4	35	0	0	35	0	0
12	84674	.	T	C	29	4	33	0	0	33	0	0
12	84716	.	G	A	36	4	40	0	0	40	0	0
12	84755	.	T	A	31	4	35	0	1	36	0	0
12	84772	.	T	A	33	6	39	0	0	39	0	0
12	84856	.	G	T	19	6	25	0	1	26	0	0
12	84871	.	G	C	20	7	27	0	0	27	0	0
12	84963	.	T	C	19	4	23	0	2	25	0	0
12	85105	.	G	A	24	5	29	0	0	29	0	0
12	85570	.	C	A	6	3	9	0	0	9	0	0
12	86584	.	T	C	34	35	69	0	0	69	0	0
12	87688	.	C	T	251	145	396	0	0	396	0	0
12	90435	.	C	T	7	14	21	0	0	21	0	0
12	90953	.	C	G	792	399	1191	0	8	1200	1	0
12	91155	.	C	T	119	61	180	0	0	180	0	0
12	267710	rs11829493	G	A	7	1	8	0	0	8	0	0
12	267715	rs78861165	C	T	8	1	9	0	0	9	0	0
12	267764	rs56020448	T	C	6	0	6	0	0	6	0	0
12	267765	rs57097854	G	A	6	0	6	0	0	6	0	0
12	267792	rs12424229	A	G	6	0	6	0	0	6	0	0
12	268155	rs12423787	C	T	7	0	7	0	0	7	0	0
12	268354	rs7305337	C	T	8	0	8	0	0	8	0	0
12	269352	rs35153841	T	C	3	3	6	0	0	6	0	0
12	269951	rs11061683	T	C	6	0	6	0	0	6	0	0
12	272669	rs139400594	G	A	6	83	89	0	1	90	0	0
12	400623	.	T	C	2	4	6	0	0	6	0	0
12	483998	rs12299057	A	C	11	6	17	0	0	17	0	0
12	498276	.	G	A	26	26	52	0	0	52	0	0
12	551394	rs75822891	A	C	16	14	30	0	0	30	0	0
12	551647	rs12317361	C	G	22	16	38	0	0	38	0	0
12	861937	.	C	G	20	13	33	0	0	33	0	0
12	862641	rs3088353	T	G	13	10	23	0	0	23	0	0
12	936468	rs2158502	C	G	5	14	19	0	0	19	0	0
12	939302	rs10774466	A	G	35	40	75	0	0	75	0	0
12	987482	rs1012729	G	A	47	48	95	0	3	98	0	0
12	993930	rs7300444	C	T	42	63	105	0	0	105	0	0
12	998365	rs12828016	G	T	51	47	98	0	1	99	0	0
12	1018101	.	C	A	85	65	150	0	0	150	0	0
12	1021557	rs1051672	G	A	31	34	65	0	0	65	0	0
12	1021813	rs11226	G	A	20	23	43	0	0	43	0	0
12	1021912	rs11571478	C	A	9	4	13	0	2	15	0	0
12	1022115	rs7310449	G	A	24	25	49	0	1	50	0	0
12	1022184	rs7301931	T	C	24	30	54	0	0	54	0	0
12	1022241	.	C	T	22	0	22	0	1	23	0	0
12	1022452	rs1051669	C	T	27	27	54	0	0	54	0	0
12	1027362	rs4766370	A	T	5	5	10	0	0	10	0	0
12	1028526	rs7295574	C	T	2	6	8	0	0	8	0	0
12	1031454	rs7962050	G	A	4	2	6	0	0	6	0	0
12	1095064	rs61917252	C	T	2	4	6	0	0	6	0	0
12	1100637	rs10774481	G	C	1	6	7	0	0	7	0	0
12	1139195	rs7954121	C	T	14	11	25	0	1	26	0	0
12	1141906	rs61918696	A	G	3	5	8	0	0	8	0	0
12	1143232	rs77384814	T	C	7	5	12	0	0	12	0	0
12	1202358	rs7134570	T	C	4	2	6	0	0	6	0	0
12	1202464	rs56153967	C	A	2	4	6	0	0	6	0	0
12	1202601	rs34430461	T	A	5	15	20	0	0	20	0	0
12	1202629	rs35258043	G	T	6	16	22	0	0	22	0	0
12	1202692	rs34752786	A	C	5	9	14	0	0	14	0	0
12	1277097	rs12301153	C	T	1	5	6	0	0	6	0	0
12	1277176	rs2968876	C	T	0	13	13	0	0	13	0	0
12	1278475	rs2906103	A	G	1	10	11	0	0	11	0	0
12	1278676	rs7133548	A	G	1	16	17	0	0	17	0	0
12	1600231	rs11610729	T	C	10	3	13	0	0	13	0	0
12	1600767	rs61912169	T	G	4	13	17	0	0	17	0	0
12	1600978	rs1064125	A	T	19	13	32	0	1	33	0	0
12	1601561	rs3741977	G	A	13	20	33	0	1	34	0	0
12	1601722	rs10773946	C	G	18	12	30	0	0	30	0	0
12	1601896	rs3741976	C	T	11	13	24	0	1	25	0	0
12	1602602	rs1134345	A	G	4	7	11	0	0	11	0	0
12	1604490	rs1046473	A	C	31	50	81	0	1	82	0	0
12	1604516	rs1046475	T	C	26	46	72	0	0	72	0	0
12	1604651	rs739971	G	A	26	54	80	0	1	81	0	0
12	1836812	rs4140992	G	A	5	2	7	0	0	7	0	0
12	1841543	rs10848563	T	C	5	8	13	0	0	13	0	0
12	1895372	rs730032	G	A	42	57	99	0	0	99	0	0
12	1902354	rs73041886	T	C	2	5	7	0	0	7	0	0
12	1902358	rs73041888	C	T	2	5	7	0	0	7	0	0
12	2777768	rs6489375	A	G	26	49	75	0	0	75	0	0
12	2781304	rs7138079	G	A	54	77	131	0	0	131	0	0
12	2799987	rs55830098	C	T	37	13	50	0	0	50	0	0
12	2937901	rs2005828	G	A	4	2	6	0	0	6	0	0
12	2938306	rs188889434	A	G	11	3	14	0	0	14	0	0
12	2969628	rs10774068	A	G	4	9	13	0	0	13	0	0
12	3321090	rs61907326	G	A	266	0	266	0	22	288	0	0
12	3722364	rs748579	T	C	2	7	9	0	0	9	0	0
12	3749874	rs7138453	T	C	21	23	44	0	1	45	0	0
12	3788145	rs242018	C	T	11	3	14	0	0	14	0	0
12	3788222	rs242017	G	A	5	2	7	0	0	7	0	0
12	3788260	rs242016	G	A	5	1	6	0	0	6	0	0
12	3842189	rs10491974	C	T	4	9	13	0	0	13	0	0
12	3915655	rs74838024	T	A	9	4	13	0	0	13	0	0
12	3915718	rs116986228	T	G	2	7	9	0	0	9	0	0
12	3918300	rs758799	G	T	43	13	56	0	0	56	0	0
12	3918475	rs700481	G	A	22	6	28	0	0	28	0	0
12	3918872	rs1860617	C	A	14	9	23	0	1	24	0	0
12	3919669	rs12424076	T	C	10	5	15	0	2	17	0	0
12	3920052	rs11612988	G	C	9	5	14	0	0	14	0	0
12	3932066	rs7975273	T	A	4	2	6	0	0	6	0	0
12	3982475	rs12823996	C	T	5	7	12	0	0	12	0	0
12	4383036	rs1049606	C	T	72	144	216	0	1	217	0	0
12	4388914	rs4372527	A	G	3	4	7	0	0	7	0	0
12	4399050	rs3217860	A	G	8	40	48	0	0	48	0	0
12	4399087	rs3217862	T	G	8	36	44	0	0	44	0	0
12	4399970	rs3217869	G	A	3	35	38	0	0	38	0	0
12	4404158	rs3217896	G	A	4	3	7	0	0	7	0	0
12	4404376	rs3217898	A	G	6	2	8	0	0	8	0	0
12	4406281	rs12299509	A	G	3	7	10	0	0	10	0	0
12	4459533	rs12823289	C	T	4	3	7	0	0	7	0	0
12	4461485	rs7133330	G	A	23	9	32	0	0	32	0	0
12	4714557	rs758532	C	T	2	6	8	0	0	8	0	0
12	4760978	rs11063282	G	A	3	3	6	0	0	6	0	0
12	4761011	rs12811453	T	C	4	2	6	0	0	6	0	0
12	4761560	rs2191156	G	C	5	2	7	0	0	7	0	0
12	4763069	rs11063285	T	C	6	3	9	0	0	9	0	0
12	4764137	rs4147672	G	A	9	2	11	0	0	11	0	0
12	4764195	rs4147673	C	T	9	4	13	0	0	13	0	0
12	4765483	rs4147675	C	T	4	4	8	0	0	8	0	0
12	4766451	rs1990311	C	T	11	4	15	0	0	15	0	0
12	4766763	rs12309713	C	T	19	4	23	0	1	24	0	0
12	4778627	rs2240762	A	G	5	7	12	0	0	12	0	0
12	4792492	rs10849118	T	C	0	7	7	0	0	7	0	0
12	4793464	rs2267552	G	A	6	9	15	0	0	15	0	0
12	4793704	rs2240761	A	G	3	8	11	0	0	11	0	0
12	4794733	rs7978162	A	G	3	4	7	0	1	8	0	0
12	4795044	rs3835026	T	C	5	6	11	0	0	11	0	0
12	4795401	rs4147694	G	C	8	2	10	0	0	10	0	0
12	4797844	rs10083146	T	C	2	6	8	0	0	8	0	0
12	4798510	rs7136382	G	A	7	3	10	0	0	10	0	0
12	4799050	rs7311644	A	G	6	12	18	0	0	18	0	0
12	6602513	rs7966700	T	C	1	5	6	0	0	6	0	0
12	6640676	rs1043271	T	A	5	34	39	0	2	41	0	0
12	7069425	.	G	C	4	34	38	0	2	40	0	0
12	8073897	.	G	A	532	1	533	0	3	536	0	0
12	8073901	.	T	C	530	1	531	0	1	532	0	0
12	8077622	.	G	A	0	19	19	0	0	19	0	0
12	9447484	.	C	T	4	6	10	0	0	10	0	0
12	9447488	.	C	T	4	6	10	0	0	10	0	0
12	9447492	.	T	C	7	4	11	0	0	11	0	0
12	9451397	.	G	A	42	2	44	0	0	44	0	0
12	9451905	.	G	A	28	0	28	0	0	28	0	0
12	9583906	.	G	A	3	3	6	0	0	6	0	0
12	9585121	.	C	T	8	0	8	0	0	8	0	0
12	9585328	.	C	G	15	0	15	0	0	15	0	0
12	10864699	rs10772355	G	A	15	2	17	0	0	17	0	0
12	11317656	rs7960823	T	C	0	6	6	0	0	6	0	0
12	12977240	rs73285364	T	C	12	4	16	0	0	16	0	0
12	13004136	rs3825274	A	G	0	9	9	0	1	10	0	0
12	15100189	rs117236382	T	G	11	1	12	0	0	12	0	0
12	21590621	rs2058464	T	C	0	6	6	0	0	6	0	0
12	21669027	rs1366	A	G	56	8	64	0	1	65	0	0
12	21685108	rs1054637	A	C	7	0	7	0	0	7	0	0
12	22602796	rs2063573	A	G	81	8	89	0	0	89	0	0
12	24965636	rs10842409	T	C	3	17	20	0	1	21	0	0
12	24965640	rs11047651	T	C	19	3	22	0	0	22	0	0
12	24966845	rs2353483	C	T	12	1	13	0	0	13	0	0
12	24967063	rs2353481	T	C	10	2	12	0	0	12	0	0
12	24967470	rs6487419	T	C	8	1	9	0	0	9	0	0
12	24967608	rs7296995	T	C	3	3	6	0	0	6	0	0
12	25223350	rs12813199	T	A	6	18	24	0	0	24	0	0
12	25224674	rs10842457	T	G	3	11	14	0	0	14	0	0
12	25225175	rs10743533	A	G	3	9	12	0	1	13	0	0
12	25225179	rs12229039	G	A	10	5	15	0	0	15	0	0
12	25225313	rs10743534	A	G	1	15	16	0	0	16	0	0
12	25226090	rs4963601	C	T	19	4	23	0	0	23	0	0
12	25228900	rs2291801	T	C	6	10	16	0	0	16	0	0
12	25229033	rs12231804	T	C	13	1	14	0	1	15	0	0
12	25358650	rs12245	A	T	81	319	400	0	5	405	0	0
12	25358969	rs1137196	T	G	14	46	60	0	3	63	0	0
12	25359841	rs13096	T	C	15	51	66	0	0	66	0	0
12	25362552	rs712	A	C	13	50	63	0	3	67	1	0
12	25367669	rs4246229	G	A	2	5	7	0	0	7	0	0
12	25388711	rs12230737	G	A	15	0	15	0	0	15	0	0
12	25388897	rs34527025	T	G	5	4	9	0	0	9	0	0
12	26274410	rs76306214	T	C	2	18	20	0	0	20	0	0
12	26732987	rs2230376	G	A	15	3	18	0	0	18	0	0
12	27058165	rs137878349	A	C	14	0	14	0	0	14	0	0
12	27064232	rs3210635	C	T	31	145	176	0	0	176	0	0
12	27067978	rs7976064	G	A	0	10	10	0	0	10	0	0
12	27124739	rs1053724	C	A	9	5	14	0	1	15	0	0
12	27125371	rs149436455	C	T	2	17	19	0	0	19	0	0
12	27183304	rs12829295	G	A	6	32	38	0	0	38	0	0
12	27183456	rs73091125	G	A	24	3	27	0	0	27	0	0
12	27187462	rs73091136	G	C	6	5	11	0	0	11	0	0
12	27189393	rs138329233	A	G	20	8	28	0	0	28	0	0
12	27189520	rs113755376	C	T	28	4	32	0	0	32	0	0
12	27799008	rs73294067	T	G	4	10	14	0	0	14	0	0
12	29324418	rs4931157	C	T	2	38	40	0	2	42	0	0
12	29325012	rs10743646	A	C	6	51	57	0	3	60	0	0
12	29431168	rs7311081	T	C	2	10	12	0	0	12	0	0
12	29431365	rs7295212	C	T	1	7	8	0	0	8	0	0
12	29446146	rs4280037	A	T	4	5	9	0	0	9	0	0
12	30782535	rs75560605	T	C	30	44	74	0	0	74	0	0
12	30862653	rs7032	T	A	12	11	23	0	0	23	0	0
12	31226835	rs7953706	T	A	14	11	25	0	0	25	0	0
12	31242399	rs3881298	T	C	40	17	57	0	0	57	0	0
12	31242440	rs2075318	A	G	5	2	7	0	0	7	0	0
12	31242718	rs2005898	T	C	7	6	13	0	0	13	0	0
12	31242725	rs41313157	T	C	7	5	12	0	0	12	0	0
12	31247098	rs11051241	G	A	6	3	9	0	0	9	0	0
12	31249861	rs2075322	C	G	50	33	83	0	0	83	0	0
12	31251544	rs4931431	C	T	7	2	9	0	0	9	0	0
12	31253995	rs1046456	C	T	47	31	78	0	0	78	0	0
12	31254221	rs6487974	T	G	5	6	11	0	0	11	0	0
12	31254256	rs6487975	C	T	8	9	17	0	0	17	0	0
12	31254522	rs2553120	T	C	12	7	19	0	0	19	0	0
12	31254642	rs7952861	T	A	9	2	11	0	0	11	0	0
12	31254701	rs7966366	G	T	12	4	16	0	2	18	0	0
12	31254752	rs7966272	C	T	7	4	11	0	0	11	0	0
12	31254959	rs7966523	C	T	5	1	6	0	0	6	0	0
12	31256075	rs3825318	G	A	7	2	9	0	0	9	0	0
12	31256164	rs3825321	G	T	7	1	8	0	0	8	0	0
12	31256546	rs1046457	G	A	82	37	119	0	1	120	0	0
12	31256905	rs1046458	T	C	73	34	107	0	0	107	0	0
12	31256995	rs11545332	G	A	36	42	78	0	0	78	0	0
12	31257327	rs1046467	T	C	141	46	187	0	0	187	0	0
12	31257464	rs9750	G	A	149	68	217	0	0	217	0	0
12	31257695	rs11219	T	C	44	31	75	0	0	75	0	0
12	31441668	rs117816539	C	A	6	4	10	0	2	12	0	0
12	31454991	rs4931477	A	G	2	4	6	0	0	6	0	0
12	31648826	rs4930979	C	T	6	4	10	0	0	10	0	0
12	31703509	rs36164089	T	C	9	1	10	0	0	10	0	0
12	31703511	.	G	C	9	1	10	0	0	10	0	0
12	31703526	rs36181279	T	G	8	1	9	0	0	9	0	0
12	31704330	rs9738834	G	A	3	3	6	0	0	6	0	0
12	31740839	rs66597773	G	A	3	5	8	0	0	8	0	0
12	31868161	rs79989271	C	T	2	7	9	0	0	9	0	0
12	32114937	rs111992234	A	T	2	4	6	0	0	6	0	0
12	32117831	rs4931586	G	A	7	1	8	0	0	8	0	0
12	32118515	rs2084394	G	A	3	3	6	0	0	6	0	0
12	32134240	rs2388982	C	T	43	56	99	0	0	99	0	0
12	32134638	rs2166807	T	C	32	30	62	0	0	62	0	0
12	32138924	rs7302975	T	C	24	49	73	0	0	73	0	0
12	32139418	rs10771895	T	G	22	36	58	0	0	58	0	0
12	32140812	rs10743773	T	G	3	3	6	0	0	6	0	0
12	32141495	rs4931000	A	G	3	6	9	0	0	9	0	0
12	32143169	rs4931002	C	A	6	7	13	0	0	13	0	0
12	32143652	rs4931004	T	C	1	5	6	0	0	6	0	0
12	32144484	rs10771897	G	A	2	4	6	0	0	6	0	0
12	32145000	rs4931005	A	G	5	4	9	0	0	9	0	0
12	32261239	rs1144713	A	G	11	16	27	0	0	27	0	0
12	32261252	rs1144714	A	C	13	21	34	0	0	34	0	0
12	32261435	rs1144715	A	G	5	6	11	0	0	11	0	0
12	32735236	rs904582	C	T	5	4	9	0	0	9	0	0
12	32735720	rs41276670	T	A	1	5	6	0	0	6	0	0
12	32764184	rs10844253	G	A	6	6	12	0	0	12	0	0
12	32777362	rs11052110	G	A	5	12	17	0	0	17	0	0
12	32794600	rs10844268	A	C	5	6	11	0	0	11	0	0
12	32854366	rs10844308	A	C	55	51	106	0	0	106	0	0
12	32856415	rs7980752	C	T	3	3	6	0	0	6	0	0
12	32859757	rs10844309	C	T	15	8	23	0	0	23	0	0
12	32860302	rs2272238	G	A	56	60	116	0	1	117	0	0
12	32875406	rs10844318	A	G	68	62	130	0	0	130	0	0
12	32878475	rs10844323	A	G	6	5	11	0	1	12	0	0
12	32878563	rs12303426	T	C	13	2	15	0	1	16	0	0
12	32878800	rs28464612	A	C	6	1	7	0	0	7	0	0
12	32878934	rs61328017	A	G	4	2	6	0	0	6	0	0
12	32879346	rs10844324	C	A	10	3	13	0	0	13	0	0
12	32890161	rs7302970	C	T	9	9	18	0	0	18	0	0
12	32890343	rs6488080	G	A	2	4	6	0	0	6	0	0
12	32890551	rs58595773	T	C	3	4	7	0	0	7	0	0
12	32892678	rs7955582	C	T	32	27	59	0	2	61	0	0
12	32896365	rs1059422	G	C	112	138	250	0	2	252	0	0
12	32896366	rs3200103	A	T	101	138	239	0	2	241	0	0
12	32896615	rs1020670	C	G	76	75	151	0	1	152	0	0
12	32897088	rs1971911	A	T	99	95	194	0	3	197	0	0
12	32897437	rs1971910	T	C	107	80	187	0	2	189	0	0
12	32897557	rs11052213	G	T	123	94	217	0	2	219	0	0
12	32897586	rs10844336	G	A	145	121	266	0	6	272	0	0
12	32899495	rs11052214	C	T	2	5	7	0	0	7	0	0
12	32908237	rs11539445	C	A	12	12	24	0	0	24	0	0
12	32908518	rs11539444	G	A	8	6	14	0	0	14	0	0
12	34184679	rs12302890	G	T	6	6	12	0	1	13	0	0
12	34186008	rs10844779	G	A	4	6	10	0	1	11	0	0
12	34186733	rs1197569	A	T	4	2	6	0	0	6	0	0
12	42475888	rs3229	G	A	6	1	7	0	0	7	0	0
12	42476613	rs1064469	A	C	3	4	7	0	0	7	0	0
12	42481545	rs17801478	T	C	9	9	18	0	0	18	0	0
12	42554505	rs1059360	A	G	61	48	109	0	15	124	0	0
12	42606696	rs7316575	C	T	3	4	7	0	0	7	0	0
12	42617901	rs7975518	C	A	4	3	7	0	0	7	0	0
12	42618530	rs10880273	A	G	95	77	172	0	2	174	0	0
12	42619524	rs34289722	G	A	34	36	70	0	0	70	0	0
12	42620377	rs10785334	G	A	17	13	30	0	0	30	0	0
12	42620488	rs6582386	G	A	6	9	15	0	0	15	0	0
12	42620578	rs7956016	C	T	7	7	14	0	0	14	0	0
12	42621292	.	C	T	5	1	6	0	0	6	0	0
12	42621315	.	C	T	9	1	10	0	0	10	0	0
12	46292995	rs113452887	C	T	6	6	12	0	0	12	0	0
12	46298435	rs1650007	T	C	6	3	9	0	0	9	0	0
12	46298437	rs1650008	A	G	6	3	9	0	0	9	0	0
12	46313638	rs1366024	G	A	35	27	62	0	1	63	0	0
12	46321514	rs7315731	A	T	80	63	143	0	0	143	0	0
12	46322449	rs10880868	C	T	61	92	153	0	1	154	0	0
12	46336258	rs11183243	G	A	4	5	9	0	0	9	0	0
12	46347124	rs997307	G	A	3	3	6	0	0	6	0	0
12	46348076	rs7967208	A	G	4	5	9	0	0	9	0	0
12	46367903	rs10880879	T	C	2	8	10	0	0	10	0	0
12	46367939	rs11183268	G	T	13	7	20	0	0	20	0	0
12	46577235	rs9080	G	C	197	113	310	0	3	313	0	0
12	46584681	rs141234062	T	C	20	7	27	0	0	27	0	0
12	46588858	.	A	G	7	2	9	0	0	9	0	0
12	46662485	rs2242355	G	C	11	12	23	0	0	23	0	0
12	46755112	rs7961994	A	T	6	3	9	0	0	9	0	0
12	46757510	.	G	A	164	120	284	0	3	287	0	0
12	46758494	rs2307061	A	G	6	4	10	0	0	10	0	0
12	46759017	rs7968173	T	A	19	13	32	0	0	32	0	0
12	46759057	rs12307969	G	C	15	10	25	0	0	25	0	0
12	46759136	rs7968283	T	C	18	9	27	0	0	27	0	0
12	46759788	rs956910	A	G	20	14	34	0	0	34	0	0
12	46761127	rs10880959	G	A	23	13	36	0	0	36	0	0
12	46761324	rs1873793	C	T	16	17	33	0	1	34	0	0
12	46761829	rs10880960	T	G	11	18	29	0	0	29	0	0
12	46763686	rs2897968	G	A	6	6	12	0	1	13	0	0
12	47470997	rs34535517	G	T	13	10	23	0	0	23	0	0
12	47471439	rs2269828	G	A	10	10	20	0	0	20	0	0
12	47473937	rs77380695	C	T	5	2	7	0	0	7	0	0
12	48172778	rs73105899	C	G	5	4	9	0	0	9	0	0
12	48176102	rs11608804	G	A	39	15	54	0	0	54	0	0
12	48178194	rs7307046	A	G	16	8	24	0	0	24	0	0
12	48178513	rs7972177	A	G	25	24	49	0	0	49	0	0
12	48178604	rs11168236	T	C	15	14	29	0	0	29	0	0
12	48178977	rs3815135	G	C	21	14	35	0	0	35	0	0
12	48178997	rs3815134	C	T	16	12	28	0	2	30	0	0
12	48179048	rs3815132	C	T	17	7	24	0	2	26	0	0
12	48179402	rs3815131	C	T	6	7	13	0	0	13	0	0
12	48179463	rs3815130	C	T	5	2	7	0	0	7	0	0
12	48180321	rs80095092	G	C	19	11	30	0	0	30	0	0
12	48180508	rs2240108	C	T	3	8	11	0	0	11	0	0
12	48181374	rs1557848	A	G	2	7	9	0	0	9	0	0
12	48238068	rs3847987	C	A	5	8	13	0	0	13	0	0
12	48238757	rs731236	A	G	9	10	19	0	0	19	0	0
12	48264776	rs12721395	T	A	4	2	6	0	0	6	0	0
12	48264777	rs59707231	A	T	4	2	6	0	0	6	0	0
12	48265006	rs3819545	A	G	4	4	8	0	0	8	0	0
12	48265538	rs12721396	G	A	6	4	10	0	0	10	0	0
12	48272895	rs2228570	A	G	3	5	8	0	0	8	0	0
12	48359676	rs35000511	G	T	12	13	25	0	0	25	0	0
12	48362412	rs6823	G	C	32	34	66	0	0	66	0	0
12	48367054	rs41272777	G	A	6	3	9	0	0	9	0	0
12	48368541	rs12721427	C	T	3	3	6	0	0	6	0	0
12	48449224	rs75064228	G	C	3	4	7	0	0	7	0	0
12	48492922	rs10875741	A	C	0	12	12	0	0	12	0	0
12	48526659	rs2228501	G	A	8	4	12	0	0	12	0	0
12	48527186	rs1049392	C	T	5	7	12	0	0	12	0	0
12	48529549	rs10219623	C	T	4	2	6	0	0	6	0	0
12	48542266	rs80343014	G	A	46	47	93	0	0	93	0	0
12	48542347	rs12297470	C	T	53	51	104	0	4	108	0	0
12	48542415	rs12310813	A	G	34	41	75	0	1	76	0	0
12	48543584	rs3936179	G	C	37	38	75	0	0	75	0	0
12	48545245	rs56288528	A	G	6	4	10	0	0	10	0	0
12	48548592	rs148662008	C	T	2	4	6	0	0	6	0	0
12	48734275	rs751315	C	T	21	15	36	0	0	36	0	0
12	48734509	rs751316	G	A	17	17	34	0	0	34	0	0
12	48735114	rs56383074	G	T	5	11	16	0	0	16	0	0
12	48735309	rs34157519	T	A	9	6	15	0	0	15	0	0
12	48736303	rs2732480	C	A	2	5	7	0	0	7	0	0
12	49222217	rs954	T	C	14	12	26	0	0	26	0	0
12	49230035	rs1057908	T	G	23	27	50	0	0	50	0	0
12	49389476	rs3741619	G	A	5	1	6	0	0	6	0	0
12	49399132	rs1126930	G	C	36	37	73	0	0	73	0	0
12	49463452	rs371926422	C	A	6	10	16	0	0	16	0	0
12	49723963	rs4243545	A	G	18	11	29	0	0	29	0	0
12	49724299	.	G	A	11	13	24	0	0	24	0	0
12	49885157	rs7976165	C	T	6	2	8	0	2	10	0	0
12	49920860	rs139096986	A	G	37	27	64	0	0	64	0	0
12	49951377	rs59261129	C	T	3	4	7	0	0	7	0	0
12	49952394	rs13906	C	T	146	131	277	0	2	279	0	0
12	49952668	rs2303305	G	A	114	116	230	0	2	232	0	0
12	49958911	rs73305008	G	A	14	10	24	0	0	24	0	0
12	49960551	rs13066	C	A	31	31	62	0	0	62	0	0
12	50093938	rs11169111	G	C	4	6	10	0	0	10	0	0
12	50093941	rs11169112	C	T	4	6	10	0	0	10	0	0
12	50093947	rs11169113	A	G	4	4	8	0	0	8	0	0
12	50094437	rs9804971	A	G	5	1	6	0	0	6	0	0
12	50137180	rs139089295	G	T	5	5	10	0	0	10	0	0
12	50137281	rs897056	T	A	24	43	67	0	1	68	0	0
12	50138465	rs56737983	T	G	5	6	11	0	0	11	0	0
12	50140682	rs12296586	A	G	4	5	9	0	0	9	0	0
12	50141164	rs9805063	T	G	5	8	13	0	1	14	0	0
12	50152193	rs4563	G	A	270	208	478	0	2	480	0	0
12	50156640	rs10506287	T	C	4	10	14	0	0	14	0	0
12	50157071	rs7688	T	C	216	227	443	0	5	448	0	0
12	50158544	rs1049986	A	G	154	88	242	0	3	245	0	0
12	50505969	rs1389280	G	A	4	6	10	0	0	10	0	0
12	50821551	rs146142861	G	T	20	14	34	0	0	34	0	0
12	51139279	rs4768914	A	G	7	10	17	0	0	17	0	0
12	51139692	rs35845404	T	G	28	24	52	0	0	52	0	0
12	51139803	rs3742063	C	A	28	38	66	0	1	67	0	0
12	51139892	rs3742064	C	T	28	23	51	0	1	52	0	0
12	51373742	rs706802	C	T	17	34	51	0	0	51	0	0
12	51374748	rs829022	G	T	12	7	19	0	0	19	0	0
12	51380232	rs149411	A	G	23	15	38	0	0	38	0	0
12	51380835	rs11169654	C	T	13	14	27	0	0	27	0	0
12	51381750	rs2285230	T	C	6	3	9	0	0	9	0	0
12	51386066	rs1048230	A	G	24	19	43	0	0	43	0	0
12	51398511	rs41439649	G	A	6	0	6	0	0	6	0	0
12	51399050	rs224589	T	G	2	4	6	0	0	6	0	0
12	51442944	rs12379	G	A	92	103	195	0	0	195	0	0
12	51443469	rs6580782	A	G	5	5	10	0	1	11	0	0
12	51444039	rs12427345	C	G	6	0	6	0	0	6	0	0
12	51446936	rs11831946	A	C	3	7	10	0	0	10	0	0
12	51447054	rs1486014	C	G	7	6	13	0	0	13	0	0
12	51447506	rs7971308	A	G	8	5	13	0	0	13	0	0
12	51448555	rs10876128	T	C	5	8	13	0	0	13	0	0
12	51448918	rs7978723	C	A	4	6	10	0	0	10	0	0
12	51449122	rs10876129	A	G	10	6	16	0	0	16	0	0
12	51452875	rs10876130	A	G	11	5	16	0	1	17	0	0
12	51453637	rs15756	G	T	308	222	530	0	2	532	0	0
12	51453682	rs10275	G	A	318	196	514	0	1	515	0	0
12	51487882	rs10099	T	C	14	15	29	0	0	29	0	0
12	51488422	rs12820966	A	C	28	13	41	0	0	41	0	0
12	51551772	rs186372986	T	C	6	3	9	0	0	9	0	0
12	51581184	rs115353814	C	T	11	6	17	0	0	17	0	0
12	51581740	rs10876151	C	A	10	2	12	0	0	12	0	0
12	51583506	rs3490	G	A	7	8	15	0	0	15	0	0
12	51595505	rs11169761	G	A	2	4	6	0	0	6	0	0
12	51595644	rs201488462	T	G	4	3	7	0	3	10	0	0
12	51595737	rs7975737	A	G	5	6	11	0	1	12	0	0
12	51595928	rs7976292	G	A	0	11	11	0	1	12	0	0
12	51642921	.	G	A	7	1	8	0	0	8	0	0
12	51717246	rs3843650	G	C	4	2	6	0	0	6	0	0
12	51745834	rs10516	C	T	14	19	33	0	0	33	0	0
12	51746264	rs6580826	G	A	7	6	13	0	0	13	0	0
12	51746694	rs59535902	T	G	4	8	12	0	0	12	0	0
12	52379238	rs34437092	A	G	3	4	7	0	1	8	0	0
12	52379854	rs2220805	A	G	4	6	10	0	0	10	0	0
12	52381026	rs2252518	C	A	13	7	20	0	0	20	0	0
12	52381230	rs2252526	G	T	10	7	17	0	0	17	0	0
12	52388891	rs2854464	A	G	3	12	15	0	0	15	0	0
12	52402635	rs55863539	A	G	10	10	20	0	0	20	0	0
12	52404618	rs1298913	T	G	3	11	14	0	0	14	0	0
12	52407063	rs2701133	G	A	16	4	20	0	1	21	0	0
12	52408422	rs1283166	A	G	25	17	42	0	0	42	0	0
12	52445872	rs2087978	C	T	8	11	19	0	0	19	0	0
12	52447752	rs2603756	T	C	7	7	14	0	0	14	0	0
12	52450046	rs12812582	C	T	12	12	24	0	1	25	0	0
12	52452220	rs1882116	C	T	20	16	36	0	0	36	0	0
12	52452357	rs1882121	G	A	7	6	13	0	0	13	0	0
12	52452757	rs45496793	C	T	252	293	545	0	3	548	0	0
12	52463835	rs11538191	C	A	18	8	26	0	1	27	0	0
12	52466182	rs10876230	C	T	3	4	7	0	0	7	0	0
12	52466205	rs10876231	G	A	3	4	7	0	0	7	0	0
12	52471159	rs11521	C	T	92	66	158	0	1	159	0	0
12	53294381	rs8608	T	C	103	60	163	0	4	167	0	0
12	53416119	rs7975725	T	C	5	6	11	0	0	11	0	0
12	53416251	rs10506315	C	T	12	5	17	0	2	19	0	0
12	53418232	rs2037416	C	T	5	3	8	0	0	8	0	0
12	53418294	rs2037418	A	G	4	2	6	0	0	6	0	0
12	53418730	rs880002	G	A	4	4	8	0	0	8	0	0
12	53421107	rs4919717	G	A	4	2	6	0	0	6	0	0
12	53421507	rs4919697	G	A	4	3	7	0	0	7	0	0
12	53431837	rs1402395	C	T	8	10	18	0	0	19	1	0
12	53431884	rs7953948	G	A	8	13	21	0	0	21	0	0
12	53432076	rs77749367	T	G	13	16	29	0	0	29	0	0
12	53432088	rs7968918	T	C	15	11	26	0	0	26	0	0
12	53432107	rs55927246	A	G	20	14	34	0	0	34	0	0
12	53432297	rs77889282	G	A	19	11	30	0	0	30	0	0
12	53432936	rs1548203	A	G	26	36	62	0	0	62	0	0
12	53433150	.	C	T	10	10	20	0	0	20	0	0
12	53433486	rs8916	C	T	826	537	1363	0	11	1375	1	0
12	53433709	rs1356993	C	G	19	15	34	0	0	34	0	0
12	53433788	rs1356994	A	G	20	14	34	0	0	34	0	0
12	53434105	rs4825	C	A	596	435	1031	0	5	1036	0	0
12	53434995	rs1961466	C	G	969	690	1659	0	4	1663	0	0
12	53435762	rs11170384	T	C	1063	1235	2298	0	6	2304	0	0
12	53457618	rs12816417	C	T	4	4	8	0	0	8	0	0
12	53457704	rs34922637	C	A	4	8	12	0	0	12	0	0
12	53457893	rs14369	A	G	3	4	7	0	0	7	0	0
12	53458589	rs1048565	C	T	20	28	48	0	1	49	0	0
12	53459002	rs2293060	T	G	22	18	40	0	0	40	0	0
12	53459101	rs2293059	G	A	12	19	31	0	0	31	0	0
12	53573030	rs148831100	C	T	5	4	9	0	0	9	0	0
12	53581376	rs3101059	C	T	19	11	30	0	0	30	0	0
12	53647373	rs10876422	T	C	50	52	102	0	1	103	0	0
12	53662624	rs6580942	C	A	8	4	12	0	0	12	0	0
12	53670545	rs1318648	C	A	13	8	21	0	0	21	0	0
12	53682326	rs1110720	G	A	20	19	39	0	0	39	0	0
12	53682457	rs56358776	G	A	28	10	38	0	0	38	0	0
12	53682986	rs3214023	C	T	18	10	28	0	1	29	0	0
12	53687387	rs1056692	A	G	8	9	17	0	0	17	0	0
12	53693403	rs1465073	C	G	10	6	16	0	0	16	0	0
12	53808159	.	C	T	67	68	135	0	1	136	0	0
12	53842472	rs2683514	T	C	2	5	7	0	0	7	0	0
12	53846600	rs570873040	C	A	25	12	37	0	3	40	0	0
12	53847473	rs10783580	G	A	99	86	185	0	0	185	0	0
12	53860781	rs12831185	A	G	3	6	9	0	1	10	0	0
12	53864855	rs11170562	A	G	5	5	10	0	0	10	0	0
12	53866619	rs784563	G	T	8	5	13	0	0	13	0	0
12	53867312	rs2249381	G	A	4	8	12	0	0	12	0	0
12	53867722	rs10876460	A	G	5	5	10	0	0	10	0	0
12	53872450	rs729037	T	C	5	4	9	0	0	9	0	0
12	53873844	rs1049193	G	C	110	100	210	0	6	216	0	0
12	53880653	rs7958457	C	T	6	7	13	0	0	13	0	0
12	53881874	rs1716966	C	T	12	27	39	0	0	39	0	0
12	53882216	rs34614022	C	T	16	12	28	0	0	28	0	0
12	53894465	rs784567	G	A	2	4	6	0	0	6	0	0
12	54035448	rs12817180	A	G	7	2	9	0	0	9	0	0
12	54059739	rs10876478	G	C	12	8	20	0	0	20	0	0
12	54059819	rs10876479	C	T	8	8	16	0	0	16	0	0
12	54060234	rs11170638	G	A	8	6	14	0	0	14	0	0
12	54064888	rs4759279	C	T	3	6	9	0	0	9	0	0
12	54064958	rs4759280	C	A	2	5	7	0	0	7	0	0
12	54107509	.	T	C	27	20	47	0	0	47	0	0
12	54109659	rs3741659	C	T	24	19	43	0	0	43	0	0
12	54109733	rs3741658	A	G	16	11	27	0	0	27	0	0
12	54626752	rs1056010	T	C	25	32	57	0	1	58	0	0
12	54627090	rs2272470	C	T	29	30	59	0	1	60	0	0
12	54627857	rs60127327	A	G	13	7	20	0	0	20	0	0
12	54630517	rs4759348	C	T	9	11	20	0	0	20	0	0
12	54634666	rs12425616	T	C	6	5	11	0	1	12	0	0
12	54651471	rs1140681	A	G	17	19	36	0	1	37	0	0
12	54667285	rs4759075	T	C	5	3	8	0	0	8	0	0
12	54677980	rs7967622	C	T	18	11	29	0	1	30	0	0
12	54742413	rs147566805	C	A	9	9	18	0	0	18	0	0
12	54755802	rs11170882	T	A	3	10	13	0	0	13	0	0
12	54764962	rs2244933	G	T	48	52	100	0	2	102	0	0
12	54765785	rs7960765	G	A	14	16	30	0	0	30	0	0
12	54766119	rs2700151	C	A	28	18	46	0	0	46	0	0
12	54766230	rs2706247	T	C	32	19	51	0	1	52	0	0
12	54767443	rs2700152	A	G	10	19	29	0	1	30	0	0
12	54767613	rs2706258	C	T	12	16	28	0	2	30	0	0
12	54767812	rs2887875	G	A	124	133	257	0	0	257	0	0
12	54769864	rs2700153	A	C	9	10	19	0	0	19	0	0
12	54770374	rs12297727	G	A	15	20	35	0	0	35	0	0
12	54778823	rs3825192	G	A	3	3	6	0	0	6	0	0
12	54905815	rs2458409	C	G	82	68	150	0	0	150	0	0
12	54961644	rs10161382	A	T	3	3	6	0	0	6	0	0
12	54965159	rs117734063	C	T	5	1	6	0	0	6	0	0
12	54967662	.	T	A	35	3	38	0	0	38	0	0
12	54970236	rs11170976	G	A	13	13	26	0	0	26	0	0
12	54972194	rs11170978	C	T	161	139	300	0	0	300	0	0
12	55807588	.	C	T	14	0	14	0	0	14	0	0
12	56110364	rs78784079	G	A	29	28	57	0	0	57	0	0
12	56335107	rs1136082	A	G	60	38	98	0	0	98	0	0
12	56364321	rs2069408	A	G	4	4	8	0	0	8	0	0
12	56375137	rs773110	C	G	2	7	9	0	0	9	0	0
12	56375740	rs773111	C	A	9	4	13	0	0	13	0	0
12	56375881	rs773112	C	T	7	2	9	0	0	9	0	0
12	56384687	rs705698	T	C	3	5	8	0	0	8	0	0
12	56384804	rs705699	G	A	2	4	6	0	1	7	0	0
12	56386294	rs11611579	C	T	8	21	29	0	0	29	0	0
12	56393337	rs1081975	C	G	14	3	17	0	0	17	0	0
12	56435929	rs1131017	C	G	18	9	27	0	0	27	0	0
12	56507452	.	T	G	275	221	496	0	3	499	0	0
12	56634260	.	A	T	10	2	12	0	5	17	0	0
12	56634267	.	A	T	10	3	13	0	5	18	0	0
12	56666514	rs79563232	G	A	277	245	522	0	2	524	0	0
12	56717594	rs144721765	G	A	33	38	71	0	0	71	0	0
12	56751609	.	C	T	4	2	6	0	0	6	0	0
12	56814653	rs2291739	G	A	30	31	61	0	0	61	0	0
12	56814656	rs61376834	A	G	30	28	58	0	0	58	0	0
12	56956213	rs3759091	T	C	15	14	29	0	0	29	0	0
12	56961932	rs7305370	C	T	8	16	24	0	0	24	0	0
12	56983050	.	C	T	32	4	36	0	0	36	0	0
12	57035936	rs150739320	C	T	3	5	8	0	1	9	0	0
12	57394635	rs3741578	G	C	30	33	63	0	0	63	0	0
12	57460682	rs841828	T	C	3	3	6	0	0	6	0	0
12	57486647	rs324019	A	G	7	2	9	0	0	9	0	0
12	57489648	rs4559	C	T	54	24	78	0	1	79	0	0
12	57489709	rs1059513	T	C	76	51	127	0	1	128	0	0
12	57490100	rs324015	T	C	60	78	138	0	1	139	0	0
12	57492996	rs841718	G	A	15	17	32	0	0	32	0	0
12	57493727	rs3024971	T	G	12	10	22	0	1	23	0	0
12	57637593	rs3204635	G	A	29	23	52	0	0	52	0	0
12	57649840	rs4075325	C	T	40	40	80	0	0	80	0	0
12	57822616	rs12230111	G	A	3	3	6	0	0	6	0	0
12	57829129	rs560048	C	T	5	4	9	0	0	9	0	0
12	57869447	rs2277318	T	C	12	15	27	0	0	27	0	0
12	57869476	rs2277317	G	A	15	24	39	0	1	40	0	0
12	57869486	rs2277316	A	G	17	25	42	0	0	42	0	0
12	57869582	rs2277315	T	C	21	21	42	0	1	43	0	0
12	57870155	rs11544238	A	C	72	72	144	0	5	149	0	0
12	57934124	rs75567496	G	A	19	18	37	0	0	37	0	0
12	58090722	rs7309600	A	G	6	6	12	0	0	12	0	0
12	58092554	rs7979246	A	G	3	3	6	0	0	6	0	0
12	58093735	rs10783842	G	A	4	2	6	0	0	6	0	0
12	58094274	rs75231257	G	A	4	3	7	0	0	7	0	0
12	58103423	rs76809208	G	C	5	2	7	0	0	7	0	0
12	58112437	rs2239891	C	A	16	20	36	0	0	36	0	0
12	58118847	rs4760169	T	C	16	9	25	0	0	25	0	0
12	58120276	rs12318065	C	A	19	14	33	0	0	33	0	0
12	58329820	rs2372309	G	A	40	9	49	0	2	51	0	0
12	58335626	rs3751325	A	T	19	12	31	0	0	31	0	0
12	58350631	rs10122	C	T	24	12	36	0	0	36	0	0
12	60007747	rs4304824	C	T	5	5	10	0	0	10	0	0
12	62698716	rs1389134	G	A	4	6	10	0	0	10	0	0
12	62724098	rs2131436	A	G	4	5	9	0	0	9	0	0
12	62724233	rs2131437	A	G	9	4	13	0	0	13	0	0
12	62724699	rs7970898	T	C	6	8	14	0	1	15	0	0
12	62724863	rs7956101	C	G	6	5	11	0	1	12	0	0
12	62726401	rs10784291	G	T	3	3	6	0	0	6	0	0
12	62778065	rs2044846	A	G	64	55	119	0	2	121	0	0
12	62781946	rs11174455	T	C	6	2	8	0	0	8	0	0
12	62785524	rs1532435	T	C	3	6	9	0	0	9	0	0
12	62959137	rs11174549	A	G	9	10	19	0	0	19	0	0
12	62977227	rs10459257	A	G	1	5	6	0	0	6	0	0
12	62989110	rs10877884	A	C	6	3	9	0	0	9	0	0
12	63038698	rs3825305	C	A	9	1	10	0	0	10	0	0
12	63359168	rs699596	G	A	104	0	104	0	9	113	0	0
12	63359409	rs699597	C	A	102	0	102	0	3	105	0	0
12	63961390	rs12582849	A	G	2	6	8	0	0	8	0	0
12	64863191	rs79136929	G	A	2	5	7	0	0	7	0	0
12	64894527	rs118156905	C	T	2	4	6	0	0	6	0	0
12	66532100	rs4296075	A	G	4	3	7	0	0	7	0	0
12	66542153	rs12582384	T	G	5	1	6	0	0	6	0	0
12	66546100	rs8793	A	G	27	32	59	0	0	59	0	0
12	66555533	rs12578801	C	T	5	3	8	0	0	8	0	0
12	66555618	rs34750837	C	A	3	6	9	0	0	9	0	0
12	66557216	rs12814606	G	A	5	3	8	0	0	8	0	0
12	66557372	rs12814331	A	T	6	4	10	0	0	10	0	0
12	66559436	rs1168744	C	T	2	5	7	0	0	7	0	0
12	66560879	rs1185888	G	A	13	7	20	0	0	20	0	0
12	66562755	rs17245364	T	C	5	2	7	0	0	7	0	0
12	66563206	rs737614	G	A	4	4	8	0	0	8	0	0
12	66585129	rs1625441	C	G	8	8	16	0	0	16	0	0
12	66585738	rs2701654	T	A	8	8	16	0	0	16	0	0
12	66585840	rs2576183	C	T	7	11	18	0	0	18	0	0
12	66586143	rs56156535	T	C	6	5	11	0	0	11	0	0
12	66586948	rs4762087	C	T	8	4	12	0	1	13	0	0
12	66591582	rs4762088	G	C	14	13	27	0	0	27	0	0
12	66592025	rs12823414	C	T	3	4	7	0	0	7	0	0
12	66592242	rs17767286	C	A	5	8	13	0	1	14	0	0
12	66594676	rs1185253	T	C	6	2	8	0	0	8	0	0
12	66594760	rs1732875	T	G	7	4	11	0	0	11	0	0
12	66597701	rs1882200	C	T	7	5	12	0	0	12	0	0
12	66598568	.	A	G	7	2	9	0	0	9	0	0
12	66598570	.	A	G	8	1	9	0	0	9	0	0
12	66598687	rs2289134	T	C	3	4	7	0	0	7	0	0
12	66600751	rs1152884	G	A	1	5	6	0	0	6	0	0
12	66605006	rs2293657	A	T	7	2	9	0	0	9	0	0
12	66605228	rs1152888	A	G	99	102	201	0	4	205	0	0
12	66606228	rs1821777	C	T	7	10	17	0	0	17	0	0
12	66631916	rs3782347	A	G	7	12	19	0	0	19	0	0
12	66632067	rs117029533	G	A	2	6	8	0	0	8	0	0
12	66632268	rs55913894	A	G	2	9	11	0	0	11	0	0
12	66633020	rs1152911	C	T	5	4	9	0	0	9	0	0
12	66633685	rs11176095	T	C	11	5	16	0	0	16	0	0
12	66634505	rs1152914	C	T	4	9	13	0	0	13	0	0
12	66636302	rs1152918	T	C	8	12	20	0	0	20	0	0
12	66637485	rs3782348	C	T	14	19	33	0	0	33	0	0
12	66643170	rs77111803	C	T	33	15	48	0	1	49	0	0
12	66647206	rs10878395	T	C	19	12	31	0	0	31	0	0
12	66648328	rs11541076	A	T	4	3	7	0	0	7	0	0
12	66696410	rs3741604	C	T	4	5	9	0	0	9	0	0
12	66698144	rs2118138	A	G	2	4	6	0	0	6	0	0
12	66698895	rs4430553	T	C	3	11	14	0	0	14	0	0
12	66704697	rs11176139	G	A	2	5	7	0	0	7	0	0
12	66706748	rs7978354	T	G	1	8	9	0	0	9	0	0
12	66716844	rs3741603	G	A	4	8	12	0	1	14	1	0
12	66717692	rs7969887	T	G	2	5	7	0	0	7	0	0
12	66717716	rs7957877	C	T	4	5	9	0	0	9	0	0
12	66719052	rs11176144	C	T	11	11	22	0	0	22	0	0
12	66725160	rs1185244	C	T	13	9	22	0	0	22	0	0
12	66725202	rs1168312	C	T	15	10	25	0	1	26	0	0
12	66731864	rs1168329	C	A	7	2	9	0	0	9	0	0
12	66732057	rs1183274	C	G	5	3	8	0	0	8	0	0
12	66732190	rs1179889	G	A	3	6	9	0	0	9	0	0
12	66732273	rs2951656	T	G	5	4	9	0	1	10	0	0
12	66735421	rs1183272	T	C	4	2	6	0	0	6	0	0
12	66736467	rs1168300	C	A	7	1	8	0	0	8	0	0
12	66739539	rs1168307	A	G	25	3	28	0	0	28	0	0
12	67663208	rs17103637	C	T	3	5	8	0	0	8	0	0
12	67671666	rs1252405	G	T	8	13	21	0	0	21	0	0
12	67686932	rs11836317	G	A	4	4	8	0	0	8	0	0
12	67688413	rs1392587	A	G	5	4	9	0	0	9	0	0
12	67699536	rs17781675	G	A	61	69	130	0	1	131	0	0
12	67703909	rs116416219	C	A	8	9	17	0	0	17	0	0
12	67706466	rs1060350	G	A	310	241	551	0	3	554	0	0
12	67707441	rs1137465	A	G	15	10	25	0	0	25	0	0
12	67712978	rs17103688	A	G	7	6	13	0	0	13	0	0
12	67713322	rs17103691	A	G	14	9	23	0	0	23	0	0
12	67745664	rs11176695	C	G	2	5	7	0	0	7	0	0
12	68688939	rs7958232	C	T	8	5	13	0	0	13	0	0
12	68708761	rs2306393	C	T	30	16	46	0	0	46	0	0
12	68709892	rs17224810	C	T	26	22	48	0	0	48	0	0
12	68711301	rs17224817	T	C	2	5	7	0	0	7	0	0
12	68719216	rs2870812	G	A	3	3	6	0	0	6	0	0
12	68719792	rs7296181	C	A	7	4	11	0	0	11	0	0
12	68720627	rs962976	G	A	5	11	16	0	0	16	0	0
12	68721040	rs962977	A	G	7	6	13	0	0	13	0	0
12	68724951	rs3741808	G	T	4	5	9	0	0	9	0	0
12	69014230	rs112127843	T	G	3	4	7	0	0	7	0	0
12	69017409	rs2956528	G	A	7	10	17	0	0	17	0	0
12	69017618	rs7309715	C	T	13	10	23	0	0	23	0	0
12	69031631	rs78475071	C	T	3	4	7	0	0	7	0	0
12	69034890	rs79406475	G	A	6	5	11	0	0	11	0	0
12	69036611	rs3814238	C	A	14	15	29	0	0	29	0	0
12	69036809	rs3814237	C	G	12	3	15	0	0	15	0	0
12	69038072	rs41460144	T	A	5	5	10	0	0	10	0	0
12	69038759	rs734661	G	A	4	7	11	0	0	11	0	0
12	69042690	rs3213921	T	G	9	14	23	0	0	23	0	0
12	69133950	rs7962663	G	A	4	2	6	0	0	6	0	0
12	69162243	rs12321570	T	C	13	0	13	0	0	13	0	0
12	69162438	rs12301074	A	G	6	0	6	0	0	6	0	0
12	69169316	rs73334654	G	A	3	4	7	0	0	7	0	0
12	69202164	rs937283	A	G	19	16	35	0	0	35	0	0
12	69214691	rs1201644	G	A	4	2	6	0	0	6	0	0
12	69216798	rs3730558	A	G	5	2	7	0	0	7	0	0
12	69235406	rs1690916	G	A	35	54	89	0	1	90	0	0
12	69249087	rs13486	A	G	5	7	12	0	0	12	0	0
12	69633379	rs2305642	A	G	2	7	9	0	0	9	0	0
12	69636314	rs1350166	G	T	5	5	10	0	0	10	0	0
12	69638298	rs10878945	T	C	8	5	13	0	0	13	0	0
12	69638610	rs595348	T	C	9	6	15	0	0	15	0	0
12	69639238	rs1026331	T	G	2	5	7	0	0	7	0	0
12	69642315	rs10878946	C	T	47	32	79	0	0	79	0	0
12	69646914	rs2305641	G	A	60	62	122	0	0	122	0	0
12	69655167	rs7969559	A	G	5	2	7	0	1	8	0	0
12	69655752	.	A	G	5	7	12	0	0	12	0	0
12	69657145	rs317646	G	A	5	1	6	0	0	6	0	0
12	69658330	rs7135092	T	C	8	1	9	0	0	9	0	0
12	69667075	rs1463335	T	A	41	28	69	0	0	69	0	0
12	69667123	rs73141990	A	G	22	32	54	0	0	54	0	0
12	69742967	rs777263	C	G	3	3	6	0	0	6	0	0
12	69747834	rs1384	C	T	1852	695	2547	0	27	2574	0	0
12	69753595	rs622656	C	T	25	20	45	0	0	45	0	0
12	69773411	rs11177632	G	A	5	1	6	0	0	6	0	0
12	69774377	rs7133487	G	A	15	20	35	0	1	36	0	0
12	69774563	rs501212	A	G	15	19	34	0	1	35	0	0
12	69774618	rs7304714	T	G	13	13	26	0	0	27	1	0
12	69774877	rs1670737	G	A	15	11	26	0	0	26	0	0
12	69775103	rs2870902	T	C	10	12	22	0	0	22	0	0
12	69775118	rs2870901	T	C	12	10	22	0	0	22	0	0
12	69775972	rs56054057	C	T	28	21	49	0	1	50	0	0
12	69776461	rs4761237	C	G	34	27	61	0	0	61	0	0
12	69776800	rs2603089	A	G	24	23	47	0	0	47	0	0
12	69776886	rs4761239	T	A	23	18	41	0	2	43	0	0
12	69777188	rs2603090	G	A	40	28	68	0	0	68	0	0
12	69880170	rs221087	A	G	2	4	6	0	0	6	0	0
12	69956208	rs576942	G	A	4	4	8	0	0	8	0	0
12	69966459	rs800648	C	T	16	24	40	0	0	40	0	0
12	69970051	rs143557575	A	G	31	21	52	0	0	52	0	0
12	69971267	rs542403	A	G	13	12	25	0	0	25	0	0
12	69971474	rs2588440	G	A	17	13	30	0	0	30	0	0
12	69971713	rs710755	C	T	40	43	83	0	2	85	0	0
12	69972227	rs512283	A	T	32	22	54	0	0	54	0	0
12	69973007	rs556678	C	T	23	10	33	0	0	33	0	0
12	69973204	rs503881	A	G	11	7	18	0	1	19	0	0
12	69973392	rs3201	T	C	29	39	68	0	0	68	0	0
12	69979517	rs2601006	C	T	5	4	9	0	0	9	0	0
12	69982129	rs710777	G	C	18	28	46	0	0	46	0	0
12	69982271	rs532650	A	G	18	9	27	0	0	27	0	0
12	69992301	rs17225328	A	G	34	41	75	0	3	78	0	0
12	69992465	rs710764	A	G	18	24	42	0	1	43	0	0
12	69993137	rs61929303	G	A	12	15	27	0	0	27	0	0
12	69993288	rs35641	C	T	8	12	20	0	2	22	0	0
12	69993501	rs35642	A	G	14	22	36	0	0	36	0	0
12	70636829	rs78129473	G	A	4	4	8	0	0	8	0	0
12	70637787	rs78943832	A	G	4	2	6	0	0	6	0	0
12	70689137	rs78550979	T	C	9	7	16	0	0	16	0	0
12	70690188	rs80037325	G	A	5	3	8	0	0	8	0	0
12	70701782	rs74379907	C	T	8	10	18	0	0	18	0	0
12	70721025	rs77000192	A	G	1	5	6	0	0	6	0	0
12	70723760	rs17814151	C	T	5	4	9	0	0	9	0	0
12	70724053	rs11615947	G	A	4	3	7	0	0	7	0	0
12	70728679	rs10879130	C	A	7	10	17	0	1	18	0	0
12	72016248	.	T	G	10	13	23	0	1	24	0	0
12	72168784	rs328712	T	C	5	2	7	0	0	7	0	0
12	72179446	rs61754230	C	T	185	149	334	0	1	335	0	0
12	72179691	rs11178946	T	G	94	79	173	0	11	184	0	0
12	72240590	rs328770	A	G	2	4	6	0	0	6	0	0
12	72241603	rs328772	T	G	4	7	11	0	0	11	0	0
12	72245016	rs328773	A	C	9	10	19	0	0	19	0	0
12	72245731	rs328775	T	C	6	9	15	0	0	15	0	0
12	72246542	rs328778	C	G	9	6	15	0	0	15	0	0
12	72248423	rs2468335	T	C	6	14	20	0	0	20	0	0
12	72260048	rs7969244	G	C	6	1	7	0	0	7	0	0
12	72302333	rs12810964	G	A	2	4	6	0	0	6	0	0
12	72304118	rs7975561	A	G	5	2	7	0	0	7	0	0
12	72304358	rs9668736	A	G	8	3	11	0	0	11	0	0
12	72307412	rs12581846	C	T	7	11	18	0	0	18	0	0
12	72307616	rs3759171	A	G	223	226	449	0	4	453	0	0
12	72307637	rs11178983	C	G	228	238	466	0	6	472	0	0
12	72320070	rs7955650	T	C	7	5	12	0	0	12	0	0
12	75877304	rs11611121	A	G	40	42	82	0	1	83	0	0
12	75877848	rs11180546	A	C	27	43	70	0	0	70	0	0
12	75878059	rs11180547	A	G	29	39	68	0	0	68	0	0
12	75878751	rs10879922	A	G	3	11	14	0	0	14	0	0
12	75882455	rs7299877	A	G	2	4	6	0	0	6	0	0
12	75883580	rs10879923	C	T	6	3	9	0	0	9	0	0
12	75884876	rs12826635	T	C	11	9	20	0	0	20	0	0
12	75886695	rs35619460	A	C	9	9	18	0	0	18	0	0
12	75887350	rs12827668	A	G	16	7	23	0	0	23	0	0
12	75888251	rs15513	G	A	89	48	137	0	1	138	0	0
12	75889601	rs12819511	T	C	9	18	27	0	0	27	0	0
12	75889876	rs61933361	C	T	34	12	46	0	0	46	0	0
12	75890007	rs61933362	C	T	51	45	96	0	0	96	0	0
12	75890333	rs1501634	A	G	31	26	57	0	1	58	0	0
12	75890652	rs11611609	G	A	42	25	67	0	0	67	0	0
12	75890818	.	C	T	64	58	122	0	3	125	0	0
12	75891253	rs3741496	T	C	46	52	98	0	0	98	0	0
12	75891678	rs11180552	A	G	13	19	32	0	0	32	0	0
12	75893399	rs1056904	T	G	17	29	46	0	0	46	0	0
12	75893486	rs1056900	A	G	100	187	287	0	7	294	0	0
12	75898340	rs1604381	T	C	4	8	12	0	0	12	0	0
12	75899918	rs7966268	G	T	10	5	15	0	1	16	0	0
12	75900588	rs2070162	A	G	164	205	369	0	2	371	0	0
12	75904102	rs12812559	T	C	15	18	33	0	1	34	0	0
12	75904837	rs17218895	G	A	20	18	38	0	0	38	0	0
12	76420006	rs73133134	C	T	8	10	18	0	0	18	0	0
12	76439659	rs1063104	A	G	22	19	41	0	0	41	0	0
12	76439734	rs7978288	C	T	25	14	39	0	0	39	0	0
12	76442907	rs11180815	T	C	4	3	7	0	0	7	0	0
12	76449900	rs1059143	T	C	900	986	1886	0	36	1922	0	0
12	76451696	rs2163913	T	C	3	4	7	0	0	7	0	0
12	76452590	rs7977777	C	G	6	5	11	0	0	11	0	0
12	76453966	rs4663	G	A	897	828	1725	0	6	1731	0	0
12	76454448	rs7136330	A	G	5	4	9	0	0	9	0	0
12	76454606	rs117152628	C	T	1	6	7	0	0	7	0	0
12	76455714	rs7315194	T	C	7	10	17	0	0	17	0	0
12	76455817	rs7299063	C	T	4	12	16	0	0	16	0	0
12	76462612	rs10880034	T	C	7	5	12	0	0	12	0	0
12	76745688	rs185267075	A	G	66	61	127	0	2	129	0	0
12	76766165	rs2369128	G	T	5	2	7	0	0	7	0	0
12	76866400	rs11829590	C	T	2	5	7	0	0	7	0	0
12	76882269	rs73385514	G	A	4	2	6	0	0	6	0	0
12	76953374	rs4761430	G	A	4	5	9	0	0	9	0	0
12	77217463	rs73146822	A	C	6	3	9	0	0	9	0	0
12	77217677	rs11115603	A	C	4	2	6	0	0	6	0	0
12	77219722	rs6539705	G	A	6	4	10	0	0	10	0	0
12	77219845	rs6539707	C	T	7	5	12	0	0	12	0	0
12	77220089	rs10778945	A	G	6	4	10	0	0	10	0	0
12	77220514	rs4761342	T	A	4	5	9	0	0	9	0	0
12	77222970	rs10862594	G	A	6	3	9	0	0	9	0	0
12	77224689	rs7304988	G	T	7	5	12	0	0	12	0	0
12	77232877	rs1495332	G	A	7	1	8	0	0	8	0	0
12	77235768	rs33996476	A	G	19	13	32	0	0	32	0	0
12	77238563	rs1874301	G	T	4	5	9	0	0	9	0	0
12	77238653	rs1874300	G	A	3	5	8	0	0	8	0	0
12	77245749	rs702062	A	G	55	54	109	0	0	109	0	0
12	77245750	rs702063	A	T	56	54	110	0	0	110	0	0
12	79611374	rs2037743	C	T	6	8	14	0	0	14	0	0
12	80014907	rs2307223	A	T	15	5	20	0	0	20	0	0
12	81187139	rs149260641	A	G	6	9	15	0	0	15	0	0
12	82747128	rs17774157	A	C	3	7	10	0	0	10	0	0
12	82752543	rs112592060	T	G	8	10	18	0	0	18	0	0
12	82752559	rs113882703	T	G	4	7	11	0	0	11	0	0
12	82792666	rs10506872	C	T	2	4	6	0	0	6	0	0
12	82792942	rs10506873	A	G	9	2	11	0	0	11	0	0
12	88440676	rs9262	G	C	128	89	217	0	1	218	0	0
12	89913633	rs11831532	T	C	20	26	46	0	0	46	0	0
12	89914142	rs7306772	T	G	15	12	27	0	0	27	0	0
12	89914883	rs71454159	A	T	8	6	14	0	0	14	0	0
12	89914886	.	A	T	8	8	16	0	0	16	0	0
12	89915549	rs3864928	C	G	22	18	40	0	0	40	0	0
12	89917037	rs2230282	G	A	13	13	26	0	0	26	0	0
12	89917518	rs2230281	A	G	7	15	22	0	0	22	0	0
12	89986336	rs10506974	C	T	3	6	9	0	0	9	0	0
12	90006905	rs111481954	C	T	8	6	14	0	0	14	0	0
12	90028901	rs1050395	T	C	36	51	87	0	0	87	0	0
12	90040620	rs73196686	A	T	2	8	10	0	0	10	0	0
12	92383550	rs73218572	G	A	4	3	7	0	0	7	0	0
12	92487362	rs7977082	T	C	7	12	19	0	1	20	0	0
12	92505932	rs709240	T	C	5	2	7	0	0	7	0	0
12	92506124	rs7967030	A	G	2	4	6	0	0	6	0	0
12	92521198	rs10859277	C	T	5	1	6	0	0	6	0	0
12	92521346	rs7979348	T	C	3	7	10	0	1	11	0	0
12	92536826	rs709222	G	T	124	157	281	0	1	282	0	0
12	92539344	rs709223	T	C	24	26	50	0	0	50	0	0
12	92539378	rs1049979	G	A	20	17	37	0	2	39	0	0
12	93398323	.	G	A	2	4	6	0	0	6	0	0
12	93772469	rs72620740	C	T	3	4	7	0	0	7	0	0
12	93773927	rs4247307	G	A	2	5	7	0	0	7	0	0
12	93781777	rs11107007	T	C	3	3	6	0	0	6	0	0
12	93794530	.	C	A	344	2	346	0	0	347	1	0
12	93794653	.	G	T	296	5	301	0	1	302	0	0
12	93796425	rs12597	G	A	59	85	144	0	0	144	0	0
12	93800678	rs7968453	T	C	4	4	8	0	0	8	0	0
12	93807711	rs79579959	G	A	4	7	11	0	0	11	0	0
12	93807934	rs4020453	C	T	4	9	13	0	0	13	0	0
12	93811272	rs7311222	A	G	6	3	9	0	0	9	0	0
12	93815387	rs117864740	A	G	3	3	6	0	0	6	0	0
12	93895773	rs12811748	T	C	20	36	56	0	0	56	0	0
12	93895774	rs12810335	C	T	21	37	58	0	0	58	0	0
12	93896894	rs4761728	G	A	40	32	72	0	0	72	0	0
12	93950430	rs11107107	G	T	2	4	6	0	0	6	0	0
12	93966502	rs41477552	C	G	32	39	71	0	2	73	0	0
12	94132186	rs6538450	T	A	5	2	7	0	0	7	0	0
12	94184082	rs11107184	C	T	4	2	6	0	0	6	0	0
12	94243853	rs56944668	C	T	14	6	20	0	0	20	0	0
12	94603406	rs34565975	G	C	8	15	23	0	0	23	0	0
12	94645255	rs2230757	A	G	16	12	28	0	0	28	0	0
12	94650325	rs2242499	A	G	2	5	7	0	0	7	0	0
12	94660974	rs2068435	T	C	11	13	24	0	0	24	0	0
12	94963456	rs17022770	G	A	3	3	6	0	0	6	0	0
12	94963611	rs61440179	C	T	1	7	8	0	0	8	0	0
12	95042839	rs7975526	C	G	3	5	8	0	0	8	0	0
12	95043123	rs2279793	T	C	4	7	11	0	0	11	0	0
12	95661297	.	G	A	4	2	6	0	1	7	0	0
12	95676984	rs10859866	T	C	5	4	9	0	0	9	0	0
12	95691186	rs2367083	C	T	7	2	9	0	1	10	0	0
12	95693407	rs7976638	A	G	3	7	10	0	0	10	0	0
12	95694394	rs14121	G	A	59	74	133	0	0	133	0	0
12	95878751	rs301036	T	G	3	3	6	0	0	6	0	0
12	95896829	rs2769468	G	T	10	7	17	0	1	18	0	0
12	95897653	rs78145003	G	T	8	23	31	0	0	31	0	0
12	95906603	rs3794261	C	A	157	166	323	0	2	325	0	0
12	96259951	rs17369927	G	A	150	7	157	0	2	159	0	0
12	96273291	rs10507067	A	T	7	0	7	0	0	7	0	0
12	96274089	rs79398728	G	C	9	2	11	0	0	11	0	0
12	96274690	rs2196457	A	G	23	1	24	0	0	24	0	0
12	96374614	rs7297245	C	T	23	9	32	0	0	32	0	0
12	96374672	rs6538695	T	C	18	10	28	0	1	29	0	0
12	96375495	rs143737288	C	T	4	3	7	0	0	7	0	0
12	96375534	rs7966537	A	G	8	2	10	0	0	10	0	0
12	96375785	rs17676451	G	A	4	6	10	0	0	10	0	0
12	96376259	rs17733203	C	T	8	3	11	0	0	11	0	0
12	96376333	rs73216216	G	A	6	3	9	0	0	9	0	0
12	96376393	rs77798722	G	A	8	7	15	0	0	15	0	0
12	96376763	rs56361316	C	T	5	4	9	0	0	9	0	0
12	96397081	rs17677343	T	A	5	4	9	0	0	9	0	0
12	96403199	rs2072510	G	A	15	20	35	0	0	35	0	0
12	96404275	rs2540497	T	A	4	7	11	0	0	11	0	0
12	96405077	rs2660900	T	C	8	4	12	0	0	12	0	0
12	96637107	rs74485638	G	T	4	2	6	0	0	6	0	0
12	96638743	rs4762290	G	A	7	5	12	0	0	12	0	0
12	96639739	rs3782563	A	G	4	6	10	0	0	10	0	0
12	96639752	rs75187077	C	T	8	5	13	0	0	13	0	0
12	96651961	rs2268503	T	C	8	13	21	0	0	21	0	0
12	96652055	rs17737199	A	G	12	3	15	0	0	15	0	0
12	96661701	rs6538704	C	T	17	22	39	0	0	39	0	0
12	96672743	rs3087520	G	C	17	15	32	0	1	33	0	0
12	96673764	rs11108452	T	C	57	59	116	0	0	116	0	0
12	96675392	rs11834338	G	A	5	1	6	0	0	6	0	0
12	96676057	rs7975426	T	G	9	8	17	0	0	17	0	0
12	96676330	rs35751611	C	A	63	41	104	0	1	105	0	0
12	96794116	rs11537648	T	A	6	3	9	0	0	9	0	0
12	97328165	rs249573	T	C	4	4	8	0	0	8	0	0
12	97340532	rs249590	G	A	2	5	7	0	0	7	0	0
12	97342356	rs10860107	A	G	1	5	6	0	0	6	0	0
12	97345955	rs2304697	A	G	28	19	47	0	1	48	0	0
12	97346505	rs7980370	A	G	25	21	46	0	0	46	0	0
12	97346924	rs1044910	G	A	58	46	104	0	1	105	0	0
12	98928277	rs113105753	A	T	30	29	59	0	0	59	0	0
12	98988433	rs145900321	C	T	170	144	314	0	4	318	0	0
12	98988786	rs2239700	T	G	129	161	290	0	0	291	1	0
12	98989918	rs79625667	A	T	164	166	330	0	1	331	0	0
12	98990289	rs12579669	C	A	153	162	315	0	0	315	0	0
12	99039326	rs2118851	C	G	8	5	13	0	1	14	0	0
12	99039467	rs2118852	G	T	22	14	36	0	1	37	0	0
12	99044157	rs11109557	G	A	8	2	10	0	0	10	0	0
12	99044920	rs34144325	C	T	5	4	9	0	0	9	0	0
12	99046768	rs77296419	C	G	5	7	12	0	0	12	0	0
12	99047714	rs78771907	T	C	13	15	28	0	0	28	0	0
12	99059900	rs11109564	A	G	8	9	17	0	0	17	0	0
12	99094484	rs2288721	A	G	4	13	17	0	0	17	0	0
12	99127431	rs12829605	T	G	13	18	31	0	0	31	0	0
12	99128001	rs6538881	A	T	47	28	75	0	0	75	0	0
12	99128002	rs6538882	T	C	46	29	75	0	0	75	0	0
12	101732655	rs56265469	C	T	2	7	9	0	1	10	0	0
12	101787433	rs17500109	G	C	33	38	71	0	1	72	0	0
12	101798357	rs28398934	T	C	4	4	8	0	0	8	0	0
12	102114664	rs188040170	C	A	9	7	16	0	0	16	0	0
12	102115769	rs181508052	G	A	7	11	18	0	0	18	0	0
12	102184071	rs222512	C	T	3	3	6	0	0	6	0	0
12	102407432	rs7971939	A	T	8	7	15	0	1	16	0	0
12	102408043	rs10860830	A	G	3	4	7	0	0	7	0	0
12	102453467	rs73185904	T	C	2	14	16	0	0	16	0	0
12	102494849	rs17438178	T	C	25	23	48	0	1	49	0	0
12	102510564	rs141154086	C	T	5	2	7	0	0	7	0	0
12	102517753	rs2036772	T	C	6	1	7	0	0	7	0	0
12	104186946	rs1866295	G	T	5	2	7	0	0	7	0	0
12	104188523	rs11111783	A	G	7	3	10	0	0	10	0	0
12	104189056	rs11111785	A	G	1	6	7	0	0	7	0	0
12	104189057	rs11111786	T	C	1	6	7	0	0	7	0	0
12	104189923	rs10861104	A	C	3	3	6	0	0	6	0	0
12	104189999	rs10861105	C	T	7	5	12	0	0	12	0	0
12	104325649	rs2722188	T	G	2	5	7	0	0	7	0	0
12	104325871	rs1183212	T	C	5	1	6	0	0	6	0	0
12	104325924	rs1165682	T	A	5	4	9	0	0	9	0	0
12	104327979	rs6615	C	T	181	213	394	0	1	395	0	0
12	104344361	rs2248995	A	G	3	4	7	0	0	7	0	0
12	104359647	rs4135038	G	A	6	2	8	0	0	8	0	0
12	104362132	rs4135047	C	A	2	4	6	0	0	6	0	0
12	104381355	.	G	C	52	0	52	0	2	54	0	0
12	104492003	rs2629755	A	G	4	3	7	0	0	7	0	0
12	104512918	rs2466551	T	G	19	14	33	0	0	33	0	0
12	104527129	rs7310193	T	C	5	1	6	0	0	6	0	0
12	104659095	rs35651749	C	T	259	0	259	0	3	262	0	0
12	104851112	rs111789728	T	C	32	20	52	0	1	53	0	0
12	104851463	rs35676334	C	G	4	9	13	0	0	13	0	0
12	104851523	rs12299738	A	C	6	2	8	0	0	8	0	0
12	104853067	rs3751319	C	G	7	4	11	0	0	11	0	0
12	104853323	rs78057832	A	G	2	6	8	0	0	8	0	0
12	104854420	rs10778334	C	T	6	2	8	0	0	8	0	0
12	104854458	rs7307713	A	G	4	4	8	0	0	8	0	0
12	104854634	rs12819044	G	C	2	7	9	0	0	9	0	0
12	104855192	rs10735397	C	A	13	3	16	0	0	16	0	0
12	104855630	rs7976781	C	T	33	25	58	0	2	61	1	0
12	104855969	rs7979881	A	G	27	20	47	0	4	51	0	0
12	104857140	rs2178669	G	A	5	3	8	0	0	8	0	0
12	104857619	rs7135581	C	T	5	1	6	0	0	6	0	0
12	104858328	rs7953927	T	C	4	2	6	0	0	6	0	0
12	104859237	rs17035629	G	A	4	6	10	0	0	10	0	0
12	104862036	rs4964292	T	C	4	4	8	0	0	8	0	0
12	104862611	rs10746001	G	A	25	17	42	0	1	43	0	0
12	104873612	rs7299352	T	C	4	2	6	0	0	6	0	0
12	104873686	rs7313791	C	T	3	3	6	0	0	6	0	0
12	104873780	rs7313930	C	T	7	2	9	0	0	9	0	0
12	104873781	rs7313820	A	G	7	2	9	0	0	9	0	0
12	104874300	rs7953577	G	C	3	5	8	0	0	8	0	0
12	104874471	rs67672936	G	A	9	6	15	0	0	15	0	0
12	104875438	rs3902812	G	T	4	2	6	0	0	6	0	0
12	104875480	rs3902813	C	T	3	3	6	0	0	6	0	0
12	104876567	rs7976717	T	G	4	7	11	0	0	11	0	0
12	104879273	rs2103391	A	G	9	4	13	0	0	13	0	0
12	104880469	rs7956477	C	G	5	6	11	0	0	11	0	0
12	104881167	rs2091769	C	G	7	5	12	0	0	12	0	0
12	104881328	rs10861225	T	C	2	4	6	0	0	6	0	0
12	104882004	rs7963874	C	A	13	8	21	0	0	21	0	0
12	104882199	rs11112078	C	G	10	12	22	0	0	22	0	0
12	104882922	rs7133503	T	C	8	4	12	0	0	12	0	0
12	104883003	rs7133525	T	C	4	3	7	0	0	7	0	0
12	104883474	rs2888823	T	C	5	6	11	0	0	11	0	0
12	104883476	rs2374397	T	C	5	6	11	0	0	11	0	0
12	104883910	rs7971806	C	G	10	13	23	0	0	23	0	0
12	104884438	rs10778336	G	T	13	16	29	0	1	30	0	0
12	104885460	rs10778337	T	C	13	6	19	0	1	20	0	0
12	104885863	rs6539155	C	T	9	12	21	0	0	21	0	0
12	104886384	rs17035655	G	A	14	19	33	0	1	34	0	0
12	104888056	rs1882493	C	G	40	33	73	0	0	73	0	0
12	104888494	rs1882492	G	A	23	32	55	0	0	55	0	0
12	104889033	rs28629798	G	A	42	44	86	0	1	87	0	0
12	104889991	rs59632603	T	G	83	82	165	0	1	167	1	0
12	104937731	rs1625417	C	T	30	14	44	0	1	45	0	0
12	104937993	rs1966076	G	C	26	11	37	0	0	37	0	0
12	104938474	rs1631471	G	T	13	1	14	0	3	17	0	0
12	104938727	rs1795867	T	C	9	1	10	0	0	10	0	0
12	104939114	rs1704917	C	T	6	3	9	0	0	9	0	0
12	104968196	rs10861238	A	G	14	16	30	0	0	30	0	0
12	104968885	rs10746003	T	C	2	10	12	0	0	12	0	0
12	104979240	rs10861239	G	A	5	4	9	0	0	9	0	0
12	104979907	rs1650139	T	C	0	6	6	0	0	6	0	0
12	104980041	rs10861240	A	G	8	3	11	0	0	11	0	0
12	104980255	rs11112112	G	C	5	6	11	0	0	11	0	0
12	104980423	rs11112113	G	T	1	6	7	0	0	7	0	0
12	105152391	rs2468110	A	G	5	11	16	0	0	16	0	0
12	105152997	rs2463018	T	C	9	12	21	0	0	21	0	0
12	105153570	rs903247	C	T	11	20	31	0	0	31	0	0
12	105154087	rs2463437	G	A	14	17	31	0	0	31	0	0
12	105154135	rs2453155	C	T	14	14	28	0	0	28	0	0
12	105154148	rs2453156	T	C	14	16	30	0	0	30	0	0
12	105155605	rs7847	C	T	20	23	43	0	0	43	0	0
12	105309208	rs10861293	C	T	8	9	17	0	0	17	0	0
12	105518611	rs34705618	C	G	3	3	6	0	0	6	0	0
12	105520069	rs34434425	G	T	19	20	39	0	0	39	0	0
12	105524294	rs10861354	T	C	4	4	8	0	0	8	0	0
12	105526695	rs11112380	C	T	3	3	6	0	0	6	0	0
12	105530153	rs1196812	T	A	3	3	6	0	0	6	0	0
12	105562788	rs1076	T	C	33	55	88	0	0	88	0	0
12	105567135	rs703683	T	C	29	30	59	0	1	60	0	0
12	105567572	rs10071	A	G	79	61	140	0	2	142	0	0
12	105567611	rs9143	A	G	49	40	89	0	1	90	0	0
12	105568953	rs1196866	T	C	7	1	8	0	0	8	0	0
12	105570041	rs10861360	C	T	6	5	11	0	0	11	0	0
12	105572064	rs1196863	C	G	4	10	14	0	0	14	0	0
12	105589122	rs34775780	G	A	31	26	57	0	1	58	0	0
12	105591569	rs12303948	G	A	30	23	53	0	0	53	0	0
12	105592823	rs3829297	G	C	4	4	8	0	0	8	0	0
12	105626907	rs1196779	A	G	5	7	12	0	0	12	0	0
12	105627084	rs1196781	A	G	3	4	7	0	0	7	0	0
12	105764984	rs6797	T	G	25	17	42	0	1	43	0	0
12	105765097	rs1061749	T	C	56	77	133	0	2	135	0	0
12	106632131	rs7112	G	C	83	65	148	0	1	149	0	0
12	106701422	rs4964174	G	A	1	6	7	0	0	7	0	0
12	106732411	rs2264813	A	G	6	0	6	0	0	6	0	0
12	107364873	rs10778520	C	T	5	2	7	0	0	7	0	0
12	107367224	rs1053050	T	C	11	19	30	0	0	30	0	0
12	107367225	rs1053051	T	C	11	19	30	0	0	30	0	0
12	107385610	rs1056560	C	A	46	25	71	0	0	71	0	0
12	107387025	rs3741890	A	C	10	6	16	0	0	16	0	0
12	107387163	rs3741892	C	G	5	7	12	0	0	12	0	0
12	107390867	rs3815570	C	T	2	4	6	0	0	6	0	0
12	107395106	rs8192440	A	G	54	61	115	0	0	115	0	0
12	107396353	rs7310850	T	G	4	6	10	0	0	11	1	0
12	107396797	rs10778522	G	A	5	11	16	0	0	16	0	0
12	107487069	rs3809235	C	T	21	13	34	0	1	35	0	0
12	107712440	rs1107438	A	G	6	3	9	0	1	10	0	0
12	107728676	rs759564	G	A	7	20	27	0	0	27	0	0
12	107943616	rs7959490	G	A	2	4	6	0	0	6	0	0
12	107944676	rs11113391	T	A	4	4	8	0	0	8	0	0
12	107944798	rs7963272	A	T	7	6	13	0	0	13	0	0
12	107993378	rs34883973	G	C	10	0	10	0	0	10	0	0
12	107993524	rs57387892	G	A	9	2	11	0	0	11	0	0
12	108045336	rs2241185	T	C	4	3	7	0	0	7	0	0
12	108052435	rs2241183	A	G	23	16	39	0	1	40	0	0
12	108914419	rs7969198	G	A	4	4	8	0	0	8	0	0
12	108916677	rs703691	T	G	61	69	130	0	5	135	0	0
12	108917161	rs12833341	G	T	80	95	175	0	9	184	0	0
12	108918146	rs2303633	C	T	92	96	188	0	2	190	0	0
12	108919390	rs7963063	T	C	3	3	6	0	0	6	0	0
12	108923950	rs1549096	A	G	58	54	112	0	0	112	0	0
12	108927483	rs2111954	T	C	5	7	12	0	0	12	0	0
12	108929450	rs7301731	C	T	5	4	9	0	0	9	0	0
12	108929452	.	A	G	4	5	9	0	0	9	0	0
12	108930831	rs7974452	G	C	2	4	6	0	0	6	0	0
12	108932053	rs2287551	C	T	6	2	8	0	0	8	0	0
12	108932100	rs7978765	G	A	4	3	7	0	0	7	0	0
12	108954502	rs1160332	G	A	50	21	71	0	2	73	0	0
12	108954823	rs1063936	C	T	53	50	103	0	0	103	0	0
12	108956417	rs10778647	T	G	85	56	141	0	2	143	0	0
12	108956418	rs10778648	T	G	85	56	141	0	2	144	1	0
12	108956433	rs2287555	C	T	119	89	208	0	1	209	0	0
12	108956610	rs2287556	C	G	34	32	66	0	0	66	0	0
12	108958439	rs10083175	T	C	7	2	9	0	0	9	0	0
12	108960586	rs965260	G	C	3	4	7	0	0	7	0	0
12	108960906	rs10861945	G	T	5	3	8	0	0	8	0	0
12	108961293	rs888546	C	T	7	3	10	0	0	10	0	0
12	108961354	rs888547	T	C	8	3	11	0	0	11	0	0
12	108961383	rs888548	A	G	6	2	8	0	0	8	0	0
12	108962398	rs888549	C	G	30	16	46	0	0	46	0	0
12	109178003	rs3741781	C	A	52	49	101	0	0	101	0	0
12	109178973	rs2003242	T	G	23	31	54	0	0	54	0	0
12	109180115	rs78866567	G	T	16	30	46	0	0	46	0	0
12	109182049	rs3741778	T	C	15	13	28	0	0	28	0	0
12	109485448	rs7955458	T	C	5	4	9	0	0	9	0	0
12	109490401	rs2304266	C	T	4	5	9	0	0	9	0	0
12	109490601	rs2304267	C	T	6	3	9	0	0	9	0	0
12	109511256	rs7967322	T	C	49	52	101	0	2	104	1	0
12	109525439	rs1059257	G	A	116	97	213	0	3	216	0	0
12	109525735	rs1059262	T	G	18	41	59	0	0	59	0	0
12	109692053	rs17848835	C	T	5	2	7	0	0	7	0	0
12	109693982	rs3742023	C	T	5	6	11	0	0	11	0	0
12	109886603	rs6663	G	A	34	60	94	0	0	94	0	0
12	109888779	rs1477117	G	A	68	59	127	0	0	127	0	0
12	109890080	rs4766601	G	C	3	5	8	0	0	8	0	0
12	109890510	rs4766602	T	C	4	4	8	0	0	8	0	0
12	109890955	rs12833054	G	A	3	7	10	0	0	10	0	0
12	109891742	rs12578648	A	G	5	5	10	0	0	10	0	0
12	109893514	rs35590455	A	G	2	6	8	0	0	8	0	0
12	109893697	rs2302709	A	G	4	4	8	0	0	8	0	0
12	109893726	rs2302708	A	C	4	5	9	0	0	9	0	0
12	109893797	rs2302707	G	A	1	5	6	0	0	6	0	0
12	109894028	rs2302706	A	G	55	46	101	0	1	102	0	0
12	109895958	rs11609019	G	A	9	6	15	0	0	15	0	0
12	109896002	rs12822891	A	G	4	4	8	0	0	8	0	0
12	109896005	rs76932709	G	T	4	5	9	0	0	9	0	0
12	109896165	rs7313797	T	C	3	3	6	0	0	6	0	0
12	109898047	rs11613023	T	C	2	4	6	0	0	6	0	0
12	109898194	rs72647792	G	A	5	5	10	0	0	10	0	0
12	109915727	rs1045582	G	T	3	5	8	0	0	8	0	0
12	109973273	rs2058807	T	C	7	5	12	0	0	12	0	0
12	109973297	rs4766609	A	G	6	8	14	0	1	15	0	0
12	109973979	rs1045255	G	C	15	10	25	0	0	25	0	0
12	109973981	rs1045256	G	A	15	10	25	0	0	25	0	0
12	109974151	rs14863	C	T	7	11	18	0	0	18	0	0
12	109974191	rs1045263	A	G	7	9	16	0	0	16	0	0
12	109974264	rs1617	G	A	12	17	29	0	1	30	0	0
12	109991998	rs12817689	A	G	3	3	6	0	0	6	0	0
12	109992132	rs2241201	C	G	3	5	8	0	0	8	0	0
12	109994870	rs9593	A	T	12	10	22	0	0	22	0	0
12	109999068	rs2287180	G	A	1	7	8	0	0	8	0	0
12	110401858	rs71458314	C	T	4	7	11	0	1	12	0	0
12	110780540	rs3026482	A	T	1	5	6	0	0	6	0	0
12	110783241	rs1860561	G	A	89	98	187	0	1	188	0	0
12	110815922	rs28609096	A	G	12	10	22	0	1	23	0	0
12	110819139	rs28637922	G	T	8	7	15	0	0	15	0	0
12	110874508	.	T	A	17	6	23	0	0	26	3	0
12	110879226	rs12822385	A	G	3	6	9	0	1	10	0	0
12	110879831	rs10774601	T	C	2	5	7	0	1	8	0	0
12	110939421	rs6606687	T	C	8	8	16	0	0	16	0	0
12	110974890	rs10849900	T	C	97	65	162	0	1	163	0	0
12	110975675	rs6606689	T	C	20	14	34	0	0	34	0	0
12	111798553	rs3742004	A	G	7	9	16	0	0	16	0	0
12	111799681	rs874286	T	C	5	5	10	0	0	10	0	0
12	111800059	rs10849938	T	C	4	6	10	0	0	10	0	0
12	111858086	rs739497	C	T	2	6	8	0	0	8	0	0
12	111864684	rs10849947	T	C	4	5	9	0	0	9	0	0
12	111865049	rs7310615	C	G	8	0	8	0	0	8	0	0
12	111865565	rs2283358	C	T	6	5	11	0	0	11	0	0
12	111871141	rs4766462	A	T	2	6	8	0	0	8	0	0
12	111875410	rs10849948	A	G	4	4	8	0	0	8	0	0
12	111878526	rs7296313	T	C	7	8	15	0	0	15	0	0
12	111881309	rs2239195	G	T	11	11	22	0	0	22	0	0
12	111882485	rs2238154	C	A	11	9	20	0	0	20	0	0
12	111884415	rs28362508	T	C	15	26	41	0	0	41	0	0
12	111884608	rs3184504	T	C	44	40	84	0	0	84	0	0
12	111887659	rs739496	A	G	105	97	202	0	2	205	1	0
12	111888808	rs144152836	T	C	310	311	621	0	3	624	0	0
12	112120170	rs646275	C	T	7	5	12	0	0	12	0	0
12	112183574	rs11066018	T	C	2	4	6	0	0	6	0	0
12	112277576	rs3177647	C	T	4	4	8	0	0	8	0	0
12	112278025	rs2879603	A	G	83	104	187	0	1	188	0	0
12	112280773	rs3213628	G	T	11	20	31	0	0	31	0	0
12	112281013	rs4767068	A	G	20	29	49	0	0	49	0	0
12	112282838	rs57786827	A	G	2	4	6	0	0	6	0	0
12	112318997	rs61440627	T	C	3	3	6	0	0	6	0	0
12	112323016	rs12315146	C	T	17	4	21	0	0	21	0	0
12	112323582	rs1981517	A	G	17	6	23	0	0	23	0	0
12	112326123	rs2269801	T	C	4	3	7	0	0	7	0	0
12	112326138	rs2269802	A	G	5	4	9	0	0	9	0	0
12	112326145	rs2269803	T	C	5	4	9	0	0	9	0	0
12	112331358	rs111615149	G	C	6	12	18	0	0	18	0	0
12	112331475	rs74601291	G	A	5	3	8	0	1	9	0	0
12	112331676	.	C	T	3	6	9	0	0	9	0	0
12	112332283	rs7974772	C	T	6	3	9	0	1	10	0	0
12	112332570	rs61088218	A	G	8	7	15	0	0	15	0	0
12	112333660	rs4766705	C	A	6	7	13	0	0	13	0	0
12	112335217	rs10849981	A	T	7	6	13	0	0	13	0	0
12	112335539	rs10849982	G	A	2	5	7	0	0	7	0	0
12	112339015	rs12321677	G	A	3	3	6	0	0	6	0	0
12	112339843	rs3741998	A	G	1	7	8	0	0	8	0	0
12	112453959	rs16941831	T	C	23	27	50	0	0	50	0	0
12	112459849	rs80350869	C	T	6	10	16	0	0	16	0	0
12	112471090	rs12298022	G	T	45	37	82	0	0	82	0	0
12	112490764	rs2339941	G	T	3	4	7	0	0	7	0	0
12	112584408	rs76012166	C	T	6	1	7	0	0	7	0	0
12	112667675	rs1005902	T	G	13	16	29	0	0	29	0	0
12	112721528	rs80234740	C	T	2	5	7	0	0	7	0	0
12	112732507	rs77718440	C	T	5	5	10	0	0	10	0	0
12	112843998	rs2233861	A	T	16	9	25	0	1	26	0	0
12	112928451	rs7978851	G	A	5	2	7	0	0	7	0	0
12	112930599	.	A	G	3	3	6	0	0	6	0	0
12	112930606	.	T	C	3	3	6	0	0	6	0	0
12	113335681	rs1045670	G	A	3	3	6	0	0	6	0	0
12	113335687	rs2240192	G	A	3	3	6	0	0	6	0	0
12	113348870	rs1131454	G	A	6	6	12	0	0	12	0	0
12	113357193	rs10774671	G	A	5	8	13	0	0	13	0	0
12	113357209	rs1131476	G	A	20	9	29	0	1	30	0	0
12	113357237	rs1051042	G	C	22	6	28	0	0	28	0	0
12	113357442	rs2660	G	A	26	7	33	0	0	33	0	0
12	113376320	rs3815178	C	T	10	4	14	0	0	14	0	0
12	113376331	rs1859331	C	A	11	4	15	0	0	15	0	0
12	113376388	rs1859330	G	A	11	5	16	0	0	16	0	0
12	113376452	rs1859329	C	T	6	4	10	0	0	10	0	0
12	113380008	rs10735079	G	A	11	13	24	0	0	24	0	0
12	113380708	rs7977345	A	T	2	6	8	0	0	8	0	0
12	113381956	rs2269899	C	T	1	5	6	0	0	6	0	0
12	113386950	rs2285932	T	C	15	9	24	0	0	24	0	0
12	113389011	rs34473003	C	T	1	6	7	0	0	7	0	0
12	113401199	rs45603631	G	A	13	8	21	0	0	21	0	0
12	113408208	rs2010604	G	C	11	9	20	0	1	21	0	0
12	113409260	rs2072133	T	C	17	12	29	0	2	31	0	0
12	113409413	rs4767045	C	T	32	12	44	0	1	45	0	0
12	113410316	rs10744791	G	A	30	24	54	0	0	54	0	0
12	113416443	.	G	T	30	30	60	0	1	61	0	0
12	113423971	rs35936495	A	G	5	5	10	0	0	10	0	0
12	113424003	rs71442750	G	A	4	2	6	0	0	6	0	0
12	113424475	rs12814926	G	A	2	4	6	0	0	6	0	0
12	113425154	rs1293767	C	G	37	34	71	0	0	71	0	0
12	113425493	rs1293765	T	C	48	43	91	0	1	92	0	0
12	113425679	rs1293764	T	C	62	66	128	0	0	128	0	0
12	113426180	rs2040807	G	A	124	105	229	0	0	229	0	0
12	113612943	.	C	T	65	62	127	0	1	128	0	0
12	113629949	rs1043845	C	T	11	5	16	0	0	16	0	0
12	113734932	rs2232517	T	G	6	10	16	0	0	16	0	0
12	113736985	rs78468550	G	A	102	94	196	0	0	196	0	0
12	113742879	rs12422330	C	T	9	7	16	0	0	16	0	0
12	113825679	rs12425042	C	T	15	18	33	0	2	35	0	0
12	113826442	rs78927955	C	G	29	17	46	0	1	47	0	0
12	114254860	rs1043811	G	A	31	10	41	0	0	41	0	0
12	114254995	rs1043810	T	C	18	19	37	0	0	37	0	0
12	114255320	rs7312601	C	T	18	13	31	0	0	31	0	0
12	114255322	rs12369142	C	T	19	13	32	0	0	32	0	0
12	114255756	rs7312304	G	A	15	7	22	0	0	22	0	0
12	114256137	rs7970186	T	C	6	4	10	0	0	10	0	0
12	114256513	rs11066769	G	A	4	6	10	0	0	10	0	0
12	114256652	rs10744801	T	A	5	2	7	0	0	7	0	0
12	114256924	rs10850216	A	G	6	3	9	0	0	9	0	0
12	114256994	rs11066771	A	G	1	7	8	0	0	8	0	0
12	114258394	rs7314142	T	G	6	2	8	0	0	8	0	0
12	114260225	rs11614209	C	T	16	34	50	0	0	50	0	0
12	114260606	rs12303721	G	C	7	5	12	0	0	12	0	0
12	114377885	rs2290790	G	C	8	15	23	0	0	23	0	0
12	116398626	rs66898998	A	C	97	102	199	0	1	203	3	0
12	116412921	rs1992068	A	T	3	5	8	0	0	8	0	0
12	116412922	rs1992069	T	C	2	5	7	0	0	7	0	0
12	116623820	rs183096899	A	G	1	9	10	0	0	10	0	0
12	116972249	.	T	G	16	0	16	0	8	24	0	0
12	116972729	.	G	A	27	28	55	0	1	56	0	0
12	116997195	rs10850665	G	C	4	5	9	0	0	9	0	0
12	116999861	rs8181674	T	C	7	8	15	0	0	15	0	0
12	116999897	rs8181728	G	A	9	7	16	0	0	16	0	0
12	116999936	rs8181752	C	T	8	7	15	0	0	15	0	0
12	116999958	rs8181730	G	A	8	5	13	0	0	13	0	0
12	117000032	rs10161436	A	G	2	6	8	0	0	8	0	0
12	117154273	rs17500801	T	C	4	5	9	0	0	9	0	0
12	117485751	rs4766826	C	T	4	6	10	0	0	10	0	0
12	117485787	rs4766827	T	G	3	6	9	0	0	9	0	0
12	117582242	rs3741468	C	A	17	13	30	0	0	30	0	0
12	117584066	rs3741467	G	A	6	15	21	0	0	21	0	0
12	118575096	rs2088702	T	C	21	15	36	0	0	36	0	0
12	118575566	rs11068844	G	C	13	8	21	0	0	21	0	0
12	118582967	rs1051175	G	A	358	243	601	0	43	644	0	0
12	118583232	rs1051470	T	C	640	629	1269	0	24	1293	0	0
12	118590579	rs795483	T	C	22	43	65	0	0	65	0	0
12	118590816	rs795482	A	G	11	22	33	0	1	34	0	0
12	118592812	rs7298852	T	A	3	7	10	0	0	10	0	0
12	118593032	rs2463173	C	T	10	11	21	0	0	21	0	0
12	118597656	rs795475	C	G	47	42	89	0	2	91	0	0
12	118672434	rs424034	A	G	3	4	7	0	0	7	0	0
12	118675292	rs418941	C	T	5	1	6	0	0	6	0	0
12	118682751	rs428073	C	T	56	48	104	0	0	104	0	0
12	118684243	.	A	G	2	20	22	0	1	23	0	0
12	118684748	.	A	C	0	64	64	0	4	68	0	0
12	118841990	rs59848754	A	C	9	2	11	0	0	11	0	0
12	118853467	rs148082556	C	T	28	21	49	0	0	49	0	0
12	118854804	rs2279833	A	G	34	33	67	0	0	67	0	0
12	118855405	rs7795	A	G	44	54	98	0	0	98	0	0
12	118855432	rs1045542	G	A	50	34	84	0	0	84	0	0
12	120118415	rs575683175	C	A	153	166	319	0	3	322	0	0
12	120125216	.	G	A	2	9	11	0	0	11	0	0
12	120537299	rs117005478	C	T	24	10	34	0	0	34	0	0
12	120541570	rs17499109	G	A	17	7	24	0	0	24	0	0
12	120878530	rs8903	T	C	13	2	15	0	0	15	0	0
12	120882217	rs1048830	G	T	113	108	221	0	1	222	0	0
12	120888424	rs1179462	A	G	12	12	24	0	0	24	0	0
12	120888619	rs2235218	A	C	4	8	12	0	0	12	0	0
12	120889031	rs1179463	T	C	8	1	9	0	0	9	0	0
12	120889277	rs1179465	T	G	6	4	10	0	0	10	0	0
12	120891172	rs10774549	C	T	2	4	6	0	0	6	0	0
12	120893057	rs4767897	C	T	9	3	12	0	0	12	0	0
12	120893110	rs7307666	C	T	8	7	15	0	0	15	0	0
12	120894318	rs7957424	G	A	6	5	11	0	0	11	0	0
12	120894510	rs4767898	G	C	5	4	9	0	0	9	0	0
12	120898591	rs11065130	A	C	8	4	12	0	0	12	0	0
12	120898738	rs526176	A	G	9	7	16	0	0	16	0	0
12	120900274	rs9040	C	T	32	18	50	0	0	50	0	0
12	120900554	rs10744752	T	G	35	22	57	0	0	57	0	0
12	120902007	rs542407	T	C	131	153	284	0	2	286	0	0
12	120902111	rs1050187	C	T	113	120	233	0	3	236	0	0
12	120903610	rs75905531	C	A	3	3	6	0	0	6	0	0
12	120941215	rs7471	T	C	23	32	55	0	0	55	0	0
12	120966921	rs3742052	A	G	6	8	14	0	2	16	0	0
12	120990582	rs12309824	A	C	4	3	7	0	0	7	0	0
12	120991240	rs4767910	C	T	1	5	6	0	1	7	0	0
12	120992013	rs1167713	T	C	5	10	15	0	1	16	0	0
12	120992401	rs3213565	C	T	18	12	30	0	1	31	0	0
12	120993415	rs146861677	C	A	4	3	7	0	0	7	0	0
12	120996668	rs10849760	C	T	8	8	16	0	0	16	0	0
12	120997602	rs10849762	G	A	11	6	17	0	0	17	0	0
12	120997999	rs10774557	A	G	6	6	12	0	0	12	0	0
12	120998443	rs603574	A	G	13	14	27	0	0	27	0	0
12	121000133	rs585510	A	G	5	7	12	0	0	12	0	0
12	121006009	.	C	G	6	1	7	0	0	7	0	0
12	121009198	rs651627	C	T	14	11	25	0	0	25	0	0
12	121009577	rs10774558	T	A	9	6	15	0	0	15	0	0
12	121010030	rs10849764	C	T	5	7	12	0	0	12	0	0
12	121010237	rs11065163	T	C	7	14	21	0	0	21	0	0
12	121010696	rs574858	G	A	7	4	11	0	0	11	0	0
12	121013148	rs2292680	G	T	41	34	75	0	0	75	0	0
12	121014841	rs3088345	G	C	517	534	1051	0	6	1057	0	0
12	121017243	rs509445	A	C	2	4	6	0	0	6	0	0
12	121017264	rs2301456	C	T	5	2	7	0	0	7	0	0
12	121018061	rs11065164	G	A	4	4	8	0	0	8	0	0
12	121018422	rs12227470	T	A	4	2	6	0	0	6	0	0
12	121127347	rs10431384	A	G	5	3	8	0	0	8	0	0
12	121128633	rs1814851	C	G	3	5	8	0	0	8	0	0
12	121128699	rs2005455	A	G	4	2	6	0	0	6	0	0
12	121128882	rs10431385	T	C	3	4	7	0	0	7	0	0
12	121128926	rs10431386	C	T	5	1	6	0	1	7	0	0
12	121130046	rs7306541	A	G	9	5	14	0	0	14	0	0
12	121131051	rs75867074	C	G	2	4	6	0	0	6	0	0
12	121131891	rs2393749	C	T	10	7	17	0	0	17	0	0
12	121135467	rs7976497	T	C	34	43	77	0	1	78	0	0
12	121149064	rs998727	T	G	17	13	30	0	0	30	0	0
12	121149475	rs17847	A	G	6	3	9	0	0	9	0	0
12	121157851	rs3752531	A	G	67	51	118	0	1	119	0	0
12	121159380	rs696337	T	C	77	71	148	0	0	148	0	0
12	121160615	rs2066938	A	G	113	92	205	0	3	208	0	0
12	121167387	rs3999408	C	T	3	4	7	0	0	7	0	0
12	121169436	rs696339	A	T	2	4	6	0	0	6	0	0
12	121171803	rs558314	C	G	12	3	15	0	0	15	0	0
12	121171891	rs34673751	G	A	11	5	16	0	0	16	0	0
12	121173431	rs575437	T	C	9	3	12	0	0	12	0	0
12	121173653	rs696340	A	T	6	0	6	0	0	6	0	0
12	121173932	rs708783	A	G	5	3	8	0	0	8	0	0
12	121175524	rs2014355	T	C	15	11	26	0	1	27	0	0
12	121175984	rs555404	T	C	30	26	56	0	1	57	0	0
12	121176083	rs1799958	G	A	68	67	135	0	2	137	0	0
12	121176679	rs3915	C	T	72	72	144	0	1	145	0	0
12	121177272	rs3916	G	C	65	83	148	0	0	148	0	0
12	121177778	rs9204	A	G	55	55	110	0	0	110	0	0
12	121200609	rs618482	C	T	23	16	39	0	0	39	0	0
12	121201167	rs13746	C	T	64	30	94	0	2	96	0	0
12	121202362	rs6553	T	C	74	73	147	0	1	148	0	0
12	121202664	rs9431	A	C	176	134	310	0	3	313	0	0
12	121207147	rs12579868	C	T	6	4	10	0	0	10	0	0
12	121209957	rs634850	C	T	6	1	7	0	0	7	0	0
12	121221628	rs7137504	C	T	6	1	7	0	1	8	0	0
12	121221763	rs568297	C	T	5	4	9	0	0	9	0	0
12	121229893	rs662739	T	C	3	4	7	0	0	7	0	0
12	121233235	rs532140	C	A	6	2	8	0	0	8	0	0
12	121301732	rs73413868	T	C	6	10	16	0	0	16	0	0
12	121440878	rs117509570	A	G	13	11	24	0	0	24	0	0
12	121442199	rs3751151	T	A	26	17	43	0	0	43	0	0
12	121442214	rs3751150	G	A	25	17	42	0	0	42	0	0
12	121454257	rs2258227	T	A	10	5	15	0	0	15	0	0
12	121458138	rs2259697	G	A	249	220	469	0	0	469	0	0
12	121458400	rs12819210	C	T	697	545	1242	0	11	1253	0	0
12	121459440	rs7300883	C	G	4	11	15	0	2	17	0	0
12	121460983	rs34119995	G	T	12	12	24	0	0	24	0	0
12	121462139	rs2259883	G	C	23	27	50	0	0	50	0	0
12	121462157	rs12231806	C	T	23	29	52	0	0	52	0	0
12	121463140	rs73214160	C	T	19	20	39	0	0	39	0	0
12	121463288	rs2708081	T	C	17	16	33	0	1	34	0	0
12	121475933	rs73214166	A	G	7	5	12	0	0	12	0	0
12	121476099	rs73214167	A	C	6	9	15	0	0	15	0	0
12	121476232	rs73214168	T	C	4	8	12	0	1	13	0	0
12	121476423	rs10774580	A	G	3	7	10	0	0	10	0	0
12	121600253	rs208294	T	C	2	5	7	0	0	7	0	0
12	121648870	rs2686387	C	G	4	2	6	0	0	6	0	0
12	121651259	rs10774587	A	T	4	4	8	0	1	9	0	0
12	121651373	rs10849855	C	T	3	5	8	0	0	8	0	0
12	121651820	rs6489799	G	A	3	3	6	0	0	6	0	0
12	121652041	rs930186	G	T	9	3	12	0	0	12	0	0
12	121652277	rs930187	G	A	2	6	8	0	0	8	0	0
12	121652473	rs10849856	A	T	5	4	9	0	0	9	0	0
12	121654011	rs1169727	A	G	6	5	11	0	0	11	0	0
12	121656045	rs112778059	C	T	3	4	7	0	0	7	0	0
12	121656404	rs55780768	G	A	5	2	7	0	0	7	0	0
12	121658895	rs2686388	C	T	22	25	47	0	0	47	0	0
12	121659999	rs1629287	G	A	14	1	15	0	0	15	0	0
12	121660461	rs6489800	C	T	14	8	22	0	0	22	0	0
12	121660787	rs25643	T	C	54	48	102	0	0	102	0	0
12	121661614	rs11065494	A	C	2	6	8	0	0	8	0	0
12	121661688	rs11065495	C	T	4	5	9	0	0	9	0	0
12	121661700	rs10849858	A	G	4	4	8	0	0	8	0	0
12	121663245	rs112371853	G	A	8	2	10	0	0	10	0	0
12	121665011	rs2942063	A	G	8	7	15	0	0	15	0	0
12	121665084	rs73220298	C	A	10	7	17	0	0	17	0	0
12	121665334	rs2668235	C	T	3	4	7	0	0	7	0	0
12	121665853	rs2567992	A	G	7	7	14	0	0	14	0	0
12	121667102	rs58211692	G	T	9	6	15	0	0	15	0	0
12	121668254	rs10849860	T	C	5	8	13	0	0	13	0	0
12	121668474	rs2668252	A	C	11	9	20	0	0	20	0	0
12	121668789	rs200739133	T	A	7	2	9	0	0	9	0	0
12	121669145	rs1180051	A	G	10	6	16	0	0	16	0	0
12	121669631	rs111249465	A	G	13	7	20	0	0	20	0	0
12	121669769	rs112856277	C	T	12	8	20	0	0	20	0	0
12	121680570	.	G	A	5	2	7	0	0	7	0	0
12	121681536	rs1140886	C	T	13	12	25	0	1	26	0	0
12	121681687	rs1063843	T	C	10	11	21	0	0	21	0	0
12	121682051	rs2686340	T	C	7	6	13	0	0	13	0	0
12	121685188	rs2686342	T	A	4	3	7	0	0	7	0	0
12	121688026	rs1169809	G	A	4	3	7	0	0	7	0	0
12	121712077	rs3817190	T	A	6	17	23	0	0	23	0	0
12	121717956	rs7964571	C	T	2	5	7	0	0	7	0	0
12	121769904	rs12321214	C	T	7	2	9	0	0	9	0	0
12	121790178	rs11541850	G	A	24	13	37	0	0	37	0	0
12	121842268	rs10849877	G	A	4	6	10	0	0	10	0	0
12	121865301	rs11065569	T	C	5	1	6	0	0	6	0	0
12	121865865	rs951498	C	T	19	13	32	0	0	32	0	0
12	121870539	rs57971979	C	T	3	4	7	0	0	7	0	0
12	121870922	rs12427382	G	A	4	11	15	0	0	15	0	0
12	121871006	rs11065575	A	C	4	8	12	0	0	12	0	0
12	121878659	rs1064951	C	T	64	48	112	0	1	113	0	0
12	121880520	rs3751131	G	A	60	56	116	0	1	117	0	0
12	121881848	rs10849885	G	A	62	59	121	0	1	122	0	0
12	121882098	rs3817551	T	G	6	0	6	0	0	6	0	0
12	121882660	rs3817548	T	C	4	3	7	0	0	7	0	0
12	121882661	rs3817547	G	C	4	3	7	0	0	7	0	0
12	121882723	rs3817546	G	A	4	2	6	0	0	6	0	0
12	121882777	rs3817545	T	C	4	2	6	0	0	6	0	0
12	122211782	rs10082967	A	G	10	6	16	0	0	16	0	0
12	122211808	rs55695154	A	C	8	6	14	0	0	14	0	0
12	122212124	rs56012262	C	T	8	7	15	0	1	16	0	0
12	122212375	rs11043194	A	G	11	5	16	0	0	16	0	0
12	122212525	rs11043195	C	G	10	2	12	0	0	12	0	0
12	122212659	rs11043196	C	T	12	6	18	0	0	18	0	0
12	122212752	rs7314742	G	T	7	3	10	0	0	10	0	0
12	122214836	rs73413711	A	G	10	2	12	0	2	14	0	0
12	122215023	rs73413713	G	A	6	7	13	0	0	13	0	0
12	122215128	rs73413716	A	G	8	10	18	0	0	18	0	0
12	122215196	rs73413717	T	A	4	7	11	0	0	11	0	0
12	122215259	rs73413720	C	T	11	11	22	0	0	22	0	0
12	122215520	rs1064169	T	C	11	7	18	0	2	20	0	0
12	122215626	rs15797	C	A	13	10	23	0	0	23	0	0
12	122216036	rs1052202	A	G	237	235	472	0	2	474	0	0
12	122216221	rs143838180	G	A	160	178	338	0	4	342	0	0
12	122216622	rs3741590	A	G	236	223	459	0	2	461	0	0
12	122231573	rs2707066	C	T	15	2	17	0	0	17	0	0
12	122233495	rs712852	G	C	200	307	507	0	5	512	0	0
12	122234089	rs1168663	T	A	32	42	74	0	0	74	0	0
12	122234676	rs1168664	G	A	26	45	71	0	1	72	0	0
12	122234813	rs1168665	A	G	11	20	31	0	1	32	0	0
12	122237115	rs895951	A	G	10	24	34	0	0	34	0	0
12	122238300	rs1795966	G	A	4	5	9	0	0	9	0	0
12	122238380	rs1667578	T	G	6	3	9	0	0	9	0	0
12	122239074	rs1667579	C	A	7	8	15	0	0	15	0	0
12	122239608	rs1795965	A	G	7	13	20	0	0	20	0	0
12	122243905	rs1168666	C	T	38	27	65	0	1	66	0	0
12	122248582	rs895952	C	G	20	19	39	0	3	42	0	0
12	122262789	rs117325937	C	T	13	6	19	0	0	19	0	0
12	122263815	rs2122266	C	G	9	7	16	0	0	16	0	0
12	122268696	rs11043207	C	G	88	65	153	0	1	154	0	0
12	122355017	rs58642707	C	T	24	21	45	0	0	45	0	0
12	122355041	rs59695002	C	T	18	14	32	0	0	32	0	0
12	122468687	rs2272132	C	T	41	21	62	0	1	63	0	0
12	122492598	rs2280573	A	G	2	4	6	0	0	6	0	0
12	122497001	rs28629903	T	C	48	40	88	0	1	89	0	0
12	122498002	rs28384349	C	G	63	71	134	0	1	135	0	0
12	122499101	rs28643366	C	T	109	120	229	0	1	230	0	0
12	122614387	rs7487292	T	G	5	6	11	0	0	11	0	0
12	122615515	rs4758654	C	G	6	5	11	0	0	11	0	0
12	122616099	rs4758688	C	T	8	2	10	0	0	10	0	0
12	122616286	rs4758687	G	A	4	5	9	0	0	9	0	0
12	122616759	rs7955571	G	A	10	16	26	0	0	26	0	0
12	122616766	rs7955575	G	A	10	15	25	0	1	26	0	0
12	122617989	rs7978353	A	G	103	124	227	0	0	227	0	0
12	122618131	rs36045144	A	G	102	92	194	0	53	250	3	0
12	122619261	rs7964148	G	T	4	6	10	0	1	11	0	0
12	122623000	rs4758686	T	C	32	31	63	0	0	63	0	0
12	122623595	rs9668430	A	G	11	12	23	0	1	24	0	0
12	122624350	rs4758653	G	A	12	9	21	0	0	21	0	0
12	122625097	rs7962500	C	T	11	10	21	0	0	21	0	0
12	122625212	rs7488857	A	G	10	9	19	0	0	19	0	0
12	122626381	rs11057509	G	A	79	90	169	0	2	171	0	0
12	122626842	rs4758685	G	A	108	119	227	0	1	228	0	0
12	122628219	rs1047796	T	C	183	165	348	0	2	350	0	0
12	122628429	rs3741452	T	A	95	79	174	0	4	178	0	0
12	122628516	rs1047813	A	T	100	103	203	0	2	205	0	0
12	122629864	rs7312210	A	G	125	156	281	0	1	283	1	0
12	122630009	rs10744177	G	T	94	93	187	0	3	190	0	0
12	122630285	rs3809117	G	A	194	166	360	0	0	360	0	0
12	122630909	rs1043763	G	A	311	234	545	0	3	548	0	0
12	122630915	rs1043764	C	T	306	243	549	0	0	549	0	0
12	122631208	rs2017594	G	T	193	212	405	0	4	409	0	0
12	122631752	rs709284	T	C	374	259	633	0	2	635	0	0
12	122689244	rs12828049	C	T	3	3	6	0	0	6	0	0
12	122692820	rs12870	T	C	240	195	435	0	3	438	0	0
12	122693602	rs7957117	T	G	14	9	23	0	1	24	0	0
12	122693700	rs7298397	A	G	18	19	37	0	0	37	0	0
12	122701994	rs12826834	G	A	7	4	11	0	0	11	0	0
12	122703014	rs7963565	C	T	6	7	13	0	0	13	0	0
12	122708508	rs10846470	C	T	5	2	7	0	0	7	0	0
12	122715535	rs3809116	C	T	6	4	10	0	0	10	0	0
12	122716068	rs2068223	G	A	2	10	12	0	0	12	0	0
12	122716447	rs12816400	T	C	13	12	25	0	0	25	0	0
12	122756184	rs7388	A	T	13	18	31	0	0	31	0	0
12	122756342	rs10270	G	A	33	33	66	0	1	67	0	0
12	122759023	rs12809220	A	T	2	10	12	0	0	12	0	0
12	122759093	rs12815053	T	G	2	8	10	0	2	12	0	0
12	122760191	.	G	A	5	3	8	0	0	8	0	0
12	122812503	rs1129167	G	C	21	26	47	0	0	47	0	0
12	122852292	rs9788228	G	A	11	10	21	0	1	22	0	0
12	122853073	rs10846699	T	C	11	8	19	0	0	19	0	0
12	122853197	rs4758695	G	A	6	0	6	0	0	6	0	0
12	122854788	rs10846714	T	G	2	5	7	0	0	7	0	0
12	122855144	rs1553178	A	G	2	4	6	0	0	6	0	0
12	122856158	rs12818177	G	A	1	5	6	0	0	6	0	0
12	122856627	rs10773104	G	A	2	4	6	0	0	6	0	0
12	122865029	rs1803290	T	C	12	10	22	0	0	22	0	0
12	122963550	rs12369179	C	T	15	14	29	0	1	30	0	0
12	122964708	rs10846978	T	C	5	7	12	0	0	12	0	0
12	122970156	rs10773208	T	C	8	3	11	0	0	11	0	0
12	122985057	rs1473553	G	T	5	5	10	0	0	10	0	0
12	122989412	rs10998	G	A	56	49	105	0	0	105	0	0
12	122991279	rs11058480	C	T	18	16	34	0	0	34	0	0
12	122991478	rs9988963	C	G	8	6	14	0	0	14	0	0
12	123000055	rs61453559	T	C	3	4	7	0	0	7	0	0
12	123077485	rs10744287	T	A	13	16	29	0	1	30	0	0
12	123105143	rs2270775	C	T	125	65	190	0	2	192	0	0
12	123110910	rs189253549	T	A	7	8	15	0	0	15	0	0
12	123112356	rs7296826	G	A	2	5	7	0	0	7	0	0
12	123186880	.	C	T	116	0	116	0	0	116	0	0
12	123186900	.	G	A	100	0	100	0	3	103	0	0
12	123339358	rs2292137	C	G	4	2	6	0	0	6	0	0
12	123345509	rs34149579	G	T	79	79	158	0	0	158	0	0
12	123361339	.	T	C	76	77	153	0	0	153	0	0
12	123379193	rs11060623	C	T	8	7	15	0	0	15	0	0
12	123739088	rs184781816	G	A	5	6	11	0	0	11	0	0
12	123745869	rs1801957	C	T	356	324	680	0	4	684	0	0
12	123776650	rs143256181	C	T	10	8	18	0	0	18	0	0
12	123919687	rs1706475	A	G	3	5	8	0	0	8	0	0
12	123919969	rs1707730	T	C	3	3	6	0	0	6	0	0
12	123921264	rs28434767	G	T	12	17	29	0	1	30	0	0
12	124102894	rs79786297	G	A	3	8	11	0	1	12	0	0
12	124144964	.	G	A	25	16	41	0	0	41	0	0
12	124421453	rs9863	T	C	8	9	17	0	1	18	0	0
12	124427306	rs11057401	T	A	4	4	8	0	0	8	0	0
12	124496153	.	C	T	75	0	75	0	0	75	0	0
12	124496316	rs1054852	A	G	38	32	70	0	0	70	0	0
12	124496864	rs80197353	T	G	69	0	69	0	1	70	0	0
12	124498969	rs13012	G	A	134	0	134	0	0	134	0	0
12	124499476	.	T	C	110	90	200	0	2	202	0	0
12	124799387	rs904647	G	A	4	9	13	0	0	13	0	0
12	124799458	rs10846654	G	A	2	5	7	0	0	7	0	0
12	124799642	rs4765540	C	T	6	3	9	0	0	9	0	0
12	124800318	rs12551	T	C	1	12	13	0	0	13	0	0
12	124809920	.	A	C	13	0	13	0	3	16	0	0
12	124810174	rs10846657	G	A	2	4	6	0	1	7	0	0
12	124813316	rs74643464	C	T	5	3	8	0	0	8	0	0
12	124821666	rs61751354	G	A	35	21	56	0	0	56	0	0
12	124856618	rs7961196	A	G	21	17	38	0	1	39	0	0
12	124856660	rs3741513	T	A	15	18	33	0	2	35	0	0
12	124857033	rs7978237	C	T	16	16	32	0	2	34	0	0
12	124932357	rs111590000	C	G	2	6	8	0	0	8	0	0
12	124932363	rs111930690	C	T	2	8	10	0	0	10	0	0
12	124979789	rs872225	T	G	30	20	50	0	1	51	0	0
12	124979833	rs872224	C	G	11	22	33	0	0	33	0	0
12	124996667	rs61933581	A	G	5	7	12	0	0	12	0	0
12	125007040	rs77471279	T	C	3	4	7	0	0	7	0	0
12	125284748	rs5888	A	G	4	10	14	0	0	14	0	0
12	125396488	.	T	C	2139	163	2302	0	103	2405	0	0
12	125397061	rs17840844	G	A	377	238	615	0	2	617	0	0
12	125397364	rs8963	A	G	1938	709	2647	0	83	2736	6	0
12	125398039	rs1071862	G	C	1232	903	2135	0	93	2249	21	0
12	125399150	rs8397	G	A	796	867	1663	0	6	1670	1	0
12	125399167	rs13624	T	C	650	555	1205	0	8	1213	0	0
12	125431990	rs3803143	C	T	33	43	76	0	5	81	0	0
12	125434716	rs4078216	G	A	37	36	73	0	1	74	0	0
12	125439806	rs7959530	T	C	3	4	7	0	1	8	0	0
12	125448960	rs4076777	C	T	38	29	67	0	0	67	0	0
12	125451487	rs35364982	C	T	14	12	26	0	0	26	0	0
12	125451532	rs35177301	G	C	13	7	20	0	1	21	0	0
12	125451561	rs17879868	T	C	17	7	24	0	2	26	0	0
12	125451589	rs35874447	A	G	11	8	19	0	0	19	0	0
12	125626535	rs3751181	A	G	3	3	6	0	0	6	0	0
12	125627003	rs117276868	G	A	24	15	39	0	1	40	0	0
12	125627053	rs11058046	C	T	28	18	46	0	0	46	0	0
12	126001896	.	T	G	20	0	20	0	8	28	0	0
12	129278204	rs7965732	A	T	113	101	214	0	2	216	0	0
12	129286009	rs55670540	C	T	5	5	10	0	0	10	0	0
12	129289112	rs11059918	T	C	4	2	6	0	0	6	0	0
12	129291255	rs11610064	C	T	5	1	6	0	0	6	0	0
12	129291283	rs11610066	C	T	7	0	7	0	0	7	0	0
12	129291317	rs2170989	T	C	1	5	6	0	0	6	0	0
12	129293346	rs11059924	C	T	134	136	270	0	1	271	0	0
12	129294881	rs10773579	A	C	3	4	7	0	0	7	0	0
12	129294905	rs12831705	G	A	2	4	6	0	0	6	0	0
12	129299950	rs11610968	G	A	8	1	9	0	0	9	0	0
12	129299980	rs10744390	T	C	8	1	9	0	0	9	0	0
12	129300059	rs11059931	C	T	6	2	8	0	0	8	0	0
12	129300511	rs56756897	G	T	4	3	7	0	0	7	0	0
12	131305119	rs4759796	A	G	20	13	33	0	1	34	0	0
12	131356862	rs7970825	C	A	2	4	6	0	0	6	0	0
12	131360352	rs112060445	G	C	4	3	7	0	0	7	0	0
12	131360360	rs73461299	G	T	4	3	7	0	0	7	0	0
12	131361241	rs14035	C	T	26	21	47	0	0	47	0	0
12	132237750	rs1051219	C	T	133	120	253	0	3	256	0	0
12	132243928	rs10751692	T	C	3	3	6	0	0	6	0	0
12	132244801	rs7298593	C	T	5	5	10	0	0	10	0	0
12	132245026	rs7305121	A	T	8	2	10	0	0	10	0	0
12	132245981	rs10794425	G	C	7	7	14	0	0	14	0	0
12	132246500	rs11612242	T	A	3	4	7	0	1	8	0	0
12	132250213	rs2895143	C	G	104	88	192	0	2	194	0	0
12	132250712	rs1051233	G	C	169	148	317	0	1	318	0	0
12	132262911	rs75324057	A	T	4	3	7	0	0	7	0	0
12	132264053	rs11246803	C	T	7	3	10	0	0	10	0	0
12	132264110	rs11246804	G	A	8	6	14	0	0	14	0	0
12	132265166	rs35769880	G	A	4	5	9	0	0	9	0	0
12	132266763	rs12824836	T	C	16	12	28	0	0	28	0	0
12	132268844	rs73160793	A	C	3	3	6	0	0	6	0	0
12	132282082	rs78690272	C	A	6	2	8	0	0	8	0	0
12	132325239	rs6598163	G	A	4	2	6	0	0	6	0	0
12	132399004	rs74749868	C	G	88	64	152	0	1	154	1	0
12	132401566	rs11546871	C	T	74	65	139	0	0	139	0	0
12	132407008	rs3088051	T	C	318	319	637	0	3	640	0	0
12	132562126	rs73164912	G	A	78	81	159	0	3	162	0	0
12	132563675	.	C	T	19	21	40	0	0	40	0	0
12	132622706	.	C	T	81	71	152	0	0	152	0	0
12	132635521	rs7397057	T	C	4	7	11	0	0	11	0	0
12	132635779	rs12818246	C	T	7	8	15	0	0	15	0	0
12	132635989	rs11246947	A	G	10	8	18	0	0	18	0	0
12	132636400	rs11246948	G	A	3	11	14	0	0	14	0	0
12	133068820	.	C	T	5	2	7	0	1	8	0	0
12	133069134	rs1882297	G	A	4	2	6	0	0	6	0	0
12	133069139	rs11147223	G	T	3	4	7	0	0	7	0	0
12	133069698	rs12811407	G	A	1	5	6	0	0	6	0	0
12	133079987	rs11147271	G	A	2	4	6	0	0	6	0	0
12	133084202	rs79206283	G	T	5	2	7	0	0	7	0	0
12	133087707	rs3764049	C	G	33	69	102	0	0	102	0	0
12	133088165	rs3751297	G	A	41	74	115	0	1	116	0	0
12	133088290	rs3751300	G	T	51	79	130	0	0	130	0	0
12	133088370	rs11778	C	T	31	50	81	0	0	81	0	0
12	133129836	rs2875247	C	T	13	8	21	0	0	21	0	0
12	133130292	rs1574157	C	A	9	18	27	0	0	27	0	0
12	133136791	rs7973123	G	T	7	3	10	0	0	10	0	0
12	133140840	rs12809318	T	C	6	3	9	0	0	9	0	0
12	133140853	rs12826964	A	G	5	3	8	0	1	9	0	0
12	133141973	rs5023077	T	C	2	4	6	0	0	6	0	0
12	133142352	rs35969568	G	T	7	2	9	0	0	9	0	0
12	133142376	rs2875212	G	A	8	2	10	0	0	10	0	0
12	133142686	rs10870469	T	C	5	4	9	0	0	9	0	0
12	133142687	rs10870470	G	A	5	4	9	0	0	9	0	0
12	133149056	rs148231108	G	A	9	0	9	0	0	9	0	0
12	133153281	rs10870473	A	T	5	4	9	0	1	10	0	0
12	133155907	rs11146953	C	T	6	6	12	0	0	12	0	0
12	133159733	rs11550079	C	T	23	25	48	0	0	48	0	0
12	133202004	rs4883543	C	T	22	18	40	0	0	40	0	0
12	133205160	rs12230022	C	T	7	3	10	0	1	11	0	0
12	133205980	rs7487063	G	A	6	5	11	0	0	11	0	0
12	133206166	rs7485668	T	C	3	5	8	0	0	8	0	0
12	133207715	rs5745047	G	A	5	4	9	0	0	9	0	0
12	133208288	rs5745040	C	A	1	6	7	0	0	7	0	0
12	133208291	rs5745039	G	A	2	6	8	0	0	8	0	0
12	133208485	rs5745034	G	A	5	14	19	0	0	19	0	0
12	133208611	rs5745031	A	G	4	3	7	0	1	8	0	0
12	133208739	rs5745028	A	G	7	4	11	0	0	11	0	0
12	133208886	rs5745023	C	T	3	3	6	0	0	6	0	0
12	133212582	rs5744990	G	A	108	105	213	0	0	213	0	0
12	133217872	rs4883615	G	A	36	28	64	0	0	64	0	0
12	133219831	rs5744944	T	C	60	36	96	0	1	97	0	0
12	133220526	rs5744934	T	C	74	47	121	0	3	124	0	0
12	133221239	rs5744929	G	T	62	17	79	0	0	79	0	0
12	133221305	rs5744926	T	C	18	34	52	0	5	57	0	0
12	133222644	rs10781626	A	G	17	6	23	0	0	23	0	0
12	133222861	rs7958381	G	C	29	8	37	0	0	37	0	0
12	133223642	rs7973238	C	T	13	3	16	0	0	16	0	0
12	133223685	rs36118826	A	C	12	5	17	0	0	17	0	0
12	133224393	rs7954928	T	C	21	4	25	0	0	25	0	0
12	133224410	rs7974140	C	T	21	4	25	0	0	25	0	0
12	133225446	rs4883538	G	T	13	5	18	0	1	19	0	0
12	133236000	rs5744857	C	T	78	61	139	0	3	142	0	0
12	133243226	rs5744811	C	T	37	48	85	0	0	85	0	0
12	133243288	rs59762387	A	G	31	49	80	0	3	83	0	0
12	133243347	rs5744808	C	G	27	58	85	0	1	86	0	0
12	133243650	rs5744805	T	C	23	27	50	0	0	50	0	0
12	133243788	rs4883577	T	A	18	21	39	0	0	39	0	0
12	133249017	rs5744783	G	A	8	12	20	0	2	22	0	0
12	133249139	rs5744780	T	A	6	10	16	0	2	18	0	0
12	133250734	rs5744769	C	G	3	4	7	0	0	7	0	0
12	133253310	rs5744757	A	G	3	4	7	0	1	8	0	0
12	133253995	rs5744751	G	A	32	42	74	0	0	74	0	0
12	133259157	rs7307845	C	G	5	3	8	0	0	8	0	0
12	133259920	rs4128449	G	C	14	6	20	0	0	20	0	0
12	133260288	rs9630293	T	A	6	9	15	0	0	15	0	0
12	133260381	rs11147003	G	A	7	5	12	0	0	12	0	0
12	133261750	.	C	A	5	2	7	0	0	7	0	0
12	133272380	rs10781627	G	C	1	7	8	0	0	8	0	0
12	133272470	rs74727297	G	T	30	31	61	0	0	61	0	0
12	133278075	rs4883610	G	T	5	3	8	0	0	8	0	0
12	133278634	rs7131963	C	T	5	4	9	0	0	9	0	0
12	133281462	rs10007	G	A	20	7	27	0	0	27	0	0
12	133281476	rs7979132	G	A	21	7	28	0	0	28	0	0
12	133313227	rs7134465	A	G	11	3	14	0	0	14	0	0
12	133317460	rs35570604	G	A	7	4	11	0	1	12	0	0
12	133332709	rs118138073	T	C	2	4	6	0	0	6	0	0
12	133337352	rs7971299	G	A	4	7	11	0	0	11	0	0
12	133337805	rs6560901	A	G	9	8	17	0	0	17	0	0
12	133346212	rs13254	A	G	71	56	127	0	1	128	0	0
12	133359709	.	G	C	2	5	7	0	0	7	0	0
12	133363006	rs12823938	G	A	3	3	6	0	1	7	0	0
12	133384864	rs3741486	G	A	7	10	17	0	0	17	0	0
12	133389998	rs7134809	T	C	64	88	152	0	1	153	0	0
12	133391022	rs11836108	G	A	3	3	6	0	0	6	0	0
12	133399746	rs55960846	C	T	4	2	6	0	0	6	0	0
12	133400246	rs77000720	G	A	4	3	7	0	0	7	0	0
12	133401313	rs1564649	C	T	4	5	9	0	0	9	0	0
12	133401945	rs56240650	G	A	4	5	9	0	0	9	0	0
12	133404805	rs900448	C	G	6	4	10	0	0	10	0	0
12	133404828	rs3816761	G	A	4	6	10	0	0	10	0	0
12	133417285	rs8021	T	C	117	120	237	0	9	246	0	0
12	133417908	rs3741490	C	T	67	87	154	0	1	155	0	0
12	133418069	rs1045979	C	T	71	52	123	0	6	129	0	0
12	133419040	rs76060528	A	G	4	2	6	0	0	6	0	0
12	133423695	rs2306537	A	G	45	45	90	0	0	90	0	0
12	133428242	rs2306541	G	A	30	29	59	0	0	59	0	0
12	133430596	rs7977432	C	T	15	20	35	0	0	35	0	0
12	133435716	rs35011845	T	G	38	32	70	0	3	73	0	0
12	133456222	rs12822648	G	A	3	3	6	0	0	6	0	0
12	133498660	rs1278603	G	T	10	9	19	0	0	19	0	0
12	133498938	rs1278602	G	A	8	5	13	0	0	13	0	0
12	133501081	rs61951591	A	G	2	7	9	0	0	9	0	0
12	133682655	rs710945	A	G	15	16	31	0	0	31	0	0
12	133683261	rs905226	T	C	18	21	39	0	1	40	0	0
12	133683280	rs905225	A	T	21	23	44	0	0	44	0	0
12	133683628	rs1025	A	T	51	45	96	0	0	96	0	0
12	133683750	rs1026	C	A	29	20	49	0	5	54	0	0
12	133710501	rs7305560	T	A	4	2	6	0	0	6	0	0
12	133710824	rs7305166	A	G	5	4	9	0	0	9	0	0
12	133713440	rs11147250	G	A	7	2	9	0	0	9	0	0
12	133713814	rs11147251	T	G	5	6	11	0	0	11	0	0
12	133713921	rs10870584	C	A	6	6	12	0	1	13	0	0
12	133714791	rs12313498	T	A	8	5	13	0	0	13	0	0
12	133715587	rs10870585	G	T	6	3	9	0	0	9	0	0
12	133716744	rs77516785	G	A	6	7	13	0	0	13	0	0
12	133716808	.	A	G	8	0	8	0	1	9	0	0
12	133716904	rs55864270	C	T	5	5	10	0	0	10	0	0
12	133717054	rs59272889	A	G	7	4	11	0	0	11	0	0
12	133717204	rs12305745	A	G	6	6	12	0	0	12	0	0
12	133717224	rs73162477	G	A	5	5	10	0	1	11	0	0
12	133718507	rs11147252	A	C	14	11	25	0	0	25	0	0
12	133719122	rs73162479	G	A	17	11	28	0	0	28	0	0
12	133720563	rs12310357	C	A	18	24	42	0	1	43	0	0
12	133720865	rs11147253	C	T	15	15	30	0	0	30	0	0
12	133726921	rs6560923	C	T	4	3	7	0	0	7	0	0
12	133726951	rs6560924	A	G	5	4	9	0	0	9	0	0
12	133732624	rs3763151	C	T	59	59	118	0	1	119	0	0
12	133733678	rs12826062	A	T	26	21	47	0	0	47	0	0
12	133778796	rs7975069	C	T	19	12	31	0	0	31	0	0
12	133781428	rs36173379	A	C	16	28	44	0	0	44	0	0
12	133781605	rs4031	A	G	21	29	50	0	0	50	0	0
12	133782033	rs150579525	C	T	11	8	19	0	0	19	0	0
12	133782199	rs149232094	C	T	12	22	34	0	0	34	0	0
12	133782526	rs1134645	G	A	14	23	37	0	0	37	0	0
12	133782598	rs1134646	T	G	10	7	17	0	0	17	0	0
12	133783049	rs36179164	C	G	11	8	19	0	0	19	0	0
12	133783401	rs142879938	C	T	21	14	35	0	0	35	0	0
12	133783496	rs137879891	A	G	10	7	17	0	0	17	0	0
12	133787329	rs138369699	A	G	12	21	33	0	0	33	0	0
13	20242189	rs73166953	G	A	4	7	11	0	0	11	0	0
13	20277413	.	T	C	323	2	325	0	6	331	0	0
13	20278276	.	A	C	10	0	10	0	0	10	0	0
13	20416333	rs73168967	C	T	7	4	11	0	0	11	0	0
13	20421418	rs73168969	C	A	2	5	7	0	0	7	0	0
13	20645318	rs9509024	G	A	11	14	25	0	0	25	0	0
13	20645650	rs4769937	T	A	19	20	39	0	1	40	0	0
13	20652752	rs11618347	G	A	0	6	6	0	0	6	0	0
13	20656439	rs4769946	G	T	10	6	16	0	0	16	0	0
13	20978006	rs7165	A	G	26	39	65	0	2	67	0	0
13	20992831	rs7332444	T	C	7	5	12	0	0	12	0	0
13	21001140	rs9552174	A	G	5	3	8	0	0	8	0	0
13	21063524	rs14236	A	G	26	19	45	0	0	45	0	0
13	21086599	rs7139733	G	A	21	28	49	0	0	49	0	0
13	21237416	rs111647114	A	G	5	8	13	0	0	13	0	0
13	21354586	rs9315865	A	G	39	48	87	0	2	89	0	0
13	21356448	rs12867715	C	T	16	18	34	0	0	34	0	0
13	21356650	rs4617691	T	A	21	19	40	0	0	40	0	0
13	21357452	rs9509373	A	G	10	13	23	0	0	23	0	0
13	21366323	rs12873484	C	T	2	5	7	0	0	7	0	0
13	21366557	rs35584557	T	C	5	5	10	0	0	10	0	0
13	21366695	rs9506554	G	A	3	4	7	0	0	7	0	0
13	21367434	rs4463942	C	T	5	4	9	0	0	9	0	0
13	21367912	rs9509376	T	G	5	3	8	0	0	8	0	0
13	21368861	rs34884872	C	A	5	4	9	0	0	9	0	0
13	21561875	rs113977480	T	C	16	6	22	0	0	22	0	0
13	21719404	rs2148705	G	A	87	31	118	0	1	119	0	0
13	21720956	rs4620	C	T	932	784	1716	0	11	1727	0	0
13	21722190	rs1046530	C	G	107	119	226	0	1	227	0	0
13	21722557	rs3088071	A	G	2	6	8	0	0	8	0	0
13	21750890	rs9550716	G	A	10	13	23	0	1	24	0	0
13	21950709	rs41284199	T	C	57	55	112	0	1	113	0	0
13	21980547	rs9580103	T	G	7	10	17	0	0	17	0	0
13	21983767	rs9506671	C	T	6	7	13	0	0	13	0	0
13	21984416	rs143754778	C	T	5	2	7	0	0	7	0	0
13	21986320	rs9506674	T	C	4	4	8	0	0	8	0	0
13	24874926	rs947230	A	C	3	6	9	0	0	9	0	0
13	24875731	rs6490891	T	C	4	4	8	0	0	8	0	0
13	24875734	rs61946750	C	T	4	4	8	0	0	8	0	0
13	24875790	rs947229	G	A	4	2	6	0	0	6	0	0
13	24876070	rs947227	C	T	2	4	6	0	0	6	0	0
13	24876231	rs9580927	T	C	6	2	8	0	0	8	0	0
13	24876351	rs12585910	C	T	4	4	8	0	0	8	0	0
13	24876752	rs33990382	T	C	19	10	29	0	0	29	0	0
13	24877151	rs9580929	A	G	20	12	32	0	0	32	0	0
13	24877179	rs9578699	G	A	17	11	28	0	0	28	0	0
13	24877308	rs9578700	A	G	12	19	31	0	0	32	1	0
13	24877442	rs9580930	G	A	16	10	26	0	0	26	0	0
13	24877445	rs11149059	T	C	16	11	27	0	0	27	0	0
13	24877550	rs9580931	G	C	19	11	30	0	0	30	0	0
13	24878466	rs3803218	A	G	17	15	32	0	0	32	0	0
13	24880292	rs9511184	C	T	43	42	85	0	1	86	0	0
13	24880583	rs142290220	T	C	70	71	141	0	1	142	0	0
13	24995616	.	G	C	75	0	75	0	0	75	0	0
13	25052261	rs4770696	C	T	23	19	42	0	0	42	0	0
13	25075859	rs1539096	C	T	39	29	68	0	0	68	0	0
13	25082944	rs4770701	A	G	5	4	9	0	0	9	0	0
13	25084431	rs9553327	A	G	4	4	8	0	1	9	0	0
13	25086526	rs2282409	G	A	4	3	7	0	0	7	0	0
13	25161438	.	T	A	7	0	7	0	0	7	0	0
13	25487103	rs35498994	T	C	10	5	15	0	0	15	0	0
13	25671271	.	A	G	6	0	6	0	0	6	0	0
13	25671292	.	C	T	11	0	11	0	0	11	0	0
13	25671320	.	A	G	0	8	8	0	1	9	0	0
13	25876011	rs11556093	G	A	27	27	54	0	3	57	0	0
13	25916059	rs12491	T	C	40	56	96	0	1	97	0	0
13	26788114	rs301047	A	G	93	80	173	0	0	173	0	0
13	26796743	rs3759468	T	C	10	11	21	0	0	21	0	0
13	36857468	rs1998797	C	T	0	10	10	0	0	10	0	0
13	36857500	rs1998799	A	C	0	11	11	0	0	11	0	0
13	52334619	rs12856726	C	T	18	0	18	0	0	18	0	0
13	52352132	rs9535757	T	C	8	1	9	0	0	9	0	0
13	52507110	rs928169	G	C	5	3	8	0	0	8	0	0
13	52507175	rs77770386	C	A	6	4	10	0	1	11	0	0
13	52507710	rs79490882	G	A	5	1	6	0	1	7	0	0
13	52508702	rs115420019	G	T	4	7	11	0	0	11	0	0
13	52520507	rs1801246	C	T	2	4	6	0	0	6	0	0
13	52544805	rs1801244	C	G	1	11	12	0	0	12	0	0
13	52548140	rs1801243	A	C	3	5	8	0	0	8	0	0
13	52597888	rs6561656	A	G	8	1	9	0	0	9	0	0
13	52602919	rs3825528	A	C	1	5	6	0	0	6	0	0
13	52603194	rs3742289	G	T	4	2	6	0	0	6	0	0
13	52603775	rs3742291	C	T	3	4	7	0	0	7	0	0
13	52605675	rs2897964	A	G	2	4	6	0	0	6	0	0
13	52607169	rs1055062	T	C	1	6	7	0	0	7	0	0
13	52707240	rs3368	C	G	44	41	85	0	0	85	0	0
13	52744910	rs4369550	A	G	1	8	9	0	0	9	0	0
13	52765847	rs9535895	G	A	9	17	26	0	0	26	0	0
13	52987477	rs13431	G	C	9	4	13	0	0	13	0	0
13	52989863	rs1056335	C	T	14	8	22	0	1	23	0	0
13	52990717	rs4886018	C	T	3	3	6	0	0	6	0	0
13	52993412	rs9568732	G	A	3	3	6	0	0	6	0	0
13	52998697	rs4886077	G	T	4	2	6	0	1	7	0	0
13	53049492	rs74850630	G	A	11	14	25	0	0	25	0	0
13	53217035	rs9536211	C	A	81	74	155	0	3	158	0	0
13	53217270	rs9536212	A	G	136	127	263	0	1	264	0	0
13	53264106	rs9568751	T	C	3	3	6	0	0	6	0	0
13	64550085	rs34525356	A	C	4	2	6	0	0	6	0	0
13	64577497	rs9598695	A	T	3	11	14	0	0	14	0	0
13	64577532	rs9592311	A	G	4	13	17	0	0	17	0	0
13	64608552	rs269583	G	T	6	7	13	0	0	13	0	0
13	64631108	rs269568	A	G	4	5	9	0	0	9	0	0
13	64631242	rs269569	T	C	8	5	13	0	0	13	0	0
13	64631610	rs269572	C	T	6	6	12	0	0	12	0	0
13	72125641	rs9599855	A	C	7	4	11	0	0	11	0	0
13	73323447	rs117287297	A	G	5	6	11	0	0	11	0	0
13	73333369	rs12837	T	A	205	215	420	0	4	424	0	0
13	73353857	rs12867130	C	T	3	4	7	0	0	7	0	0
13	74261585	rs73214981	A	T	6	8	14	0	0	14	0	0
13	75861001	rs557337	A	G	4	4	8	0	0	8	0	0
13	75866284	rs9600455	G	A	5	2	7	0	0	7	0	0
13	76100639	rs1050235	A	G	205	162	367	0	4	371	0	0
13	77457608	.	T	A	9	11	20	0	1	21	0	0
13	78276296	rs6563017	C	A	4	3	7	0	0	7	0	0
13	80910851	rs11911	A	C	170	168	338	0	3	341	0	0
13	80911525	rs504122	G	A	178	165	343	0	1	344	0	0
13	80912101	rs563692	T	C	11	12	23	0	0	23	0	0
13	95059164	rs7988636	A	G	1	5	6	0	0	6	0	0
13	95235890	rs7330873	C	A	2	5	7	0	0	7	0	0
13	95238465	rs61965579	G	A	4	3	7	0	0	7	0	0
13	95238466	rs61965580	A	G	4	3	7	0	0	7	0	0
13	95279505	rs9524568	T	A	4	4	8	0	0	8	0	0
13	95280923	rs2298057	A	T	3	4	7	0	0	7	0	0
13	95281129	rs2298056	A	G	3	3	6	0	0	6	0	0
13	95281296	rs2298055	A	G	3	4	7	0	0	7	0	0
13	95672237	rs3770	G	A	10	8	18	0	0	18	0	0
13	95672950	rs1059751	A	G	17	18	35	0	0	35	0	0
13	95673135	rs4148553	C	T	11	13	24	0	0	24	0	0
13	95673518	rs4148551	T	C	10	9	19	0	0	19	0	0
13	95673791	rs3742106	A	C	2	4	6	0	0	6	0	0
13	97930890	rs6491347	A	G	6	15	21	0	0	21	0	0
13	97931564	rs9516887	G	A	14	15	29	0	0	29	0	0
13	97931709	rs9516888	A	G	29	24	53	0	0	53	0	0
13	97938649	rs9516890	T	C	5	6	11	0	0	11	0	0
13	97938866	rs4771989	A	C	2	5	7	0	0	7	0	0
13	98119524	rs12873919	T	C	9	15	24	0	0	24	0	0
13	98640318	rs592246	C	T	12	1	13	0	0	13	0	0
13	98675951	rs17190392	A	G	10	11	21	0	0	21	0	0
13	99103855	rs9517312	G	A	8	9	17	0	0	17	0	0
13	99104004	rs7988959	T	C	10	4	14	0	0	14	0	0
13	99104170	rs3742134	C	T	5	4	9	0	0	9	0	0
13	99104689	rs6956	T	C	220	218	438	0	3	441	0	0
13	99105302	rs12463	G	A	125	138	263	0	1	264	0	0
13	99105395	rs8481	G	A	109	128	237	0	6	243	0	0
13	99106979	rs9630321	C	G	3	4	7	0	0	7	0	0
13	99108729	rs41279124	G	A	19	13	32	0	0	32	0	0
13	99116384	rs17574378	T	C	9	6	15	0	0	15	0	0
13	99117149	rs3803253	G	A	5	4	9	0	0	9	0	0
13	99117685	rs7988345	A	G	6	4	10	0	0	10	0	0
13	99118590	rs9584854	C	T	7	5	12	0	0	12	0	0
13	99138057	rs17574433	G	A	10	2	12	0	0	12	0	0
13	99138353	rs7322911	C	T	3	6	9	0	0	9	0	0
13	99155547	rs9517328	A	T	5	5	10	0	0	10	0	0
13	99157379	rs72655629	G	A	5	6	11	0	0	11	0	0
13	99171326	rs12583333	C	T	9	2	11	0	0	11	0	0
13	99204003	rs72646403	G	A	4	2	6	0	1	7	0	0
13	99464698	rs150546405	G	C	12	0	12	0	0	12	0	0
13	99895264	rs9554576	G	A	4	3	7	0	0	7	0	0
13	99907341	rs3742130	G	A	5	12	17	0	1	18	0	0
13	99946853	rs3181718	C	T	4	6	10	0	0	10	0	0
13	99948178	rs2230342	C	A	57	54	111	0	0	111	0	0
13	100015539	rs9585040	T	C	4	5	9	0	0	9	0	0
13	100017105	rs723090	A	G	7	7	14	0	0	14	0	0
13	100022758	rs1923894	C	T	5	2	7	0	0	7	0	0
13	100038233	rs1058083	A	G	63	85	148	0	0	148	0	0
13	100038271	rs701537	A	T	75	101	176	0	1	177	0	0
13	100038336	rs1058143	T	C	91	108	199	0	0	199	0	0
13	100192140	rs17472806	G	A	5	8	13	0	0	13	0	0
13	100196608	rs9585122	C	A	4	6	10	0	0	10	0	0
13	100197070	rs17610676	T	C	5	7	12	0	0	12	0	0
13	100199224	rs3751373	C	T	14	10	24	0	0	24	0	0
13	100200172	rs4771335	T	C	9	6	15	0	0	15	0	0
13	100201026	rs4586288	C	T	11	14	25	0	0	25	0	0
13	100202369	rs9517767	C	A	4	2	6	0	0	6	0	0
13	100202844	rs79998592	T	C	3	5	8	0	0	8	0	0
13	100213186	rs9513628	C	G	23	16	39	0	0	39	0	0
13	100214363	rs17610732	A	T	34	30	64	0	0	65	1	0
13	100518580	rs3783185	A	G	6	5	11	0	0	11	0	0
13	100815683	rs9513736	T	C	3	3	6	0	0	6	0	0
13	100888122	rs538229	A	G	8	6	14	0	0	14	0	0
13	100991644	rs2390464	A	G	3	5	8	0	0	8	0	0
13	100991705	rs2390465	A	G	2	5	7	0	0	7	0	0
13	101167798	rs142646074	G	C	8	8	16	0	0	16	0	0
13	103269466	rs2148763	G	A	4	3	7	0	0	7	0	0
13	103418566	rs7963	A	G	20	11	31	0	1	32	0	0
13	103490239	rs75691303	G	A	3	3	6	0	0	6	0	0
13	107144320	rs9520087	G	A	4	5	9	0	0	9	0	0
13	108861913	rs1805386	A	G	4	5	9	0	0	9	0	0
13	108869355	rs12429072	G	C	2	5	7	0	0	7	0	0
13	108877629	rs1473792	T	C	1	6	7	0	0	7	0	0
13	108882748	rs9587535	A	G	21	16	37	0	1	38	0	0
13	108885156	rs55665720	A	G	11	6	17	0	0	17	0	0
13	108934045	rs8181791	G	A	6	1	7	0	0	7	0	0
13	110431574	rs7981170	C	T	7	4	11	0	0	11	0	0
13	110431626	rs4771648	G	A	3	3	6	0	0	6	0	0
13	110431891	rs7981705	C	T	4	5	9	0	0	9	0	0
13	110435231	rs1805097	C	T	11	23	34	0	0	34	0	0
13	111185709	rs9559838	A	T	4	3	7	0	0	7	0	0
13	111209413	rs9521840	C	T	9	4	13	0	0	13	0	0
13	111283960	rs379324	A	C	5	4	9	0	0	9	0	0
13	111284417	rs412822	G	A	3	3	6	0	0	6	0	0
13	111284941	rs55794132	C	G	4	7	11	0	1	12	0	0
13	111285717	rs422789	C	T	3	3	6	0	0	6	0	0
13	111285726	rs180675320	T	C	3	3	6	0	0	6	0	0
13	111285807	rs2986320	G	T	3	3	6	0	0	6	0	0
13	111285857	rs381033	A	G	4	3	7	0	1	8	0	0
13	111286592	rs3759463	C	T	4	2	6	0	0	6	0	0
13	111286607	rs179356	G	A	3	3	6	0	0	6	0	0
13	111287332	.	C	T	7	9	16	0	0	16	0	0
13	111288461	rs330572	A	G	10	5	15	0	1	16	0	0
13	111290364	rs191322	C	A	27	22	49	0	0	49	0	0
13	111290628	rs41275124	G	C	18	17	35	0	0	35	0	0
13	111290630	rs41275126	T	C	19	17	36	0	0	36	0	0
13	111290880	rs330563	G	A	57	45	102	0	1	103	0	0
13	111290967	rs41275128	T	C	44	20	64	0	0	64	0	0
13	111291044	rs330564	T	C	47	24	71	0	0	71	0	0
13	111291247	rs330566	G	A	67	33	100	0	2	102	0	0
13	111291256	rs424943	G	A	82	28	110	0	1	111	0	0
13	111291266	rs74127059	T	C	80	30	110	0	0	110	0	0
13	111291538	rs16940507	T	C	69	37	106	0	1	107	0	0
13	111291622	rs11551105	G	A	94	46	140	0	1	141	0	0
13	111292044	rs7394	A	G	70	45	115	0	0	115	0	0
13	111293847	rs330570	G	A	66	66	132	0	1	133	0	0
13	111293915	rs1043886	T	G	109	116	225	0	0	225	0	0
13	111295695	rs7324648	C	A	14	16	30	0	1	31	0	0
13	111296335	rs3818497	T	G	40	21	61	0	0	62	1	0
13	111300897	rs451270	C	T	4	3	7	0	0	7	0	0
13	111315299	rs4622384	T	C	2	4	6	0	0	6	0	0
13	111531264	rs6829	C	T	129	127	256	0	2	258	0	0
13	111531483	rs3180286	G	A	197	202	399	0	4	403	0	0
13	111531742	rs3809343	A	G	133	142	275	0	3	278	0	0
13	111531885	rs1547178	C	A	102	90	192	0	4	196	0	0
13	111533606	rs143872712	T	G	20	17	37	0	2	39	0	0
13	111534577	rs75292703	G	A	9	15	24	0	0	24	0	0
13	111535439	rs67008969	T	C	6	2	8	0	1	9	0	0
13	111536743	rs6492325	T	C	3	8	11	0	0	11	0	0
13	111537606	rs7332021	G	A	4	5	9	0	1	10	0	0
13	111537692	rs7332214	G	A	3	5	8	0	0	8	0	0
13	111538047	rs7332528	A	G	0	7	7	0	0	7	0	0
13	111538096	rs9588291	C	T	4	2	6	0	0	6	0	0
13	111538525	rs75533516	T	G	6	4	10	0	0	10	0	0
13	111538590	rs1926715	A	G	4	6	10	0	0	10	0	0
13	111540499	rs9583545	C	T	10	3	13	0	0	13	0	0
13	111540560	rs9521977	T	C	3	7	10	0	0	10	0	0
13	111541321	rs7319481	T	C	5	3	8	0	1	9	0	0
13	111543043	rs9515307	G	A	14	8	22	0	0	22	0	0
13	111543106	rs7994149	C	T	13	10	23	0	0	23	0	0
13	111543277	rs72665842	G	A	9	5	14	0	0	14	0	0
13	111547103	rs116355942	T	A	17	16	33	0	1	34	0	0
13	111547130	rs9521982	T	C	17	14	31	0	1	32	0	0
13	111547210	rs9521983	T	C	13	4	17	0	1	18	0	0
13	111547760	rs11618215	G	T	17	19	36	0	0	36	0	0
13	111548261	rs2148568	C	T	40	36	76	0	0	76	0	0
13	111548896	rs77579810	A	G	45	29	74	0	1	75	0	0
13	111549458	rs67357970	T	G	8	24	32	0	0	32	0	0
13	111549722	rs1134348	C	T	7	17	24	0	0	24	0	0
13	111549790	rs13343	C	T	18	18	36	0	0	36	0	0
13	111550791	rs66681527	C	T	16	16	32	0	0	32	0	0
13	111551103	rs546942140	T	C	21	1	22	0	1	23	0	0
13	111551920	rs3205743	T	C	13	14	27	0	0	27	0	0
13	111552119	rs4773270	G	A	9	11	20	0	1	21	0	0
13	111552215	rs74545222	T	C	10	8	18	0	1	19	0	0
13	111553839	rs9521986	A	T	11	4	15	0	0	15	0	0
13	111553865	rs74899630	C	G	11	6	17	0	0	17	0	0
13	111555363	rs9515308	C	A	10	10	20	0	0	20	0	0
13	111555372	rs9515309	A	G	9	10	19	0	0	19	0	0
13	111555592	rs9521987	G	A	18	11	29	0	0	29	0	0
13	111556343	rs2391876	A	T	6	10	16	0	0	16	0	0
13	111557327	rs146342821	A	G	8	5	13	0	0	13	0	0
13	111557399	rs7987467	G	A	6	7	13	0	0	13	0	0
13	111557432	.	A	C	10	3	13	0	0	13	0	0
13	111557849	rs34123604	A	C	4	2	6	0	0	6	0	0
13	111567385	rs4773274	T	C	1	5	6	0	0	6	0	0
13	111806245	rs61966721	A	G	8	4	12	0	0	12	0	0
13	111858742	rs11617467	A	C	1	5	6	0	0	6	0	0
13	111886057	rs9583590	T	C	23	12	35	0	0	35	0	0
13	111933098	rs2296353	C	G	9	21	30	0	0	30	0	0
13	111933998	rs7983485	C	T	30	13	43	0	1	44	0	0
13	111937652	rs7985658	C	T	13	5	18	0	0	18	0	0
13	111943932	rs9515399	G	A	2	4	6	0	0	6	0	0
13	111944710	.	T	G	11	11	22	0	0	22	0	0
13	111946651	rs41275852	C	T	30	12	42	0	0	42	0	0
13	111954634	rs4773341	G	A	5	2	7	0	0	7	0	0
13	111956103	rs3783083	A	G	57	88	145	0	0	145	0	0
13	111968680	rs7991693	C	T	2	5	7	0	0	7	0	0
13	111968907	rs12427765	A	G	5	3	8	0	0	8	0	0
13	113363755	rs12427584	G	A	10	11	21	0	0	21	0	0
13	113481088	rs144248225	C	T	8	11	19	0	0	19	0	0
13	113527967	rs1320525	G	A	9	6	15	0	0	15	0	0
13	113531357	rs9549595	A	G	13	9	22	0	1	23	0	0
13	113531469	rs9549596	C	T	13	5	18	0	0	18	0	0
13	113532076	rs9549315	G	A	4	11	15	0	0	15	0	0
13	113532224	rs2297801	C	T	6	1	7	0	0	7	0	0
13	113532990	rs1278761	T	C	3	6	9	0	0	9	0	0
13	113533113	rs9549597	G	A	4	6	10	0	0	10	0	0
13	113534382	rs1278766	T	C	5	2	7	0	0	7	0	0
13	113534907	rs9577174	T	C	4	2	6	0	0	6	0	0
13	113535742	rs9549317	A	G	4	3	7	0	0	7	0	0
13	113536132	rs1290177	T	C	7	4	11	0	0	11	0	0
13	113536467	rs36048052	G	A	17	9	26	0	1	27	0	0
13	113537311	rs3742232	C	T	13	18	31	0	1	32	0	0
13	113537448	rs3742233	G	A	23	19	42	0	0	42	0	0
13	113539523	rs1063098	G	A	17	11	28	0	0	28	0	0
13	113539688	rs1140048	A	C	17	13	30	0	0	30	0	0
13	113539894	rs1046793	C	T	18	16	34	0	1	35	0	0
13	113540004	rs1046790	T	C	8	29	37	0	1	38	0	0
13	113540304	rs9549598	C	T	13	11	24	0	0	24	0	0
13	113540395	rs9549599	C	T	11	13	24	0	0	24	0	0
13	113752573	rs73578937	G	A	7	1	8	0	0	8	0	0
13	113867371	rs184134540	A	G	10	10	20	0	0	20	0	0
13	113875080	rs56129102	C	T	88	100	188	0	0	188	0	0
13	113918770	rs11552924	A	C	41	39	80	0	0	80	0	0
13	113979880	rs55866528	G	A	2	6	8	0	0	8	0	0
13	114113038	rs9577554	C	T	1	5	6	0	0	6	0	0
13	114138852	rs80006447	C	T	2	4	6	0	0	6	0	0
13	114156898	.	C	T	5	4	9	0	0	9	0	0
13	114292561	rs143805038	G	A	11	9	20	0	0	20	0	0
13	114519139	.	A	G	6	1	7	0	0	7	0	0
13	114519203	.	G	C	6	0	6	0	0	6	0	0
13	114519418	rs72670693	C	A	3	6	9	0	0	9	0	0
13	114519485	rs113194252	A	C	5	3	8	0	0	8	0	0
13	114519681	rs72670688	C	T	4	3	7	0	0	7	0	0
13	114519894	rs12860172	T	C	4	7	11	0	0	11	0	0
13	114522595	rs7999037	T	C	6	5	11	0	3	14	0	0
13	114522858	rs72670681	G	A	8	16	24	0	0	24	0	0
13	114523222	rs11843762	A	G	8	10	18	0	0	18	0	0
13	114542858	rs9604573	G	A	5	2	7	0	0	7	0	0
13	114542957	rs9604489	C	G	3	4	7	0	0	7	0	0
13	114544024	rs7140110	T	C	10	1	11	0	0	11	0	0
13	114544119	rs7337498	G	A	8	1	9	0	0	9	0	0
13	114544125	rs6602913	A	C	8	1	9	0	0	9	0	0
13	114544155	rs7337339	G	A	6	1	7	0	0	7	0	0
13	114545031	rs12019772	T	C	10	0	10	0	3	13	0	0
13	114545036	rs113307397	C	T	13	0	13	0	0	13	0	0
13	114545100	rs34241719	A	G	15	2	17	0	2	19	0	0
13	114545317	rs9577924	A	G	20	8	28	0	0	28	0	0
13	114548163	rs9577923	C	G	6	1	7	0	0	7	0	0
13	114557938	rs6602907	A	G	4	5	9	0	0	9	0	0
13	114558628	rs9577865	C	T	3	6	9	0	0	9	0	0
13	114559422	rs7997328	A	G	4	17	21	0	0	21	0	0
13	114559522	rs8000868	C	T	5	15	20	0	0	20	0	0
13	114748139	rs11552972	A	G	136	132	268	0	3	271	0	0
13	114748384	rs11552971	C	T	82	86	168	0	0	168	0	0
13	114758331	rs868521	G	A	3	6	9	0	0	9	0	0
13	114762844	rs9525175	C	T	6	1	7	0	0	7	0	0
13	114773126	rs9562086	C	T	11	8	19	0	0	19	0	0
13	114774698	rs6560942	T	C	6	4	10	0	0	10	0	0
13	114774813	rs6560943	C	T	5	3	8	0	0	8	0	0
13	114775345	rs2297098	C	T	30	27	57	0	0	57	0	0
13	114775538	rs2297099	T	A	31	25	56	0	0	56	0	0
13	114775708	rs2297100	C	T	26	17	43	0	0	43	0	0
13	114775711	rs2297101	C	T	25	17	42	0	0	42	0	0
13	114775783	rs2297102	A	G	22	19	41	0	0	41	0	0
13	114780764	rs2274717	A	G	71	44	115	0	0	115	0	0
13	114782779	rs61749934	G	A	57	70	127	0	1	128	0	0
13	114848948	rs9525387	C	T	6	3	9	0	0	9	0	0
13	114848963	rs9525388	G	A	5	2	7	0	0	7	0	0
13	114891196	rs9525277	T	C	10	17	27	0	0	27	0	0
13	115027759	rs9525312	G	C	7	2	9	0	0	9	0	0
13	115047700	rs9590410	A	T	6	5	11	0	0	11	0	0
13	115053155	rs7327124	T	C	38	47	85	0	2	87	0	0
14	20755287	rs1057605	C	A	8	8	16	0	0	16	0	0
14	20755790	rs61995495	A	G	13	8	21	0	1	22	0	0
14	20757518	rs45622542	C	T	22	20	42	0	0	42	0	0
14	20764585	rs1953552	A	C	8	9	17	0	0	17	0	0
14	20784718	rs1132644	G	T	217	185	402	0	1	403	0	0
14	20785289	rs7142395	T	C	2	4	6	0	0	6	0	0
14	20785514	rs61995513	G	A	6	8	14	0	0	14	0	0
14	20785555	rs28500547	C	T	8	6	14	0	0	14	0	0
14	20785793	rs61995534	C	T	3	5	8	0	0	8	0	0
14	20786575	rs61995535	T	C	3	9	12	0	0	12	0	0
14	20788159	rs61995536	G	A	8	2	10	0	0	10	0	0
14	20793013	rs6575168	C	G	5	1	6	0	0	6	0	0
14	20823052	rs3093926	G	A	92	86	178	0	1	179	0	0
14	20824181	rs3093930	T	C	153	162	315	0	1	316	0	0
14	20825013	rs878157	C	T	6	5	11	0	0	11	0	0
14	20825323	rs200223594	T	G	17	11	28	0	0	28	0	0
14	20825362	rs3093939	G	A	14	12	26	0	1	27	0	0
14	20834548	rs1713419	A	G	4	4	8	0	0	8	0	0
14	20834809	rs1713418	A	G	4	11	15	0	0	15	0	0
14	20837033	rs2104978	T	C	13	14	27	0	2	29	0	0
14	20847876	rs74743908	T	G	3	3	6	0	0	6	0	0
14	20914598	rs66761532	G	A	0	6	6	0	0	6	0	0
14	20916249	rs2275008	T	C	35	6	41	0	0	41	0	0
14	20916958	rs938883	T	C	176	109	285	0	9	294	0	0
14	20916987	rs938882	G	A	7	5	12	0	0	12	0	0
14	20917442	rs938881	A	T	89	76	165	0	3	168	0	0
14	20917744	rs883037	C	T	50	46	96	0	3	99	0	0
14	20918113	rs8015086	A	G	36	18	54	0	0	54	0	0
14	20918245	rs3120072	T	C	12	12	24	0	2	26	0	0
14	20918598	rs3120071	A	C	32	20	52	0	1	53	0	0
14	20919097	rs3120070	T	C	10	3	13	0	0	13	0	0
14	20919188	rs3094277	G	A	13	3	16	0	0	16	0	0
14	20919192	rs3120069	C	T	13	4	17	0	0	17	0	0
14	20919551	rs3120068	C	T	26	4	30	0	0	30	0	0
14	20919623	rs3120067	T	C	10	8	18	0	2	20	0	0
14	20919667	rs3120066	C	T	9	4	13	0	0	13	0	0
14	20919712	rs3120065	C	T	26	3	29	0	0	29	0	0
14	20920043	rs1320150	C	T	37	16	53	0	2	55	0	0
14	20920250	rs2275007	T	C	54	32	86	0	1	87	0	0
14	20920340	rs2275006	A	G	23	4	27	0	1	28	0	0
14	20920749	rs1878703	C	G	10	1	11	0	0	11	0	0
14	20921053	rs3762147	G	A	4	3	7	0	0	7	0	0
14	20922351	rs36219439	G	A	9	0	9	0	0	9	0	0
14	20922994	rs3120064	C	A	2	6	8	0	0	8	0	0
14	20923007	rs3120063	C	A	2	6	8	0	0	8	0	0
14	20925154	rs1130409	T	G	551	439	990	0	8	999	1	0
14	20925669	rs17112002	A	T	773	865	1638	0	6	1645	1	0
14	20927267	rs74533796	C	T	27	29	56	0	0	56	0	0
14	20940515	rs1049562	C	T	256	113	369	0	2	371	0	0
14	20940606	rs1049564	G	A	291	159	450	0	4	454	0	0
14	20940626	rs1130650	C	T	317	184	501	0	4	505	0	0
14	20940834	rs1713422	A	G	14	4	18	0	0	18	0	0
14	20941413	rs1617940	T	A	13	5	18	0	0	18	0	0
14	20941613	rs1760935	A	G	11	2	13	0	0	13	0	0
14	20942013	rs17880405	G	A	12	0	12	0	0	12	0	0
14	20942063	rs1760934	T	C	9	4	13	0	0	13	0	0
14	20942451	rs1713421	T	G	13	4	17	0	0	17	0	0
14	20942744	rs1713420	A	G	45	21	66	0	1	67	0	0
14	20943504	rs1756369	T	A	3	3	6	0	0	6	0	0
14	20943902	rs533712362	C	T	5	1	6	0	0	6	0	0
14	21250124	rs1045922	G	A	6	4	10	0	0	10	0	0
14	21360216	rs2073342	C	G	160	545	705	0	5	710	0	0
14	21360344	rs2233860	G	C	650	161	811	0	3	814	0	0
14	21387994	rs10459477	A	G	1	10	11	0	0	11	0	0
14	21388266	rs3748340	G	C	1	16	17	0	0	17	0	0
14	21388302	rs3748341	G	A	1	19	20	0	0	20	0	0
14	21388397	rs12147654	C	T	7	1	8	0	0	8	0	0
14	21460902	rs2741738	T	C	4	2	6	0	0	6	0	0
14	21461502	rs2783779	A	G	18	29	47	0	0	47	0	0
14	21461836	rs2783802	A	G	27	29	56	0	1	57	0	0
14	21485506	rs10196	T	C	26	19	45	0	0	45	0	0
14	21548930	.	G	A	15	13	28	0	0	28	0	0
14	21558558	rs6571653	G	C	97	75	172	0	0	173	1	0
14	21674374	.	T	A	10	14	24	0	0	24	0	0
14	21674392	rs1243371	C	T	17	10	27	0	0	27	0	0
14	21677694	rs7495	T	C	274	209	483	0	1	484	0	0
14	21678416	rs17113516	G	C	299	236	535	0	4	539	0	0
14	21698859	rs7148674	C	T	5	12	17	0	0	17	0	0
14	21703444	rs4981367	G	A	7	2	9	0	0	9	0	0
14	21703589	rs17102712	A	G	2	4	6	0	0	6	0	0
14	21724070	rs7142957	G	A	16	21	37	0	0	37	0	0
14	21724726	rs6571734	G	A	4	4	8	0	0	8	0	0
14	21727084	rs12878905	C	T	3	3	6	0	0	6	0	0
14	21733820	rs35052312	T	G	5	3	8	0	0	8	0	0
14	21819061	rs6571770	G	T	20	34	54	0	0	54	0	0
14	21820029	rs2295865	A	C	169	199	368	0	4	372	0	0
14	21825924	rs3762156	T	C	3	3	6	0	0	6	0	0
14	21829129	rs3762158	C	G	80	69	149	0	1	151	1	0
14	21831052	rs10138699	T	C	97	90	187	0	2	189	0	0
14	21831419	rs61746713	C	T	86	89	175	0	0	175	0	0
14	21854711	rs17197107	T	C	6	10	16	0	0	16	0	0
14	21855880	rs11623642	A	G	4	4	8	0	0	8	0	0
14	21856080	rs11624716	T	C	4	5	9	0	0	9	0	0
14	21857330	rs1998331	A	G	2	5	7	0	0	7	0	0
14	21857431	rs142017737	C	T	3	6	9	0	0	9	0	0
14	21859536	rs3762159	T	C	7	8	15	0	0	15	0	0
14	21860360	rs1998332	G	A	5	5	10	0	0	10	0	0
14	21871653	rs8022395	C	T	51	42	93	0	0	93	0	0
14	21875487	rs7147024	T	C	10	10	20	0	0	20	0	0
14	21927276	rs1045842	C	T	94	85	179	0	2	181	0	0
14	21928745	.	C	A	5	2	7	0	4	11	0	0
14	21932592	rs11628702	C	T	4	3	7	0	0	7	0	0
14	21934603	rs56267245	G	A	5	3	8	0	0	8	0	0
14	21939302	rs7157640	A	G	2	4	6	0	0	6	0	0
14	21939621	rs7157563	C	G	2	4	6	0	0	6	0	0
14	21940730	rs6571844	T	A	3	3	6	0	0	6	0	0
14	21940886	rs6571846	C	T	4	3	7	0	0	7	0	0
14	21940905	rs7158389	A	T	4	3	7	0	0	7	0	0
14	21942279	rs7141654	G	A	5	5	10	0	0	10	0	0
14	21955930	rs1061031	G	A	13	27	40	0	0	40	0	0
14	21960816	rs1060722	T	C	80	81	161	0	5	166	0	0
14	21960969	rs7617	G	A	81	89	170	0	0	170	0	0
14	21963809	rs933192	C	A	4	7	11	0	0	11	0	0
14	21967916	rs1139130	A	G	29	32	61	0	0	61	0	0
14	21968619	rs1263790	A	G	8	5	13	0	0	13	0	0
14	21969672	rs1263791	A	T	12	5	17	0	0	17	0	0
14	21970091	rs1263792	C	T	5	2	7	0	0	7	0	0
14	21970379	rs1263793	A	G	7	7	14	0	0	14	0	0
14	21970410	rs966602	A	G	10	7	17	0	0	17	0	0
14	21970849	rs1263795	A	G	10	9	19	0	0	19	0	0
14	21972429	.	G	T	13	12	25	0	0	25	0	0
14	21974415	rs1263796	T	C	4	2	6	0	1	7	0	0
14	21976052	rs17197156	C	G	19	20	39	0	0	39	0	0
14	21976476	rs1268403	T	C	3	5	8	0	1	9	0	0
14	21977006	rs1263798	A	G	11	5	16	0	0	16	0	0
14	21977092	rs1263799	C	A	12	7	19	0	0	19	0	0
14	21977316	rs1263800	T	C	11	8	19	0	0	19	0	0
14	21977672	rs1754626	G	T	18	8	26	0	0	26	0	0
14	21977673	rs1794219	C	G	18	8	26	0	0	26	0	0
14	21977962	rs17197170	A	G	7	8	15	0	0	15	0	0
14	21978884	rs1263801	G	C	25	20	45	0	0	45	0	0
14	21989829	rs3177954	T	C	10	9	19	0	0	19	0	0
14	21990537	rs1124981	G	A	2	6	8	0	0	8	0	0
14	22887730	rs2301201	A	G	10	10	20	0	0	20	0	0
14	23020919	rs3700	C	T	14	20	34	0	0	34	0	0
14	23020921	rs3701	G	C	15	20	35	0	0	35	0	0
14	23020970	rs3702	G	T	7	7	14	0	0	14	0	0
14	23021039	rs9125	G	A	3	3	6	0	0	6	0	0
14	23044002	rs7621	G	T	184	197	381	0	4	385	0	0
14	23058084	rs1051101	A	G	33	34	67	0	1	68	0	0
14	23073608	rs1242922	T	C	4	2	6	0	0	6	0	0
14	23237835	rs6572731	C	T	32	28	60	0	1	61	0	0
14	23239512	rs2075846	A	G	147	175	322	0	1	323	0	0
14	23240882	.	G	A	395	344	739	0	6	745	0	0
14	23282449	rs1805059	C	T	3	3	6	0	0	6	0	0
14	23349953	rs35956093	A	G	19	22	41	0	2	43	0	0
14	23371055	rs1127066	G	C	78	77	155	0	0	155	0	0
14	23387823	.	T	G	5	6	11	0	0	11	0	0
14	23516435	rs3197716	A	G	36	27	63	0	0	63	0	0
14	23518068	rs8006527	G	T	8	9	17	0	0	17	0	0
14	23518791	rs2295689	A	G	3	3	6	0	0	6	0	0
14	23518918	rs11623976	T	C	19	12	31	0	0	31	0	0
14	23530908	rs56402910	C	T	3	3	6	0	0	6	0	0
14	23531507	rs12896019	G	A	4	6	10	0	0	10	0	0
14	23533923	rs56066925	T	C	8	13	21	0	0	21	0	0
14	23541441	rs55833875	C	A	7	11	18	0	0	18	0	0
14	23542399	rs75568395	T	C	6	3	9	0	0	9	0	0
14	23549319	rs1885097	A	G	89	102	191	0	3	194	0	0
14	23549380	rs1885098	G	A	98	84	182	0	1	183	0	0
14	23549785	rs3811182	T	C	118	92	210	0	0	210	0	0
14	23565012	rs8003631	C	T	16	10	26	0	0	26	0	0
14	23565603	rs2331832	C	T	8	10	18	0	0	18	0	0
14	23565785	rs7142934	A	T	4	7	11	0	0	11	0	0
14	23778811	rs117138993	G	C	42	36	78	0	1	79	0	0
14	23779877	rs3210043	C	A	27	44	71	0	0	71	0	0
14	23788721	rs117040032	G	C	3	5	8	0	0	8	0	0
14	23789955	rs34074573	A	G	6	3	9	0	0	9	0	0
14	23792416	rs45508899	A	C	12	19	31	0	5	36	0	0
14	23793305	rs45528934	C	T	24	22	46	0	0	46	0	0
14	23848311	rs723840	C	T	25	13	38	0	0	38	0	0
14	23942535	rs10142383	G	C	6	0	6	0	0	6	0	0
14	23942761	rs11622733	T	C	4	2	6	0	0	6	0	0
14	23943469	rs7151139	A	G	6	2	8	0	0	8	0	0
14	23943918	rs7154379	G	A	5	1	6	0	0	6	0	0
14	23944020	rs6573195	A	G	7	0	7	0	0	7	0	0
14	23944505	rs2236260	G	A	173	212	385	0	4	389	0	0
14	23944514	rs2236261	C	A	181	229	410	0	2	412	0	0
14	23945366	rs2295706	A	G	20	6	26	0	0	26	0	0
14	23947374	rs1956950	G	A	8	10	18	0	0	18	0	0
14	24026493	rs34015250	A	G	3	6	9	0	0	9	0	0
14	24032091	rs2281679	G	C	22	25	47	0	0	47	0	0
14	24033027	rs12897422	G	A	68	95	163	0	2	165	0	0
14	24408954	rs1885811	A	G	8	0	8	0	0	8	0	0
14	24409799	rs113551151	A	G	5	2	7	0	0	7	0	0
14	24422995	rs4457918	T	G	11	14	25	0	1	26	0	0
14	24423007	rs17099455	G	A	16	16	32	0	0	32	0	0
14	24423090	rs2273944	A	G	28	13	41	0	0	41	0	0
14	24424367	rs12147221	G	A	15	16	31	0	1	32	0	0
14	24438189	rs4706	C	A	51	102	153	0	1	154	0	0
14	24446336	rs80309124	G	T	3	3	6	0	0	6	0	0
14	24456401	rs8004540	G	A	4	3	7	0	0	7	0	0
14	24458162	rs2273946	G	C	11	23	34	0	0	34	0	0
14	24459443	rs45579231	G	C	32	11	43	0	0	43	0	0
14	24459493	rs60865462	G	A	9	21	30	0	2	32	0	0
14	24459520	rs45583341	T	C	8	15	23	0	1	24	0	0
14	24470138	rs1811890	C	T	13	9	22	0	0	22	0	0
14	24470231	.	T	G	15	1	16	0	0	16	0	0
14	24475215	.	G	C	44	3	47	0	1	48	0	0
14	24475318	rs75949238	C	A	45	10	55	0	0	55	0	0
14	24475564	rs7267	A	G	13	11	24	0	0	24	0	0
14	24538727	rs75871902	C	T	2	5	7	0	0	7	0	0
14	24550224	rs3561	C	T	3	5	8	0	0	8	0	0
14	24609534	rs10873178	T	G	6	13	19	0	1	20	0	0
14	24610733	rs2236352	T	C	14	5	19	0	0	19	0	0
14	24615435	rs4575	T	C	104	89	193	0	1	194	0	0
14	24616783	rs927493	G	A	2	5	7	0	0	7	0	0
14	24617238	rs2273913	C	T	43	42	85	0	0	85	0	0
14	24624191	rs11622031	G	A	33	18	51	0	0	51	0	0
14	24628070	rs62001568	A	G	11	8	19	0	0	19	0	0
14	24628196	rs2031101	G	C	9	8	17	0	0	17	0	0
14	24634825	rs12436555	G	A	52	30	82	0	1	83	0	0
14	24636025	rs12432194	C	T	34	23	57	0	0	57	0	0
14	24636433	rs12432304	C	T	29	17	46	0	0	46	0	0
14	24641526	rs4761	T	C	274	264	538	0	6	546	2	0
14	24643782	rs1998424	T	C	4	8	12	0	0	12	0	0
14	24644426	rs59110805	G	A	3	7	10	0	0	10	0	0
14	24647522	rs3736840	G	T	1	7	8	0	0	8	0	0
14	24647814	rs1885711	T	C	595	616	1211	0	3	1214	0	0
14	24647957	rs1885710	C	T	68	70	138	0	1	139	0	0
14	24649835	rs2273911	T	C	4	2	6	0	0	6	0	0
14	24650047	rs7145633	A	G	5	5	10	0	0	10	0	0
14	24653523	rs11550452	G	C	24	19	43	0	0	43	0	0
14	24653954	rs7146310	G	A	22	24	46	0	0	46	0	0
14	24654489	rs2025258	T	C	21	20	41	0	0	41	0	0
14	24657407	rs6573607	T	G	4	3	7	0	0	7	0	0
14	24660228	rs3742503	C	T	11	3	14	0	0	14	0	0
14	24660323	rs3742504	A	G	10	5	15	0	0	15	0	0
14	24660406	rs1061838	C	G	9	6	15	0	1	16	0	0
14	24661174	rs112679565	C	T	6	5	11	0	0	11	0	0
14	24662177	rs10583	C	T	26	26	52	0	0	52	0	0
14	24664609	rs2234100	T	C	1	5	6	0	0	6	0	0
14	24667435	.	G	C	4	3	7	0	0	7	0	0
14	24669465	rs12588742	G	A	1	6	7	0	0	7	0	0
14	24669623	rs12588782	G	A	4	5	9	0	0	9	0	0
14	24670393	rs111900757	A	G	5	4	9	0	0	9	0	0
14	24670570	rs1242025	G	A	5	4	9	0	0	9	0	0
14	24671208	rs55949103	C	T	30	30	60	0	0	60	0	0
14	24671443	rs2748542	C	T	27	26	53	0	0	53	0	0
14	24671444	rs2748541	A	G	26	26	52	0	0	52	0	0
14	24672221	rs1242023	C	T	4	16	20	0	0	20	0	0
14	24673174	rs142595906	C	T	9	5	14	0	0	14	0	0
14	24673627	rs72694311	G	T	7	9	16	0	0	16	0	0
14	24673655	rs72694312	G	T	8	10	18	0	0	18	0	0
14	24674425	rs1272986	T	G	5	4	9	0	0	9	0	0
14	24675569	rs1242017	A	G	1	5	6	0	0	6	0	0
14	24675607	rs78386085	C	A	3	7	10	0	0	10	0	0
14	24678412	rs1242013	A	G	2	5	7	0	0	8	1	0
14	24678443	rs1242012	A	G	4	7	11	0	0	11	0	0
14	24678784	rs12589157	A	C	9	7	16	0	0	16	0	0
14	24682141	rs143942402	C	T	22	19	41	0	0	41	0	0
14	24682837	rs2295319	G	A	5	7	12	0	0	12	0	0
14	24683125	rs2295318	A	G	5	8	13	0	0	13	0	0
14	24686214	rs11538588	T	A	257	214	471	0	2	473	0	0
14	24702032	rs3814815	G	T	6	4	10	0	0	10	0	0
14	24735130	rs6573651	A	G	9	15	24	0	0	24	0	0
14	24735361	rs6573653	G	C	4	10	14	0	0	14	0	0
14	24735624	rs2877612	A	G	2	6	8	0	0	8	0	0
14	24736027	rs14193	G	A	102	70	172	0	0	172	0	0
14	24736961	rs729421	T	C	55	65	120	0	2	122	0	0
14	24737203	rs941502	A	T	10	9	19	0	0	19	0	0
14	24740167	rs3825585	C	A	5	2	7	0	0	7	0	0
14	24760009	rs4568	G	A	58	68	126	0	1	127	0	0
14	24760255	rs2295310	C	T	11	8	19	0	1	20	0	0
14	24761690	rs1051883	C	T	41	33	74	0	0	74	0	0
14	24762222	rs8003991	C	G	7	5	12	0	0	12	0	0
14	24762882	rs7146665	C	G	3	3	6	0	0	6	0	0
14	24764114	rs10136508	A	G	6	5	11	0	0	11	0	0
14	24765063	rs12896386	A	T	10	7	17	0	0	17	0	0
14	24765622	rs2295307	G	A	3	4	7	0	0	7	0	0
14	24765684	rs2295306	G	A	5	4	9	0	0	9	0	0
14	24776219	rs2332320	T	C	22	28	50	0	0	50	0	0
14	24786060	rs1046587	G	A	9	5	14	0	0	14	0	0
14	24792966	rs12896809	A	G	8	11	19	0	0	19	0	0
14	24799024	rs1109152	G	C	5	3	8	0	0	8	0	0
14	24799586	rs74896270	G	A	7	18	25	0	0	25	0	0
14	24801325	rs3181254	C	G	7	10	17	0	0	17	0	0
14	24804088	rs3212260	A	T	9	3	12	0	0	12	0	0
14	24804827	rs10146747	G	C	4	6	10	0	0	10	0	0
14	24804859	rs12436194	C	T	5	2	7	0	0	7	0	0
14	24805824	rs3181251	C	T	6	10	16	0	0	16	0	0
14	24806852	rs28620990	C	T	6	8	14	0	0	14	0	0
14	24806902	rs34106261	G	A	31	26	57	0	0	57	0	0
14	24807221	rs56337365	G	A	33	30	63	0	0	63	0	0
14	24807302	rs45537534	C	T	7	6	13	0	0	13	0	0
14	24807635	.	C	T	16	12	28	0	0	28	0	0
14	24808388	rs3181247	A	G	13	8	21	0	0	21	0	0
14	24808961	rs11844732	T	G	4	5	9	0	0	9	0	0
14	24809185	rs3212251	T	C	4	5	9	0	0	9	0	0
14	24839165	rs2228233	C	T	6	5	11	0	0	11	0	0
14	24845543	rs2228232	T	C	23	41	64	0	0	64	0	0
14	24845841	rs7149586	T	C	16	30	46	0	1	47	0	0
14	24846961	rs10362	G	T	50	53	103	0	0	103	0	0
14	24847783	rs56082702	C	A	4	2	6	0	0	6	0	0
14	24848281	rs11848279	A	G	7	3	10	0	0	10	0	0
14	24883887	rs8017377	G	A	23	14	37	0	1	38	0	0
14	24901249	rs3742520	A	C	28	32	60	0	3	63	0	0
14	24904154	rs10134603	A	G	19	26	45	0	1	46	0	0
14	24907859	rs11622189	C	T	141	112	253	0	2	255	0	0
14	24911138	rs11628866	G	T	15	13	28	0	0	28	0	0
14	25076402	.	T	G	6	7	13	0	1	14	0	0
14	25076906	rs20545	C	T	5	10	15	0	0	15	0	0
14	25103409	rs2273843	T	C	4	2	6	0	1	7	0	0
14	31188832	rs2273519	G	A	2	4	6	0	0	6	0	0
14	31188833	rs2273518	G	A	2	4	6	0	0	6	0	0
14	31582526	rs2273483	T	C	90	102	192	0	2	194	0	0
14	31583512	rs61976859	C	T	88	67	155	0	1	156	0	0
14	31591742	rs401157	T	C	7	4	11	0	0	11	0	0
14	31594228	rs28806860	A	G	6	7	13	0	0	13	0	0
14	31647241	rs2274201	G	A	27	25	52	0	0	52	0	0
14	31647448	rs34666986	G	A	28	13	41	0	0	41	0	0
14	31906665	rs112826277	C	T	5	2	7	0	0	7	0	0
14	31915673	rs13176	G	A	20	11	31	0	0	31	0	0
14	31915905	rs7153450	A	T	5	5	10	0	0	10	0	0
14	32330071	rs1129622	A	G	8	3	11	0	0	11	0	0
14	32330080	rs1129623	G	A	7	4	11	0	0	11	0	0
14	32330260	rs10348	A	G	3	7	10	0	0	10	0	0
14	32626805	rs7152756	T	A	8	12	20	0	0	20	0	0
14	35180261	.	A	T	25	31	56	0	0	56	0	0
14	35222242	rs1044149	T	A	70	41	111	0	0	111	0	0
14	35222372	rs11548923	C	T	35	22	57	0	0	57	0	0
14	35222732	rs61754296	C	T	38	25	63	0	1	64	0	0
14	35330893	rs1200414	G	A	3	5	8	0	0	8	0	0
14	35396937	rs799453	A	T	6	4	10	0	0	10	0	0
14	35433187	rs2273154	C	T	5	2	7	0	0	7	0	0
14	35490084	rs12590905	A	G	4	5	9	0	0	9	0	0
14	35490918	rs2250579	C	G	4	7	11	0	0	11	0	0
14	35491343	rs9322942	T	A	7	1	8	0	0	8	0	0
14	35491833	rs112510746	T	G	5	2	7	0	0	7	0	0
14	35492970	rs55670220	G	A	5	7	12	0	1	13	0	0
14	35495734	rs77262907	C	G	15	9	24	0	0	24	0	0
14	35496176	rs77780729	C	A	17	5	22	0	0	22	0	0
14	35497266	rs17510813	C	T	29	34	63	0	0	63	0	0
14	35497285	rs78609489	T	C	47	19	66	0	4	70	0	0
14	35498443	rs28577270	G	A	90	76	166	0	1	167	0	0
14	35498485	rs11540758	C	T	87	79	166	0	1	167	0	0
14	35515920	rs2295103	C	G	17	11	28	0	0	28	0	0
14	35515957	rs45530731	C	A	17	21	38	0	0	38	0	0
14	35516099	rs799474	C	G	31	24	55	0	1	56	0	0
14	35516575	rs80338392	T	C	5	4	9	0	0	9	0	0
14	35517017	rs62625038	A	G	2	8	10	0	0	10	0	0
14	35517618	rs79206825	C	A	4	7	11	0	0	11	0	0
14	35517653	rs112854815	T	A	5	6	11	0	0	11	0	0
14	35518393	rs8021263	C	T	4	2	6	0	0	6	0	0
14	35528193	rs4456414	C	G	9	4	13	0	0	13	0	0
14	35545044	rs7140462	C	T	3	3	6	0	0	6	0	0
14	35545160	rs148562771	C	G	3	8	11	0	0	11	0	0
14	35546373	rs3211139	T	C	19	25	44	0	0	44	0	0
14	35555133	rs8011549	T	C	8	6	14	0	0	14	0	0
14	35556592	rs2008130	C	A	4	2	6	0	0	6	0	0
14	35560589	rs45573840	C	T	4	3	7	0	0	7	0	0
14	35561440	rs11850487	A	G	4	3	7	0	0	7	0	0
14	35569658	rs2415257	C	T	1	6	7	0	0	7	0	0
14	35570250	rs113590838	C	T	3	4	7	0	0	7	0	0
14	35581432	rs8020370	G	A	5	2	7	0	0	7	0	0
14	35581480	rs8021414	T	A	4	3	7	0	0	7	0	0
14	35582499	rs78624346	G	A	0	6	6	0	0	6	0	0
14	35591174	rs1056879	T	C	12	23	35	0	0	35	0	0
14	35591726	rs2236167	T	C	3	3	6	0	0	6	0	0
14	35691535	rs8004740	A	G	2	4	6	0	0	6	0	0
14	35718113	rs8017268	C	T	14	10	24	0	1	25	0	0
14	35872792	rs2233415	A	G	22	21	43	0	0	43	0	0
14	36782888	rs7141786	T	C	12	6	18	0	0	18	0	0
14	38061742	rs7144658	C	T	1	5	6	0	0	6	0	0
14	39507203	rs34985331	T	C	4	3	7	0	0	7	0	0
14	39552484	rs2144530	C	T	3	6	9	0	0	9	0	0
14	39556185	rs8018720	G	C	15	35	50	0	0	50	0	0
14	39556693	rs10149829	A	G	3	7	10	0	1	11	0	0
14	39560094	rs117198435	G	A	12	11	23	0	0	23	0	0
14	39587220	rs150986614	C	A	26	20	46	0	0	46	0	0
14	39617103	rs2869	T	C	23	16	39	0	0	39	0	0
14	39617711	rs28379470	G	A	25	27	52	0	0	52	0	0
14	39618412	rs12437405	T	C	5	3	8	0	0	8	0	0
14	39644498	rs1061583	G	A	174	171	345	0	2	347	0	0
14	39650234	rs2180792	A	T	394	388	782	0	4	786	0	0
14	39651193	rs532	A	G	173	184	357	0	0	357	0	0
14	39652219	rs2737721	T	C	21	8	29	0	0	29	0	0
14	39777676	rs1950952	G	C	64	60	124	0	1	125	0	0
14	39783985	rs118177774	T	G	72	66	138	0	0	138	0	0
14	39793554	rs6571920	G	A	17	20	37	0	0	37	0	0
14	39793824	rs11157059	T	A	11	6	17	0	0	17	0	0
14	39794359	rs8022515	G	A	10	1	11	0	0	11	0	0
14	39794432	rs72645017	A	C	17	2	19	0	1	20	0	0
14	39794444	rs12897561	G	T	18	4	22	0	0	22	0	0
14	39794450	rs8022239	A	T	18	5	23	0	0	23	0	0
14	39794496	rs12897272	A	G	13	5	18	0	0	18	0	0
14	39794622	rs56126634	T	A	15	1	16	0	1	17	0	0
14	39795243	rs6571921	A	G	16	11	27	0	2	29	0	0
14	39818028	rs1140952	A	G	127	122	249	0	5	254	0	0
14	45645715	rs45604036	A	G	9	5	14	0	0	14	0	0
14	45659354	rs113059739	T	A	4	2	6	0	0	6	0	0
14	45665661	rs45557033	A	G	12	12	24	0	0	24	0	0
14	45676853	.	C	A	30	20	50	0	1	51	0	0
14	50044392	rs2883438	T	C	71	67	138	0	2	140	0	0
14	50051496	rs10139832	T	A	9	6	15	0	1	16	0	0
14	50051751	rs10150823	C	T	11	11	22	0	0	22	0	0
14	50051819	rs11629047	G	C	13	15	28	0	0	28	0	0
14	50052097	rs11621094	A	C	12	12	24	0	0	24	0	0
14	50065359	rs2281837	C	G	4	2	6	0	0	6	0	0
14	50065717	rs2281836	G	C	22	21	43	0	0	43	0	0
14	50067605	rs4127814	C	T	6	8	14	0	0	14	0	0
14	50086563	rs3007030	C	T	6	8	14	0	0	14	0	0
14	50087753	rs7519	T	C	35	24	59	0	0	59	0	0
14	50088719	.	G	C	69	72	141	0	0	141	0	0
14	50092471	rs9989177	T	C	17	9	26	0	0	26	0	0
14	50098896	rs1952012	T	A	7	3	10	0	0	10	0	0
14	50099223	rs35080382	G	A	3	3	6	0	0	6	0	0
14	50100386	rs2985687	T	C	72	63	135	0	1	136	0	0
14	50100683	rs2985686	C	G	6	3	9	0	0	9	0	0
14	50580281	rs543331418	C	T	7	6	13	0	1	14	0	0
14	50583183	.	G	A	21	17	38	0	0	38	0	0
14	50623657	rs3736759	G	A	0	10	10	0	0	10	0	0
14	50623669	.	G	A	12	0	12	0	0	12	0	0
14	50623679	rs3736760	G	A	1	11	12	0	0	12	0	0
14	50623683	rs3736761	A	G	0	11	11	0	0	11	0	0
14	50655338	rs113460230	T	C	45	43	88	0	0	88	0	0
14	50788213	rs2275592	C	T	26	23	49	0	0	49	0	0
14	50793814	rs7147718	G	A	4	8	12	0	2	14	0	0
14	50798515	rs4901014	C	T	3	3	6	0	0	6	0	0
14	50799126	rs7161563	G	C	3	3	6	0	0	6	0	0
14	50800833	rs4901018	A	T	3	3	6	0	0	6	0	0
14	50801102	rs7141402	G	A	10	3	13	0	0	13	0	0
14	50802840	rs7148292	A	G	4	2	6	0	0	6	0	0
14	50802972	rs10136242	G	A	3	5	8	0	0	8	0	0
14	50803358	rs2356243	A	C	5	2	7	0	0	7	0	0
14	50890354	rs73286518	G	A	14	20	34	0	0	34	0	0
14	50950067	rs7147353	G	T	8	10	18	0	0	18	0	0
14	50951356	rs80132397	G	A	5	3	8	0	0	8	0	0
14	51130620	rs151017111	G	A	4	5	9	0	0	9	0	0
14	51188341	rs10140023	A	G	44	40	84	0	0	84	0	0
14	51264126	rs76096589	C	T	4	4	8	0	0	8	0	0
14	51359935	rs9671422	C	A	2	4	6	0	0	6	0	0
14	51370539	rs17123107	A	G	5	3	8	0	0	8	0	0
14	51372103	rs1042266	C	G	87	126	213	0	4	217	0	0
14	51372333	rs1959527	A	G	9	9	18	0	0	18	0	0
14	51372590	rs2027342	T	C	3	8	11	0	0	11	0	0
14	51372606	rs2027341	G	A	3	10	13	0	0	13	0	0
14	51374425	rs6572710	A	T	4	3	7	0	0	7	0	0
14	51382405	rs1890700	T	C	2	5	7	0	0	7	0	0
14	51383432	rs2075643	G	A	63	78	141	0	0	141	0	0
14	51387975	rs11157783	G	C	4	9	13	0	0	13	0	0
14	51388832	rs10138493	C	T	3	9	12	0	0	12	0	0
14	51388969	rs10140858	A	G	5	10	15	0	0	15	0	0
14	51389908	rs8006359	T	C	3	5	8	0	0	8	0	0
14	51389918	rs8005400	G	A	3	6	9	0	0	9	0	0
14	51390132	rs8020787	T	A	148	49	197	0	3	200	0	0
14	51390173	rs55943056	T	C	217	63	280	0	2	282	0	0
14	51391256	rs6572711	A	G	15	8	23	0	0	23	0	0
14	51394480	rs8022952	C	T	3	3	6	0	0	6	0	0
14	51395856	rs56192413	T	C	5	1	6	0	0	6	0	0
14	51407580	rs1890706	C	T	10	28	38	0	0	38	0	0
14	51407850	rs10143053	G	T	17	29	46	0	0	46	0	0
14	51407894	rs1890705	C	T	16	33	49	0	0	49	0	0
14	51408318	rs72685360	G	T	12	28	40	0	0	40	0	0
14	51408758	rs7149936	A	G	9	17	26	0	0	26	0	0
14	51410178	rs8014291	T	G	6	5	11	0	0	11	0	0
14	52368187	rs1953860	C	T	2	4	6	0	0	6	0	0
14	52398274	rs1253698	T	G	2	4	6	0	0	6	0	0
14	52398455	rs1253699	G	C	1	6	7	0	0	7	0	0
14	52457777	rs1253678	G	A	10	11	21	0	0	21	0	0
14	52468641	rs1151573	G	A	2	4	6	0	0	6	0	0
14	52469647	rs1253684	G	A	2	5	7	0	0	7	0	0
14	52474215	rs1497079	G	A	6	5	11	0	0	11	0	0
14	52474721	rs1476284	C	T	9	14	23	0	0	23	0	0
14	52477206	rs2282346	C	T	30	30	60	0	0	60	0	0
14	52478315	rs1051069	A	G	30	25	55	0	0	55	0	0
14	52781101	rs1353411	G	A	2	8	10	0	0	10	0	0
14	52781195	rs1254598	G	A	23	14	37	0	0	37	0	0
14	52792500	rs708498	A	G	1	12	13	0	0	13	0	0
14	52794234	rs708502	T	C	64	81	145	0	3	148	0	0
14	52794381	rs17197	G	A	64	67	131	0	2	133	0	0
14	52795100	rs1042618	C	T	25	25	50	0	0	50	0	0
14	52897619	rs11039	T	G	7	14	21	0	1	22	0	0
14	52898383	rs11623681	C	A	11	3	14	0	0	14	0	0
14	52898667	rs2767540	G	T	5	6	11	0	0	11	0	0
14	52906081	rs2249922	T	G	9	8	17	0	1	18	0	0
14	52907353	rs1952254	C	T	8	3	11	0	0	11	0	0
14	52937255	rs7155490	C	T	6	6	12	0	0	12	0	0
14	53107449	.	A	G	62	84	146	0	0	146	0	0
14	53107682	rs8013756	G	A	76	44	120	0	5	125	0	0
14	53109716	rs35738167	T	G	6	4	10	0	0	10	0	0
14	53115398	rs11621709	C	T	2	4	6	0	0	6	0	0
14	53126757	rs35769125	A	G	6	7	13	0	0	13	0	0
14	53176982	rs3783448	A	C	35	27	62	0	1	63	0	0
14	53192467	rs10136643	A	G	4	2	6	0	0	6	0	0
14	53194068	rs74620173	G	T	5	1	6	0	1	7	0	0
14	53194419	rs6696	T	C	113	91	204	0	2	206	0	0
14	53197042	rs2277493	G	C	8	10	18	0	0	18	0	0
14	53240035	rs73298734	A	G	9	5	14	0	1	15	0	0
14	53242362	rs75838476	G	A	11	9	20	0	0	20	0	0
14	53242849	rs1140039	C	T	6	7	13	0	0	13	0	0
14	54894296	rs10220437	T	C	79	105	184	0	1	185	0	0
14	54945681	rs17127595	G	A	4	3	7	0	0	7	0	0
14	54946910	rs10139223	C	G	19	25	44	0	0	44	0	0
14	54947501	rs59955412	T	C	8	13	21	0	0	21	0	0
14	54955677	rs3737314	A	T	36	35	71	0	0	71	0	0
14	55005535	rs17832137	G	A	3	3	6	0	0	6	0	0
14	55038021	rs78341961	A	G	3	3	6	0	0	6	0	0
14	55047949	rs7141453	A	C	8	8	16	0	0	16	0	0
14	55049748	rs4901522	G	A	4	6	10	0	0	10	0	0
14	55255673	rs11431	C	T	3	3	6	0	0	6	0	0
14	55257590	rs3813402	A	G	4	2	6	0	1	7	0	0
14	55259203	rs911615	T	G	2	7	9	0	0	9	0	0
14	55310492	rs841	G	A	23	15	38	0	0	38	0	0
14	55311569	rs752688	C	T	14	11	25	0	0	25	0	0
14	55325583	rs12587434	T	G	1	7	8	0	0	8	0	0
14	55406992	rs1354	G	A	6	0	6	0	0	6	0	0
14	55407757	rs7146775	G	A	17	16	33	0	0	33	0	0
14	55407944	rs7147147	G	T	9	13	22	0	1	23	0	0
14	55462388	rs61744409	G	A	8	7	15	0	0	15	0	0
14	55515217	rs184286868	T	C	38	27	65	0	1	66	0	0
14	55515304	rs75743211	T	C	37	28	65	0	2	67	0	0
14	55522327	rs74336460	C	T	7	4	11	0	0	11	0	0
14	55522518	rs148320104	C	T	8	4	12	0	0	12	0	0
14	55524530	rs7161656	A	G	6	2	8	0	0	8	0	0
14	55525199	rs111831572	A	G	10	9	19	0	0	19	0	0
14	55525589	rs9806049	C	A	9	2	11	0	0	11	0	0
14	55526381	rs140427123	A	G	16	8	24	0	0	24	0	0
14	55526445	rs112365184	A	G	15	8	23	0	0	23	0	0
14	55527013	rs113772282	C	G	7	0	7	0	0	7	0	0
14	55527374	rs6572999	T	C	19	24	43	0	0	43	0	0
14	55528913	rs1002054	A	C	5	1	6	0	1	7	0	0
14	55529860	rs17851309	A	G	272	241	513	0	10	524	1	0
14	55531526	rs45513892	A	C	143	113	256	0	0	257	1	0
14	55533487	rs79689798	C	T	24	20	44	0	0	44	0	0
14	55533588	rs17128143	C	G	23	24	47	0	2	49	0	0
14	55534466	rs17832311	A	G	31	47	78	0	0	78	0	0
14	55595242	rs67098772	G	A	0	8	8	0	0	8	0	0
14	55604935	rs4644	C	A	69	82	151	0	3	154	0	0
14	55605036	rs4652	A	C	114	123	237	0	5	242	0	0
14	55611839	rs11125	A	T	151	172	323	0	2	325	0	0
14	55619311	rs15870	A	G	14	13	27	0	0	27	0	0
14	55643908	rs10144326	A	G	4	10	14	0	0	14	0	0
14	55655692	rs2274271	C	T	6	4	10	0	0	10	0	0
14	55737745	rs79306172	A	G	6	1	7	0	0	7	0	0
14	55738596	rs943590	T	C	3	4	7	0	0	7	0	0
14	55738907	rs7146752	A	G	3	3	6	0	1	7	0	0
14	55742386	.	C	A	2	4	6	0	0	6	0	0
14	55749607	rs8021583	G	A	4	2	6	0	0	6	0	0
14	55762712	rs17740741	G	C	2	9	11	0	0	11	0	0
14	55762803	rs68046603	T	A	1	5	6	0	0	6	0	0
14	55763119	rs533726498	T	G	7	0	7	0	0	7	0	0
14	55763963	rs10142547	T	C	4	9	13	0	0	13	0	0
14	55765064	rs78610369	C	T	14	24	38	0	0	38	0	0
14	55765360	rs117960693	C	T	5	8	13	0	1	14	0	0
14	55765402	rs61210954	T	C	9	18	27	0	0	27	0	0
14	55765787	rs76104714	G	A	30	59	89	0	1	90	0	0
14	55770744	rs7148171	G	C	7	3	10	0	0	10	0	0
14	55817708	rs10144418	T	C	26	21	47	0	0	47	0	0
14	55818403	rs35070799	T	C	36	25	61	0	3	64	0	0
14	55818517	rs1045002	T	A	38	27	65	0	0	65	0	0
14	55818706	rs3742569	T	C	47	30	77	0	0	77	0	0
14	55833874	rs1572611	T	A	174	141	315	0	1	316	0	0
14	55834351	rs3783648	A	G	72	45	117	0	3	120	0	0
14	55835087	rs139843605	G	A	44	21	65	0	1	66	0	0
14	55835227	rs11626751	T	C	22	35	57	0	0	57	0	0
14	55835990	rs41299199	C	T	81	85	166	0	1	167	0	0
14	55841252	rs8013713	C	T	2	4	6	0	1	7	0	0
14	55845543	rs9323284	T	C	9	4	13	0	0	13	0	0
14	55845611	rs117343607	C	T	3	4	7	0	0	7	0	0
14	55845987	rs28631821	T	C	8	9	17	0	1	18	0	0
14	55846071	rs111594243	T	C	7	7	14	0	0	14	0	0
14	55846174	rs28660594	T	C	3	7	10	0	0	10	0	0
14	55846833	rs112766537	G	A	7	4	11	0	0	11	0	0
14	55858445	rs112208515	G	A	3	5	8	0	0	8	0	0
14	55858563	rs78435477	C	A	2	5	7	0	0	7	0	0
14	55859281	rs113584038	C	T	4	2	6	0	0	6	0	0
14	55861203	rs79907117	A	G	4	4	8	0	0	8	0	0
14	56584625	rs1046597	G	A	5	1	6	0	0	6	0	0
14	56654346	rs12590856	G	A	8	1	9	0	0	9	0	0
14	56654705	rs4901642	A	T	13	9	22	0	0	22	0	0
14	56655013	rs3844020	T	G	23	12	35	0	0	35	0	0
14	56658852	rs242397	T	C	3	6	9	0	0	9	0	0
14	56709005	rs12889590	G	C	4	2	6	0	0	6	0	0
14	56709516	rs7152954	A	G	6	9	15	0	0	15	0	0
14	56750158	rs11623641	C	G	1	5	6	0	0	6	0	0
14	56758563	rs34732416	G	A	4	4	8	0	0	8	0	0
14	56758690	rs3783683	G	A	3	3	6	0	0	6	0	0
14	56759417	rs17091214	G	A	6	3	9	0	0	9	0	0
14	56760329	rs1152463	G	A	6	1	7	0	0	7	0	0
14	56761781	rs111316490	T	C	5	10	15	0	0	15	0	0
14	56765746	rs1152467	A	G	62	51	113	0	1	114	0	0
14	56766094	rs8018553	T	G	47	48	95	0	1	96	0	0
14	57048529	rs11626718	C	T	4	5	9	0	0	9	0	0
14	57048537	rs59824319	A	G	3	3	6	0	0	6	0	0
14	58666882	rs61975916	A	G	12	8	20	0	0	20	0	0
14	58678802	rs8020516	T	A	2	4	6	0	0	6	0	0
14	58680784	rs8014085	T	C	6	2	8	0	0	8	0	0
14	58684121	rs61975948	C	A	5	3	8	0	0	8	0	0
14	58684804	rs8016651	T	C	1	6	7	0	0	7	0	0
14	58699629	rs28697080	G	A	0	8	8	0	0	8	0	0
14	58699886	rs2347934	T	C	2	7	9	0	0	9	0	0
14	58701682	rs11622463	A	G	5	6	11	0	0	11	0	0
14	58728679	rs28567753	C	T	3	3	6	0	0	6	0	0
14	58729762	rs2004312	G	A	5	3	8	0	1	9	0	0
14	58729996	rs111364917	C	G	4	3	7	0	0	7	0	0
14	58732748	rs12892257	G	A	162	137	299	0	8	307	0	0
14	58733401	rs79810489	A	G	110	118	228	0	0	228	0	0
14	58733854	rs7161678	G	A	43	59	102	0	0	102	0	0
14	58735125	rs141534702	T	C	24	17	41	0	0	41	0	0
14	58735712	rs146200815	G	A	25	27	52	0	2	54	0	0
14	58740480	rs10145652	C	A	6	7	13	0	0	13	0	0
14	58761904	rs143694161	G	T	50	65	115	0	0	115	0	0
14	58762413	rs28637941	C	A	53	44	97	0	0	97	0	0
14	58762451	rs149912483	G	A	57	46	103	0	0	103	0	0
14	58768333	rs45562837	C	T	70	75	145	0	0	145	0	0
14	58801698	.	C	A	4	4	8	0	0	8	0	0
14	58828077	rs74055634	A	G	5	2	7	0	0	7	0	0
14	58829032	rs8008129	T	C	2	5	7	0	0	7	0	0
14	58830509	rs8004532	T	C	7	12	19	0	0	19	0	0
14	58838668	rs1051860	A	G	164	171	335	0	1	336	0	0
14	58838701	rs1051861	C	T	177	159	336	0	2	338	0	0
14	58893791	rs6764	T	G	97	93	190	0	2	192	0	0
14	58893813	rs6763	G	C	81	80	161	0	3	164	0	0
14	59010649	rs28535751	T	C	0	7	7	0	0	7	0	0
14	59114770	rs11541	C	G	2	7	9	0	0	9	0	0
14	59261651	rs10483703	G	A	18	0	18	0	1	19	0	0
14	59835972	rs3742647	A	C	3	5	8	0	0	8	0	0
14	59939727	rs8660	T	C	17	9	26	0	0	26	0	0
14	59952901	rs17255787	A	G	6	4	10	0	0	10	0	0
14	59969882	rs17255814	G	A	4	2	6	0	0	6	0	0
14	60714142	rs60280931	C	T	2	5	7	0	0	7	0	0
14	60737876	rs10150441	G	C	3	5	8	0	1	9	0	0
14	60737981	rs10129773	G	A	4	3	7	0	0	7	0	0
14	60740853	rs4899007	A	G	6	7	13	0	0	13	0	0
14	60743352	rs6573301	C	G	5	7	12	0	1	13	0	0
14	60744634	rs7146234	A	G	6	4	10	0	0	10	0	0
14	60746756	rs6573302	A	G	7	5	12	0	0	12	0	0
14	60749118	rs7154773	G	C	38	14	52	0	1	53	0	0
14	60752912	rs12434739	C	G	3	6	9	0	0	9	0	0
14	60754455	rs17256080	G	A	22	16	38	0	0	38	0	0
14	60754693	rs8017100	T	C	20	12	32	0	0	32	0	0
14	60757001	rs6573304	C	A	4	3	7	0	0	7	0	0
14	60759727	rs1048318	T	C	198	258	456	0	2	458	0	0
14	60761830	rs72720117	G	A	5	3	8	0	0	8	0	0
14	61857969	rs2230499	A	G	18	16	34	0	0	34	0	0
14	62006054	rs117498462	A	G	2	6	8	0	0	8	0	0
14	62006693	rs1088674	C	A	5	1	6	0	0	6	0	0
14	62006887	rs3783755	C	A	5	3	8	0	0	8	0	0
14	62010359	rs3783753	A	G	3	3	6	0	0	6	0	0
14	62013894	rs1111107	A	G	6	6	12	0	0	12	0	0
14	62014289	rs2184633	T	A	6	6	12	0	0	12	0	0
14	62015885	rs76537762	G	A	21	17	38	0	0	38	0	0
14	62017135	rs3813410	G	A	72	56	128	0	2	130	0	0
14	62017643	rs14095	A	G	10	19	29	0	0	29	0	0
14	64612845	rs11629287	C	T	4	3	7	0	0	7	0	0
14	64612858	rs10151658	C	A	4	2	6	0	0	6	0	0
14	64682978	.	C	T	5	1	6	0	0	6	0	0
14	64686125	rs35648226	G	T	4	2	6	0	0	6	0	0
14	64692630	rs1152582	G	C	7	4	11	0	0	11	0	0
14	64692825	rs7229	G	A	2	4	6	0	0	6	0	0
14	64908845	rs2236225	G	A	63	44	107	0	0	107	0	0
14	64946191	rs1742159	C	G	3	3	6	0	0	6	0	0
14	64952055	rs1453005	C	T	2	5	7	0	0	7	0	0
14	64969225	rs2218994	C	T	3	3	6	0	0	6	0	0
14	64991360	.	A	G	12	14	26	0	0	26	0	0
14	65195794	rs229644	T	C	7	15	22	0	1	23	0	0
14	65197767	rs229624	G	A	17	23	40	0	1	41	0	0
14	65208026	rs229650	T	C	19	11	30	0	1	31	0	0
14	65209680	rs41301473	A	G	3	13	16	0	0	16	0	0
14	65212845	rs41307086	T	C	6	2	8	0	0	8	0	0
14	65213488	rs79724410	T	C	8	7	15	0	0	15	0	0
14	65214652	rs754435	G	A	4	8	12	0	0	12	0	0
14	65471920	rs72728236	G	A	25	19	44	0	0	44	0	0
14	65472241	rs11621325	T	C	10	7	17	0	0	17	0	0
14	65473196	rs7148590	G	A	6	5	11	0	0	11	0	0
14	65491255	rs11620955	A	G	4	2	6	0	0	6	0	0
14	65493453	rs117180732	G	A	4	5	9	0	0	9	0	0
14	65502012	rs72728257	G	A	5	4	9	0	1	10	0	0
14	65502120	rs72728258	G	C	4	3	7	0	0	7	0	0
14	65502239	rs7155454	G	A	4	2	6	0	0	6	0	0
14	65506926	rs72728264	C	T	3	5	8	0	1	9	0	0
14	65510025	rs72728266	G	A	2	4	6	0	0	6	0	0
14	65542067	rs4902357	C	G	533	521	1054	0	5	1059	0	0
14	65542477	rs4902358	A	G	219	270	489	0	2	491	0	0
14	65542607	rs1957949	C	T	256	352	608	0	6	614	0	0
14	65542629	rs1957948	C	T	237	328	565	0	18	583	0	0
14	65542790	rs4902359	G	A	423	459	882	0	6	888	0	0
14	65543102	rs45604339	C	T	181	213	394	0	9	403	0	0
14	65544367	rs762810	C	A	36	53	89	0	1	90	0	0
14	65545251	.	G	T	39	32	71	0	3	74	0	0
14	65546299	rs998247	C	T	36	37	73	0	0	73	0	0
14	65546361	rs7143495	A	G	28	36	64	0	0	64	0	0
14	65546722	rs4902360	A	C	30	34	64	0	1	65	0	0
14	65548470	rs4902361	G	T	16	19	35	0	0	35	0	0
14	65549089	rs11625045	C	T	14	15	29	0	0	29	0	0
14	65550025	rs942627	A	G	13	14	27	0	1	28	0	0
14	65550082	rs942626	C	T	13	14	27	0	0	27	0	0
14	65550816	rs7159443	T	A	149	276	425	0	0	426	1	0
14	65552182	rs8010213	C	T	9	12	21	0	0	21	0	0
14	65553822	rs7154852	C	A	6	11	17	0	0	17	0	0
14	65553939	rs2093989	C	T	3	5	8	0	0	8	0	0
14	65554638	rs55658675	C	T	8	8	16	0	0	16	0	0
14	65555471	rs10143198	C	T	2	4	6	0	0	6	0	0
14	65555707	rs8181937	A	C	5	3	8	0	0	8	0	0
14	65555712	rs8181938	A	G	5	4	9	0	0	9	0	0
14	65555758	rs8181939	G	A	3	7	10	0	0	10	0	0
14	65562306	rs1998688	C	G	4	2	6	0	1	7	0	0
14	65563309	rs7161394	G	T	2	4	6	0	1	7	0	0
14	65568563	rs2781374	C	T	8	11	19	0	0	19	0	0
14	65568742	rs143183654	G	C	19	8	27	0	0	27	0	0
14	66028446	rs2229677	A	G	5	8	13	0	0	13	0	0
14	66136163	rs35949016	C	A	5	8	13	0	0	13	0	0
14	66209190	rs1054218	C	G	12	6	18	0	0	18	0	0
14	67647946	rs192206028	G	A	4	5	9	0	0	9	0	0
14	67794576	rs189949268	G	A	6	3	9	0	0	9	0	0
14	67937477	rs1315733	C	G	12	13	25	0	0	25	0	0
14	67937892	rs1315732	A	C	6	6	12	0	0	12	0	0
14	67938276	rs1316032	A	G	9	6	15	0	0	15	0	0
14	67938638	rs1316133	G	A	4	7	11	0	0	11	0	0
14	67938818	rs2753607	G	A	8	3	11	0	0	11	0	0
14	67939093	rs1316130	A	C	6	1	7	0	0	7	0	0
14	68059834	rs12897715	A	G	21	19	40	0	0	40	0	0
14	68060033	rs34767169	T	C	28	20	48	0	2	50	0	0
14	68060375	rs2038490	C	T	26	27	53	0	0	53	0	0
14	68115476	rs12884807	C	T	19	9	28	0	0	28	0	0
14	68116324	rs8015333	A	G	8	7	15	0	0	15	0	0
14	68116881	rs34970739	T	G	10	9	19	0	0	19	0	0
14	68142552	rs3759762	C	G	2	5	7	0	0	7	0	0
14	68144423	rs7410	T	C	60	52	112	0	0	112	0	0
14	68145599	rs77554057	T	C	3	3	6	0	1	7	0	0
14	68171728	rs12882315	C	A	6	0	6	0	0	6	0	0
14	68186089	rs12889527	T	C	3	6	9	0	0	9	0	0
14	68222943	rs139938162	A	G	11	13	24	0	0	24	0	0
14	68223366	rs35103502	T	C	7	5	12	0	0	12	0	0
14	68224450	rs34666247	A	G	9	3	12	0	0	12	0	0
14	68226982	rs11158691	A	G	8	9	17	0	0	17	0	0
14	68249499	rs2235967	C	T	11	16	27	0	0	27	0	0
14	68255651	rs10483805	T	C	3	3	6	0	0	6	0	0
14	68264867	rs12891164	A	G	7	7	14	0	0	14	0	0
14	69255644	.	A	C	2	8	10	0	1	11	0	0
14	69255660	.	G	C	0	6	6	0	0	6	0	0
14	69344290	rs72733506	T	G	8	19	27	0	0	27	0	0
14	69345647	rs12586591	C	T	19	16	35	0	0	35	0	0
14	69352230	rs15993	G	A	57	72	129	0	0	129	0	0
14	69353909	rs181472	C	T	37	39	76	0	0	76	0	0
14	69354373	rs181473	A	T	14	14	28	0	0	28	0	0
14	69354557	rs181474	C	G	22	19	41	0	0	41	0	0
14	69354660	rs181476	T	G	18	24	42	0	0	42	0	0
14	69354871	rs181478	T	G	10	17	27	0	0	27	0	0
14	69355447	rs1475033	C	G	10	10	20	0	0	20	0	0
14	69356353	rs181481	C	T	5	5	10	0	0	10	0	0
14	69518959	rs117591245	C	G	40	109	149	0	4	153	0	0
14	69519003	rs142929985	C	T	72	140	212	0	2	215	1	0
14	69521345	rs61741172	G	A	112	109	221	0	0	221	0	0
14	69581898	rs7158145	C	G	8	6	14	0	0	14	0	0
14	69704553	rs8007859	G	T	8	10	18	0	0	18	0	0
14	69708241	rs1043254	G	A	7	7	14	0	0	14	0	0
14	69709373	rs3173	G	A	14	9	23	0	1	24	0	0
14	69709929	rs10148349	C	T	13	11	24	0	0	24	0	0
14	69846975	rs193051508	T	C	375	327	702	0	8	710	0	0
14	69855904	rs34864264	C	T	18	5	23	0	2	25	0	0
14	69912008	rs12893282	A	G	3	4	7	0	0	7	0	0
14	69926273	.	G	T	15	6	21	0	0	21	0	0
14	69926274	.	T	G	17	3	20	0	1	21	0	0
14	70178337	rs945310	T	C	124	95	219	0	3	222	0	0
14	70178981	rs945309	G	A	76	91	167	0	3	170	0	0
14	70180778	.	C	G	279	250	529	0	2	532	1	0
14	70233665	rs56154784	C	T	3	3	6	0	0	6	0	0
14	70233845	rs28488181	G	A	32	34	66	0	0	66	0	0
14	70235741	rs3104	G	A	77	64	141	0	0	141	0	0
14	70236600	rs45527638	A	G	364	382	746	0	8	754	0	0
14	70621118	rs11851571	T	C	4	12	16	0	0	16	0	0
14	70623885	rs7149156	G	T	1	5	6	0	0	6	0	0
14	70625349	rs17175834	A	G	2	4	6	0	0	6	0	0
14	70629538	rs17765507	T	G	4	3	7	0	0	7	0	0
14	70630349	rs7158149	A	G	2	4	6	0	0	6	0	0
14	70631485	rs7144377	T	C	3	3	6	0	0	6	0	0
14	70631524	rs7143465	G	C	2	4	6	0	0	6	0	0
14	70745199	rs2332281	C	T	6	1	7	0	0	7	0	0
14	71056632	rs61980460	T	A	1	8	9	0	0	9	0	0
14	71138231	rs45485793	C	A	43	27	70	0	0	70	0	0
14	71138716	rs1076265	A	C	35	28	63	0	0	63	0	0
14	71138730	rs13738	C	T	33	26	59	0	0	59	0	0
14	71139626	rs1076263	G	A	6	4	10	0	0	10	0	0
14	71388530	.	T	C	7	11	18	0	0	18	0	0
14	71389481	.	T	C	19	15	34	0	1	35	0	0
14	71410878	.	C	T	16	17	33	0	0	33	0	0
14	71550667	.	G	A	3	3	6	0	0	6	0	0
14	71823388	rs41229	G	T	3	10	13	0	0	13	0	0
14	71884567	rs12880291	G	T	5	2	7	0	0	7	0	0
14	71907198	rs36535	C	T	5	11	16	0	0	16	0	0
14	71907295	rs61989367	G	A	3	7	10	0	1	11	0	0
14	72055468	rs1859643	A	C	7	8	15	0	0	15	0	0
14	72117156	rs8017465	T	C	10	6	16	0	0	16	0	0
14	72149647	rs7145435	C	T	4	2	6	0	0	6	0	0
14	72150764	.	G	C	4	3	7	0	0	7	0	0
14	72153441	rs7401916	T	G	1	9	10	0	0	10	0	0
14	72205824	.	G	C	35	26	61	0	0	61	0	0
14	73425328	.	G	A	9	8	17	0	0	17	0	0
14	73447924	rs4899452	C	G	3	5	8	0	1	9	0	0
14	73570698	.	A	T	17	9	26	0	1	27	0	0
14	74042189	.	A	G	8	4	12	0	2	14	0	0
14	74042317	rs14290	C	T	13	13	26	0	0	26	0	0
14	74178729	rs8949	G	T	77	74	151	0	3	154	0	0
14	74182890	rs3742818	C	G	184	203	387	0	3	390	0	0
14	74184939	rs4899476	A	G	72	74	146	0	5	151	0	0
14	74190100	.	C	T	1	9	10	0	1	11	0	0
14	74190147	rs8023053	G	C	4	7	11	0	0	11	0	0
14	74192791	rs10147537	C	T	89	89	178	0	1	179	0	0
14	74195341	rs28495709	C	T	2	4	6	0	0	6	0	0
14	74269778	rs11624703	G	C	3	9	12	0	0	12	0	0
14	74351488	rs8007148	G	C	4	3	7	0	1	8	0	0
14	74351765	rs113634161	G	C	3	3	6	0	0	6	0	0
14	74351973	rs72627116	C	T	3	7	10	0	0	10	0	0
14	74384939	rs145121907	A	G	19	22	41	0	1	42	0	0
14	74384941	rs192516248	G	A	21	21	42	0	0	42	0	0
14	74386523	rs12050300	G	A	9	4	13	0	1	14	0	0
14	74386675	rs62003757	C	T	5	3	8	0	0	8	0	0
14	74388908	rs1127392	T	C	72	124	196	0	0	196	0	0
14	74396431	rs8013946	G	C	3	3	6	0	0	6	0	0
14	74396434	rs113954406	C	T	4	3	7	0	0	7	0	0
14	74397351	rs11624140	A	G	4	8	12	0	0	12	0	0
14	74398030	rs17094056	C	T	10	3	13	0	0	13	0	0
14	74423659	rs11623965	T	C	6	2	8	0	0	8	0	0
14	74424938	rs3180946	T	C	28	18	46	0	0	46	0	0
14	74429137	rs7147229	C	G	3	5	8	0	0	8	0	0
14	74514674	rs3784038	A	T	4	3	7	0	0	7	0	0
14	74523869	rs3742809	A	G	2	6	8	0	0	8	0	0
14	74523949	rs3742808	G	A	4	7	11	0	0	11	0	0
14	74552442	rs4232872	C	G	2	4	6	0	0	6	0	0
14	74555269	rs17096208	G	A	4	4	8	0	0	8	0	0
14	74556884	rs7149639	A	G	2	7	9	0	1	10	0	0
14	74556949	rs7150171	G	T	4	10	14	0	0	14	0	0
14	74557102	rs6574160	A	G	2	4	6	0	0	6	0	0
14	74557131	rs6574161	C	T	2	4	6	0	0	6	0	0
14	74666641	rs887595	A	G	23	18	41	0	0	41	0	0
14	74666824	.	A	G	16	10	26	0	0	26	0	0
14	74756539	rs3213499	A	G	5	11	16	0	0	16	0	0
14	74759006	rs3742801	C	T	34	32	66	0	0	66	0	0
14	74759301	rs4148078	G	T	46	33	79	0	3	82	0	0
14	74759477	rs4148077	C	T	47	26	73	0	1	74	0	0
14	74760383	rs58534984	C	T	12	7	19	0	0	19	0	0
14	74761584	rs3742800	A	G	7	7	14	0	0	14	0	0
14	74766352	rs2301345	A	G	11	12	23	0	0	23	0	0
14	74769302	rs4148073	C	T	2	4	6	0	0	6	0	0
14	74961352	rs1468503	C	T	2	6	8	0	0	8	0	0
14	75128316	rs16661	A	C	190	161	351	0	2	353	0	0
14	75128425	rs9441	G	A	160	127	287	0	2	289	0	0
14	75130235	rs1045430	T	G	44	43	87	0	1	88	0	0
14	75130944	rs752857	C	T	10	7	17	0	0	17	0	0
14	75159007	rs2270424	G	A	28	18	46	0	0	46	0	0
14	75179734	rs2270425	C	G	2	4	6	0	1	7	0	0
14	75251440	rs2241275	A	G	1	5	6	0	0	6	0	0
14	75290018	rs8021280	C	G	9	8	17	0	0	17	0	0
14	75293374	rs11159104	A	G	7	3	10	0	0	10	0	0
14	75298052	rs11159105	C	T	3	4	7	0	0	7	0	0
14	75349723	rs10142574	C	T	3	5	8	0	0	8	0	0
14	75349769	rs10142822	G	A	3	4	7	0	0	7	0	0
14	75351106	rs59159639	A	G	2	6	8	0	0	8	0	0
14	75353855	rs2300596	T	C	10	8	18	0	0	18	0	0
14	75354398	rs10141310	C	G	3	6	9	0	0	9	0	0
14	75354600	rs10141438	A	G	1	7	8	0	0	8	0	0
14	75355203	rs8010840	T	C	3	7	10	0	0	10	0	0
14	75356103	rs6574199	T	C	21	18	39	0	0	39	0	0
14	75356379	rs10147749	C	T	24	29	53	0	0	53	0	0
14	75358192	rs10130971	A	G	40	41	81	0	0	81	0	0
14	75359226	rs10146501	T	C	32	17	49	0	3	52	0	0
14	75359670	rs2230237	G	A	300	249	549	0	3	552	0	0
14	75364451	rs6574200	C	T	6	2	8	0	0	8	0	0
14	75365062	rs2080087	A	G	5	1	6	0	0	6	0	0
14	75369346	rs709888	T	C	262	229	491	0	4	495	0	0
14	75369379	rs709887	T	C	239	202	441	0	5	448	2	0
14	75370123	rs13391	C	T	640	516	1156	0	11	1167	0	0
14	75370133	rs8014499	C	A	540	440	980	0	16	996	0	0
14	75386576	rs2286913	G	A	6	0	6	0	0	6	0	0
14	75472109	rs175044	G	A	4	2	6	0	0	6	0	0
14	75476071	rs4556	G	C	68	58	126	0	2	128	0	0
14	75483812	rs13712	T	C	9	9	18	0	0	18	0	0
14	75513828	rs175080	G	A	5	2	7	0	0	7	0	0
14	75520065	rs7303	T	C	3	3	6	0	0	6	0	0
14	75549370	rs1043674	T	C	20	22	42	0	0	42	0	0
14	75550584	rs11159116	G	T	16	13	29	0	0	29	0	0
14	75570293	rs11845639	C	T	7	11	18	0	0	18	0	0
14	75574087	rs10146482	C	T	9	16	25	0	0	25	0	0
14	75590822	rs8017642	G	A	13	12	25	0	0	25	0	0
14	75590846	rs175449	A	T	14	10	24	0	0	24	0	0
14	75599155	rs13099	G	A	14	8	22	0	1	23	0	0
14	75599647	rs3742771	A	G	10	9	19	0	0	19	0	0
14	75600697	rs4322591	C	T	6	4	10	0	0	10	0	0
14	75601663	rs4649	G	A	272	259	531	0	6	537	0	0
14	75601963	rs175443	C	T	4	7	11	0	0	11	0	0
14	75605792	rs1047418	A	G	4	31	35	0	0	35	0	0
14	75611320	rs77762397	G	A	8	9	17	0	0	17	0	0
14	75611455	rs117194725	C	T	4	3	7	0	0	7	0	0
14	75612083	rs12588240	C	A	3	5	8	0	0	8	0	0
14	75725067	rs56101848	T	C	2	7	9	0	0	9	0	0
14	75725418	rs61979185	T	C	2	4	6	0	0	6	0	0
14	75746144	rs4645854	C	T	28	32	60	0	1	61	0	0
14	75747118	rs1063169	G	T	54	80	134	0	4	138	0	0
14	75903613	rs117731880	G	A	5	3	8	0	0	8	0	0
14	75909727	rs909222	A	C	3	3	6	0	0	6	0	0
14	75911184	rs4899564	T	C	2	4	6	0	0	6	0	0
14	75911912	rs4899565	A	G	14	19	33	0	0	33	0	0
14	75912098	rs4899566	A	G	16	14	30	0	0	30	0	0
14	75912137	rs10483868	C	T	14	19	33	0	0	33	0	0
14	75912479	rs2359795	T	C	13	15	28	0	0	28	0	0
14	75912847	rs2081338	A	G	19	25	44	0	0	44	0	0
14	75926285	rs10130710	T	C	3	3	6	0	0	6	0	0
14	75926297	rs10141767	G	A	4	3	7	0	0	7	0	0
14	75927117	rs1477459	C	T	4	13	17	0	0	17	0	0
14	75927119	rs1477460	T	C	4	13	17	0	0	17	0	0
14	75927317	rs1477461	T	C	4	3	7	0	0	7	0	0
14	75936466	rs9348	C	T	563	401	964	0	7	971	0	0
14	75937022	rs10057	G	A	152	155	307	0	6	313	0	0
14	76011326	rs4903326	A	G	5	1	6	0	0	6	0	0
14	76151092	rs77439688	A	G	4	5	9	0	0	9	0	0
14	76156609	rs2303345	C	T	5	8	13	0	0	13	0	0
14	76231655	rs61980797	A	G	6	0	6	0	0	6	0	0
14	76368544	rs1133834	T	C	12	14	26	0	0	26	0	0
14	76549752	rs8536	G	A	5	6	11	0	0	11	0	0
14	77236380	rs3815550	C	T	7	5	12	0	0	12	0	0
14	77239567	rs2075772	A	G	4	2	6	0	0	6	0	0
14	77246758	rs2280796	C	T	16	20	36	0	1	37	0	0
14	77252510	rs1989376	C	T	5	7	12	0	1	13	0	0
14	77254836	rs2242624	A	C	15	9	24	0	0	24	0	0
14	77492891	rs879027	G	A	73	77	150	0	1	151	0	0
14	77493788	.	C	T	3	3	6	0	0	6	0	0
14	77494682	rs12897921	G	A	38	38	76	0	1	77	0	0
14	77703057	rs403291	A	G	5	5	10	0	0	10	0	0
14	77708804	rs61731611	C	T	4	7	11	0	0	11	0	0
14	77724226	rs3813539	G	A	9	11	20	0	0	20	0	0
14	77736154	.	C	G	12	0	12	0	1	13	0	0
14	77746112	rs11625197	T	C	4	2	6	0	0	6	0	0
14	77746804	.	C	T	12	13	25	0	1	26	0	0
14	77928525	rs1061638	A	G	72	72	144	0	2	146	0	0
14	77931605	rs17105824	G	C	7	1	8	0	0	8	0	0
14	77935659	rs11539461	G	A	94	90	184	0	0	184	0	0
14	77974990	rs1063271	C	T	8	12	20	0	0	20	0	0
14	77975103	rs1063270	T	G	4	4	8	0	0	8	0	0
14	77975925	rs10147023	C	T	7	5	12	0	0	12	0	0
14	77976325	rs11159269	T	C	4	3	7	0	0	7	0	0
14	77976450	rs17824567	T	G	4	6	10	0	0	10	0	0
14	77976468	rs45493395	T	C	3	6	9	0	0	9	0	0
14	77987958	rs2072672	C	A	30	17	47	0	0	47	0	0
14	77988648	rs2299910	G	A	9	20	29	0	0	29	0	0
14	77990302	rs12589478	G	A	12	5	17	0	1	18	0	0
14	77991106	rs10147810	C	T	29	16	45	0	0	45	0	0
14	77993620	rs138284086	T	C	8	1	9	0	1	10	0	0
14	77993956	rs72683250	G	A	12	6	18	0	0	18	0	0
14	77993957	rs72683251	C	G	11	6	17	0	0	17	0	0
14	77994447	rs79842708	C	G	4	9	13	0	0	13	0	0
14	77995041	rs28676801	C	T	4	3	7	0	1	8	0	0
14	77995599	.	T	C	6	8	14	0	1	15	0	0
14	77995600	.	T	C	13	2	15	0	2	17	0	0
14	77996330	rs2299911	C	T	5	8	13	0	0	13	0	0
14	77997637	rs147697521	C	T	9	4	13	0	0	13	0	0
14	77998797	rs56208416	G	A	1	6	7	0	0	7	0	0
14	78000160	.	G	A	3	6	9	0	0	9	0	0
14	78000331	rs28482839	G	A	5	1	6	0	0	6	0	0
14	78000949	rs4903596	T	C	3	4	7	0	0	7	0	0
14	78001357	rs4903600	G	A	18	9	27	0	0	27	0	0
14	78001602	rs34359219	G	A	21	18	39	0	1	40	0	0
14	78015897	rs2284230	C	T	2	5	7	0	0	7	0	0
14	78040095	rs12148048	C	A	20	16	36	0	0	36	0	0
14	78040434	rs61990793	A	G	12	7	19	0	1	20	0	0
14	78041522	rs12586884	C	T	4	2	6	0	0	6	0	0
14	78062644	rs113271346	T	C	10	7	17	0	0	17	0	0
14	78062994	rs34278364	C	T	12	12	24	0	1	25	0	0
14	78080746	rs2267751	A	G	5	5	10	0	0	10	0	0
14	78080783	rs8021660	G	A	5	2	7	0	1	8	0	0
14	78081469	rs17752117	C	A	5	3	8	0	0	8	0	0
14	78150227	rs9323649	C	T	3	5	8	0	0	8	0	0
14	78153269	rs4903630	C	T	0	6	6	0	0	6	0	0
14	78154069	rs61992917	T	C	2	4	6	0	0	6	0	0
14	78179185	rs79159906	C	T	2	4	6	0	0	6	0	0
14	78183451	rs17106259	G	C	4	4	8	0	0	8	0	0
14	78185723	rs61993669	G	A	3	7	10	0	0	10	0	0
14	78187032	rs45611739	T	C	6	4	10	0	0	10	0	0
14	78188937	rs61993671	A	T	3	3	6	0	0	6	0	0
14	78195733	rs10162548	T	C	5	2	7	0	0	7	0	0
14	78195782	rs176978	T	C	8	1	9	0	0	9	0	0
14	78197365	rs114763	C	T	193	184	377	0	6	384	1	0
14	78203713	rs45519831	T	C	5	10	15	0	0	15	0	0
14	78204986	rs11851588	G	A	3	5	8	0	0	8	0	0
14	78205855	rs1030151	C	T	4	2	6	0	0	6	0	0
14	78228167	rs57485881	G	C	3	4	7	0	0	7	0	0
14	81642996	rs10483974	G	C	3	4	7	0	1	8	0	0
14	81643800	rs4899786	G	T	13	16	29	0	0	29	0	0
14	81686319	rs10149681	G	A	4	2	6	0	0	6	0	0
14	81728194	rs17111619	C	A	52	55	107	0	1	108	0	0
14	81729751	rs6574634	A	G	6	11	17	0	0	17	0	0
14	81732758	rs10133562	T	C	18	10	28	0	0	28	0	0
14	81735565	rs8007595	T	G	4	4	8	0	0	8	0	0
14	81737076	rs2241621	A	C	24	18	42	0	0	42	0	0
14	81859994	rs4089876	A	T	3	4	7	0	0	7	0	0
14	86595036	rs8003714	G	T	6	0	6	0	0	6	0	0
14	86595965	rs7146598	C	T	15	6	21	0	0	21	0	0
14	87919480	rs139800033	A	T	6	2	8	0	0	8	0	0
14	88414211	rs398076	G	A	17	13	30	0	0	30	0	0
14	88477882	rs3742704	A	C	45	35	80	0	0	80	0	0
14	89074404	.	C	T	10	2	12	0	4	16	0	0
14	89844150	rs74963309	G	A	3	4	7	0	0	7	0	0
14	89847011	rs12880900	C	T	4	3	7	0	0	7	0	0
14	90390566	rs2281753	A	G	4	2	6	0	1	7	0	0
14	90390631	rs2281754	T	C	5	1	6	0	0	6	0	0
14	90393192	rs57584574	A	G	7	14	21	0	1	22	0	0
14	90398907	rs8778	G	A	11	15	26	0	0	26	0	0
14	90420298	rs3736860	C	T	6	10	16	0	0	16	0	0
14	90422928	rs35439694	A	G	7	3	10	0	0	10	0	0
14	90429749	rs3825663	A	G	6	11	17	0	0	17	0	0
14	90509564	rs9488	C	T	23	12	35	0	0	35	0	0
14	90509880	rs7150480	T	C	4	6	10	0	0	10	0	0
14	90510935	rs34004710	G	A	49	36	85	0	2	87	0	0
14	90510939	rs34923595	C	T	53	40	93	0	0	93	0	0
14	90510947	rs35944390	C	G	56	34	90	0	1	91	0	0
14	90723152	rs3825662	A	G	4	3	7	0	0	7	0	0
14	90723172	rs8005870	A	C	4	3	7	0	0	7	0	0
14	90723660	rs11848894	C	A	3	6	9	0	0	9	0	0
14	90724177	rs2151749	G	A	3	6	9	0	0	9	0	0
14	90724399	rs60548738	G	A	37	28	65	0	2	67	0	0
14	90729565	rs4904663	G	T	6	0	6	0	0	6	0	0
14	90729931	rs8022531	T	C	12	17	29	0	0	29	0	0
14	90729984	rs8015510	C	T	16	18	34	0	0	34	0	0
14	90730071	rs4811	C	T	153	162	315	0	5	320	0	0
14	90730265	rs2282030	G	A	6	4	10	0	0	10	0	0
14	90730943	rs2282031	T	C	4	10	14	0	0	14	0	0
14	90732150	rs7145398	T	C	19	20	39	0	1	40	0	0
14	90732280	rs7144335	A	G	19	13	32	0	0	32	0	0
14	90732554	rs943989	G	T	25	15	40	0	0	40	0	0
14	90732703	rs17260827	G	A	26	17	43	0	0	43	0	0
14	90733012	rs3783838	A	G	19	20	39	0	2	41	0	0
14	90733656	rs11159959	C	T	5	8	13	0	0	13	0	0
14	90734378	rs2236402	G	C	41	24	65	0	2	67	0	0
14	90734953	rs11628952	T	C	1	10	11	0	0	11	0	0
14	90735707	rs3742673	A	G	7	2	9	0	0	9	0	0
14	90736325	rs2236403	C	T	10	17	27	0	0	27	0	0
14	90738002	rs11628906	C	T	3	5	8	0	0	8	0	0
14	90738165	rs11624890	T	A	3	6	9	0	0	9	0	0
14	90744672	rs10184	G	A	50	20	70	0	1	71	0	0
14	90745422	rs3737035	T	C	30	31	61	0	2	63	0	0
14	90746471	rs11623736	G	T	9	4	13	0	0	13	0	0
14	90767607	rs3825661	C	T	7	9	16	0	1	17	0	0
14	90863489	rs12886342	G	A	86	80	166	0	0	166	0	0
14	90864848	rs2300496	C	A	8	15	23	0	1	24	0	0
14	90865283	rs2300497	T	C	10	15	25	0	0	25	0	0
14	90865462	rs2300498	C	G	17	13	30	0	0	30	0	0
14	90865717	rs2300500	G	C	10	19	29	0	0	29	0	0
14	90866346	rs2268433	C	T	17	16	33	0	0	33	0	0
14	90868442	rs2300502	G	A	11	5	16	0	0	16	0	0
14	90869913	rs3213718	C	T	6	14	20	0	0	20	0	0
14	90872505	rs3814845	C	G	58	41	99	0	1	100	0	0
14	90873412	rs3179089	C	G	88	73	161	0	0	161	0	0
14	90873798	rs1058903	C	T	91	90	181	0	1	182	0	0
14	91008804	rs1294573	G	A	5	3	8	0	0	8	0	0
14	91239038	rs75644554	G	A	25	19	44	0	0	44	0	0
14	91383854	rs1286131	T	C	3	7	10	0	0	10	0	0
14	91384576	rs1286129	A	G	1	5	6	0	0	6	0	0
14	91385651	rs2145958	A	T	2	5	7	0	0	7	0	0
14	91404688	rs1286119	T	C	8	10	18	0	0	18	0	0
14	91753004	rs17127209	A	C	2	5	7	0	0	7	0	0
14	91753033	rs7143715	G	T	5	2	7	0	0	7	0	0
14	91773494	rs1970911	G	A	17	13	30	0	0	30	0	0
14	91773568	rs1970912	T	C	15	17	32	0	1	33	0	0
14	91845133	rs1046311	A	G	5	8	13	0	0	13	0	0
14	91847234	rs12437041	A	G	2	5	7	0	0	7	0	0
14	91872440	rs117851932	C	A	1	6	7	0	0	7	0	0
14	91873792	rs1285835	C	T	2	4	6	0	0	6	0	0
14	91923988	rs10329	C	A	26	15	41	0	0	41	0	0
14	91925027	rs10135595	G	T	388	385	773	0	5	778	0	0
14	91927243	.	G	T	3	6	9	0	0	9	0	0
14	91928286	rs2273647	C	T	6	5	11	0	0	11	0	0
14	91934969	rs12590726	A	G	1	6	7	0	1	8	0	0
14	91935587	rs12437182	A	G	2	4	6	0	0	6	0	0
14	91935904	rs35732175	T	C	6	5	11	0	0	11	0	0
14	91936044	rs1957081	T	C	3	4	7	0	1	8	0	0
14	91936697	rs10873408	A	C	3	3	6	0	0	6	0	0
14	91941141	rs11625753	T	C	8	7	15	0	1	16	0	0
14	91944911	rs876561	G	A	8	25	33	0	0	33	0	0
14	91945502	rs11626225	G	T	12	16	28	0	0	29	1	0
14	91945678	rs11626297	G	A	1	18	19	0	0	19	0	0
14	91946132	rs10146333	C	T	7	12	19	0	1	20	0	0
14	91946662	rs12589936	G	A	1	10	11	0	1	12	0	0
14	91946995	rs11628439	C	T	3	5	8	0	0	8	0	0
14	91947140	rs11628461	A	G	6	8	14	0	0	14	0	0
14	91947508	rs12050230	T	G	6	1	7	0	0	8	1	0
14	91948043	rs17127374	T	C	121	112	233	0	0	233	0	0
14	92441066	rs1051340	C	T	9	14	23	0	1	24	0	0
14	92505600	rs2295174	C	A	57	85	142	0	0	142	0	0
14	92505915	rs17127898	T	A	76	73	149	0	2	151	0	0
14	92525471	rs8022758	C	T	17	21	38	0	1	39	0	0
14	92526243	.	A	C	31	19	50	0	1	51	0	0
14	92526614	rs11621770	A	T	9	7	16	0	0	16	0	0
14	92527977	rs11628764	T	C	22	8	30	0	1	31	0	0
14	92582655	rs11160044	T	A	2	4	6	0	0	6	0	0
14	92582680	.	T	C	4	3	7	0	0	7	0	0
14	92583001	rs7160819	C	T	3	4	7	0	0	7	0	0
14	92584064	rs12882784	A	G	12	7	19	0	0	19	0	0
14	92584215	rs12883370	G	A	20	21	41	0	1	42	0	0
14	92585205	rs7152991	T	C	6	3	9	0	0	9	0	0
14	92585304	rs34114160	C	A	7	1	8	0	1	9	0	0
14	92585587	rs7152429	C	T	6	1	7	0	2	9	0	0
14	92585838	rs7152807	C	G	3	3	6	0	0	6	0	0
14	92586247	rs7158184	G	A	4	3	7	0	0	7	0	0
14	92586558	rs79507139	G	A	6	0	6	0	0	6	0	0
14	92586561	rs1950811	A	C	0	6	6	0	0	6	0	0
14	92586567	rs4548800	C	T	0	6	6	0	0	6	0	0
14	92586869	rs1950813	T	C	5	3	8	0	0	8	0	0
14	92587538	rs34949057	A	G	3	4	7	0	0	7	0	0
14	92587588	rs7143401	G	A	19	6	25	0	1	26	0	0
14	92587804	rs7143338	A	C	9	4	13	0	0	13	0	0
14	92588002	rs3818263	T	G	138	89	227	0	2	229	0	0
14	92588192	rs12886909	T	C	3	3	6	0	0	6	0	0
14	92588219	rs7148709	G	A	3	3	6	0	0	6	0	0
14	92590120	rs7149665	C	T	6	0	6	0	0	6	0	0
14	92602887	rs2402113	T	C	2	4	6	0	0	6	0	0
14	92629979	rs12590449	C	T	24	23	47	0	0	47	0	0
14	92981606	rs55930890	C	G	87	85	172	0	0	172	0	0
14	93022528	rs12587808	C	G	5	2	7	0	0	7	0	0
14	93118038	rs3829947	A	G	38	32	70	0	1	71	0	0
14	93118198	rs3814830	C	T	44	17	61	0	0	61	0	0
14	93118668	rs3742717	C	T	142	130	272	0	2	274	0	0
14	93118669	rs3742716	G	A	136	136	272	0	7	279	0	0
14	93119725	rs61992600	G	A	12	7	19	0	0	19	0	0
14	93120620	rs7160920	C	T	8	5	13	0	0	13	0	0
14	93120683	rs34141236	A	G	12	5	17	0	0	17	0	0
14	93120719	rs11629324	C	T	12	5	17	0	1	18	0	0
14	93121370	rs11849307	T	C	5	7	12	0	0	12	0	0
14	93121725	rs61992602	A	G	13	11	24	0	1	25	0	0
14	93123142	rs11624035	A	G	15	13	28	0	0	28	0	0
14	93123534	rs35291284	C	T	14	16	30	0	1	31	0	0
14	93123549	rs2402174	G	A	15	9	24	0	1	25	0	0
14	93123991	rs12879040	G	A	14	4	18	0	0	18	0	0
14	93124994	rs56019622	C	G	20	9	29	0	1	30	0	0
14	93125282	rs12885166	G	T	5	1	6	0	0	6	0	0
14	93126557	rs7155457	T	C	4	14	18	0	0	18	0	0
14	93127184	rs12896481	G	A	10	6	16	0	0	16	0	0
14	93127411	rs12896830	G	A	19	7	26	0	0	26	0	0
14	93128101	.	C	A	3	11	14	0	1	15	0	0
14	93129982	rs11160087	G	A	9	15	24	0	0	24	0	0
14	93130227	rs4900140	A	G	12	29	41	0	0	41	0	0
14	93131547	rs8014880	G	A	4	14	18	0	0	18	0	0
14	93131849	rs12890220	G	C	17	10	27	0	1	28	0	0
14	93131973	rs9672040	A	G	26	5	31	0	0	31	0	0
14	93132015	rs7157523	C	T	5	22	27	0	0	27	0	0
14	93132080	rs12590630	G	C	14	2	16	0	0	16	0	0
14	93132299	rs12895078	G	C	20	16	36	0	0	36	0	0
14	93152137	rs12887391	A	C	15	14	29	0	0	29	0	0
14	93152184	rs12888973	T	C	22	13	35	0	0	35	0	0
14	93152220	rs4900141	A	G	29	18	47	0	1	48	0	0
14	93153412	rs61994063	G	A	7	16	23	0	0	23	0	0
14	93170741	rs2250672	T	C	6	6	12	0	0	12	0	0
14	93170901	rs2402189	A	C	8	8	16	0	0	16	0	0
14	93170993	rs9791	C	T	4	4	8	0	0	8	0	0
14	93171553	rs4904977	A	C	11	6	17	0	0	17	0	0
14	93173473	rs8012639	G	C	12	16	28	0	0	28	0	0
14	93173488	rs8013557	T	C	8	17	25	0	0	25	0	0
14	93173860	rs6575282	C	G	41	30	71	0	0	71	0	0
14	93263982	rs17128572	C	G	34	21	55	0	1	56	0	0
14	93273571	rs45539743	A	G	8	10	18	0	0	18	0	0
14	93275841	rs17128583	A	G	27	15	42	0	0	42	0	0
14	93406160	rs74074511	G	A	7	6	13	0	0	13	0	0
14	93406702	rs3814828	A	G	87	59	146	0	1	147	0	0
14	93407062	rs1043542	A	G	75	49	124	0	0	124	0	0
14	93407248	rs11446	A	G	58	46	104	0	1	105	0	0
14	93407301	rs13316	C	A	33	40	73	0	0	73	0	0
14	93407486	rs12588550	C	T	60	61	121	0	0	121	0	0
14	93407771	rs7140970	G	A	22	17	39	0	0	39	0	0
14	93649201	rs1128801	G	C	157	123	280	0	1	281	0	0
14	93673655	rs2286653	G	A	26	25	51	0	0	51	0	0
14	93681742	rs3783901	T	C	3	4	7	0	0	7	0	0
14	93682932	rs76122387	T	C	3	6	9	0	0	9	0	0
14	93683659	rs1263398	T	C	6	1	7	0	0	7	0	0
14	93684814	rs10132640	T	C	3	4	7	0	0	7	0	0
14	93685097	rs17128941	C	T	9	9	18	0	0	18	0	0
14	93685167	rs113599144	T	C	8	3	11	0	0	11	0	0
14	93685221	rs1152435	G	T	8	2	10	0	0	10	0	0
14	93693604	rs10144530	T	G	71	63	134	0	0	134	0	0
14	93694159	rs1043640	G	A	96	73	169	0	1	170	0	0
14	93694679	rs11547258	T	C	118	89	207	0	0	207	0	0
14	93694680	rs74709229	G	A	118	89	207	0	0	207	0	0
14	93695018	rs3742709	G	A	151	124	275	0	4	280	1	0
14	93707752	rs73340064	G	A	3	3	6	0	0	6	0	0
14	93707909	rs17749087	G	C	4	2	6	0	0	6	0	0
14	93755562	rs12433927	C	T	6	2	8	0	0	8	0	0
14	93787926	rs144893090	A	G	9	8	17	0	0	17	0	0
14	94423899	rs12436182	C	T	2	6	8	0	0	8	0	0
14	94423922	rs2402377	G	T	6	4	10	0	0	10	0	0
14	94423997	rs12436854	G	A	4	4	8	0	0	8	0	0
14	94514901	rs11622635	A	T	9	5	14	0	1	15	0	0
14	94515007	rs1045869	T	C	7	3	10	0	1	11	0	0
14	94515150	rs1114	G	A	6	5	11	0	0	11	0	0
14	94518080	rs8013920	G	C	4	2	6	0	0	6	0	0
14	94520228	rs77124857	G	A	12	10	22	0	0	22	0	0
14	94520260	rs11846532	C	T	15	8	23	0	0	23	0	0
14	94520694	rs10136663	G	C	19	15	34	0	0	34	0	0
14	94521263	rs11624586	C	T	15	12	27	0	0	27	0	0
14	94525447	rs8003508	C	T	2	5	7	0	0	7	0	0
14	94529123	rs34390971	G	A	2	7	9	0	0	9	0	0
14	94547478	rs11549780	C	T	66	70	136	0	3	139	0	0
14	94568083	rs12881245	A	T	10	6	16	0	0	16	0	0
14	94844843	rs1303	T	G	45	67	112	0	0	112	0	0
14	94854902	rs11558258	A	G	2	9	11	0	0	11	0	0
14	94856884	rs56367058	C	T	9	22	31	0	2	33	0	0
14	94856914	rs8004738	G	A	22	8	30	0	0	30	0	0
14	95267286	rs6575464	G	A	6	0	6	0	0	6	0	0
14	95554142	rs1057035	T	C	22	21	43	0	0	43	0	0
14	95874397	rs3168818	G	A	13	16	29	0	0	29	0	0
14	95876097	rs3742344	C	G	2	4	6	0	0	6	0	0
14	95876387	rs3742343	C	A	8	4	12	0	0	12	0	0
14	95884323	rs12434757	G	A	3	7	10	0	0	10	0	0
14	95906321	rs9671369	G	A	9	6	15	0	0	15	0	0
14	95908492	rs11624688	G	T	4	2	6	0	0	6	0	0
14	95914647	rs17092294	T	C	8	28	36	0	0	36	0	0
14	95914751	rs28450546	T	C	3	13	16	0	0	16	0	0
14	95915368	rs17092298	G	A	3	14	17	0	0	17	0	0
14	95915406	rs17092301	T	A	3	13	16	0	0	16	0	0
14	95915655	rs117361699	G	C	5	19	24	0	0	24	0	0
14	95918625	rs4905318	T	C	9	12	21	0	0	21	0	0
14	95918928	rs4905323	G	T	5	1	6	0	0	6	0	0
14	95921741	rs4905324	C	T	12	23	35	0	1	36	0	0
14	95923670	rs2024863	A	C	10	11	21	0	1	22	0	0
14	95926078	rs7160702	C	T	1	5	6	0	0	6	0	0
14	96007810	rs1007813	C	T	3	6	9	0	0	9	0	0
14	96009307	rs716315	C	T	4	3	7	0	0	7	0	0
14	96009748	rs10484052	A	G	4	7	11	0	1	12	0	0
14	96009962	rs12050232	T	C	7	7	14	0	0	14	0	0
14	96010070	rs35968066	T	C	8	5	13	0	0	13	0	0
14	96010589	rs7120	G	A	231	213	444	0	2	446	0	0
14	96747986	rs10134160	T	C	54	51	105	0	0	105	0	0
14	96748288	rs7150025	T	G	65	70	135	0	2	137	0	0
14	96748610	rs7150634	T	C	27	22	49	0	0	49	0	0
14	96748876	rs3809420	T	C	31	21	52	0	1	53	0	0
14	96748991	rs3809421	A	G	32	22	54	0	0	54	0	0
14	96749381	rs4900321	A	T	22	27	49	0	3	52	0	0
14	96749759	rs3742476	G	A	34	20	54	0	0	54	0	0
14	96749846	rs3742475	T	C	14	17	31	0	0	31	0	0
14	96751010	rs8019013	T	C	15	9	24	0	0	24	0	0
14	96777468	rs3759601	G	C	14	8	22	0	0	22	0	0
14	96784847	rs12882717	A	G	8	8	16	0	0	16	0	0
14	96820342	rs72704901	T	C	3	4	7	0	0	7	0	0
14	96820446	rs12147175	G	A	14	14	28	0	0	28	0	0
14	96820777	rs12147185	G	A	98	80	178	0	2	180	0	0
14	96821049	rs77574609	T	C	46	34	80	0	1	81	0	0
14	96821396	rs11160333	C	T	47	36	83	0	1	84	0	0
14	96823739	rs72704902	C	T	9	12	21	0	1	22	0	0
14	96827247	rs4905485	A	T	3	4	7	0	0	7	0	0
14	96852071	rs1545280	T	C	16	16	32	0	0	32	0	0
14	97006750	.	C	T	5	1	6	0	0	6	0	0
14	97299853	rs2145635	A	G	34	34	68	0	0	68	0	0
14	97321689	rs2230532	C	T	95	61	156	0	0	156	0	0
14	97343323	rs736929	T	C	6	11	17	0	0	17	0	0
14	99876216	rs2943	G	A	18	6	24	0	0	24	0	0
14	99876505	rs1047351	A	G	23	12	35	0	1	36	0	0
14	99880878	rs2400665	C	G	6	4	10	0	0	10	0	0
14	99924036	rs941554	G	A	18	10	28	0	0	28	0	0
14	99932341	rs2144798	A	C	18	10	28	0	0	28	0	0
14	99933825	rs3809412	C	T	6	10	16	0	0	16	0	0
14	99934161	rs1884526	T	C	11	13	24	0	0	24	0	0
14	99935261	rs11621155	A	G	15	6	21	0	1	22	0	0
14	99936258	rs8011670	G	A	11	8	19	0	0	19	0	0
14	99936321	rs8011858	G	A	7	6	13	0	0	13	0	0
14	99936947	rs11622717	C	G	6	9	15	0	0	15	0	0
14	99938225	rs941552	T	C	8	6	14	0	0	14	0	0
14	99938340	rs8023115	G	A	7	2	9	0	0	9	0	0
14	99942692	rs10136777	G	A	4	2	6	0	0	6	0	0
14	99948357	rs3918038	C	G	5	5	10	0	0	10	0	0
14	99948585	rs1950598	A	G	13	8	21	0	0	21	0	0
14	99949522	rs8015304	A	G	6	6	12	0	0	12	0	0
14	99950336	rs10145006	C	G	4	5	9	0	0	9	0	0
14	99954084	rs3918051	A	G	9	14	23	0	0	23	0	0
14	99954792	rs61984133	T	A	9	8	17	0	0	17	0	0
14	99955474	rs185297608	A	T	9	8	17	0	0	17	0	0
14	99957703	rs2400677	T	C	28	21	49	0	0	49	0	0
14	99957927	rs2400678	T	A	19	12	31	0	0	31	0	0
14	99961086	rs72704588	A	G	9	2	11	0	0	11	0	0
14	99968377	rs2069496	C	T	2	4	6	0	0	6	0	0
14	99971294	rs3918094	C	T	39	32	71	0	0	71	0	0
14	99971361	rs3918095	G	A	36	21	57	0	0	57	0	0
14	100572508	rs72711948	G	T	7	3	10	0	0	10	0	0
14	100599437	rs941898	G	T	5	13	18	0	0	18	0	0
14	100604822	rs3783338	C	T	20	7	27	0	0	27	0	0
14	100606678	rs6575764	G	T	3	4	7	0	0	7	0	0
14	100734668	rs3783340	A	G	2	4	6	0	0	6	0	0
14	100742355	rs35696661	G	C	41	52	93	0	1	94	0	0
14	100743555	rs35788933	C	T	11	9	20	0	0	20	0	0
14	100759046	rs3825555	C	A	45	28	73	0	0	73	0	0
14	100759738	rs3809409	A	C	13	6	19	0	0	19	0	0
14	100760272	rs35022210	C	T	13	8	21	0	1	22	0	0
14	100762740	rs7143776	A	G	1	6	7	0	0	7	0	0
14	100766664	rs10873515	G	A	4	9	13	0	0	13	0	0
14	100768007	rs8020584	T	C	6	5	11	0	0	11	0	0
14	100768021	rs8019432	C	T	5	5	10	0	0	10	0	0
14	100768069	rs8019885	G	T	2	4	6	0	0	6	0	0
14	100769163	rs1059264	C	T	5	4	9	0	0	9	0	0
14	100769938	rs2281892	G	A	4	2	6	0	0	6	0	0
14	100771572	rs8007427	C	T	9	13	22	0	0	22	0	0
14	101297454	rs35431412	T	C	0	98	98	0	0	98	0	0
14	101297515	rs10147988	A	G	0	89	89	0	0	89	0	0
14	101297963	rs3087918	T	G	0	46	46	0	1	47	0	0
14	101298031	rs3087917	A	G	0	52	52	0	0	52	0	0
14	101299000	rs3742390	C	T	0	30	30	0	0	31	1	0
14	101300567	rs2400941	C	G	0	74	74	0	1	75	0	0
14	101301262	.	G	A	127	0	127	0	1	128	0	0
14	101301866	rs1053900	C	T	0	158	158	0	2	160	0	0
14	101301982	rs1054000	A	C	150	0	150	0	1	151	0	0
14	101302090	rs8013873	C	T	469	0	469	0	2	471	0	0
14	101302270	rs74080162	G	C	197	0	197	0	0	197	0	0
14	101302463	rs55996894	G	C	6	0	6	0	0	6	0	0
14	101312869	rs1054013	G	A	0	9	9	0	0	9	0	0
14	101320319	rs2400942	G	A	10	0	10	0	0	10	0	0
14	101323211	rs8012953	C	T	0	6	6	0	0	6	0	0
14	101323546	rs2281510	A	G	0	7	7	0	0	7	0	0
14	101587305	rs56765774	A	C	19	15	34	0	0	34	0	0
14	102025158	rs8011440	C	T	6	3	9	0	0	9	0	0
14	102283677	rs78571641	G	T	4	2	6	0	0	6	0	0
14	102286300	rs67946231	G	A	5	9	14	0	0	14	0	0
14	102287568	rs5026256	T	G	5	2	7	0	0	7	0	0
14	102287747	rs77546365	G	A	4	7	11	0	0	11	0	0
14	102288143	rs73356812	G	A	9	5	14	0	0	14	0	0
14	102288663	rs961495	A	G	5	3	8	0	0	8	0	0
14	102289334	rs67245746	C	T	12	15	27	0	0	27	0	0
14	102291595	rs10129676	T	G	6	1	7	0	0	7	0	0
14	102292122	rs73356822	G	A	13	4	17	0	0	17	0	0
14	102292328	rs61994049	A	G	4	6	10	0	0	10	0	0
14	102292868	rs73356829	T	C	10	5	15	0	0	15	0	0
14	102295146	rs66678081	C	G	8	7	15	0	0	15	0	0
14	102295214	rs73356837	T	C	5	3	8	0	0	9	1	0
14	102295343	rs66877816	A	G	5	10	15	0	1	16	0	0
14	102296018	rs2281773	G	A	23	21	44	0	0	44	0	0
14	102296083	rs2281772	G	C	36	24	60	0	2	62	0	0
14	102296484	rs12432571	A	G	4	4	8	0	0	8	0	0
14	102296578	rs12432614	C	T	7	7	14	0	0	14	0	0
14	102296740	rs61994050	G	A	5	14	19	0	0	19	0	0
14	102297215	rs8016207	C	G	2	6	8	0	0	8	0	0
14	102297758	rs8018344	T	C	6	9	15	0	1	16	0	0
14	102299045	rs4906147	G	T	7	3	10	0	0	10	0	0
14	102299182	rs4906148	T	C	6	4	10	0	0	10	0	0
14	102299333	rs10143160	A	G	6	0	6	0	0	6	0	0
14	102301836	rs73356862	C	T	14	10	24	0	1	25	0	0
14	102302302	rs79467866	C	T	11	14	25	0	0	25	0	0
14	102302372	rs10431745	A	G	5	14	19	0	0	19	0	0
14	102302907	rs2296153	T	C	20	17	37	0	0	37	0	0
14	102303428	rs10431642	T	C	48	47	95	0	0	95	0	0
14	102303637	rs7159203	C	T	65	41	106	0	1	107	0	0
14	102303672	rs10431643	T	C	44	23	67	0	4	72	1	0
14	102303704	rs7159403	C	G	57	45	102	0	1	103	0	0
14	102303780	rs7159905	G	A	66	47	113	0	0	113	0	0
14	102304392	rs67343520	T	C	75	76	151	0	0	151	0	0
14	102304609	rs78320727	G	T	77	62	139	0	2	141	0	0
14	102304923	rs4359371	T	C	5	7	12	0	0	12	0	0
14	102348850	rs1677989	G	T	4	2	6	0	0	6	0	0
14	102356475	rs1904298	C	T	7	1	8	0	0	8	0	0
14	102360745	rs7142002	T	C	2	4	6	0	0	6	0	0
14	102391577	rs3742424	G	C	5	5	10	0	0	10	0	0
14	102392122	rs1741143	G	A	11	10	21	0	1	22	0	0
14	102393084	rs1741144	G	A	17	14	31	0	1	32	0	0
14	102393120	rs1058327	C	G	9	15	24	0	0	24	0	0
14	102414829	rs2474679	C	T	4	3	7	0	0	7	0	0
14	102463407	rs12893215	A	G	23	27	50	0	1	51	0	0
14	102466430	rs34690489	G	A	38	37	75	0	1	76	0	0
14	102484565	rs7148324	T	C	11	6	17	0	0	17	0	0
14	102493761	rs8010870	A	G	99	85	184	0	1	185	0	0
14	102494853	rs17512621	A	T	5	1	6	0	0	6	0	0
14	102495294	rs4906175	G	A	4	5	9	0	0	9	0	0
14	102503654	rs113436309	G	A	12	3	15	0	1	16	0	0
14	102507751	rs45444691	C	T	8	7	15	0	0	15	0	0
14	102508056	rs10129889	C	A	164	146	310	0	3	313	0	0
14	102510428	rs1190606	A	G	5	1	6	0	0	6	0	0
14	102512872	rs76447849	G	A	13	9	22	0	1	23	0	0
14	102514227	rs13749	T	C	279	265	544	0	4	548	0	0
14	102514435	rs2273656	T	G	9	6	15	0	0	15	0	0
14	102514644	rs112780477	C	T	6	0	6	0	1	7	0	0
14	102547648	rs1058078	A	G	1880	1957	3837	0	6	3843	0	0
14	102548224	rs2298877	T	C	49	65	114	0	0	114	0	0
14	102549231	rs10873530	C	T	65	62	127	0	0	127	0	0
14	102552856	rs36112665	G	A	7	3	10	0	0	10	0	0
14	102666439	rs11160671	T	C	3	6	9	0	0	9	0	0
14	102666589	rs11160672	G	A	5	1	6	0	0	6	0	0
14	102669477	rs72698549	T	C	5	2	7	0	0	7	0	0
14	102675350	rs6575900	G	C	26	23	49	0	0	49	0	0
14	102677215	rs74704971	A	C	2	6	8	0	0	8	0	0
14	102679193	rs45511198	A	C	9	7	16	0	0	16	0	0
14	102686183	rs7154553	A	G	2	4	6	0	0	6	0	0
14	102695406	rs1052780	G	A	10	13	23	0	0	23	0	0
14	102695563	rs3087686	A	G	14	4	18	0	0	18	0	0
14	102695693	rs2236493	T	C	16	8	24	0	0	24	0	0
14	102698131	rs7152550	G	A	12	10	22	0	0	22	0	0
14	102807671	rs9464	C	T	36	43	79	0	0	79	0	0
14	102808273	rs1053019	C	A	60	65	125	0	1	126	0	0
14	102808562	rs56144634	C	G	67	62	129	0	0	129	0	0
14	102809559	rs8005475	A	G	5	2	7	0	1	8	0	0
14	102810628	rs2031233	T	C	4	2	6	0	0	6	0	0
14	102813867	rs60530409	T	G	6	3	9	0	0	9	0	0
14	102900956	rs118141823	C	T	8	10	18	0	0	18	0	0
14	102901023	rs45605932	G	A	8	7	15	0	0	15	0	0
14	102909991	rs17100923	C	T	12	13	25	0	0	25	0	0
14	102931767	rs73351378	T	A	17	28	45	0	0	45	0	0
14	102975265	rs8006911	A	G	29	17	46	0	0	46	0	0
14	102975266	rs8007356	G	A	31	17	48	0	0	48	0	0
14	102975552	rs3742445	T	A	11	6	17	0	0	17	0	0
14	102975572	rs3742446	C	T	9	7	16	0	0	16	0	0
14	102975655	rs1061924	C	T	2	5	7	0	0	7	0	0
14	103172319	.	C	T	11	9	20	0	0	20	0	0
14	103188515	.	C	T	6	4	10	0	0	10	0	0
14	103188738	rs61739374	C	T	52	67	119	0	1	120	0	0
14	103193028	rs2295695	G	A	58	43	101	0	0	101	0	0
14	103301072	rs7146581	C	T	5	2	7	0	1	8	0	0
14	103342049	rs1131877	T	C	50	44	94	0	1	95	0	0
14	103361736	rs11160706	G	A	5	1	6	0	1	7	0	0
14	103361937	rs57521303	T	C	6	0	6	0	0	6	0	0
14	103362017	rs4906269	A	C	5	1	6	0	0	6	0	0
14	103366542	rs7155889	A	C	5	1	6	0	0	6	0	0
14	103366698	rs7156339	C	T	7	3	10	0	0	10	0	0
14	103366718	rs112520413	A	G	3	6	9	0	0	9	0	0
14	103367667	rs3783385	G	A	10	1	11	0	0	11	0	0
14	103367708	rs3783386	C	T	9	0	9	0	0	9	0	0
14	103376031	rs4906272	C	T	6	6	12	0	0	12	0	0
14	103377321	rs10133111	G	A	17	8	25	0	1	26	0	0
14	103377354	rs11552464	T	G	16	9	25	0	0	25	0	0
14	103398891	rs7857	C	T	12	19	31	0	0	31	0	0
14	103399448	rs4708	T	C	7	9	16	0	0	16	0	0
14	103599311	rs1887940	G	A	8	2	10	0	0	10	0	0
14	103599490	rs376480634	T	C	3	3	6	0	0	6	0	0
14	103599938	rs2234143	C	T	19	3	22	0	0	22	0	0
14	103602981	rs150317393	C	G	245	191	436	0	1	437	0	0
14	103603570	rs1052823	G	T	381	376	757	0	5	762	0	0
14	103603653	rs1052912	G	A	286	209	495	0	5	500	0	0
14	103801574	rs8021359	G	T	32	22	54	0	1	55	0	0
14	103810913	rs10289	A	G	144	125	269	0	0	269	0	0
14	103811181	rs3548	A	G	165	160	325	0	1	326	0	0
14	104166994	rs3212102	C	T	121	111	232	0	7	240	1	0
14	104167611	.	G	A	82	91	173	0	3	176	0	0
14	104178670	.	C	T	1	7	8	0	0	8	0	0
14	104339517	rs149304133	G	A	3	3	6	0	0	6	0	0
14	104339548	rs34557614	C	T	4	2	6	0	0	6	0	0
14	104339590	rs34819387	C	T	5	1	6	0	0	6	0	0
14	104379206	rs2236246	G	T	11	21	32	0	0	32	0	0
14	104379912	rs2269186	C	T	7	5	12	0	0	12	0	0
14	104380925	rs112997158	C	T	7	126	133	0	0	133	0	0
14	104381502	rs1053419	T	C	497	540	1037	0	2	1039	0	0
14	104481083	rs11160779	T	C	4	2	6	0	0	6	0	0
14	104497543	rs10135507	C	T	1	5	6	0	0	6	0	0
14	104516262	rs11160784	T	C	4	3	7	0	0	7	0	0
14	104518453	rs7150461	A	G	6	9	15	0	0	15	0	0
14	105220078	rs78475567	C	T	4	2	6	0	0	6	0	0
14	105238266	rs189534725	G	A	5	11	16	0	0	16	0	0
14	105245251	rs2498794	A	G	3	6	9	0	0	9	0	0
14	105258067	rs61758463	G	A	10	3	13	0	1	14	0	0
14	105675701	rs8270	C	A	43	59	102	0	2	104	0	0
14	105676048	rs3087836	G	C	89	108	197	0	1	198	0	0
14	105678266	rs7142008	G	A	7	17	24	0	0	24	0	0
14	105678818	rs61996214	C	T	0	6	6	0	0	6	0	0
14	105679055	rs3784230	A	G	1	6	7	0	0	7	0	0
14	105679373	rs33997228	G	T	3	3	6	0	1	7	0	0
14	105679391	rs34766944	C	T	3	3	6	0	0	6	0	0
14	105679928	rs3784227	T	C	4	3	7	0	0	7	0	0
14	105680414	rs7147888	G	A	3	3	6	0	0	6	0	0
14	105686146	rs28702916	T	C	4	3	7	0	0	7	0	0
14	105693340	rs2091919	A	C	14	13	27	0	0	27	0	0
14	105856378	rs116887599	C	A	9	10	19	0	2	21	0	0
14	105930406	rs4983413	G	A	137	120	257	0	5	262	0	0
14	106109573	rs28371022	T	C	6	10	16	0	0	16	0	0
14	106110057	rs11160859	G	A	19	14	33	0	0	33	0	0
14	106110137	rs8009156	C	T	12	10	22	0	0	22	0	0
14	106110914	rs11627594	G	T	6	9	15	0	0	15	0	0
14	106110966	rs11557955	C	T	6	8	14	0	2	16	0	0
14	106134628	rs10144455	C	G	0	11	11	0	0	11	0	0
14	106134635	.	C	G	0	9	9	0	0	9	0	0
14	106134706	.	A	G	8	0	8	0	0	8	0	0
14	106173790	.	A	G	4	29	33	0	1	34	0	0
14	106173808	.	G	A	30	4	34	0	0	34	0	0
14	106207843	rs8011686	T	C	1	9	10	0	1	11	0	0
15	20870397	.	C	G	2	4	6	0	0	6	0	0
15	21938082	.	G	A	7	0	7	0	0	7	0	0
15	22925782	rs139395765	G	C	4	2	6	0	0	6	0	0
15	22925851	rs4134802	C	T	4	6	10	0	0	10	0	0
15	22930067	rs11637146	G	A	3	3	6	0	0	6	0	0
15	22931008	rs7403800	A	G	2	8	10	0	0	10	0	0
15	22939192	rs11633474	G	A	9	10	19	0	0	19	0	0
15	22960868	rs2289818	G	C	14	20	34	0	0	34	0	0
15	22998972	rs12438474	A	G	4	3	7	0	0	7	0	0
15	23004808	rs1051288	C	T	19	26	45	0	0	45	0	0
15	23004893	rs3693	A	C	15	22	37	0	0	37	0	0
15	23004957	rs1051287	G	A	21	33	54	0	0	54	0	0
15	23005202	rs3785	G	A	24	23	47	0	0	47	0	0
15	23005298	rs142941036	A	G	16	21	37	0	0	37	0	0
15	23016558	rs6606817	T	C	6	1	7	0	0	7	0	0
15	23016659	rs73420291	C	T	5	3	8	0	0	8	0	0
15	23016810	rs34180176	G	A	11	2	13	0	0	13	0	0
15	23017052	rs12911925	T	C	12	4	16	0	0	16	0	0
15	23019195	rs73420298	C	T	2	4	6	0	0	6	0	0
15	23021238	rs7170838	C	T	61	54	115	0	0	115	0	0
15	23021968	rs2117311	G	A	24	9	33	0	0	33	0	0
15	23024001	rs8028189	G	C	3	3	6	0	0	6	0	0
15	23024018	rs7167422	G	A	3	3	6	0	0	6	0	0
15	23024765	rs17806738	A	G	4	4	8	0	0	8	0	0
15	23024823	rs17137358	A	C	6	3	9	0	0	9	0	0
15	23025657	rs34324428	G	A	5	3	8	0	0	8	0	0
15	23026848	rs4778370	G	A	5	4	9	0	0	9	0	0
15	23027015	rs11263680	A	G	4	2	6	0	0	6	0	0
15	23027667	rs3764213	C	G	4	2	6	0	0	6	0	0
15	23029778	rs1865335	C	T	5	1	6	0	0	6	0	0
15	23030815	rs11635213	T	C	5	3	8	0	0	8	0	0
15	23031024	rs34308663	T	C	3	4	7	0	0	7	0	0
15	23031066	rs60371576	C	T	4	6	10	0	0	10	0	0
15	23031067	rs28459196	A	G	4	6	10	0	0	10	0	0
15	23046902	rs17807140	T	C	4	4	8	0	0	8	0	0
15	23047857	rs8025849	G	A	40	26	66	0	0	66	0	0
15	23048542	rs3812924	A	G	6	15	21	0	0	21	0	0
15	23052632	rs11263683	T	C	9	10	19	0	0	19	0	0
15	23095761	rs1808724	C	T	2	5	7	0	0	7	0	0
15	23096645	rs28546131	G	A	2	7	9	0	0	9	0	0
15	23096790	rs2347172	A	G	6	4	10	0	0	10	0	0
15	23097308	rs10152634	C	T	4	7	11	0	0	11	0	0
15	23097503	rs1808726	A	G	7	6	13	0	0	13	0	0
15	23098401	.	C	T	80	0	80	0	1	81	0	0
15	23098449	.	C	T	56	0	56	0	0	56	0	0
15	23098570	rs2881569	G	A	8	0	8	0	0	8	0	0
15	23098626	.	C	T	7	0	7	0	0	7	0	0
15	23098663	.	T	A	6	0	6	0	0	6	0	0
15	23098666	.	G	A	6	0	6	0	0	6	0	0
15	23098668	.	G	T	6	0	6	0	0	6	0	0
15	23108625	rs12324507	C	T	20	5	25	0	0	25	0	0
15	23114374	rs11635667	A	G	5	6	11	0	0	11	0	0
15	23188624	.	G	A	44	9	53	0	0	53	0	0
15	23189262	rs562169012	C	T	29	30	59	0	0	59	0	0
15	23189701	rs55687917	C	T	28	17	45	0	0	45	0	0
15	23191502	rs7167486	C	T	60	69	129	0	2	131	0	0
15	23200323	.	T	G	35	32	67	0	0	67	0	0
15	23201566	rs389677	C	A	28	30	58	0	0	58	0	0
15	23205190	rs186707745	T	C	33	20	53	0	0	54	1	0
15	23283460	rs12593588	T	A	27	17	44	0	1	45	0	0
15	25218372	rs78475481	G	C	21	0	21	0	1	22	0	0
15	25230528	.	A	C	8	0	8	0	0	8	0	0
15	25235289	rs74335291	C	G	0	46	46	0	0	46	0	0
15	25242284	rs34316840	G	C	0	10	10	0	0	10	0	0
15	25925094	rs3816800	C	G	14	22	36	0	0	36	0	0
15	25925675	rs7178018	G	A	3	3	6	0	0	6	0	0
15	25926186	rs2076743	G	A	8	22	30	0	0	30	0	0
15	25964626	rs2014016	C	T	2	4	6	0	0	6	0	0
15	26052358	rs12441479	A	C	4	2	6	0	0	6	0	0
15	26052526	rs12441532	A	G	5	1	6	0	0	6	0	0
15	28386626	rs11636232	C	T	27	18	45	0	1	46	0	0
15	28930149	rs11557518	T	C	85	93	178	0	2	180	0	0
15	29060699	rs3930183	A	G	29	5	34	0	0	34	0	0
15	29066255	rs148580559	T	C	4	2	6	0	0	6	0	0
15	29083893	rs58800852	A	G	61	32	93	0	2	95	0	0
15	29092336	rs77625797	A	G	1	6	7	0	1	8	0	0
15	29093158	rs4037363	A	G	7	12	19	0	0	19	0	0
15	29093249	rs12592684	G	A	6	20	26	0	0	26	0	0
15	29093949	rs58894774	T	G	3	4	7	0	0	7	0	0
15	29094236	rs8030319	T	C	7	5	12	0	0	12	0	0
15	29094237	rs4445872	G	A	7	5	12	0	0	12	0	0
15	29094551	rs8031002	T	C	4	2	6	0	0	6	0	0
15	29095322	rs183516498	C	T	5	5	10	0	0	10	0	0
15	29096698	rs2344375	A	G	3	6	9	0	0	9	0	0
15	29096797	rs577612799	C	T	7	5	12	0	0	12	0	0
15	29096835	rs4037373	A	G	8	2	10	0	0	10	0	0
15	29096856	rs147888517	G	A	8	2	10	0	0	10	0	0
15	29096858	rs4037374	A	G	6	2	8	0	0	8	0	0
15	29347019	rs8040932	T	C	7	1	8	0	1	9	0	0
15	29394009	rs73370275	C	T	2	6	8	0	0	8	0	0
15	29395379	rs1038731	T	C	8	12	20	0	0	20	0	0
15	29395418	rs1038730	G	A	8	9	17	0	0	17	0	0
15	29397345	rs2279491	C	T	11	4	15	0	0	15	0	0
15	29410073	rs3751555	G	C	3	3	6	0	0	6	0	0
15	30396042	rs62016990	T	C	0	12	12	0	0	12	0	0
15	30396121	.	C	A	3	16	19	0	1	20	0	0
15	30771234	.	G	A	53	0	53	0	0	53	0	0
15	30777143	rs7174800	A	T	2	4	6	0	0	6	0	0
15	30778306	rs78171004	G	A	17	0	17	0	0	17	0	0
15	30778338	rs79367536	G	A	15	2	17	0	0	17	0	0
15	30778351	rs11635528	T	C	16	2	18	0	0	18	0	0
15	30778368	.	C	G	10	2	12	0	0	12	0	0
15	30779120	rs71244531	C	T	17	11	28	0	0	28	0	0
15	30779344	rs7163399	G	A	14	10	24	0	0	24	0	0
15	30779618	rs74442269	C	G	9	6	15	0	1	16	0	0
15	30782439	rs11543065	C	T	11	0	11	0	0	11	0	0
15	30888946	rs71478486	T	A	2	4	6	0	0	6	0	0
15	30899336	.	G	C	8	4	12	0	1	13	0	0
15	30900628	rs62018325	C	G	1	5	6	0	0	6	0	0
15	30900637	rs79226001	T	G	2	5	7	0	0	7	0	0
15	30900873	.	T	C	20	3	23	0	1	24	0	0
15	30905994	.	G	A	10	9	19	0	1	20	0	0
15	30906165	rs4104459	T	C	13	15	28	0	0	28	0	0
15	30906401	.	C	T	5	5	10	0	0	10	0	0
15	30906604	.	G	C	9	5	14	0	0	14	0	0
15	30909443	rs3910034	A	G	36	11	47	0	1	48	0	0
15	30917889	.	A	G	1	9	10	0	0	10	0	0
15	30918248	rs1872093	G	C	5	2	7	0	0	7	0	0
15	30918773	rs114851315	C	G	11	2	13	0	1	14	0	0
15	30954335	rs1967030	T	C	4	4	8	0	0	8	0	0
15	31060115	rs4779494	T	C	7	7	14	0	0	14	0	0
15	31125545	rs2339043	C	T	7	2	9	0	0	9	0	0
15	31126935	rs798084	A	G	9	4	13	0	0	13	0	0
15	31129037	rs11070624	G	A	14	14	28	0	0	28	0	0
15	31175269	rs8036176	C	T	11	5	16	0	0	16	0	0
15	31191687	rs28708881	C	T	15	16	31	0	0	31	0	0
15	31197564	rs4779794	G	A	23	10	33	0	1	34	0	0
15	31210981	rs2955797	A	G	9	9	18	0	0	18	0	0
15	31211886	rs2959038	T	C	28	14	42	0	1	43	0	0
15	31217111	rs2955776	C	T	4	8	12	0	0	12	0	0
15	31218164	rs2959037	T	C	14	17	31	0	0	31	0	0
15	31219742	rs2959036	T	G	73	64	137	0	0	137	0	0
15	31219788	rs2955777	A	C	69	65	134	0	1	135	0	0
15	31229420	rs2955795	T	C	50	50	100	0	1	101	0	0
15	31230078	rs2949567	T	C	19	32	51	0	0	51	0	0
15	31231190	rs565	T	C	126	117	243	0	1	244	0	0
15	31231255	rs2873	A	G	219	176	395	0	2	397	0	0
15	31233220	rs2955792	C	T	82	52	134	0	0	134	0	0
15	31234064	rs6493352	C	T	76	97	173	0	2	175	0	0
15	31234579	rs2949568	C	T	82	86	168	0	1	169	0	0
15	31234932	rs1043251	C	T	130	127	257	0	2	259	0	0
15	31235357	rs2293319	C	T	3	4	7	0	0	7	0	0
15	31235575	rs2293320	T	G	3	3	6	0	0	6	0	0
15	31236145	rs2339048	T	C	46	107	153	0	2	155	0	0
15	31236630	rs2339047	A	G	22	63	85	0	0	85	0	0
15	31236637	rs2959035	T	C	23	61	84	0	1	85	0	0
15	31236733	rs2959034	T	C	12	26	38	0	0	38	0	0
15	31238572	rs2949569	A	G	30	67	97	0	0	97	0	0
15	31242540	rs2949570	T	C	7	4	11	0	0	11	0	0
15	31243198	rs2955791	C	T	3	8	11	0	0	11	0	0
15	31243259	rs2949571	G	C	6	8	14	0	0	14	0	0
15	31243275	rs2959055	A	G	6	5	11	0	0	11	0	0
15	31243278	rs2949572	T	C	6	5	11	0	0	11	0	0
15	31243820	rs2140735	G	A	6	2	8	0	0	8	0	0
15	31244083	rs2955790	T	G	2	5	7	0	0	7	0	0
15	31251781	rs2949574	T	C	2	6	8	0	0	8	0	0
15	31256980	rs2949575	C	A	2	4	6	0	0	6	0	0
15	31260448	rs2955778	A	G	10	3	13	0	0	13	0	0
15	31262582	rs2949576	C	T	8	9	17	0	0	17	0	0
15	31262808	rs2949577	C	T	6	6	12	0	0	12	0	0
15	31263272	rs1524876	C	T	10	5	15	0	0	15	0	0
15	31263728	rs1404469	G	A	24	13	37	0	0	37	0	0
15	31263872	rs1404470	T	C	10	11	21	0	0	21	0	0
15	31267147	rs1133642	C	T	123	121	244	0	6	250	0	0
15	31516470	rs1060493	C	A	3	3	6	0	0	6	0	0
15	31516712	rs4779843	G	T	8	4	12	0	0	12	0	0
15	31516919	rs4779844	G	C	5	7	12	0	1	13	0	0
15	31516953	rs74221455	G	A	6	6	12	0	1	13	0	0
15	31663442	rs4779519	G	A	4	2	6	0	0	6	0	0
15	32445955	.	T	C	8	0	8	0	0	8	0	0
15	32445977	.	C	G	8	0	8	0	0	8	0	0
15	32791990	.	T	C	3	4	7	0	0	7	0	0
15	32792035	.	C	T	3	4	7	0	0	7	0	0
15	32872126	.	T	C	6	0	6	0	0	6	0	0
15	32898631	rs1062254	C	G	7	7	14	0	1	15	0	0
15	32907712	rs73369102	C	T	1	7	8	0	1	9	0	0
15	32931921	rs28457217	G	A	8	8	16	0	0	16	0	0
15	34144231	rs1134659	T	A	6	4	10	0	0	10	0	0
15	34145311	rs56258848	A	G	5	8	13	0	1	14	0	0
15	34145444	rs721400	T	A	8	2	10	0	1	11	0	0
15	34157486	rs200126350	C	T	4	4	8	0	0	8	0	0
15	34157488	rs201908377	T	C	4	4	8	0	0	8	0	0
15	34158266	rs1044129	A	G	5	1	6	0	0	6	0	0
15	34276570	rs6495421	G	A	3	3	6	0	1	7	0	0
15	34276599	rs6495422	G	C	4	3	7	0	0	7	0	0
15	34276680	rs6495423	T	C	5	1	6	0	0	6	0	0
15	34276738	rs6495424	A	G	5	3	8	0	0	8	0	0
15	34388399	rs115117959	T	A	22	19	41	0	0	41	0	0
15	34390351	rs6495519	T	G	6	4	10	0	0	10	0	0
15	34392475	rs2576308	G	A	3	7	10	0	0	10	0	0
15	34393214	rs16958770	T	C	5	9	14	0	0	14	0	0
15	34517995	rs17236770	T	G	5	6	11	0	0	11	0	0
15	34519254	rs73386041	A	G	5	2	7	0	0	7	0	0
15	34519563	rs8035954	T	G	5	3	8	0	0	8	0	0
15	34521940	rs8033087	C	A	8	6	14	0	1	15	0	0
15	34525588	rs16958873	T	C	74	52	126	0	0	126	0	0
15	34528948	rs4577050	G	A	60	86	146	0	0	146	0	0
15	34541376	rs6495646	T	C	9	5	14	0	0	14	0	0
15	34551082	rs7164902	G	A	19	23	42	0	1	43	0	0
15	34610964	rs347867	G	C	2	7	9	0	0	9	0	0
15	34629870	rs79294885	C	A	4	3	7	0	0	7	0	0
15	34634324	rs422388	C	G	5	1	6	0	0	6	0	0
15	34652261	rs72625170	C	T	7	5	12	0	0	12	0	0
15	34671278	rs4984228	A	G	6	10	16	0	0	16	0	0
15	34671583	rs8631	A	G	124	98	222	0	2	224	0	0
15	34672761	rs3169217	T	C	156	113	269	0	2	271	0	0
15	34673722	.	C	T	40	137	177	0	4	181	0	0
15	34673973	rs347879	C	T	3	12	15	0	0	15	0	0
15	34674006	.	C	T	2	8	10	0	0	10	0	0
15	34674034	.	C	T	8	1	9	0	0	9	0	0
15	34674048	.	G	A	5	1	6	0	1	7	0	0
15	34677517	rs3179271	G	A	5	2	7	0	0	7	0	0
15	34678911	.	C	G	24	16	40	0	0	40	0	0
15	34692942	.	T	C	32	10	42	0	0	42	0	0
15	34720817	.	T	A	10	0	10	0	0	10	0	0
15	34720820	rs369392103	C	A	10	0	10	0	0	10	0	0
15	34720852	rs115902813	C	G	8	1	9	0	0	9	0	0
15	34727642	rs2114262	C	G	25	25	50	0	1	51	0	0
15	34817507	rs3538	A	G	85	11	96	0	0	96	0	0
15	34817765	rs3200769	C	T	148	53	201	0	5	206	0	0
15	34818262	rs1059893	C	T	234	55	289	0	1	290	0	0
15	34818270	rs115263952	G	A	229	58	287	0	1	288	0	0
15	34818459	rs1059885	C	A	132	48	180	0	3	183	0	0
15	34818908	rs72486688	C	T	148	51	199	0	0	199	0	0
15	34818982	rs16954481	C	T	168	57	225	0	5	230	0	0
15	34819027	rs16954442	C	T	180	68	248	0	2	250	0	0
15	34819063	rs141780192	A	G	159	58	217	0	2	219	0	0
15	34819198	rs4041350	C	T	154	12	166	0	1	167	0	0
15	34819652	.	G	C	94	6	100	0	2	102	0	0
15	34820194	.	C	T	9	0	9	0	0	9	0	0
15	34820227	rs564951643	C	T	7	0	7	0	0	7	0	0
15	34856192	.	G	C	5	1	6	0	0	6	0	0
15	34856205	.	C	G	5	1	6	0	0	6	0	0
15	34856224	rs349647	A	T	5	1	6	0	0	6	0	0
15	34857251	.	T	C	6	0	6	0	0	6	0	0
15	34857334	.	C	G	6	0	6	0	0	6	0	0
15	34858607	rs16954217	G	C	10	1	11	0	0	11	0	0
15	38777833	rs61047925	A	C	43	32	75	0	0	75	0	0
15	38780856	rs56160046	T	C	6	2	8	0	0	8	0	0
15	38794566	rs12324402	A	G	7	5	12	0	0	12	0	0
15	39879747	rs9920929	G	A	3	3	6	0	1	7	0	0
15	40269052	rs34298786	G	A	3	3	6	0	0	6	0	0
15	40269333	rs7169411	T	C	4	7	11	0	1	12	0	0
15	40269501	rs4923847	C	T	4	6	10	0	0	10	0	0
15	40269916	rs117778159	T	C	4	2	6	0	0	6	0	0
15	40282701	rs2307104	T	C	3	4	7	0	0	7	0	0
15	40313141	rs3207297	C	T	56	71	127	0	0	127	0	0
15	40321351	rs3736290	C	A	11	2	13	0	0	13	0	0
15	40322124	rs937213	T	C	2	6	8	0	0	8	0	0
15	40323932	.	C	T	4	2	6	0	0	6	0	0
15	40328007	.	T	C	18	72	90	0	1	91	0	0
15	40328292	rs4770	A	G	437	270	707	0	1	708	0	0
15	40328973	rs2291620	A	G	2	4	6	0	0	6	0	0
15	40380207	rs8116	T	A	136	110	246	0	3	249	0	0
15	40380818	rs1540686	A	G	208	180	388	0	3	391	0	0
15	40380933	rs648289	T	C	198	181	379	0	1	380	0	0
15	40381272	rs34500961	C	T	71	62	133	0	2	135	0	0
15	40382924	rs117739569	C	G	82	86	168	0	1	169	0	0
15	40383779	rs3743129	A	C	71	68	139	0	2	141	0	0
15	40462780	rs1801389	G	A	28	20	48	0	1	49	0	0
15	40488851	rs1047130	G	A	36	31	67	0	0	67	0	0
15	40507243	rs7182070	T	G	4	2	6	0	0	6	0	0
15	40509600	rs2290551	A	G	4	11	15	0	2	17	0	0
15	40583560	rs62021888	G	T	15	27	42	0	1	43	0	0
15	40584164	rs2290550	C	A	53	71	124	0	0	124	0	0
15	40589218	rs2305650	C	G	46	30	76	0	0	76	0	0
15	40589460	rs12438880	C	G	22	21	43	0	1	44	0	0
15	40589830	rs2305649	G	A	31	20	51	0	1	52	0	0
15	40590134	rs2229690	G	A	105	85	190	0	1	191	0	0
15	40593199	rs11636491	C	T	9	7	16	0	0	16	0	0
15	40685850	rs11541643	A	G	10	12	22	0	1	23	0	0
15	40686087	rs11541641	T	C	19	24	43	0	0	43	0	0
15	40699940	rs2289331	T	C	5	4	9	0	0	9	0	0
15	40700483	rs68169695	T	G	2	4	6	0	0	6	0	0
15	40701966	rs73383135	G	A	4	6	10	0	0	10	0	0
15	40702038	.	T	C	3	3	6	0	0	6	0	0
15	40702509	rs72733442	T	C	3	3	6	0	0	6	0	0
15	40705225	rs2229312	C	T	22	25	47	0	0	47	0	0
15	40707456	rs875767	C	T	11	7	18	0	0	18	0	0
15	40711933	rs4923865	G	A	38	39	77	0	1	78	0	0
15	40712352	rs12185076	G	C	31	32	63	0	0	63	0	0
15	40712737	rs11790	T	C	33	33	66	0	0	66	0	0
15	40727879	rs72733450	C	A	13	9	22	0	0	22	0	0
15	40750740	rs3743143	A	G	28	17	45	0	0	45	0	0
15	40751555	rs3803357	C	A	23	31	54	0	0	54	0	0
15	40837872	rs34750756	C	T	3	5	8	0	0	8	0	0
15	40838109	rs11632370	G	T	6	3	9	0	0	9	0	0
15	40845597	rs6582	A	G	49	32	81	0	0	81	0	0
15	40845952	rs1044474	A	G	40	34	74	0	1	75	0	0
15	40855210	rs10152546	T	A	31	17	48	0	1	49	0	0
15	40862064	rs1058734	C	T	39	42	81	0	1	82	0	0
15	40862930	rs1453183	C	T	6	2	8	0	0	8	0	0
15	40915894	rs11070285	T	C	3	4	7	0	0	7	0	0
15	40916801	rs16970911	A	G	2	4	6	0	0	6	0	0
15	40955069	rs35684277	G	A	3	3	6	0	0	6	0	0
15	40979543	rs2263551	G	A	3	7	10	0	1	11	0	0
15	40979651	rs2412545	C	T	1	5	6	0	0	6	0	0
15	40987565	rs1801321	G	T	7	8	15	0	0	15	0	0
15	40993710	rs4924495	C	T	5	4	9	0	0	9	0	0
15	41023878	rs12593359	T	G	4	3	7	0	0	7	0	0
15	41024303	rs11855560	T	C	5	2	7	0	0	7	0	0
15	41030865	.	C	G	11	12	23	0	0	23	0	0
15	41031775	rs3092983	G	A	8	3	11	0	0	11	0	0
15	41032138	rs2304583	A	G	7	7	14	0	0	14	0	0
15	41036448	rs4923884	G	A	5	1	6	0	0	6	0	0
15	41038082	rs12372947	C	G	7	15	22	0	0	22	0	0
15	41038214	rs7167854	A	G	8	10	18	0	0	18	0	0
15	41038693	rs8033829	C	T	4	3	7	0	0	7	0	0
15	41040246	rs146262541	C	A	5	6	11	0	0	11	0	0
15	41041228	rs7176245	G	A	7	3	10	0	0	10	0	0
15	41041292	rs7175905	A	G	4	3	7	0	0	7	0	0
15	41041875	rs11070293	T	C	4	5	9	0	0	9	0	0
15	41063244	rs1866170	C	T	12	4	16	0	0	16	0	0
15	41099349	rs11070297	C	T	3	3	6	0	0	6	0	0
15	41101124	rs3743033	C	G	18	7	25	0	0	25	0	0
15	41101145	rs3743034	C	T	19	9	28	0	0	28	0	0
15	41102667	rs745032	A	G	1	6	7	0	0	7	0	0
15	41105926	rs690347	T	G	27	26	53	0	0	53	0	0
15	41146880	rs8028552	T	C	7	9	16	0	0	16	0	0
15	41149571	rs3189773	G	A	14	11	25	0	1	26	0	0
15	41199503	rs3100812	C	G	2	4	6	0	0	6	0	0
15	41247629	rs147487857	A	G	2	7	9	0	0	9	0	0
15	41564507	rs77674852	T	A	11	16	27	0	1	28	0	0
15	41572702	rs28493702	A	G	18	16	34	0	2	36	0	0
15	41573347	rs9972547	G	A	96	77	173	0	1	174	0	0
15	41573612	rs9568	C	A	175	180	355	0	1	356	0	0
15	41578807	rs28716689	G	C	5	7	12	0	0	12	0	0
15	41579419	rs75056850	C	T	11	8	19	0	0	19	0	0
15	41591475	rs80024738	G	A	7	37	44	0	0	44	0	0
15	41591859	rs7162231	G	A	6	10	16	0	1	17	0	0
15	41594303	rs28437576	A	C	6	3	9	0	0	9	0	0
15	41597437	rs1132639	T	A	14	14	28	0	0	28	0	0
15	41597680	rs28643296	C	A	33	32	65	0	0	65	0	0
15	41598448	rs10467974	T	G	73	54	127	0	1	128	0	0
15	41613100	rs6493000	G	C	3	3	6	0	0	6	0	0
15	41646398	rs11854081	C	T	5	3	8	0	0	8	0	0
15	41672037	rs10152497	G	A	4	3	7	0	0	7	0	0
15	41672384	rs7168431	A	G	96	82	178	0	3	181	0	0
15	41679717	rs73407109	C	T	33	5	38	0	0	38	0	0
15	41689166	rs3204853	C	A	5	11	16	0	0	16	0	0
15	41689232	rs1899	C	T	4	9	13	0	0	13	0	0
15	41694639	rs146883891	G	A	3	3	6	0	0	6	0	0
15	41769952	rs113973642	T	A	13	10	23	0	1	24	0	0
15	41773741	rs77755940	G	T	146	145	291	0	0	291	0	0
15	41775221	rs316604	C	T	49	45	94	0	0	94	0	0
15	41805237	rs2305030	C	T	17	16	33	0	0	33	0	0
15	41822163	rs61753586	C	T	7	3	10	0	1	11	0	0
15	41829230	rs721772	A	G	7	10	17	0	0	17	0	0
15	41991315	rs2178004	A	T	15	6	21	0	0	21	0	0
15	42005772	rs1918313	A	G	4	4	8	0	0	8	0	0
15	42007520	rs6493010	C	G	17	19	36	0	0	36	0	0
15	42026764	rs1918314	C	T	4	3	7	0	0	7	0	0
15	42041750	rs61757235	A	G	6	1	7	0	0	7	0	0
15	42059521	rs2605570	A	T	11	13	24	0	0	24	0	0
15	42107950	.	C	T	6	7	13	0	0	13	0	0
15	42109223	rs1197689	T	C	7	3	10	0	0	10	0	0
15	42117783	rs3743028	G	C	9	11	20	0	0	20	0	0
15	42118651	rs1197687	T	C	21	18	39	0	0	39	0	0
15	42119900	rs1043627	T	C	15	19	34	0	0	34	0	0
15	42128855	rs7166139	T	C	4	4	8	0	0	8	0	0
15	42129373	rs11547012	C	G	10	14	24	0	1	25	0	0
15	42131965	rs57498313	A	G	2	4	6	0	0	6	0	0
15	42132200	rs2077543	C	G	0	6	6	0	1	7	0	0
15	42134097	rs3816533	C	T	9	9	18	0	0	18	0	0
15	42135541	rs1648831	G	T	6	7	13	0	0	13	0	0
15	42135988	rs1672466	C	T	13	5	18	0	2	20	0	0
15	42140166	rs1061354	G	T	37	29	66	0	0	66	0	0
15	42188870	rs4924583	G	T	11	2	13	0	0	13	0	0
15	42191783	.	A	C	45	32	77	0	2	79	0	0
15	42451108	rs7086	G	C	180	133	313	0	1	314	0	0
15	42451773	.	G	A	141	168	309	0	4	313	0	0
15	42452961	rs113183884	A	G	70	61	131	0	1	132	0	0
15	42453561	rs113815429	T	A	3	3	6	0	0	6	0	0
15	42454464	rs588695	A	G	3	5	8	0	0	8	0	0
15	42457582	rs633483	G	A	15	15	30	0	0	30	0	0
15	42459034	rs1619030	T	C	41	38	79	0	1	81	1	0
15	42470835	rs113101524	T	C	4	4	8	0	0	8	0	0
15	42471036	.	C	T	3	7	10	0	0	10	0	0
15	42476845	rs113175757	C	T	30	41	71	0	1	72	0	0
15	42483455	rs635919	C	T	12	11	23	0	0	23	0	0
15	42502896	rs8108	A	T	162	164	326	0	4	330	0	0
15	42505422	rs2620383	G	A	6	0	6	0	0	6	0	0
15	42517791	rs1678991	C	A	4	2	6	0	0	6	0	0
15	42518384	rs1678990	G	C	8	3	11	0	0	11	0	0
15	42518824	rs1678989	T	C	2	4	6	0	0	6	0	0
15	42520410	rs72718869	A	G	3	4	7	0	0	7	0	0
15	42521188	rs1678986	G	C	8	8	16	0	2	18	0	0
15	42522010	rs1678985	T	C	7	6	13	0	0	13	0	0
15	42522701	.	T	C	2	5	7	0	0	7	0	0
15	42523171	rs1712418	A	C	5	2	7	0	0	7	0	0
15	42524065	rs1630294	T	C	28	24	52	0	1	53	0	0
15	42524104	rs16972896	A	G	19	24	43	0	0	43	0	0
15	42524165	rs1712420	C	T	6	6	12	0	0	12	0	0
15	42524399	rs1712421	G	A	13	8	21	0	0	21	0	0
15	42524923	.	G	A	4	8	12	0	0	12	0	0
15	42530109	rs4923934	T	C	5	6	11	0	0	11	0	0
15	42570718	rs8024732	A	G	6	10	16	0	0	16	0	0
15	42572988	rs16972993	C	T	5	7	12	0	0	12	0	0
15	42573067	rs8037020	C	T	5	2	7	0	0	7	0	0
15	42618531	rs2578652	T	A	5	3	8	0	0	8	0	0
15	42620265	rs75412106	A	T	7	9	16	0	0	16	0	0
15	42631928	rs36023127	T	C	5	4	9	0	0	9	0	0
15	42631976	rs35039186	G	A	6	4	10	0	0	10	0	0
15	42643529	rs7181742	T	C	10	12	22	0	0	22	0	0
15	42644790	rs76540793	G	A	3	5	8	0	0	8	0	0
15	42645446	rs116227269	C	T	9	13	22	0	0	22	0	0
15	42645768	rs3743006	G	A	8	7	15	0	0	15	0	0
15	42649015	rs113052163	G	A	5	3	8	0	0	8	0	0
15	42649021	rs111697500	T	C	5	3	8	0	0	8	0	0
15	42652235	.	C	A	4	2	6	0	0	6	0	0
15	42707269	.	G	A	41	37	78	0	0	78	0	0
15	42707843	rs1062038	G	C	49	41	90	0	1	91	0	0
15	42708005	rs1139100	A	G	22	14	36	0	1	37	0	0
15	42820589	rs1060291	G	A	56	45	101	0	0	101	0	0
15	42824476	rs73404763	A	G	54	60	114	0	1	115	0	0
15	42824578	rs11022	T	C	73	86	159	0	1	160	0	0
15	42824582	rs1060265	T	C	73	86	159	0	0	159	0	0
15	42832534	rs10454039	C	T	9	7	16	0	0	16	0	0
15	42833475	rs12906697	G	C	7	9	16	0	0	16	0	0
15	42835381	.	T	A	58	39	97	0	0	97	0	0
15	42837498	rs1060293	T	A	0	9	9	0	0	9	0	0
15	42837647	.	G	A	1	22	23	0	0	23	0	0
15	42859235	rs10851411	T	G	29	38	67	0	1	68	0	0
15	42859872	rs113424324	C	T	28	38	66	0	1	67	0	0
15	42860591	rs4924687	G	T	86	72	158	0	1	159	0	0
15	42861567	rs34643746	A	G	57	43	100	0	0	100	0	0
15	42861771	rs113390666	C	G	108	63	171	0	0	171	0	0
15	42966288	rs35738819	G	A	2	4	6	0	0	6	0	0
15	42977676	rs6493060	G	A	5	4	9	0	0	9	0	0
15	42981377	rs75021400	C	T	5	2	7	0	0	7	0	0
15	42982340	rs8031218	C	T	7	8	15	0	0	15	0	0
15	43012195	rs3199486	T	C	37	40	77	0	0	77	0	0
15	43012517	rs1995939	A	G	88	78	166	0	0	166	0	0
15	43016475	rs3742988	A	G	133	122	255	0	1	256	0	0
15	43016547	rs3742987	T	C	121	103	224	0	0	224	0	0
15	43017081	rs12907826	G	A	1	5	6	0	1	7	0	0
15	43017426	rs16957091	T	G	77	86	163	0	0	163	0	0
15	43020594	rs58423426	C	T	1	5	6	0	1	7	0	0
15	43023304	rs28645106	A	C	9	12	21	0	1	22	0	0
15	43023482	rs12917189	T	C	46	49	95	0	0	95	0	0
15	43024999	rs8026233	G	C	7	3	10	0	0	10	0	0
15	43025174	rs8027427	T	A	5	6	11	0	0	11	0	0
15	43025524	rs28549876	T	G	7	5	12	0	1	13	0	0
15	43027835	rs76599133	G	T	38	28	66	0	1	67	0	0
15	43032409	rs60752181	G	A	7	8	15	0	0	15	0	0
15	43044193	rs34348991	G	A	4	8	12	0	0	12	0	0
15	43170793	rs6493068	A	G	4	4	8	0	0	8	0	0
15	43211834	rs59276064	G	A	26	19	45	0	1	46	0	0
15	43212418	.	G	C	142	88	230	0	4	234	0	0
15	43212818	rs12437637	C	G	11	14	25	0	0	25	0	0
15	43237203	rs3803341	T	C	16	14	30	0	0	30	0	0
15	43253105	rs1972447	C	T	7	5	12	0	1	13	0	0
15	43253311	rs1548096	T	C	2	4	6	0	0	6	0	0
15	43263248	rs76864255	T	A	9	0	9	0	0	9	0	0
15	43264398	rs12440651	C	A	2	7	9	0	0	9	0	0
15	43264399	rs12440652	C	A	3	7	10	0	0	10	0	0
15	43265690	rs114026095	C	A	9	5	14	0	0	14	0	0
15	43266117	rs34436896	C	T	4	3	7	0	0	7	0	0
15	43266287	rs12910269	C	T	4	2	6	0	0	6	0	0
15	43266786	.	T	C	10	2	12	0	0	12	0	0
15	43433932	rs10851414	G	C	3	4	7	0	0	7	0	0
15	43445886	rs149829132	A	G	4	3	7	0	0	7	0	0
15	43465613	rs75385733	A	T	4	4	8	0	0	8	0	0
15	43467842	rs111717099	G	A	4	4	8	0	0	8	0	0
15	43468716	rs11504655	G	A	4	3	7	0	0	7	0	0
15	43469150	rs61711558	A	G	4	2	6	0	0	6	0	0
15	43469401	rs114045253	G	A	4	6	10	0	0	10	0	0
15	43473153	rs8040769	T	C	4	4	8	0	0	8	0	0
15	43478113	rs540587	G	C	30	54	84	0	1	85	0	0
15	43478156	rs1078243	C	G	66	24	90	0	1	91	0	0
15	43478511	rs530118	C	T	5	11	16	0	0	16	0	0
15	43482127	rs1474199	G	A	5	9	14	0	0	14	0	0
15	43485320	rs111530374	G	T	8	4	12	0	0	12	0	0
15	43485734	rs77090230	G	A	8	11	19	0	0	19	0	0
15	43487698	rs55802910	A	G	3	4	7	0	0	7	0	0
15	43487720	.	C	T	4	4	8	0	0	8	0	0
15	43507393	rs1042168	C	T	5	4	9	0	0	9	0	0
15	43525137	rs7176183	G	A	5	1	6	0	0	6	0	0
15	43624189	rs1549523	C	T	5	1	6	0	0	6	0	0
15	43632549	rs2278857	T	C	11	3	14	0	0	14	0	0
15	43650384	rs1133395	G	A	5	1	6	0	0	6	0	0
15	43660982	rs2412778	A	G	3	3	6	0	0	6	0	0
15	43661802	rs3809482	T	C	9	12	21	0	1	22	0	0
15	43690300	rs999025	T	C	9	8	17	0	0	17	0	0
15	43697072	rs117651906	G	A	40	39	79	0	0	79	0	0
15	43698008	.	C	T	7	20	27	0	1	28	0	0
15	43698602	rs1837960	T	C	26	36	62	0	1	63	0	0
15	43698679	rs1837959	A	G	25	25	50	0	1	51	0	0
15	43700930	rs1058298	G	T	9	9	18	0	0	18	0	0
15	43713634	rs2242069	A	C	3	4	7	0	0	8	1	0
15	43724646	rs2602141	T	G	43	47	90	0	0	90	0	0
15	43748304	rs690367	A	G	34	21	55	0	0	55	0	0
15	43762196	rs689647	C	T	36	33	69	0	1	70	0	0
15	43765533	rs2264239	C	G	5	10	15	0	0	15	0	0
15	43765887	rs11856120	G	C	7	3	10	0	1	11	0	0
15	43765978	rs2584706	T	C	13	6	19	0	0	19	0	0
15	43766025	rs2264050	G	C	12	4	16	0	0	16	0	0
15	43766069	rs2264049	T	C	8	8	16	0	0	16	0	0
15	43767774	rs560191	G	C	20	34	54	0	0	54	0	0
15	43816917	rs1060939	G	A	10	6	16	0	0	16	0	0
15	43817406	rs480108	T	C	11	13	24	0	0	24	0	0
15	43818052	rs2245715	G	A	15	14	29	0	0	29	0	0
15	43826557	rs689797	C	T	2	6	8	0	0	8	0	0
15	43993481	.	C	G	3	6	9	0	0	9	0	0
15	44061802	rs1053492	C	T	566	447	1013	0	9	1022	0	0
15	44063859	rs3087657	G	A	16	21	37	0	1	38	0	0
15	44706550	rs115460576	T	C	33	44	77	0	2	79	0	0
15	44751350	rs78868451	C	T	47	49	96	0	1	97	0	0
15	44812020	rs117931443	T	G	25	11	36	0	1	37	0	0
15	44812439	rs139481100	C	T	25	17	42	0	0	42	0	0
15	44812745	rs76088601	T	C	10	12	22	0	0	22	0	0
15	44813274	rs3752690	T	G	2	4	6	0	0	6	0	0
15	44819667	rs112495294	G	A	52	37	89	0	1	90	0	0
15	44826812	rs147658239	T	C	14	12	26	0	0	26	0	0
15	44827080	rs76263379	C	T	14	17	31	0	0	31	0	0
15	44827257	rs60399672	A	C	11	19	30	0	1	31	0	0
15	44827523	rs61234123	C	G	14	10	24	0	0	24	0	0
15	44830371	rs75825481	G	T	3	9	12	0	0	12	0	0
15	44833610	rs79221366	T	C	3	3	6	0	0	6	0	0
15	44835213	rs7178318	G	C	3	4	7	0	0	7	0	0
15	44854489	rs74935427	C	A	67	78	145	0	1	146	0	0
15	44854785	rs2288342	A	G	97	94	191	0	0	191	0	0
15	44856325	rs139460787	G	A	36	43	79	0	1	80	0	0
15	44859572	rs199549712	T	C	5	3	8	0	1	9	0	0
15	44859901	rs79493287	G	A	12	13	25	0	0	25	0	0
15	44860765	rs114352590	G	A	8	7	15	0	0	15	0	0
15	44861113	rs57618952	T	A	5	6	11	0	0	11	0	0
15	44863699	.	T	C	16	5	21	0	0	21	0	0
15	44941653	rs184012725	A	G	4	6	10	0	0	10	0	0
15	44962224	rs146795158	C	T	5	7	12	0	0	12	0	0
15	45119377	.	A	G	11	0	11	0	0	11	0	0
15	45366284	.	C	G	6	0	6	0	0	6	0	0
15	45366296	.	T	A	10	0	10	0	0	10	0	0
15	45366355	.	C	T	14	0	14	0	2	16	0	0
15	45366359	.	T	C	16	0	16	0	0	16	0	0
15	45366540	.	T	C	54	0	54	0	2	56	0	0
15	45442687	rs1706803	G	C	4	2	6	0	0	6	0	0
15	45445311	rs12908943	C	T	8	4	12	0	0	12	0	0
15	45462847	.	T	C	2	4	6	0	0	6	0	0
15	45695695	rs1153849	G	A	21	9	30	0	0	30	0	0
15	45891039	.	T	G	34	0	34	0	0	34	0	0
15	45891168	.	T	C	128	0	128	0	0	128	0	0
15	45891251	.	T	A	74	0	74	0	0	74	0	0
15	45968535	rs12914266	A	C	3	5	8	0	0	8	0	0
15	45971791	rs7342602	T	C	1	15	16	0	0	16	0	0
15	48702873	rs1042078	G	A	5	29	34	0	1	35	0	0
15	49030276	rs2169757	A	G	42	40	82	0	2	84	0	0
15	49033128	rs4417507	A	G	6	4	10	0	0	10	0	0
15	49033153	rs2089108	A	G	4	5	9	0	0	9	0	0
15	49061893	rs7178974	A	G	2	5	7	0	0	7	0	0
15	49063429	rs10519189	T	G	3	8	11	0	0	11	0	0
15	49065689	rs12440614	T	C	12	5	17	0	0	17	0	0
15	49065783	rs12443492	A	T	16	5	21	0	0	21	0	0
15	49066078	rs73400372	T	C	3	4	7	0	0	7	0	0
15	49067861	rs6493338	T	C	2	4	6	0	0	6	0	0
15	49069191	rs9652424	G	A	4	7	11	0	0	11	0	0
15	49070602	rs7179618	C	A	11	6	17	0	0	17	0	0
15	49073027	rs16961635	C	A	5	8	13	0	0	13	0	0
15	49310150	rs2305195	G	A	3	4	7	0	0	7	0	0
15	49310300	rs35212550	G	A	3	3	6	0	0	6	0	0
15	49310869	rs11635777	C	T	3	5	8	0	0	8	0	0
15	49417705	rs72727217	A	C	12	22	34	0	0	34	0	0
15	49511379	rs2413939	T	G	4	3	7	0	0	7	0	0
15	49922606	rs72731116	G	A	6	4	10	0	0	10	0	0
15	49936238	rs1048348	T	C	7	9	16	0	0	16	0	0
15	50150903	rs7497350	C	T	23	26	49	0	0	49	0	0
15	50151140	rs12915207	A	G	11	17	28	0	0	28	0	0
15	50151263	rs1059852	G	A	18	25	43	0	0	43	0	0
15	50151433	rs1059851	T	A	8	10	18	0	0	18	0	0
15	50151529	rs1059850	G	A	11	10	21	0	0	21	0	0
15	50152166	rs4494482	T	A	18	19	37	0	0	37	0	0
15	50152190	rs4544192	C	T	15	18	33	0	2	35	0	0
15	50152274	rs4494483	T	A	19	18	37	0	0	37	0	0
15	50163181	rs61618346	G	A	5	1	6	0	0	6	0	0
15	50178422	rs4775845	C	T	6	6	12	0	0	12	0	0
15	50179371	rs12914231	A	G	4	11	15	0	0	15	0	0
15	50180635	rs35996890	A	T	2	14	16	0	0	16	0	0
15	50182447	rs12905883	G	A	10	10	20	0	0	20	0	0
15	50184767	rs17487811	A	G	17	12	29	0	0	29	0	0
15	50332040	rs118186615	A	G	3	3	6	0	0	6	0	0
15	50406183	rs4143837	A	G	3	5	8	0	0	8	0	0
15	50409438	rs11632390	C	T	22	9	31	0	0	31	0	0
15	50410290	rs12443409	G	A	6	3	9	0	0	9	0	0
15	50410477	rs72737004	G	A	5	11	16	0	0	16	0	0
15	50474900	rs34490804	C	T	6	8	14	0	0	14	0	0
15	50528414	rs1802536	C	A	14	28	42	0	0	42	0	0
15	50545159	rs2070596	T	A	125	39	164	0	0	164	0	0
15	50545162	rs2070595	G	T	121	38	159	0	1	160	0	0
15	50551083	rs854153	T	C	7	1	8	0	0	8	0	0
15	50570036	rs12923	A	G	193	228	421	0	5	426	0	0
15	50571444	rs4775872	T	C	15	10	25	0	0	25	0	0
15	50572398	rs12906304	C	T	7	4	11	0	0	11	0	0
15	50572477	rs35033384	G	A	4	7	11	0	1	12	0	0
15	50572601	rs12910368	A	G	9	4	13	0	0	13	0	0
15	50573557	rs7179756	C	T	7	1	8	0	0	8	0	0
15	50573615	rs59514998	A	G	8	0	8	0	0	8	0	0
15	50573676	rs7179819	A	G	5	2	7	0	0	7	0	0
15	50573688	rs7180278	G	A	4	3	7	0	0	7	0	0
15	50574621	rs11635546	G	A	5	5	10	0	0	10	0	0
15	50577160	rs11633903	T	A	4	6	10	0	0	10	0	0
15	50577794	rs12440811	T	C	13	21	34	0	0	34	0	0
15	50626787	rs8043257	T	C	7	5	12	0	0	12	0	0
15	50626829	rs8042451	G	C	9	8	17	0	0	17	0	0
15	50640584	rs28408662	C	T	5	3	8	0	0	8	0	0
15	50649361	rs535648	T	C	4	3	7	0	0	7	0	0
15	50654138	rs7164431	G	A	5	3	8	0	0	8	0	0
15	50654733	rs7169506	A	T	3	4	7	0	0	7	0	0
15	50656449	rs11634585	G	A	1	6	7	0	1	8	0	0
15	50656574	rs7182201	G	C	3	3	6	0	0	6	0	0
15	50763945	rs61751062	T	A	25	13	38	0	0	38	0	0
15	50791491	rs149936619	A	G	35	33	68	0	0	68	0	0
15	50849952	rs35806905	T	C	11	5	16	0	0	16	0	0
15	51742565	rs77557886	G	C	7	3	10	0	0	10	0	0
15	51743186	rs17524694	C	T	3	4	7	0	0	7	0	0
15	51754742	rs193004809	C	T	2	5	7	0	0	7	0	0
15	52020481	.	T	C	4	7	11	0	0	11	0	0
15	52020485	.	G	A	9	4	13	0	0	13	0	0
15	52027537	rs8040986	G	T	3	6	9	0	0	9	0	0
15	52046670	rs74015761	C	T	14	14	28	0	0	28	0	0
15	52076805	rs73407396	T	A	3	4	7	0	0	7	0	0
15	52175787	rs919057	T	C	5	4	9	0	0	9	0	0
15	52176912	rs2570228	T	C	5	12	17	0	0	17	0	0
15	52201631	rs2570218	C	T	15	19	34	0	0	34	0	0
15	52202307	rs74408321	G	A	26	24	50	0	0	50	0	0
15	52202980	rs1135871	T	G	24	25	49	0	4	53	0	0
15	52202985	rs2470609	T	G	25	23	48	0	2	50	0	0
15	52213737	rs2623281	T	C	3	10	13	0	0	13	0	0
15	52226474	rs2570268	A	G	8	16	24	0	0	24	0	0
15	52230139	rs2554342	T	C	4	2	6	0	0	6	0	0
15	52230633	rs17649692	C	T	5	4	9	0	0	9	0	0
15	52230692	rs2554341	C	T	5	3	8	0	0	8	0	0
15	52237636	rs8042310	A	G	0	7	7	0	0	7	0	0
15	52309625	rs2001741	C	T	5	3	8	0	0	8	0	0
15	52312217	rs74013644	T	A	5	1	6	0	1	7	0	0
15	52321843	rs2441781	T	C	1	5	6	0	1	7	0	0
15	52350879	rs2306793	T	C	52	59	111	0	0	111	0	0
15	52357589	rs58936667	A	G	60	57	117	0	1	118	0	0
15	52358533	rs17540338	A	T	4	8	12	0	0	12	0	0
15	52359109	rs144725916	A	G	12	10	22	0	0	22	0	0
15	52413316	rs12396	G	C	21	26	47	0	0	47	0	0
15	52424366	rs57669647	T	A	0	6	6	0	0	6	0	0
15	52455709	rs28835411	A	G	6	3	9	0	0	9	0	0
15	52484589	rs9228	G	A	3	4	7	0	0	7	0	0
15	52485024	rs4219	G	T	12	6	18	0	0	18	0	0
15	52496454	rs6493545	C	T	3	3	6	0	0	6	0	0
15	52497681	rs3751606	T	C	4	9	13	0	0	13	0	0
15	52506655	rs6493546	C	T	8	0	8	0	0	8	0	0
15	52521383	rs62623565	C	T	8	11	19	0	0	19	0	0
15	52536596	rs55712142	C	T	6	8	14	0	0	14	0	0
15	52539235	rs41504447	A	C	3	3	6	0	0	6	0	0
15	52539673	rs10163109	C	T	5	13	18	0	0	18	0	0
15	52541221	rs4600419	G	C	4	2	6	0	0	6	0	0
15	52541796	rs4776028	G	A	5	4	9	0	0	9	0	0
15	52543391	rs3751630	T	G	19	8	27	0	0	27	0	0
15	52740956	rs1724589	A	G	4	6	10	0	0	10	0	0
15	52841622	rs11539780	C	T	123	119	242	0	4	246	0	0
15	52854109	rs55997353	C	T	7	3	10	0	0	10	0	0
15	54768563	.	G	A	7	1	8	0	0	8	0	0
15	55496313	rs12907749	T	G	26	41	67	0	2	69	0	0
15	55497335	.	A	G	56	54	110	0	1	111	0	0
15	55542883	rs16976227	T	C	10	6	16	0	1	17	0	0
15	55543530	rs16976229	C	G	7	5	12	0	0	12	0	0
15	55543584	rs16976231	A	G	3	4	7	0	0	7	0	0
15	55581774	rs35720996	G	C	14	19	33	0	0	33	0	0
15	55614736	rs8026689	C	T	2	6	8	0	0	8	0	0
15	55632859	rs678892	G	T	22	21	43	0	0	45	2	0
15	55651370	rs1051099	A	G	70	82	152	0	1	153	0	0
15	55653031	rs501231	A	G	61	67	128	0	0	128	0	0
15	55656162	rs519647	A	C	2	6	8	0	0	8	0	0
15	55658507	rs55964720	T	A	7	3	10	0	0	10	0	0
15	55658648	rs17819096	G	T	6	4	10	0	0	10	0	0
15	55663289	rs11071183	C	T	4	2	6	0	0	6	0	0
15	55668414	rs472579	C	G	4	3	7	0	0	7	0	0
15	56120984	rs150212864	T	C	5	8	13	0	0	13	0	0
15	56121060	rs9920007	A	C	5	5	10	0	0	10	0	0
15	56121334	rs7162435	T	C	24	11	35	0	0	35	0	0
15	56121886	rs1042477	C	A	13	11	24	0	0	24	0	0
15	56242878	rs79873736	G	A	5	1	6	0	0	6	0	0
15	56387859	rs3803459	T	C	45	31	76	0	0	76	0	0
15	56388033	rs12439907	T	C	37	29	66	0	1	67	0	0
15	56425189	rs72738604	A	C	12	10	22	0	0	22	0	0
15	56425335	rs72738605	A	G	6	2	8	0	0	8	0	0
15	56425615	rs72738607	A	G	6	12	18	0	0	18	0	0
15	56425746	rs72738608	T	G	14	27	41	0	0	41	0	0
15	56429493	rs200318599	C	G	8	13	21	0	1	22	0	0
15	56429728	rs78634107	G	A	6	6	12	0	0	12	0	0
15	56429932	rs201519136	A	T	6	0	6	0	0	6	0	0
15	56431458	rs9670809	A	T	3	3	6	0	0	6	0	0
15	56434050	rs1031077	C	T	3	3	6	0	0	6	0	0
15	56436240	rs1867089	T	C	5	9	14	0	0	14	0	0
15	56510796	rs72738682	A	G	2	4	6	0	0	6	0	0
15	56522988	rs11630394	C	A	9	3	12	0	0	12	0	0
15	56523152	rs12594121	T	C	6	4	10	0	0	10	0	0
15	56523595	rs2414466	C	T	20	9	29	0	0	29	0	0
15	56523659	rs140751507	C	T	27	14	41	0	0	41	0	0
15	56524034	rs11631865	A	G	37	18	55	0	0	55	0	0
15	56524043	rs11631902	A	C	36	19	55	0	1	56	0	0
15	56524096	rs11631910	A	C	27	13	40	0	0	40	0	0
15	56524136	rs11631915	A	G	27	12	39	0	0	39	0	0
15	56524268	rs11632081	G	A	26	12	38	0	0	38	0	0
15	56524307	rs11632087	G	C	22	8	30	0	0	30	0	0
15	56525171	rs12595428	T	C	6	10	16	0	1	17	0	0
15	56525216	rs12592881	C	A	7	13	20	0	0	20	0	0
15	56525311	rs12592899	C	T	13	9	22	0	1	23	0	0
15	56525994	rs12591294	T	C	7	0	7	0	0	7	0	0
15	56526217	rs16976832	T	A	9	2	11	0	0	11	0	0
15	56526620	rs55957636	G	T	2	5	7	0	0	7	0	0
15	56531056	rs72738701	A	G	4	2	6	0	0	6	0	0
15	56532219	rs72740503	G	A	6	0	6	0	0	6	0	0
15	56756285	rs1715919	T	G	3	6	9	0	0	9	0	0
15	56923536	rs3803457	A	G	16	11	27	0	0	27	0	0
15	56959028	rs28620278	C	T	8	10	18	0	0	18	0	0
15	57020862	rs8025391	T	A	3	3	6	0	0	6	0	0
15	57023417	rs7182346	T	G	9	8	17	0	0	17	0	0
15	57023826	rs12898521	G	A	7	9	16	0	0	16	0	0
15	57023951	rs28497695	A	G	7	4	11	0	0	11	0	0
15	57247604	rs213148	G	T	6	14	20	0	1	21	0	0
15	57247606	.	G	A	6	14	20	0	0	20	0	0
15	57254593	rs2116065	T	A	8	5	13	0	0	13	0	0
15	57254778	rs2116066	A	G	12	10	22	0	3	25	0	0
15	57254842	rs1642929	T	A	11	15	26	0	1	27	0	0
15	57255153	rs1642930	T	C	8	7	15	0	0	15	0	0
15	57356494	rs2920268	G	A	8	9	17	0	0	17	0	0
15	57400749	rs28648502	T	C	4	2	6	0	0	6	0	0
15	57422017	rs77128866	C	T	9	5	14	0	0	14	0	0
15	57425413	rs17819940	G	T	6	6	12	0	0	12	0	0
15	57580940	rs8035097	T	C	34	36	70	0	0	70	0	0
15	57581135	rs55892639	G	A	7	11	18	0	0	18	0	0
15	57581311	rs12911297	G	A	25	24	49	0	1	50	0	0
15	57581413	rs2921430	T	C	24	32	56	0	1	57	0	0
15	57597280	rs2243504	T	G	6	7	13	0	0	13	0	0
15	57597961	rs2248534	T	G	5	5	10	0	0	10	0	0
15	58000981	rs1062707	C	T	106	93	199	0	3	203	1	0
15	58002958	rs72745581	G	T	1	7	8	0	0	8	0	0
15	58008169	.	G	A	178	0	178	0	1	179	0	0
15	58008281	.	G	A	170	0	170	0	1	171	0	0
15	58008607	.	C	T	7	0	7	0	0	7	0	0
15	58008774	.	C	T	6	0	6	0	0	6	0	0
15	58461006	rs2414544	G	A	5	1	6	0	0	6	0	0
15	58478067	rs17240643	C	T	11	13	24	0	0	24	0	0
15	58888855	.	A	G	17	15	32	0	0	32	0	0
15	58892528	rs7165259	G	C	5	7	12	0	0	12	0	0
15	58893521	rs6494026	A	C	8	4	12	0	0	12	0	0
15	58893584	rs7171098	A	C	14	4	18	0	0	18	0	0
15	58894308	rs1365772	T	C	4	4	8	0	0	8	0	0
15	58897874	rs10851639	T	C	3	3	6	0	0	6	0	0
15	59174539	rs7179456	G	T	9	8	17	0	1	18	0	0
15	59205253	rs17302066	A	C	9	8	17	0	0	17	0	0
15	59222464	rs11856185	G	A	15	15	30	0	0	30	0	0
15	59222700	rs11853076	T	A	4	8	12	0	0	12	0	0
15	59280119	rs55671218	T	C	18	25	43	0	0	43	0	0
15	59297328	rs71478699	A	G	7	4	11	0	0	11	0	0
15	59312074	rs1968606	C	T	1	5	6	0	0	6	0	0
15	59314563	rs8027536	G	C	4	7	11	0	0	11	0	0
15	59321119	rs9788719	C	T	4	5	9	0	0	9	0	0
15	59322829	rs1374155	A	G	5	6	11	0	0	11	0	0
15	59325433	rs4774320	T	C	4	3	7	0	0	7	0	0
15	59325463	rs4774321	T	C	5	3	8	0	0	8	0	0
15	59325790	rs4775111	C	T	7	1	8	0	0	8	0	0
15	59347929	rs1446239	C	A	19	11	30	0	0	30	0	0
15	59353863	rs16940987	C	A	7	6	13	0	1	14	0	0
15	59368167	rs7178935	G	A	12	11	23	0	0	23	0	0
15	59377446	rs10518996	C	T	6	2	8	0	0	8	0	0
15	59429111	rs11539756	G	A	8	9	17	0	0	17	0	0
15	59664774	rs113660219	G	A	5	2	7	0	0	7	0	0
15	59930350	rs1129616	G	C	6	5	11	0	0	11	0	0
15	59930551	rs11636043	G	C	14	7	21	0	0	21	0	0
15	59952341	rs11071467	T	C	48	44	92	0	1	93	0	0
15	60647210	rs66868332	C	G	3	4	7	0	0	7	0	0
15	60685664	rs12911318	C	T	3	3	6	0	0	6	0	0
15	60685668	rs12911320	C	T	3	3	6	0	0	6	0	0
15	60687152	rs16942555	T	G	8	25	33	0	0	33	0	0
15	60687230	rs12440452	A	C	13	5	18	0	0	18	0	0
15	60687251	rs16942556	C	T	5	11	16	0	1	17	0	0
15	60687676	rs3940746	G	T	9	4	13	0	0	14	1	0
15	60715248	rs34293839	A	G	7	3	10	0	0	10	0	0
15	60715643	rs3068	C	T	18	21	39	0	0	39	0	0
15	60715800	rs1046657	T	G	12	17	29	0	0	29	0	0
15	60734697	rs1063100	A	G	6	4	10	0	0	10	0	0
15	62145214	rs1046156	T	C	11	16	27	0	1	28	0	0
15	63419699	rs34536322	A	C	53	55	108	0	1	109	0	0
15	63494159	rs12595312	T	C	2	8	10	0	0	10	0	0
15	63494235	rs12912328	A	G	1	5	6	0	1	7	0	0
15	63494482	rs7176597	G	A	2	20	22	0	0	22	0	0
15	63553994	rs1017545	T	C	6	6	12	0	0	12	0	0
15	63582095	rs58698989	C	T	2	4	6	0	0	6	0	0
15	63599105	rs79083210	T	C	13	8	21	0	0	21	0	0
15	63600603	rs17762798	G	A	13	14	27	0	0	27	0	0
15	64036367	.	C	G	5	3	8	0	0	8	0	0
15	64432335	.	T	C	11	0	11	0	0	11	0	0
15	64434782	rs141633013	C	T	16	19	35	0	0	35	0	0
15	64662456	rs2414847	T	G	3	3	6	0	0	6	0	0
15	64975614	rs76580542	C	T	14	11	25	0	0	25	0	0
15	64985174	rs117687089	G	A	14	11	25	0	0	25	0	0
15	64986268	.	C	T	5	5	10	0	3	13	0	0
15	64986269	.	C	T	8	4	12	0	1	13	0	0
15	64986890	rs149897018	C	T	5	9	14	0	0	14	0	0
15	65156523	rs1719277	A	G	4	5	9	0	0	9	0	0
15	65159458	rs1043697	T	C	202	180	382	0	0	382	0	0
15	65161466	rs12438348	C	A	4	3	7	0	0	7	0	0
15	65196252	rs7175351	G	A	9	11	20	0	0	20	0	0
15	65198309	rs1684051	G	C	5	3	8	0	0	8	0	0
15	65224535	rs118114992	C	T	2	4	6	0	0	6	0	0
15	65235776	rs34988193	A	G	13	9	22	0	0	22	0	0
15	65250554	rs72739245	G	A	30	24	54	0	0	54	0	0
15	65553246	rs2304896	C	T	15	7	22	0	1	23	0	0
15	65588628	rs7175829	C	T	26	15	41	0	0	41	0	0
15	65734856	rs7227	G	C	3	3	6	0	0	6	0	0
15	65735181	rs593544	G	A	35	43	78	0	0	78	0	0
15	65735386	rs138823128	A	T	25	24	49	0	0	49	0	0
15	65735707	rs590958	T	G	12	12	24	0	0	24	0	0
15	65737946	rs11455	A	G	24	27	51	0	0	51	0	0
15	65739303	rs11009	C	A	34	33	67	0	0	68	1	0
15	65772698	rs352461	T	C	22	29	51	0	0	51	0	0
15	65783389	rs451282	A	G	10	5	15	0	0	15	0	0
15	65783410	rs373638	C	A	9	4	13	0	0	13	0	0
15	65783438	rs387599	C	G	8	2	10	0	0	10	0	0
15	65788608	rs11071845	G	A	6	2	8	0	0	8	0	0
15	65804537	rs352477	A	T	3	3	6	0	1	7	0	0
15	65808910	rs74718834	T	C	3	4	7	0	0	7	0	0
15	65856653	rs11539008	G	A	23	25	48	0	0	48	0	0
15	65863917	rs2279854	A	C	21	16	37	0	0	37	0	0
15	65865632	rs6494528	T	G	2	4	6	0	0	6	0	0
15	65868981	rs11539009	A	C	26	28	54	0	0	54	0	0
15	65869272	rs12333	C	T	32	40	72	0	0	72	0	0
15	65870058	.	C	A	65	69	134	0	1	135	0	0
15	65871378	rs3743168	T	C	133	130	263	0	1	264	0	0
15	65871439	rs3743169	G	A	111	141	252	0	1	253	0	0
15	65871698	rs11484	G	T	87	66	153	0	5	159	1	0
15	65891738	rs75381442	C	T	10	9	19	0	0	19	0	0
15	65900233	rs74552918	G	A	3	7	10	0	0	10	0	0
15	65903398	rs4366668	G	A	12	7	19	0	0	19	0	0
15	65903400	rs77989486	G	A	12	7	19	0	0	19	0	0
15	65908594	rs142912094	A	G	4	4	8	0	0	8	0	0
15	65908615	rs145109597	A	G	2	4	6	0	0	6	0	0
15	65908753	rs62013116	G	A	8	1	9	0	0	9	0	0
15	65909411	rs62013117	G	T	5	2	7	0	1	8	0	0
15	65913244	rs57933781	T	C	5	9	14	0	0	14	0	0
15	65944191	rs62014378	T	C	3	4	7	0	0	7	0	0
15	65944548	rs8035639	C	T	1	5	6	0	1	7	0	0
15	65948035	rs62014380	A	G	4	3	7	0	0	7	0	0
15	65950648	rs62014381	C	G	6	3	9	0	0	9	0	0
15	65951672	.	T	G	8	0	8	0	0	8	0	0
15	65952034	rs8031179	T	C	17	16	33	0	0	33	0	0
15	65958942	rs8030562	T	C	21	21	42	0	0	42	0	0
15	65994733	rs17810074	C	T	21	34	55	0	0	55	0	0
15	66011363	rs112751712	C	T	13	3	16	0	0	16	0	0
15	66020908	rs7497961	A	G	7	1	8	0	0	8	0	0
15	66181143	rs117150201	T	G	97	86	183	0	2	185	0	0
15	66181936	rs12591642	A	C	9	15	24	0	1	25	0	0
15	66183011	rs28716044	G	T	15	11	26	0	0	26	0	0
15	66183436	rs117568432	G	T	38	28	66	0	0	66	0	0
15	66612965	rs17851970	T	C	12	12	24	0	1	25	0	0
15	66624166	rs28723485	G	T	10	4	14	0	0	14	0	0
15	66625161	rs11071885	A	G	44	35	79	0	0	79	0	0
15	66628874	rs11637949	A	G	3	6	9	0	0	9	0	0
15	66679601	rs112542693	G	C	5	6	11	0	0	11	0	0
15	66757961	rs11631448	T	A	0	6	6	0	0	6	0	0
15	66772721	rs78288367	C	T	6	0	6	0	0	6	0	0
15	66773975	rs41277720	G	A	4	8	12	0	0	12	0	0
15	66783261	rs14303	C	A	108	103	211	0	0	211	0	0
15	66791258	rs4432220	T	C	11	8	19	0	0	19	0	0
15	66792087	rs112095287	C	T	17	16	33	0	0	33	0	0
15	66792113	rs111385971	G	A	11	17	28	0	0	28	0	0
15	66792317	rs35435814	C	T	10	10	20	0	0	20	0	0
15	66821250	rs11071896	A	G	6	8	14	0	0	14	0	0
15	66832466	rs75532475	A	G	19	13	32	0	0	32	0	0
15	66840985	rs11858742	A	C	27	20	47	0	0	47	0	0
15	67391739	rs2053295	G	A	6	7	13	0	0	13	0	0
15	67391805	rs9972423	T	A	9	8	17	0	0	17	0	0
15	67392656	rs1530061	G	A	13	11	24	0	0	24	0	0
15	67421609	rs4776897	T	G	1	5	6	0	0	6	0	0
15	67427414	rs28414740	T	G	4	3	7	0	0	7	0	0
15	67890453	rs35733169	G	C	4	7	11	0	1	12	0	0
15	67892766	rs3865018	C	T	21	14	35	0	0	35	0	0
15	67892792	rs17241808	A	G	11	17	28	0	0	28	0	0
15	68410402	rs145658469	C	T	5	2	7	0	0	7	0	0
15	68584019	.	G	A	70	60	130	0	1	131	0	0
15	68585795	rs75571734	G	A	173	166	339	0	2	341	0	0
15	69085757	rs1551343	T	C	6	1	7	0	0	7	0	0
15	69086316	rs767453	A	T	5	3	8	0	0	8	0	0
15	70342341	rs71393476	T	C	273	191	464	0	4	468	0	0
15	70362781	rs118133167	G	A	5	2	7	0	0	7	0	0
15	71456952	rs557123092	C	T	6	0	6	0	0	6	0	0
15	72635570	rs11072359	A	T	2	4	6	0	0	6	0	0
15	73853809	rs7163212	T	C	6	11	17	0	0	17	0	0
15	73855043	rs7169976	T	C	7	4	11	0	0	11	0	0
15	73858415	rs17185294	A	G	6	3	9	0	0	9	0	0
15	73859016	rs62004587	A	C	2	5	7	0	0	7	0	0
15	73860318	rs16958019	A	G	1	7	8	0	0	8	0	0
15	73860360	rs75418437	C	T	0	7	7	0	0	7	0	0
15	73868026	rs79432474	C	G	9	10	19	0	0	19	0	0
15	74210428	rs4886470	G	A	8	20	28	0	0	28	0	0
15	74235500	rs2304719	C	T	3	3	6	0	0	6	0	0
15	74237120	rs1530169	T	C	8	5	13	0	0	13	0	0
15	74239307	rs67182653	G	A	1	5	6	0	0	6	0	0
15	74239871	rs72745372	C	T	14	4	18	0	0	18	0	0
15	74243012	rs60579378	G	A	3	4	7	0	0	7	0	0
15	74277795	rs10851866	T	C	3	3	6	0	0	6	0	0
15	74320118	.	G	C	93	84	177	0	4	181	0	0
15	74328116	rs743580	A	G	172	164	336	0	1	337	0	0
15	74328141	rs743581	G	T	169	152	321	0	5	326	0	0
15	74328576	rs9479	A	G	353	355	708	0	4	712	0	0
15	74338462	rs1036673	C	T	11	8	19	0	0	19	0	0
15	74338939	rs6772	C	T	13	18	31	0	0	31	0	0
15	74711769	rs8025655	C	G	8	6	14	0	1	15	0	0
15	74715205	rs11852686	T	C	1	5	6	0	0	6	0	0
15	74716174	rs11856835	G	A	5	1	6	0	0	6	0	0
15	74716609	rs8036030	A	G	7	5	12	0	0	12	0	0
15	74716690	rs8036474	G	T	7	4	11	0	0	11	0	0
15	74719297	rs28362881	C	T	3	6	9	0	0	9	0	0
15	74741686	rs147593058	C	T	40	57	97	0	1	98	0	0
15	74886525	rs142628617	C	A	5	1	6	0	0	6	0	0
15	74888652	rs185172299	G	A	154	110	264	0	2	266	0	0
15	74922992	rs11547808	G	A	34	30	64	0	0	64	0	0
15	74923335	rs1128628	G	C	30	33	63	0	0	63	0	0
15	75080872	rs2168519	T	C	5	1	6	0	0	6	0	0
15	75081745	rs3784790	G	C	4	2	6	0	0	6	0	0
15	75084281	rs1350193	G	C	3	4	7	0	0	7	0	0
15	75090349	rs12898997	C	T	7	4	11	0	1	13	1	0
15	75095483	rs7085	T	C	48	35	83	0	2	85	0	0
15	75128501	rs9210	T	C	31	26	57	0	0	57	0	0
15	75129584	rs55973697	A	C	137	103	240	0	3	243	0	0
15	75130093	rs12898397	T	C	111	7	118	0	0	118	0	0
15	75130573	rs2290572	A	G	6	2	8	0	0	8	0	0
15	75131661	rs4886615	A	G	92	88	180	0	1	181	0	0
15	75131959	rs936227	A	G	91	67	158	0	0	158	0	0
15	75135447	rs2290574	T	C	4	2	6	0	0	6	0	0
15	75136257	rs6939	A	C	246	253	499	0	1	500	0	0
15	75136261	rs6938	C	G	268	258	526	0	2	529	1	0
15	75136694	rs12487	T	C	244	216	460	0	10	470	0	0
15	75139696	rs12902690	A	G	4	8	12	0	0	12	0	0
15	75140854	rs3765066	G	A	11	12	23	0	0	23	0	0
15	75145098	rs936230	T	C	2	7	9	0	0	9	0	0
15	75189930	rs1130741	A	G	20	24	44	0	0	44	0	0
15	75193004	rs1127796	T	C	70	104	174	0	1	175	0	0
15	75194490	rs6495127	C	T	24	34	58	0	0	58	0	0
15	75196176	rs4886636	G	A	4	2	6	0	0	6	0	0
15	75212225	rs1133323	C	T	49	28	77	0	0	77	0	0
15	75212357	rs1133322	A	G	43	34	77	0	0	77	0	0
15	75311959	rs8033925	A	G	3	8	11	0	0	11	0	0
15	75312187	rs13056	A	G	0	10	10	0	1	11	0	0
15	75312715	rs3812943	C	G	1	7	8	0	0	8	0	0
15	75337426	rs8039755	T	C	2	5	7	0	0	7	0	0
15	75339575	rs78664321	G	A	11	12	23	0	1	24	0	0
15	75339985	rs1867148	T	C	18	10	28	0	1	29	0	0
15	75339993	rs1867149	C	T	18	11	29	0	0	29	0	0
15	75340727	rs2304902	G	T	30	16	46	0	1	47	0	0
15	75346760	rs7163636	T	C	7	5	12	0	0	12	0	0
15	75348105	rs11072520	T	C	5	2	7	0	0	7	0	0
15	75352201	rs12185102	G	A	5	4	9	0	0	9	0	0
15	75498744	rs1873379	G	C	327	281	608	0	2	610	0	0
15	75499995	rs28509789	T	G	335	272	607	0	7	614	0	0
15	75630562	rs143588533	C	T	6	5	11	0	0	11	0	0
15	75630635	rs7166436	A	T	11	10	21	0	0	21	0	0
15	75632280	rs117112913	C	T	37	33	70	0	0	70	0	0
15	75633401	rs185821232	C	T	5	5	10	0	1	11	0	0
15	75645350	rs5745920	T	C	4	4	8	0	0	8	0	0
15	75647964	rs4462560	G	C	43	42	85	0	1	86	0	0
15	75648617	rs5745935	G	A	21	10	31	0	0	31	0	0
15	75660662	rs75458893	C	T	5	22	27	0	0	27	0	0
15	75670079	rs9972533	C	T	10	7	17	0	0	17	0	0
15	75670512	rs74391430	A	G	2	7	9	0	0	9	0	0
15	75685873	rs62029734	T	C	10	13	23	0	0	23	0	0
15	75867469	.	G	C	6	0	6	0	0	6	0	0
15	75878956	rs11635080	G	T	6	4	10	0	0	10	0	0
15	75890612	rs3210683	G	A	45	34	79	0	0	79	0	0
15	75890689	rs1128585	G	T	43	25	68	0	1	69	0	0
15	75892249	rs113860312	C	T	3	4	7	0	0	7	0	0
15	75909803	rs11547316	A	G	8	20	28	0	0	28	0	0
15	75950602	rs4886726	T	C	7	5	12	0	0	12	0	0
15	75950733	rs8609	T	C	8	9	17	0	0	17	0	0
15	76176310	rs1039547	A	G	1	8	9	0	0	9	0	0
15	76177538	rs8030948	G	A	4	2	6	0	2	8	0	0
15	76178352	rs7175758	A	G	6	7	13	0	0	13	0	0
15	76179664	rs74024014	C	T	18	20	38	0	0	38	0	0
15	76180166	rs60088262	A	G	12	9	21	0	0	21	0	0
15	76180651	rs59143042	G	A	10	6	16	0	0	16	0	0
15	76181522	rs335717	A	C	11	7	18	0	0	18	0	0
15	76181538	rs17427298	C	T	11	8	19	0	0	19	0	0
15	76181938	rs57429900	A	G	16	14	30	0	0	30	0	0
15	76183191	rs62028936	T	A	3	4	7	0	0	7	0	0
15	76189108	rs1910510	G	T	11	3	14	0	0	14	0	0
15	76191966	rs335687	T	C	122	117	239	0	4	243	0	0
15	76193199	rs74024017	T	C	240	251	491	0	0	491	0	0
15	76222140	rs335679	G	T	6	0	6	0	0	6	0	0
15	76228447	rs7180064	A	C	1	10	11	0	0	11	0	0
15	76228632	rs335725	G	A	12	2	14	0	0	14	0	0
15	76230778	rs8035611	A	C	7	0	7	0	0	7	0	0
15	76232575	rs35031760	C	G	3	4	7	0	0	7	0	0
15	76232982	rs2648437	C	T	4	4	8	0	0	8	0	0
15	76234072	rs74024028	G	A	4	3	7	0	0	7	0	0
15	76234637	rs78460277	T	G	4	3	7	0	0	7	0	0
15	76244979	rs335731	A	G	2	5	7	0	0	7	0	0
15	76251452	rs12913434	A	G	5	2	7	0	0	7	0	0
15	76507838	rs1474117	C	G	15	22	37	0	0	37	0	0
15	76521798	rs959991	C	T	4	4	8	0	0	8	0	0
15	77236574	rs12909665	G	C	8	0	8	0	1	9	0	0
15	77236982	rs1711019	A	G	5	2	7	0	0	7	0	0
15	77238410	.	A	G	3	4	7	0	0	7	0	0
15	77241568	rs1711018	T	C	75	71	146	0	1	147	0	0
15	77241751	rs1706848	T	C	45	37	82	0	1	84	1	0
15	77353257	rs12148612	A	T	2	4	6	0	0	6	0	0
15	77360023	rs33940778	C	A	7	4	11	0	0	11	0	0
15	77360602	rs75163607	C	T	78	48	126	0	4	130	0	0
15	77360750	rs139286044	G	A	20	16	36	0	2	38	0	0
15	77401143	rs12904882	A	C	14	32	46	0	1	47	0	0
15	77757971	.	A	G	2	4	6	0	0	6	0	0
15	77776673	rs11631927	G	A	24	22	46	0	2	49	1	0
15	78276417	rs62008651	C	T	7	4	11	0	1	12	0	0
15	78276594	rs72732526	A	C	6	3	9	0	0	9	0	0
15	78276595	rs72732527	C	A	6	3	9	0	0	9	0	0
15	78287889	rs2921118	T	G	62	16	78	0	2	80	0	0
15	78288350	rs561743940	G	A	12	5	17	0	0	17	0	0
15	78288490	rs139941936	G	A	0	18	18	0	1	19	0	0
15	78288727	rs76398134	G	A	56	38	94	0	0	94	0	0
15	78288778	rs56367308	G	T	41	55	96	0	2	98	0	0
15	78288975	rs10519181	G	C	70	39	109	0	3	112	0	0
15	78292820	rs12911332	A	G	11	22	33	0	0	33	0	0
15	78292822	rs150312640	C	T	12	22	34	0	0	34	0	0
15	78294785	rs182747827	A	C	8	14	22	0	0	22	0	0
15	78313041	rs56357772	C	G	4	3	7	0	0	7	0	0
15	78315497	rs12594823	C	T	24	20	44	0	0	44	0	0
15	78316386	rs1992470	T	A	10	8	18	0	1	19	0	0
15	78369815	rs9047	G	A	20	19	39	0	0	39	0	0
15	78397355	rs112196879	G	T	6	0	6	0	0	6	0	0
15	78462258	rs117706925	G	A	48	49	97	0	0	97	0	0
15	78558170	rs55718582	T	C	5	8	13	0	1	14	0	0
15	78558509	rs2037347	G	A	1	7	8	0	0	8	0	0
15	78561627	rs12050695	C	T	2	4	6	0	0	6	0	0
15	78565414	rs11629630	A	G	2	4	6	0	0	6	0	0
15	78565478	rs7163689	C	T	13	19	32	0	1	33	0	0
15	78567543	rs3813574	A	G	10	7	17	0	1	18	0	0
15	78567853	rs967821	G	T	14	9	23	0	0	23	0	0
15	78573487	rs6996	A	T	21	10	31	0	0	31	0	0
15	78573619	rs3743083	C	T	16	22	38	0	1	39	0	0
15	78590625	rs17402697	C	T	4	2	6	0	0	6	0	0
15	78632830	rs1127472	C	G	1	8	9	0	0	9	0	0
15	78730591	rs954144	C	T	2	4	6	0	0	6	0	0
15	78763617	rs7174190	C	T	24	14	38	0	1	39	0	0
15	78764285	rs3817092	A	G	14	14	28	0	0	28	0	0
15	78764324	rs8036042	G	A	14	13	27	0	0	27	0	0
15	78765189	rs16969883	C	T	16	10	26	0	1	27	0	0
15	78768167	rs28602670	C	G	24	17	41	0	0	41	0	0
15	78789676	rs2292116	T	C	3	3	6	0	0	6	0	0
15	78790189	rs2292115	A	G	23	20	43	0	0	43	0	0
15	78791061	rs3743079	C	T	113	118	231	0	1	232	0	0
15	78792439	rs7174348	G	A	43	57	100	0	3	103	0	0
15	78793109	rs16969906	T	C	67	93	160	0	0	160	0	0
15	78832792	rs3813571	G	T	12	0	12	0	0	12	0	0
15	78833612	rs55690619	A	G	15	11	26	0	0	26	0	0
15	78833758	rs4886571	G	A	11	11	22	0	0	22	0	0
15	78833830	rs4243083	C	G	14	15	29	0	0	29	0	0
15	78834689	rs2292117	A	G	4	4	8	0	0	8	0	0
15	78835552	rs11858230	A	G	4	2	6	0	0	6	0	0
15	78841220	rs8053	T	C	426	313	739	0	6	745	0	0
15	78883628	rs584135	A	G	4	2	6	0	0	6	0	0
15	78894339	rs1051730	G	A	4	2	6	0	0	6	0	0
15	79151860	rs12903249	C	T	5	1	6	0	0	6	0	0
15	79151999	rs12903542	C	T	7	1	8	0	0	8	0	0
15	79157755	rs6495346	T	C	3	3	6	0	0	6	0	0
15	79165441	rs8034658	G	T	7	2	9	0	0	9	0	0
15	79166943	.	T	C	6	0	6	0	3	9	0	0
15	79167118	rs11072813	C	T	4	6	10	0	0	10	0	0
15	79167603	rs8029659	A	G	7	4	11	0	0	11	0	0
15	79168040	rs72749233	A	G	3	3	6	0	0	6	0	0
15	79185180	rs28408315	G	A	2	6	8	0	0	8	0	0
15	79188389	rs34449854	C	T	2	5	7	0	0	7	0	0
15	79214215	rs3129	C	T	45	29	74	0	2	77	1	0
15	79237247	rs1036938	C	G	9	16	25	0	0	25	0	0
15	79237293	rs2289702	C	T	9	5	14	0	0	14	0	0
15	79237324	rs1036939	C	A	0	7	7	0	0	7	0	0
15	80137560	rs8923	T	C	15	15	30	0	0	30	0	0
15	80186340	rs12440798	C	T	7	5	12	0	0	12	0	0
15	80187732	rs16971515	C	T	8	2	10	0	0	10	0	0
15	80188006	rs2586179	G	T	4	3	7	0	0	7	0	0
15	80206958	rs8024713	C	G	7	0	7	0	0	7	0	0
15	80206964	rs35512725	C	T	7	0	7	0	0	7	0	0
15	80212782	rs1134274	C	T	25	27	52	0	0	52	0	0
15	80212826	rs1055947	T	C	29	21	50	0	1	51	0	0
15	80212912	rs1134264	A	C	23	18	41	0	0	41	0	0
15	80212956	rs3178647	T	C	22	11	33	0	0	33	0	0
15	80213023	rs3178646	T	C	24	5	29	0	0	29	0	0
15	80213031	rs12951	C	T	18	5	23	0	0	23	0	0
15	80213049	rs7179584	G	A	16	4	20	0	0	20	0	0
15	80214230	rs57972189	A	G	18	12	30	0	0	30	0	0
15	80214242	rs28434359	C	T	17	12	29	0	0	29	0	0
15	80214259	rs60250355	C	T	15	9	24	0	0	24	0	0
15	80214285	rs57425739	A	G	13	7	20	0	0	20	0	0
15	80214291	rs57141546	C	T	13	7	20	0	0	20	0	0
15	80214476	rs34284386	G	C	8	9	17	0	0	17	0	0
15	80214565	rs72736547	A	G	11	10	21	0	0	21	0	0
15	80214566	rs67481680	T	C	11	10	21	0	0	21	0	0
15	80214612	rs34468549	G	A	2	8	10	0	0	10	0	0
15	80214662	rs34589265	A	G	9	4	13	0	0	13	0	0
15	80214677	rs34397803	T	G	10	8	18	0	0	18	0	0
15	80214708	rs16971581	T	G	17	14	31	0	0	31	0	0
15	80214840	rs12904257	C	A	12	8	20	0	0	20	0	0
15	80215597	rs2303824	G	T	7	9	16	0	0	16	0	0
15	80216015	rs3803540	C	A	14	19	33	0	1	34	0	0
15	80216165	rs17214656	G	T	7	5	12	0	0	12	0	0
15	80216176	rs34149442	G	T	7	5	12	0	0	12	0	0
15	80216243	rs36070199	A	C	6	3	9	0	0	9	0	0
15	80216325	rs12442408	A	G	19	23	42	0	1	43	0	0
15	80216516	rs71409262	A	C	31	25	56	0	0	56	0	0
15	80216931	rs34172478	T	C	34	23	57	0	1	58	0	0
15	80373047	rs77013706	C	T	3	4	7	0	0	7	0	0
15	80416605	rs151054565	C	A	6	7	13	0	0	13	0	0
15	81022646	rs13380029	C	G	0	8	8	0	0	8	0	0
15	81022981	.	C	T	5	4	9	0	0	9	0	0
15	81026638	rs12591734	A	G	0	6	6	0	0	6	0	0
15	81027646	rs72736184	T	G	5	2	7	0	0	7	0	0
15	81029561	rs35978580	G	A	3	4	7	0	0	7	0	0
15	81030289	rs72736190	A	G	6	4	10	0	0	10	0	0
15	81031026	rs72736191	T	C	15	5	20	0	0	20	0	0
15	81031886	rs12441947	T	C	11	24	35	0	0	35	0	0
15	81031974	rs2062315	G	T	12	32	44	0	2	46	0	0
15	81047003	rs7166728	C	T	9	30	39	0	0	39	0	0
15	81047404	rs1046417	T	C	9	37	46	0	0	46	0	0
15	81047829	rs11072940	C	A	5	16	21	0	1	22	0	0
15	82512429	rs2292189	C	G	15	18	33	0	0	33	0	0
15	83423493	rs3803383	C	T	58	50	108	0	0	108	0	0
15	83479349	rs66851469	T	C	28	24	52	0	2	54	0	0
15	83480154	rs35590674	C	T	8	6	14	0	0	14	0	0
15	83481259	rs34337936	C	T	5	5	10	0	0	10	0	0
15	83481451	rs144030056	G	A	5	2	7	0	0	7	0	0
15	83481579	rs8025432	A	C	7	8	15	0	0	15	0	0
15	83485804	rs12903411	G	A	2	6	8	0	1	9	0	0
15	83486082	rs11857233	A	C	5	2	7	0	0	7	0	0
15	83488382	rs1807242	T	A	4	4	8	0	0	8	0	0
15	83488773	rs2379996	T	C	5	7	12	0	1	13	0	0
15	83493525	rs12902970	T	C	22	8	30	0	0	30	0	0
15	83493843	rs28539127	C	T	7	10	17	0	0	17	0	0
15	83494051	rs12907810	T	C	2	4	6	0	0	6	0	0
15	83494901	rs4779068	G	A	2	7	9	0	0	9	0	0
15	83496743	rs35989256	A	G	6	2	8	0	0	8	0	0
15	83498795	rs8041231	T	G	5	5	10	0	0	10	0	0
15	83499665	rs3814282	G	A	88	49	137	0	7	150	6	0
15	83499766	rs3814281	G	A	165	162	327	0	5	332	0	0
15	83502767	rs34291804	A	G	256	191	447	0	7	454	0	0
15	83503075	rs35407574	A	G	520	494	1014	0	14	1029	1	0
15	83664191	rs1037403	C	G	5	1	6	0	0	6	0	0
15	83664519	rs2381028	C	T	5	2	7	0	0	7	0	0
15	83680287	rs4842860	A	G	7	21	28	0	1	29	0	0
15	83712460	rs71412290	A	G	5	6	11	0	1	12	0	0
15	83713442	rs4842993	A	C	6	9	15	0	0	15	0	0
15	83724143	rs10152914	A	G	15	19	34	0	0	34	0	0
15	83724410	rs2167603	C	G	16	13	29	0	0	29	0	0
15	83724987	rs8038107	C	G	8	5	13	0	0	13	0	0
15	83855242	rs36093153	T	C	2	4	6	0	0	6	0	0
15	84911311	rs202113240	G	C	22	5	27	0	1	28	0	0
15	85055706	rs62637746	T	C	22	20	42	0	4	46	0	0
15	85055872	.	C	T	29	29	58	0	3	61	0	0
15	85062472	rs62029643	G	A	5	3	8	0	0	8	0	0
15	85072528	rs62029646	T	C	11	7	18	0	0	18	0	0
15	85072558	rs62029647	C	T	9	7	16	0	0	16	0	0
15	85073443	rs62029648	T	C	0	9	9	0	0	9	0	0
15	85074334	rs62029649	C	T	2	8	10	0	0	10	0	0
15	85078143	rs150967	G	A	8	3	11	0	0	11	0	0
15	85079649	rs150966	C	T	9	3	12	0	0	12	0	0
15	85080527	rs150965	T	G	17	5	22	0	0	22	0	0
15	85080662	rs11073840	T	C	3	10	13	0	0	13	0	0
15	85113972	rs11633075	C	A	9	5	14	0	0	14	0	0
15	85148231	rs11638554	T	G	2	8	10	0	0	10	0	0
15	85149575	rs748455	T	C	6	11	17	0	0	17	0	0
15	85165699	rs11635597	C	T	7	13	20	0	0	20	0	0
15	85174755	rs3825878	C	T	3	5	8	0	1	9	0	0
15	85174786	.	C	T	6	4	10	0	0	10	0	0
15	85177723	rs36126054	T	G	5	3	8	0	0	8	0	0
15	85182786	rs1057946	G	T	24	32	56	0	0	56	0	0
15	85183790	rs1061737	G	C	23	11	34	0	0	34	0	0
15	85184243	rs3748374	A	G	8	7	15	0	0	15	0	0
15	85184963	rs12914433	G	A	12	7	19	0	1	20	0	0
15	85186577	rs7237	C	T	31	15	46	0	0	46	0	0
15	85187152	rs11633762	T	C	5	2	7	0	0	7	0	0
15	85189464	rs2271431	T	G	33	18	51	0	0	51	0	0
15	85191274	rs7169629	C	G	2	7	9	0	0	9	0	0
15	85196244	rs62021208	G	A	8	5	13	0	0	13	0	0
15	85197253	rs4842978	T	C	12	13	25	0	0	25	0	0
15	85200520	rs1051168	G	T	24	14	38	0	0	38	0	0
15	85200754	rs2292462	G	T	3	9	12	0	0	12	0	0
15	85215229	rs6496318	C	T	5	1	6	0	0	6	0	0
15	85215383	rs7176522	C	G	4	2	6	0	0	6	0	0
15	85337699	rs12903134	T	A	7	3	10	0	0	10	0	0
15	85337800	rs35726233	C	T	6	4	10	0	0	10	0	0
15	85343980	rs35960805	T	G	5	7	12	0	1	13	0	0
15	85344550	rs12912388	T	A	5	4	9	0	0	9	0	0
15	85347709	rs17601029	A	G	16	14	30	0	0	30	0	0
15	85638924	rs2342974	T	A	3	3	6	0	0	6	0	0
15	85639841	rs12904238	A	T	3	3	6	0	0	6	0	0
15	85640911	rs3816105	G	A	6	2	8	0	0	8	0	0
15	85640983	rs2304418	T	C	5	4	9	0	0	9	0	0
15	85958438	rs11638454	C	G	8	4	12	0	0	12	0	0
15	85958673	rs35451550	G	T	12	2	14	0	0	14	0	0
15	86048103	rs34585751	T	G	7	1	8	0	0	8	0	0
15	86122654	rs2061821	T	C	4	5	9	0	1	10	0	0
15	86122779	rs2061822	T	C	3	9	12	0	0	12	0	0
15	86122916	rs2061823	T	C	4	8	12	0	0	12	0	0
15	86123019	rs2061824	C	T	4	4	8	0	0	8	0	0
15	86123833	rs4075256	T	C	6	6	12	0	0	12	0	0
15	86123924	rs4075255	C	T	7	9	16	0	0	16	0	0
15	86123988	rs4075254	G	A	4	6	10	0	0	10	0	0
15	86124419	rs4843073	C	T	8	5	13	0	0	13	0	0
15	86124483	rs4843074	C	G	6	3	9	0	0	9	0	0
15	86124555	rs4843075	G	A	6	7	13	0	0	13	0	0
15	86124616	rs61731243	A	G	9	11	20	0	0	20	0	0
15	86124946	rs7162168	T	C	11	9	20	0	1	21	0	0
15	86124968	rs11633087	G	A	9	10	19	0	0	19	0	0
15	86125031	rs7178065	G	A	12	12	24	0	0	24	0	0
15	86125304	rs7179919	C	T	12	11	23	0	0	23	0	0
15	86126275	rs4842891	C	A	25	18	43	0	0	43	0	0
15	86127408	rs12906184	A	G	8	0	8	0	0	8	0	0
15	86193194	rs385603	C	T	5	1	6	0	0	6	0	0
15	86193756	rs10163090	G	A	7	3	10	0	0	10	0	0
15	86242048	rs8034454	G	A	1	5	6	0	0	6	0	0
15	86284009	rs184019539	C	G	11	7	18	0	2	20	0	0
15	86284342	rs16943792	C	T	36	30	66	0	0	66	0	0
15	86285824	rs56141817	A	C	5	4	9	0	0	9	0	0
15	86285835	rs12908773	C	T	4	3	7	0	0	7	0	0
15	86287910	rs11073517	C	T	72	74	146	0	4	150	0	0
15	86288518	rs1053992	G	C	121	103	224	0	4	228	0	0
15	86288596	rs16943854	T	G	94	124	218	0	0	218	0	0
15	86288673	rs11631419	C	T	78	97	175	0	1	176	0	0
15	86289879	rs3743326	G	C	127	106	233	0	2	235	0	0
15	86290060	rs3743327	T	C	123	124	247	0	1	248	0	0
15	86290416	rs3743328	G	C	151	157	308	0	2	310	0	0
15	86291642	rs3169122	T	C	124	88	212	0	2	214	0	0
15	86302765	rs8040517	C	T	8	11	19	0	0	19	0	0
15	89169858	rs8027765	A	G	11	10	21	0	1	22	0	0
15	89172558	rs3743475	G	C	13	9	22	0	0	22	0	0
15	89173136	rs3826039	A	C	5	3	8	0	1	9	0	0
15	89173657	rs3826038	A	T	10	14	24	0	0	24	0	0
15	89174048	rs3743473	T	C	9	13	22	0	0	22	0	0
15	89174748	rs2278598	G	C	20	34	54	0	0	54	0	0
15	89175173	rs1047276	A	G	52	34	86	0	0	86	0	0
15	89175174	rs1047278	C	G	53	34	87	0	0	87	0	0
15	89182596	rs3200942	A	G	36	55	91	0	6	97	0	0
15	89185054	rs12050581	G	A	4	3	7	0	0	7	0	0
15	89186108	rs28409522	G	A	9	4	13	0	0	13	0	0
15	89187668	rs140646877	C	A	3	3	6	0	0	6	0	0
15	89188705	rs12442205	C	T	3	3	6	0	0	6	0	0
15	89420974	rs17201864	C	T	19	27	46	0	0	46	0	0
15	89421327	rs2280463	A	G	26	19	45	0	0	45	0	0
15	89430544	rs62620238	G	A	21	13	34	0	0	34	0	0
15	89442466	rs10859	G	C	17	16	33	0	0	33	0	0
15	89445598	rs8025462	C	T	4	4	8	0	0	8	0	0
15	89446284	rs56108780	C	G	4	4	8	0	0	8	0	0
15	89450546	rs1878327	C	T	8	9	17	0	1	18	0	0
15	89450587	rs1878326	G	T	12	9	21	0	0	21	0	0
15	89637418	rs293375	C	A	13	8	21	0	0	21	0	0
15	89645230	rs293380	A	G	4	7	11	0	0	11	0	0
15	89648943	rs293392	C	T	8	8	16	0	0	16	0	0
15	89649508	rs293390	G	A	6	5	11	0	0	11	0	0
15	89649704	rs293389	C	T	3	6	9	0	0	9	0	0
15	89650795	rs293388	C	T	6	2	8	0	0	8	0	0
15	89651254	rs293387	G	C	5	2	7	0	0	7	0	0
15	89652138	rs293386	G	A	9	2	11	0	0	11	0	0
15	89652552	rs293385	G	A	8	8	16	0	0	16	0	0
15	89652572	rs293384	A	G	5	5	10	0	0	10	0	0
15	89653764	rs1033155	A	G	7	3	10	0	0	10	0	0
15	89654197	rs293382	T	A	4	10	14	0	1	15	0	0
15	89654764	rs293401	A	G	22	9	31	0	0	31	0	0
15	89654976	rs293400	T	C	10	9	19	0	0	19	0	0
15	89655405	rs293399	C	G	14	15	29	0	0	29	0	0
15	89720921	rs2283439	T	C	2	4	6	0	0	6	0	0
15	89720946	rs16942802	T	A	2	4	6	0	0	6	0	0
15	89721461	rs2283438	T	C	30	65	95	0	0	95	0	0
15	89852432	rs150742793	C	T	4	2	6	0	0	6	0	0
15	89865898	rs2307428	T	G	5	2	7	0	0	7	0	0
15	90168693	rs1866928	T	A	6	1	7	0	0	7	0	0
15	90170237	rs3743372	C	T	7	12	19	0	0	19	0	0
15	90170933	rs3743371	G	A	15	27	42	0	0	42	0	0
15	90171306	rs1054435	A	G	10	11	21	0	0	21	0	0
15	90172834	rs72750748	T	G	5	5	10	0	0	10	0	0
15	90174789	rs9672286	C	T	5	4	9	0	0	9	0	0
15	90174824	rs12900805	C	T	4	3	7	0	0	7	0	0
15	90176073	rs3803530	C	A	7	1	8	0	0	8	0	0
15	90193686	rs12595712	G	A	4	4	8	0	0	8	0	0
15	90334240	rs25654	A	G	141	169	310	0	3	313	0	0
15	90334345	rs7168329	C	G	24	11	35	0	0	35	0	0
15	90334415	rs7169161	A	G	15	22	37	0	1	38	0	0
15	90335534	rs25652	G	A	182	185	367	0	4	371	0	0
15	90335788	rs25651	C	T	143	129	272	0	1	273	0	0
15	90336373	rs16943605	T	C	2	5	7	0	0	7	0	0
15	90338029	rs28638060	T	C	4	3	7	0	0	7	0	0
15	90338062	rs28626435	T	G	4	3	7	0	0	7	0	0
15	90338071	rs28639834	T	G	4	2	6	0	0	6	0	0
15	90338072	rs28545693	T	C	4	2	6	0	0	6	0	0
15	90338193	rs1439120	A	G	3	3	6	0	0	6	0	0
15	90349558	rs25653	C	T	47	43	90	0	3	93	0	0
15	90351574	rs10152918	G	A	3	6	9	0	0	9	0	0
15	90373873	rs7111	T	C	14	11	25	0	0	25	0	0
15	90374257	rs2028299	C	A	26	15	41	0	1	42	0	0
15	90376800	rs12197	G	A	7	12	19	0	0	19	0	0
15	90376965	rs78859143	T	C	17	8	25	0	0	25	0	0
15	90381258	rs748508	G	T	2	5	7	0	0	7	0	0
15	90387740	rs11636349	T	C	4	2	6	0	0	6	0	0
15	90402735	rs4932256	C	T	6	4	10	0	0	10	0	0
15	90403198	rs35878743	G	A	3	6	9	0	0	9	0	0
15	90617539	rs6496620	C	T	7	3	10	0	0	10	0	0
15	90618867	rs2939847	G	T	16	8	24	0	0	24	0	0
15	90619081	rs2939848	C	T	12	13	25	0	1	26	0	0
15	90619082	rs2939849	C	G	12	14	26	0	0	26	0	0
15	90619154	rs2970359	A	G	9	11	20	0	0	20	0	0
15	90619362	rs2939850	T	C	12	9	21	0	0	21	0	0
15	90621108	rs112549371	C	T	6	1	7	0	0	7	0	0
15	90622504	rs2970358	C	T	7	5	12	0	0	12	0	0
15	90623052	rs2970357	T	C	9	11	20	0	1	21	0	0
15	90623540	rs2970356	C	G	17	19	36	0	0	36	0	0
15	90768959	rs908044	A	C	10	7	17	0	0	17	0	0
15	90771704	rs3751656	G	A	9	8	17	0	1	18	0	0
15	90771750	rs3751655	T	G	11	10	21	0	0	21	0	0
15	90772005	rs11547962	G	A	16	18	34	0	0	34	0	0
15	90772156	rs11547961	A	G	13	15	28	0	1	29	0	0
15	90772831	rs7024	C	T	5	8	13	0	0	13	0	0
15	90773782	rs2073706	C	T	10	7	17	0	0	17	0	0
15	90774987	rs2073704	G	A	136	127	263	0	7	270	0	0
15	90775397	rs2073703	G	A	57	89	146	0	5	151	0	0
15	90775700	rs4628940	G	A	72	230	302	0	0	302	0	0
15	90775913	rs8041338	C	T	54	136	190	0	0	190	0	0
15	90775919	rs8025875	T	A	51	144	195	0	0	195	0	0
15	90776154	rs9745131	G	T	28	81	109	0	6	115	0	0
15	90776375	rs9744242	T	C	53	198	251	0	1	252	0	0
15	90777267	rs8025979	G	A	2	4	6	0	0	6	0	0
15	90809460	rs117872724	C	T	93	117	210	0	2	212	0	0
15	90819641	rs12904877	A	C	6	10	16	0	0	16	0	0
15	90819876	rs7174932	T	C	8	7	15	0	1	16	0	0
15	91010776	rs1505936	T	C	6	6	12	0	0	12	0	0
15	91044408	rs1042538	T	A	24	27	51	0	0	51	0	0
15	91045408	rs3540	G	A	20	28	48	0	3	51	0	0
15	91185291	rs71407320	C	T	16	15	31	0	0	31	0	0
15	91185485	rs2286287	A	G	18	17	35	0	2	37	0	0
15	91185842	rs3743403	A	G	18	18	36	0	0	36	0	0
15	91185971	rs3743402	G	A	18	16	34	0	1	35	0	0
15	91187490	rs3803565	C	A	55	52	107	0	0	107	0	0
15	91382995	rs7402445	C	T	8	0	8	0	0	8	0	0
15	91415633	rs78569252	C	G	10	11	21	0	0	21	0	0
15	91416550	rs17514846	C	A	16	14	30	0	1	31	0	0
15	91416565	rs80291522	C	T	16	15	31	0	0	31	0	0
15	91416605	rs1981458	T	C	10	6	16	0	0	16	0	0
15	91416872	rs113579461	G	T	8	10	18	0	0	18	0	0
15	91417330	rs75000622	C	T	19	16	35	0	0	35	0	0
15	91418544	rs4405529	G	T	12	8	20	0	0	20	0	0
15	91418591	rs4526996	A	G	11	9	20	0	0	20	0	0
15	91421806	rs28402904	C	T	6	3	9	0	0	9	0	0
15	91422543	rs8039305	T	C	5	4	9	0	0	9	0	0
15	91423543	rs6224	G	T	3	3	6	0	0	6	0	0
15	91424574	rs6226	G	C	206	224	430	0	4	435	1	0
15	91426560	rs4702	G	A	351	384	735	0	5	740	0	0
15	91428290	rs11539637	C	T	34	39	73	0	1	74	0	0
15	91428589	rs7183988	T	G	8	3	11	0	0	11	0	0
15	91428636	rs7177338	G	A	8	4	12	0	0	12	0	0
15	91446472	rs734252	T	C	42	42	84	0	1	85	0	0
15	91450350	rs2239293	G	A	3	3	6	0	0	6	0	0
15	91450441	rs2677744	G	A	13	11	24	0	0	24	0	0
15	91451967	.	G	A	3	6	9	0	0	9	0	0
15	91452106	rs2002739	C	T	3	5	8	0	0	8	0	0
15	91452204	rs877285	A	G	4	5	9	0	0	9	0	0
15	91452294	rs7183098	A	G	2	7	9	0	0	9	0	0
15	91452595	rs2106673	A	G	116	106	222	0	3	225	0	0
15	91453131	rs3784779	C	T	4	2	6	0	0	6	0	0
15	91455618	rs6496737	C	T	46	50	96	0	0	96	0	0
15	91456102	rs1266492	T	C	5	2	7	0	0	7	0	0
15	91457220	rs1266490	G	C	8	8	16	0	0	16	0	0
15	91458485	rs1266489	G	A	10	12	22	0	0	22	0	0
15	91460284	rs1266486	T	C	21	11	32	0	1	33	0	0
15	91460302	rs17635872	T	C	18	12	30	0	2	32	0	0
15	91463842	rs4773	G	A	323	301	624	0	3	627	0	0
15	91464975	rs10048033	C	G	53	65	118	0	0	118	0	0
15	91474236	rs1052532	T	C	11	7	18	0	0	18	0	0
15	91474738	rs1052535	G	C	7	14	21	0	0	21	0	0
15	91478544	rs17635974	A	C	5	3	8	0	0	8	0	0
15	91489685	rs11854429	A	G	3	3	6	0	0	6	0	0
15	91497239	rs11207	C	T	21	30	51	0	0	51	0	0
15	92416421	rs4537992	C	G	5	5	10	0	0	10	0	0
15	92473880	rs7165108	C	T	6	6	12	0	0	12	0	0
15	92510149	rs10852166	T	G	3	4	7	0	0	7	0	0
15	92685760	rs2238356	A	C	4	2	6	0	0	6	0	0
15	92687556	rs2238351	T	C	3	5	8	0	0	8	0	0
15	92689472	rs12901919	G	C	8	1	9	0	0	9	0	0
15	92689695	rs2074886	C	G	10	23	33	0	0	33	0	0
15	92706594	rs8174	T	C	20	14	34	0	0	34	0	0
15	92707909	rs9302356	T	C	5	3	8	0	0	8	0	0
15	92707970	rs3169130	G	A	4	3	7	0	0	7	0	0
15	92708303	rs7496880	C	T	4	2	6	0	0	6	0	0
15	92714879	rs2240589	C	T	7	4	11	0	0	11	0	0
15	92715131	rs2270061	A	T	38	45	83	0	1	84	0	0
15	92715167	rs2270060	C	T	42	43	85	0	1	86	0	0
15	93429646	rs1439620	A	G	13	12	25	0	0	25	0	0
15	93431163	rs11074115	C	T	5	12	17	0	0	17	0	0
15	93432448	rs35812522	T	C	2	28	30	0	1	31	0	0
15	93433936	rs4778055	T	G	22	23	45	0	0	45	0	0
15	93434249	rs2119011	G	A	29	19	48	0	0	48	0	0
15	93435225	rs2304655	C	T	39	31	70	0	0	70	0	0
15	93436311	rs11074116	A	G	42	38	80	0	0	80	0	0
15	93436489	rs12900342	G	A	16	7	23	0	0	23	0	0
15	93438609	rs1992283	G	C	13	7	20	0	0	20	0	0
15	93439224	rs8024067	T	G	10	7	17	0	0	17	0	0
15	93441267	rs7743	G	A	647	532	1179	0	5	1184	0	0
15	93441907	rs1439621	A	G	17	23	40	0	0	40	0	0
15	93442379	rs2388023	A	C	6	1	7	0	0	7	0	0
15	93459453	rs62023121	C	T	2	6	8	0	0	8	0	0
15	93460991	rs17648415	A	G	4	6	10	0	0	10	0	0
15	93461371	rs1406714	C	G	2	5	7	0	0	7	0	0
15	93462935	rs7175134	A	T	4	3	7	0	0	7	0	0
15	93462960	rs7173103	G	T	5	4	9	0	0	9	0	0
15	93463631	rs8024528	T	C	6	4	10	0	0	10	0	0
15	93464509	rs28573213	A	G	5	5	10	0	1	11	0	0
15	93465187	rs1881837	G	A	3	6	9	0	0	9	0	0
15	93510603	rs4777755	A	G	63	57	120	0	3	123	0	0
15	93519107	rs6497012	C	G	5	1	6	0	0	6	0	0
15	93521604	rs11074121	A	G	82	74	156	0	0	156	0	0
15	93534933	rs3826035	A	G	38	44	82	0	1	83	0	0
15	93536626	rs3784785	G	T	5	4	9	0	0	9	0	0
15	93536804	rs62023149	G	T	6	1	7	0	0	7	0	0
15	93539625	rs2388054	C	T	3	6	9	0	0	9	0	0
15	93539666	rs2388055	A	T	3	8	11	0	0	11	0	0
15	93540997	rs2053359	C	T	5	1	6	0	1	7	0	0
15	93542000	rs7173849	C	G	12	4	16	0	0	16	0	0
15	93542079	rs7179483	T	C	13	6	19	0	0	19	0	0
15	93542088	rs7174043	C	T	13	6	19	0	0	19	0	0
15	93542281	rs7179863	T	C	6	4	10	0	0	10	0	0
15	93547575	rs8042437	T	C	1	5	6	0	0	6	0	0
15	93567526	rs28558199	G	A	5	4	9	0	0	9	0	0
15	93568884	rs9672839	A	C	186	175	361	0	3	364	0	0
15	93570241	rs7402385	T	C	330	284	614	0	0	614	0	0
15	93570723	rs13759	T	C	480	463	943	0	28	971	0	0
15	94406399	rs11857050	A	G	3	6	9	0	0	9	0	0
15	94776950	rs28732672	T	G	8	5	13	0	0	13	0	0
15	94779669	rs17547272	A	G	5	3	8	0	0	8	0	0
15	94780241	rs11635007	G	T	16	14	30	0	0	30	0	0
15	94780486	rs12904339	G	A	15	9	24	0	0	24	0	0
15	94780720	rs28750203	C	G	18	11	29	0	1	30	0	0
15	94780730	rs12906507	A	G	18	11	29	0	0	29	0	0
15	94781185	rs28706947	G	A	467	281	748	0	1	749	0	0
15	94781904	rs10163015	C	T	4	5	9	0	0	9	0	0
15	94803471	rs1455757	A	G	1	6	7	0	0	7	0	0
15	94859068	rs294549	T	C	3	5	8	0	0	8	0	0
15	94860677	rs56241343	C	T	3	4	7	0	0	7	0	0
15	94860903	rs56214444	A	G	6	4	10	0	0	10	0	0
15	94899308	rs2117216	A	G	4	2	6	0	0	6	0	0
15	94899354	rs2164019	T	G	3	3	6	0	0	6	0	0
15	94945719	rs7178698	G	T	30	20	50	0	0	50	0	0
15	94946216	rs11633971	A	G	55	20	75	0	0	75	0	0
15	94946231	rs11633973	A	C	53	17	70	0	1	71	0	0
15	94946328	rs79337282	T	C	60	20	80	0	2	82	0	0
15	95014655	rs1424695	T	C	3	5	8	0	0	8	0	0
15	95019387	rs3784637	G	A	30	19	49	0	1	50	0	0
15	95019465	.	G	C	19	24	43	0	0	43	0	0
15	95024344	rs2839734	G	A	18	10	28	0	0	28	0	0
15	95024760	rs1048048	T	C	37	16	53	0	0	53	0	0
15	98505039	rs60965421	C	T	3	3	6	0	0	6	0	0
15	99198425	.	A	T	5	2	7	0	0	7	0	0
15	99199212	rs12905392	G	A	6	0	6	0	0	6	0	0
15	99200056	rs4966007	G	A	12	0	12	0	0	12	0	0
15	99200467	rs28680698	G	A	4	2	6	0	0	6	0	0
15	99201573	rs34038360	A	C	12	3	15	0	0	15	0	0
15	99202875	rs8028620	C	T	13	1	14	0	0	14	0	0
15	99203445	rs4966008	C	T	55	5	60	0	3	63	0	0
15	99203496	rs4966009	C	T	69	9	78	0	2	80	0	0
15	99504129	rs3743251	G	A	2	5	7	0	0	7	0	0
15	99504437	rs2684788	C	T	4	6	10	0	0	10	0	0
15	99504671	rs1815009	C	T	13	3	16	0	0	16	0	0
15	99505129	rs2654981	C	G	1	8	9	0	0	9	0	0
15	99505316	rs3743250	C	T	10	8	18	0	0	18	0	0
15	99505423	rs3743249	G	T	1	9	10	0	0	10	0	0
15	99570877	rs2593038	C	T	4	3	7	0	0	7	0	0
15	99573706	rs72754856	G	T	3	4	7	0	0	7	0	0
15	99573959	rs2259707	C	T	4	2	6	0	0	6	0	0
15	99797868	rs12906713	C	T	3	5	8	0	0	8	0	0
15	99798405	rs34471005	C	T	3	4	7	0	0	7	0	0
15	99798934	rs7162949	G	A	6	1	7	0	0	7	0	0
15	100239400	.	T	C	5	1	6	0	0	6	0	0
15	100254725	rs897074	T	C	15	12	27	0	0	27	0	0
15	100255013	.	C	A	4	7	11	0	1	12	0	0
15	100255021	.	C	A	5	5	10	0	2	12	0	0
15	100255046	rs325383	A	G	15	5	20	0	0	20	0	0
15	100255104	rs325382	G	C	23	21	44	0	0	44	0	0
15	100417307	rs75593235	C	T	7	3	10	0	0	10	0	0
15	101189995	rs79850994	T	C	26	35	61	0	0	61	0	0
15	101464915	rs11630691	T	C	8	6	14	0	0	14	0	0
15	101473774	.	C	T	4	3	7	0	0	7	0	0
15	101475159	rs55822333	A	G	3	3	6	0	0	6	0	0
15	101475215	rs56293304	A	G	0	6	6	0	0	6	0	0
15	101475466	rs11858394	T	C	2	5	7	0	0	7	0	0
15	101529594	rs2412000	G	A	12	3	15	0	0	15	0	0
15	101612037	rs118149922	G	A	5	12	17	0	0	17	0	0
15	101716583	rs11433	A	G	143	145	288	0	1	289	0	0
15	101717065	rs3784523	A	G	160	134	294	0	0	294	0	0
15	101717680	rs8024370	G	T	99	92	191	0	2	193	0	0
15	101718097	rs28364839	C	G	105	105	210	0	5	215	0	0
15	101728381	rs7166488	C	T	43	26	69	0	0	69	0	0
15	101740199	rs10751717	A	G	3	3	6	0	0	6	0	0
15	101758227	rs12324684	G	C	6	5	11	0	0	11	0	0
15	101761003	rs67228299	G	A	4	4	8	0	0	8	0	0
15	101775905	rs7165356	C	T	4	2	6	0	0	6	0	0
15	101775920	rs7165361	C	T	4	3	7	0	0	7	0	0
15	101778146	rs8043249	T	A	14	9	23	0	1	24	0	0
15	101778350	rs8033300	A	T	12	15	27	0	0	27	0	0
15	101778710	rs8033360	C	A	15	14	29	0	0	29	0	0
15	101779863	rs11858464	G	A	16	10	26	0	1	27	0	0
15	101780094	rs11634283	A	G	10	23	33	0	0	33	0	0
15	101780691	rs58136452	C	T	11	15	26	0	0	26	0	0
15	101781125	rs11856403	A	C	5	8	13	0	0	13	0	0
15	101781323	.	C	T	9	11	20	0	2	22	0	0
15	101781934	rs752092	A	G	28	15	43	0	0	43	0	0
15	101782089	rs8029617	G	A	11	7	18	0	0	18	0	0
15	101782175	rs8031074	C	T	14	3	17	0	0	17	0	0
15	101782187	rs8036047	T	C	13	4	17	0	0	17	0	0
15	101782262	rs8031113	C	G	9	8	17	0	0	17	0	0
15	101782759	rs11639408	T	C	12	15	27	0	1	28	0	0
15	101783234	rs12324313	C	G	6	9	15	0	0	15	0	0
15	101783292	rs12324414	C	T	8	6	14	0	0	14	0	0
15	101784223	rs7182945	C	T	12	9	21	0	0	21	0	0
15	101784281	rs28465510	A	T	13	7	20	0	0	20	0	0
15	101784546	rs12324545	G	A	6	10	16	0	0	16	0	0
15	101784664	rs11247277	A	G	6	3	9	0	0	9	0	0
15	101785970	rs8038272	T	C	9	6	15	0	0	15	0	0
15	101786253	rs8032573	G	A	3	5	8	0	0	8	0	0
15	101786733	rs28445340	T	C	7	8	15	0	0	15	0	0
15	101786747	rs9672951	G	T	7	10	17	0	0	17	0	0
15	101787269	rs9672295	A	G	6	4	10	0	0	10	0	0
15	101787969	rs11636578	T	C	13	6	19	0	0	19	0	0
15	101788054	rs11630071	G	A	9	3	12	0	0	12	0	0
15	101788149	rs11636628	T	A	5	8	13	0	0	13	0	0
15	101788211	rs11630455	C	T	4	4	8	0	0	8	0	0
15	101788773	rs72768601	G	C	3	11	14	0	0	14	0	0
15	101789044	rs28498458	C	T	9	8	17	0	0	17	0	0
15	101789567	rs8025126	C	T	5	2	7	0	0	7	0	0
15	101790817	rs8032007	A	G	12	6	18	0	0	18	0	0
15	101791212	rs116643984	C	A	5	3	8	0	0	8	0	0
15	101823337	rs12902917	G	T	20	22	42	0	0	42	0	0
15	101823476	rs8028140	A	G	15	10	25	0	1	26	0	0
15	101823639	rs12438426	C	T	20	19	39	0	1	40	0	0
15	101823790	rs4965816	A	C	15	16	31	0	1	32	0	0
15	101824271	rs12909636	C	T	23	23	46	0	0	46	0	0
15	101824624	rs12908996	G	A	16	18	34	0	1	35	0	0
15	101825064	rs28415096	G	T	11	12	23	0	0	23	0	0
15	101826919	rs28698071	G	A	33	30	63	0	1	64	0	0
15	101827759	rs35525027	T	C	22	20	42	0	1	43	0	0
15	101827855	rs61752834	C	T	31	28	59	0	0	59	0	0
15	101828423	rs10152335	C	T	8	21	29	0	1	30	0	0
15	101828572	rs10152348	C	T	10	16	26	0	1	27	0	0
15	101828597	rs34314457	G	A	8	18	26	0	0	26	0	0
15	101828923	rs8027101	A	C	10	14	24	0	0	24	0	0
15	101829089	rs6598445	T	G	24	18	42	0	0	42	0	0
15	101829734	rs36106922	C	A	15	18	33	0	0	33	0	0
15	101830244	rs8037809	T	C	5	2	7	0	1	8	0	0
15	101830534	rs34883767	C	A	16	17	33	0	1	34	0	0
15	101830812	rs12899728	T	C	17	14	31	0	1	32	0	0
15	101832055	rs12440683	G	T	12	14	26	0	0	26	0	0
15	101832387	rs8028930	A	G	8	18	26	0	0	26	0	0
15	101832688	rs4965818	T	C	11	8	19	0	0	19	0	0
15	101833083	rs1482918	A	C	8	4	12	0	0	12	0	0
15	101834320	rs4965819	T	A	5	7	12	0	0	12	0	0
15	101834929	rs4965820	A	G	8	9	17	0	0	17	0	0
15	102186103	rs2956846	A	C	3	5	8	0	0	8	0	0
15	102191042	.	C	A	7	3	10	0	0	10	0	0
15	102192034	rs507903	A	G	17	17	34	0	2	36	0	0
15	102192540	rs675436	T	G	5	13	18	0	0	18	0	0
15	102194288	rs9964	C	T	12	10	22	0	0	22	0	0
15	102194403	rs520897	T	C	5	7	12	0	1	13	0	0
15	102224341	rs12901450	G	A	4	10	14	0	0	14	0	0
15	102264304	rs1143138	G	C	4	3	7	0	1	8	0	0
15	102282802	rs11630648	G	A	4	2	6	0	0	6	0	0
15	102284675	.	A	G	71	0	71	0	1	72	0	0
15	102285318	.	A	G	7	1	8	0	0	8	0	0
15	102503074	.	A	G	6	2	8	0	0	8	0	0
15	102503167	.	A	G	5	2	7	0	0	7	0	0
15	102503280	rs71411197	G	C	5	6	11	0	0	11	0	0
15	102503359	.	G	A	3	7	10	0	0	10	0	0
15	102505693	.	C	A	4	14	18	0	0	18	0	0
15	102506092	.	G	A	11	4	15	0	0	15	0	0
15	102506099	.	C	T	12	4	16	0	1	17	0	0
15	102506120	.	C	G	10	10	20	0	0	20	0	0
15	102506389	.	C	T	165	10	175	0	0	175	0	0
15	102506944	.	A	C	6	1	7	0	0	7	0	0
15	102507050	.	T	A	14	3	17	0	0	17	0	0
15	102512812	.	G	A	43	0	43	0	1	44	0	0
15	102513166	.	G	C	115	75	190	0	0	190	0	0
15	102514785	.	A	G	45	77	122	0	1	123	0	0
15	102514957	.	A	T	9	9	18	0	0	18	0	0
15	102516492	.	C	G	621	422	1043	0	2	1046	1	0
15	102516734	.	C	T	538	19	557	0	1	558	0	0
16	66646	.	G	A	11	12	23	0	0	23	0	0
16	66660	.	G	A	15	12	27	0	0	27	0	0
16	118809	rs10751767	C	G	2	4	6	0	0	6	0	0
16	132510	rs3176415	G	A	3	3	6	0	0	6	0	0
16	337830	rs193056425	G	C	133	90	223	0	2	225	0	0
16	597822	.	C	A	22	27	49	0	0	49	0	0
16	626237	.	C	G	34	25	59	0	2	61	0	0
16	630902	rs1045274	C	G	46	25	71	0	0	71	0	0
16	632011	rs74872027	C	T	4	7	11	0	0	11	0	0
16	632283	rs7187227	G	A	58	54	112	0	0	112	0	0
16	633706	rs1045283	C	T	147	95	242	0	1	243	0	0
16	633764	rs8642	G	A	100	122	222	0	0	222	0	0
16	646571	rs4984673	A	G	4	2	6	0	0	6	0	0
16	646865	rs1894675	C	G	1	6	7	0	0	7	0	0
16	647006	rs4984900	G	A	5	4	9	0	0	9	0	0
16	651113	rs2384976	T	C	4	2	6	0	0	6	0	0
16	651517	rs7191584	C	T	3	12	15	0	0	15	0	0
16	651538	rs11642273	G	A	8	3	11	0	0	11	0	0
16	652045	rs112610137	C	G	13	4	17	0	0	18	1	0
16	652941	rs7203694	G	A	12	4	16	0	0	16	0	0
16	653051	rs35368117	A	G	3	4	7	0	0	7	0	0
16	657073	rs72767879	G	C	4	5	9	0	0	9	0	0
16	664802	rs34812060	G	A	4	2	6	0	0	6	0	0
16	669857	rs72767885	G	T	2	6	8	0	0	8	0	0
16	669865	rs143577846	A	G	2	6	8	0	0	8	0	0
16	674601	rs72767889	C	T	2	9	11	0	0	11	0	0
16	675067	rs62623587	C	A	3	4	7	0	0	7	0	0
16	675215	rs2269556	G	A	3	5	8	0	0	8	0	0
16	675685	.	C	T	11	8	19	0	0	19	0	0
16	677629	rs2269557	T	C	14	10	24	0	1	25	0	0
16	678020	rs11548188	G	A	18	21	39	0	0	39	0	0
16	678843	rs1984395	C	T	40	31	71	0	2	73	0	0
16	696111	rs7203410	G	C	5	1	6	0	0	6	0	0
16	701656	rs11642546	C	T	13	35	48	0	1	49	0	0
16	704529	rs8045262	T	A	13	14	27	0	1	28	0	0
16	705360	rs3803697	T	C	27	35	62	0	1	63	0	0
16	705844	rs8051645	T	C	39	44	83	0	2	85	0	0
16	705920	rs9930754	G	C	17	25	42	0	0	42	0	0
16	706067	rs9932866	G	A	23	24	47	0	1	48	0	0
16	706534	rs28485323	G	A	48	48	96	0	0	96	0	0
16	706668	rs34775748	G	A	17	13	30	0	0	30	0	0
16	707034	rs6600228	A	C	20	6	26	0	2	28	0	0
16	707295	rs6600229	T	G	16	29	45	0	0	45	0	0
16	708275	rs45613635	C	A	35	63	98	0	0	98	0	0
16	708419	rs7188691	T	C	8	12	20	0	0	20	0	0
16	709001	rs4984906	C	A	19	28	47	0	1	48	0	0
16	709157	rs7194532	T	C	2	9	11	0	0	11	0	0
16	709630	rs4984907	A	C	5	9	14	0	0	14	0	0
16	709826	rs11248942	C	T	7	11	18	0	0	18	0	0
16	710473	rs3752495	T	C	4	3	7	0	0	7	0	0
16	711572	rs8062682	C	T	0	11	11	0	0	11	0	0
16	711582	rs8062685	C	G	0	11	11	0	0	11	0	0
16	711712	rs3177415	C	T	28	35	63	0	1	64	0	0
16	711905	rs2301426	A	G	38	54	92	0	0	92	0	0
16	712154	rs11248943	G	A	5	14	19	0	0	19	0	0
16	712867	rs1057835	A	G	37	47	84	0	0	84	0	0
16	713204	rs9929652	A	G	26	53	79	0	0	79	0	0
16	713210	rs9937980	G	A	25	52	77	0	2	79	0	0
16	713596	rs8046298	T	G	25	11	36	0	1	37	0	0
16	713747	rs4984908	A	G	27	15	42	0	0	42	0	0
16	713836	rs4984909	T	G	24	31	55	0	0	55	0	0
16	714126	rs4984910	A	G	30	33	63	0	0	63	0	0
16	714155	rs4984911	T	C	32	30	62	0	0	62	0	0
16	714232	rs4984679	T	C	38	40	78	0	0	79	1	0
16	715060	rs1044662	T	C	25	19	44	0	0	44	0	0
16	715161	rs1044663	A	G	27	26	53	0	1	54	0	0
16	715164	rs3184470	G	A	30	27	57	0	0	57	0	0
16	715990	rs7190775	G	A	76	120	196	0	3	199	0	0
16	716428	rs3743909	G	A	13	11	24	0	0	24	0	0
16	716798	rs12447392	C	T	4	5	9	0	0	9	0	0
16	717523	rs3752493	G	T	199	222	421	0	3	424	0	0
16	718514	rs7204542	C	G	53	46	99	0	0	99	0	0
16	719258	rs7202316	T	C	4	7	11	0	0	11	0	0
16	719917	rs4984680	G	C	9	9	18	0	0	18	0	0
16	719933	rs4984681	T	C	8	10	18	0	0	18	0	0
16	720041	rs3752489	C	T	16	16	32	0	1	33	0	0
16	720986	rs1139897	G	A	47	58	105	0	1	106	0	0
16	722331	rs3177338	C	T	83	75	158	0	3	161	0	0
16	722548	rs1128550	A	G	101	83	184	0	0	184	0	0
16	723647	rs1045716	C	G	104	111	215	0	0	215	0	0
16	723838	rs1045729	C	A	108	109	217	0	0	217	0	0
16	723958	.	C	T	155	126	281	0	1	282	0	0
16	726907	rs111852492	C	T	22	10	32	0	0	32	0	0
16	730955	rs72773412	A	T	5	9	14	0	0	14	0	0
16	731725	rs6597	T	G	117	91	208	0	3	211	0	0
16	735794	rs11640115	A	G	5	12	17	0	0	17	0	0
16	735921	rs763053	T	C	10	17	27	0	0	27	0	0
16	736438	rs7206567	C	T	8	6	14	0	0	14	0	0
16	736439	rs11645564	G	A	7	8	15	0	0	15	0	0
16	736447	rs10903019	A	C	8	7	15	0	0	15	0	0
16	737269	rs17850290	C	T	25	20	45	0	0	45	0	0
16	737793	rs1018804	G	A	9	12	21	0	1	22	0	0
16	772359	.	C	T	27	21	48	0	3	51	0	0
16	778024	rs1406814	T	C	6	18	24	0	0	24	0	0
16	778158	rs1406815	C	G	2	4	6	0	0	6	0	0
16	778820	rs12448432	G	A	16	16	32	0	0	32	0	0
16	779689	rs1054788	G	C	7	6	13	0	1	14	0	0
16	780339	rs7205337	A	G	283	245	528	0	4	532	0	0
16	781633	rs3829492	G	A	153	132	285	0	0	285	0	0
16	782132	rs12443759	C	T	9	13	22	0	0	22	0	0
16	783004	rs2071951	T	C	4	5	9	0	0	9	0	0
16	783156	rs61112891	G	C	4	5	9	0	0	9	0	0
16	783173	rs2071952	T	C	2	5	7	0	0	7	0	0
16	783864	rs12051048	C	A	27	13	40	0	0	40	0	0
16	783865	rs12051245	T	C	24	13	37	0	3	40	0	0
16	783967	rs12444733	C	T	23	29	52	0	0	52	0	0
16	784765	rs9928077	C	T	95	58	153	0	1	154	0	0
16	787738	rs12597563	G	C	35	32	67	0	0	67	0	0
16	787827	rs12449156	A	C	27	26	53	0	0	53	0	0
16	789618	rs10794640	G	A	32	19	51	0	0	51	0	0
16	789761	rs3752556	A	G	2	4	6	0	0	6	0	0
16	816977	rs35935235	G	A	3	7	10	0	0	10	0	0
16	1278424	rs1060341	G	A	18	588	606	0	1	607	0	0
16	1278744	.	C	T	26	137	163	0	4	167	0	0
16	1279382	.	C	T	0	56	56	0	0	56	0	0
16	1279438	rs202041848	C	T	4	98	102	0	0	102	0	0
16	1279574	rs199887053	C	G	6	133	139	0	1	140	0	0
16	1279584	rs111992451	T	C	6	147	153	0	0	153	0	0
16	1279623	rs72633259	G	A	9	171	180	0	3	183	0	0
16	1279704	.	A	G	13	80	93	0	1	94	0	0
16	1279710	.	G	A	14	56	70	0	0	70	0	0
16	1279714	.	A	G	14	39	53	0	1	54	0	0
16	1279717	.	C	T	14	40	54	0	0	54	0	0
16	1279732	.	C	A	14	37	51	0	1	52	0	0
16	1291188	.	C	T	242	24	266	0	2	268	0	0
16	1291597	rs144979264	C	G	365	57	422	0	4	426	0	0
16	1291831	.	G	C	338	217	555	0	1	556	0	0
16	1291850	.	T	C	255	196	451	0	1	452	0	0
16	1291941	.	G	A	111	102	213	0	1	214	0	0
16	1291972	.	C	G	140	116	256	0	1	257	0	0
16	1291975	.	G	A	143	99	242	0	5	247	0	0
16	1292085	.	C	T	177	113	290	0	5	295	0	0
16	1292254	rs1060314	T	G	958	623	1581	0	4	1585	0	0
16	1292257	rs17135220	G	T	989	657	1646	0	13	1659	0	0
16	1306642	rs61739908	C	T	5	2	7	0	0	7	0	0
16	1360601	rs8056919	C	T	22	29	51	0	0	51	0	0
16	1360657	rs72775490	C	T	33	24	57	0	0	57	0	0
16	1360843	rs8057293	C	T	17	20	37	0	0	37	0	0
16	1361079	rs8062442	A	G	35	14	49	0	1	50	0	0
16	1361167	rs8060742	G	T	32	17	49	0	3	52	0	0
16	1362187	rs12920764	C	T	28	19	47	0	1	48	0	0
16	1362556	rs12102342	G	A	42	50	92	0	1	93	0	0
16	1362559	rs12102374	C	G	40	48	88	0	0	88	0	0
16	1363878	rs9926183	C	T	24	20	44	0	1	45	0	0
16	1364365	rs4610	A	G	342	293	635	0	39	675	1	0
16	1364767	rs2281226	A	C	15	12	27	0	0	27	0	0
16	1365325	rs12918274	C	A	5	5	10	0	0	10	0	0
16	1365341	rs11248866	G	A	6	4	10	0	0	10	0	0
16	1365967	rs4984808	C	T	15	26	41	0	0	41	0	0
16	1366048	rs4984809	A	G	25	32	57	0	0	57	0	0
16	1366317	rs4017714	A	G	23	20	43	0	0	43	0	0
16	1366425	rs2369842	G	T	19	12	31	0	0	31	0	0
16	1367610	rs11647760	C	A	23	37	60	0	1	61	0	0
16	1368202	rs8060456	G	A	26	33	59	0	1	60	0	0
16	1371154	rs2268049	C	T	7	3	10	0	0	10	0	0
16	1372183	rs8052688	G	C	9	3	12	0	0	12	0	0
16	1372582	rs28510571	T	A	9	4	13	0	0	13	0	0
16	1372831	.	A	T	7	1	8	0	0	8	0	0
16	1373015	rs11648215	G	A	7	4	11	0	2	13	0	0
16	1373017	rs11648216	G	A	8	4	12	0	1	13	0	0
16	1373024	rs11648562	C	G	8	3	11	0	1	12	0	0
16	1374656	rs761060	A	G	14	17	31	0	0	31	0	0
16	1374818	rs8063	A	G	387	480	867	0	7	874	0	0
16	1375789	rs28457180	A	G	8	11	19	0	1	20	0	0
16	1376386	rs761063	G	C	2	15	17	0	0	17	0	0
16	1376838	rs1061611	C	T	20	22	42	0	0	42	0	0
16	1376892	rs1061621	C	T	16	19	35	0	0	35	0	0
16	1376929	rs1061633	C	T	15	17	32	0	0	32	0	0
16	1392877	rs742458	T	C	4	2	6	0	0	6	0	0
16	1397815	rs1132358	C	T	5	6	11	0	0	11	0	0
16	1414498	rs3826051	C	T	12	6	18	0	0	18	0	0
16	1414830	rs34428580	C	T	8	5	13	0	0	13	0	0
16	1470626	rs117620905	G	A	12	5	17	0	0	17	0	0
16	1486598	rs76876166	G	A	4	3	7	0	0	7	0	0
16	1495006	rs8767	C	G	30	23	53	0	0	53	0	0
16	1495300	rs941439	G	A	32	14	46	0	0	46	0	0
16	1495897	rs2294542	G	A	547	427	974	0	17	991	0	0
16	1497137	rs12599176	C	T	3	4	7	0	0	7	0	0
16	1498197	rs2235578	A	G	29	31	60	0	2	62	0	0
16	1498520	rs12597739	A	G	38	49	87	0	0	87	0	0
16	1499377	rs742408	C	T	30	22	52	0	2	54	0	0
16	1501375	rs8045185	G	T	23	33	56	0	1	57	0	0
16	1503879	rs2235579	T	A	117	87	204	0	1	205	0	0
16	1504017	rs4786337	A	G	3	6	9	0	0	9	0	0
16	1504149	rs11645645	T	C	5	3	8	0	0	8	0	0
16	1505429	rs2072694	C	G	9	6	15	0	1	16	0	0
16	1505599	rs7190701	C	T	10	6	16	0	0	16	0	0
16	1509365	rs12164970	A	G	35	45	80	0	6	86	0	0
16	1509391	rs79929432	G	A	31	33	64	0	6	70	0	0
16	1509998	rs4786417	G	A	57	45	102	0	13	115	0	0
16	1510132	rs4786419	G	A	57	72	129	0	1	130	0	0
16	1510284	rs6600148	A	G	39	44	83	0	1	84	0	0
16	1514652	rs2744996	A	G	1	6	7	0	0	7	0	0
16	1521745	rs1033466	G	A	5	4	9	0	0	9	0	0
16	1522388	rs8050362	T	C	2	8	10	0	0	10	0	0
16	1522670	rs1040497	A	G	7	3	10	0	0	10	0	0
16	1522872	rs2745113	C	T	6	7	13	0	0	13	0	0
16	1524261	rs28550432	G	T	6	1	7	0	0	7	0	0
16	1524850	rs3751884	A	G	23	17	40	0	2	42	0	0
16	1545448	rs2235624	A	G	11	10	21	0	0	21	0	0
16	1560303	rs117559520	G	T	53	74	127	0	0	127	0	0
16	1569186	rs117190102	G	A	4	2	6	0	0	6	0	0
16	1574170	rs141171038	A	G	8	6	14	0	0	14	0	0
16	1706435	rs61739874	C	T	28	41	69	0	0	69	0	0
16	1794808	rs117884379	G	A	16	24	40	0	0	40	0	0
16	1822947	rs1076695	C	G	3	11	14	0	0	14	0	0
16	1823054	rs11552432	C	G	18	11	29	0	0	29	0	0
16	1836063	rs118104889	G	A	4	2	6	0	0	6	0	0
16	2010857	rs4786902	T	A	4	4	8	0	0	8	0	0
16	2014031	rs6366	C	G	13	17	30	0	0	30	0	0
16	2014283	rs2286466	A	G	5186	96	5282	0	47	5329	0	0
16	2014424	rs403609	C	G	5	18	23	0	0	23	0	0
16	2014979	rs2302177	G	T	3	37	40	0	0	40	0	0
16	2051570	rs149153858	G	A	11	6	17	0	0	17	0	0
16	2070200	rs11248906	G	C	148	115	263	0	1	265	1	0
16	2070568	rs2286472	A	C	268	229	497	0	4	501	0	0
16	2083358	rs11544570	A	G	5	1	6	0	1	7	0	0
16	2084214	rs11643036	C	T	4	3	7	0	0	7	0	0
16	2084816	rs3890944	C	G	0	6	6	0	0	6	0	0
16	2108755	rs1800748	A	G	7	10	17	0	0	17	0	0
16	2111779	rs17135764	T	C	4	5	9	0	0	9	0	0
16	2125834	rs13337626	T	C	26	26	52	0	0	52	0	0
16	2132731	rs9928737	G	A	7	5	12	0	0	12	0	0
16	2133640	rs1800724	C	G	4	9	13	0	0	13	0	0
16	2138269	rs1748	T	C	127	153	280	0	1	282	1	0
16	2138584	rs1051771	G	C	76	112	188	0	0	188	0	0
16	2139127	rs3087631	A	T	76	103	179	0	10	189	0	0
16	2140010	rs7203729	A	G	58	49	107	0	0	107	0	0
16	2140321	rs79899502	G	A	37	38	75	0	0	75	0	0
16	2140454	rs3087632	T	C	38	36	74	0	2	76	0	0
16	2140554	rs3209986	G	A	38	53	91	0	0	91	0	0
16	2140680	rs10960	T	C	35	40	75	0	1	76	0	0
16	2144176	rs34197769	G	A	32	27	59	0	1	60	0	0
16	2149591	rs56149818	T	C	4	2	6	0	0	6	0	0
16	2152129	rs12926160	A	G	11	0	11	0	0	11	0	0
16	2152387	rs9925969	A	G	16	19	35	0	0	35	0	0
16	2152388	rs9935834	C	G	16	19	35	0	0	35	0	0
16	2154537	rs147350387	G	A	16	15	31	0	0	31	0	0
16	2156447	rs2003782	G	A	2	4	6	0	0	6	0	0
16	2156850	rs2457533	A	G	13	10	23	0	0	23	0	0
16	2159405	rs2575313	C	T	8	10	18	0	0	18	0	0
16	2159996	rs9935526	G	A	11	6	17	0	0	17	0	0
16	2160503	rs71385734	T	G	7	9	16	0	0	16	0	0
16	2164294	rs35965348	G	A	15	4	19	0	0	19	0	0
16	2164324	rs35667726	C	T	10	9	19	0	0	19	0	0
16	2204835	rs13242	T	C	268	175	443	0	0	443	0	0
16	2222598	rs187643207	C	T	97	94	191	0	2	193	0	0
16	2227368	rs35199162	C	T	99	108	207	0	2	209	0	0
16	2256326	rs27699	C	T	5	1	6	0	0	6	0	0
16	2256461	rs26863	C	G	5	18	23	0	0	23	0	0
16	2257105	rs26862	C	G	29	65	94	0	0	94	0	0
16	2261657	rs26852	A	G	3	4	7	0	0	7	0	0
16	2261683	rs26851	C	T	3	4	7	0	0	7	0	0
16	2262093	rs160546	G	A	6	2	8	0	0	8	0	0
16	2262113	rs1126	G	C	5	6	11	0	0	11	0	0
16	2263836	rs116977380	C	T	128	147	275	0	1	277	1	0
16	2274300	rs30988	T	C	6	4	10	0	0	10	0	0
16	2278509	rs2241070	G	A	20	29	49	0	4	53	0	0
16	2280277	rs27382	G	A	11	23	34	0	0	34	0	0
16	2280318	rs26837	G	A	13	18	31	0	0	31	0	0
16	2281012	rs35483132	C	T	13	21	34	0	0	34	0	0
16	2281151	rs26838	G	C	18	12	30	0	0	30	0	0
16	2281324	rs35436732	C	T	16	22	38	0	0	38	0	0
16	2290500	rs26844	G	C	3	6	9	0	0	9	0	0
16	2290591	rs34683007	C	T	6	2	8	0	0	8	0	0
16	2303353	rs7299	T	C	991	643	1634	0	8	1642	0	0
16	2303371	rs7298	C	A	1070	770	1840	0	8	1848	0	0
16	2303496	rs10721	G	A	972	618	1590	0	11	1601	0	0
16	2304338	rs9796949	G	A	3	3	6	0	0	6	0	0
16	2305539	rs155243	A	G	6	4	10	0	0	10	0	0
16	2313343	rs40342	C	T	17	17	34	0	0	34	0	0
16	2313774	rs12444273	C	T	9	7	16	0	1	17	0	0
16	2314023	rs147184621	T	C	3	11	14	0	0	14	0	0
16	2317777	rs11646649	C	G	5	3	8	0	0	8	0	0
16	2317778	rs11642797	T	G	5	3	8	0	0	8	0	0
16	2502641	rs1136062	T	C	5	1	6	0	0	6	0	0
16	2608001	.	G	A	1	7	8	0	0	8	0	0
16	2649988	.	A	G	80	0	80	0	2	82	0	0
16	2650146	.	G	C	58	0	58	0	0	58	0	0
16	2651814	rs56318884	C	G	31	23	54	0	2	56	0	0
16	2711316	rs3867	G	A	6	0	6	0	0	6	0	0
16	2711368	rs3088156	A	G	3	3	6	0	0	6	0	0
16	2720768	rs4786318	C	T	5	10	15	0	0	15	0	0
16	2722530	rs36087603	G	A	1	12	13	0	1	14	0	0
16	2734981	rs11077332	A	G	3	3	6	0	0	6	0	0
16	2736872	rs67187827	C	T	3	4	7	0	0	7	0	0
16	2809104	rs72768761	G	A	7	1	8	0	0	8	0	0
16	2810623	rs2285879	T	G	5	7	12	0	0	12	0	0
16	2812939	rs2240140	C	A	313	255	568	0	4	572	0	0
16	2819479	rs72768767	G	A	199	226	425	0	6	431	0	0
16	2819768	rs75646271	C	T	467	394	861	0	7	868	0	0
16	2821573	rs8017	C	T	25	24	49	0	0	49	0	0
16	2821763	rs1058855	C	G	23	19	42	0	0	42	0	0
16	2869684	rs11865057	A	C	70	52	122	0	1	123	0	0
16	2871121	rs11076844	T	C	292	418	710	0	4	714	0	0
16	2871555	rs10641	G	A	381	666	1047	0	7	1054	0	0
16	2872116	rs62035375	G	C	4	7	11	0	0	11	0	0
16	2872677	rs4786324	A	T	5	4	9	0	0	9	0	0
16	2873313	rs4786325	T	C	5	12	17	0	0	17	0	0
16	2874496	rs7190558	C	T	11	14	25	0	1	26	0	0
16	2874997	rs112704232	C	T	5	3	8	0	0	8	0	0
16	2876033	rs9921258	G	T	4	9	13	0	0	13	0	0
16	2880614	rs2190809	T	C	3	4	7	0	0	7	0	0
16	2880870	rs2240614	G	C	5	3	8	0	0	8	0	0
16	2880960	rs1860061	G	C	3	4	7	0	0	7	0	0
16	2881675	rs758189	G	A	6	3	9	0	0	9	0	0
16	2882197	rs12373	G	T	36	34	70	0	0	70	0	0
16	2882267	rs886953	G	C	2	8	10	0	0	10	0	0
16	2888797	rs917377	T	A	3	3	6	0	0	6	0	0
16	2945248	rs1063677	G	C	7	9	16	0	0	16	0	0
16	2949248	rs7281	T	C	22	17	39	0	4	43	0	0
16	2979640	rs11644380	T	C	12	9	21	0	0	21	0	0
16	2984244	rs72770836	C	G	11	5	16	0	0	16	0	0
16	2984254	rs72770838	T	G	11	6	17	0	0	17	0	0
16	2985684	rs17603568	G	A	4	28	32	0	0	32	0	0
16	2986158	rs4786356	T	C	3	13	16	0	0	16	0	0
16	2986323	rs9928222	T	C	14	29	43	0	0	43	0	0
16	2986431	rs739716	T	C	6	31	37	0	0	37	0	0
16	2987002	rs2074357	C	T	6	30	36	0	0	36	0	0
16	2989632	rs34960017	C	T	31	12	43	0	0	43	0	0
16	2989841	rs17136161	A	G	53	52	105	0	1	106	0	0
16	2990498	rs34779228	A	G	4	2	6	0	0	6	0	0
16	2993360	rs11561585	C	T	17	0	17	0	0	17	0	0
16	2993396	rs11536268	G	A	12	1	13	0	0	13	0	0
16	2993403	rs11561584	A	C	10	2	12	0	0	12	0	0
16	2998938	rs11552142	G	A	50	102	152	0	0	152	0	0
16	2999218	rs734138	C	T	47	89	136	0	0	136	0	0
16	2999298	rs757276	T	C	53	129	182	0	2	184	0	0
16	3001035	rs757277	G	A	7	5	12	0	0	12	0	0
16	3022261	rs7189958	C	T	20	11	31	0	0	31	0	0
16	3023605	rs886427	A	G	12	12	24	0	0	24	0	0
16	3024188	rs2074528	T	C	6	7	13	0	0	13	0	0
16	3027296	rs4149782	A	C	18	17	35	0	0	35	0	0
16	3075633	rs2526260	G	C	19	11	30	0	1	31	0	0
16	3075701	rs2717664	C	T	20	20	40	0	0	40	0	0
16	3075999	rs2245000	C	G	25	15	40	0	0	40	0	0
16	3101223	rs72772524	G	T	4	2	6	0	0	6	0	0
16	3102629	rs12596137	A	G	13	2	15	0	0	15	0	0
16	3103367	rs2717680	C	T	6	0	6	0	0	6	0	0
16	3104591	.	A	G	2	4	6	0	0	6	0	0
16	3106994	rs1064948	A	T	6	7	13	0	0	13	0	0
16	3107921	rs9924885	G	T	5	1	6	0	0	6	0	0
16	3109688	rs28602623	G	A	20	13	33	0	0	33	0	0
16	3128428	rs2179016	C	G	49	12	61	0	1	62	0	0
16	3136919	rs4786384	T	C	20	9	29	0	1	30	0	0
16	3136946	rs7196127	T	C	24	9	33	0	0	33	0	0
16	3181963	rs1053871	T	C	22	25	47	0	0	47	0	0
16	3181996	rs11649450	G	A	20	18	38	0	0	38	0	0
16	3182410	rs4786387	C	A	5	2	7	0	0	7	0	0
16	3183409	rs4785929	G	A	3	6	9	0	1	10	0	0
16	3191356	rs2735537	G	A	5	7	12	0	0	12	0	0
16	3192651	rs1053996	T	C	28	19	47	0	0	47	0	0
16	3192673	rs1053997	T	C	25	10	35	0	0	35	0	0
16	3192741	rs1053998	C	G	18	11	29	0	0	29	0	0
16	3207446	rs2717667	G	A	3	7	10	0	0	10	0	0
16	3336530	rs118162553	C	T	37	41	78	0	0	78	0	0
16	3432413	rs27229	C	T	54	63	117	0	1	118	0	0
16	3434027	rs17136367	G	C	11	8	19	0	0	19	0	0
16	3436687	rs27728	G	A	4	4	8	0	0	8	0	0
16	3455079	rs37813	T	C	6	8	14	0	0	14	0	0
16	3483475	rs1129568	G	A	33	0	33	0	0	33	0	0
16	3485983	.	G	A	6	0	6	0	1	7	0	0
16	3486285	rs12737	C	A	63	1	64	0	0	64	0	0
16	3490922	rs2270494	G	C	20	0	20	0	0	20	0	0
16	3589846	rs1124285	A	G	15	14	29	0	0	29	0	0
16	3727266	rs142538268	G	A	3	5	8	0	0	8	0	0
16	3728708	rs7203664	T	C	18	10	28	0	0	28	0	0
16	3775169	rs9392	G	A	7	7	14	0	0	14	0	0
16	3818107	rs546926602	C	T	9	1	10	0	0	10	0	0
16	4390914	rs142976385	C	A	5	4	9	0	0	9	0	0
16	4395241	rs611704	A	G	11	12	23	0	0	23	0	0
16	4403600	.	T	G	4	4	8	0	0	8	0	0
16	4433735	rs934889	A	G	39	38	77	0	1	78	0	0
16	4434646	rs112517060	G	A	37	28	65	0	0	65	0	0
16	4435163	rs62037617	G	C	13	16	29	0	0	29	0	0
16	4439958	rs76353695	G	T	3	3	6	0	0	6	0	0
16	4476089	rs1139652	T	C	7	8	15	0	1	16	0	0
16	4484396	rs1139653	A	T	9	6	15	0	1	16	0	0
16	4496973	rs2304633	T	A	10	17	27	0	1	28	0	0
16	4506232	rs4786494	G	A	9	8	17	0	0	17	0	0
16	4519548	rs62039231	A	G	9	7	16	0	0	16	0	0
16	4524443	rs2058812	C	G	8	11	19	0	0	19	0	0
16	4558615	rs2270366	G	A	2	5	7	0	0	7	0	0
16	4562351	rs8129	T	C	26	64	90	0	0	90	0	0
16	4562512	rs7665	A	G	35	68	103	0	2	105	0	0
16	4660196	rs2306770	G	C	24	20	44	0	0	44	0	0
16	4660247	rs863500	G	A	34	19	53	0	4	57	0	0
16	4660955	rs111795862	G	A	68	37	105	0	2	107	0	0
16	4661860	rs841185	T	G	61	45	106	0	0	106	0	0
16	4663805	rs841188	G	A	20	18	38	0	0	38	0	0
16	4674954	rs3747587	C	G	17	25	42	0	0	42	0	0
16	4718656	rs56308101	T	C	3	5	8	0	0	8	0	0
16	4719981	rs1659495	G	A	2	7	9	0	0	9	0	0
16	4720993	rs2278567	C	T	2	11	13	0	0	13	0	0
16	4721025	rs2278566	A	C	2	7	9	0	0	9	0	0
16	4727028	rs149252364	T	G	18	13	31	0	0	31	0	0
16	4731155	rs841229	G	A	3	9	12	0	0	12	0	0
16	4734513	rs841227	C	T	1	5	6	0	0	6	0	0
16	4737222	rs147585784	C	T	5	19	24	0	0	24	0	0
16	4737981	rs841223	G	A	7	21	28	0	0	28	0	0
16	4748825	rs841214	C	T	10	9	19	0	0	19	0	0
16	4801842	rs921864	G	A	6	3	9	0	0	9	0	0
16	4815602	rs12919587	T	C	8	8	16	0	1	17	0	0
16	4827783	rs72771909	G	A	18	14	32	0	2	34	0	0
16	4856244	rs562468436	G	T	6	11	17	0	0	17	0	0
16	4868236	rs56164846	T	C	8	3	11	0	0	11	0	0
16	4919710	rs1876354	T	C	4	3	7	0	0	7	0	0
16	4920098	rs45553841	C	A	9	8	17	0	0	17	0	0
16	5075226	rs1045693	G	A	26	49	75	0	0	75	0	0
16	5075248	rs15951	G	A	24	49	73	0	0	73	0	0
16	5075542	rs887854	G	A	36	20	56	0	1	57	0	0
16	5075633	rs7188856	G	A	25	27	52	0	0	52	0	0
16	5079417	rs2937110	C	T	3	5	8	0	0	8	0	0
16	8716906	rs117695817	C	T	9	6	15	0	0	15	0	0
16	8728999	rs151312932	G	A	6	5	11	0	0	11	0	0
16	8877591	rs9456	T	A	1	5	6	0	0	6	0	0
16	8889467	rs3760024	C	T	12	5	17	0	0	17	0	0
16	8889533	rs1864	T	C	12	8	20	0	0	20	0	0
16	8889628	rs12049	T	C	9	14	23	0	0	23	0	0
16	8896094	rs2304469	G	A	5	1	6	0	0	6	0	0
16	8908953	rs8057073	C	G	3	3	6	0	0	6	0	0
16	8932054	rs56327172	C	G	11	4	15	0	0	15	0	0
16	8932128	rs143920175	A	T	1	5	6	0	0	6	0	0
16	8941778	rs11554040	G	C	5	2	7	0	0	7	0	0
16	8944593	rs11647175	A	G	5	6	11	0	0	11	0	0
16	8944806	rs11647271	A	G	5	2	7	0	0	7	0	0
16	8944893	rs9939152	T	C	2	6	8	0	0	8	0	0
16	8944904	rs7187215	C	A	9	1	10	0	0	10	0	0
16	8945259	rs7192458	C	T	1	6	7	0	0	7	0	0
16	8945616	rs75437780	C	T	5	4	9	0	0	9	0	0
16	8945705	rs2053207	C	G	5	5	10	0	0	10	0	0
16	8946601	rs17680152	C	T	4	3	7	0	0	7	0	0
16	8947036	rs1058967	T	C	191	179	370	0	2	372	0	0
16	8947128	rs9953	G	T	170	161	331	0	0	331	0	0
16	8947251	rs1058929	T	C	135	151	286	0	1	287	0	0
16	8947282	rs1058927	T	C	112	130	242	0	3	245	0	0
16	8948433	rs3785172	C	T	18	22	40	0	1	41	0	0
16	8948437	rs3785173	C	T	17	19	36	0	1	37	0	0
16	8948445	rs117557663	C	T	8	15	23	0	0	23	0	0
16	8948473	rs2447924	A	C	9	4	13	0	0	13	0	0
16	8949455	rs11647985	T	A	5	6	11	0	0	11	0	0
16	8949474	rs4985055	G	A	7	4	11	0	0	11	0	0
16	8951323	.	A	G	7	2	9	0	0	12	3	0
16	8951392	rs7500728	G	C	10	1	11	0	0	11	0	0
16	8951620	.	T	A	9	1	10	0	1	11	0	0
16	8951714	rs2017185	G	A	6	5	11	0	0	11	0	0
16	8951920	rs7500138	C	T	6	8	14	0	1	15	0	0
16	8952113	rs62033507	C	A	9	6	15	0	0	15	0	0
16	8952117	rs4985008	C	T	6	8	14	0	1	15	0	0
16	8952524	rs3743802	A	G	25	13	38	0	0	38	0	0
16	8953737	rs3743804	G	A	4	2	6	0	0	6	0	0
16	8953944	rs2231704	G	C	12	3	15	0	0	15	0	0
16	8954058	rs34242778	C	A	6	5	11	0	0	11	0	0
16	8956076	rs11640388	G	C	5	4	9	0	0	9	0	0
16	8992342	rs2304465	G	A	3	6	9	0	0	9	0	0
16	8992552	rs2304464	T	C	9	7	16	0	1	17	0	0
16	8993892	rs2437726	T	A	19	12	31	0	1	32	0	0
16	10522831	rs117664487	A	G	5	9	14	0	0	14	0	0
16	10855341	rs2233539	C	T	8	10	18	0	0	18	0	0
16	10858802	rs62027826	C	T	14	11	25	0	0	25	0	0
16	10860579	rs3762185	G	C	6	3	9	0	0	9	0	0
16	10861914	rs2233541	T	C	3	3	6	0	0	6	0	0
16	10862231	rs8054049	A	C	6	0	6	0	0	6	0	0
16	10862707	rs9927431	C	T	11	10	21	0	0	21	0	0
16	10864435	rs1729064	C	A	0	8	8	0	0	8	0	0
16	10995852	.	C	T	13	20	33	0	0	33	0	0
16	11000848	rs4774	G	C	28	17	45	0	1	46	0	0
16	11001770	rs34654419	G	T	21	19	40	0	0	40	0	0
16	11002133	rs4781018	C	G	3	3	6	0	0	6	0	0
16	11002626	rs4780334	G	A	12	12	24	0	0	24	0	0
16	11002904	rs2228238	G	A	37	56	93	0	0	93	0	0
16	11009253	rs7500886	A	G	8	2	10	0	1	11	0	0
16	11009267	rs4781021	A	C	2	9	11	0	0	11	0	0
16	11012679	rs8056450	G	A	4	2	6	0	0	6	0	0
16	11017058	rs4781024	G	A	8	11	19	0	0	19	0	0
16	11018447	rs34538398	G	A	108	124	232	0	3	235	0	0
16	11020255	rs8052709	A	G	15	8	23	0	0	23	0	0
16	11021247	rs3205043	C	T	10	7	17	0	1	18	0	0
16	11030835	rs11639721	G	A	5	4	9	0	0	9	0	0
16	11031156	rs4780338	C	T	6	4	10	0	0	10	0	0
16	11031741	rs79748582	A	G	4	6	10	0	0	10	0	0
16	11036624	rs3087876	A	G	22	22	44	0	0	44	0	0
16	11044933	rs3813754	A	T	9	2	11	0	0	11	0	0
16	11148013	rs34083796	C	T	4	10	14	0	0	14	0	0
16	11150098	rs12924259	G	C	20	37	57	0	0	57	0	0
16	11150248	rs876476	G	A	33	34	67	0	0	67	0	0
16	11154770	rs2286973	G	A	4	3	7	0	0	7	0	0
16	11508311	rs9935550	T	C	3	3	6	0	0	6	0	0
16	11642242	rs7102	T	C	398	471	869	0	6	875	0	0
16	11647492	rs4280262	T	C	118	141	259	0	4	263	0	0
16	11650325	rs3743582	G	A	2	11	13	0	0	13	0	0
16	11764608	rs7189287	A	G	3	5	8	0	0	8	0	0
16	11764615	rs7194145	T	G	3	5	8	0	0	8	0	0
16	11765408	rs8191285	A	G	0	6	6	0	0	6	0	0
16	11765518	rs2868981	T	C	4	4	8	0	0	8	0	0
16	11765614	rs8191288	G	A	5	6	11	0	0	11	0	0
16	11768810	rs8049633	T	C	1	5	6	0	0	6	0	0
16	11769176	rs12921129	C	T	5	4	9	0	0	9	0	0
16	11769266	rs8045300	C	G	9	6	15	0	0	15	0	0
16	11769948	rs1050068	C	T	54	51	105	0	0	105	0	0
16	11769963	rs1050069	C	T	61	61	122	0	6	128	0	0
16	11770777	rs7194034	A	G	38	47	85	0	2	87	0	0
16	11771094	rs7198518	C	G	54	65	119	0	2	121	0	0
16	11771353	rs8191335	C	A	39	80	119	0	0	119	0	0
16	11771471	rs1050048	T	C	44	79	123	0	0	123	0	0
16	11771706	rs1050049	C	T	76	81	157	0	0	157	0	0
16	11773662	rs3190321	C	G	364	440	804	0	6	810	0	0
16	11773743	rs7188511	G	T	18	21	39	0	2	41	0	0
16	11773981	rs3784920	A	G	7	11	18	0	0	18	0	0
16	11774625	rs12929396	C	T	2	7	9	0	0	9	0	0
16	11774950	rs4781137	T	C	5	9	14	0	0	14	0	0
16	11784129	rs8059262	G	T	2	6	8	0	0	8	0	0
16	11792700	rs933574	A	C	9	9	18	0	1	19	0	0
16	11793395	rs933573	C	T	6	11	17	0	0	17	0	0
16	11794895	rs17606153	C	T	1	6	7	0	0	7	0	0
16	11796720	.	T	C	1	5	6	0	0	6	0	0
16	11798758	rs4584833	C	T	4	3	7	0	1	8	0	0
16	11798876	rs4255800	G	A	2	4	6	0	0	6	0	0
16	11800016	rs76815491	G	A	3	7	10	0	0	10	0	0
16	11815964	rs7205994	C	T	4	5	9	0	0	9	0	0
16	11820003	rs55934118	G	C	11	39	50	0	0	50	0	0
16	11820256	rs12929940	G	A	3	5	8	0	0	8	0	0
16	11821708	rs10492852	G	A	5	8	13	0	0	13	0	0
16	11822066	rs12599288	T	C	10	5	15	0	0	15	0	0
16	11824056	rs11639945	T	G	1	5	6	0	0	6	0	0
16	11836398	rs3743587	C	G	9	6	15	0	0	15	0	0
16	11844655	rs7090	C	A	31	32	63	0	0	63	0	0
16	11852354	rs8743	A	C	197	161	358	0	1	359	0	0
16	11852806	rs55744401	G	T	8	8	16	0	0	16	0	0
16	11853238	rs2072498	T	C	7	6	13	0	0	13	0	0
16	11854650	rs35309671	T	C	5	3	8	0	0	8	0	0
16	11856138	rs11861698	T	C	7	19	26	0	0	26	0	0
16	11868137	rs144120543	T	C	67	87	154	0	2	156	0	0
16	11873833	rs17234857	T	C	4	2	6	0	0	6	0	0
16	11874728	rs28554084	T	C	1	6	7	0	0	7	0	0
16	11882769	rs72782728	C	G	5	1	6	0	0	6	0	0
16	11929818	rs2098722	A	G	9	10	19	0	0	19	0	0
16	11929914	rs3971913	C	T	7	9	16	0	0	16	0	0
16	11930337	rs3743590	C	A	15	6	21	0	0	21	0	0
16	11933678	rs2075160	G	C	445	360	805	0	8	813	0	0
16	11940390	rs8052900	T	C	285	245	530	0	2	532	0	0
16	11963367	rs117726386	C	A	12	8	20	0	0	20	0	0
16	11965741	rs2051546	G	A	8	7	15	0	0	15	0	0
16	11976770	rs8062768	C	T	6	3	9	0	0	9	0	0
16	11992257	rs4781161	T	C	4	3	7	0	0	7	0	0
16	11997490	rs33629	G	A	1	6	7	0	0	7	0	0
16	12001447	rs7184515	G	C	15	8	23	0	0	23	0	0
16	12001772	rs13335494	G	A	10	11	21	0	1	22	0	0
16	12003035	rs4781162	C	T	3	7	10	0	0	10	0	0
16	12003948	rs7204312	C	G	3	4	7	0	0	7	0	0
16	12008513	rs33621	G	A	2	8	10	0	0	10	0	0
16	12009277	rs185937624	C	A	8	12	20	0	0	20	0	0
16	12663377	rs17223442	C	T	6	7	13	0	0	13	0	0
16	12663572	rs11645658	C	G	3	8	11	0	0	11	0	0
16	12663786	rs890895	G	C	4	6	10	0	0	10	0	0
16	12663993	rs11646569	G	T	4	6	10	0	0	10	0	0
16	12664090	rs11646611	G	A	7	3	10	0	0	10	0	0
16	12664681	rs56397350	G	A	3	7	10	0	0	10	0	0
16	12665175	rs3803603	T	C	10	10	20	0	0	20	0	0
16	12665244	rs3803604	G	T	8	12	20	0	1	21	0	0
16	12666103	rs3803606	G	C	12	9	21	0	0	21	0	0
16	12666200	rs117922914	G	A	9	11	20	0	0	20	0	0
16	12667334	rs11640862	G	C	13	9	22	0	0	22	0	0
16	12667789	rs9452	G	T	26	21	47	0	1	48	0	0
16	12897578	rs3748976	G	T	21	41	62	0	1	63	0	0
16	14030360	rs3136155	C	T	4	3	7	0	0	7	0	0
16	14031063	rs3136160	G	A	16	13	29	0	0	29	0	0
16	14045399	rs4781563	G	A	4	2	6	0	0	6	0	0
16	14264238	rs28448282	T	C	7	11	18	0	0	18	0	0
16	14700348	.	G	A	46	48	94	0	0	94	0	0
16	14769669	.	G	A	2	4	6	0	0	6	0	0
16	14973205	.	G	A	2	6	8	0	0	8	0	0
16	14988270	rs577724845	G	T	3	4	7	0	0	7	0	0
16	14988868	.	A	G	99	0	99	0	0	99	0	0
16	14989844	.	G	A	104	46	150	0	1	151	0	0
16	15010140	.	G	T	9	4	13	0	0	13	0	0
16	15012692	.	T	C	23	11	34	0	2	36	0	0
16	15016218	.	C	T	3	3	6	0	0	6	0	0
16	15019193	.	C	T	4	3	7	0	0	7	0	0
16	15022063	rs2665215	G	C	4	5	9	0	0	9	0	0
16	15022065	rs2665216	G	C	4	5	9	0	0	9	0	0
16	15022106	.	G	T	13	4	17	0	0	17	0	0
16	15034897	.	G	A	7	0	7	0	0	7	0	0
16	15069483	.	C	T	5	6	11	0	0	11	0	0
16	15106911	.	T	C	4	3	7	0	0	7	0	0
16	15116521	.	C	T	9	1	10	0	0	10	0	0
16	15117746	.	T	C	2	5	7	0	0	7	0	0
16	15121898	.	C	T	5	23	28	0	0	28	0	0
16	15122195	.	A	G	4	19	23	0	0	23	0	0
16	15123280	.	A	G	2	19	21	0	0	21	0	0
16	15127986	rs7192563	T	C	13	11	24	0	0	24	0	0
16	15129092	rs7404466	C	T	14	11	25	0	0	25	0	0
16	15129158	rs7404524	A	G	11	11	22	0	0	22	0	0
16	15129162	rs7404526	A	G	11	11	22	0	0	22	0	0
16	15129940	rs3198697	C	T	89	45	134	0	0	134	0	0
16	15162351	rs11075254	C	G	4	4	8	0	0	8	0	0
16	15164673	rs2966181	A	T	2	5	7	0	1	8	0	0
16	15166232	rs11075255	A	G	23	15	38	0	0	38	0	0
16	15166445	rs2941257	T	C	34	16	50	0	0	50	0	0
16	15167379	rs1510148	T	A	16	12	28	0	0	28	0	0
16	15167658	rs76759119	T	A	16	12	28	0	0	28	0	0
16	15177695	rs8060236	T	A	6	1	7	0	0	7	0	0
16	15177825	rs2941251	G	A	7	1	8	0	0	8	0	0
16	15179686	rs2966179	C	T	16	9	25	0	0	25	0	0
16	15198598	rs62039525	C	T	111	60	171	0	0	171	0	0
16	15204289	rs62039528	C	T	115	54	169	0	1	170	0	0
16	15219677	rs7404570	A	G	90	80	170	0	6	176	0	0
16	15220125	rs200841956	C	A	47	45	92	0	0	92	0	0
16	15220186	rs371530942	A	G	24	2	26	0	0	26	0	0
16	15220195	.	T	A	19	2	21	0	1	22	0	0
16	15220283	rs4012910	G	A	3	13	16	0	1	17	0	0
16	15220753	rs2941262	G	C	43	60	103	0	0	103	0	0
16	15220998	.	C	T	71	8	79	0	1	80	0	0
16	15221957	rs9923527	T	C	120	57	177	0	3	180	0	0
16	15227413	.	T	C	9	1	10	0	1	11	0	0
16	15228672	rs374267683	A	G	6	0	6	0	0	6	0	0
16	15229093	rs2519270	T	C	7	2	9	0	0	9	0	0
16	15229662	rs2905113	A	G	41	11	52	0	0	53	1	0
16	15503550	rs222913	T	C	4	8	12	0	0	12	0	0
16	16116556	rs17264736	G	T	4	10	14	0	0	14	0	0
16	16117271	rs152033	T	C	2	14	16	0	0	16	0	0
16	16147421	rs12920754	G	A	12	0	12	0	0	12	0	0
16	16197449	rs12926589	C	G	13	6	19	0	2	21	0	0
16	16197461	rs8046950	G	A	13	11	24	0	1	25	0	0
16	16199213	rs16967758	G	A	1	6	7	0	0	7	0	0
16	16199255	rs16967755	A	G	2	5	7	0	0	7	0	0
16	16236004	rs212090	T	A	108	78	186	0	4	190	0	0
16	16468294	.	C	T	72	87	159	0	0	159	0	0
16	16470333	.	G	T	0	29	29	0	0	29	0	0
16	16470401	.	T	C	2	17	19	0	0	19	0	0
16	17196433	rs1045885	G	C	26	27	53	0	0	53	0	0
16	17198524	rs9934313	C	A	16	27	43	0	2	45	0	0
16	17200116	rs56209014	C	T	16	16	32	0	0	32	0	0
16	17200673	rs11644173	A	G	12	25	37	0	1	38	0	0
16	17200830	rs11644229	A	G	14	22	36	0	0	36	0	0
16	17201196	rs11075338	A	G	15	24	39	0	0	39	0	0
16	17202097	rs73526133	G	A	12	16	28	0	0	28	0	0
16	17202801	rs34511974	G	A	12	18	30	0	1	31	0	0
16	17558034	rs62030329	A	G	6	3	9	0	0	9	0	0
16	17559379	rs35261971	G	A	3	6	9	0	1	10	0	0
16	17561732	rs62032190	T	C	2	5	7	0	0	7	0	0
16	17562895	rs56399325	C	A	7	5	12	0	1	13	0	0
16	17563658	rs4238650	T	C	1	9	10	0	0	10	0	0
16	17563912	rs7189553	G	A	2	6	8	0	0	8	0	0
16	17564311	rs61758388	C	A	17	11	28	0	2	30	0	0
16	18429714	.	A	G	0	8	8	0	1	9	0	0
16	18432952	.	C	A	4	8	12	0	0	12	0	0
16	18476337	rs62043983	G	A	2	6	8	0	0	8	0	0
16	18793829	.	G	T	3	3	6	0	0	6	0	0
16	18793857	.	C	A	4	2	6	0	0	6	0	0
16	18831882	rs76937745	T	C	3	4	7	0	0	7	0	0
16	19488383	rs13330677	A	G	3	5	8	0	0	8	0	0
16	19536933	rs80055487	C	T	4	5	9	0	0	9	0	0
16	19548461	rs62000395	C	T	31	10	41	0	0	41	0	0
16	19549382	rs75964070	A	C	3	3	6	0	0	6	0	0
16	19557928	rs140529793	C	T	6	3	9	0	0	9	0	0
16	19564287	rs17227624	T	A	39	38	77	0	1	78	0	0
16	19623956	rs8049073	A	T	8	6	14	0	0	14	0	0
16	19624011	rs8049383	C	A	7	6	13	0	0	13	0	0
16	19650714	rs77706575	G	A	6	3	9	0	0	9	0	0
16	19680546	rs957676	T	C	24	22	46	0	1	47	0	0
16	20634775	rs3087812	T	C	8	3	11	0	0	11	0	0
16	20638576	rs1692729	A	T	2	4	6	0	0	6	0	0
16	20696908	rs4783458	T	C	1	7	8	0	0	8	0	0
16	20697342	rs12928136	T	C	0	6	6	0	0	6	0	0
16	20728551	rs3848255	C	T	2	5	7	0	0	7	0	0
16	20729226	rs6497515	G	A	25	46	71	0	2	73	0	0
16	20730123	rs9940270	T	G	4	4	8	0	0	8	0	0
16	20734566	.	C	T	12	6	18	0	0	18	0	0
16	20744036	rs11646042	C	T	3	5	8	0	0	8	0	0
16	20745255	rs1058905	A	C	73	83	156	0	3	159	0	0
16	20745277	rs1058904	C	T	110	108	218	0	0	218	0	0
16	20745451	rs1058902	T	C	52	86	138	0	4	142	0	0
16	20746321	rs8044864	T	C	95	138	233	0	3	236	0	0
16	20749461	rs9788809	T	C	4	6	10	0	0	10	0	0
16	20750044	rs1466770	G	A	4	4	8	0	0	8	0	0
16	20750137	rs1466768	C	T	5	6	11	0	0	11	0	0
16	20751533	rs4783369	G	A	2	4	6	0	0	6	0	0
16	20757597	rs7188735	T	C	2	4	6	0	0	6	0	0
16	20765064	rs58149140	G	A	2	7	9	0	1	10	0	0
16	20799806	rs916932	T	G	2	4	6	0	0	6	0	0
16	20799807	rs916933	T	C	2	4	6	0	0	6	0	0
16	20808020	rs1059676	A	G	21	13	34	0	1	35	0	0
16	20810067	rs3213646	T	C	3	6	9	0	0	9	0	0
16	20811681	rs2301771	C	T	7	3	10	0	0	10	0	0
16	20855309	rs9929443	A	G	28	43	71	0	2	73	0	0
16	20857260	rs2269863	C	T	4	4	8	0	0	8	0	0
16	20860897	rs6654	C	T	49	66	115	0	1	116	0	0
16	20873767	rs7187522	T	G	9	9	18	0	0	18	0	0
16	20904590	rs9939849	G	T	9	9	18	0	0	18	0	0
16	20906057	rs9935342	T	C	9	6	15	0	0	15	0	0
16	21176916	rs13338482	C	T	3	4	7	0	0	7	0	0
16	21190092	rs8055894	G	A	4	2	6	0	0	6	0	0
16	21420079	.	G	A	11	16	27	0	0	27	0	0
16	21513228	.	G	A	15	11	26	0	0	26	0	0
16	21513372	.	T	C	15	8	23	0	1	24	0	0
16	21636830	rs74429610	G	A	8	4	12	0	0	12	0	0
16	21667490	.	A	G	12	0	12	0	2	14	0	0
16	22545897	.	G	T	42	54	96	0	5	101	0	0
16	23571716	.	G	T	2	5	7	0	0	7	0	0
16	23646857	rs45494092	A	G	10	5	15	0	0	15	0	0
16	24166130	rs432998	T	C	18	31	49	0	0	49	0	0
16	24202458	rs3729904	C	T	47	40	87	0	2	89	0	0
16	24231252	rs41278144	G	A	19	22	41	0	0	41	0	0
16	24801979	rs13336754	C	T	24	41	65	0	0	65	0	0
16	24957627	rs62032847	C	G	8	6	14	0	0	14	0	0
16	24958035	rs4787656	G	A	4	3	7	0	0	7	0	0
16	24959997	rs8062011	G	C	7	4	11	0	0	11	0	0
16	24967436	rs62032849	G	A	6	5	11	0	0	11	0	0
16	24967539	rs62032850	C	T	8	5	13	0	0	13	0	0
16	24968214	rs9936752	G	A	8	8	16	0	0	16	0	0
16	24968261	rs55920914	C	T	9	9	18	0	1	19	0	0
16	24968385	rs9936902	G	A	8	6	14	0	0	14	0	0
16	24969440	rs12446105	T	C	2	5	7	0	0	7	0	0
16	24970264	rs28500604	C	T	7	5	12	0	0	12	0	0
16	24970733	rs891122	T	C	4	3	7	0	0	7	0	0
16	24980189	rs12103073	G	A	10	7	17	0	0	17	0	0
16	24984822	rs7205696	G	A	4	6	10	0	0	10	0	0
16	25255503	.	G	C	5	7	12	0	0	12	0	0
16	27232433	rs9923178	T	C	4	5	9	0	0	9	0	0
16	27232780	rs34179621	T	A	4	8	12	0	0	12	0	0
16	27241608	rs34356479	T	C	3	3	6	0	0	6	0	0
16	27246617	rs17856580	T	C	29	25	54	0	0	54	0	0
16	27247479	rs12934276	A	G	7	4	11	0	0	11	0	0
16	27247661	rs12934078	T	A	2	4	6	0	0	6	0	0
16	27476332	rs118005982	C	T	9	9	18	0	1	19	0	0
16	27480797	rs61739285	C	T	87	89	176	0	0	176	0	0
16	27491505	rs118047593	G	A	6	6	12	0	0	12	0	0
16	27786106	rs117484464	G	A	18	14	32	0	0	32	0	0
16	27790276	rs16976984	G	A	37	19	56	0	2	58	0	0
16	28506428	rs151233	C	T	38	43	81	0	0	81	0	0
16	28602991	rs11401	A	G	92	75	167	0	1	168	0	0
16	28603012	rs3194168	A	G	86	59	145	0	0	145	0	0
16	28607196	rs10797300	G	A	5	7	12	0	0	12	0	0
16	28608356	rs11074908	C	T	3	7	10	0	0	10	0	0
16	28835900	rs12920514	G	A	8	8	16	0	0	16	0	0
16	28838018	rs117898009	T	C	36	14	50	0	1	51	0	0
16	28838073	rs12448482	A	G	36	14	50	0	0	50	0	0
16	28844068	rs7498491	T	A	18	12	30	0	0	30	0	0
16	28875738	rs75009327	G	A	13	5	18	0	0	18	0	0
16	28881001	rs11150623	G	T	6	7	13	0	0	13	0	0
16	28883327	rs28433345	T	C	9	7	16	0	0	16	0	0
16	28915433	rs2071342	A	C	5	6	11	0	0	11	0	0
16	28917746	rs62037412	G	A	6	3	9	0	0	9	0	0
16	28937275	rs4072401	G	A	4	3	7	0	0	7	0	0
16	28950051	rs34763945	G	A	3	4	7	0	0	7	0	0
16	28964716	rs62037423	A	G	5	3	8	0	0	8	0	0
16	28969480	rs9937676	A	G	14	12	26	0	1	27	0	0
16	28977713	rs1137843	T	C	61	62	123	0	3	126	0	0
16	28992000	rs4788113	G	A	19	30	49	0	0	49	0	0
16	28992646	rs3922668	G	A	55	50	105	0	1	106	0	0
16	28997997	rs1131543	G	A	80	48	128	0	0	128	0	0
16	29116957	rs35697633	C	T	8	3	11	0	0	11	0	0
16	29117596	rs1646142	C	T	7	1	8	0	0	8	0	0
16	29118865	rs7196973	G	A	4	3	7	0	0	7	0	0
16	29118975	rs7192443	C	T	5	4	9	0	0	9	0	0
16	29120520	rs1641995	C	T	4	4	8	0	0	8	0	0
16	29120839	.	G	A	6	8	14	0	0	14	0	0
16	29121113	rs4620996	C	T	7	8	15	0	0	15	0	0
16	29130953	rs60779366	G	A	3	5	8	0	0	8	0	0
16	29130999	rs12922496	C	T	3	4	7	0	0	7	0	0
16	29287496	rs7201797	G	A	4	2	6	0	0	6	0	0
16	29394552	.	G	T	33	11	44	0	1	45	0	0
16	29469934	.	C	T	20	20	40	0	1	41	0	0
16	29470113	.	T	G	23	10	33	0	0	33	0	0
16	29562570	.	C	A	16	0	16	0	0	16	0	0
16	29677841	rs11574558	T	A	17	19	36	0	2	38	0	0
16	29677843	rs11574559	T	A	16	21	37	0	1	38	0	0
16	29677845	rs11574560	T	A	14	22	36	0	1	37	0	0
16	29680389	rs12929333	A	C	24	28	52	0	1	54	1	0
16	29681707	rs62059023	G	A	81	38	119	0	1	120	0	0
16	29681734	rs62059024	C	T	77	44	121	0	0	121	0	0
16	29816047	.	G	A	147	169	316	0	11	327	0	0
16	29841225	rs4788186	A	G	4	6	10	0	0	10	0	0
16	29871730	rs35042042	G	A	5	3	8	0	0	8	0	0
16	29872361	rs3815822	G	A	4	5	9	0	0	9	0	0
16	29918034	rs1129700	T	C	61	86	147	0	1	148	0	0
16	29919792	rs8050576	A	G	3	5	8	0	0	8	0	0
16	29921211	rs4788189	C	T	6	0	6	0	0	6	0	0
16	29922011	rs12933766	C	T	3	7	10	0	1	11	0	0
16	29923510	rs4548895	G	A	6	1	7	0	0	7	0	0
16	29928115	rs11647753	A	G	3	4	7	0	0	7	0	0
16	29934819	rs11150574	C	T	7	0	7	0	0	7	0	0
16	29994398	rs55903157	C	T	50	43	93	0	1	94	0	0
16	30081049	rs148066566	C	T	19	31	50	0	1	51	0	0
16	30125840	rs7542	G	C	41	29	70	0	1	71	0	0
16	30194840	rs930392	A	G	7	2	9	0	0	9	0	0
16	30195791	rs72791248	C	T	62	36	98	0	4	102	0	0
16	30197475	rs188764775	C	G	428	319	747	0	5	752	0	0
16	30198151	rs1132812	A	G	936	703	1639	0	17	1656	0	0
16	30208527	.	C	T	8	3	11	0	0	11	0	0
16	30208637	.	A	G	11	1	12	0	0	12	0	0
16	30278907	.	A	G	8	4	12	0	0	12	0	0
16	30364071	rs11862806	A	G	45	55	100	0	1	101	0	0
16	30371655	rs11642676	C	G	5	6	11	0	0	11	0	0
16	30376486	rs8049108	T	C	62	78	140	0	1	141	0	0
16	30376959	rs11646130	T	C	11	15	26	0	0	26	0	0
16	30380486	rs4238961	T	C	15	17	32	0	1	33	0	0
16	30392099	rs4247355	A	G	17	10	27	0	0	27	0	0
16	30393660	rs4787643	G	A	24	23	47	0	0	47	0	0
16	30408765	rs12921440	C	T	12	9	21	0	0	21	0	0
16	30410445	rs4788413	C	T	30	20	50	0	2	52	0	0
16	30411382	rs3574	C	G	6	3	9	0	0	9	0	0
16	30679034	.	A	G	14	9	23	0	0	23	0	0
16	30783662	rs184864130	G	C	19	8	27	0	0	27	0	0
16	31282288	.	G	C	38	25	63	0	0	63	0	0
16	31375234	rs11574640	C	T	5	6	11	0	0	11	0	0
16	31382470	rs138137251	A	G	43	36	79	0	1	80	0	0
16	31393544	rs9929832	C	T	36	36	72	0	8	80	0	0
16	31394179	rs1140195	A	G	71	62	133	0	0	133	0	0
16	31460937	rs72789337	G	A	9	15	24	0	0	24	0	0
16	31461721	rs143816861	C	T	3	3	6	0	1	7	0	0
16	31462024	rs9934108	A	G	3	5	8	0	0	8	0	0
16	31473275	rs35923277	A	G	53	65	118	0	0	118	0	0
16	31476458	rs11150624	C	T	20	9	29	0	0	29	0	0
16	31488916	rs10596	C	G	12	10	22	0	0	22	0	0
16	31489033	rs13143	C	T	10	12	22	0	0	22	0	0
16	31720825	rs72798565	C	T	9	17	26	0	1	27	0	0
16	31726446	rs4889551	G	A	22	30	52	0	0	52	0	0
16	46644903	rs35313904	G	A	4	2	6	0	0	6	0	0
16	46695300	rs111681844	C	A	3	9	12	0	0	12	0	0
16	46728952	rs41187	A	C	7	10	17	0	0	17	0	0
16	46831180	rs36481	T	C	4	3	7	0	0	7	0	0
16	46998384	rs12925077	G	A	4	9	13	0	1	14	0	0
16	47285224	.	C	T	3	4	7	0	0	7	0	0
16	47496947	rs72800654	A	G	7	2	9	0	1	10	0	0
16	47591172	rs9797024	A	C	1	8	9	0	0	9	0	0
16	48314838	rs13331250	C	T	6	1	7	0	0	7	0	0
16	48377901	rs16946122	C	T	18	12	30	0	0	30	0	0
16	48378114	rs8055028	A	C	8	10	18	0	0	18	0	0
16	48380165	rs11076564	A	T	8	4	12	0	0	12	0	0
16	48380332	rs11076565	A	G	5	4	9	0	0	9	0	0
16	48385957	rs11552148	T	C	24	34	58	0	0	58	0	0
16	48386264	rs28515165	A	G	19	21	40	0	0	40	0	0
16	48394626	rs8190	C	T	49	39	88	0	0	88	0	0
16	48400979	rs9925772	G	A	10	5	15	0	0	15	0	0
16	48403588	rs75267077	G	A	6	6	12	0	0	12	0	0
16	48404295	rs8056846	C	T	3	4	7	0	0	7	0	0
16	48405108	rs7186777	G	C	4	3	7	0	0	7	0	0
16	48407186	rs28617382	T	C	3	3	6	0	0	6	0	0
16	48572817	rs1224	G	A	38	52	90	0	0	90	0	0
16	48573428	rs9941275	A	G	38	47	85	0	0	85	0	0
16	48574040	rs3743779	T	G	34	31	65	0	0	65	0	0
16	48574637	rs1039340	A	C	12	21	33	0	0	33	0	0
16	48574869	rs1039341	C	T	14	8	22	0	0	22	0	0
16	48575878	rs7197732	G	A	11	7	18	0	0	18	0	0
16	48577498	rs1039342	G	A	4	5	9	0	0	9	0	0
16	48577507	rs1039343	T	G	4	4	8	0	0	8	0	0
16	48577569	rs1039344	A	G	10	10	20	0	0	20	0	0
16	48577683	rs9937134	T	A	5	6	11	0	0	11	0	0
16	48578101	rs2047601	A	G	5	9	14	0	0	14	0	0
16	48588614	rs3785138	T	C	5	11	16	0	1	17	0	0
16	48589062	rs3826176	T	C	11	8	19	0	0	19	0	0
16	48589873	rs9921737	G	T	7	6	13	0	0	13	0	0
16	48589896	rs9921741	G	A	7	6	13	0	0	13	0	0
16	48591012	rs3826174	T	C	5	3	8	0	0	8	0	0
16	48592376	rs9939103	G	C	5	6	11	0	0	11	0	0
16	48593298	rs2354578	T	C	85	41	126	0	1	128	1	0
16	48593643	rs871903	A	C	57	49	106	0	0	106	0	0
16	48593779	rs871902	A	G	66	55	121	0	0	122	1	0
16	48594221	rs36077931	A	G	37	29	66	0	1	67	0	0
16	48594229	rs11645193	C	T	36	27	63	0	0	63	0	0
16	48644434	rs11640463	A	T	2	4	6	0	0	6	0	0
16	50059500	rs7194313	C	T	3	3	6	0	0	6	0	0
16	50060203	rs17213264	A	G	8	9	17	0	0	17	0	0
16	50067905	rs9302745	G	A	4	2	6	0	0	6	0	0
16	50068936	rs12709075	C	T	4	2	6	0	0	6	0	0
16	50069055	rs9927091	G	C	5	5	10	0	0	10	0	0
16	50069772	rs4640178	A	G	51	51	102	0	3	105	0	0
16	50139285	rs8052350	G	A	8	4	12	0	0	12	0	0
16	50139799	rs1558813	T	C	6	7	13	0	0	13	0	0
16	50224383	rs8057842	A	G	2	4	6	0	0	6	0	0
16	50308596	rs4277340	T	C	3	3	6	0	0	6	0	0
16	50335935	rs76857089	G	T	18	16	34	0	0	34	0	0
16	50335996	rs7193875	C	T	16	15	31	0	0	31	0	0
16	50336291	rs12445243	A	G	13	21	34	0	0	34	0	0
16	50340027	rs56342387	G	A	4	5	9	0	0	9	0	0
16	50341503	rs4785211	A	G	7	6	13	0	0	13	0	0
16	50343193	rs11649621	G	A	2	5	7	0	0	7	0	0
16	50348409	rs9926131	A	T	37	27	64	0	1	65	0	0
16	50348577	rs3813755	T	C	27	28	55	0	1	56	0	0
16	50350210	rs1872691	G	A	57	39	96	0	1	97	0	0
16	50351444	rs4785407	T	C	57	70	127	0	1	128	0	0
16	50351546	rs12918980	A	G	40	30	70	0	2	72	0	0
16	50353529	rs7195228	C	G	4	6	10	0	0	10	0	0
16	50353708	rs72786265	C	T	8	9	17	0	0	17	0	0
16	50353710	rs7196135	A	G	10	7	17	0	0	17	0	0
16	50371209	rs111428776	T	G	5	2	7	0	0	7	0	0
16	50371362	rs11639573	A	G	4	6	10	0	0	10	0	0
16	50371463	rs11644259	T	G	2	7	9	0	0	9	0	0
16	50371738	rs11644386	T	C	4	16	20	0	0	20	0	0
16	50376497	rs113128485	A	G	1	5	6	0	0	6	0	0
16	50378507	rs9930316	T	C	6	3	9	0	0	9	0	0
16	50378582	rs9930394	T	C	5	3	8	0	0	8	0	0
16	50382013	rs7404122	T	C	3	3	6	0	0	6	0	0
16	50715185	rs2066848	G	A	6	7	13	0	0	13	0	0
16	50733859	rs2067085	C	G	4	4	8	0	0	8	0	0
16	50766127	rs3135499	A	C	10	6	16	0	2	18	0	0
16	50766886	rs3135500	G	A	5	5	10	0	0	10	0	0
16	50816660	rs17314341	C	T	8	1	9	0	0	9	0	0
16	50819112	rs8047910	A	G	3	7	10	0	0	10	0	0
16	50819566	rs4027241	G	A	15	12	27	0	1	28	0	0
16	50819910	rs2111435	C	T	11	13	24	0	0	24	0	0
16	50820078	rs17314544	C	T	10	5	15	0	0	15	0	0
16	50820406	rs13337656	C	T	9	15	24	0	0	24	0	0
16	50822964	rs4785226	A	C	10	13	23	0	0	23	0	0
16	50827601	rs2302759	A	G	5	9	14	0	0	14	0	0
16	50829853	rs2160683	A	T	18	16	34	0	0	34	0	0
16	53165633	rs73590892	C	A	5	2	7	0	0	7	0	0
16	53166002	rs11075755	A	T	7	3	10	0	0	10	0	0
16	53170804	rs67673290	G	C	4	4	8	0	0	8	0	0
16	53171066	.	A	G	15	5	20	0	0	20	0	0
16	53171124	rs62047989	C	T	11	9	20	0	0	20	0	0
16	53283966	rs8052283	G	A	116	102	218	0	2	220	0	0
16	53284437	rs1558682	A	C	9	10	19	0	0	19	0	0
16	53284922	rs1477027	T	C	19	25	44	0	0	44	0	0
16	53285303	rs34855537	A	C	58	51	109	0	5	114	0	0
16	53285878	rs1345338	C	A	10	8	18	0	0	18	0	0
16	53326860	rs2287078	G	A	32	23	55	0	1	56	0	0
16	53352329	rs16952168	T	C	3	3	6	0	1	7	0	0
16	53358439	rs3743771	A	G	64	58	122	0	0	122	0	0
16	53362786	rs7203056	C	T	10	3	13	0	0	13	0	0
16	53501946	rs4281707	G	A	5	1	6	0	0	6	0	0
16	53503934	rs1131220	G	A	6	9	15	0	1	16	0	0
16	53503943	rs11540358	C	G	6	9	15	0	0	15	0	0
16	53504721	rs10748	T	C	30	26	56	0	2	58	0	0
16	53524308	rs3929	G	C	26	30	56	0	0	56	0	0
16	54073612	rs856982	C	T	4	3	7	0	0	7	0	0
16	54146715	rs184637142	G	A	10	10	20	0	0	20	0	0
16	55527113	rs2287074	G	A	4	6	10	0	0	10	0	0
16	55539614	rs7201	A	C	8	4	12	0	0	12	0	0
16	55543073	rs17302903	G	C	24	17	41	0	0	41	0	0
16	55543878	rs12930259	T	C	5	2	7	0	0	7	0	0
16	55558559	rs1558664	C	A	7	2	9	0	0	9	0	0
16	55558576	rs1558665	C	T	6	1	7	0	0	7	0	0
16	55560081	rs1370292	G	T	6	7	13	0	0	13	0	0
16	55561067	rs13336192	A	G	10	14	24	0	0	24	0	0
16	55561080	rs13337274	T	C	9	14	23	0	0	23	0	0
16	55561665	rs1898414	A	G	8	11	19	0	0	19	0	0
16	55562466	rs837550	G	A	208	177	385	0	0	385	0	0
16	55563016	rs9928922	G	A	59	37	96	0	1	97	0	0
16	55564010	rs9932429	C	A	12	7	19	0	0	19	0	0
16	55564408	rs837551	G	A	8	10	18	0	2	20	0	0
16	55564797	rs4402561	C	T	9	9	18	0	0	18	0	0
16	55565766	rs28373256	G	A	20	23	43	0	1	44	0	0
16	55617127	rs12934747	C	T	9	7	16	0	0	16	0	0
16	55617202	rs12933746	G	T	6	3	9	0	1	10	0	0
16	55618451	rs1393261	A	G	43	40	83	0	1	84	0	0
16	55619574	rs16955475	C	T	12	14	26	0	0	26	0	0
16	55620291	rs1044775	C	T	13	15	28	0	0	28	0	0
16	55739875	rs42879	T	C	7	0	7	0	0	7	0	0
16	56485251	rs75289223	G	T	5	2	7	0	1	8	0	0
16	56485554	rs11076155	C	G	30	20	50	0	0	50	0	0
16	56532606	rs118148062	C	G	4	5	9	0	0	9	0	0
16	56643343	rs10636	G	C	126	131	257	0	0	257	0	0
16	56660951	rs79628180	C	A	3	4	7	0	0	7	0	0
16	56966071	rs37024	T	G	22	22	44	0	0	44	0	0
16	56969148	rs2217332	G	A	56	58	114	0	1	115	0	0
16	56969683	rs39718	C	T	3	7	10	0	0	10	0	0
16	56974791	rs3903056	A	G	3	5	8	0	0	8	0	0
16	56975105	rs952440	A	G	6	4	10	0	1	11	0	0
16	56975277	rs952439	A	C	3	12	15	0	0	15	0	0
16	56975774	rs56129100	G	A	4	2	6	0	0	6	0	0
16	56975776	rs60906687	C	A	4	2	6	0	0	6	0	0
16	57026391	.	A	T	9	6	15	0	0	15	0	0
16	57056574	rs4784751	C	T	3	3	6	0	0	6	0	0
16	57056609	rs1651667	A	G	4	3	7	0	0	7	0	0
16	57060724	rs13339199	G	A	42	54	96	0	0	96	0	0
16	57071113	rs1684579	T	C	35	50	85	0	0	85	0	0
16	57089130	rs1167512	C	A	10	14	24	0	1	25	0	0
16	57090666	rs77142395	G	A	8	8	16	0	0	16	0	0
16	57090858	rs73546879	A	G	10	17	27	0	0	27	0	0
16	57113864	rs11639875	C	T	11	9	20	0	0	20	0	0
16	57113904	rs158484	A	T	8	7	15	0	1	16	0	0
16	57114924	rs154045	A	G	13	18	31	0	0	31	0	0
16	57114982	rs154044	C	T	15	16	31	0	0	31	0	0
16	57115274	rs154043	T	C	11	15	26	0	0	26	0	0
16	57116036	rs150348	A	C	3	4	7	0	0	7	0	0
16	57116287	rs27195	A	G	6	4	10	0	0	10	0	0
16	57116514	rs27194	T	A	113	117	230	0	2	232	0	0
16	57116819	rs43216	A	G	100	114	214	0	1	215	0	0
16	57117405	rs27193	C	T	64	45	109	0	1	110	0	0
16	57176967	rs111516170	C	G	3	4	7	0	0	7	0	0
16	57179676	rs111404026	C	T	10	9	19	0	0	19	0	0
16	57180717	rs2279406	G	T	2	4	6	0	0	6	0	0
16	57203488	rs79946090	G	A	4	5	9	0	0	9	0	0
16	57210814	rs182617516	C	T	11	4	15	0	0	15	0	0
16	57212650	rs767505	A	G	26	31	57	0	1	58	0	0
16	57213650	rs7203631	C	G	9	7	16	0	0	16	0	0
16	57213766	rs6499868	C	T	13	7	20	0	0	20	0	0
16	57216714	rs113010062	C	T	12	10	22	0	0	22	0	0
16	57218326	rs111731958	A	C	3	4	7	0	0	7	0	0
16	57219047	rs16967424	G	A	9	14	23	0	0	23	0	0
16	57219614	rs113153910	G	A	12	5	17	0	0	17	0	0
16	57220745	rs11076181	G	A	8	14	22	0	0	22	0	0
16	57235463	rs574682321	G	C	5	3	8	0	0	8	0	0
16	57235602	rs4503784	A	C	3	3	6	0	0	6	0	0
16	57235644	rs4330777	G	A	5	3	8	0	0	8	0	0
16	57238980	rs112725750	G	A	14	7	21	0	0	21	0	0
16	57274270	rs114775953	C	A	32	26	58	0	0	58	0	0
16	57281991	rs150588561	G	A	3	5	8	0	0	8	0	0
16	57282053	rs139584433	C	G	3	4	7	0	0	7	0	0
16	57286989	rs9843	G	A	124	114	238	0	3	241	0	0
16	57464236	rs170358	G	A	143	127	270	0	1	271	0	0
16	57466549	rs667380	C	T	4	4	8	0	0	8	0	0
16	57474971	rs588430	C	T	6	4	10	0	0	10	0	0
16	57476277	rs223849	A	T	2	4	6	0	0	6	0	0
16	57476434	rs223850	G	A	3	4	7	0	1	8	0	0
16	57477340	rs223853	G	A	3	3	6	0	0	6	0	0
16	57484980	rs223864	G	A	3	6	9	0	0	9	0	0
16	57494992	rs223869	C	A	39	43	82	0	0	82	0	0
16	57503213	rs601194	C	T	3	4	7	0	0	7	0	0
16	57503360	rs170365	C	T	5	4	9	0	0	9	0	0
16	57505313	rs149894172	T	C	150	133	283	0	1	284	0	0
16	57506915	rs223875	C	T	31	27	58	0	0	58	0	0
16	57507242	rs223876	C	G	39	45	84	0	1	85	0	0
16	57513539	rs62039360	G	A	13	14	27	0	0	27	0	0
16	57546450	rs9936078	A	G	24	19	43	0	1	44	0	0
16	57550331	rs74901418	C	T	17	15	32	0	1	33	0	0
16	57552088	rs28756858	T	C	12	18	30	0	0	30	0	0
16	57555076	rs28446687	C	T	12	15	27	0	1	28	0	0
16	57562220	rs12917875	T	C	4	4	8	0	0	8	0	0
16	57590811	rs12598786	T	C	3	3	6	0	1	7	0	0
16	57595999	rs1004363	A	G	8	6	14	0	0	14	0	0
16	57662632	rs28364782	C	G	11	8	19	0	0	19	0	0
16	57688327	.	C	A	2	4	6	0	0	6	0	0
16	57688936	rs1868681	A	C	4	2	6	0	0	6	0	0
16	57689028	rs7202126	C	T	3	4	7	0	0	7	0	0
16	57689385	rs1801257	C	G	12	12	24	0	0	24	0	0
16	57689805	rs1801255	A	C	15	16	31	0	0	31	0	0
16	57689883	rs1376041	T	C	22	13	35	0	0	35	0	0
16	57707249	rs73552781	C	T	163	146	309	0	1	310	0	0
16	57707832	rs7186179	G	A	6	6	12	0	0	12	0	0
16	57708151	rs8047307	C	T	2	5	7	0	0	7	0	0
16	57708297	rs4784841	T	C	4	4	8	0	0	8	0	0
16	57708416	rs8051879	C	T	11	13	24	0	0	24	0	0
16	57708642	rs4784003	T	G	10	5	15	0	1	16	0	0
16	57710077	rs72793600	G	A	7	10	17	0	0	17	0	0
16	57710093	rs12596635	C	G	10	6	16	0	0	16	0	0
16	57710539	rs66853547	G	T	6	3	9	0	0	9	0	0
16	57710579	rs4784843	T	C	5	5	10	0	0	10	0	0
16	57711563	rs736570	G	A	6	7	13	0	0	13	0	0
16	57713250	rs4238795	C	T	32	25	57	0	0	57	0	0
16	57713534	rs9925766	A	G	3	5	8	0	0	8	0	0
16	57713679	rs9935751	C	A	5	5	10	0	0	10	0	0
16	57713685	rs9925879	A	C	3	4	7	0	0	7	0	0
16	57714917	rs9928982	A	T	25	24	49	0	0	49	0	0
16	57716020	rs72795504	C	T	28	28	56	0	0	56	0	0
16	57716824	rs2006660	C	A	43	20	63	0	1	64	0	0
16	57716832	rs1814520	A	T	35	19	54	0	2	56	0	0
16	57716865	rs1814521	A	G	34	31	65	0	1	66	0	0
16	57716872	rs2006654	G	A	33	31	64	0	1	65	0	0
16	57718822	rs727215	A	C	11	10	21	0	0	21	0	0
16	57720563	rs1965227	T	C	18	16	34	0	0	34	0	0
16	57720695	rs183822274	T	C	18	14	32	0	0	32	0	0
16	57721127	rs2896940	G	T	19	11	30	0	2	32	0	0
16	57721146	rs1965229	G	A	21	10	31	0	0	31	0	0
16	57723077	rs1064326	G	A	595	499	1094	0	21	1115	0	0
16	57723179	rs1064327	G	A	329	262	591	0	2	593	0	0
16	57723197	rs1064328	A	G	305	226	531	0	4	535	0	0
16	57723239	rs1141417	A	G	216	170	386	0	0	386	0	0
16	57723249	rs1141418	T	C	167	138	305	0	0	305	0	0
16	57724532	rs9924013	T	A	3	3	6	0	0	6	0	0
16	57725231	rs4328432	G	A	4	3	7	0	0	7	0	0
16	57725826	rs4531722	C	G	2	12	14	0	0	14	0	0
16	57725967	rs4453481	T	C	1	9	10	0	0	10	0	0
16	57770466	rs2965777	A	G	21	10	31	0	2	33	0	0
16	57779798	rs34395261	T	A	4	3	7	0	0	7	0	0
16	57780380	rs13332223	C	T	2	4	6	0	0	6	0	0
16	57781616	rs2965796	G	A	3	3	6	0	0	6	0	0
16	57786517	rs2965797	C	T	11	6	17	0	0	17	0	0
16	57786711	rs2965798	C	T	63	66	129	0	4	133	0	0
16	57787027	rs12922275	C	T	69	78	147	0	1	148	0	0
16	57787362	.	C	T	68	82	150	0	7	157	0	0
16	57788352	rs2967123	G	C	3	4	7	0	1	8	0	0
16	57790161	rs34131744	G	T	10	14	24	0	1	25	0	0
16	57792688	rs71387192	G	A	169	157	326	0	3	329	0	0
16	57793146	rs71387193	T	C	6	4	10	0	0	10	0	0
16	57793351	rs35885527	T	C	5	5	10	0	0	10	0	0
16	57794888	rs2965799	A	T	6	2	8	0	1	9	0	0
16	57795343	rs12920931	G	A	93	78	171	0	4	175	0	0
16	57795394	rs2967172	G	A	98	86	184	0	1	185	0	0
16	57810090	rs2967162	C	T	4	3	7	0	0	7	0	0
16	57815137	rs34146657	G	A	3	3	6	0	0	6	0	0
16	57815489	rs4784858	C	T	2	4	6	0	0	6	0	0
16	57815870	rs12933672	G	A	3	4	7	0	0	7	0	0
16	57816109	rs12935285	C	A	5	5	10	0	0	10	0	0
16	57819118	rs71387195	G	A	4	3	7	0	0	7	0	0
16	57821503	rs2965780	C	T	2	6	8	0	0	8	0	0
16	57821875	rs12924788	T	C	6	2	8	0	0	8	0	0
16	57822267	rs1559404	G	A	4	2	6	0	0	6	0	0
16	57824801	rs2967118	G	A	13	15	28	0	1	29	0	0
16	57828404	rs34165478	G	A	9	1	10	0	0	10	0	0
16	57828410	rs9934509	T	C	5	4	9	0	0	9	0	0
16	58028860	rs9083	G	A	106	90	196	0	3	199	0	0
16	58030401	rs3743555	T	C	10	15	25	0	0	25	0	0
16	58030634	rs3743556	C	T	32	30	62	0	0	62	0	0
16	58035429	rs3743559	C	A	9	5	14	0	0	14	0	0
16	58045469	rs1986162	G	A	15	12	27	0	0	27	0	0
16	58047773	rs16959637	G	A	20	19	39	0	0	39	0	0
16	58051178	rs4784022	C	T	7	15	22	0	0	22	0	0
16	58054099	rs16959641	C	G	26	28	54	0	1	55	0	0
16	58054671	rs12930821	G	C	42	25	67	0	1	68	0	0
16	58054888	rs11551263	C	T	66	43	109	0	0	109	0	0
16	58080009	rs11076213	C	T	8	6	14	0	0	14	0	0
16	58194926	rs37358	C	T	181	140	321	0	1	322	0	0
16	58205110	rs75509729	C	T	7	7	14	0	0	14	0	0
16	58552921	rs3607	G	A	11	11	22	0	0	22	0	0
16	58552959	rs3169293	A	G	10	9	19	0	0	19	0	0
16	58553164	rs37035	A	C	2	6	8	0	0	8	0	0
16	58553777	rs3200575	G	A	4	12	16	0	0	16	0	0
16	58554141	rs7792	G	T	77	48	125	0	8	133	0	0
16	58554780	rs17821549	C	T	99	116	215	0	0	215	0	0
16	58573946	rs246195	C	T	6	2	8	0	0	8	0	0
16	58575489	rs11540994	G	A	40	22	62	0	2	64	0	0
16	58577421	rs41260	C	T	4	2	6	0	0	6	0	0
16	58587737	rs11866002	C	T	14	19	33	0	0	33	0	0
16	58592278	rs41445346	C	T	3	3	6	0	0	6	0	0
16	58616984	rs17854029	T	C	18	19	37	0	0	37	0	0
16	58652888	rs8053005	G	A	3	6	9	0	0	9	0	0
16	58653059	rs8054437	C	T	10	3	13	0	0	13	0	0
16	58653519	rs9302702	G	A	7	3	10	0	0	10	0	0
16	58653798	rs9940386	C	G	4	2	6	0	0	6	0	0
16	58653838	rs8058781	G	A	3	3	6	0	0	6	0	0
16	58656698	rs151811	C	A	8	3	11	0	0	11	0	0
16	58656866	rs8056834	C	A	8	2	10	0	0	10	0	0
16	58741367	rs6993	A	G	150	84	234	0	3	237	0	0
16	58742480	rs30843	G	A	3	5	8	0	0	8	0	0
16	58743454	rs30842	A	C	61	65	126	0	1	127	0	0
16	58750604	rs1058192	G	A	30	11	41	0	0	41	0	0
16	58757668	rs14221	A	C	36	31	67	0	0	67	0	0
16	58757683	rs257636	A	G	35	23	58	0	0	58	0	0
16	66501210	rs1820673	A	T	2	4	6	0	0	6	0	0
16	66599710	rs2232727	G	A	10	16	26	0	0	26	0	0
16	66643778	rs151239168	G	A	101	73	174	0	0	174	0	0
16	66646591	rs3743719	C	T	312	213	525	0	7	532	0	0
16	66757970	rs11862377	G	A	7	11	18	0	0	18	0	0
16	66758203	rs12600097	T	C	5	9	14	0	0	14	0	0
16	66759376	rs6499095	C	T	9	3	12	0	0	12	0	0
16	66759454	rs6499096	C	A	12	5	17	0	0	17	0	0
16	66759682	rs2305311	C	A	6	4	10	0	0	10	0	0
16	66764310	rs7188714	C	T	73	55	128	0	0	128	0	0
16	66764678	rs2068942	A	G	77	51	128	0	2	130	0	0
16	66765585	rs3785089	A	G	52	59	111	0	0	111	0	0
16	66765837	rs935760	G	C	59	40	99	0	0	99	0	0
16	66766913	rs8043912	C	T	35	26	61	0	0	61	0	0
16	66767459	rs9921999	C	T	24	21	45	0	0	45	0	0
16	66767632	rs9922030	A	T	30	19	49	0	0	49	0	0
16	66767796	rs9922207	A	G	21	25	46	0	1	47	0	0
16	66839222	rs7186114	T	A	3	3	6	0	0	6	0	0
16	66839294	rs7185235	G	A	3	3	6	0	0	6	0	0
16	66842195	rs363167	A	G	9	5	14	0	0	14	0	0
16	66843950	rs363206	C	A	5	7	12	0	0	12	0	0
16	67073552	rs11639620	A	G	7	2	9	0	0	9	0	0
16	67231876	.	C	G	8	8	16	0	0	16	0	0
16	67570756	.	T	A	4	3	7	0	0	7	0	0
16	67578396	rs1210978	C	T	13	16	29	0	0	29	0	0
16	67597203	rs74546615	C	T	4	3	7	0	0	7	0	0
16	67626194	rs8055358	G	A	3	4	7	0	0	7	0	0
16	67905880	rs142895455	C	T	4	3	7	0	0	7	0	0
16	67968769	.	G	C	197	218	415	0	1	416	0	0
16	67976320	rs4986970	A	T	29	27	56	0	0	56	0	0
16	67984104	rs143244172	G	A	13	5	18	0	0	18	0	0
16	68225515	rs12598	G	A	100	92	192	0	1	193	0	0
16	68387949	.	C	A	5	4	9	0	0	9	0	0
16	68387950	.	A	T	5	4	9	0	0	9	0	0
16	68573287	rs1170444	T	C	6	11	17	0	0	17	0	0
16	68573295	rs1170443	G	C	6	14	20	0	0	20	0	0
16	68573945	rs1182968	C	T	6	8	14	0	0	14	0	0
16	68574064	rs1170442	G	T	6	4	10	0	0	10	0	0
16	68598007	rs1177648	A	G	10	7	17	0	1	18	0	0
16	68598938	rs11648503	G	A	10	17	27	0	1	28	0	0
16	68599668	rs3087783	C	T	14	21	35	0	0	35	0	0
16	68600440	rs3203684	A	G	33	35	68	0	3	71	0	0
16	68600855	rs7118	G	T	53	66	119	0	1	120	0	0
16	69194031	rs9934139	A	T	5	5	10	0	0	10	0	0
16	69346752	rs9927130	A	G	4	6	10	0	0	10	0	0
16	69349779	rs35815622	A	T	1	5	6	0	0	6	0	0
16	69349785	rs11644691	T	C	1	6	7	0	0	7	0	0
16	69354963	rs1127231	A	G	108	147	255	0	3	258	0	0
16	69355636	rs36066565	G	A	40	51	91	0	2	93	0	0
16	69356695	rs11075714	A	G	2	5	7	0	0	7	0	0
16	69357309	rs9931701	T	C	5	4	9	0	0	9	0	0
16	69357681	rs9923260	C	T	4	2	6	0	0	6	0	0
16	69360265	rs35318292	G	T	32	24	56	0	0	56	0	0
16	69367385	rs9924894	T	G	2	6	8	0	0	8	0	0
16	69371927	rs12708897	A	G	4	6	10	0	0	10	0	0
16	69373414	rs11542583	T	C	7	3	10	0	0	10	0	0
16	69375658	rs8053850	G	A	34	50	84	0	1	85	0	0
16	69375841	rs8053896	C	T	25	25	50	0	0	50	0	0
16	69376269	rs11540992	G	A	60	48	108	0	1	109	0	0
16	69376686	rs1048818	C	T	34	23	57	0	0	57	0	0
16	69385641	rs76116020	A	G	7	1	8	0	0	8	0	0
16	69390642	rs12708898	G	A	14	7	21	0	0	21	0	0
16	69397393	rs153045	T	C	19	12	31	0	0	31	0	0
16	69398353	rs3743669	G	T	7	6	13	0	1	14	0	0
16	69400207	rs35124791	T	G	26	23	49	0	2	51	0	0
16	69402831	rs13330072	A	G	33	42	75	0	0	75	0	0
16	69403034	.	T	C	5	1	6	0	0	6	0	0
16	69404241	rs12325060	G	A	8	13	21	0	0	21	0	0
16	69406986	rs3785074	A	G	11	9	20	0	0	20	0	0
16	69409823	rs35808095	T	C	3	5	8	0	0	8	0	0
16	69413919	rs9938316	C	T	18	11	29	0	0	29	0	0
16	69497203	rs12149862	G	A	32	19	51	0	1	52	0	0
16	69605498	rs13338560	T	C	4	2	6	0	0	6	0	0
16	69611450	rs72801315	G	C	4	2	6	0	0	6	0	0
16	69643353	rs17297207	A	G	7	5	12	0	0	12	0	0
16	69644049	rs9936464	C	A	10	8	18	0	0	18	0	0
16	69672037	rs77616498	G	A	7	2	9	0	0	9	0	0
16	69721820	rs112608019	G	A	0	8	8	0	0	8	0	0
16	69730555	rs3826154	A	G	6	15	21	0	0	21	0	0
16	69733009	rs16959059	G	A	15	17	32	0	0	32	0	0
16	69733665	rs7359387	T	G	27	29	56	0	1	57	0	0
16	69733886	rs17298718	A	G	13	28	41	0	0	41	0	0
16	69737846	rs2965757	G	C	177	175	352	0	4	356	0	0
16	70023202	.	A	G	0	8	8	0	0	8	0	0
16	70023246	rs62051309	G	A	6	0	6	0	0	6	0	0
16	70164334	.	A	G	15	1	16	0	0	16	0	0
16	70168462	.	A	G	6	0	6	0	0	6	0	0
16	70191029	rs4985509	T	G	24	7	31	0	0	31	0	0
16	70191161	.	C	T	24	8	32	0	0	32	0	0
16	70191237	.	G	A	6	27	33	0	1	34	0	0
16	70191421	rs1055255	C	T	9	16	25	0	0	25	0	0
16	70191556	.	G	A	8	18	26	0	0	26	0	0
16	70192013	rs12448586	C	T	30	13	43	0	0	43	0	0
16	70193405	.	G	A	32	19	51	0	0	51	0	0
16	70193486	rs3811354	G	A	24	37	61	0	0	61	0	0
16	70193614	.	C	T	29	18	47	0	0	47	0	0
16	70194664	rs62051658	G	A	58	29	87	0	0	87	0	0
16	70195967	rs1044867	T	G	107	53	160	0	1	161	0	0
16	70196184	rs7269	A	G	146	80	226	0	0	226	0	0
16	70608772	.	T	C	3	3	6	0	0	6	0	0
16	70695396	.	C	T	216	167	383	0	3	386	0	0
16	70696367	rs3752785	C	T	194	161	355	0	8	363	0	0
16	70724001	rs11648765	G	T	5	3	8	0	0	8	0	0
16	70733138	rs4985563	G	A	6	3	9	0	0	9	0	0
16	71679027	rs11670	G	T	14	11	25	0	0	25	0	0
16	71681153	rs10500560	G	A	6	2	8	0	0	8	0	0
16	71682796	rs61733125	T	C	2	4	6	0	0	6	0	0
16	71763779	rs76621365	C	A	286	279	565	0	5	570	0	0
16	71765468	.	G	A	82	94	176	0	3	179	0	0
16	71773190	rs904763	G	T	134	114	248	0	0	248	0	0
16	71775396	rs77707060	G	A	5	6	11	0	0	11	0	0
16	71781102	rs11859903	C	T	9	20	29	0	0	29	0	0
16	71784348	rs149580087	C	T	11	4	15	0	0	15	0	0
16	71786994	rs77832972	G	A	3	3	6	0	0	6	0	0
16	71807232	rs113235758	C	A	45	46	91	0	1	92	0	0
16	71811374	rs78686396	G	C	4	2	6	0	0	6	0	0
16	71828616	rs77823468	C	T	13	12	25	0	0	25	0	0
16	71829329	rs34998650	T	C	4	6	10	0	0	10	0	0
16	71886530	rs7184486	T	A	60	54	114	0	0	114	0	0
16	71887381	rs16973477	A	G	36	41	77	0	2	79	0	0
16	71889173	rs6499545	C	T	84	108	192	0	1	193	0	0
16	71897244	rs1981874	T	C	5	8	13	0	0	13	0	0
16	71897399	rs7193731	T	C	6	8	14	0	0	14	0	0
16	71897926	rs2335714	T	C	2	5	7	0	0	7	0	0
16	71902142	rs2288031	C	A	8	7	15	0	0	15	0	0
16	71904291	rs2335713	T	C	1	6	7	0	0	7	0	0
16	71950450	rs1049794	C	T	289	292	581	0	4	585	0	0
16	71951845	rs4788579	A	C	7	12	19	0	0	19	0	0
16	71952354	rs28697038	G	C	3	4	7	0	1	8	0	0
16	71952614	rs11649672	G	C	3	4	7	0	0	7	0	0
16	71955085	rs72801786	C	T	22	17	39	0	0	39	0	0
16	71955400	rs4788450	T	G	32	14	46	0	0	46	0	0
16	71958025	rs74891946	C	G	267	210	477	0	4	481	0	0
16	71959727	rs12444829	A	G	11	11	22	0	0	22	0	0
16	71959733	rs8058118	T	C	13	11	24	0	0	24	0	0
16	71959748	rs72801789	C	T	13	10	23	0	0	23	0	0
16	71961246	rs140803283	G	C	9	9	18	0	0	18	0	0
16	71961339	rs3794692	T	C	9	11	20	0	0	20	0	0
16	71962591	rs6558	G	C	812	754	1566	0	8	1574	0	0
16	71962866	rs186320289	A	G	191	160	351	0	5	356	0	0
16	72119812	rs9930890	A	G	7	9	16	0	1	17	0	0
16	72121954	rs8058608	A	G	2	7	9	0	0	9	0	0
16	72121956	rs8058609	A	G	2	7	9	0	0	9	0	0
16	72122143	rs8059378	G	A	2	9	11	0	0	11	0	0
16	72122463	rs10492813	C	T	4	2	6	0	0	6	0	0
16	72122706	rs12708925	A	T	4	2	6	0	1	7	0	0
16	72122765	rs12932845	G	A	5	6	11	0	0	11	0	0
16	72128207	rs7194668	G	C	5	4	9	0	0	9	0	0
16	72128299	rs7194397	C	T	5	1	6	0	0	6	0	0
16	72130203	rs1050361	C	G	101	90	191	0	1	192	0	0
16	72130815	rs1050362	C	A	84	114	198	0	1	199	0	0
16	72135014	rs1050363	T	C	69	79	148	0	1	149	0	0
16	72137561	rs2240243	G	A	76	87	163	0	0	163	0	0
16	72138112	rs12325142	G	T	51	45	96	0	0	96	0	0
16	72139184	rs2074626	C	A	107	120	227	0	2	229	0	0
16	72140338	.	A	G	5	2	7	0	0	7	0	0
16	72140553	rs2287997	G	A	3	4	7	0	0	7	0	0
16	72142895	rs9926156	G	C	9	7	16	0	0	16	0	0
16	72144284	rs2241412	A	G	5	6	11	0	0	11	0	0
16	72144493	rs2241411	T	C	6	11	17	0	0	17	0	0
16	72146441	rs7940	C	G	278	219	497	0	1	498	0	0
16	72146570	rs6680	T	C	297	332	629	0	4	633	0	0
16	72156000	rs4788461	C	A	5	1	6	0	0	6	0	0
16	72156063	rs8061459	C	T	6	1	7	0	0	7	0	0
16	72156842	rs16973716	T	G	1	5	6	0	0	6	0	0
16	72827758	rs699444	T	C	5	3	8	0	0	8	0	0
16	74332052	rs113156784	T	C	8	2	10	0	0	10	0	0
16	74333380	rs889641	T	C	7	7	14	0	0	14	0	0
16	74333737	rs12325102	T	C	12	4	16	0	0	16	0	0
16	74337036	rs1195629	G	A	7	9	16	0	0	16	0	0
16	74337104	rs17336867	G	C	4	6	10	0	0	10	0	0
16	74360317	rs9924947	C	T	1	6	7	0	0	7	0	0
16	74360410	rs4888212	G	C	2	9	11	0	0	11	0	0
16	74362175	rs12445671	C	T	1	6	7	0	0	7	0	0
16	74365283	rs9929478	A	G	0	10	10	0	1	11	0	0
16	74365290	rs11648396	G	A	0	13	13	0	0	13	0	0
16	74395902	rs2549282	G	C	5	1	6	0	0	6	0	0
16	74396147	.	T	C	2	4	6	0	0	6	0	0
16	74396285	rs2549285	C	A	2	5	7	0	0	7	0	0
16	74398007	.	A	C	4	2	6	0	0	6	0	0
16	74398044	.	T	C	4	5	9	0	0	9	0	0
16	74398105	.	A	G	4	5	9	0	1	10	0	0
16	74398135	.	T	C	5	6	11	0	0	11	0	0
16	74398219	.	A	T	3	3	6	0	0	6	0	0
16	74398250	.	A	G	5	3	8	0	0	8	0	0
16	74398286	.	T	A	6	1	7	0	0	7	0	0
16	74398291	.	T	A	6	1	7	0	0	7	0	0
16	74398619	.	A	C	4	2	6	0	0	6	0	0
16	74398651	.	A	G	6	1	7	0	0	7	0	0
16	74398820	rs11643683	A	C	4	5	9	0	0	9	0	0
16	74399223	.	G	A	5	1	6	0	0	6	0	0
16	74400726	.	G	A	5	4	9	0	0	9	0	0
16	74425299	.	C	T	8	0	8	0	0	8	0	0
16	74442881	.	C	G	6	0	6	0	0	6	0	0
16	74447916	.	G	A	0	7	7	0	0	7	0	0
16	74497633	rs76911802	G	T	6	5	11	0	0	11	0	0
16	74497911	rs10500587	A	G	2	4	6	0	0	6	0	0
16	74498307	rs3785312	T	A	4	6	10	0	0	10	0	0
16	74498398	rs3826239	C	T	5	3	8	0	0	8	0	0
16	74499589	rs2303275	G	A	16	16	32	0	0	32	0	0
16	74504843	rs12447531	C	T	0	6	6	0	0	6	0	0
16	74506765	rs8059869	G	C	12	8	20	0	0	20	0	0
16	74537591	rs4887772	C	T	11	13	24	0	0	24	0	0
16	74655634	rs1138860	G	C	385	158	543	0	0	543	0	0
16	74655652	rs11859900	C	T	365	183	548	0	2	550	0	0
16	74655848	rs7185722	G	A	282	232	514	0	3	517	0	0
16	74657421	rs7204804	T	C	147	102	249	0	1	250	0	0
16	74692426	rs4462623	C	T	7	7	14	0	0	14	0	0
16	74692453	rs4243108	C	T	6	7	13	0	0	13	0	0
16	74695079	rs8058922	G	T	66	75	141	0	4	145	0	0
16	74697238	rs79333582	T	C	8	9	17	0	0	17	0	0
16	74697421	rs8055784	C	T	7	4	11	0	0	11	0	0
16	74697672	rs76327540	A	T	4	3	7	0	0	7	0	0
16	74698576	rs4888270	A	G	20	7	27	0	0	27	0	0
16	74705961	rs8998	T	C	105	112	217	0	2	219	0	0
16	74706349	rs9783779	T	C	62	63	125	0	0	125	0	0
16	74710728	rs7196369	T	C	3	4	7	0	0	7	0	0
16	74713054	rs6564159	A	G	3	5	8	0	0	8	0	0
16	74943928	rs12324959	C	A	4	5	9	0	0	9	0	0
16	74944085	rs11149784	C	T	3	3	6	0	0	6	0	0
16	74944135	rs12324946	G	A	5	5	10	0	0	10	0	0
16	74944162	rs12918550	G	A	6	4	10	0	0	10	0	0
16	74944573	rs1469130	C	T	4	10	14	0	0	14	0	0
16	74945394	rs713257	G	C	6	9	15	0	0	15	0	0
16	75053910	rs35771859	G	A	4	5	9	0	0	9	0	0
16	75144265	rs15819	A	C	20	41	61	0	0	61	0	0
16	75607254	rs34981527	C	T	6	6	12	0	0	12	0	0
16	75667243	rs34838148	C	A	25	34	59	0	0	59	0	0
16	75676669	rs187106611	G	C	5	10	15	0	0	15	0	0
16	75676670	rs3784931	C	T	5	10	15	0	0	15	0	0
16	75677422	rs34084576	C	T	5	8	13	0	0	13	0	0
16	77224889	rs2232498	G	T	5	8	13	0	0	13	0	0
16	77227831	rs3743760	G	T	6	4	10	0	0	10	0	0
16	77227965	rs3743763	G	A	13	14	27	0	0	27	0	0
16	77228971	rs2232506	C	T	33	35	68	0	0	68	0	0
16	77233338	rs8398	C	T	42	77	119	0	0	119	0	0
16	77234004	rs9925950	G	A	5	14	19	0	0	19	0	0
16	77234210	rs2161716	G	A	3	3	6	0	1	7	0	0
16	77236264	rs1129680	C	A	12	10	22	0	0	22	0	0
16	77239656	rs68005990	T	C	2	4	6	0	0	6	0	0
16	77241407	rs7188097	A	T	5	2	7	0	0	7	0	0
16	77241552	rs57007576	G	T	16	2	18	0	0	18	0	0
16	77241610	rs61267588	A	G	0	7	7	0	0	7	0	0
16	77242558	rs2343036	T	C	2	5	7	0	0	7	0	0
16	77244837	rs4887896	T	C	3	3	6	0	0	6	0	0
16	77245239	rs746036	C	T	5	5	10	0	0	10	0	0
16	77245865	rs755255	G	C	5	2	7	0	0	7	0	0
16	77246795	rs2278049	C	G	33	17	50	0	0	50	0	0
16	77246847	rs2278048	T	G	25	10	35	0	0	35	0	0
16	78133671	rs11545028	C	T	19	21	40	0	0	40	0	0
16	78420775	rs11545029	G	A	5	4	9	0	0	9	0	0
16	78466437	rs3764340	C	G	8	3	11	0	2	13	0	0
16	80636220	rs12932528	A	T	25	20	45	0	0	45	0	0
16	80636297	rs33943240	C	G	25	9	34	0	1	35	0	0
16	80636812	.	A	C	21	12	33	0	0	33	0	0
16	80636940	rs74028318	G	A	15	9	24	0	0	24	0	0
16	80637015	rs8063688	A	G	9	5	14	0	0	14	0	0
16	80638237	rs141544334	G	A	22	32	54	0	0	54	0	0
16	80650805	rs13329835	A	G	3	4	7	0	0	7	0	0
16	80651109	rs17750740	T	C	9	7	16	0	0	16	0	0
16	80651180	rs879843	A	G	9	6	15	0	0	15	0	0
16	80651660	rs873994	T	C	6	8	14	0	0	14	0	0
16	80651932	rs2167671	A	G	4	2	6	0	0	6	0	0
16	80652246	rs11645914	G	C	2	5	7	0	0	7	0	0
16	80687642	rs9930141	G	A	4	3	7	0	0	7	0	0
16	80688157	rs4889190	T	C	7	8	15	0	0	15	0	0
16	80689126	rs8048112	G	C	4	4	8	0	0	8	0	0
16	80718879	rs8049284	A	G	19	11	30	0	0	30	0	0
16	81063537	rs7199631	C	T	6	1	7	0	0	7	0	0
16	81484570	rs9926618	T	A	3	7	10	0	1	11	0	0
16	81504477	rs2966122	G	A	3	5	8	0	0	8	0	0
16	81506098	rs2966123	C	G	13	6	19	0	0	19	0	0
16	81507033	rs2927335	T	C	8	11	19	0	0	19	0	0
16	81507778	rs880795	C	T	20	13	33	0	0	33	0	0
16	81508461	rs9935704	T	G	7	1	8	0	1	9	0	0
16	81509279	rs2927333	A	G	2	8	10	0	0	10	0	0
16	81509692	rs55873299	A	C	4	4	8	0	0	8	0	0
16	81509722	rs2927328	T	C	5	4	9	0	0	9	0	0
16	81510046	rs2925999	T	C	8	21	29	0	0	29	0	0
16	81510071	rs9925828	G	A	10	24	34	0	0	34	0	0
16	81510523	rs55651404	G	C	5	3	8	0	0	8	0	0
16	81510699	rs1471379	T	C	4	5	9	0	0	9	0	0
16	81510836	rs1471378	C	G	3	3	6	0	0	6	0	0
16	81511079	rs1966957	G	C	2	5	7	0	0	7	0	0
16	81511398	rs77819820	A	G	2	5	7	0	0	7	0	0
16	81511534	rs2927327	T	A	3	3	6	0	0	6	0	0
16	81511806	rs2966079	C	T	3	3	6	0	0	6	0	0
16	81511987	rs2927325	C	A	8	6	14	0	2	16	0	0
16	81512636	rs1471152	T	G	7	9	16	0	2	18	0	0
16	81512821	rs2927324	C	T	7	11	18	0	0	18	0	0
16	81512948	rs2927323	G	A	5	4	9	0	0	9	0	0
16	81513620	rs2966080	A	T	3	3	6	0	0	6	0	0
16	81515722	rs2966083	G	T	3	5	8	0	0	8	0	0
16	81516228	rs7187136	C	T	3	3	6	0	0	6	0	0
16	81516383	rs2966084	A	G	4	2	6	0	0	6	0	0
16	81516634	rs2966085	A	G	5	3	8	0	0	8	0	0
16	81516858	rs2966086	T	C	8	8	16	0	0	16	0	0
16	81517119	rs16955433	C	T	6	4	10	0	0	10	0	0
16	81517204	rs2926001	T	C	7	5	12	0	0	12	0	0
16	81663793	rs7184768	G	A	16	9	25	0	0	25	0	0
16	81704756	rs74031234	C	G	1	6	7	0	0	7	0	0
16	81741284	rs2052589	G	C	5	1	6	0	0	6	0	0
16	81745097	rs1128432	T	C	54	72	126	0	0	126	0	0
16	81745267	rs111429817	C	T	12	12	24	0	0	24	0	0
16	81888152	rs1143686	A	G	7	4	11	0	1	12	0	0
16	81929527	rs13333716	C	G	17	9	26	0	0	26	0	0
16	81941319	rs1143689	C	T	11	8	19	0	0	19	0	0
16	81970353	rs16956011	G	A	3	3	6	0	0	6	0	0
16	81970366	rs3934955	A	C	3	3	6	0	0	6	0	0
16	81971403	rs1071644	T	C	25	26	51	0	0	51	0	0
16	81995543	rs12149470	G	T	19	21	40	0	0	40	0	0
16	83846041	rs11558776	A	G	105	116	221	0	1	222	0	0
16	83846198	rs4522	G	A	122	114	236	0	2	238	0	0
16	83999261	rs35132222	C	A	6	4	10	0	0	10	0	0
16	84088047	rs11607	C	T	121	121	242	0	5	247	0	0
16	84088268	rs74035120	G	C	15	33	48	0	1	49	0	0
16	84088517	rs3785009	T	C	16	29	45	0	0	45	0	0
16	84089207	rs6563996	G	T	17	29	46	0	1	47	0	0
16	84089445	rs7199441	C	T	6	28	34	0	1	35	0	0
16	84089767	rs17849043	C	T	35	24	59	0	2	62	1	0
16	84091104	rs3785013	A	G	15	14	29	0	0	29	0	0
16	84091169	rs3785015	G	A	19	12	31	0	1	32	0	0
16	84093062	rs2280024	G	A	24	18	42	0	2	44	0	0
16	84093453	rs4782887	T	C	21	27	48	0	0	48	0	0
16	84093931	rs3785017	A	G	17	16	33	0	0	33	0	0
16	84095254	rs999781	G	C	24	26	50	0	0	50	0	0
16	84095451	rs3826138	C	G	24	26	50	0	0	50	0	0
16	84095794	rs3759973	C	T	12	9	21	0	0	21	0	0
16	84096577	rs883635	A	G	19	43	62	0	0	62	0	0
16	84099634	rs78698482	T	C	2	5	7	0	0	7	0	0
16	84100552	rs10445049	T	C	5	2	7	0	0	7	0	0
16	84100602	rs12921209	T	G	2	5	7	0	0	7	0	0
16	84115483	rs3743631	G	A	52	39	91	0	0	91	0	0
16	84115610	rs3743633	G	A	2	5	7	0	0	7	0	0
16	84120291	rs17726231	G	A	18	17	35	0	1	36	0	0
16	84120656	rs2875857	A	C	14	7	21	0	0	21	0	0
16	84120718	rs8063994	G	A	6	5	11	0	0	11	0	0
16	84125629	rs2292321	G	C	2	4	6	0	0	6	0	0
16	84135453	rs1049884	A	T	35	38	73	0	0	73	0	0
16	84135515	rs11550471	C	T	34	32	66	0	0	66	0	0
16	84156755	rs3817155	G	A	9	8	17	0	0	17	0	0
16	84209815	rs2288021	C	G	18	15	33	0	0	33	0	0
16	84360533	rs12933084	A	G	5	3	8	0	0	8	0	0
16	84474484	rs2303853	G	A	5	5	10	0	0	10	0	0
16	84494275	rs2241640	C	T	8	8	16	0	0	16	0	0
16	84599970	rs13521	C	T	640	803	1443	0	8	1451	0	0
16	84600271	rs1046623	A	G	573	364	937	0	11	948	0	0
16	84600347	rs247860	T	C	506	652	1158	0	8	1167	1	0
16	84622041	rs73255567	A	G	4	2	6	0	0	6	0	0
16	84649932	rs2967868	A	C	170	69	239	0	3	242	0	0
16	84650174	rs2914845	G	C	25	7	32	0	0	32	0	0
16	84650527	rs2966305	C	T	13	7	20	0	0	20	0	0
16	84691044	rs3751762	C	T	22	20	42	0	0	42	0	0
16	84691823	rs12444911	C	T	15	15	30	0	0	30	0	0
16	84692572	rs12445708	C	T	27	15	42	0	0	42	0	0
16	84692765	rs34499035	G	A	22	25	47	0	0	47	0	0
16	84693084	rs11149671	A	G	33	42	75	0	0	75	0	0
16	84693099	rs11149672	G	C	36	43	79	0	0	79	0	0
16	84693149	rs67118461	G	A	37	35	72	0	0	72	0	0
16	84693205	rs117768539	A	G	34	28	62	0	0	62	0	0
16	84693675	rs2303230	C	T	7	4	11	0	0	11	0	0
16	84694718	rs4782649	T	C	6	0	6	0	0	6	0	0
16	84695126	rs12924673	G	A	4	5	9	0	0	9	0	0
16	84695280	rs17755815	A	G	70	74	144	0	2	146	0	0
16	84695490	rs12928590	C	T	49	50	99	0	2	102	1	0
16	84695864	rs3087669	C	A	22	17	39	0	0	39	0	0
16	84696052	rs17755862	A	T	8	3	11	0	0	11	0	0
16	84696102	rs35172224	C	T	8	3	11	0	0	11	0	0
16	84696116	rs35739726	C	T	7	3	10	0	0	10	0	0
16	84697148	rs12934624	C	T	6	5	11	0	1	12	0	0
16	84697439	rs12920360	A	T	5	4	9	0	0	9	0	0
16	84697796	rs3803624	C	T	5	2	7	0	0	7	0	0
16	84697888	rs11555907	C	T	11	9	20	0	0	20	0	0
16	84698346	rs7186755	G	A	7	3	10	0	1	11	0	0
16	84698394	rs881583	C	G	11	5	16	0	0	16	0	0
16	84698732	rs867425	A	C	14	4	18	0	0	18	0	0
16	84698808	rs883135	T	G	11	4	15	0	0	15	0	0
16	84699144	rs889613	T	C	10	7	17	0	0	17	0	0
16	84699276	rs34965909	A	C	5	8	13	0	0	13	0	0
16	84700219	rs62048800	C	G	8	16	24	0	0	24	0	0
16	84700620	rs8058266	G	A	8	8	16	0	0	16	0	0
16	84700650	rs8057967	C	A	7	8	15	0	1	16	0	0
16	84749859	rs8046664	T	C	5	9	14	0	0	14	0	0
16	84764491	rs62048856	C	A	7	7	14	0	0	14	0	0
16	84773460	rs34923260	A	G	5	3	8	0	0	8	0	0
16	84778762	rs4553618	C	T	83	74	157	0	0	157	0	0
16	84779248	rs7185949	T	G	100	109	209	0	0	209	0	0
16	84780202	rs12443928	G	T	81	58	139	0	2	141	0	0
16	84780400	rs4782653	C	T	23	15	38	0	0	38	0	0
16	84782214	rs35019923	A	C	4	2	6	0	0	6	0	0
16	84785203	rs8058755	G	A	5	4	9	0	0	9	0	0
16	84785378	rs17831494	G	A	2	4	6	0	0	6	0	0
16	84786250	rs6564074	C	A	6	1	7	0	0	7	0	0
16	84786347	rs6564075	A	G	5	3	8	0	0	8	0	0
16	84790371	rs17764342	C	T	5	5	10	0	0	10	0	0
16	84792022	rs56404731	A	G	7	6	13	0	0	13	0	0
16	84792428	rs7202832	C	T	4	7	11	0	0	11	0	0
16	84793261	rs3764333	A	G	2	9	11	0	0	11	0	0
16	84793348	rs3764331	G	A	6	4	10	0	0	10	0	0
16	84796603	rs12932018	A	G	88	109	197	0	4	201	0	0
16	84797637	rs3213810	T	A	5	4	9	0	0	9	0	0
16	84798781	rs7186685	T	C	4	2	6	0	0	6	0	0
16	84799013	rs7185686	C	T	6	3	9	0	0	9	0	0
16	84806837	rs3893782	A	C	1	7	8	0	0	8	0	0
16	84806958	rs244563	A	G	4	8	12	0	0	12	0	0
16	84808969	rs2303232	G	C	11	6	17	0	0	17	0	0
16	84808984	rs774300	T	C	9	6	15	0	0	15	0	0
16	84810608	rs76089031	G	A	10	8	18	0	0	18	0	0
16	84810754	rs55638897	G	T	15	12	27	0	0	27	0	0
16	84810949	rs774304	G	A	7	10	17	0	0	17	0	0
16	84811265	rs11644667	C	G	13	10	23	0	0	23	0	0
16	84811789	rs17597942	A	G	11	5	16	0	0	16	0	0
16	84883102	rs8061351	C	T	4	5	9	0	0	9	0	0
16	84906098	rs721005	C	G	5	3	8	0	0	8	0	0
16	84922859	rs767050	C	T	2	11	13	0	0	13	0	0
16	84940980	rs2641670	G	A	14	5	19	0	0	19	0	0
16	84941064	rs2646108	G	A	13	5	18	0	1	19	0	0
16	84941329	rs4783099	C	T	8	6	14	0	0	14	0	0
16	84942638	rs16974880	T	G	14	15	29	0	0	29	0	0
16	85009752	rs17775993	T	C	132	139	271	0	3	274	0	0
16	85126460	rs16975222	C	T	4	5	9	0	0	9	0	0
16	85613925	rs57017384	G	T	7	14	21	0	0	21	0	0
16	85614007	rs73269279	C	G	6	10	16	0	0	16	0	0
16	85697734	rs17208646	C	A	5	3	8	0	0	8	0	0
16	85700481	rs12149210	G	A	13	2	15	0	0	15	0	0
16	85701573	.	A	T	15	4	19	0	0	19	0	0
16	85701586	.	C	T	14	7	21	0	0	21	0	0
16	85705611	rs12149168	G	T	3	4	7	0	0	7	0	0
16	85706047	rs9940601	A	C	53	65	118	0	4	122	0	0
16	85706564	rs709805	G	A	55	71	126	0	2	128	0	0
16	85706633	rs1049868	T	C	92	104	196	0	1	197	0	0
16	85707014	.	T	G	23	19	42	0	1	43	0	0
16	85708665	rs72803009	T	A	63	93	156	0	0	156	0	0
16	85708846	rs2029	C	A	70	102	172	0	5	177	0	0
16	85708867	rs2028	C	G	110	62	172	0	2	174	0	0
16	85709316	rs11865	A	G	121	114	235	0	3	238	0	0
16	85709610	rs8571	G	A	153	130	283	0	1	284	0	0
16	85711502	rs9534	T	C	70	52	122	0	1	123	0	0
16	85722557	rs556074453	T	C	6	10	16	0	1	17	0	0
16	85722560	rs58171120	C	G	6	10	16	0	1	17	0	0
16	85943168	rs3794660	G	C	12	9	21	0	0	21	0	0
16	85943466	rs305077	T	C	8	10	18	0	0	18	0	0
16	85944252	rs191478859	A	G	5	2	7	0	0	7	0	0
16	85944439	rs391525	A	G	3	4	7	0	0	7	0	0
16	85945076	rs2292980	T	C	8	2	10	0	0	10	0	0
16	85955242	rs10514611	C	T	3	5	8	0	0	8	0	0
16	85955671	rs1044873	C	T	34	28	62	0	2	64	0	0
16	87372275	rs11647079	C	G	4	4	8	0	0	8	0	0
16	87377455	rs2303764	G	C	4	4	8	0	0	8	0	0
16	87390630	rs889600	A	C	1	5	6	0	0	6	0	0
16	87396755	rs9933873	T	C	3	3	6	0	0	6	0	0
16	87397288	rs745280	G	A	5	2	7	0	0	7	0	0
16	87764267	rs9934565	A	T	0	13	13	0	0	13	0	0
16	87768317	rs1599801	G	T	0	6	6	0	0	6	0	0
16	87788833	rs17772510	G	T	25	11	36	0	0	36	0	0
16	87864475	rs1060266	G	C	265	118	383	0	2	385	0	0
16	87865022	rs1060258	C	T	292	126	418	0	3	421	0	0
16	87865294	rs1060257	C	T	177	96	273	0	2	275	0	0
16	87866138	rs1060253	G	C	143	54	197	0	3	200	0	0
16	87867872	rs747578	G	A	8	1	9	0	0	9	0	0
16	87868527	rs3889228	C	A	7	2	9	0	0	9	0	0
16	87868948	rs13329933	G	C	6	2	8	0	0	8	0	0
16	87869313	rs55777228	T	C	4	2	6	0	0	6	0	0
16	87869376	rs9932892	A	G	3	5	8	0	0	8	0	0
16	87873247	rs750950	A	C	12	4	16	0	0	16	0	0
16	87876126	rs75797585	C	A	2	9	11	0	0	11	0	0
16	87876175	rs55694638	C	T	10	2	12	0	0	12	0	0
16	87876859	rs28415618	T	C	22	9	31	0	1	32	0	0
16	87878783	rs61527026	C	G	5	1	6	0	0	6	0	0
16	87878964	rs4325563	A	G	5	4	9	0	2	11	0	0
16	87878980	rs117246999	C	T	6	4	10	0	0	10	0	0
16	87879392	rs67310965	G	A	5	1	6	0	0	6	0	0
16	87879562	rs997762	C	A	6	0	6	0	1	7	0	0
16	87986136	rs7186168	T	C	90	75	165	0	1	166	0	0
16	87994452	rs11117313	C	G	5	3	8	0	0	8	0	0
16	87994969	rs7186900	T	C	7	3	10	0	0	10	0	0
16	87995179	rs7205205	A	G	7	7	14	0	0	14	0	0
16	87995200	rs12934497	A	G	8	3	11	0	0	11	0	0
16	87995510	rs7205819	A	G	9	13	22	0	0	22	0	0
16	87996407	rs7498866	A	G	1	5	6	0	0	6	0	0
16	88017809	rs3815820	C	T	8	5	13	0	0	13	0	0
16	88066717	rs74992447	C	T	3	3	6	0	0	6	0	0
16	88552370	rs3751673	A	G	5	2	7	0	1	8	0	0
16	88601481	rs2279777	C	T	5	6	11	0	0	11	0	0
16	88689997	rs2277903	C	T	4	2	6	0	0	6	0	0
16	88690745	rs12596165	A	G	6	7	13	0	0	13	0	0
16	88692070	rs145147113	G	C	17	12	29	0	0	29	0	0
16	88695300	rs4782387	C	T	3	3	6	0	0	6	0	0
16	88695338	rs4782388	C	G	3	3	6	0	0	6	0	0
16	88695376	rs4782307	A	G	4	2	6	0	0	6	0	0
16	88695685	rs148534433	C	G	6	1	7	0	0	7	0	0
16	88696309	rs8062466	C	T	22	16	38	0	0	38	0	0
16	88696485	rs8062710	C	G	34	23	57	0	0	57	0	0
16	88696716	rs147961270	G	T	24	19	43	0	1	44	0	0
16	88709712	rs7195830	A	G	92	75	167	0	5	172	0	0
16	88709737	rs1049255	C	T	176	144	320	0	3	324	1	0
16	88709828	rs1049254	A	G	336	259	595	0	51	646	0	0
16	88709968	rs12123	A	G	523	451	974	0	5	980	1	0
16	88710833	rs3180279	C	G	341	428	769	0	2	771	0	0
16	88710882	rs3794622	T	C	285	358	643	0	8	651	0	0
16	88710888	rs3794623	G	T	252	311	563	0	8	572	1	0
16	88712319	rs12709102	T	C	43	39	82	0	0	82	0	0
16	88713501	rs4782393	A	G	23	22	45	0	1	46	0	0
16	88714559	rs2306422	C	T	21	13	34	0	1	35	0	0
16	88718552	rs11076693	G	A	39	56	95	0	1	96	0	0
16	88763768	rs143100192	C	T	86	85	171	0	5	176	0	0
16	88765174	rs78069475	T	G	3	8	11	0	0	11	0	0
16	88776148	rs4377140	C	T	0	6	6	0	0	6	0	0
16	88779032	rs2290896	G	C	10	10	20	0	0	20	0	0
16	88779739	rs11549837	A	G	14	18	32	0	1	34	1	0
16	88780175	rs4782321	G	A	16	28	44	0	0	44	0	0
16	88781073	rs11549835	G	A	20	16	36	0	2	38	0	0
16	88781558	rs2306045	G	A	5	3	8	0	0	8	0	0
16	88781791	rs1061247	A	C	26	17	43	0	1	44	0	0
16	88781850	rs1061238	C	T	165	198	363	0	0	363	0	0
16	88782079	rs1061228	G	A	265	193	458	0	4	462	0	0
16	88783903	rs7186082	A	G	36	30	66	0	1	67	0	0
16	88784334	rs9924236	A	G	7	12	19	0	0	19	0	0
16	88785206	rs79311053	C	T	3	7	10	0	0	10	0	0
16	88785242	rs113385327	A	C	3	8	11	0	0	11	0	0
16	88788535	rs78759106	T	C	9	14	23	0	0	23	0	0
16	88788544	rs76661599	G	A	10	15	25	0	0	25	0	0
16	88796897	rs12102880	G	T	2	8	10	0	0	10	0	0
16	88797307	rs11646193	G	A	2	15	17	0	0	17	0	0
16	88797471	rs2340981	T	C	1	10	11	0	0	11	0	0
16	88797568	rs8050504	G	A	6	3	9	0	0	9	0	0
16	88797669	rs4782322	T	G	3	4	7	0	0	7	0	0
16	88798129	.	G	C	38	26	64	0	0	64	0	0
16	88799238	rs3214053	T	C	6	6	12	0	0	12	0	0
16	88799338	rs6500492	G	A	6	14	20	0	0	20	0	0
16	88800785	rs35265318	C	T	17	19	36	0	0	36	0	0
16	88800814	rs35353288	G	A	24	19	43	0	0	43	0	0
16	88800913	rs34908386	C	T	41	34	75	0	1	76	0	0
16	88802573	rs78905828	G	A	20	19	39	0	0	39	0	0
16	88941717	rs191067101	G	A	13	12	25	0	0	25	0	0
16	88943542	rs200760802	C	T	12	8	20	0	1	21	0	0
16	88947735	rs202023439	G	A	8	7	15	0	0	15	0	0
16	89199651	rs12447947	G	A	25	11	36	0	0	36	0	0
16	89217173	rs34695247	G	A	7	3	10	0	0	10	0	0
16	89219524	rs11640513	G	C	6	3	9	0	0	9	0	0
16	89219591	rs12599577	T	A	4	5	9	0	0	9	0	0
16	89346370	.	G	C	19	17	36	0	0	36	0	0
16	89359004	rs731135	G	A	11	8	19	0	0	19	0	0
16	89359010	rs1979504	C	T	11	7	18	0	0	18	0	0
16	89359421	rs731136	C	G	4	7	11	0	0	11	0	0
16	89359685	.	A	T	10	6	16	0	1	17	0	0
16	89360965	rs3114917	G	A	7	2	9	0	0	9	0	0
16	89361613	rs3114916	G	C	4	6	10	0	0	10	0	0
16	89365286	rs3096294	T	G	5	3	8	0	0	8	0	0
16	89366932	rs3114915	G	A	11	24	35	0	0	35	0	0
16	89368030	rs3114914	C	T	0	6	6	0	0	6	0	0
16	89369869	rs3102347	A	G	4	4	8	0	0	8	0	0
16	89370677	rs3096311	C	G	2	5	7	0	1	8	0	0
16	89371407	rs3114913	G	A	6	4	10	0	0	10	0	0
16	89406914	rs3102379	T	C	10	5	15	0	0	15	0	0
16	89406943	rs7403817	A	C	10	4	14	0	0	14	0	0
16	89451575	rs3102342	T	C	19	6	25	0	0	25	0	0
16	89452771	rs3114848	G	A	6	1	7	0	0	7	0	0
16	89453155	rs3096297	T	G	2	4	6	0	0	6	0	0
16	89455306	rs2965824	A	G	4	2	6	0	0	6	0	0
16	89458527	rs2930214	T	C	0	7	7	0	0	7	0	0
16	89458984	rs7205785	A	G	4	8	12	0	0	12	0	0
16	89493043	rs2965939	G	A	2	7	9	0	0	9	0	0
16	89553624	rs4785676	T	C	9	13	22	0	0	22	0	0
16	89553707	rs4785568	A	G	8	18	26	0	0	26	0	0
16	89571815	rs9922341	C	G	1	5	6	0	0	6	0	0
16	89581216	rs8046182	A	G	1	7	8	0	0	8	0	0
16	89582928	rs28887168	C	T	3	4	7	0	0	7	0	0
16	89582942	rs72805503	G	C	4	3	7	0	0	7	0	0
16	89583067	rs62070324	G	A	6	1	7	0	0	7	0	0
16	89583578	rs62070326	G	A	2	5	7	0	0	7	0	0
16	89583809	rs8052076	C	T	4	12	16	0	0	16	0	0
16	89584185	rs7192801	G	T	4	3	7	0	0	7	0	0
16	89585627	rs11076606	A	G	3	7	10	0	0	10	0	0
16	89585814	rs12050936	A	G	2	4	6	0	0	6	0	0
16	89586995	rs8048080	G	A	7	1	8	0	0	8	0	0
16	89587438	rs57654699	C	G	4	8	12	0	0	12	0	0
16	89587579	rs57505611	C	T	2	6	8	0	0	8	0	0
16	89590060	rs28643511	G	A	4	7	11	0	0	11	0	0
16	89590243	rs3803680	G	A	4	8	12	0	0	12	0	0
16	89593170	rs141882852	C	T	3	3	6	0	0	6	0	0
16	89595723	rs3803677	G	A	4	2	6	0	0	6	0	0
16	89596106	rs3803676	C	T	4	2	6	0	0	6	0	0
16	89597221	rs4785691	A	G	14	5	19	0	0	19	0	0
16	89597844	rs35696391	C	A	3	5	8	0	0	8	0	0
16	89597876	rs6500425	A	G	1	12	13	0	0	13	0	0
16	89603586	rs382745	A	G	6	12	18	0	0	18	0	0
16	89607414	rs2056309	G	A	47	46	93	0	0	93	0	0
16	89607679	rs3751687	G	A	54	53	107	0	2	109	0	0
16	89608342	rs12928752	T	C	42	34	76	0	9	85	0	0
16	89609241	rs12929254	C	G	4	6	10	0	0	10	0	0
16	89609694	rs35878298	A	G	4	8	12	0	0	12	0	0
16	89609853	rs11643662	G	A	18	11	29	0	0	29	0	0
16	89610021	rs2434863	C	T	9	3	12	0	1	13	0	0
16	89610346	rs28592777	C	T	18	21	39	0	0	39	0	0
16	89612421	.	T	C	3	5	8	0	0	8	0	0
16	89613037	rs462464	G	A	5	2	7	0	0	7	0	0
16	89613123	rs2292954	A	G	104	94	198	0	1	199	0	0
16	89615333	rs67643661	C	T	36	32	68	0	1	69	0	0
16	89615453	rs4325552	A	C	33	22	55	0	0	55	0	0
16	89615765	rs2019604	T	G	5	13	18	0	0	18	0	0
16	89616039	rs997212	G	A	10	9	19	0	0	19	0	0
16	89616155	rs2377056	G	T	6	5	11	0	0	11	0	0
16	89616167	rs2889543	T	C	7	2	9	0	0	9	0	0
16	89616178	rs2377057	G	A	7	3	10	0	0	10	0	0
16	89616232	rs1864155	G	A	10	5	15	0	0	15	0	0
16	89616558	rs7359417	T	C	2	4	6	0	0	6	0	0
16	89616772	rs71396924	G	T	4	5	9	0	0	9	0	0
16	89616790	rs66845605	G	A	6	4	10	0	0	10	0	0
16	89617064	rs3794632	G	C	5	3	8	0	0	8	0	0
16	89617518	rs17775174	C	T	11	6	17	0	0	17	0	0
16	89618530	rs4785577	G	A	15	10	25	0	0	25	0	0
16	89620148	rs730264	A	G	7	5	12	0	0	12	0	0
16	89620328	rs12960	G	A	215	168	383	0	3	387	1	0
16	89620367	.	A	C	181	228	409	0	2	411	0	0
16	89622524	rs12919215	T	G	2	4	6	0	0	6	0	0
16	89627460	rs2280370	T	G	2598	610	3208	0	9	3218	1	0
16	89627671	rs174035	C	T	2098	1116	3214	0	12	3226	0	0
16	89628073	rs9930567	G	A	5259	5405	10664	0	34	10700	2	0
16	89628381	rs3751691	C	T	3	6	9	0	0	9	0	0
16	89628621	rs3751690	A	G	8	7	15	0	0	15	0	0
16	89628870	rs885268	C	G	7	8	15	0	0	15	0	0
16	89628959	rs78016521	C	T	8	7	15	0	0	15	0	0
16	89629070	rs34414057	C	G	12	14	26	0	0	26	0	0
16	89629736	rs3211567	C	T	378	677	1055	0	5	1061	1	0
16	89629780	rs3211568	G	A	196	475	671	0	3	674	0	0
16	89629819	rs3211569	G	A	150	276	426	0	3	429	0	0
16	89629928	rs57775530	C	G	19	8	27	0	0	27	0	0
16	89630092	rs13380730	C	G	31	19	50	0	1	51	0	0
16	89630212	rs12709088	T	A	40	19	59	0	2	61	0	0
16	89630311	rs12709089	G	A	36	18	54	0	0	54	0	0
16	89630630	rs12932337	C	T	61	51	112	0	0	112	0	0
16	89764042	rs55645629	A	G	37	16	53	0	1	54	0	0
16	89780090	rs12149952	T	C	7	7	14	0	0	14	0	0
16	89784992	rs57119673	A	G	26	22	48	0	0	48	0	0
16	89785107	rs62068372	T	C	13	10	23	0	0	23	0	0
16	89785242	rs113661672	C	T	19	18	37	0	2	39	0	0
16	89785820	rs56112321	T	C	10	22	32	0	2	34	0	0
16	89786649	rs111836360	A	C	18	13	31	0	0	31	0	0
16	89786691	rs117849137	C	T	15	12	27	0	0	27	0	0
16	89786855	rs3809646	C	T	11	11	22	0	1	23	0	0
16	89787040	rs4785589	C	T	1	5	6	0	0	7	1	0
16	89787962	rs115025067	G	A	3	3	6	0	0	6	0	0
16	89788768	rs116853582	T	A	18	13	31	0	0	31	0	0
16	89789311	rs8056353	G	A	18	20	38	0	0	38	0	0
16	89789506	rs28557782	C	A	41	21	62	0	0	62	0	0
16	89790167	rs4785590	G	C	2	6	8	0	0	8	0	0
16	89790297	rs56048434	C	T	7	2	9	0	0	9	0	0
16	89792228	rs8059398	T	C	3	4	7	0	0	7	0	0
16	89793555	rs2099105	T	C	3	5	8	0	0	8	0	0
16	89794884	rs4633719	T	C	4	6	10	0	0	10	0	0
16	89794885	rs4640180	C	T	4	6	10	0	0	10	0	0
16	89794994	rs9941129	C	T	6	4	10	0	0	10	0	0
16	89795092	rs9933498	T	G	6	5	11	0	0	11	0	0
16	89795144	rs55729849	G	A	5	9	14	0	0	14	0	0
16	89795381	rs13339414	G	A	4	6	10	0	0	10	0	0
16	89796569	rs4785708	C	T	5	5	10	0	0	10	0	0
16	89796756	rs4785710	C	T	3	4	7	0	0	7	0	0
16	89797627	.	C	T	8	5	13	0	0	13	0	0
16	89797903	rs11643623	C	T	3	3	6	0	0	6	0	0
16	89798076	rs55865486	C	G	3	4	7	0	0	7	0	0
16	89798081	rs11643713	C	T	3	4	7	0	0	7	0	0
16	89798375	rs56296040	C	G	2	4	6	0	0	6	0	0
16	89798404	rs4785714	C	A	5	4	9	0	0	9	0	0
16	89799079	rs7206546	C	T	2	5	7	0	1	8	0	0
16	89800058	rs3803689	C	T	27	23	50	0	0	50	0	0
16	89800163	rs3840047	C	T	26	25	51	0	0	51	0	0
16	89800529	rs9935559	C	T	2	5	7	0	0	7	0	0
16	89800550	rs7189734	G	A	5	2	7	0	0	7	0	0
16	89800704	rs72807545	C	G	4	3	7	0	0	7	0	0
16	89800887	rs3764257	C	G	2	4	6	0	0	6	0	0
16	89801127	rs4785716	T	C	5	4	9	0	0	9	0	0
16	89801133	rs4785717	A	G	5	2	7	0	0	7	0	0
16	89801569	rs72807546	C	T	3	3	6	0	0	6	0	0
16	89801892	rs11649155	G	C	8	4	12	0	0	12	0	0
16	89802090	rs2077001	G	A	4	3	7	0	0	7	0	0
16	89802307	rs11355220	G	T	4	2	6	0	0	6	0	0
16	89802311	rs6500438	G	T	5	1	6	0	0	6	0	0
16	89805261	rs1800359	A	G	101	74	175	0	1	176	0	0
16	89807705	rs11076618	T	C	1	7	8	0	0	8	0	0
16	89807785	rs11640198	C	T	2	5	7	0	0	7	0	0
16	89810823	rs6500440	T	C	4	3	7	0	0	7	0	0
16	89812299	rs72807553	C	T	6	5	11	0	0	11	0	0
16	89812778	rs45524337	G	A	5	2	7	0	1	8	0	0
16	89836507	rs7200990	T	C	9	5	14	0	0	14	0	0
16	89849480	rs2239359	C	T	20	9	29	0	0	29	0	0
16	89865311	rs17226026	T	C	45	18	63	0	1	64	0	0
16	89875033	.	G	T	12	12	24	0	0	24	0	0
16	89875259	rs11076629	T	C	4	3	7	0	0	7	0	0
16	89875710	rs11861084	A	C	9	2	11	0	0	11	0	0
16	89969593	rs4785736	T	C	19	14	33	0	0	33	0	0
16	89972932	.	C	T	10	6	16	0	1	17	0	0
16	89979959	rs8060848	G	A	4	3	7	0	0	7	0	0
16	89980316	rs62052211	T	C	2	4	6	0	0	6	0	0
16	89980482	rs11860013	C	T	5	3	8	0	0	8	0	0
16	89980620	rs67784077	C	T	4	2	6	0	0	6	0	0
16	89982272	rs3212345	T	C	4	7	11	0	0	11	0	0
16	89984370	rs3212354	T	C	2	4	6	0	0	6	0	0
16	89984739	rs3212358	A	G	4	3	7	0	0	7	0	0
16	89985441	rs3212363	A	T	4	5	9	0	0	9	0	0
16	90002290	rs1135425	T	C	10	3	13	0	0	13	0	0
16	90061708	rs200955819	T	C	11	9	20	0	1	21	0	0
16	90102835	rs868045	A	G	3	5	8	0	0	8	0	0
16	90110027	rs3743824	G	A	2	4	6	0	0	6	0	0
16	90110737	rs3743817	A	G	5	3	8	0	0	8	0	0
16	90111033	.	T	G	4	3	7	0	0	7	0	0
16	90172696	rs9924610	A	G	3	11	14	0	0	14	0	0
16	90230250	.	C	T	23	0	23	0	0	23	0	0
16	90230266	.	A	G	16	0	16	0	1	17	0	0
16	90230343	.	C	T	7	0	7	0	1	8	0	0
16	90232832	.	A	C	40	1	41	0	0	41	0	0
16	90234915	rs185804457	C	T	11	12	23	0	0	23	0	0
16	90236509	rs139560308	T	C	25	4	29	0	7	36	0	0
17	16680606	.	T	G	0	8	8	0	0	8	0	0
17	16680765	.	A	G	0	13	13	0	0	13	0	0
17	16681787	.	G	T	0	17	17	0	0	17	0	0
17	16682899	.	G	A	0	19	19	0	0	19	0	0
17	16686125	.	A	G	1	13	14	0	0	14	0	0
17	16686153	rs4004020	C	T	0	17	17	0	0	17	0	0
17	19091466	rs202063833	C	T	107	160	267	0	3	270	0	0
17	19091625	rs569956882	A	C	24	16	40	0	0	40	0	0
17	20420448	.	C	A	23	0	23	0	0	23	0	0
17	20420499	.	G	A	14	0	14	0	0	14	0	0
17	20420551	.	A	G	10	0	10	0	0	10	0	0
17	21195233	rs79162051	G	A	6	0	6	0	0	6	0	0
17	21195236	rs80052421	G	A	6	0	6	0	0	6	0	0
17	21195241	.	A	G	6	0	6	0	0	6	0	0
17	21195296	.	C	T	7	0	7	0	0	7	0	0
17	21195301	.	C	T	7	0	7	0	0	7	0	0
17	21311859	.	T	C	7	0	7	0	0	7	0	0
17	21311885	.	A	T	10	0	10	0	0	10	0	0
17	21311911	.	G	A	11	0	11	0	0	11	0	0
17	21311916	rs1657716	C	T	11	0	11	0	0	11	0	0
17	21311932	.	A	G	12	0	12	0	0	12	0	0
17	21311940	.	T	C	16	0	16	0	0	16	0	0
17	21315131	.	T	A	7	0	7	0	0	7	0	0
17	21315155	.	G	T	6	0	6	0	0	6	0	0
17	21315165	.	A	T	7	0	7	0	0	7	0	0
17	21315202	.	A	G	6	0	6	0	0	6	0	0
17	21318629	.	C	T	6	0	6	0	0	6	0	0
17	21318821	.	A	C	6	0	6	0	0	6	0	0
17	21318897	.	G	C	7	0	7	0	0	7	0	0
17	21318952	rs8076599	A	G	7	0	7	0	0	7	0	0
17	21319007	rs1657740	G	A	6	0	6	0	0	6	0	0
17	21319008	rs1657741	G	C	6	0	6	0	0	6	0	0
17	21319121	.	C	T	10	0	10	0	0	10	0	0
17	21319230	.	G	C	9	0	9	0	1	10	0	0
17	21319302	.	T	C	7	0	7	0	0	7	0	0
17	21319473	.	G	A	14	0	14	0	0	14	0	0
17	21319767	.	C	T	10	0	10	0	0	10	0	0
17	21319785	.	C	T	12	0	12	0	0	12	0	0
17	21319860	.	C	T	12	0	12	0	0	12	0	0
17	21319943	.	A	G	20	0	20	0	0	20	0	0
17	21319989	rs5021700	C	T	20	0	20	0	0	20	0	0
17	21319993	rs5021701	T	C	20	0	20	0	0	20	0	0
17	21320025	.	C	T	21	0	21	0	0	21	0	0
17	21320102	.	C	A	8	0	8	0	1	9	0	0
17	21320114	.	T	G	6	0	6	0	0	6	0	0
17	21320212	rs5021705	A	G	10	0	10	0	0	10	0	0
17	21320263	.	T	C	8	0	8	0	0	8	0	0
17	21320365	.	T	C	10	0	10	0	0	10	0	0
17	21320406	.	T	A	10	0	10	0	0	10	0	0
17	25622111	rs12306	G	T	7	4	11	0	0	11	0	0
17	25623135	rs9903366	G	A	4	5	9	0	0	9	0	0
17	25624296	rs4795558	G	A	4	7	11	0	0	11	0	0
17	25625047	.	G	A	8	1	9	0	0	9	0	0
17	25628058	rs9908804	C	T	5	8	13	0	0	13	0	0
17	25628161	rs7224922	G	A	4	6	10	0	0	10	0	0
17	25628820	rs6561	T	C	29	97	126	0	1	127	0	0
17	25629273	rs3762810	C	T	8	14	22	0	1	23	0	0
17	25629890	rs4795561	G	A	5	11	16	0	0	16	0	0
17	25630388	rs2270761	T	C	13	16	29	0	0	29	0	0
17	25632168	rs16965862	C	T	6	3	9	0	0	9	0	0
17	25636449	rs33949241	C	T	8	10	18	0	0	18	0	0
17	25636904	rs6505198	A	G	14	24	38	0	0	38	0	0
17	25636954	rs11080131	T	G	19	18	37	0	0	37	0	0
17	25637343	rs6505199	G	A	38	24	62	0	2	64	0	0
17	25640081	rs1060618	A	G	288	173	461	0	13	474	0	0
17	25642315	rs3751921	A	G	4	8	12	0	1	13	0	0
17	25642522	rs1047616	G	A	13	12	25	0	0	25	0	0
17	25906336	rs62057823	A	G	2	4	6	0	0	6	0	0
17	25909816	rs2293180	C	T	12	11	23	0	0	23	0	0
17	25909850	rs2293181	G	T	8	11	19	0	0	20	1	0
17	25915281	rs62057826	C	G	4	8	12	0	0	12	0	0
17	25950175	rs2241906	C	T	25	22	47	0	0	47	0	0
17	25950220	rs1075952	G	A	29	24	53	0	0	53	0	0
17	25951644	rs749529	C	G	59	56	115	0	4	119	0	0
17	25951929	rs11867724	G	A	46	50	96	0	1	97	0	0
17	25952082	rs16966363	C	T	68	68	136	0	1	137	0	0
17	25952289	rs1807183	G	A	78	62	140	0	0	140	0	0
17	25953203	rs16966365	C	T	114	98	212	0	5	217	0	0
17	25958304	rs3751093	G	A	143	111	254	0	1	255	0	0
17	25966720	rs9891080	G	A	5	1	6	0	0	6	0	0
17	25970633	rs361497	G	A	57	66	123	0	1	124	0	0
17	25970778	rs4795835	C	T	3	3	6	0	0	6	0	0
17	25970847	rs4794975	C	T	6	4	10	0	0	10	0	0
17	25970987	rs12949932	A	C	3	13	16	0	0	16	0	0
17	25971058	rs9944511	T	C	6	11	17	0	0	17	0	0
17	25971227	rs9944514	T	C	6	11	17	0	0	17	0	0
17	25971795	rs62055780	T	C	4	5	9	0	1	10	0	0
17	25971950	rs79484276	T	C	8	12	20	0	0	20	0	0
17	25971951	rs78909201	G	A	8	12	20	0	0	20	0	0
17	25971978	rs74321993	G	A	11	11	22	0	0	22	0	0
17	25971979	rs79526289	A	G	11	11	22	0	0	22	0	0
17	25974258	rs4239242	T	C	4	8	12	0	0	12	0	0
17	25976524	rs8368	A	G	156	65	221	0	3	224	0	0
17	26080095	.	C	T	6	0	6	0	0	6	0	0
17	26375467	rs1460026	G	A	10	9	19	0	1	20	0	0
17	26554775	rs9897022	C	T	3	7	10	0	1	11	0	0
17	26656903	rs150196005	A	G	6	8	14	0	0	14	0	0
17	26657394	rs181131314	A	G	4	8	12	0	0	12	0	0
17	26670044	rs192263462	T	C	4	2	6	0	0	6	0	0
17	26670627	rs3093692	G	A	14	14	28	0	0	28	0	0
17	26671196	rs733914	C	G	43	39	82	0	1	83	0	0
17	26676135	rs13469	C	T	117	93	210	0	0	210	0	0
17	26678960	rs2073867	G	C	5	7	12	0	0	12	0	0
17	26688663	rs708100	G	A	63	51	114	0	1	115	0	0
17	26689251	.	A	G	27	17	44	0	0	44	0	0
17	26689643	rs191038669	A	T	17	21	38	0	0	38	0	0
17	26723613	rs2239911	G	T	5	1	6	0	0	6	0	0
17	26723666	rs2239910	A	C	6	4	10	0	0	10	0	0
17	26725265	rs2239908	G	A	4	3	7	0	0	7	0	0
17	26733698	rs7212349	T	C	10	19	29	0	1	30	0	0
17	26874314	rs2070139	G	A	152	177	329	0	2	331	0	0
17	26881093	rs540462627	T	G	226	242	468	0	7	475	0	0
17	26926812	rs547758835	G	C	2	5	7	0	0	7	0	0
17	26930498	rs55979545	T	A	4	2	6	0	0	6	0	0
17	26937711	rs56247345	A	G	14	23	37	0	0	37	0	0
17	26939666	rs147269427	T	C	19	18	37	0	0	37	0	0
17	26941936	.	C	T	188	204	392	0	0	392	0	0
17	26998561	rs558887922	C	T	16	10	26	0	0	26	0	0
17	27403790	rs72815764	T	C	9	11	20	0	0	20	0	0
17	27405184	rs58005815	G	A	7	4	11	0	0	11	0	0
17	27407865	rs8073831	A	G	2	7	9	0	0	9	0	0
17	27413908	rs4795495	C	G	3	4	7	0	0	7	0	0
17	27422922	rs72815778	C	T	5	10	15	0	0	15	0	0
17	27444675	rs79001652	C	G	76	81	157	0	0	157	0	0
17	27449976	rs882729	T	C	3	5	8	0	0	8	0	0
17	27460036	rs138017589	C	T	3	4	7	0	0	7	0	0
17	27583253	rs72819452	G	A	184	227	411	0	3	414	0	0
17	27588806	rs8614	C	A	258	343	601	0	4	605	0	0
17	27601486	rs59849321	C	T	4	3	7	0	0	7	0	0
17	27614837	rs797960	T	G	3	3	6	0	0	6	0	0
17	27869968	rs507577	G	A	9	7	16	0	0	16	0	0
17	27871025	rs17766675	A	G	1	8	9	0	0	9	0	0
17	27872147	rs602056	C	T	4	6	10	0	0	10	0	0
17	27875213	rs11868320	G	A	6	1	7	0	0	7	0	0
17	27876805	rs1060636	C	G	15	20	35	0	0	35	0	0
17	27941886	rs13723	A	G	6	2	8	0	0	8	0	0
17	28576076	rs1050565	T	C	105	97	202	0	2	204	0	0
17	28612448	rs7342921	G	C	70	44	114	0	0	114	0	0
17	28738020	rs7502659	C	T	4	2	6	0	0	6	0	0
17	28739865	rs2058283	C	T	24	10	34	0	2	36	0	0
17	28783346	.	A	T	71	84	155	0	0	155	0	0
17	28794020	rs9406	A	G	85	80	165	0	1	166	0	0
17	28804996	rs4795554	T	C	13	7	20	0	0	20	0	0
17	28849903	rs12449550	G	A	70	48	118	0	1	119	0	0
17	28850141	rs62070565	G	A	42	46	88	0	1	89	0	0
17	28850342	rs61429680	G	A	46	51	97	0	3	100	0	0
17	28850584	rs542322707	A	G	4	2	6	0	0	6	0	0
17	28850824	rs11657674	T	C	75	47	122	0	0	122	0	0
17	28853178	.	A	T	32	17	49	0	0	49	0	0
17	28853530	rs216463	A	C	34	37	71	0	0	71	0	0
17	28853914	rs17605796	A	T	5	8	13	0	0	13	0	0
17	28909231	rs216404	G	A	8	0	8	0	0	8	0	0
17	28934548	rs79607958	T	G	6	16	22	0	1	23	0	0
17	28934549	rs75136574	C	A	6	17	23	0	0	23	0	0
17	28934550	rs77544470	C	A	6	17	23	0	0	23	0	0
17	28943479	rs216425	G	A	5	6	11	0	0	11	0	0
17	28943498	rs216426	A	G	5	5	10	0	0	10	0	0
17	28943570	rs430301	C	T	6	1	7	0	0	7	0	0
17	28943571	rs412569	A	G	6	1	7	0	0	7	0	0
17	28949990	rs419354	G	T	2	5	7	0	0	7	0	0
17	28951039	rs450585	G	A	3	3	6	0	0	6	0	0
17	28959179	rs383436	A	G	8	8	16	0	0	16	0	0
17	28959917	rs386180	A	G	11	15	26	0	0	26	0	0
17	28962472	rs407604	G	A	4	14	18	0	2	20	0	0
17	28969013	rs11655681	C	T	5	4	9	0	0	9	0	0
17	29046782	rs11654722	G	A	2	4	6	0	0	6	0	0
17	29058694	rs11650928	T	C	5	1	6	0	0	6	0	0
17	29058730	rs8080829	C	T	15	10	25	0	1	26	0	0
17	29058863	rs8079891	G	A	26	16	42	0	0	42	0	0
17	29059631	rs73267855	C	G	1	5	6	0	0	6	0	0
17	29059737	rs73267858	A	G	2	12	14	0	0	14	0	0
17	29059985	rs56018041	G	A	0	6	6	0	0	6	0	0
17	29060170	rs56095789	A	G	2	4	6	0	0	6	0	0
17	29062326	.	C	T	1	19	20	0	0	20	0	0
17	29062403	rs28445742	C	G	9	35	44	0	0	44	0	0
17	29062491	rs9892599	C	T	9	15	24	0	0	24	0	0
17	29071815	rs73267874	C	T	11	1	12	0	0	12	0	0
17	29085307	rs11653188	C	T	5	9	14	0	0	14	0	0
17	29085359	rs11658022	A	T	9	8	17	0	1	18	0	0
17	29085713	rs61685770	G	A	13	8	21	0	0	21	0	0
17	29085731	rs57486336	G	T	9	7	16	0	1	17	0	0
17	29085758	rs55764512	G	A	3	3	6	0	0	6	0	0
17	29086332	rs73988172	A	C	6	0	6	0	0	6	0	0
17	29088141	.	T	C	4	2	6	0	0	6	0	0
17	29096326	rs73269916	A	G	10	11	21	0	0	21	0	0
17	29096821	rs11656419	A	G	11	1	12	0	0	12	0	0
17	29097223	rs11652370	G	A	6	2	8	0	0	8	0	0
17	29099775	rs8066799	A	T	2	4	6	0	0	6	0	0
17	29099884	rs8066389	C	A	8	0	8	0	0	8	0	0
17	29100002	rs8071236	T	C	5	1	6	0	0	6	0	0
17	29101105	.	C	G	2	4	6	0	0	6	0	0
17	29104976	.	G	T	2	5	7	0	0	7	0	0
17	29107471	rs9916725	A	C	3	4	7	0	0	7	0	0
17	29107472	rs9916727	A	G	3	4	7	0	0	7	0	0
17	29107588	rs9914499	G	A	4	2	6	0	0	6	0	0
17	29107708	rs9895785	T	C	4	4	8	0	0	8	0	0
17	29108639	rs9896638	C	T	3	3	6	0	0	6	0	0
17	29108759	rs73269945	G	A	4	4	8	0	0	8	0	0
17	29108804	rs9897728	A	G	3	5	8	0	0	8	0	0
17	29109954	rs1054400	A	G	14	5	19	0	0	19	0	0
17	29110196	rs1054397	T	C	61	45	106	0	0	106	0	0
17	29110355	rs9890558	T	C	57	39	96	0	2	98	0	0
17	29110373	rs9912283	A	G	66	51	117	0	1	118	0	0
17	29110432	rs9911658	C	A	54	39	93	0	0	93	0	0
17	29110508	rs9910234	G	A	69	41	110	0	2	113	1	0
17	29110533	rs9911885	C	G	69	51	120	0	0	120	0	0
17	29110652	rs12006	G	A	54	42	96	0	2	98	0	0
17	29111043	rs3752021	G	C	21	21	42	0	0	42	0	0
17	29111125	rs3752020	T	G	26	34	60	0	1	61	0	0
17	29111902	rs9891166	G	A	6	13	19	0	0	19	0	0
17	29113016	rs34756112	A	G	46	38	84	0	0	84	0	0
17	29113514	rs76191928	C	G	2	5	7	0	0	7	0	0
17	29114463	rs1061342	G	A	3	9	12	0	0	12	0	0
17	29114982	rs73269982	C	T	1	8	9	0	0	9	0	0
17	29118145	rs73269988	G	A	2	10	12	0	0	12	0	0
17	29118238	rs73269995	A	G	3	3	6	0	0	6	0	0
17	29118453	rs79950604	G	C	3	7	10	0	0	10	0	0
17	29119004	rs76053788	G	A	2	8	10	0	0	10	0	0
17	29119188	rs56846352	C	T	3	6	9	0	0	9	0	0
17	29119286	rs55961983	G	A	4	7	11	0	0	11	0	0
17	29122480	rs11658913	T	C	6	0	6	0	0	6	0	0
17	29122501	rs11653098	C	T	7	0	7	0	0	7	0	0
17	29122509	rs11658945	T	C	6	0	6	0	0	6	0	0
17	29150255	rs9899268	T	C	7	20	27	0	0	27	0	0
17	29159329	rs999797	G	A	14	13	27	0	0	27	0	0
17	29159404	rs999796	G	C	10	13	23	0	0	23	0	0
17	29159660	rs11651802	T	C	8	5	13	0	0	13	0	0
17	29161202	rs9910051	A	T	12	14	26	0	0	26	0	0
17	29161358	rs3816780	C	T	21	26	47	0	0	47	0	0
17	29161845	rs17826219	G	A	20	20	40	0	0	40	0	0
17	29162173	rs11655623	T	C	23	28	51	0	0	51	0	0
17	29167653	rs3764421	A	C	19	33	52	0	0	52	0	0
17	29184166	rs73277967	T	A	5	1	6	0	0	6	0	0
17	29184943	rs55756553	A	G	3	3	6	0	0	6	0	0
17	29185054	rs60020217	G	A	1	6	7	0	0	7	0	0
17	29187497	rs9896095	A	G	36	50	86	0	0	86	0	0
17	29214387	rs11657270	T	C	53	43	96	0	0	96	0	0
17	29222563	rs9906530	C	T	132	114	246	0	2	248	0	0
17	29224542	rs11080138	A	G	3	5	8	0	0	8	0	0
17	29225403	rs73265610	T	C	7	1	8	0	0	8	0	0
17	29225983	rs73265612	A	G	8	4	12	0	0	12	0	0
17	29226228	rs2433	T	C	11	8	19	0	0	19	0	0
17	29226630	rs28539246	T	A	8	12	20	0	0	20	0	0
17	29226652	rs9897628	A	G	4	5	9	0	0	9	0	0
17	29227765	rs11652078	G	A	6	0	6	0	0	6	0	0
17	29630649	.	C	A	77	57	134	0	0	135	1	0
17	29859506	rs2290436	G	T	15	23	38	0	0	38	0	0
17	29860652	rs4795615	C	A	5	4	9	0	0	9	0	0
17	29862862	rs1548470	G	A	6	5	11	0	0	11	0	0
17	29863370	rs8080134	G	C	4	6	10	0	0	10	0	0
17	29863879	rs1551359	C	T	4	3	7	0	0	7	0	0
17	29863955	rs1551358	G	T	5	6	11	0	0	11	0	0
17	29863956	rs1551357	T	C	5	6	11	0	0	11	0	0
17	29864006	rs1551356	A	G	6	9	15	0	0	15	0	0
17	30665005	rs35677406	T	C	18	14	32	0	0	32	0	0
17	30695790	rs1974606	G	A	8	12	20	0	1	21	0	0
17	30696296	rs72813018	G	A	10	26	36	0	0	36	0	0
17	30701210	rs11080181	C	T	5	6	11	0	0	11	0	0
17	30701879	rs8068787	C	T	7	9	16	0	0	16	0	0
17	30702319	rs11868101	G	A	8	2	10	0	0	10	0	0
17	30703100	rs4795698	G	T	4	7	11	0	0	11	0	0
17	30705346	rs17806082	G	C	13	19	32	0	0	32	0	0
17	30803567	.	A	G	15	11	26	0	2	28	0	0
17	30805795	rs12162135	T	G	5	3	8	0	0	8	0	0
17	30815681	rs8192474	G	A	1	5	6	0	0	6	0	0
17	32965617	rs11650798	G	C	13	0	13	0	0	13	0	0
17	32966065	rs998637	G	C	16	0	16	0	1	17	0	0
17	32966119	rs998638	G	C	17	0	17	0	0	17	0	0
17	33269648	rs2230553	C	G	13	7	20	0	0	20	0	0
17	33272507	rs12453786	C	G	2	5	7	0	0	7	0	0
17	33289937	rs8249	A	T	28	30	58	0	1	59	0	0
17	33307586	rs12945428	G	A	1	5	6	0	0	6	0	0
17	33322322	rs3135998	A	G	7	3	10	0	0	10	0	0
17	33331575	rs1052536	C	T	11	10	21	0	1	22	0	0
17	33332177	rs1003918	G	A	4	9	13	0	0	13	0	0
17	33332629	rs12948362	G	A	9	5	14	0	0	14	0	0
17	33356131	rs145722973	C	T	3	3	6	0	0	6	0	0
17	33456008	rs1138723	G	A	4	4	8	0	0	8	0	0
17	33464864	rs7215209	C	T	9	15	24	0	0	24	0	0
17	33569768	rs55904409	G	C	3	3	6	0	0	6	0	0
17	33569814	rs73993110	T	G	3	3	6	0	0	6	0	0
17	33571494	rs11870371	G	C	6	4	10	0	0	10	0	0
17	33592194	rs117695297	C	G	10	21	31	0	0	31	0	0
17	33592591	rs11651240	C	T	6	2	8	0	0	8	0	0
17	33592621	rs2291189	C	T	2	6	8	0	0	8	0	0
17	33593024	rs2291190	T	C	12	3	15	0	0	15	0	0
17	33593379	rs3803859	C	G	9	5	14	0	0	14	0	0
17	33593387	rs9898490	T	G	9	6	15	0	0	15	0	0
17	33594891	rs12948137	G	A	4	2	6	0	0	6	0	0
17	33594920	.	G	A	6	1	7	0	0	7	0	0
17	33595842	rs2622524	T	G	9	4	13	0	0	13	0	0
17	33596157	rs2671824	C	T	13	6	19	0	0	19	0	0
17	33596183	rs2671823	C	T	10	6	16	0	0	16	0	0
17	33596897	rs1233	G	A	25	11	36	0	1	37	0	0
17	33600213	rs28736871	A	G	5	4	9	0	0	9	0	0
17	33766427	rs8064840	T	G	2	5	7	0	0	7	0	0
17	33797534	rs12953115	G	A	5	4	9	0	0	9	0	0
17	33806332	rs8066132	C	T	4	2	6	0	0	6	0	0
17	33884804	rs10512472	T	C	6	2	8	0	0	8	0	0
17	33895309	rs11080356	T	C	29	32	61	0	2	63	0	0
17	33902635	rs1037590	G	T	7	4	11	0	1	12	0	0
17	33905468	rs321600	A	G	3	5	8	0	0	8	0	0
17	33930021	rs12945980	A	G	2	6	8	0	0	8	0	0
17	33930458	rs225286	G	A	2	8	10	0	0	10	0	0
17	33941560	rs1634683	G	C	6	10	16	0	0	16	0	0
17	33941963	rs225250	A	G	5	3	8	0	0	8	0	0
17	33987034	rs3506	T	C	15	15	30	0	0	30	0	0
17	33998904	rs17670584	T	C	26	27	53	0	0	53	0	0
17	34050934	rs9649	C	T	58	53	111	0	2	113	0	0
17	34051124	rs11653803	T	G	38	38	76	0	0	76	0	0
17	34051176	rs226426	A	G	48	32	80	0	0	80	0	0
17	34052513	rs17638867	C	T	98	78	176	0	1	177	0	0
17	34152000	rs76277035	T	C	6	3	9	0	0	9	0	0
17	34152096	rs11658222	C	G	5	4	9	0	0	9	0	0
17	34158191	rs4079183	A	G	3	5	8	0	0	8	0	0
17	34158261	rs145706798	A	C	4	2	6	0	0	6	0	0
17	34158398	rs2014839	A	G	8	3	11	0	0	11	0	0
17	34158726	rs4796112	C	T	8	4	12	0	0	12	0	0
17	34159566	rs4796113	C	T	11	7	18	0	1	19	0	0
17	34159657	rs4796114	C	G	6	3	9	0	0	9	0	0
17	34159889	rs11656322	A	G	9	8	17	0	0	17	0	0
17	34160178	rs11652192	G	C	5	9	14	0	2	16	0	0
17	34160764	rs3785764	C	T	11	10	21	0	0	21	0	0
17	34161281	rs79909998	G	A	7	3	10	0	1	11	0	0
17	34199162	rs3817656	A	G	111	75	186	0	4	190	0	0
17	34202936	rs41492346	T	C	8	3	11	0	0	11	0	0
17	34415720	rs8951	T	C	442	301	743	0	4	747	0	0
17	34415763	rs1063340	G	C	425	282	707	0	3	710	0	0
17	34416246	rs1719130	T	C	17	15	32	0	1	33	0	0
17	34416537	rs1130371	G	A	430	302	732	0	5	737	0	0
17	34416946	rs1719134	G	A	41	22	63	0	2	65	0	0
17	34431211	rs1049746	G	C	12	5	17	0	0	17	0	0
17	34431403	rs1719144	G	A	12	3	15	0	0	15	0	0
17	34432237	rs72833526	G	A	5	9	14	0	0	14	0	0
17	34432242	rs1634516	G	C	9	5	14	0	0	14	0	0
17	34432297	rs1719148	A	G	10	9	19	0	0	19	0	0
17	34432403	rs1634517	C	A	13	4	17	0	1	18	0	0
17	34432581	rs1719149	T	C	13	5	18	0	0	18	0	0
17	34432586	rs1719150	A	G	17	8	25	0	0	25	0	0
17	34432663	rs1049807	A	G	123	80	203	0	1	204	0	0
17	34432664	rs1719152	T	A	121	79	200	0	4	204	0	0
17	34842521	rs4796224	A	G	4	4	8	0	0	8	0	0
17	34848874	rs2306589	T	C	4	8	12	0	0	12	0	0
17	34853103	rs12948803	A	C	5	2	7	0	0	7	0	0
17	34853333	rs140582228	T	A	11	5	16	0	0	16	0	0
17	34854280	rs2306590	G	A	34	43	77	0	1	78	0	0
17	34866915	rs8070260	A	G	7	8	15	0	0	15	0	0
17	34869155	rs8882	G	A	27	32	59	0	1	60	0	0
17	34900836	rs3736166	G	C	61	23	84	0	2	86	0	0
17	34900847	rs3736167	A	C	30	65	95	0	0	95	0	0
17	34904985	rs12601380	A	C	3	3	6	0	0	6	0	0
17	34905408	rs9906189	A	G	5	3	8	0	0	8	0	0
17	34929379	rs59720361	A	G	4	4	8	0	0	8	0	0
17	34941376	rs34758451	C	T	4	2	6	0	0	6	0	0
17	34942595	rs1106908	G	A	291	344	635	0	4	639	0	0
17	34942750	rs1076184	T	A	32	20	52	0	0	52	0	0
17	34942870	rs1106907	A	T	16	16	32	0	0	32	0	0
17	34943719	rs3744593	C	T	7	10	17	0	0	17	0	0
17	34944593	rs17619821	G	A	40	39	79	0	0	79	0	0
17	34945034	.	A	T	35	36	71	0	1	72	0	0
17	34951091	rs2285641	C	T	4	4	8	0	0	8	0	0
17	34951204	rs2285640	G	A	2	4	6	0	0	6	0	0
17	34951327	rs2285639	C	T	2	6	8	0	0	8	0	0
17	34965349	rs1061121	T	C	3	3	6	0	1	7	0	0
17	35443538	rs12451927	C	T	13	15	28	0	0	28	0	0
17	35448211	rs9895998	G	T	3	4	7	0	0	7	0	0
17	35696804	rs58654829	G	A	4	3	7	0	0	7	0	0
17	35766475	rs72828246	A	G	12	17	29	0	0	29	0	0
17	35771468	rs7211875	C	T	5	22	27	0	0	27	0	0
17	35821931	rs853192	G	C	5	1	6	0	0	6	0	0
17	35839066	rs2074412	C	T	3	4	7	0	0	7	0	0
17	35873324	rs1051849	T	C	43	24	67	0	0	67	0	0
17	35875629	rs58781505	T	C	7	3	10	0	0	10	0	0
17	35876814	rs79356259	C	T	4	5	9	0	1	10	0	0
17	36003420	rs35498905	G	C	16	14	30	0	0	30	0	0
17	36348950	.	C	T	0	10	10	0	0	10	0	0
17	36352489	.	A	C	80	0	80	0	2	82	0	0
17	36353761	.	C	T	149	0	149	0	2	151	0	0
17	36357295	.	A	G	16	0	16	0	0	16	0	0
17	36361992	.	C	T	0	9	9	0	0	9	0	0
17	36622482	rs8075324	G	C	8	11	19	0	0	19	0	0
17	36882064	.	T	C	70	63	133	0	1	134	0	0
17	36882595	rs11543289	T	A	96	112	208	0	1	209	0	0
17	36882652	rs550355516	G	C	88	94	182	0	0	182	0	0
17	36883953	rs1139109	C	T	104	89	193	0	0	193	0	0
17	36913807	rs12951408	T	C	1	7	8	0	0	8	0	0
17	36918350	rs228279	T	C	16	24	40	0	0	40	0	0
17	36918551	rs228280	G	T	43	29	72	0	0	72	0	0
17	36922196	rs1043515	A	G	28	25	53	0	0	53	0	0
17	36922510	rs228285	G	A	26	29	55	0	0	55	0	0
17	36922839	rs228286	C	G	28	23	51	0	0	51	0	0
17	36926731	rs228289	T	G	10	10	20	0	0	20	0	0
17	36926767	rs228290	G	A	10	9	19	0	0	19	0	0
17	36957048	rs228250	G	A	257	221	478	0	3	482	1	0
17	36958065	rs8592	A	G	217	201	418	0	4	422	0	0
17	36962670	rs228249	A	G	19	22	41	0	1	42	0	0
17	36966321	rs626866	T	C	12	8	20	0	0	20	0	0
17	36968171	rs678381	T	C	5	3	8	0	0	8	0	0
17	37004449	rs8074919	T	C	11	14	25	0	0	25	0	0
17	37005017	rs3826293	C	T	10	14	24	0	1	25	0	0
17	37006131	rs1239176	T	C	17	29	46	0	0	46	0	0
17	37053165	rs1038651	C	T	1	6	7	0	0	7	0	0
17	37054772	rs1130638	C	T	134	94	228	0	1	229	0	0
17	37070658	rs525989	A	G	109	115	224	0	2	226	0	0
17	37071995	rs569502	T	C	9	4	13	0	0	13	0	0
17	37072625	rs12601606	C	G	5	3	8	0	0	8	0	0
17	37072641	rs8077141	C	T	5	5	10	0	0	10	0	0
17	37074493	rs112436484	C	T	4	3	7	0	0	7	0	0
17	37076331	rs646097	G	A	233	219	452	0	2	454	0	0
17	37223636	rs3254	T	C	3	3	6	0	0	6	0	0
17	37357034	rs16530	C	T	7	3	10	0	0	10	0	0
17	37359712	.	G	A	5	1	6	0	0	6	0	0
17	37627387	rs56158954	A	G	50	39	89	0	0	89	0	0
17	37651644	.	T	G	11	0	11	0	3	14	0	0
17	37651651	.	T	G	10	0	10	0	4	14	0	0
17	37682657	rs4404103	A	G	18	14	32	0	1	33	0	0
17	37683153	rs4541107	T	C	12	10	22	0	0	22	0	0
17	37683231	rs3889368	C	T	16	12	28	0	0	28	0	0
17	37683548	rs1077715	A	T	20	16	36	0	1	37	0	0
17	37684407	rs7405770	T	A	6	8	14	0	0	14	0	0
17	37684990	rs55660616	C	A	15	8	23	0	0	23	0	0
17	37706243	rs7219909	C	T	6	3	9	0	0	9	0	0
17	37706578	rs6503519	A	G	8	4	12	0	1	13	0	0
17	37716771	rs4795384	C	G	5	2	7	0	0	7	0	0
17	37814080	rs1877031	G	A	84	55	139	0	1	140	0	0
17	37815899	rs11658786	G	A	7	8	15	0	0	15	0	0
17	37817482	rs2271308	T	C	5	4	9	0	0	9	0	0
17	37821435	rs931992	G	T	9	5	14	0	0	14	0	0
17	37822311	rs1053651	A	C	57	44	101	0	1	102	0	0
17	37828072	rs14050	C	T	60	52	112	0	2	114	0	0
17	37828496	rs2952151	T	C	55	43	98	0	1	99	0	0
17	37828745	rs2941503	A	G	45	40	85	0	0	85	0	0
17	37828787	rs907087	G	A	50	38	88	0	1	89	0	0
17	37830900	rs2941504	A	G	37	25	62	0	2	64	0	0
17	37884037	rs1058808	C	G	4	7	11	0	0	11	0	0
17	38062196	rs2305480	G	A	7	3	10	0	0	10	0	0
17	38062217	rs2305479	C	T	11	5	16	0	0	16	0	0
17	38137364	rs3087852	G	A	75	40	115	0	2	117	0	0
17	38137623	rs8075668	C	T	9	9	18	0	1	19	0	0
17	38138624	rs2305481	G	A	7	5	12	0	0	12	0	0
17	38146154	rs9916279	T	C	192	203	395	0	3	398	0	0
17	38147293	rs11654706	A	G	3	6	9	0	0	9	0	0
17	38147294	rs11078931	C	T	6	3	9	0	0	9	0	0
17	38148210	rs11078932	C	T	1	6	7	0	0	7	0	0
17	38149258	rs58212353	T	G	3	10	13	0	0	13	0	0
17	38149411	rs34648856	G	A	3	5	8	0	0	8	0	0
17	38153473	rs12453334	C	T	6	6	12	0	1	13	0	0
17	38154084	rs2012	G	C	192	217	409	0	1	411	1	0
17	38173737	rs2827	C	T	2	5	7	0	0	7	0	0
17	38175462	rs12309	C	T	225	137	362	0	19	381	0	0
17	38175866	rs11555254	G	A	166	187	353	0	2	355	0	0
17	38176256	rs2270401	A	T	7	4	11	0	0	11	0	0
17	38177839	rs12453732	A	C	14	9	23	0	0	23	0	0
17	38178149	rs2302776	A	G	9	6	15	0	0	15	0	0
17	38179492	rs2302777	A	G	66	76	142	0	3	145	0	0
17	38179667	rs2302778	A	G	14	26	40	0	0	40	0	0
17	38180352	rs34453912	T	A	6	13	19	0	0	19	0	0
17	38181133	rs12453341	C	T	9	6	15	0	0	15	0	0
17	38181134	rs143199581	G	A	6	9	15	0	0	15	0	0
17	38181168	rs12451547	T	C	5	3	8	0	1	9	0	0
17	38181176	rs12453343	C	A	9	2	11	0	0	11	0	0
17	38182081	rs7503939	A	G	13	8	21	0	0	21	0	0
17	38182229	rs9916158	G	T	7	7	14	0	0	14	0	0
17	38182844	rs2302775	T	C	39	29	68	0	0	68	0	0
17	38183090	rs2302774	G	T	12	15	27	0	0	27	0	0
17	38188419	rs3935281	C	T	4	7	11	0	0	11	0	0
17	38240216	rs2230701	C	T	57	53	110	0	0	110	0	0
17	38244409	rs36088892	C	T	5	3	8	0	0	8	0	0
17	38245791	rs12939700	C	A	19	30	49	0	0	49	0	0
17	38246454	rs34826591	A	G	34	42	76	0	5	81	0	0
17	38256693	rs939347	G	A	4	4	8	0	0	8	0	0
17	38289003	rs7211770	A	G	5	1	6	0	0	6	0	0
17	38350583	rs45567834	G	A	8	16	24	0	0	24	0	0
17	38351626	rs3744806	C	G	53	46	99	0	0	99	0	0
17	38436696	rs9894625	G	A	38	36	74	0	0	74	0	0
17	38439307	rs1807273	G	A	2	4	6	0	0	6	0	0
17	38457151	rs13706	G	A	36	30	66	0	1	67	0	0
17	38500914	rs9303285	T	C	2	4	6	0	0	6	0	0
17	38500928	rs9303286	G	C	3	3	6	0	0	6	0	0
17	38504241	rs482284	A	G	1	5	6	0	0	6	0	0
17	38782286	rs7226035	C	T	4	10	14	0	1	15	0	0
17	38782343	rs7224919	G	A	5	6	11	0	0	11	0	0
17	38804561	rs3752026	A	C	3	11	14	0	0	14	0	0
17	38974634	rs117588718	G	A	163	198	361	0	4	365	0	0
17	38991003	rs10558	T	C	2	6	8	0	0	8	0	0
17	38991032	rs6694	T	A	2	6	8	0	0	8	0	0
17	39935287	rs62065901	A	G	3	3	6	0	0	6	0	0
17	39935292	rs62065902	G	T	3	3	6	0	0	6	0	0
17	39939430	rs74871137	A	G	6	3	9	0	0	9	0	0
17	39979062	rs1043002	T	A	11	16	27	0	1	28	0	0
17	39979081	rs1043005	C	G	10	16	26	0	0	26	0	0
17	39979082	rs1043007	C	G	10	16	26	0	0	26	0	0
17	39983808	rs1046404	G	C	42	12	54	0	0	54	0	0
17	39983820	rs1046403	G	A	41	11	52	0	0	52	0	0
17	39983849	rs1128966	G	C	41	12	53	0	1	54	0	0
17	40010979	rs3744782	G	A	18	16	34	0	0	34	0	0
17	40021498	rs61743192	G	A	4	2	6	0	0	6	0	0
17	40023467	rs7713	A	C	101	116	217	0	0	217	0	0
17	40049694	rs9899285	G	A	4	4	8	0	0	8	0	0
17	40052642	rs35896706	A	G	6	0	6	0	0	6	0	0
17	40065774	rs2304497	T	G	34	27	61	0	0	61	0	0
17	40088795	rs73307798	T	G	4	7	11	0	0	11	0	0
17	40089762	rs35140765	G	A	5	4	9	0	0	9	0	0
17	40090520	rs8073987	C	T	4	3	7	0	0	7	0	0
17	40099978	rs35459707	C	T	25	12	37	0	0	37	0	0
17	40120771	rs8078650	T	G	2	4	6	0	1	7	0	0
17	40123521	rs11079027	A	G	4	3	7	0	0	7	0	0
17	40123829	rs12602950	G	A	6	2	8	0	0	8	0	0
17	40126133	rs11079028	G	A	23	7	30	0	1	31	0	0
17	40127060	rs11296	T	C	33	27	60	0	0	60	0	0
17	40257163	rs2074158	T	C	26	32	58	0	0	58	0	0
17	40258890	rs76296207	G	T	4	7	11	0	1	12	0	0
17	40259344	rs11868073	A	G	5	3	8	0	0	8	0	0
17	40263400	rs35118457	C	T	35	18	53	0	0	53	0	0
17	40264125	rs3744484	A	T	6	4	10	0	0	10	0	0
17	40264661	rs2277621	C	G	5	2	7	0	0	7	0	0
17	40278081	rs2240010	T	A	15	70	85	0	1	86	0	0
17	40279680	rs731152	G	A	18	8	26	0	0	26	0	0
17	40283413	rs2014521	C	G	6	10	16	0	0	16	0	0
17	40284191	rs9915255	C	T	4	2	6	0	0	6	0	0
17	40284783	rs7208907	C	T	0	6	6	0	0	6	0	0
17	40288278	rs9912088	T	C	3	3	6	0	0	6	0	0
17	40449362	rs12453256	G	A	2	5	7	0	0	7	0	0
17	40486688	.	C	T	4	2	6	0	0	6	0	0
17	40536804	rs62075782	G	C	6	1	7	0	0	7	0	0
17	40639422	rs8069972	G	A	1	5	6	0	0	6	0	0
17	40658533	rs4411548	C	T	3	4	7	0	0	7	0	0
17	40661458	.	C	A	3	3	6	0	0	6	0	0
17	40698542	rs12453490	A	G	3	4	7	0	0	7	0	0
17	40703023	rs185590894	T	G	4	2	6	0	0	6	0	0
17	40704563	rs2830	G	A	12	2	14	0	0	14	0	0
17	40705100	rs597255	C	T	22	13	35	0	0	35	0	0
17	40705715	rs610166	G	A	11	11	22	0	1	23	0	0
17	40705724	rs610177	T	G	12	13	25	0	1	26	0	0
17	40705955	rs2676530	C	T	8	10	18	0	0	18	0	0
17	40714804	rs615942	C	A	60	56	116	0	0	116	0	0
17	40715570	rs666039	G	T	6	9	15	0	0	15	0	0
17	40716520	rs598126	A	G	136	117	253	0	1	254	0	0
17	40720605	rs646174	G	A	3	6	9	0	0	9	0	0
17	40721360	rs632758	C	A	7	9	16	0	0	16	0	0
17	40721850	rs17671179	C	G	15	21	36	0	0	36	0	0
17	40724276	rs679	C	T	49	40	89	0	0	89	0	0
17	40725656	rs2292752	G	C	9	10	19	0	0	19	0	0
17	40725799	rs2292751	C	T	3	4	7	0	1	8	0	0
17	40727427	rs1004295	C	G	2	5	7	0	1	8	0	0
17	40728229	rs878291	C	T	4	5	9	0	0	9	0	0
17	40732698	rs8079855	A	G	15	23	38	0	1	39	0	0
17	40738610	rs55985470	T	C	4	2	6	0	0	6	0	0
17	40766546	rs1045710	C	G	39	23	62	0	0	62	0	0
17	40818451	rs1554227	G	A	11	4	15	0	0	15	0	0
17	40818699	rs1046097	A	G	6	6	12	0	0	12	0	0
17	40822678	rs2277618	C	T	3	13	16	0	0	16	0	0
17	40852841	rs9766	G	A	33	45	78	0	0	78	0	0
17	41009222	.	G	C	6	3	9	0	0	9	0	0
17	41104112	rs2292539	G	A	6	8	14	0	0	14	0	0
17	41106085	rs7218454	T	C	1	5	6	0	0	6	0	0
17	41106265	rs7213940	C	T	5	2	7	0	1	8	0	0
17	41107401	.	A	G	6	9	15	0	1	16	0	0
17	41131645	rs35444712	C	A	3	8	11	0	0	11	0	0
17	41145527	rs1043284	C	T	7	15	22	0	0	22	0	0
17	41150949	rs2271539	G	A	12	17	29	0	0	29	0	0
17	41151190	rs12451424	T	C	9	11	20	0	1	21	0	0
17	41165432	rs73983785	T	C	7	5	12	0	0	12	0	0
17	41166417	rs10840	G	A	18	21	39	0	0	39	0	0
17	41167957	rs455055	C	A	168	153	321	0	10	331	0	0
17	41174025	rs2070835	A	C	50	42	92	0	3	95	0	0
17	41196408	rs12516	G	A	5	7	12	0	0	12	0	0
17	41197274	rs8176318	C	A	5	5	10	0	0	10	0	0
17	41223094	rs1799966	T	C	8	8	16	0	0	16	0	0
17	41234470	rs1060915	A	G	7	3	10	0	0	10	0	0
17	41244936	rs799917	G	A	6	0	6	0	0	6	0	0
17	41279561	rs799910	G	C	5	3	8	0	0	8	0	0
17	41284699	rs11650848	A	G	9	2	11	0	0	11	0	0
17	41284742	rs6503726	T	C	8	2	10	0	0	10	0	0
17	41284792	rs11651905	T	A	8	0	8	0	0	8	0	0
17	41286822	rs2175957	T	G	6	4	10	0	0	10	0	0
17	41287145	rs1554063	T	C	9	5	14	0	0	14	0	0
17	41287880	rs33988650	A	G	9	8	17	0	0	17	0	0
17	41287924	rs33961729	C	A	10	7	17	0	1	18	0	0
17	41288843	rs79345851	A	G	21	15	36	0	0	36	0	0
17	41291779	rs4792978	G	T	4	2	6	0	0	6	0	0
17	41298434	rs33933224	T	C	9	2	11	0	0	11	0	0
17	41298499	rs4793210	G	A	13	2	15	0	1	16	0	0
17	41298515	rs4792979	C	T	14	2	16	0	0	16	0	0
17	41300799	rs11079056	C	A	7	22	29	0	0	29	0	0
17	41305397	rs1960605	C	T	6	0	6	0	0	6	0	0
17	41361960	rs8482	A	G	14	17	31	0	1	32	0	0
17	41362272	rs748620	C	G	15	17	32	0	0	32	0	0
17	41362721	rs13119	C	T	27	14	41	0	0	41	0	0
17	41371844	rs13851	A	G	3	5	8	0	0	8	0	0
17	41371958	rs13539	T	C	6	2	8	0	0	8	0	0
17	41381938	.	C	G	5	2	7	0	0	7	0	0
17	41602518	rs1971	G	A	22	20	42	0	0	42	0	0
17	42088853	rs12889	G	A	58	39	97	0	0	97	0	0
17	42155838	rs9913925	G	A	16	11	27	0	0	27	0	0
17	42160410	rs117114632	G	A	17	6	23	0	0	23	0	0
17	42272586	rs11652516	G	A	1	5	6	0	0	6	0	0
17	42278272	.	A	G	9	9	18	0	0	18	0	0
17	42283037	rs9910055	C	T	122	99	221	0	2	223	0	0
17	42284596	rs138321189	G	T	146	110	256	0	3	259	0	0
17	42285740	rs9895423	T	C	3	6	9	0	0	9	0	0
17	42287519	rs2071167	C	T	92	89	181	0	4	185	0	0
17	42300278	rs10208	C	T	19	16	35	0	0	35	0	0
17	42326258	rs5033	C	T	13	14	27	0	0	27	0	0
17	42327493	rs2072081	G	T	9	5	14	0	0	14	0	0
17	42401002	rs72824725	G	A	14	20	34	0	0	34	0	0
17	42423556	rs2879096	C	T	5	3	8	0	0	8	0	0
17	42454270	rs850731	T	C	14	17	31	0	0	31	0	0
17	42466043	rs9903206	C	T	3	8	11	0	0	11	0	0
17	42475983	rs936019	G	C	59	64	123	0	1	124	0	0
17	42568770	rs8074093	G	T	1	5	6	0	0	6	0	0
17	42762718	rs17627539	A	T	3	3	6	0	0	6	0	0
17	42928054	rs2304986	T	C	4	5	9	0	0	9	0	0
17	42945296	rs2120276	A	G	5	8	13	0	0	13	0	0
17	42945867	rs3785890	A	G	9	11	20	0	0	20	0	0
17	42948635	rs75868785	C	T	4	3	7	0	0	7	0	0
17	42953409	rs2289674	A	G	70	78	148	0	0	148	0	0
17	42961009	rs2289677	C	T	5	8	13	0	0	13	0	0
17	43002672	rs7214258	A	G	10	7	17	0	0	17	0	0
17	43002687	rs141842046	C	T	8	8	16	0	1	17	0	0
17	43248440	.	A	G	7	3	10	0	0	10	0	0
17	43307457	rs145972883	G	A	7	1	8	0	0	8	0	0
17	43471481	rs7613	G	A	116	109	225	0	0	226	1	0
17	43471489	rs4763	G	A	123	126	249	0	2	251	0	0
17	43474440	rs1230095	C	G	9	20	29	0	0	29	0	0
17	43474668	rs62064598	C	G	17	11	28	0	1	29	0	0
17	43475929	rs2028078	G	A	6	3	9	0	0	9	0	0
17	43476527	rs1230096	A	T	5	9	14	0	0	14	0	0
17	43478713	rs1230099	G	A	6	3	9	0	0	9	0	0
17	43479748	rs55793500	T	C	1	6	7	0	0	7	0	0
17	43507649	rs7222444	A	G	2	6	8	0	0	8	0	0
17	43513441	rs11012	C	T	130	121	251	0	3	254	0	0
17	43513551	rs9730	C	G	176	124	300	0	0	300	0	0
17	43513896	rs62064654	C	T	132	93	225	0	2	227	0	0
17	43514411	rs2521717	G	C	96	91	187	0	0	187	0	0
17	43514954	rs62064655	G	A	78	48	126	0	2	128	0	0
17	43516402	rs17631303	A	G	5	1	6	0	0	6	0	0
17	43516739	rs35591873	G	A	8	1	9	0	0	9	0	0
17	43520398	rs3845202	G	T	2	5	7	0	0	7	0	0
17	43522361	rs62065378	T	C	8	0	8	0	0	8	0	0
17	43525022	rs71373572	G	A	8	1	9	0	1	10	0	0
17	43543083	rs7219532	T	A	43	58	101	0	4	105	0	0
17	43543207	rs62065396	T	C	42	40	82	0	1	83	0	0
17	43544206	rs2959992	G	C	23	11	34	0	0	34	0	0
17	43544379	rs55663797	G	A	16	27	43	0	0	43	0	0
17	43545893	rs1879581	T	C	32	53	85	0	0	85	0	0
17	43547481	.	A	G	3	3	6	0	0	6	0	0
17	43547855	.	C	T	3	3	6	0	0	6	0	0
17	43549526	rs17631676	A	G	3	3	6	0	0	6	0	0
17	43549608	rs149366495	G	A	8	6	14	0	0	14	0	0
17	43550107	rs2090847	A	G	6	3	9	0	0	9	0	0
17	43551083	rs55746869	C	T	4	7	11	0	0	11	0	0
17	43551151	rs12950965	C	G	11	8	19	0	0	19	0	0
17	43551321	rs56015792	G	C	5	8	13	0	0	13	0	0
17	43551523	rs62065403	T	C	6	5	11	0	0	11	0	0
17	43551546	rs77132763	C	T	6	6	12	0	0	12	0	0
17	43551613	rs62065404	C	T	7	8	15	0	0	15	0	0
17	43551672	rs2037442	C	T	11	9	20	0	0	20	0	0
17	43552106	rs4792859	C	T	6	7	13	0	0	13	0	0
17	43552537	rs71238846	G	A	51	59	110	0	1	111	0	0
17	43552717	rs12452076	G	C	46	33	79	0	1	80	0	0
17	43552812	rs2521859	A	G	51	17	68	0	0	68	0	0
17	43552921	rs12452273	C	T	32	29	61	0	0	61	0	0
17	43663247	rs1724390	C	A	5	27	32	0	0	32	0	0
17	43663461	.	T	C	35	0	35	0	0	35	0	0
17	43663761	.	G	T	7	0	7	0	0	7	0	0
17	43679121	rs62066068	G	A	0	22	22	0	0	22	0	0
17	43679132	rs56191889	A	G	0	25	25	0	0	25	0	0
17	43713925	rs241041	A	G	7	24	31	0	1	32	0	0
17	43714190	rs241040	A	T	9	5	14	0	0	14	0	0
17	43714673	rs241039	A	T	5	9	14	0	0	14	0	0
17	43714850	rs2942168	G	A	7	5	12	0	0	12	0	0
17	43715018	rs2942167	T	C	8	5	13	0	0	13	0	0
17	43716885	rs413778	A	G	11	11	22	0	0	22	0	0
17	43723462	rs3418	C	T	5	7	12	0	1	13	0	0
17	44108100	rs7350928	C	T	211	203	414	0	4	418	0	0
17	44108202	rs17574361	A	G	191	185	376	0	2	379	1	0
17	44108355	rs17652961	G	A	218	209	427	0	3	430	0	0
17	44108906	rs34579536	A	G	77	92	169	0	3	172	0	0
17	44109188	rs17574425	C	G	12	3	15	0	0	15	0	0
17	44109248	rs55881134	G	A	7	4	11	0	0	11	0	0
17	44109769	rs1076222	C	G	17	17	34	0	2	36	0	0
17	44110271	rs7350980	G	A	10	22	32	0	0	32	0	0
17	44110532	rs36076725	G	A	86	85	171	0	3	174	0	0
17	44110541	rs35833914	G	A	93	79	172	0	0	172	0	0
17	44110670	rs4597358	C	G	20	15	35	0	0	35	0	0
17	44110888	rs77009866	A	T	3	3	6	0	0	6	0	0
17	44111109	rs62062321	A	G	4	2	6	0	0	6	0	0
17	44111613	rs17574604	A	G	87	88	175	0	1	176	0	0
17	44111827	rs17653162	C	A	4	4	8	0	0	8	0	0
17	44112385	rs62062322	A	G	3	5	8	0	0	8	0	0
17	44112441	rs17653193	G	A	1	6	7	0	0	7	0	0
17	44112638	rs17653211	T	C	6	3	9	0	1	10	0	0
17	44112743	rs17653255	C	A	1	5	6	0	0	6	0	0
17	44113224	rs62062323	C	T	3	3	6	0	0	6	0	0
17	44113491	rs12185225	T	C	4	2	6	0	0	6	0	0
17	44117119	rs34043286	A	G	105	93	198	0	2	200	0	0
17	44117397	rs10514897	A	G	4	2	6	0	0	6	0	0
17	44118848	rs62062137	G	A	3	3	6	0	0	6	0	0
17	44159849	rs17576165	T	C	52	72	124	0	0	124	0	0
17	44173812	rs62061798	G	A	2	8	10	0	0	10	0	0
17	44174068	rs62061799	T	C	1	5	6	0	0	6	0	0
17	44174109	rs62061800	G	C	0	9	9	0	0	9	0	0
17	44213187	rs12150295	G	T	4	2	6	0	0	6	0	0
17	44213204	rs12150320	C	T	0	6	6	0	0	6	0	0
17	44213712	rs2532316	G	A	0	6	6	0	0	6	0	0
17	44213921	rs2696605	A	C	0	6	6	0	0	6	0	0
17	44213934	rs2532315	G	A	0	7	7	0	0	7	0	0
17	44225802	rs1406070	C	T	8	7	15	0	2	17	0	0
17	44226030	rs2696585	G	A	8	8	16	0	0	16	0	0
17	44226126	rs2532304	A	C	3	5	8	0	0	8	0	0
17	44226325	rs2696584	A	T	10	2	12	0	0	12	0	0
17	44226331	rs2696583	A	G	10	2	12	0	0	12	0	0
17	44226817	rs1558247	G	A	13	8	21	0	0	21	0	0
17	44226980	rs62063238	A	G	15	2	17	0	0	17	0	0
17	44227623	rs2696578	T	C	2	8	10	0	0	10	0	0
17	44227882	rs2696577	C	G	8	1	9	0	0	9	0	0
17	44228169	rs1918793	C	T	1	8	9	0	0	9	0	0
17	44228770	rs2696576	A	G	3	3	6	0	0	6	0	0
17	44228824	rs2696575	A	G	3	5	8	0	0	8	0	0
17	44230166	rs62063243	G	A	4	3	7	0	0	7	0	0
17	44244896	rs2532282	C	G	14	1	15	0	0	15	0	0
17	44244926	rs2696657	T	G	3	16	19	0	0	19	0	0
17	44245171	rs2532281	G	T	7	1	8	0	0	8	0	0
17	44245359	rs2532280	G	A	4	3	7	0	0	7	0	0
17	44245876	rs2696659	A	G	1	8	9	0	0	9	0	0
17	44246527	.	T	C	7	3	10	0	0	10	0	0
17	44246624	.	C	A	6	7	13	0	0	13	0	0
17	44246997	rs2532275	G	A	10	7	17	0	0	17	0	0
17	44247164	rs2532274	A	G	4	7	11	0	0	11	0	0
17	44247314	rs2532273	C	T	22	11	33	0	0	33	0	0
17	44248499	.	G	C	180	68	248	0	3	251	0	0
17	44248769	rs1881193	T	C	59	175	234	0	3	237	0	0
17	44248814	rs1881194	G	A	52	184	236	0	1	237	0	0
17	44248837	rs35643216	T	C	128	81	209	0	1	210	0	0
17	44248848	.	G	A	158	51	209	0	2	211	0	0
17	44249096	rs17662889	A	C	101	59	160	0	0	160	0	0
17	44249199	rs17585974	T	G	102	62	164	0	2	166	0	0
17	44268697	rs1852633	A	C	10	0	10	0	0	10	0	0
17	44269922	.	T	C	15	3	18	0	0	18	0	0
17	44269964	.	T	A	4	14	18	0	0	18	0	0
17	44270059	.	A	T	3	6	9	0	0	9	0	0
17	44273889	rs1048343	C	T	8	18	26	0	0	26	0	0
17	44273919	rs1048333	A	G	7	15	22	0	0	22	0	0
17	44321527	rs2732715	C	T	0	30	30	0	0	30	0	0
17	44336943	.	C	T	0	18	18	0	0	18	0	0
17	44336962	.	G	A	19	0	19	0	0	19	0	0
17	44336976	rs2469937	C	T	20	0	20	0	0	20	0	0
17	44344822	rs76934998	G	A	10	0	10	0	0	10	0	0
17	44352361	rs2668623	C	T	6	1	7	0	0	7	0	0
17	44354530	rs2261200	T	A	5	3	8	0	0	8	0	0
17	44354587	rs2668630	A	G	0	6	6	0	0	6	0	0
17	44354908	.	C	T	9	1	10	0	0	10	0	0
17	44355162	rs2696534	A	G	2	8	10	0	0	10	0	0
17	44355173	rs111446248	T	C	2	8	10	0	0	10	0	0
17	44355602	rs2696532	A	G	0	7	7	0	0	7	0	0
17	44355683	.	G	A	0	8	8	0	0	8	0	0
17	44356098	rs2696529	A	C	6	0	6	0	0	6	0	0
17	44356186	.	G	A	0	7	7	0	0	7	0	0
17	44356320	rs2696528	C	T	15	0	15	0	0	15	0	0
17	44356394	rs75342548	T	G	1	13	14	0	0	14	0	0
17	44356410	rs74390346	T	C	1	17	18	0	0	18	0	0
17	44356433	rs2696527	G	T	17	0	17	0	0	17	0	0
17	44356436	rs76167437	T	C	1	16	17	0	0	17	0	0
17	44356694	rs111912558	T	C	0	9	9	0	0	9	0	0
17	44356746	rs113896715	T	C	0	9	9	0	0	9	0	0
17	44356793	rs2696524	A	G	0	10	10	0	0	10	0	0
17	44356806	.	C	T	0	8	8	0	0	8	0	0
17	44356830	.	A	G	0	6	6	0	0	6	0	0
17	44356949	rs78569719	T	C	0	11	11	0	0	11	0	0
17	44357157	.	A	G	1	11	12	0	0	12	0	0
17	44357172	rs113130019	C	T	1	8	9	0	0	9	0	0
17	44357198	rs80296410	G	A	2	8	10	0	0	10	0	0
17	44357284	.	T	C	1	8	9	0	0	9	0	0
17	44357297	rs17588637	G	T	1	9	10	0	0	10	0	0
17	44357304	.	C	T	1	11	12	0	0	12	0	0
17	44357351	rs17665188	T	C	0	9	9	0	0	9	0	0
17	44357360	rs75033119	G	A	0	13	13	0	0	13	0	0
17	44357392	rs112254607	C	A	11	0	11	0	0	11	0	0
17	44357453	rs74839514	G	T	0	6	6	0	0	6	0	0
17	44357466	.	C	T	7	0	7	0	0	7	0	0
17	44357476	.	C	T	0	6	6	0	0	6	0	0
17	44358107	rs2696516	G	T	0	7	7	0	0	7	0	0
17	44358109	rs2696515	A	T	0	7	7	0	0	7	0	0
17	44358128	.	C	T	0	10	10	0	0	10	0	0
17	44358146	rs2532323	G	A	10	0	10	0	0	10	0	0
17	44358251	.	C	T	1	6	7	0	0	7	0	0
17	44361383	rs2458218	T	C	8	1	9	0	0	9	0	0
17	44361861	rs2696508	T	G	2	6	8	0	0	8	0	0
17	44361869	rs2696507	G	C	1	7	8	0	0	8	0	0
17	44364538	rs2950680	G	C	6	0	6	0	0	6	0	0
17	44365744	.	G	A	13	0	13	0	0	13	0	0
17	44365804	.	A	G	0	15	15	0	0	15	0	0
17	44365897	rs2696492	C	T	19	0	19	0	0	19	0	0
17	44366025	.	G	A	6	1	7	0	1	8	0	0
17	44366550	.	G	A	0	7	7	0	0	7	0	0
17	44408795	rs2667848	G	A	0	9	9	0	0	9	0	0
17	44506556	.	A	G	4	4	8	0	0	8	0	0
17	44625866	rs199913382	A	C	1	5	6	0	0	6	0	0
17	44625928	rs1863115	C	A	1	13	14	0	2	16	0	0
17	44626347	.	T	C	29	104	133	0	2	135	0	0
17	44632734	.	A	G	57	149	206	0	1	207	0	0
17	44633501	.	G	A	8	3	11	0	0	11	0	0
17	44635425	.	T	C	6	0	6	0	0	6	0	0
17	44799216	rs199455	C	T	16	0	16	0	15	32	1	0
17	44828931	rs199533	G	A	14	13	27	0	0	27	0	0
17	44833217	rs35732828	C	A	7	19	26	0	0	26	0	0
17	45017193	rs11874	G	A	7	4	11	0	1	12	0	0
17	45017837	rs11657819	G	A	7	6	13	0	0	13	0	0
17	45076183	rs77212031	C	G	4	4	8	0	0	8	0	0
17	45098955	rs58031983	G	T	19	7	26	0	0	26	0	0
17	45110359	rs2959964	C	G	6	0	6	0	0	6	0	0
17	45110686	.	G	C	12	24	36	0	1	37	0	0
17	45388586	rs3809865	T	A	3	5	8	0	0	8	0	0
17	45390472	rs9916007	C	T	13	15	28	0	0	28	0	0
17	45390562	rs8068200	A	G	15	22	37	0	0	37	0	0
17	45390873	rs9894860	C	A	16	11	27	0	1	28	0	0
17	45390951	rs12600603	G	C	23	10	33	0	0	33	0	0
17	45391015	rs9893410	G	T	18	8	26	0	0	26	0	0
17	45393739	rs11079772	C	A	3	3	6	0	0	6	0	0
17	45396087	rs6504833	A	G	3	3	6	0	0	6	0	0
17	45451894	rs4968318	G	A	4	5	9	0	0	9	0	0
17	45474523	rs9897492	G	A	3	4	7	0	0	7	0	0
17	45474997	rs4968320	C	A	7	11	18	0	1	19	0	0
17	45494645	rs9915919	G	A	7	3	10	0	0	10	0	0
17	45498937	rs9911944	G	T	7	0	7	0	0	7	0	0
17	45569815	rs2610367	A	G	49	42	91	0	0	91	0	0
17	45695832	rs3760370	C	T	4	4	8	0	0	8	0	0
17	45695914	rs3760371	T	C	5	2	7	0	0	7	0	0
17	45697434	rs116841331	G	T	11	10	21	0	0	21	0	0
17	45697549	rs7207542	C	G	6	7	13	0	0	13	0	0
17	45698175	rs4793978	G	A	16	13	29	0	0	29	0	0
17	45698286	.	T	C	17	14	31	0	0	31	0	0
17	45698483	rs8073834	G	A	10	7	17	0	0	17	0	0
17	45700138	rs17609248	T	C	120	102	222	0	1	223	0	0
17	45701731	rs7223029	T	C	18	8	26	0	0	26	0	0
17	45702099	rs7214799	C	T	5	6	11	0	0	11	0	0
17	45737701	rs7219303	A	G	6	3	9	0	0	9	0	0
17	45744993	rs73315878	G	A	4	3	7	0	0	7	0	0
17	45750596	rs3809868	G	A	4	2	6	0	0	6	0	0
17	45757598	rs7210738	G	A	2	4	6	0	0	6	0	0
17	45884973	rs1053800	G	A	110	118	228	0	0	228	0	0
17	45884987	rs1053798	T	C	97	105	202	0	1	203	0	0
17	45885441	rs72833429	T	G	79	98	177	0	3	180	0	0
17	45885756	rs9911983	C	T	58	70	128	0	1	129	0	0
17	45887738	rs16948401	G	A	14	8	22	0	0	22	0	0
17	45887951	rs2074189	G	T	7	10	17	0	0	17	0	0
17	45888251	rs2074188	C	G	10	5	15	0	0	15	0	0
17	45888722	rs11079795	C	T	15	8	23	0	0	23	0	0
17	45889085	rs11869958	G	A	17	11	28	0	0	28	0	0
17	45889104	rs62076104	C	A	13	14	27	0	0	27	0	0
17	45889248	rs11870002	G	A	12	17	29	0	1	30	0	0
17	45889840	rs1018903	G	A	15	5	20	0	0	20	0	0
17	45890707	rs2301690	C	T	33	42	75	0	1	76	0	0
17	45892424	rs17700574	T	C	5	2	7	0	0	7	0	0
17	45892821	rs17700604	G	A	4	6	10	0	0	10	0	0
17	45896807	rs17774008	G	C	3	4	7	0	0	7	0	0
17	45899057	rs17700839	C	T	12	19	31	0	0	31	0	0
17	45900968	rs17035	A	T	113	103	216	0	0	216	0	0
17	45901123	rs3209	T	C	133	137	270	0	2	272	0	0
17	45901378	rs11538867	G	A	101	92	193	0	0	193	0	0
17	45901480	rs701984	C	T	149	119	268	0	0	268	0	0
17	45904420	rs11538868	C	T	74	74	148	0	1	149	0	0
17	45906757	rs62076131	T	C	6	2	8	0	0	8	0	0
17	45907039	rs62076133	G	A	5	4	9	0	0	9	0	0
17	45907599	rs17774171	A	G	5	3	8	0	0	8	0	0
17	45908551	rs16948590	G	C	1	5	6	0	0	6	0	0
17	45915468	rs878295	T	G	8	9	17	0	0	17	0	0
17	45994044	rs2228253	C	T	39	29	68	0	1	69	0	0
17	45994094	rs2228251	T	C	37	31	68	0	0	68	0	0
17	45994154	rs2229358	G	A	27	20	47	0	1	48	0	0
17	46002744	rs1130932	G	T	34	49	83	0	0	83	0	0
17	46020698	rs11079804	C	T	3	4	7	0	0	7	0	0
17	46022065	rs17679445	G	A	5	2	7	0	0	7	0	0
17	46023694	rs4378657	G	A	7	4	11	0	0	11	0	0
17	46048592	rs2905846	A	G	34	19	53	0	1	54	0	0
17	46051911	rs886444	G	A	78	76	154	0	1	155	0	0
17	46052162	rs2597171	T	C	39	41	80	0	1	81	0	0
17	46052793	rs2597172	A	G	3	3	6	0	0	6	0	0
17	46056995	rs2525088	C	T	7	5	12	0	0	12	0	0
17	46057029	rs2597174	G	A	9	6	15	0	0	15	0	0
17	46103760	rs12051	A	G	5	2	7	0	0	7	0	0
17	46128122	rs8067470	A	G	74	60	134	0	4	138	0	0
17	46128359	rs12936731	G	C	63	55	118	0	2	120	0	0
17	46137905	rs1051001	C	T	151	140	291	0	2	293	0	0
17	46147807	rs6847	T	A	24	16	40	0	0	40	0	0
17	46147945	rs8438	G	A	12	11	23	0	1	24	0	0
17	46157596	rs12103808	A	G	1	5	6	0	0	6	0	0
17	46158023	rs8065464	G	A	4	2	6	0	0	6	0	0
17	46158050	rs12949879	T	C	2	4	6	0	0	6	0	0
17	46178674	rs3744347	G	A	1	7	8	0	0	8	0	0
17	46185014	rs2072441	C	G	2	7	9	0	0	9	0	0
17	46198876	rs3744346	G	C	61	64	125	0	0	125	0	0
17	46199592	rs7222136	C	G	34	54	88	0	0	88	0	0
17	46200348	rs1010228	A	C	6	6	12	0	0	12	0	0
17	46262171	rs2278868	C	T	3	13	16	0	0	16	0	0
17	46625519	rs999493	G	A	2	4	6	0	0	6	0	0
17	46636943	rs9905165	C	T	5	3	8	0	0	8	0	0
17	46672660	rs187606459	G	A	3	3	6	0	0	6	0	0
17	46922739	.	G	C	14	0	14	0	0	14	0	0
17	46924980	rs12948015	G	T	3	3	6	0	0	6	0	0
17	46929982	.	A	G	114	45	159	0	1	160	0	0
17	46934007	rs2546495	A	C	4	6	10	0	0	10	0	0
17	46939658	.	C	G	223	229	452	0	3	455	0	0
17	46941419	rs6504584	G	T	26	21	47	0	1	48	0	0
17	46942681	rs11657868	G	A	11	12	23	0	0	23	0	0
17	46942739	rs12952879	C	T	5	9	14	0	0	14	0	0
17	46943250	rs34231452	G	A	6	12	18	0	0	18	0	0
17	46970259	rs1962412	T	C	3	3	6	0	0	6	0	0
17	46972865	rs832410	C	T	7	12	19	0	0	19	0	0
17	46986616	rs28528789	C	T	5	4	9	0	0	9	0	0
17	46986679	rs62075824	A	G	10	7	17	0	0	17	0	0
17	46987665	rs999474	G	A	6	17	23	0	0	23	0	0
17	46988044	rs999475	G	A	15	20	35	0	0	35	0	0
17	46988529	rs46521	A	G	8	4	12	0	0	12	0	0
17	46988597	rs46522	C	T	6	6	12	0	0	12	0	0
17	46989154	rs9894220	A	G	7	10	17	0	0	17	0	0
17	46989354	rs318093	A	G	11	6	17	0	1	18	0	0
17	46991531	rs170319	T	C	10	7	17	0	0	17	0	0
17	46991556	rs318091	A	G	10	5	15	0	1	16	0	0
17	46991752	rs318090	G	A	9	6	15	0	0	15	0	0
17	46993233	rs3744608	C	G	7	10	17	0	0	17	0	0
17	46993370	rs4378658	G	A	6	8	14	0	0	14	0	0
17	47000251	rs1058018	C	T	116	74	190	0	1	191	0	0
17	47002389	rs62075844	G	A	4	2	6	0	0	6	0	0
17	47005193	rs15563	A	G	171	111	282	0	1	283	0	0
17	47005509	rs1057897	T	G	201	143	344	0	1	345	0	0
17	47005588	rs1057902	C	T	223	158	381	0	0	381	0	0
17	47007963	rs2270576	C	T	307	274	581	0	9	590	0	0
17	47008207	rs4793992	A	G	11	21	32	0	0	32	0	0
17	47008546	rs4793993	C	T	2	7	9	0	0	9	0	0
17	47008757	rs56046215	A	T	6	1	7	0	0	7	0	0
17	47009835	rs4399576	G	A	12	12	24	0	0	24	0	0
17	47010008	rs9889674	G	A	13	18	31	0	0	31	0	0
17	47010034	rs12602179	G	T	16	7	23	0	0	23	0	0
17	47011620	rs17708633	C	G	5	19	24	0	0	24	0	0
17	47011755	rs9904730	G	A	11	9	20	0	0	20	0	0
17	47011897	rs57901004	C	T	30	17	47	0	1	48	0	0
17	47012504	rs62075850	A	G	9	13	22	0	0	22	0	0
17	47012551	rs55917610	C	G	11	6	17	0	0	17	0	0
17	47013240	rs118118454	C	G	6	12	18	0	2	20	0	0
17	47014127	rs1994970	T	C	4	2	6	0	0	6	0	0
17	47016837	rs12232531	G	T	5	2	7	0	0	7	0	0
17	47016882	rs9747646	C	T	5	2	7	0	0	7	0	0
17	47021418	rs12603612	A	C	23	22	45	0	1	46	0	0
17	47021428	rs2411375	C	G	22	21	43	0	0	43	0	0
17	47301268	rs9889994	T	A	12	6	18	0	1	19	0	0
17	47687123	rs77954128	G	A	4	2	6	0	0	6	0	0
17	47688526	rs10514970	C	T	3	3	6	0	0	6	0	0
17	47781095	rs75544113	T	G	24	9	33	0	0	33	0	0
17	47781677	rs2289600	T	C	13	7	20	0	0	20	0	0
17	47789865	rs8064701	G	C	6	5	11	0	0	11	0	0
17	47793038	.	C	A	5	4	9	0	0	9	0	0
17	47793042	rs2017835	G	A	5	4	9	0	0	9	0	0
17	48172779	rs7221362	A	C	5	7	12	0	0	12	0	0
17	48187470	rs60269840	G	A	21	18	39	0	0	39	0	0
17	48187546	rs61328000	G	C	11	17	28	0	0	28	0	0
17	48187884	rs1063647	C	T	12	18	30	0	0	30	0	0
17	48188755	rs1053102	T	G	6	4	10	0	0	10	0	0
17	48188923	rs75762778	G	A	5	12	17	0	0	17	0	0
17	48188979	rs847690	C	T	10	12	22	0	0	22	0	0
17	48189024	rs2239953	G	A	7	13	20	0	1	21	0	0
17	48199174	rs56396804	C	G	5	2	7	0	0	7	0	0
17	48211533	rs11365	T	G	382	301	683	0	6	689	0	0
17	48212101	rs12953283	C	T	189	198	387	0	2	389	0	0
17	48216944	rs1569116	C	T	158	117	275	0	4	279	0	0
17	48262775	rs1061237	A	G	11	9	20	0	0	20	0	0
17	48433958	rs4794136	T	C	5	8	13	0	0	13	0	0
17	48437456	rs6504649	C	G	16	16	32	0	0	32	0	0
17	48438055	rs2526537	G	T	12	11	23	0	0	23	0	0
17	48438148	rs78035001	G	A	18	17	35	0	0	35	0	0
17	48445699	rs2586438	C	T	4	12	16	0	0	16	0	0
17	48457251	rs16948981	G	A	5	2	7	0	0	7	0	0
17	48457567	rs917029	G	A	6	3	9	0	0	9	0	0
17	48457609	rs917028	C	G	3	5	8	0	0	8	0	0
17	48458925	rs17741	C	T	285	280	565	0	5	570	0	0
17	48459181	rs12902	T	C	238	249	487	0	2	489	0	0
17	48539035	rs9674937	T	C	5	8	13	0	0	13	0	0
17	48549457	rs9896780	C	T	12	6	18	0	0	18	0	0
17	48549791	rs2305998	C	G	25	12	37	0	0	37	0	0
17	48552154	rs7627	G	C	13	14	27	0	1	28	0	0
17	48559559	rs7210579	A	G	13	6	19	0	0	19	0	0
17	48560883	rs1551717	A	G	8	4	12	0	0	12	0	0
17	48563234	rs557	C	T	25	17	42	0	0	42	0	0
17	48770959	rs8196	A	G	58	63	121	0	1	122	0	0
17	48778298	rs2286650	T	C	3	5	8	0	0	8	0	0
17	49330938	.	G	A	4	5	9	0	0	9	0	0
17	53039315	rs4829	C	T	7	1	8	0	0	8	0	0
17	53039483	rs7643	G	A	54	41	95	0	0	95	0	0
17	54869473	rs17822403	C	T	4	2	6	0	0	6	0	0
17	54908250	rs116946289	A	C	6	3	9	0	1	10	0	0
17	54908901	rs79899681	T	C	8	5	13	0	0	13	0	0
17	54912339	rs1048159	G	A	10	14	24	0	0	24	0	0
17	54913410	rs56380338	G	A	26	22	48	0	0	48	0	0
17	54913571	rs1040261	T	G	5	2	7	0	0	7	0	0
17	54921494	rs3760158	A	C	17	13	30	0	0	30	0	0
17	54923619	rs72837375	A	G	1	5	6	0	0	6	0	0
17	54939715	rs9911560	T	C	1	6	7	0	0	7	0	0
17	54939737	rs3826295	T	A	1	5	6	0	0	6	0	0
17	54940391	rs8071009	A	G	20	15	35	0	0	35	0	0
17	54940916	rs9897759	T	A	19	23	42	0	0	42	0	0
17	54941516	rs1992554	C	T	14	19	33	0	0	33	0	0
17	54941637	.	A	G	24	28	52	0	0	52	0	0
17	54941967	rs33932456	T	A	36	16	52	0	0	52	0	0
17	54942096	rs17833555	T	C	7	6	13	0	1	14	0	0
17	54942723	rs9911132	A	C	33	19	52	0	0	52	0	0
17	54943982	rs9893721	T	C	27	23	50	0	1	51	0	0
17	54943998	rs117022995	G	A	28	22	50	0	0	50	0	0
17	54944086	rs9892659	G	A	35	22	57	0	0	57	0	0
17	54945008	rs12150106	G	A	38	31	69	0	1	70	0	0
17	54945009	rs12150100	C	A	39	30	69	0	1	70	0	0
17	54945129	rs8078200	A	G	52	40	92	0	1	93	0	0
17	54945188	rs8078230	A	G	45	25	70	0	0	70	0	0
17	54965932	rs7615	A	G	125	104	229	0	4	233	0	0
17	54966805	rs11540270	A	G	83	104	187	0	2	189	0	0
17	54967404	rs205500	T	C	117	91	208	0	0	208	0	0
17	55156055	rs12601109	G	A	12	5	17	0	0	17	0	0
17	55183203	rs2230772	T	C	3	3	6	0	0	6	0	0
17	55183716	rs1050515	T	C	5	4	9	0	0	9	0	0
17	55197914	rs3095505	G	C	6	3	9	0	0	9	0	0
17	55198420	rs6967	C	T	11	8	19	0	0	19	0	0
17	55357716	rs7223877	G	A	7	5	12	0	0	12	0	0
17	55357921	rs144835370	C	T	4	5	9	0	0	9	0	0
17	55358728	rs6503803	G	T	3	4	7	0	0	7	0	0
17	55442184	rs1975469	G	T	7	3	10	0	1	11	0	0
17	55478748	rs61762987	A	G	100	99	199	0	0	199	0	0
17	55706937	rs2333025	C	T	4	2	6	0	0	6	0	0
17	55707828	rs8082495	G	T	5	3	8	0	0	8	0	0
17	55707928	rs8082385	C	T	6	3	9	0	0	9	0	0
17	55708267	rs72834944	A	G	8	5	13	0	0	13	0	0
17	55708429	rs28706339	G	A	6	5	11	0	0	11	0	0
17	55708490	rs3853826	C	G	6	7	13	0	0	13	0	0
17	55708632	rs3853827	A	C	2	5	7	0	0	7	0	0
17	55708812	rs3853828	A	C	5	2	7	0	0	7	0	0
17	55709380	rs3760161	A	G	38	25	63	0	0	63	0	0
17	55710036	rs3826301	T	C	55	62	117	0	0	117	0	0
17	55710048	rs75705656	C	T	64	58	122	0	0	122	0	0
17	55754573	rs2286359	G	A	8	6	14	0	0	14	0	0
17	55755313	rs12938108	G	A	7	4	11	0	0	11	0	0
17	55756196	rs11079323	C	T	4	5	9	0	0	9	0	0
17	55759115	rs1047513	T	C	25	25	50	0	1	51	0	0
17	55918466	rs112671856	G	A	5	1	6	0	0	6	0	0
17	55950064	rs35704289	C	T	6	5	11	0	0	11	0	0
17	55951037	rs17762338	C	T	7	4	11	0	0	11	0	0
17	56056550	rs1135655	C	G	115	79	194	0	2	196	0	0
17	56057346	rs8066251	A	C	2	4	6	0	1	7	0	0
17	56069926	rs11652086	C	T	39	31	70	0	1	71	0	0
17	56071490	rs8076305	T	C	35	20	55	0	1	56	0	0
17	56071497	rs6503843	A	G	36	20	56	0	0	56	0	0
17	56074750	rs8072724	A	G	25	29	54	0	0	54	0	0
17	56075850	rs7225290	A	G	20	25	45	0	1	46	0	0
17	56076127	rs76257397	G	C	11	23	34	0	0	34	0	0
17	56078738	rs8819	C	T	15	17	32	0	0	32	0	0
17	56080310	rs11654058	T	C	14	14	28	0	0	28	0	0
17	56162496	rs11079337	C	A	7	9	16	0	0	16	0	0
17	56168371	rs10132	G	A	558	543	1101	0	9	1110	0	0
17	56351816	rs11649901	A	G	18	7	25	0	0	25	0	0
17	56381389	rs2240261	T	C	20	20	40	0	2	42	0	0
17	56382512	rs11867412	C	T	106	110	216	0	4	220	0	0
17	56383187	rs3744102	C	T	8	0	8	0	0	8	0	0
17	56383744	rs11079346	T	C	182	163	345	0	3	348	0	0
17	56384022	rs11652685	A	C	51	59	110	0	0	110	0	0
17	56384928	rs36057095	C	T	21	13	34	0	0	34	0	0
17	56385509	rs2057807	T	C	10	6	16	0	1	17	0	0
17	56386118	rs2680689	A	G	86	59	145	0	1	146	0	0
17	56386358	rs2526360	T	A	84	69	153	0	2	155	0	0
17	56388238	rs2680704	C	G	45	41	86	0	1	87	0	0
17	56388683	rs12600886	C	T	4	3	7	0	0	7	0	0
17	56388927	rs2072144	T	C	7	2	9	0	0	9	0	0
17	56390423	rs2680706	A	G	18	21	39	0	0	39	0	0
17	56391719	rs2526382	G	A	18	18	36	0	0	36	0	0
17	56399100	rs2526379	G	T	18	6	24	0	2	26	0	0
17	56404349	rs2526378	A	G	8	2	10	0	0	10	0	0
17	56405858	rs2680691	T	C	30	20	50	0	1	51	0	0
17	56409089	rs2632516	G	C	105	102	207	0	1	208	0	0
17	56409571	rs2632526	C	T	336	299	635	0	9	644	0	0
17	56420163	rs2680690	A	G	4	2	6	0	0	6	0	0
17	56423114	rs8263	C	T	207	238	445	0	3	448	0	0
17	56427142	rs2526376	A	C	6	4	10	0	0	10	0	0
17	56429094	rs2526375	A	G	9	3	12	0	1	13	0	0
17	56431549	rs2680702	A	G	6	4	10	0	1	11	0	0
17	56584205	rs2302189	A	C	8	4	12	0	0	12	0	0
17	56585872	rs3744108	G	C	7	10	17	0	1	18	0	0
17	56636854	rs7225128	T	C	23	14	37	0	2	39	0	0
17	56676184	rs146947403	C	T	3	19	22	0	0	22	0	0
17	56676368	rs389389	T	C	16	9	25	0	1	26	0	0
17	56698827	rs302863	G	A	1	5	6	0	0	6	0	0
17	56708979	rs368243	T	C	9	5	14	0	1	15	0	0
17	56709034	rs411988	G	A	23	17	40	0	0	40	0	0
17	56709058	rs412000	G	C	21	24	45	0	1	46	0	0
17	56709077	rs420878	A	G	20	23	43	0	1	44	0	0
17	56709086	rs369184	C	T	17	21	38	0	1	39	0	0
17	56735123	rs451962	A	G	1	5	6	0	0	6	0	0
17	56736473	rs654778	A	C	61	55	116	0	1	117	0	0
17	56736490	rs654743	T	C	63	59	122	0	0	122	0	0
17	56736598	rs71372848	G	C	63	27	90	0	2	92	0	0
17	56756977	rs302865	A	G	9	7	16	0	0	16	0	0
17	57076104	rs28475409	T	A	32	36	68	0	0	68	0	0
17	57187729	rs7208505	G	A	27	20	47	0	0	47	0	0
17	57187795	rs7208282	C	T	18	21	39	0	0	39	0	0
17	57287454	rs6503905	A	G	8	9	17	0	0	17	0	0
17	57474923	rs10599	G	A	28	22	50	0	1	51	0	0
17	57475540	rs72839014	G	T	8	24	32	0	1	33	0	0
17	57475896	rs9905500	G	A	47	37	84	0	0	84	0	0
17	57476653	rs7221185	T	C	52	48	100	0	0	100	0	0
17	57477235	rs1451508	T	G	39	10	49	0	2	51	0	0
17	57477273	rs1451507	T	G	34	5	39	0	0	39	0	0
17	57477616	rs758379	G	A	51	61	112	0	1	113	0	0
17	57478069	rs7220373	C	G	51	55	106	0	0	106	0	0
17	57478253	rs1046037	A	C	113	88	201	0	1	202	0	0
17	57822132	rs113879993	A	G	6	2	8	0	0	8	0	0
17	58521154	rs12451779	G	A	5	3	8	0	0	8	0	0
17	58521507	rs545376966	T	A	5	3	8	0	0	8	0	0
17	59470055	rs2286530	A	C	2	5	7	0	0	7	0	0
17	59862082	rs72842992	G	A	4	4	8	0	0	8	0	0
17	59943532	rs7215076	T	C	31	13	44	0	0	44	0	0
17	60042569	rs140673828	T	C	75	80	155	0	0	155	0	0
17	60501409	rs11543000	A	G	9	13	22	0	0	22	0	0
17	60527427	rs144033353	C	G	6	7	13	0	0	13	0	0
17	60553530	rs7406820	G	A	3	4	7	0	0	7	0	0
17	60553672	rs112997374	C	T	1	6	7	0	0	7	0	0
17	60554275	rs9898829	T	G	4	5	9	0	0	9	0	0
17	60555375	rs113301871	C	T	2	9	11	0	0	11	0	0
17	60662222	rs4968766	G	T	2	6	8	0	0	8	0	0
17	60667965	rs34372896	A	C	26	37	63	0	0	63	0	0
17	60675940	rs4990253	C	T	3	4	7	0	0	7	0	0
17	60683503	rs8078132	A	G	119	97	216	0	1	217	0	0
17	60691074	rs2245092	G	A	10	10	20	0	1	21	0	0
17	60720362	rs8078112	C	T	5	2	7	0	0	7	0	0
17	61782002	rs140928028	G	T	12	7	19	0	0	19	0	0
17	61848401	.	G	A	0	9	9	0	0	9	0	0
17	61916956	.	A	C	1	5	6	0	1	7	0	0
17	62117262	rs1985961	C	T	27	37	64	0	2	66	0	0
17	62117733	rs3803813	T	C	20	9	29	0	0	29	0	0
17	62119555	rs196904	C	T	7	25	32	0	0	32	0	0
17	62120045	rs196907	A	G	5	4	9	0	0	9	0	0
17	62120569	rs16947383	C	T	30	15	45	0	0	45	0	0
17	62121480	rs196912	T	C	12	14	26	0	0	26	0	0
17	62180072	rs151007382	T	C	1	5	6	0	0	6	0	0
17	62204560	rs11655020	G	A	19	6	25	0	0	25	0	0
17	62288520	rs3863512	C	T	2	4	6	0	0	6	0	0
17	62507335	rs146904572	C	A	7	4	11	0	0	11	0	0
17	62808973	rs150338433	T	C	4	9	13	0	0	13	0	0
17	62893412	.	A	G	0	10	10	0	0	10	0	0
17	62915545	.	T	C	9	2	11	0	0	11	0	0
17	62971597	rs35122942	G	A	1	5	6	0	0	6	0	0
17	63011770	rs12943269	G	C	10	4	14	0	4	19	1	0
17	64023624	rs17704679	T	C	16	18	34	0	0	34	0	0
17	64023642	rs11079628	A	G	16	14	30	0	0	30	0	0
17	64025331	rs11652766	A	G	10	15	25	0	1	26	0	0
17	65068246	rs7501436	A	C	63	67	130	0	0	130	0	0
17	65104666	rs11657929	T	G	54	44	98	0	0	98	0	0
17	65146338	rs8080855	C	T	13	6	19	0	0	19	0	0
17	65167484	rs72838424	T	C	2	4	6	0	0	6	0	0
17	65182140	.	G	A	3	5	8	0	0	8	0	0
17	65182445	rs8066336	G	A	6	7	13	0	0	13	0	0
17	65184412	rs72838437	G	A	29	38	67	0	0	67	0	0
17	65186749	rs72838439	C	T	2	4	6	0	1	7	0	0
17	65191969	.	T	C	8	1	9	0	3	12	0	0
17	65191985	.	T	G	7	5	12	0	1	13	0	0
17	65192484	rs12942297	G	A	12	9	21	0	0	21	0	0
17	65212042	rs8080100	C	T	53	61	114	0	3	117	0	0
17	65241954	rs8072883	G	C	3	5	8	0	0	8	0	0
17	65716503	rs2110111	C	T	5	7	12	0	0	12	0	0
17	65727714	rs9905088	C	T	8	4	12	0	0	12	0	0
17	65729963	rs7226085	T	C	3	4	7	0	0	7	0	0
17	65730404	rs4790943	G	A	6	0	6	0	0	6	0	0
17	65732093	rs3760227	A	G	118	143	261	0	2	263	0	0
17	65732485	rs6504528	G	A	6	8	14	0	0	14	0	0
17	65732959	rs7223990	A	G	6	8	14	0	0	14	0	0
17	65734514	rs1542610	A	G	35	46	81	0	0	81	0	0
17	65734828	rs7215206	A	G	42	46	88	0	1	89	0	0
17	65893704	rs146030885	G	A	8	7	15	0	1	16	0	0
17	65987600	.	A	G	25	0	25	0	0	25	0	0
17	65987601	.	C	A	25	0	25	0	0	25	0	0
17	65987619	.	C	A	19	0	19	0	0	19	0	0
17	65987674	.	C	G	14	0	14	0	0	14	0	0
17	66445469	rs2952296	G	C	2	7	9	0	0	9	0	0
17	66445652	rs2909208	G	A	5	4	9	0	0	9	0	0
17	66449122	rs883541	G	A	4	3	7	0	0	7	0	0
17	66509892	rs4265886	C	T	38	43	81	0	0	81	0	0
17	66510136	rs4561532	C	T	31	30	61	0	1	62	0	0
17	66510442	rs8079916	A	G	26	23	49	0	0	49	0	0
17	66513025	rs8076465	A	G	104	98	202	0	1	203	0	0
17	66513802	rs28521534	G	A	6	10	16	0	0	16	0	0
17	66513958	rs56278628	C	G	5	10	15	0	0	15	0	0
17	66515322	rs11867767	A	G	8	18	26	0	0	26	0	0
17	66528778	rs6958	C	G	71	70	141	0	1	142	0	0
17	70642742	rs1126967	T	C	9	13	22	0	0	22	0	0
17	70642923	rs17780256	A	C	9	9	18	0	0	18	0	0
17	70643425	.	G	A	9	5	14	0	0	14	0	0
17	70725819	rs72843242	A	G	2	6	8	0	0	8	0	0
17	71192663	rs1052706	G	A	10	9	19	0	0	19	0	0
17	71192873	rs11544800	A	G	22	31	53	0	0	53	0	0
17	71193594	rs7221701	G	A	1	5	6	0	0	6	0	0
17	71193633	rs11658510	G	A	5	1	6	0	0	6	0	0
17	71195833	rs1009111	T	C	1	7	8	0	0	8	0	0
17	71195949	rs1009110	C	T	4	2	6	0	0	6	0	0
17	71196359	rs2278793	A	G	5	6	11	0	0	11	0	0
17	71196809	rs1026128	A	G	37	38	75	0	1	76	0	0
17	71197439	rs1551036	C	T	53	31	84	0	3	87	0	0
17	71197748	rs1037256	G	A	53	41	94	0	0	94	0	0
17	71200948	rs8072987	G	A	12	4	16	0	0	16	0	0
17	71205854	rs8387	A	G	23	25	48	0	0	48	0	0
17	71223501	rs17184168	T	C	2	4	6	0	0	6	0	0
17	71223837	rs9904267	C	T	1	7	8	0	0	8	0	0
17	71228937	rs1466115	C	T	4	5	9	0	0	9	0	0
17	71228952	rs1466116	T	G	5	5	10	0	0	10	0	0
17	71232687	rs745143	T	C	5	10	15	0	0	15	0	0
17	71232807	rs904383	T	C	4	12	16	0	0	16	0	0
17	71232881	rs745142	G	C	7	11	18	0	0	18	0	0
17	71233130	rs11869253	A	G	4	13	17	0	1	18	0	0
17	71233736	rs966939	A	G	2	6	8	0	0	8	0	0
17	71239087	rs1566290	G	T	3	6	9	0	1	10	0	0
17	71244702	rs12885	G	T	16	10	26	0	0	26	0	0
17	71279839	rs3841	T	C	46	39	85	0	0	85	0	0
17	71279856	rs536	C	T	62	59	121	0	1	122	0	0
17	71280052	rs6905	T	A	74	72	146	0	1	147	0	0
17	71280075	rs1042988	T	C	56	56	112	0	2	114	0	0
17	71280213	rs1071577	G	A	50	39	89	0	1	90	0	0
17	71280722	rs12795	T	C	39	30	69	0	0	69	0	0
17	71280954	rs2345288	T	C	22	20	42	0	1	43	0	0
17	72233559	rs62621376	G	A	3	3	6	0	0	6	0	0
17	72240177	rs35999669	T	G	3	6	9	0	0	9	0	0
17	72246101	rs3897753	T	C	8	4	12	0	0	12	0	0
17	72246466	rs7224615	C	T	4	2	6	0	0	6	0	0
17	72248483	rs4789640	A	G	5	3	8	0	0	8	0	0
17	72249229	rs9899862	C	A	5	2	7	0	1	8	0	0
17	72257253	rs3893391	C	G	11	7	18	0	0	18	0	0
17	72257347	rs74613031	G	T	11	8	19	0	0	19	0	0
17	72257932	rs7651	T	C	10	9	19	0	1	20	0	0
17	72467868	rs9902865	G	A	2	4	6	0	0	6	0	0
17	72469966	rs2272111	G	A	18	18	36	0	1	37	0	0
17	72470145	rs2293189	G	A	5	1	6	0	0	6	0	0
17	72470542	rs2293192	C	T	3	4	7	0	0	7	0	0
17	72478717	rs112743758	G	T	1	6	7	0	0	7	0	0
17	72479459	rs12943442	C	A	0	9	9	0	0	9	0	0
17	72479833	rs9944466	T	C	5	6	11	0	0	11	0	0
17	72480467	rs9903890	A	G	69	68	137	0	0	137	0	0
17	72480505	rs1044282	A	G	59	66	125	0	0	125	0	0
17	72743120	rs3178300	C	T	237	220	457	0	2	459	0	0
17	73127217	rs3736075	G	C	24	21	45	0	0	45	0	0
17	73127683	rs4788867	T	C	20	12	32	0	1	33	0	0
17	73139367	rs11655444	A	T	3	3	6	0	0	6	0	0
17	73162124	rs11653062	A	C	13	7	20	0	0	20	0	0
17	73163277	rs11077777	G	A	5	6	11	0	0	11	0	0
17	73220999	rs1871269	C	T	5	4	9	0	0	9	0	0
17	73224639	rs1005714	G	C	5	8	13	0	1	14	0	0
17	73224653	rs143620169	T	G	8	5	13	0	0	13	0	0
17	73224795	rs1005713	A	C	2	4	6	0	0	6	0	0
17	73228144	rs2291030	T	C	9	41	50	0	0	50	0	0
17	73228173	rs2291031	C	T	9	53	62	0	0	62	0	0
17	73230856	rs9988	C	T	198	204	402	0	4	406	0	0
17	73233599	rs79858696	G	C	131	124	255	0	2	257	0	0
17	73236605	rs11077781	C	A	11	15	26	0	1	27	0	0
17	73238208	rs1985808	T	C	16	16	32	0	0	32	0	0
17	73257830	rs2279161	C	T	6	8	14	0	0	14	0	0
17	73257986	rs8075276	C	T	25	26	51	0	1	52	0	0
17	73258479	rs6501772	C	T	18	24	42	0	0	42	0	0
17	73259992	rs149118979	C	T	16	6	22	0	2	24	0	0
17	73260298	rs4788878	A	G	11	28	39	0	0	39	0	0
17	73262293	rs4789161	T	C	56	61	117	0	1	118	0	0
17	73263150	rs80212667	T	C	3	5	8	0	1	9	0	0
17	73265822	.	C	T	7	4	11	0	1	12	0	0
17	73267831	rs3809716	G	T	5	2	7	0	0	7	0	0
17	73269258	rs7198	G	C	13	10	23	0	0	23	0	0
17	73269530	rs1809352	A	G	8	4	12	0	0	12	0	0
17	73269676	rs4789164	C	T	4	8	12	0	0	12	0	0
17	73270159	rs733301	T	C	5	3	8	0	0	8	0	0
17	73315368	rs7219	C	T	183	225	408	0	11	419	0	0
17	73316679	rs8079197	G	C	25	27	52	0	0	52	0	0
17	73317443	rs12945743	C	A	25	15	40	0	0	40	0	0
17	73317510	rs12943707	G	C	14	12	26	0	0	26	0	0
17	73317644	rs12946365	C	T	33	19	52	0	0	52	0	0
17	73318398	rs9891824	A	G	6	8	14	0	0	14	0	0
17	73319892	rs4402606	T	C	18	4	22	0	0	22	0	0
17	73320383	rs12940287	C	T	5	11	16	0	0	16	0	0
17	73320433	rs12938183	G	C	4	4	8	0	0	8	0	0
17	73320893	rs9913257	C	T	6	5	11	0	0	11	0	0
17	73321117	rs2385263	T	C	3	9	12	0	0	12	0	0
17	73321212	rs76954202	A	G	4	3	7	0	0	7	0	0
17	73321687	rs7207618	T	C	7	7	14	0	0	14	0	0
17	73393459	rs2053158	T	A	3	3	6	0	0	6	0	0
17	73485707	rs34364349	G	A	28	26	54	0	0	54	0	0
17	73487533	rs76073955	C	T	31	41	72	0	1	73	0	0
17	73488794	rs4078259	C	T	27	33	60	0	3	63	0	0
17	73489567	rs4078474	C	G	13	15	28	0	0	28	0	0
17	73512884	rs8079373	T	G	13	7	20	0	0	20	0	0
17	73513156	rs8074291	G	A	5	1	6	0	0	6	0	0
17	73513289	rs6501818	C	G	87	46	133	0	1	134	0	0
17	73513434	rs6501819	A	G	2	4	6	0	0	6	0	0
17	73513619	rs56895494	C	A	5	1	6	0	0	6	0	0
17	73515737	rs144009519	G	C	6	1	7	0	0	7	0	0
17	73518203	rs9911502	G	C	67	88	155	0	1	156	0	0
17	73518328	rs77247739	A	C	61	28	89	0	0	89	0	0
17	73518563	rs67746118	G	C	29	7	36	0	0	36	0	0
17	73518850	rs1133934	C	T	10	12	22	0	0	22	0	0
17	73519137	rs62088468	A	C	31	19	50	0	0	50	0	0
17	73519413	rs8064529	C	T	130	131	261	0	2	263	0	0
17	73519589	rs62088469	T	C	8	8	16	0	0	16	0	0
17	73519668	rs72851947	G	A	6	5	11	0	0	11	0	0
17	73552185	rs1671036	G	A	7	3	10	0	0	10	0	0
17	73559441	rs34158736	C	T	3	6	9	0	0	9	0	0
17	73561717	rs3785430	G	A	7	5	12	0	0	12	0	0
17	73562421	rs1661722	C	T	6	6	12	0	0	12	0	0
17	73563413	rs35093418	T	C	6	4	10	0	0	10	0	0
17	73564024	rs3910704	G	A	2	4	6	0	1	7	0	0
17	73564036	rs12949844	A	G	5	5	10	0	0	10	0	0
17	73565171	rs1671021	T	C	9	14	23	0	0	23	0	0
17	73567846	rs1661715	C	T	16	8	24	0	0	24	0	0
17	73570718	rs1126939	C	G	12	34	46	0	0	46	0	0
17	73571030	rs1042861	A	G	23	24	47	0	1	48	0	0
17	73586184	rs820241	C	G	25	14	39	0	0	39	0	0
17	73586358	rs820242	G	A	18	23	41	0	0	41	0	0
17	73587257	rs147655466	A	G	23	54	77	0	0	77	0	0
17	73587268	rs2290455	C	T	48	23	71	0	0	71	0	0
17	73587274	rs80252608	A	G	27	49	76	0	0	76	0	0
17	73587347	rs11656113	G	A	5	3	8	0	0	8	0	0
17	73587414	rs2290454	C	T	6	4	10	0	0	10	0	0
17	73587477	rs72854926	C	A	6	10	16	0	0	16	0	0
17	73587519	rs55903825	C	T	8	7	15	0	1	16	0	0
17	73587784	rs936056	A	G	28	48	76	0	0	76	0	0
17	73588058	rs736522	G	T	35	20	55	0	1	56	0	0
17	73588067	rs736523	A	G	18	41	59	0	0	59	0	0
17	73588199	rs736525	T	C	5	4	9	0	0	9	0	0
17	73588542	rs736521	A	G	10	19	29	0	0	29	0	0
17	73590331	rs62089228	A	T	12	18	30	0	1	31	0	0
17	73590817	rs2305524	C	T	39	33	72	0	2	74	0	0
17	73592019	rs820257	A	C	8	9	17	0	0	17	0	0
17	73592125	rs78712603	T	A	7	7	14	0	2	16	0	0
17	73593278	rs11657018	G	A	4	4	8	0	0	8	0	0
17	73594030	rs9913002	C	T	9	5	14	0	0	14	0	0
17	73594485	rs820262	C	T	4	7	11	0	0	11	0	0
17	73597544	rs11871553	A	G	54	53	107	0	2	109	0	0
17	73597919	rs3760124	C	T	5	3	8	0	0	8	0	0
17	73598423	rs1670997	A	G	2	4	6	0	1	7	0	0
17	73599411	rs1661696	G	A	2	5	7	0	0	7	0	0
17	73600021	rs1661700	C	T	5	3	8	0	0	8	0	0
17	73600891	rs1624922	A	G	6	4	10	0	0	10	0	0
17	73600919	rs1670995	G	T	6	1	7	0	0	7	0	0
17	73600920	rs1624988	T	C	6	1	7	0	0	7	0	0
17	73602081	rs8068464	G	A	19	25	44	0	0	44	0	0
17	73603064	rs1670994	C	T	5	5	10	0	0	10	0	0
17	73606275	rs820136	T	C	30	38	68	0	1	69	0	0
17	73606302	rs820137	G	C	29	30	59	0	0	59	0	0
17	73609516	rs113730899	C	T	23	15	38	0	1	39	0	0
17	73750859	rs8669	C	G	2	4	6	0	0	6	0	0
17	73825654	rs7216655	A	G	18	19	37	0	2	39	0	0
17	73890024	rs9902734	A	G	2	6	8	0	0	8	0	0
17	73938278	rs139936850	G	A	9	5	14	0	0	14	0	0
17	73942196	rs71382188	C	G	19	23	42	0	0	42	0	0
17	74035543	rs7409	T	C	170	138	308	0	0	308	0	0
17	74036573	rs2260516	A	T	5	5	10	0	0	10	0	0
17	74037208	rs2598445	G	A	9	9	18	0	0	18	0	0
17	74037715	rs2598446	A	G	9	12	21	0	0	21	0	0
17	74037997	rs2665977	G	A	3	5	8	0	0	8	0	0
17	74039867	rs1530834	T	C	5	8	13	0	0	13	0	0
17	74040293	rs2305345	G	T	4	4	8	0	0	8	0	0
17	74041110	rs2598432	A	C	4	2	6	0	0	6	0	0
17	74046672	rs2665972	A	G	3	4	7	0	0	7	0	0
17	74056413	rs2665998	C	T	114	93	207	0	1	208	0	0
17	74067099	rs2598414	C	T	5	2	7	0	0	7	0	0
17	74077497	rs8836	G	C	56	57	113	0	0	113	0	0
17	74079077	rs2665987	G	A	37	33	70	0	1	71	0	0
17	74079838	rs2665986	A	G	3	4	7	0	0	7	0	0
17	74081216	rs2246274	G	A	2	4	6	0	0	6	0	0
17	74099240	rs1979132	G	A	5	4	9	0	0	9	0	0
17	74261929	rs71382201	A	G	12	7	19	0	0	19	0	0
17	74387284	rs3803739	C	T	21	23	44	0	1	45	0	0
17	74413885	rs7207108	A	G	9	10	19	0	0	19	0	0
17	74477620	rs12943385	C	T	9	10	19	0	0	19	0	0
17	74560728	rs1132652	A	G	195	179	374	0	4	378	0	0
17	74561319	rs7353	G	A	418	176	594	0	3	597	0	0
17	74710128	rs2240775	T	C	20	19	39	0	0	39	0	0
17	74710572	rs2240774	T	C	21	15	36	0	0	36	0	0
17	74711723	rs2240772	T	C	5	8	13	0	1	14	0	0
17	74712310	rs2286585	A	G	4	7	11	0	0	11	0	0
17	74713847	rs35949251	C	T	4	2	6	0	0	6	0	0
17	74714354	rs62086780	G	A	13	4	17	0	0	17	0	0
17	74715214	.	T	G	7	7	14	0	0	14	0	0
17	74717604	rs2240770	C	T	13	8	21	0	2	23	0	0
17	74718155	rs2240769	C	T	19	13	32	0	0	32	0	0
17	74733403	rs3744061	G	A	11	7	18	0	0	18	0	0
17	75085260	rs2247814	C	G	18	37	55	0	1	56	0	0
17	75085434	rs2678770	G	A	16	16	32	0	0	32	0	0
17	75086949	rs9913954	G	A	4	4	8	0	0	8	0	0
17	75137642	rs3785445	C	T	3	6	9	0	1	10	0	0
17	75144393	rs58069837	A	G	4	3	7	0	0	7	0	0
17	75144835	rs62078297	C	T	4	5	9	0	0	9	0	0
17	75146909	rs55994155	C	G	10	3	13	0	0	13	0	0
17	75148741	rs10163481	G	A	34	48	82	0	2	84	0	0
17	75199580	rs12602668	A	G	4	6	10	0	0	10	0	0
17	75200606	.	T	C	9	0	9	0	1	10	0	0
17	75203092	rs7226135	C	T	6	0	6	0	0	6	0	0
17	75207545	rs77291632	G	A	3	4	7	0	1	8	0	0
17	75207586	rs77932036	T	G	4	6	10	0	0	10	0	0
17	75207853	rs78493457	A	C	5	2	7	0	0	7	0	0
17	75208580	rs35528126	C	T	14	19	33	0	1	34	0	0
17	75208601	rs35300000	G	A	11	14	25	0	0	25	0	0
17	75208638	rs9912398	G	A	10	15	25	0	1	26	0	0
17	75208766	rs1983158	C	T	17	16	33	0	0	33	0	0
17	75210574	rs3744063	A	C	81	68	149	0	1	150	0	0
17	75211608	rs12942219	G	A	119	73	192	0	25	217	0	0
17	75211868	rs62078341	T	C	22	4	26	0	5	31	0	0
17	75211907	rs71384149	T	C	33	1	34	0	4	38	0	0
17	75211935	rs71384150	A	C	40	1	41	0	6	47	0	0
17	75447586	rs11650934	C	G	2	4	6	0	0	6	0	0
17	75489542	rs312798	C	A	3	4	7	0	0	7	0	0
17	75489548	rs220035	A	G	2	4	6	0	0	6	0	0
17	75489643	rs312799	G	C	2	4	6	0	0	6	0	0
17	76111251	rs3794741	A	G	11	14	25	0	0	25	0	0
17	76111560	rs2613515	A	G	15	11	26	0	1	27	0	0
17	76115441	.	C	T	147	138	285	0	1	286	0	0
17	76117401	rs2073284	A	G	16	10	26	0	0	26	0	0
17	76118555	rs116717140	G	A	11	9	20	0	0	20	0	0
17	76119842	rs149574761	T	C	9	11	20	0	1	21	0	0
17	76119930	rs55677349	T	C	10	11	21	0	0	21	0	0
17	76120065	rs2613522	A	G	12	7	19	0	0	19	0	0
17	76120533	rs117892474	C	T	12	11	23	0	0	23	0	0
17	76121760	rs7502920	C	T	55	48	103	0	1	104	0	0
17	76121781	rs141458473	T	A	39	40	79	0	3	82	0	0
17	76121864	rs2748427	A	G	143	148	291	0	2	293	0	0
17	76122104	rs147617056	A	G	44	35	79	0	0	79	0	0
17	76126204	rs429216	T	G	4	3	7	0	0	7	0	0
17	76127076	rs11658760	G	T	7	4	11	0	0	11	0	0
17	76127746	rs145016347	T	C	36	33	69	0	0	69	0	0
17	76129636	rs417780	T	C	12	22	34	0	0	34	0	0
17	76129930	rs8079824	G	C	10	41	51	0	0	51	0	0
17	76130674	rs146790329	T	C	8	10	18	0	0	18	0	0
17	76131070	rs12452890	G	A	143	144	287	0	3	290	0	0
17	76131247	rs11657180	G	A	6	4	10	0	0	10	0	0
17	76132065	rs11658268	A	G	6	5	11	0	0	11	0	0
17	76132109	rs111843410	T	C	4	7	11	0	0	11	0	0
17	76132141	rs11658379	G	C	9	9	18	0	0	18	0	0
17	76132375	rs11654009	T	A	9	4	13	0	0	13	0	0
17	76132692	rs8068430	T	C	4	7	11	0	0	11	0	0
17	76132826	rs8067323	A	G	10	6	16	0	0	16	0	0
17	76133573	rs117626020	C	G	22	16	38	0	0	38	0	0
17	76133608	rs117808042	G	A	17	16	33	0	0	33	0	0
17	76133746	rs12449680	A	G	10	6	16	0	0	16	0	0
17	76134028	rs11651478	A	G	2	8	10	0	0	10	0	0
17	76134237	rs11651675	G	A	183	162	345	0	1	346	0	0
17	76134333	rs11651650	C	T	1	6	7	0	0	7	0	0
17	76134407	rs11651741	G	A	1	7	8	0	0	8	0	0
17	76134650	rs11651864	G	T	19	10	29	0	0	29	0	0
17	76135402	rs17773842	G	A	107	97	204	0	1	205	0	0
17	76135412	rs17773854	G	T	100	91	191	0	0	191	0	0
17	76136715	rs61740060	T	C	15	8	23	0	0	23	0	0
17	76137589	rs11655790	C	T	321	280	601	0	4	605	0	0
17	76137801	rs11651404	T	A	331	326	657	0	4	661	0	0
17	76137804	rs11655880	C	T	330	332	662	0	4	666	0	0
17	76137933	rs11654773	T	G	291	253	544	0	2	546	0	0
17	76138133	rs11649824	C	G	264	233	497	0	2	499	0	0
17	76138296	rs11649896	C	G	398	335	733	0	14	747	0	0
17	76138710	rs11650029	A	G	563	626	1189	0	2	1191	0	0
17	76167047	rs1062668	C	T	110	133	243	0	0	243	0	0
17	76167393	rs4789546	G	A	7	7	14	0	0	14	0	0
17	76171277	rs8072887	C	T	4	5	9	0	0	9	0	0
17	76172104	rs2661679	T	G	5	9	14	0	0	14	0	0
17	76172167	rs9893988	G	A	4	4	8	0	0	8	0	0
17	76172615	.	A	G	7	3	10	0	0	10	0	0
17	76172691	rs12452081	C	T	5	5	10	0	1	11	0	0
17	76173175	rs7217417	G	C	8	6	14	0	0	14	0	0
17	76175987	rs79354941	C	G	4	2	6	0	0	6	0	0
17	76179775	rs11657714	C	T	4	2	6	0	0	6	0	0
17	76180515	rs16970907	G	C	9	9	18	0	0	18	0	0
17	76180636	rs115449370	G	A	9	5	14	0	0	14	0	0
17	76203652	rs60968356	T	C	24	13	37	0	0	37	0	0
17	76219591	rs2071214	G	A	62	55	117	0	1	118	0	0
17	76354126	rs41522945	C	T	418	293	711	0	9	720	0	0
17	76354469	rs72899753	C	T	399	352	751	0	11	762	0	0
17	76374763	.	C	T	0	6	6	0	0	6	0	0
17	76395430	rs2292642	C	T	72	46	118	0	0	118	0	0
17	76400236	rs3744219	G	A	18	14	32	0	0	32	0	0
17	76400251	rs3744218	C	G	15	19	34	0	0	34	0	0
17	76400258	rs3744217	G	A	21	16	37	0	0	37	0	0
17	76400268	rs3826323	C	G	22	17	39	0	0	39	0	0
17	76400321	rs9900494	A	G	16	26	42	0	0	42	0	0
17	76400329	rs12601079	G	A	27	10	37	0	0	37	0	0
17	76400337	rs11077364	C	A	18	10	28	0	4	32	0	0
17	76400507	rs9901493	G	A	25	23	48	0	0	48	0	0
17	76400566	rs9901724	G	T	19	28	47	0	0	47	0	0
17	76401318	rs1976704	C	T	8	5	13	0	0	13	0	0
17	76401328	rs1976703	C	T	8	6	14	0	0	14	0	0
17	76402105	rs2376583	A	T	4	4	8	0	0	8	0	0
17	76403028	rs4580257	T	G	20	22	42	0	1	43	0	0
17	76403860	rs4365353	G	A	26	18	44	0	0	44	0	0
17	76403984	rs4129767	G	A	24	27	51	0	1	52	0	0
17	76415939	rs72903305	A	T	16	16	32	0	0	32	0	0
17	76419984	rs72914863	G	A	52	35	87	0	0	87	0	0
17	76420388	rs112415080	C	A	92	114	206	0	1	207	0	0
17	76670749	rs1126615	A	G	265	251	516	0	4	521	1	0
17	76672002	rs1126607	T	C	124	87	211	0	5	216	0	0
17	76674257	rs3936118	T	C	50	60	110	0	2	112	0	0
17	76675661	rs11657360	G	C	56	49	105	0	0	105	0	0
17	76675803	rs11657403	G	A	41	37	78	0	0	78	0	0
17	76691564	rs55779573	T	C	5	3	8	0	0	8	0	0
17	76692298	rs922838	G	C	5	2	7	0	0	7	0	0
17	76693697	rs59428334	A	G	4	2	6	0	0	6	0	0
17	76693711	rs11077394	A	G	3	3	6	0	0	6	0	0
17	76783642	rs6501249	A	G	93	124	217	0	2	219	0	0
17	76784198	rs2889479	T	C	6	7	13	0	0	13	0	0
17	76784781	rs747423	C	T	9	8	17	0	0	17	0	0
17	76787000	rs8072569	G	A	3	8	11	0	1	12	0	0
17	76787885	rs62075586	T	C	6	4	10	0	0	10	0	0
17	76789754	rs12953123	G	A	3	4	7	0	0	7	0	0
17	76789991	rs8182269	A	T	2	5	7	0	0	7	0	0
17	76790279	rs8073626	C	T	4	6	10	0	0	10	0	0
17	76792179	rs1044486	G	A	300	242	542	0	3	545	0	0
17	76793600	rs3744802	G	A	101	58	159	0	0	159	0	0
17	76793728	rs3744801	G	A	93	63	156	0	0	156	0	0
17	76793825	rs3744800	G	A	125	85	210	0	3	213	0	0
17	76793885	rs3826552	G	A	91	68	159	0	0	159	0	0
17	76794774	rs3744799	T	C	23	14	37	0	0	37	0	0
17	76794981	rs2279308	A	G	19	11	30	0	0	30	0	0
17	76796463	rs11077397	C	T	15	7	22	0	2	24	0	0
17	76796854	rs8079153	T	C	7	7	14	0	0	14	0	0
17	76799795	rs1057040	G	A	59	32	91	0	1	92	0	0
17	76799860	rs3088040	T	C	45	35	80	0	1	82	1	0
17	76799898	rs9302885	A	G	48	43	91	0	0	91	0	0
17	76800182	rs11649964	G	C	4	3	7	0	0	7	0	0
17	76802098	rs2054624	C	T	3	8	11	0	0	11	0	0
17	76810284	rs1110274	C	A	6	7	13	0	0	13	0	0
17	76817090	rs3744793	C	T	69	64	133	0	5	138	0	0
17	76822131	rs1531798	A	G	9	6	15	0	1	16	0	0
17	76822168	rs1531797	T	C	8	4	12	0	0	12	0	0
17	76832133	rs900349	T	C	15	3	18	0	0	18	0	0
17	76990635	rs111981689	C	T	8	3	11	0	0	11	0	0
17	76990802	rs74949399	C	T	9	9	18	0	0	18	0	0
17	77182206	rs9905105	T	C	3	3	6	0	0	6	0	0
17	77753442	rs3751953	G	A	51	54	105	0	0	105	0	0
17	77756266	rs113561509	G	C	5	9	14	0	0	14	0	0
17	77758484	rs3751956	G	A	26	19	45	0	1	46	0	0
17	77758691	rs3751957	G	A	23	30	53	0	0	53	0	0
17	77760764	rs4889787	A	G	48	69	117	0	1	118	0	0
17	77768654	rs4889891	C	A	24	24	48	0	0	48	0	0
17	77809823	rs1285251	T	C	26	8	34	0	0	34	0	0
17	77809998	rs1285250	C	T	23	9	32	0	0	32	0	0
17	77810143	rs1285249	C	G	14	9	23	0	1	24	0	0
17	78078709	rs1800300	T	C	7	6	13	0	0	13	0	0
17	78079597	rs1042393	A	G	6	2	8	0	0	8	0	0
17	78081661	rs1800303	A	T	9	5	14	0	0	14	0	0
17	78082504	rs1800304	G	A	8	11	19	0	0	19	0	0
17	78083791	rs1800305	C	T	7	10	17	0	0	17	0	0
17	78085213	rs7221675	C	T	10	1	11	0	0	11	0	0
17	78085214	rs7209921	A	G	9	1	10	0	1	11	0	0
17	78085228	rs4889818	A	G	7	2	9	0	1	10	0	0
17	78085597	rs12951255	A	G	4	3	7	0	0	7	0	0
17	78091405	rs1126690	G	A	21	12	33	0	0	33	0	0
17	78092063	rs1042397	G	A	14	20	34	0	1	35	0	0
17	78093221	rs2229221	G	A	41	27	68	0	1	69	0	0
17	78110917	rs77319086	C	A	2	4	6	0	0	6	0	0
17	78111449	rs2289535	A	C	5	1	6	0	0	6	0	0
17	78111877	rs2361710	T	C	5	2	7	0	1	8	0	0
17	78174764	rs7225268	T	C	10	11	21	0	0	21	0	0
17	78181647	rs7222024	C	T	3	3	6	0	0	6	0	0
17	78183396	rs1046832	A	G	76	74	150	0	3	153	0	0
17	78183403	rs709677	G	C	77	81	158	0	3	161	0	0
17	78183411	rs709678	T	C	70	75	145	0	5	150	0	0
17	78183936	rs2071148	G	A	57	46	103	0	2	105	0	0
17	78184393	rs7503034	C	T	20	30	50	0	0	50	0	0
17	78185527	rs2269376	T	G	13	18	31	0	0	31	0	0
17	78185556	rs2269375	G	A	12	10	22	0	0	22	0	0
17	78185642	rs2269374	G	A	13	12	25	0	0	25	0	0
17	78187720	rs35087113	A	G	7	8	15	0	0	15	0	0
17	78187954	rs6565647	A	G	5	6	11	0	0	11	0	0
17	78188256	rs6565648	C	T	8	5	13	0	0	13	0	0
17	78188963	rs4889839	G	A	4	4	8	0	0	8	0	0
17	78189334	rs12450437	T	C	6	4	10	0	0	10	0	0
17	78190078	rs7406336	C	A	4	5	9	0	0	9	0	0
17	78225055	rs8078855	G	T	5	3	8	0	0	8	0	0
17	78225078	rs138983772	G	T	5	4	9	0	0	9	0	0
17	78261730	rs17853714	G	A	3	6	9	0	0	9	0	0
17	78262161	rs17857135	T	C	6	7	13	0	0	13	0	0
17	78263486	rs17853989	T	C	3	8	11	0	0	11	0	0
17	78263514	rs17853713	G	A	4	8	12	0	0	12	0	0
17	78306102	rs9913636	G	C	6	5	11	0	0	11	0	0
17	78346870	rs62077764	C	A	16	22	38	0	0	38	0	0
17	78355176	rs7224239	A	G	6	4	10	0	0	10	0	0
17	78355494	rs61745599	C	G	39	23	62	0	0	62	0	0
17	78355918	rs11547133	G	A	20	20	40	0	1	41	0	0
17	78355951	rs62077766	G	A	11	8	19	0	0	19	0	0
17	78357059	rs12603603	T	C	5	7	12	0	0	12	0	0
17	78358363	rs62077767	G	A	2	11	13	0	1	14	0	0
17	78358600	rs11653704	G	A	12	7	19	0	0	19	0	0
17	78363054	rs8072774	G	A	66	35	101	0	0	101	0	0
17	78368051	rs8359	G	A	76	56	132	0	0	132	0	0
17	78390836	rs4275910	G	C	5	2	7	0	0	7	0	0
17	78390931	rs9913006	T	G	6	1	7	0	0	7	0	0
17	78391049	rs4531782	T	G	5	1	6	0	0	6	0	0
17	78392234	rs11657930	G	A	3	3	6	0	0	6	0	0
17	78392391	rs8067574	C	T	7	13	20	0	0	20	0	0
17	78554888	rs4424946	T	C	5	9	14	0	0	14	0	0
17	78865546	rs2289764	T	C	6	13	19	0	0	19	0	0
17	78865630	rs2289765	A	G	6	8	14	0	0	14	0	0
17	78896529	rs2271603	C	T	11	8	19	0	0	19	0	0
17	78900118	rs7502001	G	T	2	4	6	0	0	6	0	0
17	78900598	rs4969227	C	T	3	3	6	0	0	6	0	0
17	78900811	rs4969228	A	G	3	6	9	0	0	9	0	0
17	78901669	rs56072626	G	A	3	11	14	0	1	15	0	0
17	78901980	rs4969310	T	C	2	7	9	0	0	9	0	0
17	78904680	rs9899051	A	G	3	4	7	0	0	7	0	0
17	78906360	rs4969311	C	G	3	8	11	0	0	11	0	0
17	78906976	rs2090203	A	G	7	6	13	0	0	13	0	0
17	78908322	rs62068529	C	T	0	6	6	0	0	6	0	0
17	78910439	rs12602601	G	T	6	3	9	0	0	9	0	0
17	78910440	rs12602731	C	T	6	3	9	0	0	9	0	0
17	78910629	rs11653325	T	C	4	4	8	0	0	8	0	0
17	78910751	rs12936701	C	A	5	8	13	0	0	13	0	0
17	78910800	rs7501689	T	C	6	5	11	0	0	11	0	0
17	78921117	rs4969231	C	T	12	8	20	0	0	20	0	0
17	78938385	rs11547302	G	A	10	15	25	0	0	25	0	0
17	78939414	rs3751932	C	T	22	36	58	0	1	59	0	0
17	79006850	rs11870986	T	C	7	11	18	0	0	18	0	0
17	79007075	rs11150764	C	A	8	12	20	0	0	20	0	0
17	79084072	rs4072588	T	G	7	7	14	0	1	15	0	0
17	79089590	rs4969391	A	G	22	17	39	0	6	45	0	0
17	79163649	rs2292182	G	A	19	1	20	0	0	20	0	0
17	79165171	rs869370	G	A	7	11	18	0	1	19	0	0
17	79170576	rs1542961	C	T	19	19	38	0	0	38	0	0
17	79182778	rs62075318	T	C	16	9	25	0	1	26	0	0
17	79202329	rs1048775	G	C	120	145	265	0	2	267	0	0
17	79202956	rs2048057	T	C	66	62	128	0	0	129	1	0
17	79204661	rs12937612	C	G	2	4	6	0	0	6	0	0
17	79205736	rs11655759	G	A	76	63	139	0	1	140	0	0
17	79206789	rs11150777	G	A	4	6	10	0	1	11	0	0
17	79207061	rs2292183	C	T	5	9	14	0	0	14	0	0
17	79208535	rs11150778	G	A	24	12	36	0	0	36	0	0
17	79208604	rs11652662	G	A	17	10	27	0	0	27	0	0
17	79213562	rs2255166	T	C	5	2	7	0	0	7	0	0
17	79220224	rs2725405	G	C	4	10	14	0	0	14	0	0
17	79223558	rs11656141	G	A	3	3	6	0	0	6	0	0
17	79237900	rs9901514	A	G	5	3	8	0	0	8	0	0
17	79238213	rs11651784	C	T	4	4	8	0	0	8	0	0
17	79244802	rs2292184	T	C	10	15	25	0	1	26	0	0
17	79250858	rs143498783	A	C	5	7	12	0	0	12	0	0
17	79255998	rs10871494	G	A	10	2	12	0	0	12	0	0
17	79356566	rs143619610	C	T	6	0	6	0	0	6	0	0
17	79362222	rs1811556	G	A	15	19	34	0	0	34	0	0
17	79362292	rs11650118	G	A	18	5	23	0	0	23	0	0
17	79362574	rs12150093	C	T	10	3	13	0	0	13	0	0
17	79363169	rs11651713	C	G	2	4	6	0	0	6	0	0
17	79363671	rs8081442	G	A	9	8	17	0	0	17	0	0
17	79375315	rs66643547	C	T	26	38	64	0	2	66	0	0
17	79375687	rs56355243	C	T	82	87	169	0	0	169	0	0
17	79375998	rs1701	C	A	86	89	175	0	1	176	0	0
17	79377046	rs67155885	C	T	6	5	11	0	0	11	0	0
17	79377838	rs138131825	C	T	5	2	7	0	0	7	0	0
17	79412465	rs116255905	C	A	4	3	7	0	1	8	0	0
17	79414634	rs61745233	G	A	12	5	17	0	0	17	0	0
17	79414804	rs61739649	T	C	3	5	8	0	0	8	0	0
17	79418770	rs61746096	C	T	3	7	10	0	0	10	0	0
17	79524790	rs8068511	T	A	152	145	297	0	7	304	0	0
17	79525862	rs3087664	A	G	114	124	238	0	0	238	0	0
17	79526402	rs4073997	G	C	74	56	130	0	0	130	0	0
17	79782786	rs138726152	G	A	5	11	16	0	0	16	0	0
17	79816926	rs1533756	C	T	19	24	43	0	0	43	0	0
17	79971065	rs4995642	C	T	7	7	14	0	0	14	0	0
17	79974804	rs149041999	C	T	48	42	90	0	0	90	0	0
17	80016452	rs4280314	C	A	22	88	110	0	7	117	0	0
17	80036877	rs11550611	A	G	20	15	35	0	1	36	0	0
17	80038952	rs4246444	T	G	4	3	7	0	0	7	0	0
17	80039420	rs72863323	A	C	9	5	14	0	1	15	0	0
17	80039481	rs1140616	G	A	43	49	92	0	1	93	0	0
17	80040607	rs4969465	T	C	4	8	12	0	0	12	0	0
17	80040639	rs17848942	G	A	4	8	12	0	0	12	0	0
17	80044211	rs41283365	G	A	15	20	35	0	0	35	0	0
17	80051183	rs2228309	A	G	12	11	23	0	0	23	0	0
17	80052304	rs9901600	G	A	8	1	9	0	0	9	0	0
17	80054341	rs201311256	C	T	5	3	8	0	0	8	0	0
17	80059487	rs1127678	C	T	105	130	235	0	5	240	0	0
17	80059596	rs13949	T	C	152	201	353	0	1	354	0	0
17	80085633	rs11077969	A	G	30	50	80	0	1	81	0	0
17	80085703	rs7213172	G	T	34	45	79	0	2	82	1	0
17	80086386	rs7406162	C	T	37	44	81	0	0	81	0	0
17	80086389	rs7406163	C	T	38	44	82	0	0	82	0	0
17	80086395	rs4625783	T	C	38	47	85	0	0	85	0	0
17	80093139	rs4789747	C	T	6	0	6	0	0	6	0	0
17	80093142	rs4789746	C	T	6	0	6	0	0	6	0	0
17	80109778	rs7502533	A	G	8	5	13	0	0	13	0	0
17	80109806	rs7501461	C	T	8	5	13	0	0	13	0	0
17	80110394	rs10163482	C	A	10	6	16	0	0	16	0	0
17	80110396	rs10163483	C	A	9	6	15	0	0	15	0	0
17	80110750	rs10163485	C	T	9	10	19	0	1	20	0	0
17	80110867	rs10163496	G	A	7	8	15	0	0	15	0	0
17	80110957	rs8073645	C	T	6	8	14	0	0	14	0	0
17	80111026	rs8067138	T	C	9	8	17	0	1	18	0	0
17	80111205	rs6502067	A	G	11	11	22	0	2	24	0	0
17	80111442	rs6416859	G	C	7	7	14	0	0	14	0	0
17	80111724	rs3088177	A	G	17	13	30	0	0	30	0	0
17	80112223	rs6502068	C	T	17	6	23	0	1	24	0	0
17	80112599	rs6502069	G	T	19	5	24	0	3	27	0	0
17	80112634	rs6502070	G	A	17	7	24	0	0	24	0	0
17	80112978	rs3924780	G	A	9	10	19	0	0	19	0	0
17	80113130	rs3924781	T	C	13	9	22	0	0	22	0	0
17	80113322	rs8078087	T	G	15	4	19	0	0	19	0	0
17	80113381	rs3935129	G	C	14	1	15	0	0	15	0	0
17	80113414	rs3935128	T	C	9	1	10	0	1	11	0	0
17	80113925	rs34960918	A	G	8	7	15	0	0	15	0	0
17	80114145	rs3935403	C	T	4	3	7	0	0	7	0	0
17	80114252	rs3935402	C	T	5	12	17	0	0	17	0	0
17	80114326	rs116852572	T	A	10	5	15	0	0	15	0	0
17	80114360	rs9900072	C	G	9	5	14	0	0	14	0	0
17	80114529	rs9911379	A	G	4	5	9	0	0	9	0	0
17	80114814	rs12051747	T	C	13	5	18	0	0	18	0	0
17	80115247	rs8070014	T	G	6	2	8	0	1	9	0	0
17	80115399	rs8065565	A	G	5	3	8	0	0	8	0	0
17	80115447	rs8080625	G	A	7	7	14	0	0	14	0	0
17	80136418	rs7209474	C	T	26	15	41	0	0	41	0	0
17	80151805	rs4789670	T	C	25	8	33	0	0	33	0	0
17	80151881	rs4789722	G	A	32	12	44	0	0	44	0	0
17	80159665	rs11653797	G	A	14	19	33	0	0	33	0	0
17	80172318	rs4247356	G	C	9	3	12	0	0	12	0	0
17	80187533	rs62079460	C	A	5	7	12	0	1	13	0	0
17	80189642	rs12450761	A	G	3	9	12	0	0	12	0	0
17	80191189	rs7502052	T	G	11	5	16	0	0	16	0	0
17	80191348	rs12601778	C	T	8	4	12	0	0	12	0	0
17	80191425	rs7503429	C	A	8	1	9	0	0	9	0	0
17	80194273	rs117905529	G	A	12	2	14	0	0	14	0	0
17	80195791	.	A	G	3	5	8	0	0	8	0	0
17	80214198	rs12601586	A	G	14	11	25	0	0	25	0	0
17	80218800	rs35693344	G	A	18	20	38	0	0	38	0	0
17	80230357	rs117777876	G	A	10	3	13	0	0	13	0	0
17	80230633	rs7209167	G	C	6	5	11	0	1	12	0	0
17	80248220	rs11655036	G	A	9	9	18	0	0	18	0	0
17	80279649	rs11575031	C	T	31	17	48	0	0	48	0	0
17	80279877	rs74451576	G	A	26	10	36	0	1	37	0	0
17	80280025	rs73999860	C	T	27	9	36	0	0	36	0	0
17	80280054	rs61738919	A	C	28	8	36	0	0	36	0	0
17	80285076	rs73999868	T	C	9	5	14	0	1	15	0	0
17	80285085	rs73999869	T	G	8	5	13	0	1	14	0	0
17	80350331	rs11903	G	A	66	42	108	0	1	109	0	0
17	80351104	rs7208956	T	C	5	9	14	0	0	14	0	0
17	80351428	rs4077609	G	C	2	5	7	0	0	7	0	0
17	80351550	rs6502105	G	C	4	2	6	0	0	6	0	0
17	80351639	rs7503819	A	G	4	2	6	0	0	6	0	0
17	80354859	rs72857427	G	T	3	6	9	0	0	9	0	0
17	80354937	rs59719801	G	C	5	6	11	0	0	11	0	0
17	80367275	rs111690356	T	C	19	14	33	0	0	33	0	0
17	80377690	rs1141463	T	G	3	11	14	0	0	14	0	0
17	80382929	rs12939367	A	G	12	6	18	0	1	19	0	0
17	80383844	rs9902897	G	A	2	5	7	0	1	8	0	0
17	80384152	rs9914195	A	G	4	12	16	0	0	16	0	0
17	80384338	rs9914652	A	G	2	5	7	0	0	7	0	0
17	80391684	rs4789773	A	G	14	11	25	0	1	26	0	0
17	80394873	rs117926109	G	A	1	6	7	0	0	7	0	0
17	80400626	rs11951	G	C	33	22	55	0	0	55	0	0
17	80401220	rs117272520	T	C	20	9	29	0	1	30	0	0
17	80401292	rs76370224	C	T	17	15	32	0	0	32	0	0
17	80401650	rs113066339	C	T	10	8	18	0	0	18	0	0
17	80404373	rs79854600	G	C	5	3	8	0	0	8	0	0
17	80404379	rs562221279	C	T	4	3	7	0	0	7	0	0
17	80407480	rs60529510	C	T	4	3	7	0	0	7	0	0
17	80407948	rs12450191	C	T	6	1	7	0	1	8	0	0
17	80407978	rs12450192	C	T	5	2	7	0	0	7	0	0
17	80412248	rs111348758	G	A	2	6	8	0	0	8	0	0
17	80415242	rs4789692	T	A	5	1	6	0	0	6	0	0
17	80415315	rs6502113	C	T	0	9	9	0	0	9	0	0
17	80415914	rs7209788	A	G	3	7	10	0	0	10	0	0
17	80415981	rs7218534	T	C	4	2	6	0	0	6	0	0
17	80416377	rs28365944	C	G	5	6	11	0	1	12	0	0
17	80419492	rs7211620	A	C	2	5	7	0	0	7	0	0
17	80419724	rs11077995	C	T	5	10	15	0	0	15	0	0
17	80423712	rs12450240	G	T	12	11	23	0	0	23	0	0
17	80424386	rs9891900	T	G	9	29	38	0	0	38	0	0
17	80424721	rs117818305	A	G	8	12	20	0	0	20	0	0
17	80426152	rs117939112	A	G	7	11	18	0	1	19	0	0
17	80427340	rs7406694	G	C	3	3	6	0	0	6	0	0
17	80438578	rs141554985	C	T	6	7	13	0	1	14	0	0
17	80438886	rs78524960	T	C	14	25	39	0	1	40	0	0
17	80439907	rs9898723	A	G	32	51	83	0	0	83	0	0
17	80439925	rs9905527	T	C	31	53	84	0	0	84	0	0
17	80441172	rs117078788	G	A	61	86	147	0	1	148	0	0
17	80441177	rs117262637	G	A	64	85	149	0	2	151	0	0
17	80442722	rs3829567	T	C	326	491	817	0	3	820	0	0
17	80443150	rs28457140	T	A	17	10	27	0	0	27	0	0
17	80443153	rs28534643	C	T	16	10	26	0	1	27	0	0
17	80445654	rs113771718	C	T	0	13	13	0	0	13	0	0
17	80447979	rs901372	C	T	24	17	41	0	1	42	0	0
17	80448017	rs901371	T	A	30	18	48	0	0	48	0	0
17	80522718	rs56979318	A	T	5	1	6	0	0	7	1	0
17	80526139	rs2291395	A	G	6	2	8	0	0	8	0	0
17	80526390	rs878822	C	T	0	6	6	0	0	6	0	0
17	80528996	rs3829566	C	T	9	0	9	0	0	9	0	0
17	80530279	rs3736204	C	T	13	37	50	0	0	50	0	0
17	80530347	rs3736205	T	C	19	42	61	0	0	61	0	0
17	80533844	rs112268660	G	A	6	0	6	0	0	6	0	0
17	80541103	rs4789804	C	T	4	3	7	0	0	7	0	0
17	80545238	rs3794717	A	G	3	3	6	0	1	7	0	0
17	80546228	rs56034282	G	A	8	3	11	0	0	11	0	0
17	80546876	rs60966564	G	A	3	11	14	0	0	14	0	0
17	80555850	rs58717680	C	G	3	3	6	0	0	6	0	0
17	80555865	rs60889372	T	C	3	3	6	0	0	6	0	0
17	80560494	rs4822	G	A	5	4	9	0	0	9	0	0
17	80561325	rs3794714	G	A	5	3	8	0	0	8	0	0
17	80562219	rs12944611	T	A	6	2	8	0	1	9	0	0
17	80562220	rs12939611	C	T	6	3	9	0	0	9	0	0
17	80573272	rs9271	A	G	352	279	631	0	3	634	0	0
17	80574082	rs753569	T	G	4	2	6	0	0	6	0	0
17	80574090	rs4789813	T	G	4	2	6	0	0	6	0	0
17	80577813	rs7210861	C	A	3	8	11	0	0	11	0	0
17	80580795	rs12944730	C	G	6	4	10	0	0	10	0	0
17	80580843	rs12949889	T	C	2	8	10	0	0	10	0	0
17	80583230	rs3826309	A	G	12	10	22	0	0	22	0	0
17	80583711	rs3826310	G	A	21	10	31	0	0	31	0	0
17	80583852	rs12451837	C	G	14	1	15	0	0	15	0	0
17	80584627	rs2291391	A	G	27	27	54	0	0	54	0	0
17	80585033	rs2291392	T	A	10	12	22	0	0	22	0	0
17	80585094	rs2291393	C	T	105	109	214	0	1	215	0	0
17	80588528	rs2306754	C	T	14	13	27	0	0	27	0	0
17	80675105	rs2280251	G	C	15	14	29	0	0	29	0	0
17	80676111	rs4789711	G	A	20	24	44	0	2	46	0	0
17	80676154	rs4789712	C	T	15	18	33	0	1	34	0	0
17	80676971	.	C	G	9	9	18	0	0	18	0	0
17	80677407	rs12941965	A	C	7	14	21	0	0	21	0	0
17	80677587	rs12946071	C	T	6	19	25	0	0	25	0	0
17	80677649	.	A	C	11	13	24	0	0	24	0	0
17	80679455	rs58867683	T	A	5	7	12	0	0	12	0	0
17	80680394	rs2246577	T	C	7	8	15	0	0	15	0	0
17	80680589	rs3748812	G	A	6	14	20	0	0	20	0	0
17	80683718	rs4510058	G	C	3	3	6	0	0	6	0	0
17	80685426	rs1046875	A	G	99	115	214	0	0	214	0	0
17	80685533	rs1046896	C	T	130	107	237	0	0	237	0	0
17	80685655	rs1046917	A	G	111	109	220	0	1	221	0	0
17	80699093	rs2252848	A	G	4	4	8	0	0	8	0	0
17	80708601	rs1056534	C	G	11	2	13	0	0	13	0	0
17	80877862	rs3744155	G	C	4	3	7	0	0	7	0	0
17	80878992	rs2279063	T	C	1	5	6	0	0	6	0	0
17	80887244	rs1127986	T	C	33	31	64	0	0	64	0	0
17	80897215	rs3744156	C	T	4	6	10	0	0	10	0	0
17	80899229	rs116857425	C	T	8	1	9	0	0	9	0	0
17	80899281	rs9390	G	A	61	54	115	0	0	115	0	0
17	80901002	rs3603	C	T	51	14	65	0	1	66	0	0
17	80901750	rs11077950	C	T	110	61	171	0	1	172	0	0
17	80901838	rs72861593	C	T	57	83	140	0	1	142	1	0
17	80904844	rs7225887	C	T	71	57	128	0	3	131	0	0
17	80905987	rs34143788	C	T	17	20	37	0	0	37	0	0
17	80906422	rs72861602	A	G	12	20	32	0	1	33	0	0
17	80907253	rs7222745	A	G	10	11	21	0	1	22	0	0
17	80907283	rs7222773	A	G	18	12	30	0	0	30	0	0
17	80907287	rs4986141	G	A	13	15	28	0	0	28	0	0
17	80907728	rs6502021	T	C	10	9	19	0	0	19	0	0
17	80908110	rs8069697	T	C	11	2	13	0	0	13	0	0
17	80908174	rs9906163	T	C	11	5	16	0	0	16	0	0
17	80908264	rs72862812	G	A	8	13	21	0	0	21	0	0
17	80908501	rs12949939	C	T	12	7	19	0	0	19	0	0
17	80908652	rs6502022	C	T	9	3	12	0	0	12	0	0
17	80909157	rs2380173	T	G	12	4	16	0	1	17	0	0
17	80910061	rs8076119	A	G	5	2	7	0	0	7	0	0
17	80911471	rs150027799	G	C	7	7	14	0	0	14	0	0
17	80911849	rs146836086	A	G	7	1	8	0	0	8	0	0
17	80915716	rs67082360	A	C	6	0	6	0	0	6	0	0
17	80986861	rs34614760	G	A	8	1	9	0	0	9	0	0
17	80987384	rs9899855	A	G	3	4	7	0	0	7	0	0
17	80992932	rs16940609	A	C	46	32	78	0	1	79	0	0
17	80995563	rs6502036	G	A	5	1	6	0	0	6	0	0
17	80995645	rs8065396	T	C	9	0	9	0	0	9	0	0
17	81006387	rs1143006	G	A	31	44	75	0	3	78	0	0
17	81006629	rs7406119	C	T	14	18	32	0	0	32	0	0
17	81006850	rs62073441	C	T	9	4	13	0	0	13	0	0
17	81039234	rs79964142	A	C	4	2	6	0	1	7	0	0
17	81039239	rs8068701	C	A	4	2	6	0	0	6	0	0
17	81039544	rs8069795	A	C	8	3	11	0	0	11	0	0
17	81039877	.	C	T	3	10	13	0	0	13	0	0
17	81040193	rs58635421	C	A	12	5	17	0	0	17	0	0
17	81041077	rs6502043	C	T	7	2	9	0	0	9	0	0
17	81041338	rs6502044	A	G	5	7	12	0	0	12	0	0
17	81041760	rs56848030	A	G	11	10	21	0	1	22	0	0
17	81041938	rs66468457	A	G	3	8	11	0	0	11	0	0
17	81042222	rs72854233	A	G	8	6	14	0	0	14	0	0
17	81042402	rs72854234	C	T	12	19	31	0	1	32	0	0
17	81042479	rs72854236	A	G	16	12	28	0	1	29	0	0
17	81042773	rs72854237	C	T	11	8	19	0	0	19	0	0
17	81045722	rs7406561	T	C	3	4	7	0	0	7	0	0
17	81047572	rs7405511	C	T	4	6	10	0	0	10	0	0
17	81049391	rs4986107	T	C	6	9	15	0	1	16	0	0
17	81049395	rs4986079	A	G	6	8	14	0	0	14	0	0
17	81049726	rs4986109	C	T	9	7	16	0	0	16	0	0
17	81049741	rs4986080	G	A	9	7	16	0	1	17	0	0
17	81049792	rs4986081	G	A	6	6	12	0	0	12	0	0
17	81049906	rs62074712	T	C	9	10	19	0	0	19	0	0
17	81051887	rs7223467	T	G	13	9	22	0	0	22	0	0
17	81052423	rs8269	G	A	59	118	177	0	0	177	0	0
18	21101011	rs2356683	G	A	3	9	12	0	0	12	0	0
18	22758936	rs8097117	G	A	13	0	13	0	0	13	0	0
18	23618586	.	G	T	16	19	35	0	0	35	0	0
18	29204098	rs8097755	T	C	7	12	19	0	0	19	0	0
18	29204210	rs1791161	C	T	3	3	6	0	0	6	0	0
18	29205359	rs41447647	G	A	8	6	14	0	1	15	0	0
18	29255261	rs718780	T	C	6	4	10	0	0	10	0	0
18	29258615	rs182741664	C	T	1	6	7	0	0	7	0	0
18	29259412	rs12327203	C	G	3	3	6	0	1	7	0	0
18	29264005	.	G	C	5	10	15	0	0	15	0	0
18	29264028	rs1449082	C	T	10	3	13	0	0	13	0	0
18	29432624	rs3737374	T	C	28	26	54	0	1	55	0	0
18	29454644	rs2276145	A	G	12	17	29	0	0	29	0	0
18	29484640	rs11665424	C	T	1	6	7	0	0	7	0	0
18	29488804	rs12326860	A	G	17	24	41	0	0	41	0	0
18	29521176	rs62093903	C	T	4	8	12	0	1	13	0	0
18	29598847	rs34097443	C	T	9	13	22	0	0	22	0	0
18	29647415	rs336281	G	T	3	3	6	0	0	6	0	0
18	29647869	rs8086733	G	A	2	8	10	0	0	10	0	0
18	29650152	rs661717	C	T	35	25	60	0	0	60	0	0
18	29671721	rs3760568	G	A	4	5	9	0	0	9	0	0
18	29672676	rs114104374	G	T	79	79	158	0	0	158	0	0
18	29698627	rs10853418	C	T	6	2	8	0	0	8	0	0
18	29698665	rs10853419	G	A	7	4	11	0	0	11	0	0
18	29702087	rs4239373	T	C	11	8	19	0	0	20	1	0
18	29702569	rs1814795	T	C	7	9	16	0	0	16	0	0
18	29704652	rs11081746	G	C	2	5	7	0	0	7	0	0
18	29711261	rs1054667	A	C	186	167	353	0	7	360	0	0
18	32440323	rs58956993	G	A	6	6	12	0	0	12	0	0
18	32440383	rs12953797	A	G	8	9	17	0	0	17	0	0
18	32714225	.	G	A	3	5	8	0	0	8	0	0
18	33049346	rs12457825	T	C	8	7	15	0	0	15	0	0
18	33161137	.	C	T	18	6	24	0	0	24	0	0
18	33570853	.	G	A	9	4	13	0	1	14	0	0
18	33745717	rs145132282	C	T	7	6	13	0	0	13	0	0
18	34370503	rs485935	C	A	4	8	12	0	0	12	0	0
18	34373794	rs58979547	A	G	3	9	12	0	0	12	0	0
18	34374865	rs11665141	A	G	8	5	13	0	0	13	0	0
18	34375487	rs11659465	A	G	5	4	9	0	0	9	0	0
18	34376565	rs11660414	C	T	57	35	92	0	1	93	0	0
18	34465924	rs149340082	C	T	23	16	39	0	0	39	0	0
18	34472083	rs72887031	C	A	5	3	8	0	0	8	0	0
18	36915528	rs112450376	T	C	6	0	6	0	0	6	0	0
18	36915582	rs112676479	C	T	6	0	6	0	0	6	0	0
18	42429610	rs630122	G	C	2	4	6	0	0	6	0	0
18	42465957	rs669738	A	C	9	0	9	0	0	9	0	0
18	42529996	rs11082414	G	C	4	6	10	0	0	10	0	0
18	42566287	rs11082417	C	T	4	6	10	0	0	10	0	0
18	43428936	rs2958437	T	C	3	3	6	0	0	6	0	0
18	43429337	rs1660561	A	G	5	3	8	0	0	8	0	0
18	43429966	rs2282614	C	T	14	16	30	0	0	30	0	0
18	43430139	rs570975	G	A	24	29	53	0	0	53	0	0
18	43430190	rs492411	C	A	24	26	50	0	0	50	0	0
18	43430409	rs1790299	C	A	20	13	33	0	0	33	0	0
18	43430870	.	C	T	149	120	269	0	2	271	0	0
18	43432292	rs507653	C	T	105	85	190	0	7	197	0	0
18	43481075	rs1893523	G	A	31	29	60	0	0	60	0	0
18	43490602	rs3744996	G	A	27	19	46	0	0	46	0	0
18	43497710	rs3744998	A	G	6	7	13	0	0	13	0	0
18	43516473	rs58306126	C	A	7	1	8	0	0	8	0	0
18	43533921	rs12454420	T	C	19	4	23	0	0	23	0	0
18	43563677	rs67746112	T	C	259	252	511	0	3	514	0	0
18	43563978	rs6507658	G	C	228	111	339	0	0	339	0	0
18	43564050	rs8084943	G	T	205	119	324	0	2	326	0	0
18	43564074	rs8084952	G	A	199	137	336	0	1	337	0	0
18	43564296	rs7229227	G	A	205	199	404	0	5	409	0	0
18	43564506	rs7229264	A	G	151	137	288	0	2	290	0	0
18	43564927	rs1438388	G	C	152	140	292	0	2	294	0	0
18	43565171	rs75348747	T	C	111	94	205	0	0	205	0	0
18	43565195	rs1048827	G	T	117	87	204	0	4	208	0	0
18	43565380	rs57589400	A	G	139	133	272	0	0	272	0	0
18	43565399	rs58786055	C	A	139	127	266	0	3	269	0	0
18	43565514	rs60116181	G	A	8	6	14	0	0	14	0	0
18	43565555	rs79723750	T	G	6	5	11	0	0	11	0	0
18	43566645	rs637001	C	T	3	5	8	0	0	8	0	0
18	43566798	rs7240441	A	G	2	4	6	0	0	6	0	0
18	43567101	rs7244712	A	G	5	2	7	0	0	7	0	0
18	43567199	rs7227161	T	C	7	9	16	0	0	16	0	0
18	43567289	rs57872016	G	C	6	3	9	0	3	12	0	0
18	43567295	rs61066139	T	C	6	5	11	0	0	11	0	0
18	43567534	rs58941766	C	T	6	4	10	0	0	10	0	0
18	43567622	rs11082504	A	T	2	4	6	0	0	6	0	0
18	43567868	rs4890308	C	A	1	8	9	0	0	9	0	0
18	43567936	rs4890608	A	G	4	6	10	0	0	10	0	0
18	43567993	rs4890609	G	A	4	6	10	0	0	10	0	0
18	43568593	rs3844540	T	G	1	6	7	0	0	7	0	0
18	43568717	rs2276199	T	C	133	113	246	0	2	248	0	0
18	43568904	rs2276197	C	G	2	9	11	0	0	11	0	0
18	43569240	rs4081459	T	C	6	6	12	0	0	12	0	0
18	43569401	rs4081460	G	A	3	5	8	0	0	8	0	0
18	43572325	rs4121893	G	A	2	4	6	0	0	6	0	0
18	43575196	rs7241551	T	C	4	5	9	0	0	9	0	0
18	43575318	rs7240541	A	G	4	2	6	0	0	6	0	0
18	43584201	rs6507659	G	A	4	2	6	0	0	6	0	0
18	43590426	rs674457	C	G	4	7	11	0	0	11	0	0
18	43590960	rs78972202	A	G	6	1	7	0	0	7	0	0
18	43596825	rs10502871	C	T	20	20	40	0	1	41	0	0
18	43598578	rs4890310	G	C	6	7	13	0	0	13	0	0
18	43599355	rs6507662	T	C	12	9	21	0	0	21	0	0
18	43600271	rs8097830	T	C	10	13	23	0	0	23	0	0
18	43644002	rs12959752	C	G	12	6	18	0	0	18	0	0
18	43644445	.	A	T	15	9	24	0	0	24	0	0
18	43672940	rs112472135	C	T	8	2	10	0	0	10	0	0
18	43673272	rs72903432	G	A	8	11	19	0	0	19	0	0
18	43673396	rs118129154	G	A	14	5	19	0	0	19	0	0
18	43673959	rs1964984	C	G	10	12	22	0	0	22	0	0
18	43674646	rs2850646	C	A	3	6	9	0	0	9	0	0
18	43676720	rs2578183	A	G	5	2	7	0	0	7	0	0
18	43676859	.	G	C	7	3	10	0	0	10	0	0
18	43684330	rs41274318	G	C	2	4	6	0	0	6	0	0
18	43684561	rs72903449	C	A	3	8	11	0	0	11	0	0
18	43684657	rs3744992	C	A	4	11	15	0	1	16	0	0
18	43689743	rs72903458	G	A	1	9	10	0	0	10	0	0
18	43797564	rs4890629	A	G	6	5	11	0	0	11	0	0
18	43798023	rs9675387	G	A	14	16	30	0	0	30	0	0
18	43802126	rs4574015	T	C	34	27	61	0	1	62	0	0
18	43802169	rs4542747	C	T	34	31	65	0	0	65	0	0
18	43802778	rs12607898	A	G	10	6	16	0	0	16	0	0
18	43805564	rs12963787	C	A	4	4	8	0	0	8	0	0
18	43805661	rs12963943	C	T	5	4	9	0	0	9	0	0
18	43806524	rs12969147	G	A	5	5	10	0	0	10	0	0
18	43808597	rs6507690	A	G	8	3	11	0	0	11	0	0
18	43808648	rs6507691	T	C	11	3	14	0	1	15	0	0
18	43809614	rs7240354	G	A	8	7	15	0	0	15	0	0
18	43810037	rs117383640	G	A	10	7	17	0	0	17	0	0
18	43811050	rs9959905	A	G	6	5	11	0	0	11	0	0
18	43811262	rs9960378	G	A	11	14	25	0	0	25	0	0
18	43811300	rs9949494	T	C	14	13	27	0	0	27	0	0
18	43811915	rs4890631	G	T	17	17	34	0	0	34	0	0
18	43812010	rs9952469	T	C	19	10	29	0	0	29	0	0
18	43812644	rs4890319	T	A	21	26	47	0	0	47	0	0
18	43844658	rs8086610	A	C	35	19	54	0	0	54	0	0
18	43845177	rs72905367	A	C	40	52	92	0	0	92	0	0
18	43845269	rs3744858	C	T	57	43	100	0	0	100	0	0
18	44063598	rs1377016	G	A	5	2	7	0	0	7	0	0
18	44121836	.	C	T	12	3	15	0	0	15	0	0
18	44149474	rs2086005	G	A	4	4	8	0	0	8	0	0
18	44151895	rs435770	T	C	2	4	6	0	0	6	0	0
18	44181227	rs10163657	C	T	7	7	14	0	0	14	0	0
18	45360991	rs1981	A	G	7	1	8	0	1	9	0	0
18	45386395	rs1787194	T	C	13	16	29	0	0	29	0	0
18	45387584	rs8099681	G	A	15	10	25	0	0	25	0	0
18	45388421	rs1792675	G	T	5	7	12	0	0	12	0	0
18	45390248	rs1792674	A	G	9	9	18	0	0	18	0	0
18	45408300	rs9966637	G	A	0	13	13	0	0	13	0	0
18	45410147	rs1792670	C	T	1	7	8	0	0	8	0	0
18	46343666	rs3764481	C	T	1	6	7	0	0	7	0	0
18	46388853	rs3809920	C	T	12	14	26	0	0	26	0	0
18	46389344	rs9950937	A	G	35	28	63	0	0	63	0	0
18	46916284	rs72642462	T	G	12	5	17	0	0	17	0	0
18	46917287	rs4939866	A	T	2	4	6	0	0	6	0	0
18	47017820	rs1943676	A	G	33	61	94	0	0	94	0	0
18	47313850	rs56085706	C	T	2	5	7	0	0	7	0	0
18	47319774	rs72923991	C	T	5	9	14	0	0	14	0	0
18	47777244	rs35193847	C	T	4	3	7	0	0	7	0	0
18	47803354	rs140686	C	T	69	60	129	0	3	132	0	0
18	47809871	rs12458654	G	T	19	12	31	0	2	33	0	0
18	47810251	rs3819217	C	G	20	21	41	0	0	41	0	0
18	47811374	rs17660776	G	A	172	171	343	0	0	343	0	0
18	47901471	rs11663953	C	T	5	5	10	0	0	10	0	0
18	47918639	rs10460085	A	C	20	17	37	0	1	38	0	0
18	47919224	rs9952721	T	C	15	5	20	0	0	20	0	0
18	48407652	rs2665560	C	T	7	9	16	0	0	16	0	0
18	48440699	rs76624846	A	G	4	2	6	0	0	6	0	0
18	48458662	rs649224	G	A	27	26	53	0	1	54	0	0
18	48514395	rs8088712	T	C	4	4	8	0	0	8	0	0
18	48549945	rs7244227	A	G	7	6	13	0	1	14	0	0
18	48552453	rs4390682	G	A	5	3	8	0	0	8	0	0
18	48562852	rs78801230	A	T	3	4	7	0	0	7	0	0
18	48577091	rs8084630	G	A	3	6	9	0	0	9	0	0
18	48577782	rs7229678	G	C	26	24	50	0	0	50	0	0
18	48610831	rs3819122	A	C	26	39	65	0	2	67	0	0
18	48709104	rs4940059	C	T	1	5	6	0	1	7	0	0
18	48723076	.	G	A	84	94	178	0	0	178	0	0
18	51682266	rs150484204	T	C	9	13	22	0	0	22	0	0
18	51796976	rs596887	C	T	5	5	10	0	0	10	0	0
18	51796996	rs524464	G	A	6	4	10	0	0	10	0	0
18	51797231	rs666027	A	G	8	6	14	0	0	14	0	0
18	51797332	rs3730682	A	G	9	6	15	0	0	15	0	0
18	51816408	rs12965763	G	A	3	3	6	0	0	6	0	0
18	51820805	rs8305	G	A	54	56	110	0	2	112	0	0
18	51907137	rs1046699	T	G	5	4	9	0	0	9	0	0
18	51908067	rs1061830	C	T	2	5	7	0	0	7	0	0
18	52895531	rs8766	T	C	23	27	50	0	0	50	0	0
18	52896509	rs2276195	G	A	3	3	6	0	0	6	0	0
18	54264534	rs496102	T	C	7	4	11	0	0	11	0	0
18	54265130	rs12968679	A	G	4	9	13	0	0	13	0	0
18	54265847	rs573399	G	A	3	3	6	0	0	6	0	0
18	54271248	rs2286984	T	A	16	19	35	0	0	35	0	0
18	54271371	rs11151970	C	A	12	12	24	0	0	24	0	0
18	54273424	rs643116	G	A	4	3	7	0	0	7	0	0
18	54279070	rs11660073	C	T	13	17	30	0	2	32	0	0
18	54279245	.	A	C	11	8	19	0	0	19	0	0
18	54279378	rs35096744	G	A	20	16	36	0	0	36	0	0
18	54279522	rs4801040	C	A	9	7	16	0	0	16	0	0
18	54280285	rs611549	G	A	16	14	30	0	0	30	0	0
18	54281286	rs17090266	T	G	6	11	17	0	0	17	0	0
18	54281790	rs655539	T	C	353	350	703	0	11	714	0	0
18	54281987	rs17090268	G	T	5	4	9	0	0	9	0	0
18	54283089	rs35529993	C	T	7	2	9	0	0	9	0	0
18	54305757	rs681176	G	A	165	152	317	0	0	317	0	0
18	54363747	rs1468742	A	G	1	6	7	0	0	7	0	0
18	54694452	rs3745033	C	T	3	3	6	0	0	6	0	0
18	54696407	rs1657396	T	C	7	7	14	0	0	14	0	0
18	54696421	rs185109777	C	T	5	8	13	0	0	13	0	0
18	54696444	rs3826642	C	A	4	9	13	0	0	13	0	0
18	55221648	rs536560	T	C	41	33	74	0	0	74	0	0
18	55226383	rs536765	G	C	32	26	58	0	0	58	0	0
18	55240505	rs1041951	C	T	37	17	54	0	0	54	0	0
18	55268486	rs11356	A	C	54	52	106	0	2	108	0	0
18	55270446	rs317831	A	C	6	8	14	0	0	14	0	0
18	55270936	rs317830	T	G	3	6	9	0	0	9	0	0
18	55272968	rs4940931	C	T	3	5	8	0	0	8	0	0
18	55297708	rs540680	C	G	5	6	11	0	0	11	0	0
18	55298886	rs411805	C	T	6	5	11	0	0	11	0	0
18	56815258	rs1814878	G	C	4	8	12	0	0	12	0	0
18	56815269	rs62095623	C	T	9	4	13	0	0	13	0	0
18	56995920	rs34753206	G	T	129	126	255	0	0	255	0	0
18	56995938	rs34679996	T	C	124	122	246	0	3	249	0	0
18	56996108	rs7236294	C	T	30	25	55	0	1	56	0	0
18	56996262	rs7239187	G	C	52	66	118	0	5	123	0	0
18	56996526	rs1043334	T	G	92	82	174	0	1	175	0	0
18	56998754	.	C	T	39	27	66	0	1	67	0	0
18	56998901	rs12959578	C	T	10	5	15	0	0	15	0	0
18	56999477	rs35219613	T	C	5	6	11	0	0	11	0	0
18	57000041	rs34912074	G	A	3	7	10	0	1	11	0	0
18	57002438	rs7244401	C	G	6	7	13	0	0	13	0	0
18	57003619	rs41528645	T	C	9	1	10	0	0	10	0	0
18	57003889	rs71357633	G	A	4	5	9	0	0	9	0	0
18	57004599	rs66850351	C	T	5	4	9	0	0	9	0	0
18	57005352	.	T	C	3	8	11	0	0	11	0	0
18	57005655	rs10515978	T	C	3	4	7	0	0	7	0	0
18	57005739	rs35746038	T	A	3	5	8	0	0	8	0	0
18	57018922	rs12963340	G	A	8	7	15	0	0	15	0	0
18	57019274	rs12964019	T	G	3	3	6	0	0	6	0	0
18	57022754	rs1127220	T	C	28	17	45	0	1	46	0	0
18	57026361	rs33926449	A	G	21	17	38	0	0	38	0	0
18	59726910	.	A	C	11	5	16	0	0	16	0	0
18	59727386	rs879656	T	A	3	9	12	0	0	12	0	0
18	59814268	rs9320000	G	A	8	2	10	0	0	10	0	0
18	59814324	rs9320001	G	C	6	2	8	0	0	8	0	0
18	59973657	rs1045950	C	T	4	8	12	0	1	13	0	0
18	60223842	rs10503073	G	A	8	8	16	0	0	16	0	0
18	60225760	rs17070098	T	C	6	5	11	0	0	11	0	0
18	60226704	rs55696318	A	T	13	10	23	0	0	23	0	0
18	60227833	rs17070100	T	C	35	34	69	0	0	69	0	0
18	60233766	rs78146763	C	T	9	5	14	0	0	14	0	0
18	60236565	rs11664892	T	G	6	5	11	0	0	11	0	0
18	60236676	rs75468922	G	A	6	3	9	0	0	9	0	0
18	60241699	rs34413962	T	C	57	52	109	0	0	109	0	0
18	60241732	rs3744926	C	T	61	55	116	0	0	116	0	0
18	60244855	rs77119162	C	T	110	82	192	0	1	193	0	0
18	60245247	rs3744927	G	A	124	97	221	0	2	224	1	0
18	60383927	rs76447412	C	T	5	7	12	0	0	12	0	0
18	60383982	rs12957017	G	A	6	6	12	0	1	13	0	0
18	60440257	rs74639039	G	A	9	0	9	0	0	9	0	0
18	60562298	rs624821	A	T	23	44	67	0	0	67	0	0
18	60562603	rs74418352	G	A	2	9	11	0	0	11	0	0
18	60645509	rs34061095	C	T	52	45	97	0	3	100	0	0
18	60646972	rs71353376	A	G	40	38	78	0	1	79	0	0
18	60981256	rs2051423	T	C	6	9	15	0	0	15	0	0
18	60984964	rs1893806	C	A	8	14	22	0	0	22	0	0
18	60985879	rs1801018	T	C	39	25	64	0	0	64	0	0
18	60986837	rs2279115	G	T	45	41	86	0	0	86	0	0
18	60995738	rs2551407	C	T	1	5	6	0	0	6	0	0
18	60996360	rs10460159	T	C	11	5	16	0	0	16	0	0
18	60997449	rs2850765	T	C	3	3	6	0	0	6	0	0
18	60997778	rs11663788	T	C	3	6	9	0	1	10	0	0
18	60998401	rs6810	A	G	89	98	187	0	0	187	0	0
18	61022791	rs2003149	C	T	30	25	55	0	1	56	0	0
18	61602360	rs35453062	G	A	73	67	140	0	1	141	0	0
18	61647069	rs1944270	G	A	50	67	117	0	0	117	0	0
18	61652719	rs72945626	T	G	9	8	17	0	1	18	0	0
18	61653115	rs72945629	G	T	18	12	30	0	0	30	0	0
18	61653570	rs73484274	C	G	38	38	76	0	0	76	0	0
18	61654463	rs3826616	A	G	107	115	222	0	2	224	0	0
18	66343998	rs117426990	G	C	49	42	91	0	0	91	0	0
18	67687860	rs2304378	T	C	16	14	30	0	0	30	0	0
18	67794783	rs117774280	C	T	13	9	22	0	0	22	0	0
18	67981349	rs147168574	G	A	30	22	52	0	0	52	0	0
18	67992279	rs2231562	G	A	43	35	78	0	0	78	0	0
18	71823160	rs75544106	C	T	3	3	6	0	0	6	0	0
18	71825719	rs8148	A	G	67	51	118	0	0	118	0	0
18	71928150	rs7238987	C	T	6	4	10	0	0	10	0	0
18	71959075	rs1051236	G	A	4	3	7	0	0	7	0	0
18	72167124	rs3764509	C	G	9	10	19	0	0	19	0	0
18	72170006	rs34676212	A	G	2	4	6	0	0	6	0	0
18	72170142	rs78044276	T	G	4	3	7	0	0	7	0	0
18	72171173	.	G	T	3	3	6	0	0	6	0	0
18	72175170	rs34868541	A	G	5	1	6	0	0	6	0	0
18	72176083	rs2278161	T	C	16	18	34	0	1	35	0	0
18	72183212	rs76001336	A	C	6	3	9	0	0	9	0	0
18	72185358	rs112316318	T	C	10	7	17	0	0	17	0	0
18	72243912	rs4892246	T	G	3	3	6	0	0	6	0	0
18	72945268	rs17056699	A	G	7	3	10	0	0	10	0	0
18	72945330	rs62089810	G	A	7	4	11	0	0	11	0	0
18	74070562	rs1047922	T	C	68	78	146	0	2	148	0	0
18	74149526	rs1056714	T	C	24	7	31	0	0	31	0	0
18	74149668	rs660029	A	G	3	13	16	0	0	16	0	0
18	74152017	rs689878	C	T	4	9	13	0	0	13	0	0
18	74152618	rs690392	G	A	2	5	7	0	0	7	0	0
18	74152717	rs55710939	T	C	3	5	8	0	1	9	0	0
18	74153146	rs59762437	G	A	6	1	7	0	0	7	0	0
18	74530943	rs9951735	T	A	5	3	8	0	0	8	0	0
18	74671768	rs470403	T	C	11	7	18	0	0	18	0	0
18	74681192	rs470683	G	A	28	18	46	0	0	46	0	0
18	74691189	rs1048947	G	T	4	3	7	0	0	7	0	0
18	74691225	rs6565924	A	G	6	2	8	0	1	9	0	0
18	74727631	rs12959006	C	T	12	24	36	0	1	37	0	0
18	74727699	rs62105705	C	T	28	9	37	0	0	37	0	0
18	74825228	rs1789093	G	A	1	8	9	0	0	9	0	0
18	74841350	rs57038555	C	T	9	1	10	0	0	10	0	0
18	74841492	rs74372563	C	T	4	8	12	0	0	12	0	0
18	74842984	.	A	C	14	7	21	0	0	21	0	0
18	74842986	.	A	C	14	7	21	0	0	21	0	0
18	74842988	.	A	C	14	7	21	0	0	21	0	0
18	74842990	.	A	C	14	7	21	0	0	21	0	0
18	74843041	.	G	A	6	20	26	0	2	28	0	0
18	74844467	rs62104563	G	C	11	4	15	0	0	15	0	0
18	74844599	rs62104564	G	C	19	8	27	0	0	27	0	0
18	74845353	rs9966986	A	G	7	8	15	0	0	15	0	0
18	77067000	rs3760541	T	G	21	20	41	0	0	41	0	0
18	77227554	rs35099556	C	T	28	13	41	0	0	41	0	0
18	77440816	rs62097686	G	A	1	7	8	0	0	8	0	0
18	77469970	rs117381185	C	T	9	5	14	0	0	14	0	0
18	77470189	.	C	T	2	5	7	0	0	7	0	0
18	77498379	rs4798911	C	G	5	4	9	0	0	9	0	0
18	77498387	rs4799082	C	G	5	4	9	0	0	9	0	0
18	77558934	rs1317903	C	G	4	3	7	0	0	7	0	0
18	77560878	rs509568	A	T	4	6	10	0	0	10	0	0
18	77560879	rs509573	A	T	4	6	10	0	0	10	0	0
18	77567601	rs8083903	C	G	3	3	6	0	0	6	0	0
18	77569307	.	T	C	7	1	8	0	0	8	0	0
18	77573548	rs4799088	A	G	3	5	8	0	0	8	0	0
18	77574374	rs71367544	C	T	10	7	17	0	0	17	0	0
18	77575613	rs56775891	C	T	23	40	63	0	0	63	0	0
18	77575871	rs34945223	A	G	27	42	69	0	0	69	0	0
18	77576337	rs71367545	G	A	30	32	62	0	0	62	0	0
18	77665222	.	G	A	11	13	24	0	0	24	0	0
18	77682662	rs56390815	T	C	5	2	7	0	0	7	0	0
18	77693268	rs62101198	G	A	4	5	9	0	0	9	0	0
18	77694168	rs2277725	T	G	7	7	14	0	0	14	0	0
18	77694294	rs2277724	C	A	10	5	15	0	0	15	0	0
18	77694439	rs59300126	C	A	5	5	10	0	0	10	0	0
18	77695384	rs7230837	T	A	33	25	58	0	0	58	0	0
18	77697110	rs11874805	T	C	7	6	13	0	1	14	0	0
18	77724726	rs8095764	A	C	12	11	23	0	0	23	0	0
18	77725625	rs1430598	G	C	6	4	10	0	0	10	0	0
18	77725699	rs1430597	A	G	5	8	13	0	1	14	0	0
18	77726944	rs9962647	G	C	28	16	44	0	0	44	0	0
18	77727126	rs4799112	T	C	16	7	23	0	0	23	0	0
18	77728045	rs2298644	C	T	59	67	126	0	0	126	0	0
18	77728135	rs2298645	G	T	98	84	182	0	0	182	0	0
18	77728594	rs34937055	A	G	10	10	20	0	0	20	0	0
18	77729549	rs7505247	T	C	11	12	23	0	0	23	0	0
18	77730197	rs4799113	A	G	13	14	27	0	0	27	0	0
18	77736735	rs4799116	T	C	9	16	25	0	0	25	0	0
18	77745640	rs10438902	A	G	9	17	26	0	0	26	0	0
18	77746403	rs11663328	T	A	3	3	6	0	0	6	0	0
18	77746623	rs8086024	T	C	33	43	76	0	0	76	0	0
18	77798033	rs11081587	C	T	5	6	11	0	0	11	0	0
18	77804809	rs11665551	G	A	2	4	6	0	0	6	0	0
18	77805949	rs3744873	A	C	36	44	80	0	2	82	0	0
18	77807211	rs72972292	C	T	6	0	6	0	0	6	0	0
18	77807228	rs72972293	C	A	8	0	8	0	0	8	0	0
18	77830588	.	A	G	6	2	8	0	0	8	0	0
18	77876658	rs4798941	G	A	6	3	9	0	0	9	0	0
18	77876701	rs4799134	C	T	6	5	11	0	0	11	0	0
18	77878457	rs12954186	C	T	3	3	6	0	0	6	0	0
18	77878486	rs12971129	G	C	3	3	6	0	0	6	0	0
18	77879658	rs61154317	C	T	2	7	9	0	0	9	0	0
18	77881878	rs58748616	G	T	4	4	8	0	0	8	0	0
18	77882568	rs4799135	G	A	2	4	6	0	0	6	0	0
18	77883888	rs59018136	T	G	1	5	6	0	0	6	0	0
18	77885421	rs6506805	C	T	6	2	8	0	0	8	0	0
18	77889826	rs7239975	G	C	6	6	12	0	0	12	0	0
18	77897478	rs3809927	C	G	96	99	195	0	3	198	0	0
19	199879	.	G	T	13	0	13	0	0	13	0	0
19	281360	rs7815	C	T	7	3	10	0	0	10	0	0
19	309476	rs58838051	A	G	4	6	10	0	0	10	0	0
19	338693	rs10416141	G	A	9	8	17	0	0	17	0	0
19	340700	rs882572	C	T	6	3	9	0	0	9	0	0
19	342331	rs4549009	A	G	4	2	6	0	0	6	0	0
19	344005	rs79196409	C	G	3	4	7	0	0	7	0	0
19	518914	.	G	T	13	9	22	0	0	22	0	0
19	576716	rs2238544	A	G	3	4	7	0	0	7	0	0
19	577347	rs8110980	C	T	15	9	24	0	1	25	0	0
19	577426	rs7252138	T	G	18	10	28	0	0	28	0	0
19	577436	rs7245585	G	C	16	9	25	0	0	25	0	0
19	578239	rs2283571	C	T	8	8	16	0	0	16	0	0
19	578663	.	G	C	13	12	25	0	0	25	0	0
19	578785	rs1138150	T	C	5	8	13	0	0	13	0	0
19	578794	rs1138151	A	G	4	9	13	0	0	13	0	0
19	579010	rs7253615	G	A	1	9	10	0	0	10	0	0
19	579035	rs2283572	C	T	1	9	10	0	0	10	0	0
19	579630	rs61729580	G	A	290	398	688	0	10	698	0	0
19	580154	rs2041192	A	G	6	9	15	0	0	15	0	0
19	580268	rs2108832	G	C	8	13	21	0	0	21	0	0
19	580333	rs11879069	G	A	8	12	20	0	0	20	0	0
19	580665	rs4682	T	C	419	532	951	0	5	957	1	0
19	582468	rs2074962	A	G	6	3	9	0	0	9	0	0
19	582505	rs2072309	G	A	13	3	16	0	0	16	0	0
19	582775	rs8637	A	G	468	559	1027	0	6	1033	0	0
19	582927	rs8259	T	A	342	538	880	0	12	892	0	0
19	610847	rs11085143	G	A	4	2	6	0	0	6	0	0
19	612234	rs10403485	A	G	3	8	11	0	1	12	0	0
19	613307	rs2301778	C	T	5	7	12	0	0	12	0	0
19	617614	rs41551212	G	A	80	65	145	0	0	145	0	0
19	617963	rs41546612	T	G	2	4	6	0	0	6	0	0
19	619139	rs11669180	G	A	0	10	10	0	0	10	0	0
19	621063	rs76890343	A	G	37	10	47	0	0	47	0	0
19	621070	rs77809401	G	A	36	10	46	0	0	46	0	0
19	629846	rs11550305	G	A	7	13	20	0	0	20	0	0
19	647645	rs192965845	C	T	121	132	253	0	0	253	0	0
19	649110	rs2040736	G	C	5	4	9	0	0	9	0	0
19	650931	rs2040738	A	G	7	5	12	0	0	12	0	0
19	651280	rs4919879	C	A	5	5	10	0	1	11	0	0
19	652238	rs11554788	A	G	87	92	179	0	1	180	0	0
19	652739	rs12973146	C	G	22	16	38	0	1	39	0	0
19	657666	rs3787004	C	T	4	3	7	0	0	7	0	0
19	682211	rs62134284	G	A	25	31	56	0	2	58	0	0
19	687279	rs12976484	T	C	11	8	19	0	0	19	0	0
19	687773	rs7359915	A	G	6	7	13	0	1	14	0	0
19	687799	rs7359916	A	C	7	6	13	0	0	13	0	0
19	687835	rs7359958	T	C	5	7	12	0	0	12	0	0
19	688243	rs61622571	C	T	5	5	10	0	0	10	0	0
19	688355	rs61602138	G	T	5	1	6	0	0	6	0	0
19	688379	rs12985435	T	C	6	2	8	0	0	8	0	0
19	689004	rs12609586	G	T	4	4	8	0	0	8	0	0
19	690639	rs10412005	C	T	3	4	7	0	0	7	0	0
19	690761	rs10422514	A	T	4	3	7	0	0	7	0	0
19	690762	rs10402839	T	G	4	3	7	0	0	7	0	0
19	691025	rs8108922	C	T	1	6	7	0	0	7	0	0
19	691391	rs35418707	G	T	4	2	6	0	0	6	0	0
19	747245	rs113424036	C	T	11	3	14	0	1	15	0	0
19	803686	rs116961534	G	A	5	6	11	0	1	12	0	0
19	805238	rs377123149	C	T	6	5	11	0	0	11	0	0
19	811423	.	A	G	126	118	244	0	3	247	0	0
19	815258	rs202012376	C	T	5	3	8	0	1	9	0	0
19	846548	rs631822	C	T	23	5	28	0	1	29	0	0
19	855162	rs7250194	T	A	26	6	32	0	0	32	0	0
19	855966	rs17216649	C	A	3476	2821	6297	0	37	6337	3	0
19	885818	rs1060442	A	G	11	13	24	0	1	25	0	0
19	897215	rs2930883	C	T	407	319	726	0	9	736	1	0
19	898657	rs2062422	G	A	5	9	14	0	1	15	0	0
19	903826	rs62132328	G	A	3	4	7	0	0	7	0	0
19	910742	rs168405	G	T	2	6	8	0	0	8	0	0
19	912852	rs350156	G	C	3	5	8	0	0	8	0	0
19	948358	rs2238576	T	C	2	4	6	0	0	6	0	0
19	960266	rs1683584	C	T	4	3	7	0	0	7	0	0
19	961054	rs1637996	T	C	1	5	6	0	0	6	0	0
19	962108	rs2238584	G	C	6	3	9	0	0	9	0	0
19	962161	rs2238585	C	T	6	4	10	0	0	10	0	0
19	965775	rs4807313	T	C	5	2	7	0	0	7	0	0
19	965830	rs111674541	A	G	3	3	6	0	0	6	0	0
19	966693	rs6510986	C	T	15	12	27	0	0	27	0	0
19	970630	rs4438418	A	G	1	5	6	0	0	6	0	0
19	971933	rs1051504	A	G	12	17	29	0	0	29	0	0
19	971949	rs1051505	G	A	13	10	23	0	0	23	0	0
19	972821	rs9789291	A	C	12	0	12	0	3	15	0	0
19	973971	rs12971369	T	A	45	27	72	0	0	72	0	0
19	974967	rs1056144	A	G	24	15	39	0	0	39	0	0
19	975387	rs11085230	T	C	8	6	14	0	0	14	0	0
19	1006572	rs739882	C	G	7	0	7	0	0	7	0	0
19	1006925	rs7251496	G	T	6	3	9	0	0	9	0	0
19	1007109	rs9989716	A	G	6	1	7	0	0	7	0	0
19	1007158	rs11085232	C	A	4	2	6	0	0	6	0	0
19	1009883	rs1058603	A	G	603	497	1100	0	21	1121	0	0
19	1010691	rs2240159	A	G	162	149	311	0	10	322	1	0
19	1011823	rs2240161	A	G	5	9	14	0	0	14	0	0
19	1011846	rs10420656	T	C	6	9	15	0	0	15	0	0
19	1011999	rs116854930	A	G	3	5	8	0	0	8	0	0
19	1012002	rs117246624	A	G	3	5	8	0	0	8	0	0
19	1012379	rs2240162	C	G	330	337	667	0	4	673	2	0
19	1012381	rs2240163	T	C	315	340	655	0	6	661	0	0
19	1013560	rs6510989	A	G	5	4	9	0	0	9	0	0
19	1014398	rs7146	A	G	422	361	783	0	5	788	0	0
19	1015784	rs182209161	C	G	3	7	10	0	1	11	0	0
19	1015909	rs3815172	A	G	5	12	17	0	0	17	0	0
19	1018318	rs739884	G	A	6	2	8	0	0	8	0	0
19	1018673	rs2240168	A	G	1	5	6	0	0	6	0	0
19	1020287	rs10414196	A	C	5	8	13	0	0	13	0	0
19	1020673	rs1005504	C	G	4	10	14	0	0	14	0	0
19	1021627	rs117481827	T	C	10	2	12	0	0	12	0	0
19	1028032	rs35981894	C	T	6	4	10	0	0	10	0	0
19	1028149	rs75364577	G	A	3	3	6	0	0	6	0	0
19	1030650	rs7252428	C	G	6	5	11	0	0	11	0	0
19	1030956	rs7256075	G	C	7	6	13	0	0	13	0	0
19	1032689	rs1141534	G	T	459	569	1028	0	6	1034	0	0
19	1032871	rs4630683	A	G	16	11	27	0	0	27	0	0
19	1035450	rs35190713	C	T	49	51	100	0	0	100	0	0
19	1036314	rs112340731	A	G	10	4	14	0	0	14	0	0
19	1036456	rs1064410	C	G	472	562	1034	0	8	1042	0	0
19	1036468	rs1064411	A	G	476	529	1005	0	4	1009	0	0
19	1036552	rs2304262	T	C	488	491	979	0	3	982	0	0
19	1036575	rs2304260	G	A	22	12	34	0	0	34	0	0
19	1036631	rs11672916	T	C	18	15	33	0	3	36	0	0
19	1036691	rs11670349	C	T	18	10	28	0	0	28	0	0
19	1036704	rs11670373	C	T	17	8	25	0	1	26	0	0
19	1036718	rs11667191	G	A	15	7	22	0	0	22	0	0
19	1036793	rs11672975	T	A	6	4	10	0	0	10	0	0
19	1036913	rs11670441	C	T	202	83	285	0	1	286	0	0
19	1037108	rs5014188	T	C	14	5	19	0	0	19	0	0
19	1037170	rs11665845	T	A	15	2	17	0	0	17	0	0
19	1037551	rs113353568	G	A	28	8	36	0	1	37	0	0
19	1037563	rs111525696	A	G	25	8	33	0	0	33	0	0
19	1037584	rs72973561	C	T	22	11	33	0	0	33	0	0
19	1037932	rs3848639	G	C	384	498	882	0	15	898	1	0
19	1038222	rs2020000	C	G	506	689	1195	0	7	1202	0	0
19	1038445	rs10419707	C	T	858	986	1844	0	6	1850	0	0
19	1038862	rs1141561	C	G	1065	1154	2219	0	18	2237	0	0
19	1038871	rs1135643	C	G	1070	1193	2263	0	12	2277	2	0
19	1038893	rs1057895	C	T	1117	1215	2332	0	3	2335	0	0
19	1038995	rs1057914	A	C	656	871	1527	0	3	1530	0	0
19	1052005	rs3764652	C	T	11	12	23	0	0	23	0	0
19	1054060	rs3752243	A	G	10	13	23	0	1	24	0	0
19	1055191	rs3745842	G	A	23	25	48	0	1	50	1	0
19	1056065	rs881768	A	G	13	21	34	0	0	34	0	0
19	1056492	rs3752246	G	C	33	36	69	0	0	69	0	0
19	1059004	rs2279796	A	G	2	7	9	0	0	9	0	0
19	1063303	rs4147924	C	T	6	0	6	0	0	6	0	0
19	1063310	rs4147926	C	G	6	0	6	0	0	6	0	0
19	1063312	rs558820627	C	T	6	0	6	0	0	6	0	0
19	1064193	rs4147930	G	A	44	19	63	0	0	63	0	0
19	1065018	rs4147934	G	T	16	4	20	0	0	20	0	0
19	1065563	rs2242437	G	C	8	1	9	0	0	9	0	0
19	1068734	rs3764653	T	C	57	60	117	0	3	120	0	0
19	1068738	rs1801284	G	A	61	59	120	0	2	122	0	0
19	1074000	rs2074442	A	T	59	69	128	0	6	134	0	0
19	1075035	rs3214170	A	C	4	2	6	0	0	6	0	0
19	1075720	rs2269846	C	G	41	33	74	0	0	74	0	0
19	1075979	rs757232	A	G	36	31	67	0	0	67	0	0
19	1076063	rs2269848	T	C	45	44	89	0	1	90	0	0
19	1076683	rs2240051	A	G	34	18	52	0	1	53	0	0
19	1077985	rs7251797	A	G	106	76	182	0	1	183	0	0
19	1079959	rs36084354	G	A	124	147	271	0	2	273	0	0
19	1080311	rs2074454	G	C	200	175	375	0	3	378	0	0
19	1081120	rs8113708	A	G	3	4	7	0	0	7	0	0
19	1081617	rs10404947	A	G	97	117	214	0	1	215	0	0
19	1083532	rs35646539	C	T	8	6	14	0	0	14	0	0
19	1083556	rs34593562	A	G	8	8	16	0	0	16	0	0
19	1083960	rs12975739	G	C	19	39	58	0	0	58	0	0
19	1084026	rs62131205	G	C	21	17	38	0	1	39	0	0
19	1084845	rs34912310	G	A	8	7	15	0	0	15	0	0
19	1085252	rs1142926	T	A	53	75	128	0	2	130	0	0
19	1085966	rs3761028	A	G	444	389	833	0	10	843	0	0
19	1086043	rs3761026	T	C	360	288	648	0	4	652	0	0
19	1086211	rs1061233	G	A	341	415	756	0	12	768	0	0
19	1086352	rs12471	C	A	510	490	1000	0	42	1042	0	0
19	1088078	rs2238586	G	T	12	22	34	0	0	34	0	0
19	1088285	rs6843	T	C	160	102	262	0	2	264	0	0
19	1106615	rs713041	T	C	782	788	1570	0	7	1577	0	0
19	1122520	.	G	T	30	32	62	0	0	62	0	0
19	1208072	rs7256801	T	C	0	6	6	0	0	6	0	0
19	1208289	rs1978728	C	T	3	6	9	0	1	10	0	0
19	1217560	rs3795063	C	G	3	4	7	0	0	7	0	0
19	1219129	rs35113943	G	A	11	8	19	0	0	19	0	0
19	1219191	rs2075605	A	G	13	4	17	0	0	17	0	0
19	1219274	rs34928889	G	A	18	19	37	0	0	37	0	0
19	1219553	rs11084889	G	T	29	18	47	0	1	48	0	0
19	1220004	rs35369365	A	G	51	36	87	0	0	87	0	0
19	1222012	rs2075607	G	C	3	3	6	0	0	6	0	0
19	1222316	rs2075608	C	T	5	6	11	0	0	11	0	0
19	1222443	rs60286867	G	C	6	7	13	0	0	13	0	0
19	1224286	rs35004890	G	T	13	15	28	0	0	28	0	0
19	1224934	rs7246159	G	A	10	7	17	0	0	17	0	0
19	1224935	rs12985504	T	C	10	7	17	0	0	17	0	0
19	1225028	rs36078268	T	C	8	11	19	0	0	19	0	0
19	1225054	rs7253853	T	G	9	16	25	0	0	25	0	0
19	1225547	rs59436472	C	T	20	21	41	0	0	41	0	0
19	1226004	rs12977689	C	A	13	9	22	0	0	22	0	0
19	1228191	rs10415095	T	C	20	8	28	0	1	29	0	0
19	1253425	.	C	G	15	14	29	0	0	29	0	0
19	1256998	rs9823	C	T	156	143	299	0	2	301	0	0
19	1258287	rs58612681	C	T	441	452	893	0	8	901	0	0
19	1268178	rs12975875	G	A	5	4	9	0	0	9	0	0
19	1271274	rs12609287	C	T	50	48	98	0	0	98	0	0
19	1271529	rs4807050	C	T	16	10	26	0	0	26	0	0
19	1272040	rs12488	T	C	1341	1290	2631	0	10	2643	2	0
19	1274539	rs8108009	T	C	47	44	91	0	2	93	0	0
19	1274601	rs1054695	C	T	52	37	89	0	1	90	0	0
19	1277275	rs757292	G	C	44	40	84	0	2	86	0	0
19	1319464	.	T	G	14	0	14	0	2	16	0	0
19	1386441	rs117700303	A	G	1	5	6	0	0	6	0	0
19	1388538	rs1142530	C	T	31	20	51	0	0	51	0	0
19	1389064	rs7258846	G	T	4	3	7	0	0	7	0	0
19	1389203	rs76175054	C	T	2	6	8	0	0	8	0	0
19	1389517	rs11666067	C	A	5	1	6	0	0	6	0	0
19	1390757	rs2074895	C	A	9	3	12	0	0	12	0	0
19	1390839	rs7256647	G	A	3	6	9	0	0	9	0	0
19	1391059	rs2074896	G	T	8	23	31	0	1	32	0	0
19	1392264	rs78825486	A	G	22	15	37	0	0	37	0	0
19	1392636	rs73515051	T	C	18	11	29	0	0	29	0	0
19	1394865	rs73515054	T	C	31	34	65	0	0	65	0	0
19	1395301	rs79526322	A	G	23	30	53	0	0	53	0	0
19	1395547	.	G	T	16	10	26	0	0	26	0	0
19	1413078	rs60042271	A	G	4	4	8	0	0	8	0	0
19	1419197	rs60221474	T	C	4	8	12	0	0	12	0	0
19	1419891	rs265266	A	G	4	3	7	0	1	8	0	0
19	1419914	rs4807926	T	C	6	4	10	0	1	11	0	0
19	1425448	rs11666805	C	T	8	5	13	0	0	13	0	0
19	1427260	rs3786983	C	T	3	10	13	0	0	13	0	0
19	1430896	rs11670759	A	G	5	4	9	0	0	9	0	0
19	1431647	rs8108743	T	C	13	13	26	0	0	26	0	0
19	1432303	rs74348591	C	T	6	4	10	0	1	11	0	0
19	1433103	rs78295495	G	A	23	16	39	0	0	39	0	0
19	1433423	rs79139068	G	C	13	7	20	0	0	20	0	0
19	1434135	rs7251937	T	C	24	25	49	0	0	49	0	0
19	1434842	rs61735591	C	T	220	183	403	0	2	406	1	0
19	1438865	rs7251165	C	T	2145	1890	4035	0	16	4051	0	0
19	1481481	rs1047854	G	A	3	7	10	0	0	10	0	0
19	1481559	rs1047852	C	T	6	13	19	0	0	19	0	0
19	1497543	rs1050017	A	G	3	15	18	0	0	18	0	0
19	1577208	rs1053151	G	A	103	81	184	0	0	184	0	0
19	1586217	rs4807934	G	A	9	14	23	0	0	23	0	0
19	1586274	rs4807122	C	T	6	8	14	0	1	15	0	0
19	1619333	rs1140828	G	A	18	13	31	0	0	31	0	0
19	1619339	rs8140	T	C	17	13	30	0	0	30	0	0
19	1621261	rs116208576	G	A	4	7	11	0	0	11	0	0
19	1782189	rs1054597	G	A	11	10	21	0	0	21	0	0
19	1782798	rs757528	A	G	16	8	24	0	0	24	0	0
19	1783261	rs2385387	C	T	7	4	11	0	1	12	0	0
19	1784890	rs3764605	A	G	5	3	8	0	0	8	0	0
19	1784944	rs3764606	A	G	6	2	8	0	0	8	0	0
19	1822107	rs146846786	G	C	18	23	41	0	1	42	0	0
19	1823033	rs149566385	G	A	20	20	40	0	0	40	0	0
19	1877023	rs541571053	T	C	83	65	148	0	2	150	0	0
19	1882094	.	A	G	52	58	110	0	1	111	0	0
19	1990753	.	G	A	60	53	113	0	4	117	0	0
19	1997363	rs1610045	A	G	57	48	105	0	1	106	0	0
19	2037846	.	A	C	877	609	1486	0	37	1523	0	0
19	2039435	rs547551679	A	G	305	241	546	0	5	551	0	0
19	2039511	rs561755800	G	T	309	293	602	0	19	621	0	0
19	2072038	rs8102231	T	C	125	93	218	0	0	218	0	0
19	2072646	rs4404194	T	C	68	51	119	0	1	120	0	0
19	2109157	rs25673	T	C	108	112	220	0	3	223	0	0
19	2109596	rs111707404	T	C	17	13	30	0	0	30	0	0
19	2109667	rs17604924	C	T	12	12	24	0	0	24	0	0
19	2109812	rs79162849	G	C	19	15	34	0	1	35	0	0
19	2109988	rs77265501	A	T	3	3	6	0	0	6	0	0
19	2110019	rs2074958	T	C	5	3	8	0	0	8	0	0
19	2110108	rs113684349	T	C	5	1	6	0	0	6	0	0
19	2110746	rs20567	G	A	104	101	205	0	1	206	0	0
19	2111035	rs79288884	C	T	3	3	6	0	0	6	0	0
19	2111038	rs77605654	G	C	3	3	6	0	0	6	0	0
19	2111382	rs17604954	G	A	6	10	16	0	0	16	0	0
19	2111397	rs75865123	T	C	7	10	17	0	0	17	0	0
19	2113301	rs117630602	C	T	4	2	6	0	0	6	0	0
19	2114175	rs55698722	T	C	48	40	88	0	2	90	0	0
19	2115439	rs2066764	C	G	4	2	6	0	0	6	0	0
19	2115493	rs2066775	A	G	3	3	6	0	0	6	0	0
19	2116649	rs2074960	A	G	29	24	53	0	1	54	0	0
19	2118692	rs34569645	C	T	24	19	43	0	0	43	0	0
19	2131148	rs12979965	A	G	4	2	6	0	1	7	0	0
19	2133332	rs12981497	C	G	3	5	8	0	0	8	0	0
19	2133465	rs12981780	C	T	1	8	9	0	0	9	0	0
19	2136102	rs2159213	T	C	3	3	6	0	0	6	0	0
19	2136703	rs4806831	C	T	4	2	6	0	0	6	0	0
19	2138654	rs25672	T	G	19	19	38	0	0	38	0	0
19	2167739	.	T	C	7	0	7	0	0	7	0	0
19	2190690	rs7248941	T	C	5	2	7	0	0	7	0	0
19	2190774	.	T	A	7	6	13	0	0	13	0	0
19	2190845	rs117505833	G	A	6	3	9	0	0	9	0	0
19	2191685	rs34982309	G	A	21	22	43	0	0	43	0	0
19	2191980	rs3815145	T	C	42	44	86	0	1	87	0	0
19	2192015	rs3815146	C	T	41	48	89	0	0	89	0	0
19	2192323	rs3815147	T	C	4	9	13	0	0	13	0	0
19	2195065	rs12983546	G	T	2	4	6	0	0	6	0	0
19	2196783	rs2269882	A	G	3	5	8	0	0	8	0	0
19	2198845	rs2269883	C	T	2	4	6	0	1	7	0	0
19	2200243	rs76569620	C	T	4	4	8	0	0	8	0	0
19	2200547	rs12982300	G	A	5	2	7	0	0	7	0	0
19	2202245	rs12985448	C	T	4	2	6	0	0	6	0	0
19	2204693	rs4807215	T	C	2	4	6	0	0	6	0	0
19	2205668	rs12981806	C	G	6	8	14	0	0	14	0	0
19	2206163	rs35792872	G	A	3	4	7	0	0	7	0	0
19	2206575	rs1003531	G	T	2	12	14	0	1	15	0	0
19	2207041	rs3746160	A	G	7	10	17	0	0	17	0	0
19	2207269	rs12983678	A	G	7	5	12	0	0	12	0	0
19	2221792	rs12462556	T	C	2	4	6	0	0	6	0	0
19	2226676	rs3815308	G	A	32	38	70	0	0	70	0	0
19	2245622	rs45521740	G	A	13	17	30	0	0	30	0	0
19	2248250	.	C	G	448	363	811	0	30	842	1	0
19	2270099	rs2250625	C	T	7	7	14	0	1	15	0	0
19	2270634	rs2523173	C	T	18	5	23	0	1	24	0	0
19	2271159	rs28384669	C	G	11	15	26	0	0	26	0	0
19	2271181	rs2523174	T	C	9	11	20	0	0	20	0	0
19	2271282	rs2074457	T	C	13	5	18	0	0	18	0	0
19	2271323	rs2523175	A	G	39	15	54	0	1	55	0	0
19	2271741	rs2074458	G	A	115	102	217	0	2	219	0	0
19	2276710	rs10409063	T	C	4	3	7	0	0	7	0	0
19	2281997	rs2158263	G	C	4	5	9	0	0	9	0	0
19	2292293	rs145366197	A	G	6	3	9	0	0	9	0	0
19	2292741	rs7252541	C	G	0	6	6	0	0	6	0	0
19	2294260	rs8113792	C	G	8	9	17	0	0	17	0	0
19	2294552	rs11084929	G	T	4	5	9	0	0	9	0	0
19	2295629	rs11879876	T	G	15	15	30	0	0	30	0	0
19	2295984	rs12462019	G	C	4	4	8	0	0	8	0	0
19	2296098	rs10418405	C	G	6	3	9	0	0	9	0	0
19	2325360	rs12984128	A	G	10	6	16	0	0	16	0	0
19	2336498	rs112220376	T	A	3	3	6	0	0	6	0	0
19	2342955	rs113581583	C	T	87	80	167	0	3	170	0	0
19	2346882	rs12982784	C	T	6	0	6	0	0	6	0	0
19	2424570	rs62122265	A	T	4	2	6	0	2	8	0	0
19	2424675	rs111768825	T	G	4	3	7	0	0	7	0	0
19	2425775	rs534837455	T	C	3	7	10	0	0	10	0	0
19	2426444	rs142721868	A	G	4	5	9	0	0	9	0	0
19	2426545	rs8105832	G	A	4	9	13	0	0	13	0	0
19	2427815	rs4806847	A	G	3	7	10	0	1	11	0	0
19	2430232	rs743578	T	C	28	21	49	0	0	49	0	0
19	2430637	rs1049910	C	G	41	48	89	0	1	90	0	0
19	2431272	rs4807263	T	G	7	8	15	0	0	15	0	0
19	2432073	rs733820	G	A	4	4	8	0	0	8	0	0
19	2438884	rs2288943	A	G	4	3	7	0	0	7	0	0
19	2439664	rs12462898	C	T	1	7	8	0	0	8	0	0
19	2440768	rs62119870	T	C	3	3	6	0	0	6	0	0
19	2477820	rs7354	C	A	480	483	963	0	7	970	0	0
19	2477823	rs14384	T	C	501	466	967	0	10	977	0	0
19	2512038	rs60833063	A	G	12	11	23	0	1	24	0	0
19	2512151	rs8112518	C	G	12	15	27	0	1	28	0	0
19	2512371	rs8102090	T	G	9	9	18	0	1	19	0	0
19	2512606	rs7258864	G	A	6	8	14	0	0	14	0	0
19	2714771	rs2014626	T	C	25	29	54	0	0	54	0	0
19	2732741	rs9160	G	A	61	53	114	0	0	114	0	0
19	2733250	rs61736898	C	T	26	28	54	0	0	54	0	0
19	2735363	rs62121118	C	T	114	105	219	0	1	220	0	0
19	2735891	rs61386578	G	C	67	56	123	0	0	123	0	0
19	2737474	rs10405932	T	C	7	3	10	0	0	10	0	0
19	2737551	rs10424305	G	A	20	7	27	0	0	27	0	0
19	2738352	rs4806874	A	G	5	1	6	0	0	6	0	0
19	2738643	rs11084955	C	T	3	6	9	0	0	9	0	0
19	2738705	rs11881479	C	T	7	4	11	0	0	11	0	0
19	2739696	rs10415622	A	G	16	13	29	0	0	29	0	0
19	2760716	rs12973643	C	T	14	7	21	0	0	21	0	0
19	2786397	rs1736194	C	G	3	3	6	0	1	7	0	0
19	2790394	rs1736176	G	A	6	2	8	0	0	8	0	0
19	2809672	rs1736183	A	G	12	3	15	0	1	16	0	0
19	2810248	rs1736184	G	A	8	2	10	0	0	10	0	0
19	2812018	rs117027861	C	G	11	1	12	0	0	12	0	0
19	2812153	rs941407	A	G	9	2	11	0	0	11	0	0
19	2813000	rs1736185	A	G	13	10	23	0	4	27	0	0
19	2859468	rs72982773	C	G	10	13	23	0	1	24	0	0
19	2917186	rs2288959	T	C	10	10	20	0	0	20	0	0
19	2917612	rs10410539	T	C	15	12	27	0	0	27	0	0
19	2936535	rs35699176	G	A	16	8	24	0	0	24	0	0
19	3057228	rs307716	A	C	26	27	53	0	0	53	0	0
19	3118311	rs79329720	C	T	3	6	9	0	0	9	0	0
19	3118389	rs308047	C	A	4	4	8	0	0	8	0	0
19	3121699	rs79137555	G	A	6	4	10	0	0	10	0	0
19	3121908	rs308040	C	G	2	5	7	0	0	7	0	0
19	3122941	rs2240564	T	C	4	6	10	0	0	10	0	0
19	3122945	rs2240565	C	G	7	4	11	0	0	11	0	0
19	3123113	rs415647	C	T	4	6	10	0	0	10	0	0
19	3146501	rs436493	G	A	3	12	15	0	0	15	0	0
19	3147071	rs12461303	T	C	13	1	14	0	0	14	0	0
19	3147326	rs12462845	G	A	8	0	8	0	0	8	0	0
19	3147643	rs28620329	G	A	14	6	20	0	0	20	0	0
19	3147798	rs62127296	A	G	10	0	10	0	1	11	0	0
19	3150418	rs2302063	C	A	3	54	57	0	0	57	0	0
19	3150577	rs74719458	G	A	87	1	88	0	0	88	0	0
19	3151458	rs2074863	G	A	6	132	138	0	0	138	0	0
19	3151686	rs72983023	A	C	4	128	132	0	0	132	0	0
19	3153774	rs310676	A	G	11	12	23	0	1	24	0	0
19	3155459	rs72983031	G	T	32	51	83	0	0	83	0	0
19	3155736	rs2074864	T	C	25	46	71	0	1	72	0	0
19	3157885	rs61758985	T	C	20	94	114	0	0	114	0	0
19	3157887	rs72983041	A	G	19	94	113	0	1	114	0	0
19	3157916	rs66509881	C	T	20	106	126	0	1	127	0	0
19	3158363	rs66786322	G	C	1	7	8	0	2	10	0	0
19	3158498	rs1614080	G	A	11	1	12	0	0	12	0	0
19	3158713	rs11882084	C	G	11	10	21	0	0	21	0	0
19	3158736	rs11880016	T	C	12	8	20	0	0	20	0	0
19	3158801	rs11882112	C	T	8	6	14	0	1	15	0	0
19	3158894	rs11881967	G	C	4	10	14	0	0	14	0	0
19	3159189	rs4807415	G	A	3	4	7	0	0	7	0	0
19	3159224	rs11880092	A	G	5	1	6	0	0	6	0	0
19	3159712	rs11880825	T	C	6	4	10	0	0	10	0	0
19	3159769	rs11880198	A	G	10	5	15	0	0	15	0	0
19	3159786	rs73530033	C	T	8	7	15	0	0	15	0	0
19	3160440	rs80116271	G	C	14	6	20	0	0	20	0	0
19	3161086	rs1637654	G	A	15	6	21	0	0	21	0	0
19	3161615	rs74404567	A	G	17	8	25	0	1	26	0	0
19	3162004	rs112085168	C	T	4	3	7	0	1	8	0	0
19	3162009	rs7257374	T	C	4	4	8	0	0	8	0	0
19	3162909	rs1637656	C	T	826	566	1392	0	8	1400	0	0
19	3163216	.	G	A	599	792	1391	0	11	1402	0	0
19	3178599	rs311633	A	G	7	7	14	0	0	14	0	0
19	3179427	rs143964699	G	A	27	35	62	0	0	62	0	0
19	3185563	rs507905	C	T	3	5	8	0	0	8	0	0
19	3185607	rs45579238	G	A	5	7	12	0	0	12	0	0
19	3185636	rs556075	T	C	5	7	12	0	0	12	0	0
19	3186085	rs11551095	G	T	6	6	12	0	0	12	0	0
19	3193484	rs499877	A	G	18	20	38	0	1	39	0	0
19	3194193	rs568441	C	A	7	10	17	0	0	18	1	0
19	3194240	rs527451	G	C	8	7	15	0	0	15	0	0
19	3194243	rs527453	C	T	8	7	15	0	0	15	0	0
19	3194595	rs482740	T	A	23	26	49	0	0	49	0	0
19	3195135	rs56971413	T	G	14	11	25	0	0	25	0	0
19	3195243	rs311614	G	T	17	9	26	0	0	26	0	0
19	3196122	rs311615	T	C	16	14	30	0	1	31	0	0
19	3196667	rs311617	C	T	5	1	6	0	0	6	0	0
19	3196746	rs118160328	C	T	2	4	6	0	0	6	0	0
19	3196999	rs186339	G	C	3	4	7	0	0	7	0	0
19	3199940	rs519266	T	C	4	2	6	0	0	6	0	0
19	3200637	rs2873039	A	G	3	4	7	0	0	7	0	0
19	3200799	rs892221	G	A	5	4	9	0	0	9	0	0
19	3202106	rs733502	C	T	4	2	6	0	0	6	0	0
19	3202679	rs892222	C	T	8	5	13	0	1	14	0	0
19	3208350	rs312070	A	G	127	121	248	0	3	251	0	0
19	3208418	rs312071	T	C	144	131	275	0	24	301	2	0
19	3209483	rs4594	T	G	195	147	342	0	0	342	0	0
19	3363565	rs4807453	C	T	4	3	7	0	0	7	0	0
19	3462240	rs6510755	T	C	3	4	7	0	0	7	0	0
19	3463532	rs189392307	C	G	5	7	12	0	0	12	0	0
19	3463765	rs115020939	G	A	15	21	36	0	0	36	0	0
19	3464320	rs3746298	G	C	12	17	29	0	0	29	0	0
19	3464321	rs3746299	G	C	12	17	29	0	0	29	0	0
19	3464523	rs6510757	G	A	4	4	8	0	0	8	0	0
19	3465118	rs713043	T	C	34	25	59	0	0	59	0	0
19	3466692	rs73919194	T	A	18	16	34	0	2	36	0	0
19	3467707	rs73919195	T	C	24	17	41	0	2	43	0	0
19	3467822	rs8113786	T	C	13	11	24	0	0	24	0	0
19	3467990	rs8110928	A	C	49	56	105	0	1	106	0	0
19	3468713	rs532655802	T	G	45	35	80	0	2	82	0	0
19	3523795	rs3746129	G	A	8	7	15	0	0	15	0	0
19	3524311	rs4807485	C	A	5	3	8	0	0	8	0	0
19	3527019	rs138835338	C	T	146	124	270	0	1	271	0	0
19	3527110	rs10420193	G	T	39	33	72	0	2	74	0	0
19	3534268	rs2369190	T	C	27	14	41	0	2	43	0	0
19	3534655	rs740685	G	A	4	14	18	0	0	18	0	0
19	3534696	rs740686	C	T	5	12	17	0	0	17	0	0
19	3535384	rs74867937	C	T	209	219	428	0	5	433	0	0
19	3535525	rs67967456	C	A	140	185	325	0	0	325	0	0
19	3535582	rs8109960	T	C	142	190	332	0	0	332	0	0
19	3535606	rs10415238	G	A	183	197	380	0	1	381	0	0
19	3536816	rs8100223	T	C	20	16	36	0	0	36	0	0
19	3537977	rs10406138	C	T	20	22	42	0	0	42	0	0
19	3538090	rs7248746	G	C	33	28	61	0	0	61	0	0
19	3538646	rs114420443	A	G	99	85	184	0	4	188	0	0
19	3538654	rs1128872	G	C	95	81	176	0	3	179	0	0
19	3539488	rs7253540	G	A	15	14	29	0	0	29	0	0
19	3539711	.	A	G	22	18	40	0	0	40	0	0
19	3548057	rs6510759	T	C	10	5	15	0	1	16	0	0
19	3551969	rs1715094	T	C	7	5	12	0	0	12	0	0
19	3552093	rs2240754	C	T	5	5	10	0	0	10	0	0
19	3553885	rs34822862	G	A	5	1	6	0	0	6	0	0
19	3554783	rs1715093	A	G	5	4	9	0	0	9	0	0
19	3555048	rs1638539	T	C	3	4	7	0	1	8	0	0
19	3571446	rs11085023	G	A	5	6	11	0	0	11	0	0
19	3577478	rs35682312	C	T	3	4	7	0	1	8	0	0
19	3579000	rs1443	C	T	492	433	925	0	3	928	0	0
19	3591590	rs2108389	T	C	7	7	14	0	0	14	0	0
19	3592171	rs8105780	T	C	4	3	7	0	0	7	0	0
19	3592730	rs10410258	C	T	7	7	14	0	0	14	0	0
19	3592731	rs10410259	C	T	7	7	14	0	0	14	0	0
19	3592855	rs10411250	A	C	6	7	13	0	1	14	0	0
19	3595032	rs5758	C	T	10	10	20	0	0	20	0	0
19	3595238	rs5756	G	A	5	6	11	0	1	12	0	0
19	3595794	rs4523	A	G	9	3	12	0	0	12	0	0
19	3595923	rs1131882	G	A	6	6	12	0	0	12	0	0
19	3611146	rs2074786	A	G	68	66	134	0	0	134	0	0
19	3611186	rs758016	C	T	59	56	115	0	1	116	0	0
19	3611190	rs758017	C	A	57	53	110	0	1	111	0	0
19	3611548	rs2369189	A	G	54	30	84	0	1	85	0	0
19	3611765	rs2369188	A	G	18	24	42	0	1	43	0	0
19	3611972	rs2158935	G	A	47	41	88	0	0	88	0	0
19	3612819	rs62130601	G	A	4	2	6	0	0	6	0	0
19	3612914	rs6510763	T	C	3	6	9	0	0	9	0	0
19	3613596	rs57918402	A	G	1	5	6	0	0	6	0	0
19	3614850	rs2074792	G	T	6	5	11	0	0	11	0	0
19	3615164	rs768962	A	G	3	3	6	0	0	6	0	0
19	3615407	rs768963	G	A	6	0	6	0	0	6	0	0
19	3616103	rs4806943	T	C	5	7	12	0	1	13	0	0
19	3616229	rs11085027	T	G	5	5	10	0	0	10	0	0
19	3616241	rs4806944	A	C	4	6	10	0	0	10	0	0
19	3616850	rs2369187	A	G	0	8	8	0	0	8	0	0
19	3617419	rs2024131	C	G	2	5	7	0	0	7	0	0
19	3617549	rs2024132	G	A	5	3	8	0	0	8	0	0
19	3622535	rs4807492	G	A	6	5	11	0	0	11	0	0
19	3631565	rs74322196	G	A	16	15	31	0	2	33	0	0
19	3631694	rs4806946	G	A	17	10	27	0	0	27	0	0
19	3636745	rs62130603	C	T	5	2	7	0	0	7	0	0
19	3963186	.	G	A	9	11	20	0	0	20	0	0
19	4036120	rs201218647	A	G	8	1	9	0	0	9	0	0
19	4175458	rs144013468	C	A	7	14	21	0	0	21	0	0
19	4288332	rs888930	A	G	4	5	9	0	0	9	0	0
19	4292841	rs28477168	C	G	18	15	33	0	0	33	0	0
19	4294623	rs58237134	C	A	15	16	31	0	0	31	0	0
19	4294807	rs78320454	G	A	17	14	31	0	0	31	0	0
19	4380752	.	C	T	6	3	9	0	0	9	0	0
19	4450735	rs111246916	G	A	12	5	17	0	1	18	0	0
19	4493708	rs892161	A	G	25	14	39	0	0	39	0	0
19	4493979	rs150536528	C	T	27	18	45	0	0	45	0	0
19	4499598	.	C	T	56	41	97	0	0	98	1	0
19	4502201	rs8887	T	C	2	4	6	0	0	6	0	0
19	4502282	rs13041	C	T	4	7	11	0	0	11	0	0
19	4510560	rs7251858	C	T	4	2	6	0	0	6	0	0
19	4511140	rs7255715	C	G	5	2	7	0	0	7	0	0
19	4511575	rs62115185	C	G	8	1	9	0	0	9	0	0
19	4511578	rs62115186	A	G	8	1	9	0	0	9	0	0
19	4511580	rs78884463	C	T	8	1	9	0	0	9	0	0
19	4512409	rs10410197	T	C	2	4	6	0	0	6	0	0
19	4513559	rs4807597	A	G	6	2	8	0	0	8	0	0
19	4525046	rs1610090	A	G	1	6	7	0	1	8	0	0
19	4538599	rs966384	G	A	23	15	38	0	1	39	0	0
19	4653370	rs4806994	C	G	14	8	22	0	0	22	0	0
19	4655166	rs3088098	A	G	43	45	88	0	0	88	0	0
19	4676140	rs10425839	T	G	56	73	129	0	4	133	0	0
19	4684118	rs11671570	C	T	4	4	8	0	0	8	0	0
19	4685276	rs10421782	A	C	9	3	12	0	0	12	0	0
19	4686053	rs7247786	T	C	18	17	35	0	0	35	0	0
19	4816241	rs1046673	G	A	37	37	74	0	3	77	0	0
19	4818378	rs7255265	T	C	18	14	32	0	1	33	0	0
19	4844790	rs34070230	G	C	181	161	342	0	1	345	2	0
19	4847868	rs10406652	G	A	136	144	280	0	2	282	0	0
19	5110794	rs2613739	A	G	3	6	9	0	0	9	0	0
19	5152387	rs2620828	T	C	19	25	44	0	0	44	0	0
19	5152445	rs2613804	T	C	14	33	47	0	0	47	0	0
19	5587240	rs73920021	G	A	189	183	372	0	9	381	0	0
19	5587540	rs113123495	C	T	160	122	282	0	1	283	0	0
19	5588441	rs2240236	A	G	32	44	76	0	0	76	0	0
19	5589132	rs57618432	G	A	18	14	32	0	2	34	0	0
19	5589383	rs59704629	C	T	30	28	58	0	0	58	0	0
19	5589964	rs73920022	A	G	31	34	65	0	0	65	0	0
19	5591701	rs56222752	C	T	21	8	29	0	0	29	0	0
19	5592547	rs10417622	T	C	6	8	14	0	0	14	0	0
19	5593771	rs3213651	A	G	9	5	14	0	0	14	0	0
19	5595354	rs10413286	T	C	4	2	6	0	0	6	0	0
19	5598357	rs7260385	A	G	9	6	15	0	0	15	0	0
19	5610045	rs806706	G	A	53	45	98	0	0	98	0	0
19	5645444	rs2436502	G	A	9	14	23	0	0	23	0	0
19	5655792	rs2485257	C	T	4	5	9	0	0	9	0	0
19	5664612	rs1538012	G	A	26	9	35	0	0	35	0	0
19	5666182	rs2002985	A	G	9	14	23	0	0	23	0	0
19	5666336	rs8104044	C	T	15	8	23	0	0	23	0	0
19	5684775	rs35832694	G	A	3	3	6	0	0	6	0	0
19	5694349	rs2485256	G	A	7	16	23	0	0	23	0	0
19	5694630	rs2436514	C	T	12	5	17	0	1	18	0	0
19	5696962	rs3892355	G	A	2	8	10	0	0	10	0	0
19	5702619	rs144311026	G	T	2	5	7	0	0	7	0	0
19	5704353	rs945704	T	C	2	6	8	0	0	8	0	0
19	5708720	rs35335072	C	T	26	26	52	0	1	53	0	0
19	5709412	rs1890098	C	T	41	18	59	0	0	59	0	0
19	5711217	rs2436508	T	C	18	19	37	0	0	37	0	0
19	5711930	rs11085147	C	T	57	48	105	0	1	106	0	0
19	5788890	.	G	C	3	4	7	0	0	7	0	0
19	5844537	rs778986	A	G	5	6	11	0	0	11	0	0
19	5847522	rs2608892	T	C	7	5	12	0	0	12	0	0
19	5847656	rs2608893	G	A	3	8	11	0	2	13	0	0
19	5847692	rs2637194	C	T	2	6	8	0	0	8	0	0
19	5848000	rs2608894	T	C	4	9	13	0	0	13	0	0
19	5850129	rs28362450	G	A	2	5	7	0	0	7	0	0
19	5851801	rs2306969	A	G	5	1	6	0	0	6	0	0
19	5853113	rs11671428	C	A	4	2	6	0	0	6	0	0
19	5853145	rs10418972	T	C	2	5	7	0	0	7	0	0
19	5853192	rs4807818	G	T	6	2	8	0	0	8	0	0
19	5853222	rs4807819	C	A	5	1	6	0	0	6	0	0
19	5856056	rs10414865	T	C	3	3	6	0	0	6	0	0
19	5856073	rs12977907	G	C	5	3	8	0	0	8	0	0
19	5866585	rs778982	C	T	13	8	21	0	0	21	0	0
19	5866654	rs778983	A	G	12	6	18	0	0	18	0	0
19	5866724	rs4807054	G	A	12	3	15	0	0	15	0	0
19	5866736	.	T	C	10	1	11	0	0	11	0	0
19	5866840	rs702065	T	C	5	1	6	0	0	6	0	0
19	5867177	rs778970	G	A	3	10	13	0	0	13	0	0
19	5867748	rs778971	G	T	6	2	8	0	0	8	0	0
19	5891746	rs1678866	G	C	3	3	6	0	0	6	0	0
19	5895358	rs72989070	C	T	13	8	21	0	1	22	0	0
19	5895561	rs72989073	C	T	6	7	13	0	0	13	0	0
19	5909780	rs420458	T	C	16	10	26	0	1	27	0	0
19	5910095	rs7260578	G	A	15	9	24	0	0	24	0	0
19	5933920	rs274792	C	T	13	16	29	0	0	29	0	0
19	5934233	rs274791	A	G	10	12	22	0	0	22	0	0
19	5936689	rs12462305	G	A	10	10	20	0	0	20	0	0
19	5937680	rs6510863	G	C	4	3	7	0	0	7	0	0
19	5949158	rs4807825	C	T	6	3	9	0	0	9	0	0
19	6120462	.	A	C	9	1	10	0	0	10	0	0
19	6211876	rs11085164	C	T	18	17	35	0	1	36	0	0
19	6212282	rs11553930	T	G	26	21	47	0	1	48	0	0
19	6214291	rs11669692	A	G	9	7	16	0	0	16	0	0
19	6214295	rs11673633	C	G	9	6	15	0	0	15	0	0
19	6215063	rs117232445	C	T	7	9	16	0	0	16	0	0
19	6475163	rs12976944	A	C	62	57	119	0	0	119	0	0
19	6475613	rs3745571	T	C	18	39	57	0	0	57	0	0
19	6476470	rs12983560	G	A	10	13	23	0	1	24	0	0
19	6476565	rs11669557	C	T	14	10	24	0	0	24	0	0
19	6476686	rs11665713	A	C	8	7	15	0	0	15	0	0
19	6476763	rs4807872	G	A	6	6	12	0	0	12	0	0
19	6477256	rs348398	G	T	65	64	129	0	1	130	0	0
19	6477324	rs348399	G	C	3	3	6	0	0	6	0	0
19	6480501	rs1975045	G	A	5	5	10	0	0	10	0	0
19	6495064	rs446199	C	G	17	9	26	0	0	26	0	0
19	6495589	rs118102196	G	A	2	5	7	0	1	8	0	0
19	6495736	rs2071347	A	G	4	3	7	0	0	7	0	0
19	6501314	.	C	T	7	11	18	0	0	18	0	0
19	6586268	rs1862511	G	A	3	7	10	0	0	10	0	0
19	6677989	rs17030	G	A	3	4	7	0	0	7	0	0
19	6731304	rs2279626	G	A	8	1	9	0	0	9	0	0
19	6732615	rs2047139	T	C	7	6	13	0	0	13	0	0
19	6732616	rs117789674	G	A	7	6	13	0	0	13	0	0
19	6732749	rs2047140	A	G	7	3	10	0	1	11	0	0
19	6732982	rs2012357	G	A	3	3	6	0	0	6	0	0
19	6751348	.	C	A	18	8	26	0	0	26	0	0
19	6808547	rs12710098	T	G	4	3	7	0	0	7	0	0
19	6821931	rs906331	G	C	0	6	6	0	0	6	0	0
19	6822219	rs347033	T	C	0	6	6	0	0	6	0	0
19	6833210	rs117509372	G	A	54	54	108	0	1	109	0	0
19	6849906	rs331677	A	T	4	7	11	0	0	11	0	0
19	6897464	rs330880	C	G	29	42	71	0	0	71	0	0
19	6901891	rs897738	G	A	23	28	51	0	0	51	0	0
19	6903920	rs443658	A	G	52	36	88	0	1	89	0	0
19	6904137	rs370094	C	T	38	25	63	0	0	63	0	0
19	6904641	rs4807913	T	C	5	4	9	0	0	9	0	0
19	6904710	rs4807106	T	G	4	2	6	0	1	7	0	0
19	6904764	rs4807107	G	T	12	1	13	0	0	13	0	0
19	6904786	rs4807108	G	A	17	2	19	0	0	19	0	0
19	6904797	rs4807109	A	G	17	4	21	0	0	21	0	0
19	6904812	rs10409287	T	C	16	4	20	0	1	21	0	0
19	6904875	rs10402834	C	T	15	3	18	0	0	18	0	0
19	6905105	rs4807110	G	C	6	6	12	0	0	12	0	0
19	6905440	rs2546137	T	C	9	2	11	0	0	11	0	0
19	6905590	rs2607128	G	C	9	2	11	0	0	11	0	0
19	6905597	rs2607127	T	C	9	2	11	0	0	11	0	0
19	6913707	rs466876	C	T	36	37	73	0	0	73	0	0
19	6925013	rs10424159	G	A	5	1	6	0	0	6	0	0
19	6926378	rs2228539	T	C	34	49	83	0	3	86	0	0
19	6929009	rs12973445	C	G	6	5	11	0	1	12	0	0
19	6929171	rs12461871	T	C	9	6	15	0	0	15	0	0
19	6931216	rs7246579	A	G	5	1	6	0	0	6	0	0
19	6931218	rs7249745	T	C	5	1	6	0	0	6	0	0
19	6932102	rs11879887	T	G	7	3	10	0	0	10	0	0
19	6933731	rs6510931	T	C	0	6	6	0	1	7	0	0
19	6933754	rs4635445	A	G	3	7	10	0	0	10	0	0
19	6953167	rs11085208	C	G	8	10	18	0	1	19	0	0
19	7084083	rs1541831	G	C	8	6	14	0	1	15	0	0
19	7085282	rs768488	T	C	6	12	18	0	0	18	0	0
19	7087002	rs2967647	C	G	18	14	32	0	0	32	0	0
19	7116963	rs1051690	T	C	3	7	10	0	0	10	0	0
19	7125297	rs1799817	G	A	3	10	13	0	0	13	0	0
19	7163065	rs2962	G	A	6	2	8	0	0	8	0	0
19	7166376	rs2059806	C	T	4	10	14	0	0	14	0	0
19	7166388	rs2229429	G	A	8	4	12	0	2	14	0	0
19	7466747	.	A	C	2	5	7	0	0	7	0	0
19	7532334	.	G	A	6	3	9	0	0	9	0	0
19	7542584	.	G	T	5	2	7	0	0	7	0	0
19	7569282	rs484870	A	G	12	8	20	0	0	20	0	0
19	7570031	rs653751	G	A	6	3	9	0	0	9	0	0
19	7570978	rs685034	T	C	16	12	28	0	0	28	0	0
19	7570990	rs685048	A	G	18	13	31	0	1	32	0	0
19	7571030	rs3826736	T	A	13	16	29	0	0	29	0	0
19	7571489	rs589710	C	T	14	24	38	0	0	38	0	0
19	7572169	rs505570	G	C	9	8	17	0	0	17	0	0
19	7572526	rs604625	G	A	21	27	48	0	0	48	0	0
19	7573098	rs475923	T	A	49	75	124	0	1	125	0	0
19	7573287	rs1133378	C	T	26	23	49	0	0	49	0	0
19	7573297	rs608144	T	C	22	22	44	0	0	44	0	0
19	7573301	rs1133380	C	T	19	19	38	0	0	38	0	0
19	7573731	rs620329	G	A	5	4	9	0	0	9	0	0
19	7593571	rs61736600	A	C	21	14	35	0	0	35	0	0
19	7593589	rs612862	C	T	17	13	30	0	2	32	0	0
19	7606908	rs17854645	G	C	12	18	30	0	0	30	0	0
19	7607475	.	C	T	13	15	28	0	0	28	0	0
19	7615903	rs8107538	G	A	5	6	11	0	0	11	0	0
19	7622226	rs1645800	G	A	1	8	9	0	0	9	0	0
19	7622360	rs8110625	C	T	3	5	8	0	0	8	0	0
19	7622528	rs503336	A	G	2	4	6	0	1	7	0	0
19	7622744	rs7245592	G	A	6	4	10	0	0	10	0	0
19	7622831	rs521032	T	C	4	12	16	0	0	16	0	0
19	7622835	rs506104	C	A	4	12	16	0	0	16	0	0
19	7622967	rs11878263	G	A	2	7	9	0	0	9	0	0
19	7623039	rs11880908	C	T	3	13	16	0	0	16	0	0
19	7623131	rs508786	G	A	4	11	15	0	0	15	0	0
19	7623410	rs546909	T	C	10	12	22	0	0	22	0	0
19	7623474	rs547713	T	C	4	11	15	0	0	15	0	0
19	7623584	rs548664	T	C	13	4	17	0	0	17	0	0
19	7623700	rs535208	G	A	9	29	38	0	0	38	0	0
19	7626071	rs62111319	T	C	5	6	11	0	0	11	0	0
19	7626275	rs45474094	C	G	5	6	11	0	0	11	0	0
19	7686282	rs4134861	A	T	5	3	8	0	0	8	0	0
19	7686647	rs4134859	C	T	5	5	10	0	0	10	0	0
19	7688614	rs2335521	T	C	1	18	19	0	1	20	0	0
19	7691001	rs4134838	G	C	24	6	30	0	1	31	0	0
19	7691465	rs1035465	G	A	16	12	28	0	1	29	0	0
19	7691949	rs4134831	A	G	19	16	35	0	0	35	0	0
19	7692076	rs4134826	T	C	14	14	28	0	0	28	0	0
19	7692083	rs4134825	G	A	16	13	29	0	0	29	0	0
19	7693814	rs4134815	G	A	4	3	7	0	0	7	0	0
19	7698320	rs1862514	C	T	13	6	19	0	0	19	0	0
19	7698760	rs4804756	A	G	2	4	6	0	0	6	0	0
19	7701748	rs7359905	T	C	6	1	7	0	0	7	0	0
19	7702575	rs8103237	G	A	32	45	77	0	1	78	0	0
19	7703605	rs8104339	C	T	27	14	41	0	1	42	0	0
19	7708903	.	G	A	11	0	11	0	0	11	0	0
19	7709271	rs3815754	A	G	42	42	84	0	2	86	0	0
19	7710040	rs929807	T	C	11	12	23	0	0	23	0	0
19	7710210	rs889187	A	G	34	20	54	0	4	58	0	0
19	7710269	rs710951	A	G	38	19	57	0	2	59	0	0
19	7710343	rs889185	G	A	43	18	61	0	0	61	0	0
19	7710603	rs889184	C	G	76	19	95	0	3	98	0	0
19	7711221	rs10001	T	C	574	620	1194	0	18	1212	0	0
19	7712161	rs55954306	C	T	135	139	274	0	10	284	0	0
19	7712277	rs6791	A	G	426	364	790	0	10	800	0	0
19	7712425	rs34976997	G	C	103	102	205	0	0	205	0	0
19	7712474	rs794074	G	A	115	137	252	0	2	254	0	0
19	7712585	.	T	G	128	147	275	0	13	288	0	0
19	8320890	rs2306199	T	G	14	8	22	0	0	22	0	0
19	8321946	rs36247	T	C	54	35	89	0	0	89	0	0
19	8326067	rs60517522	C	T	6	6	12	0	0	12	0	0
19	8326244	rs36258	A	G	3	3	6	0	0	6	0	0
19	8327196	rs12891	G	C	48	53	101	0	1	102	0	0
19	8374065	rs2232765	G	C	4	3	7	0	0	7	0	0
19	8374087	rs2232764	C	G	4	2	6	0	0	6	0	0
19	8375072	rs36262	G	A	2	5	7	0	0	7	0	0
19	8384229	rs3097182	A	G	11	1	12	0	1	13	0	0
19	8386701	rs2241590	G	A	70	52	122	0	1	123	0	0
19	8387207	rs1057232	G	A	2518	1200	3718	0	15	3733	0	0
19	8389520	rs1019757	C	T	3	3	6	0	1	7	0	0
19	8439467	rs2967616	G	A	6	4	10	0	0	10	0	0
19	8441779	rs7252574	C	T	2	4	6	0	1	7	0	0
19	8458299	rs111469245	T	A	3	3	6	0	0	6	0	0
19	8462773	rs2967609	C	A	5	3	8	0	0	8	0	0
19	8463631	rs7409035	C	T	5	1	6	0	0	6	0	0
19	8464653	rs2913970	G	A	6	9	15	0	0	15	0	0
19	8465991	rs112225432	G	A	1	5	6	0	0	6	0	0
19	8466254	rs10404380	C	A	4	2	6	0	0	6	0	0
19	8467768	rs2967606	A	G	32	30	62	0	1	63	0	0
19	8486884	rs1133893	G	A	33	30	63	0	0	63	0	0
19	8495765	rs2303180	G	A	4	5	9	0	1	10	0	0
19	8495887	rs2303179	T	A	5	5	10	0	0	10	0	0
19	8496677	rs1599872	G	T	4	2	6	0	0	6	0	0
19	8502105	rs7408474	C	A	2	4	6	0	0	6	0	0
19	8502389	rs7408511	C	T	4	2	6	0	0	6	0	0
19	8503025	rs3815783	G	A	8	4	12	0	0	12	0	0
19	8530049	rs628532	C	G	8	10	18	0	0	18	0	0
19	8530585	rs187239094	C	G	6	3	9	0	0	9	0	0
19	8531801	rs67296634	T	G	37	34	71	0	0	71	0	0
19	8532219	rs12610448	G	A	36	57	93	0	2	95	0	0
19	8533509	rs59319088	C	T	12	7	19	0	0	19	0	0
19	8546920	rs1812467	G	A	3	3	6	0	0	6	0	0
19	8548541	rs77520511	A	C	9	5	14	0	0	14	0	0
19	8548738	rs34356342	T	C	9	7	16	0	0	16	0	0
19	8555082	rs56293063	C	G	190	184	374	0	1	375	0	0
19	8556363	rs7408912	C	T	77	44	121	0	0	121	0	0
19	8557139	rs2396106	T	G	16	10	26	0	1	27	0	0
19	8557754	rs751180	G	A	9	5	14	0	0	14	0	0
19	8559763	rs34755496	C	T	11	5	16	0	1	17	0	0
19	8561287	rs3111565	C	T	7	4	11	0	0	11	0	0
19	8565119	rs28553436	G	A	2	4	6	0	0	6	0	0
19	8566299	rs2967595	C	T	3	3	6	0	0	6	0	0
19	8566634	rs1609712	G	A	4	9	13	0	0	13	0	0
19	8566894	rs2967597	T	C	4	7	11	0	0	11	0	0
19	8566954	rs2967598	A	G	3	5	8	0	1	9	0	0
19	8567238	rs2967599	G	C	5	2	7	0	0	7	0	0
19	8567475	rs968502	T	C	25	21	46	0	0	46	0	0
19	8567500	rs968501	G	A	13	10	23	0	0	23	0	0
19	8576307	rs2910443	A	G	36	35	71	0	0	71	0	0
19	8576670	rs7175	C	T	39	24	63	0	12	75	0	0
19	8576862	rs2287865	G	C	8	25	33	0	0	33	0	0
19	8576888	rs2042302	C	G	9	23	32	0	0	32	0	0
19	8577868	rs2967578	T	C	9	2	11	0	1	12	0	0
19	8578000	rs1064010	G	A	88	66	154	0	1	155	0	0
19	8578118	rs1064009	A	G	68	53	121	0	6	128	1	0
19	8578199	rs1141019	T	C	77	74	151	0	2	153	0	0
19	8578388	rs2967580	A	G	21	17	38	0	0	38	0	0
19	8578498	rs2910444	C	T	22	16	38	0	0	38	0	0
19	8578860	rs2287864	C	T	3	3	6	0	0	6	0	0
19	8579011	rs2287863	T	C	29	39	68	0	0	68	0	0
19	8585755	rs2913922	C	T	33	14	47	0	0	47	0	0
19	8586086	rs1054623	C	A	230	204	434	0	13	447	0	0
19	8595504	.	A	G	9	21	30	0	0	30	0	0
19	8596012	rs113576178	G	T	4	6	10	0	0	10	0	0
19	8596621	rs11882393	G	T	10	17	27	0	0	27	0	0
19	8597628	rs2967591	T	C	7	7	14	0	1	15	0	0
19	8597865	rs4804310	C	T	5	2	7	0	1	8	0	0
19	8600473	rs2967594	C	T	5	4	9	0	0	9	0	0
19	8602607	rs1975029	T	C	7	2	9	0	0	9	0	0
19	8608399	rs28432269	T	C	2	12	14	0	0	14	0	0
19	8610395	rs2967777	T	G	3	3	6	0	0	6	0	0
19	8610396	rs2967778	A	C	3	3	6	0	0	6	0	0
19	8610894	rs3111576	C	T	3	4	7	0	0	7	0	0
19	8616392	rs2013694	C	T	11	10	21	0	0	21	0	0
19	8619461	rs2913925	A	G	17	17	34	0	0	34	0	0
19	8619926	rs2913926	G	A	9	3	12	0	2	14	0	0
19	8620179	rs113312019	G	A	5	4	9	0	0	9	0	0
19	8626097	rs59138202	A	G	6	6	12	0	0	12	0	0
19	8627125	rs10424530	C	T	7	6	13	0	0	13	0	0
19	8627490	rs11673177	G	A	4	2	6	0	0	6	0	0
19	8628292	rs10406855	A	G	3	6	9	0	0	9	0	0
19	8640516	rs4804314	C	T	8	7	15	0	0	15	0	0
19	8651562	rs4476282	A	G	58	53	111	0	1	112	0	0
19	8654577	rs74178113	G	A	17	7	24	0	0	24	0	0
19	8657871	rs34134669	G	C	9	15	24	0	0	24	0	0
19	8658744	rs12985470	T	A	19	26	45	0	0	45	0	0
19	8660283	rs10432321	C	T	3	4	7	0	1	8	0	0
19	8664822	rs12611233	G	A	1	5	6	0	0	6	0	0
19	8665451	rs191391286	T	C	1	5	6	0	0	6	0	0
19	8669931	rs7255721	G	C	16	26	42	0	0	42	0	0
19	8920629	rs11787	A	G	22	24	46	0	0	46	0	0
19	8921486	rs1582532	T	C	17	24	41	0	0	41	0	0
19	8929558	rs55703654	G	T	5	1	6	0	0	6	0	0
19	8932388	rs2967727	G	A	3	3	6	0	0	6	0	0
19	8934907	rs2967749	C	T	11	9	20	0	0	20	0	0
19	8942045	rs2972587	C	T	8	3	11	0	0	11	0	0
19	9408658	rs73920733	G	A	6	13	19	0	0	19	0	0
19	9530342	rs2277931	G	A	15	20	35	0	2	37	0	0
19	9538581	rs10403167	G	T	4	3	7	0	1	8	0	0
19	9542007	rs11673601	G	T	1	5	6	0	0	6	0	0
19	9641956	rs67880216	G	A	6	11	17	0	0	17	0	0
19	9646137	rs888870	A	G	27	13	40	0	0	40	0	0
19	9646898	rs2042200	G	A	45	40	85	0	0	85	0	0
19	9671231	rs1141153	G	A	309	296	605	0	1	606	0	0
19	9671279	rs1134302	C	A	254	208	462	0	2	464	0	0
19	9672127	rs73006358	A	T	43	44	87	0	0	87	0	0
19	9672415	rs9676336	G	C	42	45	87	0	1	88	0	0
19	9672507	rs9676342	G	C	33	27	60	0	2	62	0	0
19	9673834	rs78449212	C	T	30	26	56	0	1	57	0	0
19	9716723	rs113694927	G	T	4	2	6	0	0	6	0	0
19	9717818	.	C	T	10	7	17	0	0	17	0	0
19	9929218	rs377733202	T	C	2	6	8	0	0	8	0	0
19	9946655	rs4804460	G	A	7	9	16	0	0	16	0	0
19	9959014	rs2287838	G	A	7	5	12	0	0	12	0	0
19	9959556	rs4804461	C	T	8	12	20	0	0	20	0	0
19	10203171	rs15723	A	G	198	179	377	0	0	377	0	0
19	10222195	rs12460842	A	G	48	76	124	0	0	124	0	0
19	10222205	rs73011214	G	A	79	49	128	0	2	130	0	0
19	10222558	rs2010353	G	T	18	43	61	0	1	62	0	0
19	10222862	rs112647895	G	A	62	48	110	0	1	111	0	0
19	10223296	rs73011220	G	A	62	77	139	0	1	140	0	0
19	10224131	rs12462506	T	G	74	85	159	0	0	159	0	0
19	10224548	rs3745601	G	A	72	83	155	0	2	157	0	0
19	10226052	rs2305795	G	A	19	26	45	0	1	46	0	0
19	10227010	rs3826784	A	G	105	88	193	0	0	193	0	0
19	10227149	rs3826785	C	T	105	111	216	0	5	221	0	0
19	10244554	rs73013012	G	A	19	13	32	0	0	32	0	0
19	10245946	.	G	A	9	10	19	0	0	19	0	0
19	10246029	rs8101626	G	A	9	8	17	0	0	17	0	0
19	10251747	rs2290684	A	G	28	29	57	0	0	57	0	0
19	10265593	rs2228613	G	T	95	94	189	0	0	189	0	0
19	10267077	rs2228611	T	C	91	77	168	0	1	169	0	0
19	10284778	rs759920	A	G	16	7	23	0	0	23	0	0
19	10287399	rs7253378	C	A	3	4	7	0	0	7	0	0
19	10287635	rs6511685	A	T	3	6	9	0	0	9	0	0
19	10332988	rs10409243	C	T	11	4	15	0	1	16	0	0
19	10334443	rs2116941	A	C	5	2	7	0	0	7	0	0
19	10364456	rs113186126	A	G	3	16	19	0	1	20	0	0
19	10367852	rs73015182	T	G	9	8	17	0	1	18	0	0
19	10370133	rs8104608	G	A	34	32	66	0	0	66	0	0
19	10370639	rs45504492	G	A	96	111	207	0	0	207	0	0
19	10385743	rs5030352	C	G	7	7	14	0	0	14	0	0
19	10390658	rs281432	C	G	4	4	8	0	0	8	0	0
19	10397131	rs281436	G	A	158	219	377	0	1	378	0	0
19	10397133	rs114170067	C	T	161	219	380	0	5	385	0	0
19	10397238	rs281437	C	T	89	88	177	0	0	177	0	0
19	10400810	rs11575073	C	T	8	3	11	0	0	11	0	0
19	10401120	rs11575074	G	A	7	7	14	0	0	14	0	0
19	10405865	rs10402760	C	T	13	10	23	0	0	23	0	0
19	10431799	rs281425	G	T	12	19	31	0	0	31	0	0
19	10444603	rs2230399	C	G	1157	1170	2327	0	6	2336	3	0
19	10444826	rs2278442	G	A	6	4	10	0	0	10	0	0
19	10445165	rs61198164	C	A	28	20	48	0	0	49	1	0
19	10449392	rs2304240	A	G	416	503	919	0	2	921	0	0
19	10462499	rs203999	T	C	21	5	26	0	0	26	0	0
19	10462672	rs12720328	C	T	15	10	25	0	0	25	0	0
19	10462960	rs12720326	G	C	9	17	26	0	0	26	0	0
19	10463480	rs280496	C	G	6	9	15	0	1	16	0	0
19	10464687	rs280497	A	G	122	149	271	0	8	279	0	0
19	10467565	rs12720307	C	T	3	3	6	0	0	6	0	0
19	10472160	rs143978290	G	A	6	1	7	0	0	7	0	0
19	10505203	rs28382788	A	T	3	4	7	0	0	7	0	0
19	10505207	.	A	T	2	4	6	0	1	7	0	0
19	10505211	rs11881260	T	A	4	3	7	0	0	7	0	0
19	10579474	rs7256672	T	G	8	4	12	0	0	12	0	0
19	10596811	rs3177696	T	C	5	6	11	0	0	11	0	0
19	10600442	rs1048290	G	C	31	44	75	0	0	75	0	0
19	10610236	rs1048287	A	G	23	34	57	0	0	57	0	0
19	10664661	rs34495400	C	T	108	82	190	0	1	191	0	0
19	10673801	rs145554379	G	A	2	6	8	0	0	8	0	0
19	10675748	.	G	A	11	7	18	0	1	19	0	0
19	10713735	.	G	A	54	55	109	0	1	110	0	0
19	10754400	rs1053007	A	G	269	282	551	0	4	555	0	0
19	10754905	rs10948	G	T	196	207	403	0	2	405	0	0
19	10764192	rs143985646	T	C	85	122	207	0	5	212	0	0
19	10764203	rs4804514	G	T	92	123	215	0	1	216	0	0
19	10788813	rs6511708	T	C	2	5	7	0	0	7	0	0
19	10793749	rs2738039	A	G	51	41	92	0	0	92	0	0
19	10794413	rs139961882	A	G	422	287	709	0	4	713	0	0
19	10794630	rs2229383	G	T	525	502	1027	0	8	1035	0	0
19	10794657	.	G	A	6	7	13	0	0	13	0	0
19	10794793	rs892087	C	T	5	10	15	0	0	15	0	0
19	10795892	rs141778417	C	T	803	765	1568	0	16	1584	0	0
19	10796074	rs118142475	C	T	653	754	1407	0	8	1415	0	0
19	10797763	rs76966440	C	T	9	5	14	0	0	14	0	0
19	10799750	rs2742313	T	C	11	11	22	0	0	22	0	0
19	10801185	rs8102380	G	A	82	83	165	0	0	165	0	0
19	10812407	.	G	A	2	10	12	0	0	12	0	0
19	10822278	rs6511709	A	C	2	4	6	0	0	7	1	0
19	10840201	rs10404348	A	G	3	4	7	0	1	8	0	0
19	10907286	rs34516961	A	G	7	7	14	0	0	14	0	0
19	10920315	rs114560542	C	T	4	8	12	0	0	12	0	0
19	10926521	rs3786717	T	C	4	3	7	0	0	7	0	0
19	11041052	rs12978180	T	C	5	2	7	0	0	7	0	0
19	11224181	rs1003723	C	T	5	2	7	0	0	7	0	0
19	11224265	rs5930	A	G	43	33	76	0	0	76	0	0
19	11227602	rs688	C	T	59	44	103	0	3	106	0	0
19	11229218	rs2738452	A	G	2	4	6	0	1	7	0	0
19	11230645	rs2569549	T	C	2	5	7	0	1	8	0	0
19	11230690	rs116959285	C	G	2	6	8	0	0	8	0	0
19	11230881	rs5925	T	C	51	56	107	0	0	107	0	0
19	11233941	rs5927	A	G	71	74	145	0	0	145	0	0
19	11411462	rs12327600	A	G	50	25	75	0	0	75	0	0
19	11411652	rs12327783	C	T	178	65	243	0	1	244	0	0
19	11411744	rs397707	G	A	195	67	262	0	5	267	0	0
19	11411868	rs420703	C	A	136	31	167	0	2	169	0	0
19	11412145	rs418547	G	A	2	4	6	0	0	6	0	0
19	11412663	rs322160	C	G	5	1	6	0	0	6	0	0
19	11413454	rs322158	A	G	4	2	6	0	0	6	0	0
19	11414049	.	G	C	4	3	7	0	0	7	0	0
19	11433625	.	T	C	63	50	113	0	3	116	0	0
19	11444131	rs896412	C	G	5	2	7	0	0	7	0	0
19	11465316	rs6887	G	C	39	28	67	0	0	67	0	0
19	11558275	rs11557488	G	A	657	598	1255	0	7	1262	0	0
19	11561299	rs4804598	A	T	26	18	44	0	0	44	0	0
19	11664139	.	G	T	155	119	274	0	2	276	0	0
19	11776766	rs111679389	C	T	16	0	16	0	3	19	0	0
19	11832283	rs5851	A	G	19	24	43	0	0	43	0	0
19	11939702	rs149680967	C	T	9	4	13	0	0	13	0	0
19	12049224	rs138368510	G	A	6	4	10	0	0	10	0	0
19	12140619	rs142614066	G	A	4	2	6	0	0	6	0	0
19	12159841	.	C	T	5	3	8	0	0	8	0	0
19	12622922	rs117459470	G	A	2	4	6	0	0	6	0	0
19	12741423	rs2861399	C	T	34	34	68	0	0	68	0	0
19	12741432	rs4804204	T	A	36	30	66	0	0	66	0	0
19	12741885	rs34220854	C	T	58	50	108	0	1	109	0	0
19	12758723	rs74181667	A	G	13	5	18	0	4	23	1	0
19	12768948	rs35836657	T	C	103	88	191	0	3	194	0	0
19	12771823	rs8108316	A	G	5	5	10	0	1	11	0	0
19	12772090	rs1133330	C	T	119	126	245	0	1	246	0	0
19	12772165	rs1054487	G	A	122	119	241	0	1	242	0	0
19	12774208	rs1054486	G	C	103	99	202	0	2	204	0	0
19	12782090	rs2861396	C	T	19	8	27	0	0	27	0	0
19	12782418	rs35542154	A	G	9	8	17	0	0	17	0	0
19	12787701	rs112671186	G	A	23	24	47	0	1	48	0	0
19	12790936	rs117917486	G	A	6	4	10	0	0	10	0	0
19	12811045	rs722572	T	C	84	87	171	0	2	173	0	0
19	12811379	rs722571	T	C	48	41	89	0	0	89	0	0
19	12811825	rs189203088	G	C	23	8	31	0	2	33	0	0
19	12857836	rs8100505	A	G	8	10	18	0	1	19	0	0
19	12958697	rs2290688	T	C	1	5	6	0	0	6	0	0
19	12985576	rs11085822	A	G	4	5	9	0	0	9	0	0
19	13002384	rs3745647	T	C	2	7	9	0	0	9	0	0
19	13010520	rs8012	A	G	6	10	16	0	0	16	0	0
19	13022859	rs2900660	C	A	2	8	10	0	0	10	0	0
19	13054781	rs1049481	G	T	474	663	1137	0	10	1147	0	0
19	13059147	rs11558955	A	G	213	214	427	0	8	435	0	0
19	13061983	rs2974754	C	T	5	4	9	0	0	9	0	0
19	13062663	rs2974755	C	T	9	5	14	0	0	14	0	0
19	13064322	rs7395	G	T	376	384	760	0	1	762	1	0
19	13207146	rs11555273	G	C	13	4	17	0	0	17	0	0
19	13207284	rs11555274	G	C	19	16	35	0	0	35	0	0
19	13212025	rs12151248	C	T	6	4	10	0	0	10	0	0
19	13220676	rs10414282	G	A	4	3	7	0	0	7	0	0
19	13220703	rs35601737	C	G	5	3	8	0	0	8	0	0
19	13264883	rs113016450	A	C	1114	904	2018	0	13	2032	1	0
19	13318811	rs147221323	C	T	4	2	6	0	0	6	0	0
19	13859267	rs109083	C	T	5	6	11	0	0	11	0	0
19	13870153	rs371671	C	A	13	16	29	0	0	29	0	0
19	13870227	rs517323	C	T	13	10	23	0	0	23	0	0
19	13870400	rs1473197	C	G	8	2	10	0	1	11	0	0
19	13871411	rs452960	A	T	20	16	36	0	0	36	0	0
19	13871554	rs375486	T	C	19	12	31	0	0	31	0	0
19	13871830	rs404195	A	G	6	15	21	0	0	21	0	0
19	13871858	rs73009852	C	T	13	3	16	0	0	16	0	0
19	13872240	rs8109392	G	A	23	22	45	0	1	46	0	0
19	13877762	rs6511888	T	C	1	12	13	0	0	13	0	0
19	13878063	rs346150	A	G	2	12	14	0	0	14	0	0
19	13878480	rs346151	G	A	1	9	10	0	0	10	0	0
19	13879344	rs62111897	G	A	6	18	24	0	0	24	0	0
19	13883099	rs1469071	A	G	28	49	77	0	1	78	0	0
19	13883635	rs73009867	C	A	2	10	12	0	0	12	0	0
19	13885127	rs346155	A	G	5	4	9	0	0	9	0	0
19	13910539	rs28480458	G	A	1	5	6	0	0	6	0	0
19	13912312	rs2594717	A	G	1	5	6	0	0	6	0	0
19	13942221	rs3745453	A	G	20	22	42	0	0	42	0	0
19	13942587	rs12610873	G	A	39	46	85	0	0	85	0	0
19	13947292	rs895819	T	C	6	7	13	0	0	13	0	0
19	14065534	rs1056142	A	C	16	13	29	0	1	30	0	0
19	14069083	rs4926322	C	T	8	6	14	0	0	14	0	0
19	14153293	rs35026308	T	C	19	22	41	0	0	41	0	0
19	14492265	rs2302997	T	C	46	66	112	0	1	113	0	0
19	14492272	rs2302996	T	C	108	110	218	0	1	219	0	0
19	14500714	rs28672314	C	G	6	0	6	0	0	6	0	0
19	14501544	rs7260110	A	G	3	3	6	0	0	6	0	0
19	14504025	rs35133209	A	G	5	6	11	0	0	11	0	0
19	14506664	rs3786656	C	T	6	2	8	0	0	8	0	0
19	14509770	rs7255389	G	C	4	2	6	0	0	6	0	0
19	14573654	rs2420538	A	G	5	1	6	0	0	6	0	0
19	14578707	rs35416389	G	A	727	622	1349	0	4	1353	0	0
19	14580635	rs74889788	G	A	38	37	75	0	1	76	0	0
19	14580638	rs78858120	T	C	36	40	76	0	0	76	0	0
19	14580662	rs74564226	G	A	39	42	81	0	0	81	0	0
19	14580865	rs79441155	G	T	8	5	13	0	0	13	0	0
19	14581063	rs1042728	A	G	1099	975	2074	0	9	2085	2	0
19	14582539	rs8598	C	T	277	293	570	0	3	573	0	0
19	14590236	rs3815715	C	T	18	33	51	0	1	52	0	0
19	14590279	rs45458894	G	C	22	11	33	0	0	33	0	0
19	14600305	rs4926220	C	T	10	0	10	0	0	10	0	0
19	14628242	rs755892	G	A	4	7	11	0	0	11	0	0
19	14629150	rs3962158	G	A	85	71	156	0	0	156	0	0
19	14659460	rs8112305	A	G	2	4	6	0	0	6	0	0
19	14800957	rs4808305	T	C	10	8	18	0	0	18	0	0
19	14815753	rs34156991	C	A	17	7	24	0	0	24	0	0
19	14815804	rs35325242	C	T	17	7	24	0	0	24	0	0
19	14818923	rs189415594	G	A	4	12	16	0	0	16	0	0
19	14819638	rs73012801	G	A	27	23	50	0	0	50	0	0
19	14820521	rs71334736	T	C	2	4	6	0	0	6	0	0
19	14820680	rs11669337	G	A	6	0	6	0	0	6	0	0
19	14823979	rs71334737	G	C	4	3	7	0	0	7	0	0
19	14829749	rs3764626	C	T	22	10	32	0	0	32	0	0
19	14833064	rs11669065	G	A	25	14	39	0	1	40	0	0
19	14836462	rs117863960	T	C	8	2	10	0	0	10	0	0
19	14837286	rs11671118	C	T	0	7	7	0	0	7	0	0
19	14839825	rs2732801	G	A	3	4	7	0	0	7	0	0
19	14839936	rs2732800	T	C	2	4	6	0	0	6	0	0
19	14846861	rs1064103	A	G	18	20	38	0	1	39	0	0
19	14856363	rs1029474	G	A	12	1	13	0	0	13	0	0
19	14856375	rs1029475	C	G	1	12	13	0	0	13	0	0
19	14856949	rs2732788	C	A	5	4	9	0	0	9	0	0
19	14857202	.	T	C	4	3	7	0	0	7	0	0
19	14877043	rs2074892	C	T	11	6	17	0	0	17	0	0
19	14877630	rs6511971	T	A	5	4	9	0	0	9	0	0
19	14879034	rs9305048	G	A	1	7	8	0	0	8	0	0
19	14880197	rs3795034	G	T	8	12	20	0	1	21	0	0
19	14880806	rs3829680	G	A	8	9	17	0	1	18	0	0
19	14881516	rs8112061	A	G	5	2	7	0	0	7	0	0
19	14884946	rs2302090	A	G	2	15	17	0	0	17	0	0
19	14884965	rs28492070	A	G	2	14	16	0	0	16	0	0
19	14885614	rs12459485	T	C	0	46	46	0	0	46	0	0
19	14885800	rs57712673	T	A	0	24	24	0	2	26	0	0
19	14885873	rs59670438	G	A	0	33	33	0	0	33	0	0
19	14886205	rs141687210	G	A	0	23	23	0	0	23	0	0
19	14886729	rs1108014	A	C	0	30	30	0	0	30	0	0
19	14886784	rs1108015	T	C	0	30	30	0	0	30	0	0
19	14886876	rs1108016	C	A	1	40	41	0	0	41	0	0
19	14886892	rs12980660	A	G	1	37	38	0	2	40	0	0
19	14886958	rs12980874	A	G	0	25	25	0	0	25	0	0
19	14887073	rs1860029	A	G	0	25	25	0	1	26	0	0
19	14887259	rs2286361	T	G	0	19	19	0	0	19	0	0
19	15233581	rs2074265	C	A	38	58	96	0	2	98	0	0
19	15233631	rs2074266	G	A	5	17	22	0	0	22	0	0
19	15234635	rs718100	T	G	5	7	12	0	0	12	0	0
19	15235137	rs4808212	A	G	5	5	10	0	0	10	0	0
19	15235147	rs4808213	A	G	6	6	12	0	0	12	0	0
19	15235192	rs4808214	A	G	4	6	10	0	0	10	0	0
19	15235932	rs4141356	G	A	11	13	24	0	0	24	0	0
19	15236342	rs2074267	A	C	5	6	11	0	0	11	0	0
19	15236462	rs12460929	T	C	4	3	7	0	0	7	0	0
19	15292437	rs1043997	T	C	4	2	6	0	0	6	0	0
19	15359259	rs3787030	G	A	7	9	16	0	0	16	0	0
19	15484023	rs148526102	C	T	46	39	85	0	1	87	1	0
19	15512720	rs10854143	T	C	3	4	7	0	0	7	0	0
19	15514660	rs7246816	G	A	13	7	20	0	0	20	0	0
19	15570931	rs3764566	G	A	6	9	15	0	1	16	0	0
19	15573655	rs11882108	A	G	5	2	7	0	0	7	0	0
19	15574057	rs6512034	T	C	4	3	7	0	0	7	0	0
19	15762250	.	T	C	7	7	14	0	0	14	0	0
19	15763248	rs2733749	A	T	10	7	17	0	0	17	0	0
19	15763270	rs2683038	C	G	6	6	12	0	0	12	0	0
19	15763721	rs1805042	G	A	19	19	38	0	0	38	0	0
19	15770784	rs3087897	G	A	30	13	43	0	0	43	0	0
19	15771250	rs28371514	T	G	17	15	32	0	0	32	0	0
19	15771253	rs28371515	G	C	17	15	32	0	1	33	0	0
19	15771257	rs28371516	T	C	19	12	31	0	1	32	0	0
19	15771602	rs28371518	C	T	6	1	7	0	0	7	0	0
19	15771635	rs28371519	T	A	5	2	7	0	0	7	0	0
19	15771732	rs7254281	G	A	11	7	18	0	0	18	0	0
19	15771773	rs7255242	C	T	15	12	27	0	0	27	0	0
19	15771808	rs7255356	C	T	15	14	29	0	0	29	0	0
19	15771811	rs28371522	T	C	15	15	30	0	0	30	0	0
19	15771971	rs7255510	C	T	13	3	16	0	0	16	0	0
19	15771978	rs2683042	G	A	15	5	20	0	0	20	0	0
19	15772233	rs1063803	T	G	26	16	42	0	0	42	0	0
19	15772377	rs1140862	T	A	18	22	40	0	0	40	0	0
19	15772414	rs7258240	G	A	15	15	30	0	0	30	0	0
19	15772499	rs4305201	T	A	11	11	22	0	0	22	0	0
19	15772530	rs4343408	C	T	8	11	19	0	0	19	0	0
19	15772548	rs10425683	A	G	8	10	18	0	0	18	0	0
19	15772564	rs4358060	T	A	8	7	15	0	1	16	0	0
19	15772717	rs3204846	A	G	17	16	33	0	1	34	0	0
19	15772738	rs1140863	G	A	19	17	36	0	0	36	0	0
19	15773078	rs368168502	C	G	14	0	14	0	1	15	0	0
19	15773339	rs2178775	C	T	13	9	22	0	2	24	0	0
19	16185188	rs10414221	C	G	15	9	24	0	0	24	0	0
19	16185371	rs10426103	T	C	11	13	24	0	1	25	0	0
19	16185419	rs10418402	G	T	11	16	27	0	0	27	0	0
19	16185757	rs12609899	T	C	17	8	25	0	0	25	0	0
19	16186030	rs11086022	G	A	10	7	17	0	0	17	0	0
19	16186465	rs8113101	G	T	6	6	12	0	0	12	0	0
19	16188555	rs4808032	A	G	27	42	69	0	1	70	0	0
19	16188556	rs4808451	A	C	27	43	70	0	0	70	0	0
19	16189243	rs2278006	A	T	51	38	89	0	0	89	0	0
19	16189583	rs1055886	C	G	55	31	86	0	0	86	0	0
19	16190701	rs8108396	G	C	44	34	78	0	1	79	0	0
19	16190702	rs8109182	C	T	45	34	79	0	0	79	0	0
19	16190802	rs3826723	G	A	53	56	109	0	0	109	0	0
19	16190906	rs56123108	A	G	84	59	143	0	1	144	0	0
19	16190912	rs17641735	G	A	90	58	148	0	0	148	0	0
19	16191338	rs10424913	C	T	65	62	127	0	3	130	0	0
19	16191579	rs10426172	A	G	47	39	86	0	3	89	0	0
19	16192407	rs9789272	C	T	50	29	79	0	0	79	0	0
19	16192625	rs7247875	G	A	82	62	144	0	2	146	0	0
19	16192898	rs3826722	A	G	8	6	14	0	0	14	0	0
19	16192958	rs3786577	A	G	1	8	9	0	0	9	0	0
19	16193337	rs3786576	G	T	4	5	9	0	0	9	0	0
19	16193350	rs3786575	C	T	4	4	8	0	0	8	0	0
19	16195037	rs8110506	G	A	7	4	11	0	0	11	0	0
19	16197421	rs2303149	A	G	6	8	14	0	0	14	0	0
19	16200378	rs11086023	C	T	3	3	6	0	0	6	0	0
19	16201136	rs10408301	T	C	6	2	8	0	0	8	0	0
19	16201223	rs10413672	T	C	5	4	9	0	0	9	0	0
19	16201924	rs3786572	A	G	4	4	8	0	0	8	0	0
19	16205676	rs4808452	C	G	4	11	15	0	0	15	0	0
19	16235369	rs58672212	G	A	3	5	8	0	0	8	0	0
19	16238279	rs1043308	C	T	131	109	240	0	3	243	0	0
19	16241000	rs2241401	G	A	13	15	28	0	0	28	0	0
19	16241454	rs12461558	C	T	6	4	10	0	1	11	0	0
19	16241737	rs4808456	G	T	19	25	44	0	1	45	0	0
19	16241884	rs62117910	T	A	10	5	15	0	0	15	0	0
19	16241886	rs62117911	G	A	10	5	15	0	0	15	0	0
19	16242733	rs4808457	C	T	23	19	42	0	1	43	0	0
19	16243416	rs3745313	C	T	109	118	227	0	2	229	0	0
19	16243590	rs3745314	A	C	199	185	384	0	2	386	0	0
19	16243795	rs17722795	T	C	214	257	471	0	1	472	0	0
19	16244056	rs1043346	C	A	263	221	484	0	4	488	0	0
19	16244226	rs1043407	G	A	279	243	522	0	6	528	0	0
19	16244326	rs1043452	G	C	212	198	410	0	24	435	1	0
19	16244817	rs2032882	A	G	192	209	401	0	5	406	0	0
19	16263202	rs285286	G	T	6	4	10	0	0	10	0	0
19	16268727	rs74965546	G	A	473	517	990	0	11	1002	1	0
19	16269141	rs432781	C	T	699	433	1132	0	1	1133	0	0
19	16273996	rs10421451	C	T	4	2	6	0	0	6	0	0
19	16274015	rs10420081	G	A	6	1	7	0	0	7	0	0
19	16274091	rs10421686	C	T	2	4	6	0	0	6	0	0
19	16301100	rs17722868	C	T	7	5	12	0	0	12	0	0
19	16301312	rs206231	A	G	10	6	16	0	1	17	0	0
19	16339715	rs3752797	C	T	49	27	76	0	2	78	0	0
19	16437235	rs7258799	A	T	18	13	31	0	0	31	0	0
19	16957638	rs2241377	A	C	5	8	13	0	1	14	0	0
19	16967738	rs11671121	C	T	13	5	18	0	1	19	0	0
19	16982830	rs2547096	G	C	8	5	13	0	0	13	0	0
19	16983401	rs71336795	C	T	12	6	18	0	0	18	0	0
19	16984045	rs117679803	C	T	6	13	19	0	0	19	0	0
19	16985445	rs115720157	T	C	18	16	34	0	1	35	0	0
19	16985627	rs62649775	T	G	19	18	37	0	0	37	0	0
19	16987670	.	G	A	2	4	6	0	0	6	0	0
19	16990687	rs1044773	A	G	92	91	183	0	2	185	0	0
19	16990795	rs2258772	T	C	94	99	193	0	1	194	0	0
19	17161093	rs7260259	T	C	6	3	9	0	0	9	0	0
19	17163661	rs2305758	C	T	55	53	108	0	2	110	0	0
19	17172934	rs6512162	C	T	4	3	7	0	0	7	0	0
19	17195997	rs10405158	A	G	5	3	8	0	0	8	0	0
19	17198073	rs10406406	C	T	5	1	6	0	0	6	0	0
19	17211568	rs10423719	T	C	4	2	6	0	0	6	0	0
19	17212101	rs12461009	T	C	4	3	7	0	0	7	0	0
19	17216475	rs7249490	T	C	24	17	41	0	0	41	0	0
19	17216624	rs7246553	A	G	25	15	40	0	0	40	0	0
19	17217760	rs10421381	G	C	2	4	6	0	1	7	0	0
19	17218551	rs4808568	A	G	8	8	16	0	0	16	0	0
19	17218601	rs74253204	G	A	10	8	18	0	0	18	0	0
19	17221189	rs116086056	A	G	7	3	10	0	0	10	0	0
19	17221789	rs80274449	C	T	13	11	24	0	0	24	0	0
19	17221992	rs73024368	C	T	7	7	14	0	0	14	0	0
19	17222017	rs79556020	C	G	8	7	15	0	0	15	0	0
19	17222367	rs12978739	A	G	3	3	6	0	0	6	0	0
19	17224329	rs17527173	A	G	5	6	11	0	0	11	0	0
19	17224526	rs78352768	C	T	5	1	6	0	0	6	0	0
19	17225055	rs75478558	C	T	7	3	10	0	0	10	0	0
19	17225227	rs79869295	G	C	11	6	17	0	0	17	0	0
19	17273893	rs7256689	G	T	86	68	154	0	0	155	1	0
19	17283989	rs4239629	G	C	5	7	12	0	0	12	0	0
19	17318012	rs79829421	G	A	259	240	499	0	1	500	0	0
19	17347616	rs8108035	T	C	8	5	13	0	0	13	0	0
19	17397481	.	G	T	7	23	30	0	4	34	0	0
19	17591768	rs6512196	C	G	2	5	7	0	1	8	0	0
19	17615915	rs10418594	T	C	7	5	12	0	0	12	0	0
19	17616041	rs4808657	G	A	8	11	19	0	0	19	0	0
19	17616171	rs2278280	G	A	10	13	23	0	1	24	0	0
19	17620323	rs4808658	C	T	4	5	9	0	0	9	0	0
19	17621362	rs55633219	T	C	5	2	7	0	0	7	0	0
19	17621508	rs1078000	A	G	5	5	10	0	0	10	0	0
19	17622614	rs11086075	C	T	7	11	18	0	0	18	0	0
19	17623339	rs8102140	A	G	6	3	9	0	0	9	0	0
19	17624714	rs11086076	G	A	7	4	11	0	0	11	0	0
19	17628587	rs6743	A	G	259	256	515	0	8	523	0	0
19	17691087	rs80183370	C	A	2	5	7	0	0	7	0	0
19	17692324	rs8100092	T	G	82	92	174	0	0	174	0	0
19	17693206	rs2303799	T	C	163	146	309	0	2	311	0	0
19	17693680	rs8090	G	A	306	249	555	0	8	563	0	0
19	17830975	rs55752165	C	T	4	2	6	0	0	6	0	0
19	17832302	rs10423961	G	A	6	1	7	0	0	7	0	0
19	17834798	rs3761054	G	T	4	2	6	0	0	6	0	0
19	17835520	rs8111532	A	G	2	7	9	0	0	9	0	0
19	17835831	rs3761055	T	G	2	9	11	0	0	11	0	0
19	17837425	rs17710707	C	G	15	16	31	0	0	31	0	0
19	17837981	rs7253548	A	G	57	55	112	0	1	113	0	0
19	17842221	rs12104396	G	C	3	3	6	0	0	6	0	0
19	17842620	rs12984126	A	G	4	3	7	0	0	7	0	0
19	17843747	rs6512219	T	G	8	5	13	0	0	13	0	0
19	17843795	rs6512220	T	C	5	5	10	0	0	10	0	0
19	17843861	rs8102950	A	G	2	5	7	0	0	7	0	0
19	17844325	rs2287860	T	C	6	8	14	0	0	14	0	0
19	17844637	rs3787026	T	C	8	7	15	0	0	15	0	0
19	17844894	rs7253117	A	G	13	6	19	0	3	22	0	0
19	17844942	rs7251815	G	T	20	12	32	0	0	32	0	0
19	17865479	rs726909	T	G	22	25	47	0	0	47	0	0
19	17885880	rs2287855	C	T	23	13	36	0	0	36	0	0
19	17936259	rs73014967	G	A	181	180	361	0	3	364	0	0
19	18054643	rs1052564	C	T	79	105	184	0	1	185	0	0
19	18112361	rs113540008	C	T	23	20	43	0	0	43	0	0
19	18116144	rs35928002	A	G	8	0	8	0	0	8	0	0
19	18117140	rs150431168	G	A	4	3	7	0	0	7	0	0
19	18234441	rs740691	C	T	7	10	17	0	0	17	0	0
19	18245512	rs2270623	C	T	16	14	30	0	0	30	0	0
19	18248146	rs541225	T	C	16	22	38	0	0	38	0	0
19	18255359	rs8108738	G	A	16	14	30	0	0	30	0	0
19	18257750	rs2072490	C	T	18	13	31	0	0	31	0	0
19	18258459	rs1566030	A	G	2	4	6	0	0	6	0	0
19	18273047	rs1011320	T	C	8	10	18	0	0	18	0	0
19	18279638	rs273269	T	C	13	10	23	0	0	23	0	0
19	18306751	rs62120383	G	A	7	2	9	0	0	9	0	0
19	18306990	rs17683509	G	C	33	25	58	0	3	61	0	0
19	18311199	rs1046565	A	G	7	9	16	0	0	16	0	0
19	18368810	rs999813	G	T	3	8	11	0	0	11	0	0
19	18368969	rs999814	G	A	4	6	10	0	0	10	0	0
19	18368988	rs999815	G	A	3	3	6	0	1	7	0	0
19	18369120	rs2891654	G	A	9	9	18	0	0	18	0	0
19	18369211	rs3810434	T	G	5	5	10	0	0	10	0	0
19	18370571	rs3810432	T	C	3	4	7	0	0	7	0	0
19	18371439	rs8105176	T	A	5	1	6	0	0	6	0	0
19	18371452	rs73523118	A	G	5	1	6	0	0	6	0	0
19	18372264	rs72479531	T	A	5	2	7	0	0	7	0	0
19	18384039	rs12461261	G	A	5	9	14	0	0	14	0	0
19	18384121	rs55817508	C	T	4	4	8	0	1	9	0	0
19	18384122	rs146942947	A	G	5	4	9	0	0	9	0	0
19	18384127	rs12981406	T	C	4	4	8	0	0	8	0	0
19	18384330	rs10854164	T	C	7	13	20	0	0	20	0	0
19	18384861	rs1079165	G	A	12	1	13	0	0	13	0	0
19	18390864	rs4393694	A	G	2292	1401	3693	0	262	3956	1	0
19	18391171	rs7249	C	T	501	489	990	0	22	1012	0	0
19	18470742	.	G	A	4	3	7	0	0	7	0	0
19	18475073	rs73009442	C	A	41	31	72	0	1	73	0	0
19	18475146	rs10854165	A	G	20	31	51	0	4	55	0	0
19	18475226	rs12462034	T	C	38	32	70	0	0	70	0	0
19	18477017	rs3746181	A	G	63	78	141	0	1	142	0	0
19	18477814	rs11881403	G	A	35	28	63	0	1	64	0	0
19	18477940	rs10408732	C	T	39	25	64	0	2	66	0	0
19	18479019	rs28568614	A	G	51	47	98	0	0	98	0	0
19	18479047	rs12610811	C	G	55	56	111	0	0	111	0	0
19	18479647	rs749451	T	C	175	160	335	0	0	335	0	0
19	18480171	rs1043063	C	T	286	197	483	0	3	486	0	0
19	18497024	rs1059519	G	C	12	6	18	0	0	18	0	0
19	18498808	rs1227732	T	G	7	0	7	0	0	7	0	0
19	18499780	rs1227733	A	G	10	8	18	0	0	18	0	0
19	18499784	rs1055150	C	G	10	8	18	0	0	18	0	0
19	18501986	rs3848646	T	G	13	18	31	0	1	32	0	0
19	18502078	rs3848647	A	G	38	51	89	0	0	89	0	0
19	18502119	rs3848648	C	T	36	51	87	0	0	87	0	0
19	18502301	rs4328570	C	T	33	48	81	0	2	83	0	0
19	18502337	rs3848649	C	G	28	31	59	0	7	66	0	0
19	18502374	rs116399833	C	A	34	37	71	0	6	77	0	0
19	18502565	rs6512262	G	C	64	51	115	0	2	117	0	0
19	18502691	rs6512263	A	C	50	77	127	0	2	129	0	0
19	18502728	rs6512264	C	A	53	94	147	0	0	147	0	0
19	18502835	rs6512265	G	A	79	67	146	0	0	146	0	0
19	18533642	rs7258465	T	C	12	8	20	0	0	20	0	0
19	18535607	rs28534973	C	T	10	4	14	0	0	14	0	0
19	18536416	rs8106096	C	G	7	9	16	0	0	16	0	0
19	18538742	rs10405636	A	C	131	94	225	0	2	227	0	0
19	18540935	rs35183199	C	G	5	1	6	0	0	6	0	0
19	18540988	rs11673604	T	C	4	3	7	0	0	7	0	0
19	18545341	rs10442	A	C	119	101	220	0	3	223	0	0
19	18545540	rs2385088	A	G	16	11	27	0	0	27	0	0
19	18545786	.	G	T	311	310	621	0	6	627	0	0
19	18546678	rs2303697	T	C	223	190	413	0	1	414	0	0
19	18547305	rs4595905	T	A	55	59	114	0	5	119	0	0
19	18554972	rs1043327	A	G	49	52	101	0	0	101	0	0
19	18562604	.	G	A	3	3	6	0	0	6	0	0
19	18562624	rs2303695	C	T	4	3	7	0	0	7	0	0
19	18565039	rs8107743	A	G	1	5	6	0	0	6	0	0
19	18566395	rs8103660	T	C	3	3	6	0	0	6	0	0
19	18650692	rs11086113	C	T	3	9	12	0	0	12	0	0
19	18652844	rs10854166	A	G	25	24	49	0	1	50	0	0
19	18669883	rs3803917	T	C	7	7	14	0	0	14	0	0
19	18669987	rs3803916	G	A	9	6	15	0	0	15	0	0
19	18671055	rs2058077	C	T	18	15	33	0	0	33	0	0
19	18671740	rs59798925	C	T	3	3	6	0	0	6	0	0
19	18679379	rs7648	C	G	118	110	228	0	0	228	0	0
19	18685964	rs6554	G	T	2150	1712	3862	0	14	3876	0	0
19	18686587	rs7258573	T	C	15	11	26	0	0	26	0	0
19	18686621	rs7254004	G	A	12	9	21	0	0	21	0	0
19	18686810	rs11672297	C	T	8	6	14	0	0	14	0	0
19	18687175	rs10425018	T	C	19	19	38	0	1	39	0	0
19	18687225	rs12610537	A	T	11	11	22	0	0	22	0	0
19	18687533	rs12608925	G	T	14	11	25	0	0	25	0	0
19	18688027	rs12150991	C	T	28	37	65	0	0	65	0	0
19	18698019	rs4808823	T	C	4	2	6	0	0	6	0	0
19	18699990	rs2074174	T	C	21	16	37	0	1	38	0	0
19	18700047	rs2074175	A	G	25	20	45	0	0	45	0	0
19	18702674	rs2002632	G	A	3	4	7	0	0	7	0	0
19	18703077	rs3170474	T	C	77	58	135	0	1	136	0	0
19	18750302	rs148152819	C	T	6	1	7	0	0	7	0	0
19	18775077	rs1076235	C	T	6	9	15	0	0	15	0	0
19	18777667	rs3829671	T	C	2	5	7	0	0	7	0	0
19	18778445	rs10421503	C	G	4	2	6	0	0	6	0	0
19	18780769	rs3795026	T	C	44	38	82	0	0	83	1	0
19	19010913	rs78547683	G	C	5	7	12	0	0	12	0	0
19	19011244	rs1127821	T	C	659	618	1277	0	7	1284	0	0
19	19011865	rs55962391	T	C	13	7	20	0	0	20	0	0
19	19012358	rs59977691	G	A	13	12	25	0	0	25	0	0
19	19014248	rs55988241	C	T	6	5	11	0	0	11	0	0
19	19015491	rs78590319	C	T	6	3	9	0	0	9	0	0
19	19016108	rs1468460	A	G	13	8	21	0	0	21	0	0
19	19016785	rs73003085	G	A	60	46	106	0	1	107	0	0
19	19016978	rs74253302	G	A	65	73	138	0	0	138	0	0
19	19017862	rs10330	G	A	397	499	896	0	3	899	0	0
19	19018311	rs77271628	A	C	90	70	160	0	4	164	0	0
19	19018614	rs73003087	C	T	146	117	263	0	2	265	0	0
19	19018962	rs74254003	C	T	95	81	176	0	0	176	0	0
19	19019800	rs73003090	G	A	52	35	87	0	0	87	0	0
19	19021010	rs78890951	C	T	34	35	69	0	1	71	1	0
19	19022204	rs10403594	T	C	5	3	8	0	0	8	0	0
19	19023573	rs117605534	A	G	7	2	9	0	0	9	0	0
19	19023853	rs3177137	T	C	416	363	779	0	7	786	0	0
19	19026851	rs75226807	A	G	9	6	15	0	0	15	0	0
19	19032224	rs75357755	G	T	3	5	8	0	1	9	0	0
19	19034011	rs8109947	C	T	3	4	7	0	0	7	0	0
19	19036063	rs4808876	C	A	9	10	19	0	0	19	0	0
19	19036871	rs10415986	G	C	38	25	63	0	1	64	0	0
19	19037053	rs2301661	T	C	33	30	63	0	1	64	0	0
19	19037294	rs2301662	G	A	6	2	8	0	0	8	0	0
19	19037685	rs2003449	C	G	8	6	14	0	0	14	0	0
19	19038071	rs739577	C	T	16	8	24	0	0	24	0	0
19	19039298	rs7497	T	C	122	117	239	0	2	241	0	0
19	19039490	rs9304958	T	G	3	4	7	0	0	7	0	0
19	19039652	rs62138075	C	T	5	2	7	0	0	7	0	0
19	19039908	rs62138076	G	A	10	2	12	0	1	13	0	0
19	19041260	rs4600580	G	A	4	7	11	0	0	11	0	0
19	19041490	rs28714268	T	C	6	2	8	0	0	8	0	0
19	19041552	rs4522526	C	T	3	5	8	0	0	8	0	0
19	19049194	rs11540741	G	A	79	115	194	0	6	200	0	0
19	19049198	rs1064351	G	A	127	78	205	0	4	209	0	0
19	19102590	rs12016	A	T	166	213	379	0	2	381	0	0
19	19103986	rs3810444	T	A	125	163	288	0	0	288	0	0
19	19104843	rs73006908	C	A	122	149	271	0	0	271	0	0
19	19105773	rs3180770	G	A	181	135	316	0	3	319	0	0
19	19108375	rs11671696	C	T	8	1	9	0	1	10	0	0
19	19108586	rs62138088	C	T	4	3	7	0	0	7	0	0
19	19109545	rs2269869	G	A	18	14	32	0	1	33	0	0
19	19109646	rs4808900	A	G	10	14	24	0	0	24	0	0
19	19110100	rs8111635	A	G	7	6	13	0	0	13	0	0
19	19110422	rs73006914	C	T	6	12	18	0	0	18	0	0
19	19110529	rs11878368	C	T	8	5	13	0	0	13	0	0
19	19113151	rs12978990	T	C	6	4	10	0	0	10	0	0
19	19115851	rs7253244	C	A	23	23	46	0	0	46	0	0
19	19117402	rs1124921	G	A	3	3	6	0	0	6	0	0
19	19117595	rs2013813	T	C	11	5	16	0	1	17	0	0
19	19117933	rs1079543	C	T	10	7	17	0	0	17	0	0
19	19130750	rs143729015	G	A	3	3	6	0	0	6	0	0
19	19130762	rs12978822	A	C	4	2	6	0	0	6	0	0
19	19136541	rs4808907	C	T	128	108	236	0	1	237	0	0
19	19165512	rs4808911	C	G	4	5	9	0	0	9	0	0
19	19218083	rs62138101	G	A	5	6	11	0	0	11	0	0
19	19222070	rs10417974	C	T	36	14	50	0	0	50	0	0
19	19230482	rs11729	T	C	16	16	32	0	0	32	0	0
19	19230868	rs756791	A	G	48	39	87	0	0	87	0	0
19	19287802	rs539	A	G	6	4	10	0	0	10	0	0
19	19287901	rs1050544	T	C	9	5	14	0	0	14	0	0
19	19390248	rs62135549	C	T	2	4	6	0	0	6	0	0
19	19416045	rs1010207	T	C	6	4	10	0	0	10	0	0
19	19431423	rs3934667	T	G	4	2	6	0	0	6	0	0
19	19431963	rs12460764	G	T	2	5	7	0	0	7	0	0
19	19432959	rs10402661	A	G	4	2	6	0	0	6	0	0
19	19434350	rs7254230	C	T	2	6	8	0	0	8	0	0
19	19440066	rs3764567	C	T	2	5	7	0	0	7	0	0
19	19445856	rs11085259	C	T	4	2	6	0	0	6	0	0
19	19446936	rs769267	G	A	25	20	45	0	1	46	0	0
19	19449686	rs2074090	G	T	40	41	81	0	0	81	0	0
19	19456398	.	C	G	7	7	14	0	0	14	0	0
19	19456917	rs58489806	C	T	12	7	19	0	0	19	0	0
19	19457908	rs2905421	A	C	11	16	27	0	0	27	0	0
19	19459215	rs968525	C	T	15	15	30	0	0	30	0	0
19	19459554	rs10421505	C	T	7	7	14	0	0	14	0	0
19	19465529	rs9304960	G	A	5	7	12	0	0	12	0	0
19	19467545	rs2285626	C	T	104	92	196	0	2	198	0	0
19	19467937	rs2285627	T	C	118	84	202	0	2	204	0	0
19	19467996	rs2285628	T	A	103	123	226	0	0	226	0	0
19	19468710	rs13964	C	G	45	34	79	0	0	79	0	0
19	19468734	rs15622	G	A	53	40	93	0	0	94	1	0
19	19469296	rs10403731	G	A	78	77	155	0	0	155	0	0
19	19602674	.	G	A	4	3	7	0	0	7	0	0
19	19602945	rs751856	A	G	4	6	10	0	0	10	0	0
19	19605763	rs1865034	C	T	3	4	7	0	0	7	0	0
19	19605963	rs2099333	C	T	3	4	7	0	0	7	0	0
19	19606264	rs2082421	C	T	4	4	8	0	0	8	0	0
19	19606634	rs1047361	G	A	109	120	229	0	0	229	0	0
19	19616742	rs1063966	G	A	150	137	287	0	6	293	0	0
19	19616953	rs1054284	T	G	224	236	460	0	10	470	0	0
19	19617655	rs6626	T	C	198	210	408	0	6	414	0	0
19	19619317	rs10282	T	C	21	21	42	0	0	42	0	0
19	19619542	rs6909	A	G	51	13	64	0	0	64	0	0
19	19642795	rs56397647	C	T	5	3	8	0	0	8	0	0
19	19643028	rs10422819	C	A	5	8	13	0	0	13	0	0
19	19646272	rs2304098	T	C	7	4	11	0	0	11	0	0
19	19648346	rs1054930	G	C	8	11	19	0	0	19	0	0
19	19675367	rs8108705	G	T	6	8	14	0	0	14	0	0
19	19675696	rs73004933	C	T	5	6	11	0	0	11	0	0
19	19734539	rs1054685	C	T	121	95	216	0	1	217	0	0
19	19746151	rs2304128	G	T	4	3	7	0	0	7	0	0
19	19746602	.	C	G	3	7	10	0	0	10	0	0
19	19753292	rs7248885	G	A	3	7	10	0	0	10	0	0
19	19753882	rs3794995	C	T	18	12	30	0	1	31	0	0
19	19764795	.	C	T	97	98	195	0	1	196	0	0
19	19793545	rs56408111	T	C	8	4	12	0	0	12	0	0
19	19821790	.	G	A	154	139	293	0	1	294	0	0
19	19821825	rs3207975	T	C	129	158	287	0	2	289	0	0
19	19822049	rs7246866	T	C	102	114	216	0	2	218	0	0
19	19826240	rs2013571	C	G	8	14	22	0	0	22	0	0
19	19827724	rs56167115	C	T	7	7	14	0	0	14	0	0
19	19827898	rs73006760	G	A	14	7	21	0	0	21	0	0
19	19827948	rs73006763	C	T	12	8	20	0	0	20	0	0
19	19830928	rs11665940	C	T	3	4	7	0	0	7	0	0
19	20283752	rs140083802	G	A	5	3	8	0	0	8	0	0
19	20286474	.	C	A	6	10	16	0	0	16	0	0
19	20308207	rs148497901	A	T	10	10	20	0	0	20	0	0
19	20309747	.	A	C	18	16	34	0	0	34	0	0
19	20724818	rs33932	A	G	2	4	6	0	0	6	0	0
19	20725807	rs7249742	C	G	6	3	9	0	1	10	0	0
19	20725868	rs33930	G	A	14	5	19	0	0	19	0	0
19	20725963	rs7249873	A	T	6	5	11	0	0	11	0	0
19	20725979	rs7250879	T	C	6	5	11	0	0	11	0	0
19	20726011	rs57449077	G	A	8	6	14	0	0	14	0	0
19	20726268	rs73010541	T	C	8	7	15	0	0	15	0	0
19	20726660	rs117333127	G	A	9	4	13	0	0	13	0	0
19	20727211	rs33927	C	T	7	9	16	0	0	16	0	0
19	20727932	rs33926	G	A	11	12	23	0	0	23	0	0
19	20812303	rs10419579	C	A	2	4	6	0	0	6	0	0
19	20817270	rs112776902	A	G	6	4	10	0	0	10	0	0
19	20817424	rs8112343	T	C	4	5	9	0	0	9	0	0
19	20818032	rs10854032	T	C	4	3	7	0	0	7	0	0
19	20819764	rs11667375	C	T	5	2	7	0	0	7	0	0
19	20819845	rs10412797	G	C	2	4	6	0	1	7	0	0
19	20820118	rs7252292	C	G	3	4	7	0	0	7	0	0
19	20820840	rs10420114	G	C	3	8	11	0	0	11	0	0
19	20821090	rs145450002	G	A	5	6	11	0	1	12	0	0
19	20821103	rs8110209	C	T	3	4	7	0	1	8	0	0
19	20821104	rs8110124	A	T	3	5	8	0	0	8	0	0
19	20821728	rs8100509	T	A	4	2	6	0	0	6	0	0
19	20821787	rs8100596	T	C	8	2	10	0	1	11	0	0
19	20822283	rs8100360	C	T	4	4	8	0	0	8	0	0
19	20822307	rs73008355	A	G	3	4	7	0	0	7	0	0
19	20823585	rs11879682	T	C	14	7	21	0	0	21	0	0
19	20824066	rs7254509	G	A	2	4	6	0	0	6	0	0
19	20824424	rs4808258	C	T	14	10	24	0	0	24	0	0
19	20824446	rs9917105	T	A	15	12	27	0	0	27	0	0
19	20824512	rs9917099	C	T	9	4	13	0	0	13	0	0
19	20824577	rs7258883	T	C	13	5	18	0	0	18	0	0
19	20824671	rs4809083	A	G	5	7	12	0	1	13	0	0
19	20824718	rs4809084	T	A	5	5	10	0	0	10	0	0
19	20824990	rs11880581	T	C	2	9	11	0	0	11	0	0
19	20824997	rs10423967	G	A	2	9	11	0	0	11	0	0
19	20825295	rs7258892	C	G	12	10	22	0	2	24	0	0
19	20825315	rs7259846	T	C	15	8	23	0	0	23	0	0
19	20843636	.	T	C	4	5	9	0	0	9	0	0
19	20968206	rs10413052	A	C	6	3	9	0	0	9	0	0
19	20969247	rs7256669	A	G	4	3	7	0	0	7	0	0
19	20969302	rs66478629	C	T	3	3	6	0	0	6	0	0
19	20969680	rs6511162	G	A	6	4	10	0	0	10	0	0
19	20981937	rs379793	A	G	1	5	6	0	0	6	0	0
19	20988924	rs432839	G	T	4	3	7	0	0	7	0	0
19	20990455	rs8112535	C	T	4	6	10	0	1	11	0	0
19	20990588	rs649276	C	T	2	5	7	0	0	7	0	0
19	20990591	rs6511164	C	T	5	2	7	0	0	7	0	0
19	20990701	rs10426864	T	C	6	0	6	0	0	6	0	0
19	20990801	rs6511166	G	A	3	6	9	0	0	9	0	0
19	20990805	rs10427070	T	C	6	3	9	0	0	9	0	0
19	20990872	rs35668100	G	C	4	4	8	0	0	8	0	0
19	20991614	.	C	T	1	5	6	0	0	6	0	0
19	20991615	.	A	G	1	5	6	0	0	6	0	0
19	20991799	.	G	C	3	3	6	0	0	6	0	0
19	20991833	rs7507484	C	T	3	3	6	0	0	6	0	0
19	21125710	rs12983551	T	A	3	3	6	0	0	6	0	0
19	21126046	rs35877658	T	C	1	9	10	0	0	10	0	0
19	21131571	rs56321708	A	G	10	25	35	0	0	35	0	0
19	21131664	rs56231962	G	T	9	20	29	0	0	29	0	0
19	21131850	rs56393308	C	G	6	2	8	0	0	8	0	0
19	21131870	rs11665978	G	C	9	3	12	0	0	12	0	0
19	21132129	rs11670246	T	C	12	8	20	0	0	20	0	0
19	21132211	rs11665995	A	T	7	7	14	0	0	14	0	0
19	21132394	rs11666887	C	T	21	8	29	0	0	29	0	0
19	21132751	rs56207286	A	T	19	9	28	0	0	28	0	0
19	21133129	rs56137123	T	C	12	5	17	0	0	17	0	0
19	21133243	rs56339351	G	A	20	3	23	0	0	23	0	0
19	21133269	rs55637671	C	A	23	4	27	0	0	27	0	0
19	21133309	rs73021542	G	A	21	5	26	0	0	26	0	0
19	21133340	rs73021543	A	G	17	4	21	0	0	21	0	0
19	21133378	rs73021544	C	T	12	2	14	0	1	15	0	0
19	21133439	rs73021545	C	T	10	2	12	0	0	12	0	0
19	21203552	rs2081054	C	T	26	19	45	0	0	45	0	0
19	21217348	.	T	C	15	12	27	0	0	27	0	0
19	21220003	rs4365405	C	T	6	5	11	0	0	11	0	0
19	21241537	rs10409844	T	A	25	24	49	0	0	49	0	0
19	21284501	rs10412509	A	G	3	3	6	0	0	6	0	0
19	21300462	rs2884554	A	G	11	16	27	0	0	27	0	0
19	21301211	rs8100289	C	T	13	19	32	0	1	33	0	0
19	21302906	rs7253950	A	G	12	8	20	0	1	21	0	0
19	21302948	rs7254302	G	A	13	4	17	0	0	17	0	0
19	21303743	rs8111827	G	A	6	9	15	0	0	15	0	0
19	21305337	rs10405406	A	G	35	24	59	0	0	59	0	0
19	21306913	rs11085431	T	C	5	7	12	0	1	13	0	0
19	21307713	rs2115493	T	C	6	1	7	0	0	7	0	0
19	21308048	rs8101222	C	G	15	20	35	0	0	35	0	0
19	21585797	rs56171309	A	G	6	3	9	0	0	9	0	0
19	21626998	rs184043424	G	A	9	11	20	0	0	20	0	0
19	21907988	rs7252777	C	T	15	20	35	0	2	37	0	0
19	21908053	rs7252798	C	T	12	15	27	0	1	28	0	0
19	21908593	rs2203944	T	C	3	3	6	0	0	6	0	0
19	21908772	rs111304617	A	C	20	23	43	0	1	44	0	0
19	21909948	rs7246400	G	A	20	27	47	0	0	47	0	0
19	21911375	rs16998303	G	C	2	6	8	0	0	8	0	0
19	21916489	rs4436888	C	T	5	2	7	0	0	7	0	0
19	21916526	rs4381720	A	G	4	2	6	0	0	6	0	0
19	21950302	rs75668513	C	T	17	15	32	0	0	32	0	0
19	22180721	rs4932723	C	G	1	5	6	0	0	6	0	0
19	22243422	rs10423881	G	A	3	11	14	0	0	14	0	0
19	22246913	rs8104144	T	C	1	13	14	0	0	14	0	0
19	22246952	rs8103518	G	C	0	10	10	0	0	10	0	0
19	22272615	rs10417916	T	C	7	2	9	0	0	9	0	0
19	22551462	rs12610462	C	T	0	6	6	0	0	6	0	0
19	22574818	rs201005223	T	C	2	5	7	0	0	7	0	0
19	22575488	rs7247735	C	T	9	1	10	0	0	10	0	0
19	22582925	rs10420149	T	G	8	1	9	0	0	9	0	0
19	22586192	rs1368476	A	G	8	2	10	0	0	10	0	0
19	22605103	rs11669353	G	C	7	2	9	0	0	9	0	0
19	22605120	rs11669356	G	T	4	2	6	0	0	6	0	0
19	22846652	rs201176947	A	C	13	8	21	0	0	21	0	0
19	22849476	.	A	T	14	18	32	0	0	32	0	0
19	23517939	rs29984	A	G	9	4	13	0	0	13	0	0
19	23518728	rs295400	G	A	7	4	11	0	0	11	0	0
19	23523879	rs295395	C	T	4	5	9	0	0	9	0	0
19	23541372	rs40561	A	T	12	9	21	0	0	21	0	0
19	23541472	rs295368	A	G	11	14	25	0	0	25	0	0
19	23542290	rs428549	A	G	4	3	7	0	0	7	0	0
19	23542291	rs385750	G	C	3	3	6	0	1	7	0	0
19	23542697	rs1821845	G	C	8	3	11	0	0	11	0	0
19	23543095	rs296093	T	C	5	11	16	0	0	16	0	0
19	23545447	rs296091	A	G	9	10	19	0	0	19	0	0
19	23549741	rs296083	T	C	5	6	11	0	0	11	0	0
19	23551980	rs114674824	C	T	2	12	14	0	0	14	0	0
19	23553421	rs35528917	A	T	8	2	10	0	0	11	1	0
19	23553826	rs12985838	C	G	7	3	10	0	0	10	0	0
19	23555298	rs8104071	C	T	7	4	11	0	0	11	0	0
19	23555470	rs75981738	C	A	6	9	15	0	0	15	0	0
19	23555630	rs10415339	G	C	3	5	8	0	0	8	0	0
19	23555757	rs57394860	G	A	6	5	11	0	0	11	0	0
19	23557502	rs141062920	G	A	11	7	18	0	0	18	0	0
19	23837145	rs11671053	A	G	24	26	50	0	1	51	0	0
19	23842501	rs12609935	G	C	4	4	8	0	0	8	0	0
19	23842566	rs8100146	G	A	3	5	8	0	0	8	0	0
19	23865653	rs12971879	C	T	6	6	12	0	0	12	0	0
19	23974759	rs62121336	G	A	5	1	6	0	0	6	0	0
19	24010397	rs201963256	T	C	82	1	83	0	8	91	0	0
19	24219911	rs4932937	A	G	21	12	33	0	0	33	0	0
19	24220159	rs11085662	T	G	7	3	10	0	0	10	0	0
19	24222489	rs8113462	A	G	31	10	41	0	1	42	0	0
19	24297054	rs556902112	G	A	5	5	10	0	0	10	0	0
19	24310555	rs146672619	C	T	56	55	111	0	1	112	0	0
19	24310761	.	G	A	62	60	122	0	0	122	0	0
19	24311116	rs140250586	C	G	35	33	68	0	0	68	0	0
19	28221474	rs10408331	C	T	7	6	13	0	0	13	0	0
19	29702882	rs7257235	A	C	1	11	12	0	0	12	0	0
19	29704002	rs11666764	T	C	12	4	16	0	0	16	0	0
19	29704010	rs8100724	A	C	10	4	14	0	0	14	0	0
19	30100319	rs3786516	T	A	6	5	11	0	1	12	0	0
19	30106873	rs45590931	T	C	3	4	7	0	0	7	0	0
19	30314666	rs7257694	C	T	118	88	206	0	2	208	0	0
19	30315112	rs1406	C	A	53	70	123	0	3	126	0	0
19	30433491	.	T	A	13	0	13	0	2	15	0	0
19	30504816	rs10756	T	C	5	8	13	0	1	14	0	0
19	33076287	rs145844670	T	C	6	10	16	0	0	16	0	0
19	33459996	rs1133771	C	T	14	8	22	0	0	22	0	0
19	33460113	rs9676744	T	G	15	20	35	0	0	35	0	0
19	33460476	rs4570989	G	A	8	11	19	0	0	19	0	0
19	33467357	rs2304102	G	A	8	1	9	0	0	9	0	0
19	33467507	.	T	G	4	4	8	0	0	8	0	0
19	33467576	rs7258185	G	A	6	3	9	0	0	9	0	0
19	33468067	rs4805025	C	T	8	5	13	0	0	13	0	0
19	33468160	rs73037461	A	C	3	8	11	0	0	11	0	0
19	33696897	rs11084712	C	T	26	16	42	0	0	42	0	0
19	34302280	rs10426916	C	G	13	14	27	0	0	27	0	0
19	34305761	rs56214819	G	A	22	25	47	0	1	48	0	0
19	34666389	rs580137	A	G	3	3	6	0	0	6	0	0
19	34683448	rs3119814	C	T	7	0	7	0	0	7	0	0
19	34715115	rs12972585	T	C	5	3	8	0	0	8	0	0
19	34717674	rs670286	T	G	5	5	10	0	0	10	0	0
19	34717787	rs11673180	T	A	5	6	11	0	0	11	0	0
19	34717913	rs502810	A	G	8	8	16	0	0	16	0	0
19	34883100	.	T	G	45	4	49	0	1	50	0	0
19	34883104	.	T	A	48	4	52	0	0	52	0	0
19	34883112	.	C	A	49	0	49	0	0	49	0	0
19	34892284	rs7260568	G	A	36	22	58	0	0	58	0	0
19	34920999	rs8103093	C	T	6	1	7	0	0	7	0	0
19	35231638	rs148911673	A	G	4	7	11	0	1	12	0	0
19	35232987	rs61730458	A	C	9	5	14	0	0	14	0	0
19	35233198	rs7248876	T	C	14	12	26	0	0	26	0	0
19	35303848	rs7254183	A	C	3	4	7	0	0	7	0	0
19	35304505	rs10417794	A	G	2	7	9	0	0	9	0	0
19	35422808	rs10422961	C	T	6	1	7	0	0	7	0	0
19	35434238	rs1811	A	G	7	2	9	0	0	9	0	0
19	35434448	rs62122088	A	G	2	4	6	0	0	6	0	0
19	35434582	rs142299823	G	T	9	3	12	0	0	12	0	0
19	35434648	rs145945527	T	C	4	9	13	0	0	13	0	0
19	35435006	rs1345658	G	A	3	3	6	0	0	6	0	0
19	35448803	rs1063235	C	A	44	78	122	0	2	125	1	0
19	35449409	rs2651081	G	A	55	81	136	0	8	144	0	0
19	35449760	rs2651080	G	C	57	65	122	0	0	122	0	0
19	35450229	rs2651079	C	T	57	65	122	0	0	122	0	0
19	35451742	rs2651078	G	A	1	5	6	0	0	6	0	0
19	35454604	rs2546028	A	C	19	14	33	0	0	33	0	0
19	35454605	rs2546029	A	G	19	14	33	0	0	33	0	0
19	35505780	rs188985155	A	G	7	6	13	0	0	13	0	0
19	35513896	rs4806072	C	T	5	1	6	0	0	6	0	0
19	35514884	rs35995722	G	C	6	6	12	0	0	12	0	0
19	35529487	rs3761069	G	A	9	6	15	0	0	15	0	0
19	35529488	rs73040318	C	G	9	6	15	0	0	15	0	0
19	35530073	rs16969930	T	C	33	23	56	0	1	57	0	0
19	35530514	rs28365107	T	G	75	18	93	0	0	93	0	0
19	35530525	rs28365109	C	A	71	19	90	0	0	90	0	0
19	35615513	.	T	C	7	0	7	0	0	7	0	0
19	35616087	rs3826989	G	A	9	5	14	0	0	14	0	0
19	35626349	rs2445817	C	T	2	4	6	0	0	6	0	0
19	35626373	rs2451991	G	A	2	4	6	0	0	6	0	0
19	35630362	rs1672997	A	G	2	4	6	0	0	6	0	0
19	35648365	rs1688005	T	G	1185	980	2165	0	16	2181	0	0
19	35650593	rs4806093	G	A	12	9	21	0	0	21	0	0
19	35651531	rs1617607	A	G	5	11	16	0	0	16	0	0
19	35652661	rs2451993	G	A	13	18	31	0	0	31	0	0
19	35652709	rs1688007	A	C	16	9	25	0	0	25	0	0
19	35653642	rs2901967	A	G	14	15	29	0	0	29	0	0
19	35655151	rs1672994	T	C	30	1	31	0	1	32	0	0
19	35657351	rs8106303	A	C	9	3	12	0	0	12	0	0
19	35658188	rs1623779	A	G	9	8	17	0	0	17	0	0
19	35658380	rs12461097	T	G	16	7	23	0	0	23	0	0
19	35658622	rs11084801	C	G	8	11	19	0	0	19	0	0
19	35658628	rs11084802	T	C	8	13	21	0	0	21	0	0
19	35658728	rs11084803	C	T	13	10	23	0	0	23	0	0
19	35658759	rs12611051	C	T	12	8	20	0	0	20	0	0
19	35658951	rs12609891	A	G	4	10	14	0	0	14	0	0
19	35659087	rs1688045	T	A	11	11	22	0	0	22	0	0
19	35659379	rs12978479	T	C	19	12	31	0	0	31	0	0
19	35660508	rs12110	G	A	2132	1877	4009	0	20	4030	1	0
19	35660670	rs3458	G	A	1162	1097	2259	0	9	2268	0	0
19	35764978	rs117966332	G	A	20	19	39	0	1	40	0	0
19	35941993	rs55695970	G	A	4	10	14	0	0	14	0	0
19	36031688	rs78596612	T	C	11	18	29	0	1	30	0	0
19	36032301	rs2239944	A	G	33	28	61	0	1	62	0	0
19	36037525	rs117367621	G	A	7	14	21	0	0	21	0	0
19	36038390	rs7599	A	G	31	42	73	0	0	73	0	0
19	36113993	rs117004739	G	A	70	64	134	0	1	135	0	0
19	36206986	rs2234371	G	A	5	4	9	0	0	9	0	0
19	36213072	rs28373672	A	G	2	6	8	0	1	9	0	0
19	36221051	rs2242520	G	A	4	6	10	0	1	11	0	0
19	36223771	rs200327646	G	A	66	35	101	0	0	101	0	0
19	36224705	rs231591	A	G	133	108	241	0	3	244	0	0
19	36225912	rs12984350	A	T	10	10	20	0	0	20	0	0
19	36235655	rs34632325	G	C	83	102	185	0	0	185	0	0
19	36237245	rs2293688	C	G	3	6	9	0	0	9	0	0
19	36244743	rs231242	C	G	13	9	22	0	0	22	0	0
19	36249521	rs231237	G	A	2	4	6	0	1	7	0	0
19	36255965	rs7252936	C	G	5	17	22	0	0	22	0	0
19	36259292	rs11881839	C	T	11	3	14	0	0	14	0	0
19	36259415	rs35178229	G	A	14	13	27	0	0	27	0	0
19	36259494	rs231216	C	A	8	10	18	0	1	19	0	0
19	36260111	rs231214	T	C	14	19	33	0	0	33	0	0
19	36261373	rs2619197	C	T	46	43	89	0	0	89	0	0
19	36268771	rs231228	C	T	56	39	95	0	0	95	0	0
19	36271139	rs231233	C	T	42	53	95	0	1	96	0	0
19	36274488	rs231222	T	C	3	5	8	0	0	8	0	0
19	36274500	rs145725356	G	A	3	3	6	0	0	6	0	0
19	36276403	rs120959	T	G	9	6	15	0	0	15	0	0
19	36276767	rs120960	A	G	18	15	33	0	0	33	0	0
19	36278470	rs231235	C	G	24	19	43	0	0	43	0	0
19	36381700	rs58422001	C	A	5	4	9	0	0	9	0	0
19	36383462	rs7258214	T	A	9	4	13	0	0	13	0	0
19	36383463	rs200197429	T	A	9	4	13	0	0	13	0	0
19	36384313	rs78677636	C	T	6	5	11	0	0	11	0	0
19	36385928	rs7251879	A	G	5	3	8	0	0	8	0	0
19	36386392	rs183920889	A	G	3	3	6	0	0	6	0	0
19	36386521	rs114463611	T	C	9	5	14	0	0	14	0	0
19	36386667	rs146476973	T	C	5	1	6	0	0	6	0	0
19	36387881	rs8113704	A	G	71	82	153	0	1	154	0	0
19	36388906	rs74476443	T	C	5	5	10	0	0	10	0	0
19	36390123	rs16960862	A	G	3	5	8	0	0	8	0	0
19	36390252	rs7252902	G	C	3	3	6	0	0	6	0	0
19	36391962	rs8111740	T	A	17	1	18	0	1	19	0	0
19	36391968	rs8108360	C	T	19	2	21	0	0	21	0	0
19	36391990	rs8108459	C	T	19	5	24	0	0	24	0	0
19	36392027	rs117451200	G	A	17	5	22	0	0	22	0	0
19	36392355	rs7254113	G	A	5	12	17	0	0	17	0	0
19	36393186	rs11878547	T	C	11	12	23	0	0	23	0	0
19	36394272	rs33964243	T	C	590	609	1199	0	7	1206	0	0
19	36394678	rs8106495	T	C	587	606	1193	0	17	1210	0	0
19	36394834	rs8106480	A	G	11	0	11	0	1	12	0	0
19	36395446	rs1802029	T	G	508	527	1035	0	4	1040	1	0
19	36395937	rs8113524	T	C	3	3	6	0	0	6	0	0
19	36396034	rs8110231	C	T	5	2	7	0	0	7	0	0
19	36396288	rs80136078	G	A	7	0	7	0	0	7	0	0
19	36398414	rs77782321	C	A	357	392	749	0	5	754	0	0
19	36398561	rs118043958	A	G	20	23	43	0	0	43	0	0
19	36487146	rs7925	A	G	19	24	43	0	0	43	0	0
19	36505683	rs1043822	G	A	78	79	157	0	0	157	0	0
19	36523669	rs2285425	C	G	10	9	19	0	0	19	0	0
19	36558712	rs10423651	C	T	2	4	6	0	0	6	0	0
19	36611261	rs2239509	C	T	4	6	10	0	0	10	0	0
19	36611284	rs2239510	G	A	6	6	12	0	0	12	0	0
19	36612226	rs2072606	C	T	3	5	8	0	0	8	0	0
19	36612396	rs2075474	A	G	5	4	9	0	0	9	0	0
19	36636012	rs17879505	C	T	0	7	7	0	0	7	0	0
19	36640764	rs1049339	C	T	809	816	1625	0	33	1658	0	0
19	36673300	rs16970932	T	C	3	4	7	0	0	7	0	0
19	36725408	rs4315447	A	C	6	2	8	0	0	8	0	0
19	36727212	rs118146634	G	A	30	15	45	0	0	45	0	0
19	36728290	rs4806293	A	G	47	28	75	0	1	76	0	0
19	36806927	.	T	C	16	4	20	0	0	20	0	0
19	36807016	.	T	C	5	1	6	0	0	6	0	0
19	36807142	.	A	G	3	6	9	0	0	9	0	0
19	36813084	rs2972632	A	G	0	6	6	0	0	6	0	0
19	36815829	rs7259940	C	T	6	2	8	0	0	8	0	0
19	36816188	rs7260462	C	T	11	4	15	0	0	15	0	0
19	36821198	rs3111556	T	G	11	15	26	0	1	27	0	0
19	36821209	rs3098393	A	G	9	18	27	0	0	27	0	0
19	36980588	rs45573837	T	C	6	5	11	0	0	11	0	0
19	36980642	rs45625538	G	T	9	5	14	0	0	14	0	0
19	37002409	rs139716168	C	T	14	9	23	0	0	23	0	0
19	37003204	rs79139857	A	C	2	5	7	0	0	7	0	0
19	37003319	rs78643472	G	A	2	7	9	0	0	9	0	0
19	37003607	rs2945977	A	T	8	2	10	0	0	10	0	0
19	37004938	rs2967505	T	C	14	11	25	0	0	25	0	0
19	37005298	rs76808668	A	G	17	24	41	0	0	41	0	0
19	37016071	rs79495721	C	T	10	10	20	0	0	20	0	0
19	37042660	.	A	G	6	9	15	0	0	15	0	0
19	37240798	.	G	A	6	5	11	0	0	11	0	0
19	37836184	rs78124258	C	T	4	3	7	0	0	7	0	0
19	37854207	.	C	T	66	48	114	0	0	114	0	0
19	38031252	rs77317901	T	C	5	4	9	0	0	9	0	0
19	38697054	rs3745946	G	A	6	10	16	0	0	16	0	0
19	38743591	rs10993	G	T	49	19	68	0	0	68	0	0
19	38755406	rs1046773	C	G	60	59	119	0	0	119	0	0
19	38765660	rs12608697	C	A	6	2	8	0	0	8	0	0
19	38779856	rs3745948	C	T	7	0	7	0	0	7	0	0
19	38794895	rs2304176	T	C	7	24	31	0	0	31	0	0
19	38795159	rs2304177	G	A	2	6	8	0	0	8	0	0
19	38795219	.	G	C	8	18	26	0	0	26	0	0
19	38795250	rs45437199	G	A	19	6	25	0	0	25	0	0
19	38806137	.	G	A	5	3	8	0	0	8	0	0
19	38817486	rs3745951	T	C	24	31	55	0	2	57	0	0
19	38817876	rs34989303	G	A	31	53	84	0	0	84	0	0
19	38818299	rs3745952	C	T	36	61	97	0	4	101	0	0
19	38818751	rs931750	T	C	55	68	123	0	0	123	0	0
19	38818925	rs931749	C	T	36	77	113	0	0	113	0	0
19	38819098	rs73041302	A	G	53	77	130	0	0	130	0	0
19	38854554	rs4801723	C	T	2	4	6	0	0	6	0	0
19	38856159	rs12461248	G	T	4	7	11	0	0	11	0	0
19	38858062	rs3745955	G	A	8	4	12	0	0	12	0	0
19	38861333	rs1052375	G	A	12	20	32	0	0	32	0	0
19	38861362	rs2286550	T	C	23	15	38	0	0	38	0	0
19	38871182	rs2072350	C	T	5	3	8	0	0	8	0	0
19	38872008	rs2074979	C	G	9	3	12	0	0	12	0	0
19	38872033	rs2074980	C	G	10	1	11	0	0	11	0	0
19	38872335	rs2074981	C	A	4	8	12	0	0	12	0	0
19	38877997	rs62123482	G	T	4	4	8	0	0	8	0	0
19	38893950	rs3745960	C	A	4	13	17	0	0	17	0	0
19	38896244	rs3745962	C	A	37	25	62	0	1	63	0	0
19	38899548	rs3745964	G	A	25	40	65	0	0	65	0	0
19	38899783	rs185123414	T	G	94	63	157	0	2	159	0	0
19	38899999	rs4802399	G	A	171	130	301	0	2	303	0	0
19	38900078	rs4802400	A	G	79	117	196	0	0	196	0	0
19	39120987	.	A	T	5	2	7	0	0	7	0	0
19	39203816	rs146965813	C	G	39	27	66	0	0	66	0	0
19	39205015	rs2306196	C	T	30	36	66	0	1	67	0	0
19	39338834	rs112962375	G	A	16	19	35	0	0	35	0	0
19	39385298	rs4801933	C	T	4	4	8	0	0	8	0	0
19	39385299	rs4801934	C	G	4	4	8	0	0	8	0	0
19	39385532	rs10410544	T	C	10	4	14	0	0	14	0	0
19	39387716	rs4802998	G	A	11	3	14	0	1	15	0	0
19	39391547	rs4803006	A	G	6	4	10	0	0	10	0	0
19	39391817	rs12979755	T	C	6	3	9	0	0	9	0	0
19	39391974	rs57842338	C	T	5	1	6	0	0	6	0	0
19	39396300	rs3136640	C	G	5	2	7	0	1	8	0	0
19	39396335	rs2241704	A	T	6	2	8	0	0	8	0	0
19	39399277	rs3136646	C	T	119	108	227	0	2	229	0	0
19	39400175	rs10775533	C	G	6	4	10	0	0	10	0	0
19	39400495	rs11083488	C	T	2	4	6	0	0	6	0	0
19	39400504	rs12609975	A	G	2	4	6	0	0	6	0	0
19	39408688	rs4803034	C	G	5	4	9	0	0	9	0	0
19	39421388	rs730078	A	G	5	4	9	0	0	9	0	0
19	39421631	rs143403017	C	G	23	12	35	0	1	36	0	0
19	39660277	rs75096376	C	T	9	11	20	0	0	21	1	0
19	39821298	rs73546038	G	A	2	6	8	0	0	8	0	0
19	39835169	rs1368442	G	T	12	11	23	0	1	24	0	0
19	39838954	rs62119681	C	G	9	5	14	0	0	14	0	0
19	39886177	rs10402122	G	A	3	4	7	0	0	7	0	0
19	39886196	rs10403504	T	C	4	6	10	0	0	10	0	0
19	39886413	rs11665856	C	T	1	5	6	0	0	6	0	0
19	39886817	rs1654627	G	A	6	6	12	0	0	12	0	0
19	39887155	rs7250966	T	C	4	7	11	0	0	11	0	0
19	39888449	rs519575	C	T	17	19	36	0	0	36	0	0
19	39889044	rs10423565	A	T	39	35	74	0	2	76	0	0
19	39889691	rs10425594	G	A	69	47	116	0	1	117	0	0
19	39891161	rs10414216	T	C	5	10	15	0	0	15	0	0
19	39903320	rs62119731	C	T	4	8	12	0	0	12	0	0
19	39907036	rs2277743	C	T	31	23	54	0	0	54	0	0
19	39908574	rs35466645	C	T	29	20	49	0	0	49	0	0
19	39917523	rs148439185	A	G	11	16	27	0	1	28	0	0
19	39917827	rs76128311	G	A	10	7	17	0	0	17	0	0
19	39923952	rs17627	G	A	2934	2686	5620	0	9	5629	0	0
19	39925054	rs484379	T	G	49	77	126	0	0	126	0	0
19	39925417	rs481421	T	C	24	41	65	0	2	67	0	0
19	39925461	rs480656	G	C	14	27	41	0	1	42	0	0
19	39925482	rs480595	A	T	19	29	48	0	1	49	0	0
19	39925621	rs73033380	C	T	33	22	55	0	0	55	0	0
19	39926509	rs17628	A	C	2055	2217	4272	0	35	4307	0	0
19	39926521	rs17626	G	A	1813	1894	3707	0	11	3718	0	0
19	39948779	rs11881477	G	A	3	3	6	0	0	6	0	0
19	39955304	rs73035432	T	C	5	2	7	0	0	7	0	0
19	39955533	rs2304217	G	A	170	133	303	0	11	314	0	0
19	39957472	rs8103333	C	T	3	11	14	0	0	14	0	0
19	39957846	rs8106596	A	G	3	4	7	0	0	7	0	0
19	39960345	rs34946116	C	T	3	3	6	0	0	6	0	0
19	39963828	rs45568533	T	A	7	34	41	0	1	42	0	0
19	39964315	rs10420073	C	T	3	5	8	0	0	8	0	0
19	39965676	rs12972773	G	A	36	30	66	0	1	67	0	0
19	39965773	rs7245986	A	G	24	14	38	0	0	38	0	0
19	39965785	rs59269050	C	T	25	13	38	0	0	38	0	0
19	39966303	rs35297410	C	T	24	15	39	0	0	39	0	0
19	40222379	rs437780	C	G	32	29	61	0	0	61	0	0
19	40222408	rs2074926	C	T	27	30	57	0	0	57	0	0
19	40222533	rs367788	T	C	19	23	42	0	2	44	0	0
19	40222710	.	A	C	7	0	7	0	0	7	0	0
19	40223884	rs7253094	G	C	13	10	23	0	0	23	0	0
19	40223956	rs388648	T	C	15	8	23	0	0	23	0	0
19	40223965	rs446425	C	G	14	7	21	0	0	21	0	0
19	40224112	rs373449	A	C	13	15	28	0	0	28	0	0
19	40224833	rs375867	A	T	11	5	16	0	1	17	0	0
19	40224869	rs391646	T	A	7	8	15	0	0	15	0	0
19	40224887	rs391660	T	C	7	11	18	0	0	18	0	0
19	40224901	rs453827	G	A	6	11	17	0	0	17	0	0
19	40224986	rs384138	A	G	390	383	773	0	2	775	0	0
19	40225168	rs399641	T	A	16	20	36	0	0	36	0	0
19	40225319	rs385520	A	T	10	5	15	0	0	15	0	0
19	40225393	rs400233	T	C	10	5	15	0	0	15	0	0
19	40225646	rs17608	G	A	333	264	597	0	1	598	0	0
19	40225857	rs372081	G	T	9	5	14	0	1	15	0	0
19	40226130	rs372902	C	T	8	12	20	0	0	20	0	0
19	40226275	rs395892	A	G	13	8	21	0	0	21	0	0
19	40226402	rs44048	C	A	41	14	55	0	0	55	0	0
19	40226478	rs44049	C	T	79	28	107	0	1	108	0	0
19	40226580	rs396854	A	C	6	7	13	0	0	13	0	0
19	40226710	rs2238678	C	G	6	2	8	0	0	8	0	0
19	40226728	rs1985359	G	A	7	2	9	0	0	9	0	0
19	40226844	rs367156	G	A	6	7	13	0	1	14	0	0
19	40226953	rs367529	G	A	3	14	17	0	0	17	0	0
19	40226956	rs383768	C	T	3	14	17	0	0	17	0	0
19	40227136	rs444844	T	C	5	4	9	0	0	9	0	0
19	40227189	rs444963	T	C	6	6	12	0	0	12	0	0
19	40227363	rs385240	C	T	2	5	7	0	1	8	0	0
19	40227863	rs378917	G	A	4	3	7	0	1	8	0	0
19	40228350	rs364911	T	C	5	4	9	0	0	9	0	0
19	40321524	rs7247063	C	A	3	4	7	0	0	7	0	0
19	40321840	rs718066	T	C	2	5	7	0	0	7	0	0
19	40328615	rs616650	C	T	2	4	6	0	0	6	0	0
19	40728417	rs2304184	T	G	7	3	10	0	0	10	0	0
19	40736295	rs34067570	G	T	5	3	8	0	0	8	0	0
19	40738756	rs74457111	G	A	106	83	189	0	7	196	0	0
19	40739513	rs33933140	A	G	116	118	234	0	5	239	0	0
19	40739721	rs2304186	G	T	112	104	216	0	7	225	2	0
19	40742320	rs2304189	T	C	3	3	6	0	0	6	0	0
19	40743225	rs4803320	A	G	2	5	7	0	0	7	0	0
19	40776434	.	G	C	3	3	6	0	0	6	0	0
19	40785505	rs4332845	T	A	4	3	7	0	0	7	0	0
19	40786523	rs8102171	A	C	8	8	16	0	0	16	0	0
19	40788641	rs11880261	T	C	5	7	12	0	0	12	0	0
19	40788893	rs12985477	A	G	5	3	8	0	0	8	0	0
19	40789926	rs12459567	C	T	5	6	11	0	0	11	0	0
19	40865317	rs4802076	T	A	2	4	6	0	0	6	0	0
19	40883844	rs45469694	A	C	4	2	6	0	0	6	0	0
19	41089773	rs420490	C	G	5	4	9	0	0	9	0	0
19	41091145	rs404584	A	G	6	3	9	0	0	9	0	0
19	41092454	rs415075	C	G	9	13	22	0	0	22	0	0
19	41094765	rs12977500	G	A	97	162	259	0	1	260	0	0
19	41094838	rs393569	A	G	80	180	260	0	2	262	0	0
19	41095818	rs392726	T	C	55	34	89	0	1	90	0	0
19	41096189	rs396118	A	G	178	145	323	0	4	327	0	0
19	41097276	rs7171	C	G	165	123	288	0	1	289	0	0
19	41111069	rs2303729	G	A	4	3	7	0	0	7	0	0
19	41116166	rs1869712	C	G	16	2	18	0	0	18	0	0
19	41116251	rs919307	G	C	14	5	19	0	2	21	0	0
19	41116397	rs1318544	G	A	6	4	10	0	0	10	0	0
19	41116455	rs33937741	C	G	4	3	7	0	0	7	0	0
19	41117869	rs1131620	A	G	15	12	27	0	0	27	0	0
19	41118056	rs1051303	A	G	15	8	23	0	0	23	0	0
19	41120083	rs2369006	A	T	3	5	8	0	0	8	0	0
19	41128309	rs10880	C	T	41	57	98	0	0	98	0	0
19	41128415	rs35079932	G	A	55	31	86	0	3	89	0	0
19	41129842	rs7367	C	T	164	122	286	0	5	291	0	0
19	41173372	rs12975396	G	A	12	20	32	0	0	32	0	0
19	41206060	rs36012476	G	C	27	28	55	0	1	56	0	0
19	41209477	rs11538385	C	T	22	23	45	0	0	45	0	0
19	41220529	rs11673492	C	T	13	6	19	0	1	20	0	0
19	41244887	rs2607420	G	A	5	4	9	0	0	9	0	0
19	41255500	rs2254343	C	G	18	15	33	0	0	33	0	0
19	41257176	rs1457141	G	C	108	100	208	0	0	208	0	0
19	41257816	rs2604874	C	A	10	4	14	0	0	14	0	0
19	41289397	rs12973666	G	C	5	2	7	0	0	7	0	0
19	41302706	rs7937	C	T	37	35	72	0	0	72	0	0
19	41308415	rs73047085	G	T	7	6	13	0	0	13	0	0
19	41308983	rs76403165	G	A	12	9	21	0	0	21	0	0
19	41309211	rs2644916	T	C	8	13	21	0	0	21	0	0
19	41309240	rs11666504	C	T	8	16	24	0	0	24	0	0
19	41310609	rs3733828	A	G	20	16	36	0	0	36	0	0
19	41345989	rs35755165	A	G	4	2	6	0	0	6	0	0
19	41703793	rs57266494	G	A	5	8	13	0	0	13	0	0
19	41773797	rs3816052	G	A	13	17	30	0	0	30	0	0
19	41774064	rs2304230	T	C	13	19	32	0	1	33	0	0
19	41774242	.	A	G	206	206	412	0	2	414	0	0
19	41789178	rs35812313	T	C	3	4	7	0	0	7	0	0
19	41789558	rs67744888	G	A	4	3	7	0	0	7	0	0
19	41807700	rs7248164	G	A	56	64	120	0	1	121	0	0
19	41808249	rs11881953	G	A	23	13	36	0	2	38	0	0
19	41808432	rs11881940	A	T	17	20	37	0	0	37	0	0
19	41809995	rs1056854	A	G	352	346	698	0	3	701	0	0
19	41810644	rs7245398	A	G	4	3	7	0	0	7	0	0
19	41810771	rs12972266	G	A	3	3	6	0	0	6	0	0
19	41813957	rs4456618	G	C	7	4	11	0	0	11	0	0
19	41814412	rs1865053	T	C	3	5	8	0	0	8	0	0
19	41814516	rs62120967	A	G	5	5	10	0	0	10	0	0
19	41815713	rs12984160	A	G	6	1	7	0	1	8	0	0
19	41829309	rs2241720	C	G	28	21	49	0	1	50	0	0
19	41829581	rs2241719	T	A	11	18	29	0	1	30	0	0
19	41829606	rs2241718	G	A	11	22	33	0	0	33	0	0
19	41830606	rs6957	T	C	30	37	67	0	0	67	0	0
19	41837615	rs11466359	G	A	7	10	17	0	1	18	0	0
19	41839631	rs8105161	T	C	3	9	12	0	0	12	0	0
19	41916549	rs11549936	C	A	38	25	63	0	0	63	0	0
19	41928701	rs284653	C	T	8	13	21	0	1	22	0	0
19	41932063	rs45563938	A	G	13	7	20	0	0	20	0	0
19	42109374	rs62119458	T	C	10	6	16	0	0	16	0	0
19	42125660	rs1041994	T	C	24	63	87	0	2	89	0	0
19	42275422	rs117388669	G	A	56	33	89	0	1	90	0	0
19	42304362	rs7258053	A	G	4	17	21	0	0	21	0	0
19	42315281	rs899662	G	T	7	20	27	0	2	29	0	0
19	42315300	rs2008808	G	T	6	18	24	0	0	24	0	0
19	42315406	rs2008798	A	G	5	12	17	0	0	17	0	0
19	42368016	rs12972552	G	A	6	5	11	0	0	11	0	0
19	42376115	rs61762302	G	A	65	79	144	0	1	145	0	0
19	42389280	rs882520	T	A	3	4	7	0	1	8	0	0
19	42428767	rs1864207	A	G	11	6	17	0	1	18	0	0
19	42429833	rs11665965	G	A	17	7	24	0	0	24	0	0
19	42431033	rs2081999	G	A	31	21	52	0	0	52	0	0
19	42432549	rs35009020	G	C	5	6	11	0	0	11	0	0
19	42434050	rs10409822	G	C	98	76	174	0	0	174	0	0
19	42461454	rs11083642	G	A	5	4	9	0	0	9	0	0
19	42463447	rs735571	C	T	34	37	71	0	2	73	0	0
19	42504505	rs454150	G	A	18	22	40	0	0	40	0	0
19	42506044	rs443239	C	G	4	13	17	0	0	17	0	0
19	42507043	rs3859462	A	C	6	4	10	0	0	10	0	0
19	42542466	rs899661	A	C	7	4	11	0	0	11	0	0
19	42542999	rs4803523	C	T	9	7	16	0	0	16	0	0
19	42573970	.	C	T	11	7	18	0	0	18	0	0
19	42591484	rs1056995	G	A	9	7	16	0	0	16	0	0
19	42594894	rs76335122	T	G	9	5	14	0	0	14	0	0
19	42603916	.	G	A	5	2	7	0	0	7	0	0
19	42703833	rs2303652	A	G	85	111	196	0	9	205	0	0
19	42728836	rs3810151	T	C	6	6	12	0	1	13	0	0
19	42735177	rs74259566	C	G	8	13	21	0	0	21	0	0
19	42735798	rs8108096	T	C	10	15	25	0	0	25	0	0
19	42753034	rs35493131	A	G	185	133	318	0	20	338	0	0
19	42753283	rs61735151	G	A	240	226	466	0	2	468	0	0
19	42753649	rs11557114	G	C	245	232	477	0	3	480	0	0
19	42754403	rs76292187	G	A	12	13	25	0	1	26	0	0
19	42754938	rs111862714	A	G	20	18	38	0	0	38	0	0
19	42755698	rs2267630	G	A	9	17	26	0	1	27	0	0
19	42756345	rs4141062	T	C	29	27	56	0	0	56	0	0
19	42776574	rs10426306	T	C	12	9	21	0	0	21	0	0
19	42776580	rs10426310	T	C	14	9	23	0	0	23	0	0
19	42779057	rs9636121	A	G	7	5	12	0	0	12	0	0
19	42781137	rs10410198	T	C	4	2	6	0	0	6	0	0
19	42787664	rs3810148	T	C	2	5	7	0	0	7	0	0
19	42795554	rs10410185	T	C	124	119	243	0	0	243	0	0
19	42797603	rs78756053	C	T	10	8	18	0	0	18	0	0
19	42852549	rs34922891	C	T	2	4	6	0	0	6	0	0
19	42857179	rs149155949	C	T	3	4	7	0	0	7	0	0
19	42858793	rs61995685	T	C	2	4	6	0	0	6	0	0
19	42861016	rs149279834	C	T	2	4	6	0	0	6	0	0
19	42882095	rs77151871	G	A	9	13	22	0	0	22	0	0
19	42882853	rs2304210	T	C	15	17	32	0	0	32	0	0
19	43833486	rs10418506	A	G	12	7	19	0	1	20	0	0
19	43866823	rs7257560	T	C	4	4	8	0	0	8	0	0
19	44050231	.	G	T	89	76	165	0	0	165	0	0
19	44089398	rs182857417	T	G	0	6	6	0	0	6	0	0
19	44157677	.	G	A	11	15	26	0	0	26	0	0
19	44163033	rs2239373	T	G	15	13	28	0	1	29	0	0
19	44163061	rs2283628	T	C	14	18	32	0	0	32	0	0
19	44240028	rs78310538	G	A	4	3	7	0	0	7	0	0
19	44280313	.	T	G	14	0	14	0	1	15	0	0
19	44280342	rs2163860	A	G	5	15	20	0	2	22	0	0
19	44280509	rs1207132	G	T	20	18	38	0	2	40	0	0
19	44280837	rs514328	G	A	3	7	10	0	0	10	0	0
19	44280980	rs35773079	T	G	3	8	11	0	0	11	0	0
19	44281478	rs671375	G	T	4	6	10	0	0	10	0	0
19	44281492	rs11083720	G	T	6	3	9	0	0	9	0	0
19	44281898	rs11879798	G	A	4	6	10	0	0	10	0	0
19	44282529	rs56344893	C	A	2	6	8	0	0	8	0	0
19	44283031	rs56681946	T	C	5	7	12	0	0	12	0	0
19	44283843	rs62116961	G	C	2	5	7	0	0	7	0	0
19	44417295	rs376069	T	C	20	21	41	0	0	41	0	0
19	44417575	rs417699	A	G	17	23	40	0	0	40	0	0
19	44418077	rs407731	C	T	18	18	36	0	0	36	0	0
19	44418343	rs406968	C	T	10	12	22	0	0	22	0	0
19	44418544	rs425221	A	G	22	8	30	0	0	30	0	0
19	44418680	rs388685	G	C	11	8	19	0	0	19	0	0
19	44418693	rs388706	T	C	15	10	25	0	0	25	0	0
19	44418824	rs399098	C	T	10	10	20	0	1	21	0	0
19	44428406	rs117082389	G	A	9	5	14	0	0	14	0	0
19	44439396	rs73036793	T	C	4	2	6	0	0	6	0	0
19	44567608	rs7248068	C	G	4	3	7	0	0	7	0	0
19	44570393	rs6509138	C	A	15	19	34	0	0	34	0	0
19	44571154	rs4433920	T	C	35	23	58	0	0	58	0	0
19	44610843	rs72480796	C	T	24	15	39	0	1	40	0	0
19	44890697	rs1836280	A	G	5	3	8	0	0	8	0	0
19	44890801	rs12610859	T	C	5	2	7	0	0	7	0	0
19	44932323	rs204554	G	A	16	15	31	0	0	31	0	0
19	44936245	rs2356889	A	G	2	4	6	0	0	6	0	0
19	44947050	rs204548	T	C	12	8	20	0	0	20	0	0
19	44947184	rs204547	T	C	20	7	27	0	0	27	0	0
19	44981375	rs954314	T	C	12	22	34	0	1	35	0	0
19	44981883	rs1897820	C	G	14	9	23	0	0	23	0	0
19	44983567	rs2253563	C	G	4	10	14	0	0	14	0	0
19	45001346	rs2571108	G	A	10	5	15	0	0	15	0	0
19	45003267	rs892596	A	C	2	5	7	0	0	7	0	0
19	45159023	rs10422182	T	C	2	4	6	0	0	6	0	0
19	45162955	rs10411273	G	A	6	3	9	0	0	9	0	0
19	45163671	rs754340	T	C	4	2	6	0	0	6	0	0
19	45165912	rs714948	C	A	17	21	38	0	1	39	0	0
19	45172785	rs62119321	T	C	3	3	6	0	0	6	0	0
19	45179631	rs76075198	C	T	17	10	27	0	0	27	0	0
19	45186873	rs62119327	G	T	30	32	62	0	1	63	0	0
19	45186965	rs2289494	G	C	25	19	44	0	1	45	0	0
19	45187163	rs62119328	A	G	40	22	62	0	2	64	0	0
19	45218925	rs1137573	A	T	4	2	6	0	0	6	0	0
19	45218971	rs1137572	C	A	5	2	7	0	0	7	0	0
19	45219011	rs1137571	G	A	6	1	7	0	0	7	0	0
19	45219015	rs3201345	C	T	6	1	7	0	0	7	0	0
19	45251156	rs2965169	A	C	5	3	8	0	0	8	0	0
19	45253491	rs10401176	C	T	4	11	15	0	1	16	0	0
19	45254168	rs8103315	C	A	14	17	31	0	0	31	0	0
19	45255266	rs62117205	T	C	7	4	11	0	0	11	0	0
19	45255679	rs62117206	G	C	11	12	23	0	2	25	0	0
19	45377467	rs2075642	G	A	17	18	35	0	0	35	0	0
19	45379060	rs387976	A	C	21	20	41	0	0	41	0	0
19	45379309	rs3852859	T	C	17	17	34	0	0	34	0	0
19	45380970	rs11668861	G	T	40	55	95	0	0	95	0	0
19	45381917	rs3729640	C	T	184	667	851	0	8	860	1	0
19	45384105	rs11083749	C	T	9	6	15	0	0	15	0	0
19	45384338	rs1985129	G	A	6	3	9	0	1	10	0	0
19	45384405	.	T	C	7	3	10	0	1	11	0	0
19	45404972	rs1038025	T	C	7	0	7	0	0	7	0	0
19	45405062	rs1038026	A	G	6	2	8	0	0	8	0	0
19	45405521	rs1305062	G	C	2	6	8	0	0	8	0	0
19	45406673	rs10119	G	A	131	132	263	0	2	265	0	0
19	45412079	rs7412	C	T	4	6	10	0	0	10	0	0
19	45487178	rs204474	C	T	3	4	7	0	0	7	0	0
19	45488133	rs60876330	C	T	6	0	6	0	0	6	0	0
19	45490065	rs11083755	C	T	29	38	67	0	0	67	0	0
19	45490192	rs11672748	A	G	22	17	39	0	0	39	0	0
19	45490570	rs3786505	A	G	86	62	148	0	1	149	0	0
19	45490636	rs204468	T	C	81	105	186	0	0	186	0	0
19	45493061	rs909134	T	C	5	2	7	0	0	7	0	0
19	45493133	rs3859419	T	G	5	4	9	0	1	10	0	0
19	45495682	rs2075619	A	G	5	1	6	0	0	6	0	0
19	45496303	rs9193	T	C	174	156	330	0	2	332	0	0
19	45508847	rs34647054	C	G	3	3	6	0	0	6	0	0
19	45519100	rs35891370	G	A	17	6	23	0	0	23	0	0
19	45522210	rs73049472	C	T	10	1	11	0	1	12	0	0
19	45522998	rs6509175	C	G	4	7	11	0	0	11	0	0
19	45523583	rs4803791	G	A	6	10	16	0	1	17	0	0
19	45534041	rs1076986	C	T	7	5	12	0	0	12	0	0
19	45536036	rs10424046	C	G	16	15	31	0	0	31	0	0
19	45562374	rs3786508	C	G	7	2	9	0	0	9	0	0
19	45568650	.	A	G	12	0	12	0	0	12	0	0
19	45568795	rs7256279	G	A	11	13	24	0	2	26	0	0
19	45569009	rs10419815	C	T	13	10	23	0	0	23	0	0
19	45570051	rs3786509	G	C	14	23	37	0	1	38	0	0
19	45571781	rs10445571	T	C	4	3	7	0	0	7	0	0
19	45571903	rs36097205	G	C	3	3	6	0	0	6	0	0
19	45594170	rs3178166	A	G	3	3	6	0	0	6	0	0
19	45649386	rs968445	A	G	5	10	15	0	0	15	0	0
19	45650253	rs28683101	A	G	42	37	79	0	2	81	0	0
19	45653227	rs8108762	G	A	3	3	6	0	0	6	0	0
19	45653234	rs1054470	T	C	3	5	8	0	0	8	0	0
19	45715680	rs11083767	T	C	12	10	22	0	1	23	0	0
19	45715717	rs8102712	C	T	22	12	34	0	0	34	0	0
19	45715976	rs3803906	A	G	6	6	12	0	0	12	0	0
19	45716192	rs11667509	G	C	2	6	8	0	1	9	0	0
19	45716197	rs11667430	A	G	1	8	9	0	0	9	0	0
19	45756376	rs12981145	G	C	2	8	10	0	0	10	0	0
19	45799975	rs2098088	G	C	4	3	7	0	0	7	0	0
19	45806609	rs2395	A	G	85	107	192	0	0	192	0	0
19	45810035	rs4884	A	G	10	5	15	0	0	15	0	0
19	45814860	rs7260463	G	T	4	11	15	0	0	15	0	0
19	45814908	rs7260359	C	T	3	5	8	0	1	9	0	0
19	45815248	rs10402747	T	C	6	15	21	0	0	21	0	0
19	45815824	rs11878815	G	A	5	3	8	0	0	8	0	0
19	45816125	rs10408267	A	T	5	2	7	0	0	7	0	0
19	45972039	rs2282696	A	C	25	27	52	0	1	53	0	0
19	45972408	rs12976374	C	G	12	14	26	0	0	26	0	0
19	45972861	rs11883164	A	G	24	24	48	0	1	49	0	0
19	45972881	rs7259071	A	C	35	25	60	0	0	60	0	0
19	45973056	rs2238686	T	C	48	34	82	0	0	82	0	0
19	45973166	rs2238687	G	C	44	47	91	0	1	92	0	0
19	45974809	rs2276472	A	G	2	11	13	0	0	13	0	0
19	45976718	rs3170167	T	C	75	47	122	0	2	124	0	0
19	45997347	rs12609601	T	C	7	0	7	0	0	8	1	0
19	46003066	rs34138946	T	G	5	1	6	0	0	6	0	0
19	46003068	rs35446288	A	G	5	1	6	0	0	6	0	0
19	46021978	rs12608829	A	C	3	3	6	0	0	6	0	0
19	46024584	rs2301283	T	G	121	91	212	0	0	212	0	0
19	46025400	rs2301285	G	C	4	3	7	0	0	7	0	0
19	46026970	rs11880111	T	A	8	4	12	0	1	13	0	0
19	46028354	rs9916945	A	C	4	2	6	0	0	6	0	0
19	46029981	rs10156	T	C	552	277	829	0	53	882	0	0
19	46030154	rs10995	G	A	160	141	301	0	2	303	0	0
19	46030879	rs61267572	T	C	6	2	8	0	0	8	0	0
19	46031606	rs7259834	T	C	6	4	10	0	0	10	0	0
19	46033058	rs7252959	A	G	4	4	8	0	0	8	0	0
19	46053385	rs3760844	C	T	10	2	12	0	0	12	0	0
19	46056620	rs3826861	C	T	4	2	6	0	0	6	0	0
19	46124531	rs36062041	G	A	18	12	30	0	0	30	0	0
19	46146033	rs552009647	A	C	5	2	7	0	0	7	0	0
19	46191828	rs10403723	C	T	3	5	8	0	0	8	0	0
19	46192403	rs28396273	T	A	5	3	8	0	0	8	0	0
19	46202172	rs2287019	C	T	4	2	6	0	0	6	0	0
19	46203916	rs11673709	A	C	2	7	9	0	0	9	0	0
19	46203956	rs34505371	T	A	6	5	11	0	0	11	0	0
19	46205050	rs4803848	T	C	8	6	14	0	0	14	0	0
19	46206425	rs11672416	T	C	52	43	95	0	0	95	0	0
19	46214244	rs66796860	A	G	46	45	91	0	2	93	0	0
19	46214297	rs1055220	C	T	36	40	76	0	1	77	0	0
19	46319415	rs1132645	G	C	99	86	185	0	0	185	0	0
19	46321539	rs11670843	G	C	7	5	12	0	1	13	0	0
19	46321978	rs4803856	G	A	12	8	20	0	0	20	0	0
19	46323942	rs4803859	G	T	9	10	19	0	2	21	0	0
19	46324023	.	T	G	14	11	25	0	0	25	0	0
19	46327185	rs7252416	G	C	8	4	12	0	0	12	0	0
19	46327297	rs10853776	A	G	9	4	13	0	0	13	0	0
19	46327367	rs10853777	T	C	10	3	13	0	0	13	0	0
19	46327746	rs12610647	A	G	4	2	6	0	0	6	0	0
19	46327831	rs10520390	C	G	4	2	6	0	0	6	0	0
19	46327981	rs8109700	A	C	4	3	7	0	0	7	0	0
19	46328057	rs8110723	T	C	5	1	6	0	0	6	0	0
19	46328058	rs8110130	G	A	5	1	6	0	0	6	0	0
19	46331302	rs4239535	C	G	4	3	7	0	0	7	0	0
19	46332194	rs3745929	C	T	4	2	6	0	0	6	0	0
19	46341824	rs17850110	C	T	30	33	63	0	0	63	0	0
19	46351140	rs113726151	G	A	27	30	57	0	1	58	0	0
19	46352122	rs2303014	A	G	25	32	57	0	0	57	0	0
19	46357811	rs2287718	C	A	6	7	13	0	0	13	0	0
19	46359794	rs76793172	C	T	6	1	7	0	1	8	0	0
19	46360019	rs34653235	A	C	5	4	9	0	0	9	0	0
19	46361475	rs79648563	G	C	3	4	7	0	0	7	0	0
19	46365177	rs113577760	T	C	4	7	11	0	1	12	0	0
19	46387941	rs200198801	G	A	2	11	13	0	0	13	0	0
19	46526298	rs2072562	T	G	20	12	32	0	0	32	0	0
19	46857015	rs917948	C	T	18	21	39	0	2	41	0	0
19	46885977	rs11670522	C	T	7	4	11	0	1	12	0	0
19	46887847	rs2302596	C	T	5	3	8	0	0	8	0	0
19	46893810	rs8811	G	A	24	19	43	0	0	43	0	0
19	46971363	rs3745787	G	A	6	0	6	0	0	6	0	0
19	47110841	rs10853780	A	C	13	35	48	0	0	48	0	0
19	47112648	rs10113	T	C	357	344	701	0	8	709	0	0
19	47112740	rs710889	C	T	255	194	449	0	16	466	1	0
19	47113138	rs10405893	A	G	397	365	762	0	8	770	0	0
19	47137459	rs12974613	C	T	5	4	9	0	0	9	0	0
19	47183416	rs3859426	T	C	20	17	37	0	0	37	0	0
19	47183840	rs6509290	T	C	10	14	24	0	0	24	0	0
19	47184029	rs191914921	T	C	19	12	31	0	0	31	0	0
19	47184356	rs8105742	G	A	6	11	17	0	0	17	0	0
19	47207654	rs11083846	G	A	5	1	6	0	0	6	0	0
19	47209115	rs62134785	T	G	3	3	6	0	0	6	0	0
19	47209159	rs117579506	G	A	5	3	8	0	0	8	0	0
19	47210859	rs12609920	C	A	8	4	12	0	0	12	0	0
19	47211592	rs12975247	T	C	3	5	8	0	1	9	0	0
19	47211778	rs10404836	T	C	12	8	20	0	0	20	0	0
19	47212229	.	G	T	8	9	17	0	0	17	0	0
19	47212593	rs10423365	A	G	5	9	14	0	0	14	0	0
19	47217914	rs588712	A	C	10	2	12	0	0	12	0	0
19	47218101	rs3848528	G	T	8	9	17	0	0	17	0	0
19	47219450	rs56034494	A	G	68	40	108	0	1	109	0	0
19	47223543	rs313840	T	C	279	264	543	0	5	548	0	0
19	47224317	rs313842	C	T	16	17	33	0	0	33	0	0
19	47224484	rs313843	A	G	24	19	43	0	0	43	0	0
19	47224607	rs3786705	C	T	20	12	32	0	1	33	0	0
19	47227295	rs4803996	C	A	4	2	6	0	0	6	0	0
19	47227327	rs10416300	C	A	4	2	6	0	0	6	0	0
19	47230113	rs10411851	C	T	10	21	31	0	0	31	0	0
19	47242992	rs4802322	G	A	6	7	13	0	0	13	0	0
19	47243621	rs11668563	A	T	2	5	7	0	0	7	0	0
19	47245792	rs3786706	T	C	6	3	9	0	0	9	0	0
19	47248585	rs62134793	C	T	3	3	6	0	0	6	0	0
19	47258674	rs3201779	C	T	15	12	27	0	0	27	0	0
19	47278859	rs3027961	C	G	116	125	241	0	1	242	0	0
19	47291174	rs3027956	G	C	17	17	34	0	2	36	0	0
19	47291492	rs3027955	G	A	50	33	83	0	0	83	0	0
19	47291561	rs3027953	A	G	49	51	100	0	1	101	0	0
19	47291570	rs3027952	G	A	47	48	95	0	0	95	0	0
19	47342867	rs312185	A	C	3	3	6	0	0	6	0	0
19	47506352	rs11548674	A	G	22	17	39	0	1	40	0	0
19	47506769	rs1052669	C	T	15	17	32	0	1	33	0	0
19	47699707	rs35368210	G	A	5	1	6	0	0	6	0	0
19	47761543	rs2302985	T	C	4	2	6	0	0	6	0	0
19	47761646	rs12985905	G	C	57	53	110	0	1	111	0	0
19	47768128	rs2032811	G	C	9	16	25	0	1	26	0	0
19	47769120	rs7248282	C	T	8	14	22	0	0	22	0	0
19	47769165	rs10407675	T	G	8	10	18	0	0	18	0	0
19	47769839	rs9304666	A	G	7	6	13	0	0	13	0	0
19	47770015	rs10413121	A	C	56	68	124	0	1	125	0	0
19	47770938	rs883030	C	A	5	3	8	0	0	8	0	0
19	47771499	rs884537	G	A	3	4	7	0	0	7	0	0
19	47772932	rs4802336	T	G	6	6	12	0	1	13	0	0
19	47773647	rs73061366	C	T	10	12	22	0	0	22	0	0
19	47773786	rs888838	A	G	6	1	7	0	0	7	0	0
19	47774447	rs66726054	G	A	10	2	12	0	0	12	0	0
19	47774572	rs60930438	C	T	157	149	306	0	2	308	0	0
19	47774772	rs888836	T	C	125	143	268	0	5	273	0	0
19	47778221	rs10407367	A	C	4	3	7	0	0	7	0	0
19	47852979	rs16972147	C	T	3	4	7	0	0	7	0	0
19	47853563	rs10403921	C	T	4	2	6	0	0	6	0	0
19	47855299	rs10419759	T	C	3	3	6	0	0	6	0	0
19	47878858	rs61751860	C	T	5	5	10	0	0	10	0	0
19	47879874	rs10419083	C	T	5	3	8	0	0	8	0	0
19	47883086	rs28522883	T	G	17	19	36	0	0	36	0	0
19	47978671	rs2272295	G	A	55	51	106	0	0	106	0	0
19	47980153	rs2293424	G	A	44	57	101	0	1	102	0	0
19	47988965	rs12460436	C	T	50	27	77	0	0	77	0	0
19	47989438	rs3760633	G	A	4	3	7	0	0	7	0	0
19	47989457	rs3760634	C	G	3	3	6	0	0	6	0	0
19	47989988	rs830150	A	C	26	44	70	0	2	72	0	0
19	47991451	rs10853789	A	G	176	256	432	0	8	440	0	0
19	47992042	rs8100846	T	C	50	40	90	0	0	90	0	0
19	47994210	rs2293421	T	C	49	54	103	0	0	103	0	0
19	47994475	rs12460373	G	T	46	63	109	0	0	109	0	0
19	47996010	rs11881195	C	T	48	73	121	0	1	122	0	0
19	47999116	rs2242495	G	A	48	19	67	0	0	67	0	0
19	47999664	rs35400373	G	A	48	21	69	0	0	69	0	0
19	48002389	rs754502	G	T	6	6	12	0	1	13	0	0
19	48002394	rs754501	G	A	8	7	15	0	0	15	0	0
19	48005996	rs8106455	C	T	5	1	6	0	0	6	0	0
19	48017957	rs34206657	C	T	12	14	26	0	1	27	0	0
19	48205288	rs8100472	G	A	5	6	11	0	0	11	0	0
19	48206069	rs77211154	G	A	85	84	169	0	0	169	0	0
19	48245075	rs28384119	T	C	7	3	10	0	0	10	0	0
19	48248907	rs78530808	G	C	847	663	1510	0	5	1515	0	0
19	48249609	rs143353428	T	C	20	20	40	0	1	41	0	0
19	48250203	rs2334292	T	A	40	41	81	0	0	81	0	0
19	48254799	rs11538669	T	C	1378	1087	2465	0	25	2490	0	0
19	48259200	rs55813323	A	G	36	40	76	0	2	78	0	0
19	48259787	rs11538664	C	T	1428	1170	2598	0	9	2607	0	0
19	48260752	rs73051800	G	A	9	0	9	0	0	9	0	0
19	48261001	rs28501100	G	A	8	16	24	0	0	24	0	0
19	48282453	rs10412662	A	C	3	3	6	0	0	6	0	0
19	48621036	rs13436	C	G	56	65	121	0	0	121	0	0
19	48622427	rs20581	A	G	53	58	111	0	1	112	0	0
19	48641574	rs411073	A	G	15	10	25	0	0	25	0	0
19	48642266	rs380487	T	C	2	10	12	0	0	12	0	0
19	48642811	rs3730951	G	C	7	0	7	0	0	7	0	0
19	48654553	rs20580	G	T	31	31	62	0	0	62	0	0
19	48700406	.	G	C	2	8	10	0	0	10	0	0
19	48711476	rs1062808	T	C	7	0	7	0	0	7	0	0
19	48711906	rs4597433	T	A	10	2	12	0	0	12	0	0
19	48711960	rs4347733	C	T	6	1	7	0	0	7	0	0
19	48711962	rs4423519	C	T	5	1	6	0	1	7	0	0
19	48712084	rs118114021	A	T	5	4	9	0	0	9	0	0
19	48712219	rs71357807	T	C	3	3	6	0	0	6	0	0
19	48712436	rs11665981	C	T	5	4	9	0	0	9	0	0
19	48713950	rs1347170	A	C	4	4	8	0	0	8	0	0
19	48715153	rs3745718	T	C	16	15	31	0	0	31	0	0
19	48737706	rs2043211	A	T	11	19	30	0	0	30	0	0
19	48745309	rs12984929	G	T	4	2	6	0	0	6	0	0
19	48759028	rs7258674	A	G	8	10	18	0	0	18	0	0
19	48759677	rs7259589	C	T	11	11	22	0	0	22	0	0
19	48759727	rs10427120	T	C	13	16	29	0	0	29	0	0
19	48759731	rs7260636	T	C	12	16	28	0	0	28	0	0
19	48759978	rs12459322	C	G	17	18	35	0	0	35	0	0
19	48760005	rs12459359	G	C	19	17	36	0	0	36	0	0
19	48760022	rs12459323	A	G	16	17	33	0	0	33	0	0
19	48760229	rs7248320	G	A	22	18	40	0	0	40	0	0
19	48760676	rs7343088	A	T	5	3	8	0	1	9	0	0
19	48760744	rs7248752	C	T	4	14	18	0	0	18	0	0
19	48760771	rs7248766	C	T	6	19	25	0	0	25	0	0
19	48760890	rs10412163	A	G	14	25	39	0	0	39	0	0
19	48761065	rs10412609	A	G	14	17	31	0	0	31	0	0
19	48762913	rs7253258	G	C	10	5	15	0	0	15	0	0
19	48762925	rs10414340	C	T	9	5	14	0	0	14	0	0
19	48762956	rs7253271	G	A	8	5	13	0	0	13	0	0
19	48766302	rs73061558	C	T	9	5	14	0	0	14	0	0
19	48766329	rs12462140	T	G	7	6	13	0	0	13	0	0
19	48768026	rs7259415	A	G	7	3	10	0	0	10	0	0
19	48768093	rs7260495	T	C	5	4	9	0	0	9	0	0
19	48768620	rs11669615	G	A	3	3	6	0	0	6	0	0
19	48774282	rs59575473	C	T	2	5	7	0	0	7	0	0
19	48774683	rs55976836	G	A	9	20	29	0	1	30	0	0
19	48789612	rs75734088	G	A	4	3	7	0	0	7	0	0
19	48825103	rs10403090	G	C	8	5	13	0	0	13	0	0
19	48829228	rs8182501	T	C	10	13	23	0	0	23	0	0
19	48829630	rs8182495	C	T	15	10	25	0	0	25	0	0
19	48830286	rs10415654	T	A	12	14	26	0	0	26	0	0
19	48830446	rs10414314	A	C	20	20	40	0	1	41	0	0
19	48831777	rs12463018	G	A	31	24	55	0	0	55	0	0
19	48831792	rs55876324	A	T	29	25	54	0	0	54	0	0
19	48832554	rs8102349	A	G	108	91	199	0	1	200	0	0
19	48833608	rs4893	A	G	934	917	1851	0	3	1854	0	0
19	48833800	rs8355	C	T	73	52	125	0	2	127	0	0
19	48833806	rs11665	C	G	58	19	77	0	1	79	1	0
19	48836082	rs3745720	A	C	7	4	11	0	0	11	0	0
19	48836208	rs1062919	G	A	4	3	7	0	0	7	0	0
19	48836236	rs1062918	G	A	0	6	6	0	1	7	0	0
19	48836673	rs3826828	G	T	3	6	9	0	0	9	0	0
19	48885918	rs1050671	C	T	186	195	381	0	1	382	0	0
19	48885949	rs116882936	G	A	213	230	443	0	9	452	0	0
19	48898274	rs2304244	C	A	2	4	6	0	0	6	0	0
19	48899448	rs276713	G	A	6	3	9	0	0	9	0	0
19	48999850	rs10408497	A	G	3	4	7	0	0	7	0	0
19	49001600	rs61745738	A	G	3	7	10	0	0	10	0	0
19	49300913	rs34867589	T	C	0	7	7	0	0	7	0	0
19	49302286	rs4802505	A	G	3	3	6	0	0	6	0	0
19	49303070	rs11548193	G	C	10	7	17	0	0	17	0	0
19	49409026	rs111959800	G	A	126	116	242	0	1	243	0	0
19	49463040	rs11669164	A	G	4	2	6	0	0	6	0	0
19	49469087	rs2230267	T	C	3567	3568	7135	0	78	7215	2	0
19	49483068	rs11882285	G	A	7	0	7	0	0	7	0	0
19	49483086	rs11882289	G	T	5	1	6	0	0	6	0	0
19	49485548	rs5464	G	A	13	8	21	0	0	21	0	0
19	49513273	rs1062708	C	T	100	82	182	0	2	184	0	0
19	49513349	rs2287760	C	G	2	5	7	0	0	7	0	0
19	49518484	rs753307	C	T	4	3	7	0	0	7	0	0
19	49588746	rs11539822	C	T	99	78	177	0	1	178	0	0
19	49605530	rs10419811	A	G	95	71	166	0	47	242	29	0
19	49606680	rs1062250	G	A	247	177	424	0	13	438	1	0
19	49610389	rs3795055	T	C	130	108	238	0	0	238	0	0
19	49610413	rs3795056	C	T	122	99	221	0	0	221	0	0
19	49621964	rs2232003	T	C	5	5	10	0	0	10	0	0
19	49838891	rs354020	C	A	14	6	20	0	0	20	0	0
19	49839015	rs354021	T	C	513	600	1113	0	14	1127	0	0
19	49839283	rs354022	G	A	2	5	7	0	0	7	0	0
19	49839428	rs354023	T	C	3	7	10	0	0	10	0	0
19	49839504	rs354024	T	C	2	4	6	0	0	6	0	0
19	49841054	rs354026	G	T	2	12	14	0	0	14	0	0
19	49842824	rs164820	G	A	41	20	61	0	2	63	0	0
19	49843042	rs7257387	A	C	31	48	79	0	2	81	0	0
19	49949589	rs1043263	A	T	3	16	19	0	0	19	0	0
19	49949652	rs7462	G	A	86	48	134	0	3	137	0	0
19	49950413	rs2335090	C	G	12	11	23	0	0	23	0	0
19	49965131	rs76844851	G	A	11	5	16	0	1	17	0	0
19	49965132	rs79109084	G	C	10	6	16	0	0	16	0	0
19	49965173	rs7259560	A	T	30	31	61	0	0	61	0	0
19	49967680	rs2293009	G	A	40	67	107	0	1	108	0	0
19	49967981	rs11558188	T	G	91	51	142	0	1	143	0	0
19	49968169	rs11669044	T	C	8	6	14	0	0	14	0	0
19	49968176	rs11672888	G	C	8	7	15	0	0	15	0	0
19	49968707	rs10422735	C	T	5	4	9	0	0	9	0	0
19	49968781	rs2914667	A	G	8	7	15	0	1	16	0	0
19	49969085	rs10853810	C	T	69	73	142	0	0	142	0	0
19	49973784	rs1055637	A	G	50	50	100	0	0	100	0	0
19	50000009	rs2280401	G	A	19	23	42	0	0	42	0	0
19	50002253	.	C	T	62	55	117	0	1	118	0	0
19	50140068	rs1368464	C	T	7	6	13	0	0	13	0	0
19	50140092	rs1865077	G	A	16	17	33	0	0	33	0	0
19	50140209	rs1368463	C	T	8	6	14	0	0	14	0	0
19	50140246	rs1865076	C	A	9	9	18	0	0	18	0	0
19	50140649	rs1965104	C	T	3	5	8	0	0	8	0	0
19	50168174	rs34739574	C	T	19	12	31	0	1	32	0	0
19	50176686	rs10411771	A	G	36	21	57	0	0	57	0	0
19	50176786	rs1045567	T	C	38	27	65	0	0	65	0	0
19	50192062	.	C	T	15	16	31	0	0	31	0	0
19	50271502	rs1674139	T	C	2	9	11	0	0	11	0	0
19	50281537	rs1273644	T	C	6	3	9	0	0	9	0	0
19	50283379	rs1273646	C	G	5	7	12	0	0	12	0	0
19	50301844	rs7248071	T	G	0	6	6	0	0	6	0	0
19	50304336	rs1003424	A	G	5	1	6	0	0	6	0	0
19	50304392	rs10421561	T	C	5	2	7	0	0	7	0	0
19	50305688	rs2159984	G	C	8	9	17	0	0	17	0	0
19	50307344	rs11879607	C	T	24	18	42	0	0	42	0	0
19	50307408	rs11879637	G	A	26	17	43	0	0	43	0	0
19	50307727	.	G	A	12	5	17	0	0	17	0	0
19	50308134	rs2241040	G	C	36	47	83	0	0	83	0	0
19	50308893	rs8101959	T	C	10	6	16	0	0	16	0	0
19	50335510	rs3745480	T	C	11	4	15	0	2	17	0	0
19	50343129	rs921470	T	C	69	65	134	0	1	135	0	0
19	50385156	rs75874825	T	C	6	3	9	0	0	9	0	0
19	50435747	rs283525	T	C	39	19	58	0	0	58	0	0
19	50435921	rs201354210	C	T	3	8	11	0	9	20	0	0
19	50880741	rs2695121	T	C	3	5	8	0	0	8	0	0
19	50881326	rs28514894	T	C	42	36	78	0	0	78	0	0
19	50882169	rs2248949	A	G	6	6	12	0	0	12	0	0
19	50882172	rs41432149	C	T	6	6	12	0	0	12	0	0
19	50884885	rs4802703	C	A	2	4	6	0	0	6	0	0
19	50983930	rs10409679	C	T	154	113	267	0	3	270	0	0
19	50986074	rs14031	G	A	188	172	360	0	4	364	0	0
19	51012816	rs1274698	G	A	7	2	9	0	0	9	0	0
19	51163306	rs73596611	G	T	21	1	22	0	1	23	0	0
19	51163834	rs73042560	G	A	8	51	59	0	1	60	0	0
19	51164022	rs73042561	T	A	5	27	32	0	2	34	0	0
19	51164803	rs78642714	G	A	5	13	18	0	4	22	0	0
19	51172526	rs41275782	G	C	6	24	30	0	0	30	0	0
19	51301230	rs9991	G	A	223	290	513	0	3	516	0	0
19	51301395	rs4801853	C	T	212	272	484	0	1	485	0	0
19	51301456	rs4802741	G	A	218	291	509	0	2	511	0	0
19	51302066	rs3745528	A	G	102	128	230	0	2	232	0	0
19	51302154	rs1043315	G	A	97	118	215	0	0	215	0	0
19	51302202	rs3745526	T	A	83	111	194	0	2	196	0	0
19	51303541	rs77036225	G	A	5	2	7	0	0	7	0	0
19	51304104	rs2456585	C	T	4	2	6	0	1	7	0	0
19	51305287	rs10401588	A	G	11	8	19	0	0	19	0	0
19	51305784	rs2560931	C	T	10	3	13	0	0	13	0	0
19	51728477	rs12459419	C	T	18	8	26	0	0	26	0	0
19	51728641	rs2455069	A	G	13	24	37	0	0	37	0	0
19	51738917	rs35112940	G	A	59	69	128	0	0	128	0	0
19	51834937	rs36054492	C	A	6	6	12	0	0	12	0	0
19	51835549	rs35525343	G	A	5	4	9	0	0	9	0	0
19	51871195	rs3745403	G	A	7	5	12	0	0	12	0	0
19	52091782	rs1063973	A	C	4	7	11	0	0	11	0	0
19	52092733	.	G	T	1	5	6	0	0	6	0	0
19	52092821	rs1054328	C	G	12	8	20	0	0	20	0	0
19	52115833	rs12462938	A	G	3	7	10	0	0	10	0	0
19	52130830	rs8107754	C	A	7	17	24	0	0	24	0	0
19	52216464	rs3829649	G	A	2	4	6	0	0	6	0	0
19	52216473	rs3829648	C	T	2	6	8	0	0	8	0	0
19	52216563	rs3829647	T	G	5	16	21	0	0	21	0	0
19	52222552	rs11084112	G	A	6	1	7	0	0	7	0	0
19	52249702	rs2070746	G	T	127	125	252	0	7	259	0	0
19	52249947	rs2070745	C	G	100	104	204	0	1	205	0	0
19	52250216	rs5030878	A	G	94	115	209	0	2	211	0	0
19	52346515	rs17835129	A	C	5	2	7	0	0	7	0	0
19	52390901	.	C	T	6	6	12	0	0	12	0	0
19	52403516	rs1549931	T	C	11	19	30	0	1	31	0	0
19	52452437	rs118048159	G	C	4	2	6	0	0	6	0	0
19	52456673	rs8107692	G	A	6	0	6	0	0	6	0	0
19	52464230	rs6509603	G	A	2	4	6	0	0	6	0	0
19	52465481	rs8107827	A	G	8	9	17	0	0	17	0	0
19	52466065	rs6509607	A	G	7	5	12	0	0	12	0	0
19	52466678	rs8111969	A	G	2	5	7	0	0	7	0	0
19	52467822	rs2278414	G	A	68	75	143	0	0	143	0	0
19	52468203	rs2278415	T	A	116	97	213	0	0	213	0	0
19	52468587	rs3764538	G	T	97	91	188	0	1	189	0	0
19	52468998	rs4988334	A	G	47	53	100	0	2	102	0	0
19	52471872	rs2278420	A	G	94	109	203	0	1	204	0	0
19	52472295	rs4986773	A	G	102	84	186	0	1	187	0	0
19	52472868	rs12461777	C	T	8	5	13	0	0	13	0	0
19	52476662	rs73934705	T	C	2	4	6	0	0	6	0	0
19	52477980	rs11668463	C	G	18	10	28	0	0	28	0	0
19	52483593	rs12460506	G	C	11	8	19	0	0	19	0	0
19	52484649	rs11669564	G	A	2	5	7	0	0	7	0	0
19	52484742	rs11665781	T	C	3	7	10	0	0	10	0	0
19	52487127	rs58116420	G	C	13	10	23	0	0	23	0	0
19	52487161	rs8110542	A	G	13	13	26	0	0	26	0	0
19	52495109	rs1835999	T	C	28	10	38	0	1	39	0	0
19	52495114	rs1836000	T	C	26	8	34	0	1	35	0	0
19	52495312	rs1433090	C	T	6	6	12	0	0	12	0	0
19	52495380	rs11084127	C	T	4	4	8	0	0	8	0	0
19	52495646	rs11084128	A	T	32	37	69	0	0	69	0	0
19	52495648	rs2288885	A	G	32	37	69	0	0	69	0	0
19	52495684	rs2288886	A	T	26	23	49	0	0	49	0	0
19	52495803	rs2288887	A	G	46	20	66	0	1	67	0	0
19	52496149	rs16983353	C	T	15	31	46	0	0	46	0	0
19	52497250	rs1978717	G	A	16	22	38	0	1	39	0	0
19	52497943	rs10500311	G	A	10	16	26	0	0	26	0	0
19	52506985	rs1433089	T	C	11	10	21	0	0	21	0	0
19	52507882	rs4516337	C	G	4	5	9	0	0	9	0	0
19	52516360	rs11671702	C	T	20	9	29	0	0	29	0	0
19	52517520	rs8111873	T	C	19	26	45	0	0	45	0	0
19	52517894	rs11665783	G	A	15	16	31	0	0	31	0	0
19	52519608	rs8104890	C	T	27	22	49	0	2	51	0	0
19	52520550	rs141035689	C	T	16	18	34	0	1	35	0	0
19	52520607	rs61574510	C	T	17	16	33	0	0	33	0	0
19	52521296	rs9636139	G	A	15	19	34	0	0	34	0	0
19	52532271	rs2288884	C	T	2	4	6	0	0	6	0	0
19	52535172	rs58329304	A	G	83	57	140	0	3	143	0	0
19	52535421	rs12462359	T	G	10	10	20	0	0	20	0	0
19	52535803	rs12460118	C	T	42	16	58	0	0	58	0	0
19	52535834	rs12460617	G	A	40	15	55	0	0	55	0	0
19	52536117	rs73053909	C	A	39	30	69	0	0	69	0	0
19	52536692	rs58817690	C	T	63	56	119	0	0	119	0	0
19	52537576	rs11666149	T	G	25	41	66	0	3	69	0	0
19	52539027	rs7254131	A	C	5	2	7	0	0	7	0	0
19	52550401	rs17779341	G	T	3	3	6	0	0	6	0	0
19	52551486	rs3752118	G	C	6	1	7	0	0	7	0	0
19	52551498	rs3752119	C	T	5	1	6	0	0	6	0	0
19	52552021	rs3752120	C	T	2	5	7	0	0	7	0	0
19	52552669	rs11667001	G	C	5	3	8	0	0	8	0	0
19	52709992	rs3826653	G	T	2	8	10	0	0	10	0	0
19	52710097	rs3786487	A	G	3	6	9	0	0	9	0	0
19	52714917	rs41275800	G	A	4	2	6	0	0	6	0	0
19	52825235	rs8102373	A	G	11	13	24	0	0	24	0	0
19	52828640	rs321935	A	C	29	31	60	0	0	60	0	0
19	52830121	rs321934	T	G	4	2	6	0	0	6	0	0
19	52869312	rs162120	T	C	6	1	7	0	0	7	0	0
19	52869534	rs162119	G	A	6	0	6	0	0	6	0	0
19	52870052	rs1054612	C	G	6	1	7	0	0	7	0	0
19	52882733	rs10445583	T	C	11	1	12	0	0	12	0	0
19	52882805	rs10445584	C	T	7	1	8	0	0	8	0	0
19	52882824	rs10445585	T	A	7	1	8	0	0	8	0	0
19	52883483	rs62108317	G	A	7	0	7	0	0	7	0	0
19	52887427	rs8104808	A	C	6	5	11	0	0	11	0	0
19	52887437	rs8104812	A	C	5	4	9	0	0	9	0	0
19	52887904	.	T	C	4	7	11	0	0	11	0	0
19	52888210	.	T	C	7	6	13	0	0	13	0	0
19	52888245	rs55748277	A	G	9	7	16	0	0	16	0	0
19	52893473	rs7253837	A	G	5	1	6	0	0	6	0	0
19	52898959	rs11670607	G	A	23	7	30	0	0	30	0	0
19	52900846	rs11672854	G	A	15	6	21	0	0	21	0	0
19	52909989	rs11668956	A	G	4	3	7	0	0	7	0	0
19	52915967	rs113365590	G	T	5	4	9	0	1	10	0	0
19	52915998	rs7507280	T	G	3	6	9	0	0	9	0	0
19	52916988	rs1820691	T	G	5	2	7	0	0	7	0	0
19	52917198	rs1824245	C	A	4	12	16	0	0	16	0	0
19	52917590	rs162124	G	A	0	7	7	0	1	8	0	0
19	52917907	rs4802932	A	G	3	3	6	0	0	6	0	0
19	52921057	rs8106133	A	G	7	22	29	0	0	29	0	0
19	53090335	rs3339	A	C	6	8	14	0	0	14	0	0
19	53090349	rs3338	T	C	5	8	13	0	0	13	0	0
19	53110102	rs34908470	A	G	10	8	18	0	0	18	0	0
19	53110104	rs34577894	G	A	9	8	17	0	0	17	0	0
19	53112754	.	A	T	5	1	6	0	0	6	0	0
19	53116060	rs1046648	G	A	91	75	166	0	0	167	1	0
19	53117531	rs1056185	C	T	45	25	70	0	0	70	0	0
19	53117809	rs10406458	C	A	49	25	74	0	0	74	0	0
19	53120249	rs10402789	T	A	28	10	38	0	0	38	0	0
19	53120393	rs57287728	C	T	17	20	37	0	1	38	0	0
19	53120559	rs10401904	C	T	30	18	48	0	0	48	0	0
19	53121758	rs35017334	G	A	10	0	10	0	0	10	0	0
19	53122009	rs10402372	C	T	22	11	33	0	0	33	0	0
19	53122030	rs10402926	G	C	18	16	34	0	0	34	0	0
19	53130245	rs446825	T	G	29	28	57	0	0	57	0	0
19	53130334	rs365701	G	A	13	35	48	0	0	48	0	0
19	53144803	rs329954	A	C	10	16	26	0	0	26	0	0
19	53144820	rs329953	T	C	10	17	27	0	1	28	0	0
19	53145297	rs10406117	C	T	13	8	21	0	0	21	0	0
19	53146831	rs651023	G	A	3	3	6	0	1	7	0	0
19	53147590	rs329951	C	G	11	5	16	0	0	16	0	0
19	53147770	rs12980672	G	A	7	2	9	0	0	9	0	0
19	53149057	rs11666880	C	A	8	3	11	0	0	11	0	0
19	53150962	rs802877	G	C	8	10	18	0	0	18	0	0
19	53151775	rs12986098	T	C	2	6	8	0	0	8	0	0
19	53157096	rs4287691	C	A	6	6	12	0	0	12	0	0
19	53157171	rs329942	T	C	5	5	10	0	0	10	0	0
19	53206725	rs34312893	G	A	11	11	22	0	0	22	0	0
19	53207182	rs7256563	C	T	11	2	13	0	0	13	0	0
19	53209553	rs4085566	G	A	8	4	12	0	0	12	0	0
19	53209554	rs4085565	G	T	8	4	12	0	0	12	0	0
19	53223528	rs9676492	G	A	5	6	11	0	0	11	0	0
19	53223598	rs9676494	G	A	5	5	10	0	0	10	0	0
19	53227280	rs2112930	T	C	4	2	6	0	0	6	0	0
19	53267479	rs8104631	C	T	4	2	6	0	0	6	0	0
19	53267506	rs11667063	C	T	2	4	6	0	0	6	0	0
19	53270460	rs4614842	G	A	9	13	22	0	0	22	0	0
19	53300984	rs9917029	C	T	2	4	6	0	0	6	0	0
19	53301194	rs7252051	C	T	23	22	45	0	0	45	0	0
19	53301245	rs7253090	T	C	17	15	32	0	1	33	0	0
19	53302057	rs7248697	C	A	9	11	20	0	0	20	0	0
19	53302453	rs10407516	A	G	10	7	17	0	0	17	0	0
19	53302481	rs10407539	A	G	12	7	19	0	0	19	0	0
19	53302622	rs10408156	C	T	8	5	13	0	0	13	0	0
19	53302737	rs10410012	T	C	5	6	11	0	0	11	0	0
19	53303527	rs8107444	A	G	5	5	10	0	0	10	0	0
19	53303705	rs10417163	T	G	8	4	12	0	0	12	0	0
19	53319489	rs56292969	G	T	7	2	9	0	0	9	0	0
19	53319514	rs8108112	G	A	13	9	22	0	0	22	0	0
19	53319713	rs8108961	T	C	17	14	31	0	0	31	0	0
19	53319888	rs28703777	C	G	13	7	20	0	1	21	0	0
19	53319913	rs28450473	A	G	11	4	15	0	1	16	0	0
19	53320292	rs28420198	T	G	11	5	16	0	0	16	0	0
19	53320349	rs28712529	G	C	10	4	14	0	0	14	0	0
19	53320351	rs28439016	A	C	10	4	14	0	0	14	0	0
19	53320462	rs28667452	C	T	13	7	20	0	0	20	0	0
19	53320518	rs56008301	G	C	14	8	22	0	0	22	0	0
19	53320557	rs58599955	G	A	12	7	19	0	0	19	0	0
19	53320582	rs55996509	G	A	11	6	17	0	0	17	0	0
19	53320822	rs12459154	C	T	1	5	6	0	0	6	0	0
19	53342969	.	C	T	46	40	86	0	0	86	0	0
19	53425993	rs10424724	A	C	10	12	22	0	0	22	0	0
19	53426612	rs1975043	C	T	8	23	31	0	1	32	0	0
19	53426745	rs1978618	C	T	8	6	14	0	5	19	0	0
19	53426847	rs1978620	T	C	5	10	15	0	0	15	0	0
19	53427209	rs11666503	C	T	18	26	44	0	1	45	0	0
19	53427298	rs4334054	A	C	17	28	45	0	0	45	0	0
19	53445212	rs117392732	C	T	4	7	11	0	0	11	0	0
19	53445267	rs12985813	T	C	5	2	7	0	0	7	0	0
19	53445298	rs12983748	A	G	7	2	9	0	0	9	0	0
19	53448098	rs6509709	A	G	1	5	6	0	0	6	0	0
19	53451228	rs9304741	T	C	4	5	9	0	1	10	0	0
19	53451291	rs9304742	T	C	11	5	16	0	0	16	0	0
19	53451782	rs62116795	C	T	5	7	12	0	1	13	0	0
19	53452769	rs1044467	A	G	38	23	61	0	0	61	0	0
19	53452944	rs1808106	T	G	34	31	65	0	0	65	0	0
19	53452965	rs3745177	C	T	28	26	54	0	0	54	0	0
19	53453403	rs149695139	C	A	11	17	28	0	0	28	0	0
19	53453777	.	C	T	30	23	53	0	0	53	0	0
19	53454543	rs11084210	G	A	14	17	31	0	0	31	0	0
19	53454789	rs12459008	A	T	12	7	19	0	1	20	0	0
19	53454963	rs12461778	T	A	2	6	8	0	0	8	0	0
19	53455088	rs12461796	T	A	2	9	11	0	0	11	0	0
19	53455877	rs2011496	C	T	8	0	8	0	0	8	0	0
19	53478886	rs1650958	T	A	3	11	14	0	0	14	0	0
19	53489867	rs329695	T	C	6	0	6	0	0	6	0	0
19	53573187	rs77816404	T	G	44	42	86	0	0	86	0	0
19	53576465	rs329734	C	G	10	9	19	0	0	19	0	0
19	53576589	rs329733	C	G	12	15	27	0	0	27	0	0
19	53577419	rs8105668	G	C	47	52	99	0	0	99	0	0
19	53579631	rs329708	T	C	9	5	14	0	0	14	0	0
19	53581412	.	G	A	7	9	16	0	0	16	0	0
19	53582436	rs4801951	G	A	6	6	12	0	0	12	0	0
19	53583793	rs4305192	G	A	3	5	8	0	0	8	0	0
19	53584736	rs12984129	G	A	4	3	7	0	0	7	0	0
19	53585412	rs8102965	T	G	6	4	10	0	0	10	0	0
19	53590676	rs2115088	G	A	5	3	8	0	0	8	0	0
19	53592453	rs12975777	C	T	3	8	11	0	1	12	0	0
19	53593040	rs7258975	A	G	5	7	12	0	0	12	0	0
19	53593042	rs7258976	A	G	5	7	12	0	0	12	0	0
19	53593229	rs7260308	T	C	2	5	7	0	0	7	0	0
19	53593932	rs11670432	G	T	5	5	10	0	0	10	0	0
19	53594296	rs10406368	C	T	7	6	13	0	0	13	0	0
19	53594806	rs3745178	A	G	17	19	36	0	2	38	0	0
19	53611187	rs3814	T	C	3	14	17	0	0	17	0	0
19	53611473	rs1045764	C	T	6	29	35	0	0	35	0	0
19	53612311	rs4803051	T	C	4	7	11	0	0	11	0	0
19	53612745	rs1133327	T	C	5	8	13	0	0	13	0	0
19	53612757	rs1054485	T	G	5	8	13	0	0	13	0	0
19	53682862	rs12971967	T	C	4	8	12	0	0	12	0	0
19	53682988	rs7253428	T	C	10	4	14	0	0	14	0	0
19	53742153	rs1129002	T	A	26	21	47	0	0	47	0	0
19	53742898	rs7260260	A	C	2	4	6	0	0	6	0	0
19	53743117	rs7260595	A	G	18	23	41	0	0	41	0	0
19	53743134	rs7246435	T	C	16	20	36	0	0	36	0	0
19	53743161	rs7245436	C	A	13	10	23	0	0	23	0	0
19	53743336	rs3097248	C	T	17	9	26	0	0	26	0	0
19	53743799	rs8100627	C	T	4	5	9	0	1	10	0	0
19	53746263	rs2965222	T	C	3	5	8	0	0	8	0	0
19	53848779	rs75887836	T	C	13	18	31	0	0	31	0	0
19	53848837	rs56683540	C	T	14	17	31	0	0	31	0	0
19	53848845	rs57319493	G	A	12	14	26	0	0	26	0	0
19	53856349	rs55874600	A	T	22	26	48	0	0	48	0	0
19	53885276	rs60179423	C	A	3	6	9	0	0	9	0	0
19	53885352	rs58896082	C	T	5	5	10	0	0	10	0	0
19	53885667	rs62115355	G	A	2	5	7	0	0	7	0	0
19	53888813	rs12983975	G	A	9	11	20	0	1	21	0	0
19	53911510	rs8182488	G	A	3	6	9	0	0	9	0	0
19	53911973	rs10425136	A	G	8	4	12	0	0	12	0	0
19	53912242	rs10426347	G	A	5	7	12	0	0	12	0	0
19	53912521	rs73059151	G	A	6	4	10	0	0	10	0	0
19	53912548	rs7246019	T	C	6	6	12	0	0	12	0	0
19	53912770	rs12461238	G	A	8	6	14	0	0	14	0	0
19	53913555	rs6509753	C	G	17	15	32	0	0	32	0	0
19	53914108	rs2068630	C	T	10	15	25	0	0	25	0	0
19	53914425	rs7253508	C	A	14	13	27	0	1	28	0	0
19	53926885	rs2259947	G	C	4	4	8	0	0	8	0	0
19	53926911	rs12978276	T	A	4	3	7	0	0	7	0	0
19	53927121	.	A	C	9	2	11	0	0	11	0	0
19	53927131	.	C	A	9	2	11	0	0	11	0	0
19	53929106	rs3761115	G	A	6	4	10	0	0	10	0	0
19	53937669	rs3975039	C	T	4	2	6	0	1	7	0	0
19	53942084	rs75739523	A	G	3	3	6	0	0	6	0	0
19	53942883	rs11672864	A	G	4	4	8	0	0	8	0	0
19	53943200	rs59290332	A	G	4	3	7	0	0	7	0	0
19	53943214	rs4539721	G	A	3	3	6	0	0	6	0	0
19	53978691	rs7249747	G	A	8	0	8	0	0	8	0	0
19	54024728	rs73935608	G	A	25	8	33	0	0	33	0	0
19	54026565	rs2569574	T	C	7	7	14	0	0	14	0	0
19	54026571	rs2569573	G	C	6	6	12	0	0	12	0	0
19	54041511	rs185947297	A	G	0	13	13	0	0	13	0	0
19	54070738	rs56136926	A	G	0	9	9	0	0	9	0	0
19	54074446	rs73051575	A	G	0	6	6	0	0	6	0	0
19	54074747	rs3746301	G	A	7	0	7	0	0	7	0	0
19	54080279	rs1351	T	C	11	86	97	0	0	97	0	0
19	54080780	rs16985052	C	T	15	141	156	0	0	156	0	0
19	54080999	rs1056393	A	G	22	179	201	0	2	203	0	0
19	54081518	rs73051595	C	T	11	82	93	0	0	93	0	0
19	54082669	rs1061422	G	C	11	84	95	0	0	95	0	0
19	54371257	rs10411316	A	G	7	7	14	0	0	14	0	0
19	54378030	rs200046918	T	C	261	31	292	0	20	312	0	0
19	54378082	rs1143262	T	C	105	132	237	0	1	238	0	0
19	54378627	rs307935	T	A	104	122	226	0	3	229	0	0
19	54378789	rs307936	C	G	141	123	264	0	44	309	1	0
19	54379573	rs8604	C	T	93	97	190	0	2	192	0	0
19	54544189	rs2303558	C	T	155	159	314	0	2	316	0	0
19	54545186	rs73058793	C	T	202	163	365	0	4	369	0	0
19	54545274	rs67563163	G	T	3	4	7	0	0	7	0	0
19	54567012	.	G	A	125	106	231	0	0	231	0	0
19	54603429	.	C	A	3	8	11	0	0	11	0	0
19	54612424	.	G	A	2	8	10	0	0	10	0	0
19	54658001	rs1055234	C	G	15	10	25	0	1	26	0	0
19	54688378	rs59537494	C	G	5	4	9	0	0	9	0	0
19	54692523	rs36625	G	A	3	5	8	0	0	8	0	0
19	54704760	rs3810232	A	C	133	60	193	0	0	193	0	0
19	54705317	rs158366	C	G	24	101	125	0	1	126	0	0
19	54705340	rs2304524	C	G	23	106	129	0	0	129	0	0
19	54705583	rs78525177	A	G	34	38	72	0	1	73	0	0
19	54705588	rs17305304	A	G	37	36	73	0	1	74	0	0
19	54705641	rs17305311	T	C	38	38	76	0	0	76	0	0
19	54705912	rs67627137	C	G	23	23	46	0	0	46	0	0
19	54705928	rs71365431	T	C	26	20	46	0	1	47	0	0
19	54706042	rs67776059	C	T	32	35	67	0	0	67	0	0
19	54706088	rs67832260	C	T	37	35	72	0	0	72	0	0
19	54706104	rs68051412	G	A	43	29	72	0	0	72	0	0
19	54706127	rs67724353	C	A	42	31	73	0	0	73	0	0
19	54706157	rs34797979	G	A	49	39	88	0	1	89	0	0
19	54706279	rs17239552	T	A	44	44	88	0	0	88	0	0
19	54706422	rs17239559	T	C	31	39	70	0	2	72	0	0
19	54706443	rs17239566	A	C	34	52	86	0	0	86	0	0
19	54706507	rs73614906	G	A	59	39	98	0	0	98	0	0
19	54706680	rs11084315	C	A	41	48	89	0	0	89	0	0
19	54706772	rs11084316	A	C	39	41	80	0	1	81	0	0
19	54706827	rs11084317	A	T	37	59	96	0	0	97	1	0
19	54706855	rs73614911	C	T	68	43	111	0	1	112	0	0
19	54706990	rs11084318	T	C	42	58	100	0	0	100	0	0
19	54707359	rs34587409	G	A	32	31	63	0	3	66	0	0
19	54707486	rs117107587	C	T	50	29	79	0	1	80	0	0
19	54707562	rs3852885	C	T	40	35	75	0	0	75	0	0
19	54707576	rs3852886	C	T	40	44	84	0	3	87	0	0
19	54707588	rs3852887	G	A	42	51	93	0	3	96	0	0
19	54707822	rs3865475	T	C	40	44	84	0	1	85	0	0
19	54707954	rs12973461	C	T	35	28	63	0	1	64	0	0
19	54708077	rs34812946	T	C	17	36	53	0	1	54	0	0
19	54708083	rs111736365	T	C	40	17	57	0	0	57	0	0
19	54708156	rs34868797	C	T	26	31	57	0	1	58	0	0
19	54708158	rs34924761	A	G	27	32	59	0	0	59	0	0
19	54708250	rs36102336	G	A	23	33	56	0	0	56	0	0
19	54708399	rs35955135	G	A	34	54	88	0	1	89	0	0
19	54708665	rs17305332	T	C	42	57	99	0	1	100	0	0
19	54709243	rs12984659	T	C	46	30	76	0	0	76	0	0
19	54709298	rs12983262	G	C	35	36	71	0	2	73	0	0
19	54709377	rs12982851	A	G	46	56	102	0	2	104	0	0
19	54709379	rs12983496	G	A	48	57	105	0	1	106	0	0
19	54709882	rs3889084	C	T	144	123	267	0	1	268	0	0
19	54709894	rs4294923	C	T	126	148	274	0	0	274	0	0
19	54709930	rs3889085	C	A	110	108	218	0	2	220	0	0
19	54711032	rs4806499	A	G	164	178	342	0	1	343	0	0
19	54713254	rs35740980	C	A	4	3	7	0	0	7	0	0
19	54718216	rs6509852	A	G	7	0	7	0	0	7	0	0
19	54718224	rs6509853	G	A	7	0	7	0	0	7	0	0
19	54719768	rs255775	C	T	9	6	15	0	0	15	0	0
19	54721203	rs1132612	C	T	14	11	25	0	0	25	0	0
19	54721215	rs1053011	C	T	16	10	26	0	0	26	0	0
19	54721216	rs1053008	A	G	16	10	26	0	0	26	0	0
19	54721256	rs117030367	A	G	18	15	33	0	0	33	0	0
19	54721260	rs117334650	G	A	20	16	36	0	0	36	0	0
19	54721320	.	C	G	18	26	44	0	0	44	0	0
19	54722039	rs112913349	C	T	4	3	7	0	0	7	0	0
19	54722095	rs112224147	G	A	3	5	8	0	0	8	0	0
19	54722209	rs58414108	T	C	5	8	13	0	0	13	0	0
19	54722250	rs1132610	T	C	16	28	44	0	0	44	0	0
19	54722594	rs3852891	T	C	3	10	13	0	0	13	0	0
19	54722595	rs3852892	G	A	3	10	13	0	0	13	0	0
19	54723118	rs78889379	G	C	6	12	18	0	0	18	0	0
19	54723310	rs4806725	T	C	6	8	14	0	0	14	0	0
19	54723355	rs255774	A	G	13	5	18	0	0	18	0	0
19	54723546	rs255773	C	T	5	2	7	0	0	7	0	0
19	54723621	rs117449986	C	G	2	4	6	0	0	6	0	0
19	54723766	rs114574888	A	G	1	7	8	0	0	8	0	0
19	54724407	rs1132608	C	T	4	3	7	0	0	7	0	0
19	54724443	rs201735825	G	A	4	3	7	0	0	7	0	0
19	54725529	rs56211996	T	C	6	0	6	0	0	6	0	0
19	54725913	rs199822090	C	T	3	6	9	0	0	9	0	0
19	54725930	rs61480095	C	T	7	3	10	0	0	10	0	0
19	54726630	.	C	T	6	0	6	0	0	6	0	0
19	54726816	.	A	T	8	0	8	0	0	8	0	0
19	54726833	.	T	C	7	0	7	0	0	7	0	0
19	54726839	rs141453251	C	T	8	0	8	0	0	8	0	0
19	54726843	rs138124247	C	G	8	0	8	0	0	8	0	0
19	54726861	.	C	T	8	0	8	0	0	8	0	0
19	54726870	rs71266894	C	G	6	2	8	0	0	8	0	0
19	54726872	.	C	G	7	0	7	0	0	7	0	0
19	54740705	rs7256687	G	A	13	10	23	0	0	23	0	0
19	54740974	rs2361804	C	T	10	1	11	0	0	11	0	0
19	54741424	rs4328567	G	C	4	6	10	0	0	10	0	0
19	54741434	rs4399657	G	A	4	6	10	0	0	10	0	0
19	54742303	rs71365449	C	T	4	2	6	0	0	6	0	0
19	54744794	.	G	A	11	6	17	0	0	17	0	0
19	54744799	.	G	C	11	6	17	0	0	17	0	0
19	54745550	.	G	T	1	6	7	0	0	7	0	0
19	54745978	.	T	C	14	4	18	0	1	19	0	0
19	54745989	rs1052963	G	C	16	5	21	0	0	21	0	0
19	54746051	.	A	C	13	2	15	0	0	15	0	0
19	54746081	.	T	C	11	5	16	0	0	16	0	0
19	54778185	rs77679745	T	C	17	21	38	0	1	39	0	0
19	54779101	rs443501	C	T	1	5	6	0	0	6	0	0
19	54781078	.	G	T	13	15	28	0	0	28	0	0
19	54782670	rs10405713	T	C	28	7	35	0	0	35	0	0
19	54782671	rs41308754	G	C	27	7	34	0	1	35	0	0
19	54782682	.	C	T	26	7	33	0	1	34	0	0
19	54782731	rs10404685	G	A	21	2	23	0	0	23	0	0
19	54782737	rs41308750	T	C	19	3	22	0	0	22	0	0
19	54782919	rs386056	C	T	8	15	23	0	0	23	0	0
19	54783375	rs373032	T	A	15	19	34	0	1	35	0	0
19	54784130	rs383369	T	C	4	9	13	0	1	14	0	0
19	54784920	rs448083	C	T	3	10	13	0	0	13	0	0
19	54784936	rs448092	C	T	3	5	8	0	0	8	0	0
19	54867931	.	G	C	14	9	23	0	0	23	0	0
19	54879975	rs1985841	T	C	7	3	10	0	0	10	0	0
19	54880811	rs11084332	T	C	3	3	6	0	0	6	0	0
19	54956254	rs10401901	A	C	1	5	6	0	0	6	0	0
19	54968245	rs7259898	G	A	2	4	6	0	1	7	0	0
19	54969169	rs79561966	C	T	360	416	776	0	3	779	0	0
19	54973280	rs10423424	C	G	5	4	9	0	0	9	0	0
19	55084727	.	A	G	9	5	14	0	0	14	0	0
19	55086249	rs45523736	T	C	59	47	106	0	1	107	0	0
19	55175740	rs3745871	C	T	3	3	6	0	0	6	0	0
19	55178162	rs11574576	A	G	2	4	6	0	0	6	0	0
19	55393069	rs7248382	T	C	14	6	20	0	0	20	0	0
19	55393253	rs75358524	C	T	2	8	10	0	0	10	0	0
19	55396913	rs11666735	G	A	105	72	177	0	0	177	0	0
19	55398656	rs116934473	A	G	5	7	12	0	0	12	0	0
19	55399314	rs74672836	G	T	2	6	8	0	1	9	0	0
19	55400454	rs78488294	C	T	15	10	25	0	2	27	0	0
19	55512232	rs1043673	C	A	4	2	6	0	0	6	0	0
19	55512316	rs1043678	T	G	8	1	9	0	0	9	0	0
19	55518937	.	C	G	3	4	7	0	0	7	0	0
19	55518941	rs80231030	T	C	2	4	6	0	0	6	0	0
19	55518942	rs75513678	C	T	2	4	6	0	0	6	0	0
19	55519228	rs11881945	C	T	1	5	6	0	0	6	0	0
19	55519248	rs11881948	C	T	2	4	6	0	0	6	0	0
19	55521845	rs55960306	A	C	2	5	7	0	0	7	0	0
19	55523718	rs58954940	G	A	3	5	8	0	0	8	0	0
19	55550807	rs141443125	T	C	1	11	12	0	0	12	0	0
19	55552823	rs1671214	A	G	4	3	7	0	0	7	0	0
19	55553019	rs1671215	C	A	2	5	7	0	0	7	0	0
19	55553200	rs13958	C	G	6	5	11	0	0	11	0	0
19	55553206	rs1054796	C	G	6	5	11	0	0	11	0	0
19	55554076	rs1671216	G	A	2	8	10	0	0	10	0	0
19	55555845	rs4029	A	G	6	12	18	0	0	18	0	0
19	55564724	rs191949170	T	C	3	3	6	0	0	6	0	0
19	55658167	rs11550310	G	C	40	66	106	0	2	108	0	0
19	55658222	rs11550309	T	C	47	39	86	0	1	87	0	0
19	55738181	rs3826884	G	A	89	72	161	0	1	162	0	0
19	55738425	rs3745919	G	A	102	108	210	0	0	210	0	0
19	55738746	rs4374298	G	A	27	34	61	0	1	62	0	0
19	55739515	rs4255895	T	C	14	4	18	0	0	18	0	0
19	55739605	rs4606850	C	T	40	35	75	0	0	75	0	0
19	55739813	rs10419308	G	A	31	27	58	0	0	58	0	0
19	55741205	rs3826886	G	A	257	233	490	0	2	492	0	0
19	55742521	rs77084013	T	C	8	2	10	0	0	10	0	0
19	55843654	rs60978141	A	C	15	2	17	0	0	17	0	0
19	55876074	rs1126760	G	A	5	8	13	0	0	13	0	0
19	55876240	rs2298885	C	T	4	4	8	0	1	9	0	0
19	55877111	rs1042506	A	C	4	3	7	0	0	7	0	0
19	55899178	rs11541583	G	C	38	63	101	0	0	102	1	0
19	55899602	rs56312243	C	T	32	23	55	0	1	56	0	0
19	55899940	rs10418020	T	C	4	3	7	0	0	7	0	0
19	55900174	rs118132990	A	C	3	3	6	0	0	6	0	0
19	55900869	rs12981911	A	G	9	5	14	0	0	14	0	0
19	55901099	rs10425596	T	C	6	8	14	0	0	14	0	0
19	55901617	rs11540466	C	T	4	6	10	0	0	10	0	0
19	55902084	rs45494801	T	C	8	9	17	0	0	17	0	0
19	55902150	rs45603534	G	C	5	7	12	0	0	12	0	0
19	55902519	rs45572040	G	C	12	16	28	0	1	29	0	0
19	55902941	rs45448592	G	A	63	41	104	0	1	105	0	0
19	55911465	rs61280119	G	A	4	2	6	0	0	6	0	0
19	55912946	rs61748180	T	G	204	102	306	0	4	310	0	0
19	55964464	rs3170264	T	C	9	7	16	0	1	17	0	0
19	55964554	rs114227024	C	A	18	11	29	0	0	29	0	0
19	55967848	rs11555784	C	T	4	5	9	0	1	10	0	0
19	55994240	rs12981044	C	T	6	8	14	0	0	14	0	0
19	55995272	rs11550705	G	A	49	51	100	0	1	101	0	0
19	55998511	rs7478	T	A	111	89	200	0	2	202	0	0
19	56089219	rs1053817	C	T	95	109	204	0	9	213	0	0
19	56089353	rs2292812	C	T	96	96	192	0	1	193	0	0
19	56090493	rs12974617	A	C	6	4	10	0	0	10	0	0
19	56091437	rs12610510	A	C	14	13	27	0	0	27	0	0
19	56091674	rs34937940	T	C	5	7	12	0	0	12	0	0
19	56091768	rs76516526	G	A	8	2	10	0	1	11	0	0
19	56091782	rs78670840	G	A	8	2	10	0	0	10	0	0
19	56109499	rs75515951	C	T	3	3	6	0	0	6	0	0
19	56121332	rs34318926	C	T	3	6	9	0	0	9	0	0
19	56122852	rs310466	A	C	4	3	7	0	0	7	0	0
19	56124049	rs310464	G	T	6	2	8	0	0	8	0	0
19	56127597	rs3852898	G	A	11	19	30	0	1	31	0	0
19	56132487	rs2292811	A	G	56	53	109	0	2	111	0	0
19	56132661	rs751729	G	A	38	27	65	0	0	65	0	0
19	56146469	rs8108198	G	A	7	6	13	0	0	13	0	0
19	56146924	rs8111497	G	C	3	13	16	0	0	16	0	0
19	56148389	rs485152	G	A	6	2	8	0	0	8	0	0
19	56153868	rs310475	G	A	39	38	77	0	1	78	0	0
19	56154339	rs12981222	C	T	24	24	48	0	0	48	0	0
19	56154545	rs11671023	A	C	217	346	563	0	5	568	0	0
19	56156447	rs11084406	A	G	56	41	97	0	3	100	0	0
19	56177029	rs12982547	T	G	5	7	12	0	0	12	0	0
19	56178559	rs310436	T	C	4	6	10	0	0	10	0	0
19	56181408	rs36092527	T	C	4	2	6	0	0	6	0	0
19	56185250	rs664684	G	A	8	10	18	0	0	18	0	0
19	56185763	rs8791	T	A	324	342	666	0	7	673	0	0
19	56197667	rs3786644	C	T	4	2	6	0	0	6	0	0
19	56204991	rs3786642	C	T	3	3	6	0	0	6	0	0
19	56206876	.	C	T	337	371	708	0	16	725	1	0
19	56211995	rs10419814	C	A	5	8	13	0	0	13	0	0
19	56216940	rs7247619	G	A	7	3	10	0	1	11	0	0
19	56220245	rs2287832	C	G	3	7	10	0	0	10	0	0
19	56222998	rs28527338	C	T	3	4	7	0	0	7	0	0
19	56223486	rs59900917	G	T	5	5	10	0	0	10	0	0
19	56227165	rs11882068	A	G	23	35	58	0	1	59	0	0
19	56273293	rs2019946	G	A	15	0	15	0	0	15	0	0
19	56284507	rs73933348	T	G	9	1	10	0	0	10	0	0
19	56284511	rs112094956	C	G	9	1	10	0	0	10	0	0
19	56284529	.	C	A	10	1	11	0	0	11	0	0
19	56284535	.	A	G	10	1	11	0	0	11	0	0
19	56668436	rs581486	C	A	6	2	8	0	0	8	0	0
19	56668890	rs2637085	G	A	8	2	10	0	0	10	0	0
19	56669628	rs679082	A	G	4	2	6	0	0	6	0	0
19	56671836	rs274154	C	T	58	45	103	0	2	105	0	0
19	56951374	rs7248278	C	T	17	9	26	0	0	26	0	0
19	56953365	.	T	C	5	10	15	0	0	15	0	0
19	56953585	rs3760849	T	C	10	11	21	0	0	21	0	0
19	56953963	rs35914474	G	A	4	6	10	0	0	10	0	0
19	56954103	rs7253217	C	A	7	4	11	0	0	11	0	0
19	57006069	rs3971706	G	A	23	5	28	0	0	29	1	0
19	57006721	rs7253	G	C	15	18	33	0	0	33	0	0
19	57065189	rs145011	T	C	5	6	11	0	0	11	0	0
19	57066013	rs10409531	C	T	11	10	21	0	0	21	0	0
19	57067354	rs12975138	C	T	4	5	9	0	0	9	0	0
19	57068039	rs7258886	C	T	1	7	8	0	0	8	0	0
19	57068749	rs4801174	C	T	4	4	8	0	0	8	0	0
19	57068836	rs1052280	C	T	2	4	6	0	0	6	0	0
19	57068986	rs10405702	G	C	5	4	9	0	0	9	0	0
19	57089050	rs4801177	C	T	4	2	6	0	0	6	0	0
19	57136660	rs113908254	C	T	5	1	6	0	1	7	0	0
19	57864647	.	C	T	9	6	15	0	0	15	0	0
19	58595676	rs10878	G	T	70	55	125	0	0	125	0	0
19	58597405	rs1064267	C	T	4	6	10	0	0	10	0	0
19	58599443	rs34114202	G	A	12	11	23	0	2	25	0	0
19	58599760	rs35358425	T	C	18	12	30	0	0	30	0	0
19	58604114	rs10409388	A	G	3	11	14	0	0	14	0	0
19	58605521	rs12977251	T	C	4	3	7	0	0	7	0	0
19	58605523	rs12975230	A	G	4	3	7	0	0	7	0	0
19	58608592	rs11084533	G	A	5	3	8	0	0	8	0	0
19	58696598	rs157379	T	C	5	2	7	0	0	7	0	0
19	58696697	rs157378	A	G	4	5	9	0	0	9	0	0
19	58696798	rs2124911	A	G	5	7	12	0	1	13	0	0
19	58718269	rs7256349	G	A	47	58	105	0	0	105	0	0
19	58718698	rs11672645	A	G	11	15	26	0	0	26	0	0
19	58720201	rs62116004	G	C	7	3	10	0	1	11	0	0
19	58720992	rs10415286	G	A	16	9	25	0	0	25	0	0
19	58785739	rs379075	G	C	12	14	26	0	0	26	0	0
19	58785900	rs500286	C	T	10	7	17	0	0	17	0	0
19	58786084	rs431093	T	C	5	1	6	0	0	6	0	0
19	58786146	rs448403	T	C	5	2	7	0	0	7	0	0
19	58786176	rs62114183	A	G	1	5	6	0	0	6	0	0
19	58786953	rs1993464	C	T	8	1	9	0	1	10	0	0
19	58790359	rs11666156	C	A	6	5	11	0	0	11	0	0
19	58790784	rs260502	G	A	6	3	9	0	0	9	0	0
19	58791716	rs260499	A	G	3	4	7	0	0	7	0	0
19	58796805	rs8105044	G	C	3	5	8	0	0	8	0	0
19	58806083	rs260471	T	C	79	80	159	0	1	160	0	0
19	58808709	rs931258	A	C	9	12	21	0	1	22	0	0
19	58809007	rs8106692	G	A	23	25	48	0	0	48	0	0
19	58809154	rs8107581	T	G	23	21	44	0	0	44	0	0
19	58809647	rs8107546	G	A	15	14	29	0	1	30	0	0
19	58812530	rs3745140	C	T	63	83	146	0	2	148	0	0
19	58814593	rs28510467	G	A	69	54	123	0	5	128	0	0
19	58826521	rs11084541	T	G	135	66	201	0	0	202	1	0
19	58865857	rs1451	G	C	14	13	27	0	0	27	0	0
19	58866434	rs3830	G	A	10	12	22	0	0	22	0	0
19	58899303	rs4584938	C	G	4	2	6	0	1	7	0	0
19	58899342	rs1529959	A	G	6	2	8	0	0	8	0	0
19	58900337	rs7250889	C	T	26	14	40	0	1	41	0	0
19	58906163	rs2241787	T	C	406	323	729	0	3	732	0	0
19	58914719	rs12608956	C	T	2	4	6	0	0	6	0	0
19	58917068	rs149863732	C	T	4	2	6	0	0	6	0	0
19	58917418	rs10405769	A	G	8	1	9	0	0	9	0	0
19	58917575	rs10406593	G	A	3	5	8	0	0	8	0	0
19	58918405	rs4801583	A	G	4	2	6	0	0	6	0	0
19	58928302	rs10423138	T	C	4	3	7	0	0	7	0	0
19	58928786	rs7257872	A	G	9	3	12	0	0	12	0	0
19	58929052	rs3764535	G	A	6	19	25	0	1	26	0	0
19	58929136	rs3764534	G	A	7	18	25	0	0	25	0	0
19	58929194	rs3764533	A	G	5	10	15	0	1	16	0	0
19	58929305	rs3764531	G	C	14	8	22	0	0	22	0	0
19	58944402	rs1051500	A	G	9	3	12	0	0	12	0	0
19	58978517	rs4801595	G	A	9	6	15	0	0	15	0	0
19	58986799	rs3794968	G	C	12	6	18	0	0	18	0	0
19	58989495	rs893185	A	C	25	20	45	0	1	46	0	0
19	58991479	rs882609	G	A	8	7	15	0	0	15	0	0
19	58991900	rs882610	G	A	31	42	73	0	0	73	0	0
19	59057375	.	C	G	19	25	44	0	0	44	0	0
19	59058083	rs7249714	G	T	57	72	129	0	1	130	0	0
19	59065952	rs873104	T	C	39	17	56	0	1	57	0	0
19	59066391	rs45454797	C	G	87	138	225	0	2	227	0	0
19	59069353	rs3794965	T	C	5	3	8	0	0	8	0	0
19	59079257	rs7248800	A	G	2	4	6	0	0	6	0	0
19	59079334	rs73068327	T	C	1	5	6	0	0	6	0	0
19	59082605	rs3752109	C	T	6	4	10	0	0	10	0	0
19	59085787	.	T	C	4	3	7	0	0	7	0	0
19	59093239	rs10448	T	C	16	13	29	0	0	29	0	0
19	59093464	rs7910	C	T	21	16	37	0	0	37	0	0
19	59093484	rs3499	G	T	25	13	38	0	0	38	0	0
19	59094453	rs3211055	A	C	17	29	46	0	0	46	0	0
19	59094709	rs3752108	C	G	22	18	40	0	0	40	0	0
19	59095126	rs8110595	G	T	31	20	51	0	0	51	0	0
19	59100589	rs3190203	A	G	9	3	12	0	0	12	0	0
2	218386	rs9213	G	A	3	4	7	0	0	7	0	0
2	218476	rs1046207	C	G	20	6	26	0	0	26	0	0
2	272203	rs11553746	C	T	122	151	273	0	0	273	0	0
2	272926	rs12714402	A	G	11	5	16	0	0	16	0	0
2	273621	rs7419262	C	G	9	7	16	0	0	16	0	0
2	274672	rs62114548	C	G	5	8	13	0	1	14	0	0
2	276728	.	A	G	8	11	19	0	0	19	0	0
2	277003	rs79716074	A	G	294	271	565	0	5	571	1	0
2	277314	rs77927634	G	A	348	314	662	0	4	666	0	0
2	672745	rs34848618	T	C	7	3	10	0	0	10	0	0
2	3193040	rs17682	G	A	44	57	101	0	0	101	0	0
2	3383538	rs10176767	C	A	3	6	9	0	0	9	0	0
2	3456506	rs10207406	T	C	0	8	8	0	0	8	0	0
2	6988669	rs13308	T	C	12	12	24	0	0	24	0	0
2	6990720	rs112755306	A	C	3	3	6	0	0	6	0	0
2	6991551	rs79692126	G	A	6	2	8	0	0	8	0	0
2	7037185	rs75387034	C	T	40	18	58	0	0	58	0	0
2	7109981	rs112130473	T	C	11	12	23	0	0	23	0	0
2	7137067	rs364891	A	G	13	6	19	0	0	19	0	0
2	7164578	rs376219	A	G	8	9	17	0	0	17	0	0
2	7167153	rs416416	C	G	4	2	6	0	0	6	0	0
2	7215449	rs1453125	G	A	3	3	6	0	1	7	0	0
2	8871342	rs1044280	C	A	50	67	117	0	0	117	0	0
2	8877042	rs61742863	G	A	39	32	71	0	0	71	0	0
2	8933820	rs73151205	C	T	14	4	18	0	0	18	0	0
2	8938020	rs7602942	C	G	4	6	10	0	0	10	0	0
2	8961158	rs68032361	C	T	5	1	6	0	0	6	0	0
2	9639287	rs143866237	G	A	2	6	8	0	0	8	0	0
2	9665046	rs12692384	T	C	2	7	9	0	0	9	0	0
2	9694620	rs12692385	C	T	3	3	6	0	0	6	0	0
2	9695906	rs12692386	A	G	10	7	17	0	0	17	0	0
2	10044999	rs76120746	C	G	6	3	9	0	0	9	0	0
2	10188649	rs11687357	A	T	18	8	26	0	0	26	0	0
2	10194192	rs4669522	T	C	28	27	55	0	1	56	0	0
2	10194487	rs7632	T	C	57	24	81	0	0	81	0	0
2	10262920	rs1130609	T	G	12	8	20	0	1	21	0	0
2	10338860	rs7560636	G	A	6	3	9	0	0	9	0	0
2	10447635	rs13010136	C	G	4	2	6	0	0	6	0	0
2	10453020	rs369323766	A	G	13	9	22	0	0	22	0	0
2	10454029	rs1989368	C	T	12	8	20	0	1	22	1	0
2	10462787	rs75444592	G	C	5	2	7	0	0	7	0	0
2	10489562	rs55737816	G	C	4	5	9	0	0	9	0	0
2	10489582	rs6729667	G	C	5	3	8	0	0	8	0	0
2	10495745	rs572522394	A	G	4	3	7	0	0	7	0	0
2	10495928	rs1476986	G	A	4	2	6	0	0	6	0	0
2	10498418	rs1974677	C	T	3	6	9	0	1	10	0	0
2	10498736	rs6734890	T	C	6	14	20	0	0	20	0	0
2	10565872	rs13417910	A	G	5	10	15	0	0	15	0	0
2	10567082	rs1042953	A	G	41	42	83	0	3	86	0	0
2	10580967	rs1049500	G	A	228	235	463	0	0	463	0	0
2	10585311	rs2302614	A	C	94	71	165	0	0	165	0	0
2	10711112	rs78463923	G	A	6	3	9	0	0	9	0	0
2	10715720	rs9973572	C	G	1	6	7	0	0	7	0	0
2	10715777	rs12692410	G	A	4	15	19	0	0	19	0	0
2	10715847	rs9973898	G	A	3	15	18	0	1	19	0	0
2	10717806	rs2287059	C	T	83	63	146	0	0	146	0	0
2	10774531	rs77767350	C	T	8	2	10	0	0	10	0	0
2	10924524	rs1198873	T	C	12	12	24	0	0	24	0	0
2	10927038	rs1734436	C	T	6	1	7	0	0	7	0	0
2	10930903	rs4807	T	C	190	154	344	0	2	346	0	0
2	10933249	rs4799	C	T	189	149	338	0	2	340	0	0
2	10942687	rs4758	C	T	93	78	171	0	0	171	0	0
2	11911761	rs11538448	C	T	15	12	27	0	0	27	0	0
2	11924950	rs3795974	T	C	2	4	6	0	0	6	0	0
2	11965342	rs74564998	G	A	31	38	69	0	0	69	0	0
2	11966317	rs11524	T	C	38	36	74	0	2	76	0	0
2	11967003	rs77333662	C	G	89	90	179	0	1	180	0	0
2	15385788	rs72776632	T	C	3	5	8	0	0	8	0	0
2	15601441	rs7590340	C	T	11	12	23	0	0	23	0	0
2	15607842	rs4668909	T	C	6	16	22	0	0	22	0	0
2	15614404	rs13014906	T	C	13	11	24	0	0	24	0	0
2	15615910	rs1990754	A	G	7	13	20	0	0	20	0	0
2	15674267	rs11892720	T	C	2	4	6	0	0	6	0	0
2	15674686	rs13029846	T	C	7	1	8	0	1	9	0	0
2	16786035	rs73918606	G	C	3	3	6	0	0	6	0	0
2	16786036	rs73918607	G	A	3	3	6	0	0	6	0	0
2	17845224	.	T	C	8	5	13	0	0	13	0	0
2	17846162	rs2555107	A	G	5	3	8	0	0	8	0	0
2	17884495	rs1065381	C	T	15	21	36	0	0	36	0	0
2	17897488	rs35195207	T	C	7	8	15	0	2	17	0	0
2	17940098	rs13017989	G	C	4	3	7	0	0	7	0	0
2	17942775	rs1812152	T	A	10	2	12	0	0	12	0	0
2	17962450	rs300168	A	G	19	15	34	0	0	34	0	0
2	17962518	rs300169	C	T	20	11	31	0	1	32	0	0
2	17963123	rs77424145	A	G	20	15	35	0	3	38	0	0
2	17965931	rs300170	G	A	13	9	22	0	0	22	0	0
2	17966421	rs300172	T	G	3	4	7	0	0	7	0	0
2	20235109	rs1016316	T	C	36	29	65	0	2	67	0	0
2	20236305	rs34539547	G	A	9	20	29	0	0	29	0	0
2	20237861	rs3754904	G	A	7	4	11	0	0	11	0	0
2	20240668	rs3731673	C	A	478	344	822	0	4	826	0	0
2	20448561	rs1043419	A	G	31	16	47	0	1	48	0	0
2	20449174	rs1043400	G	A	123	117	240	0	1	241	0	0
2	20464713	rs62123442	T	C	2	5	7	0	0	7	0	0
2	20467490	rs72785300	A	G	8	6	14	0	0	14	0	0
2	20467694	rs72785301	G	A	3	6	9	0	0	9	0	0
2	20470312	rs77602641	A	C	11	11	22	0	0	22	0	0
2	20472030	rs193109277	A	T	2	4	6	0	0	6	0	0
2	20472031	rs17612703	A	T	2	4	6	0	0	6	0	0
2	20472928	rs72787406	T	A	3	4	7	0	0	7	0	0
2	20475446	rs10856797	T	C	5	3	8	0	0	8	0	0
2	20490841	rs917904	T	A	11	5	16	0	0	16	0	0
2	20491321	rs11896241	G	A	19	5	24	0	0	24	0	0
2	20491584	rs3821218	T	C	29	7	36	0	0	36	0	0
2	20521647	rs719148	G	A	1	8	9	0	0	9	0	0
2	20522178	rs140072619	T	C	5	3	8	0	0	8	0	0
2	20647241	rs7043	C	T	35	45	80	0	2	82	0	0
2	20648124	rs112622561	C	T	208	211	419	0	1	420	0	0
2	20648211	rs1062292	G	T	155	128	283	0	2	285	0	0
2	23973799	rs6751857	T	C	13	10	23	0	0	23	0	0
2	24150632	rs13021384	G	A	6	3	9	0	0	9	0	0
2	24163121	rs6729507	T	G	3	4	7	0	0	7	0	0
2	24225621	rs1044277	T	C	15	12	27	0	0	27	0	0
2	24227450	rs4665651	G	A	22	22	44	0	0	44	0	0
2	24227480	rs7422667	T	C	21	17	38	0	0	38	0	0
2	24252417	rs3203	T	C	13	18	31	0	0	31	0	0
2	24252436	rs3204	A	G	11	19	30	0	1	31	0	0
2	24262060	rs3731620	G	A	4	3	7	0	0	7	0	0
2	24291080	rs10194004	A	G	14	10	24	0	0	24	0	0
2	24292353	rs6728930	A	T	3	3	6	0	0	6	0	0
2	24295715	rs13421574	G	T	4	3	7	0	0	7	0	0
2	24300563	rs10209238	T	C	34	17	51	0	1	52	0	0
2	24305512	rs4149372	T	G	4	7	11	0	0	11	0	0
2	24308128	rs10170774	T	C	8	3	11	0	0	11	0	0
2	24308323	rs35781149	C	A	15	13	28	0	0	28	0	0
2	24311700	rs12464159	C	T	3	3	6	0	0	6	0	0
2	24314978	rs6545266	C	T	5	1	6	0	0	6	0	0
2	24318236	rs11886838	C	A	6	2	8	0	0	8	0	0
2	24318343	rs6755030	C	T	4	6	10	0	0	10	0	0
2	24318674	rs13406445	T	C	9	8	17	0	0	17	0	0
2	24318768	rs13415402	G	A	3	4	7	0	0	7	0	0
2	24318837	rs13415416	G	A	5	7	12	0	0	12	0	0
2	24319332	rs7606853	C	T	11	7	18	0	1	19	0	0
2	24319352	rs7567487	A	G	11	7	18	0	0	18	0	0
2	24319450	rs7606989	C	T	13	12	25	0	0	25	0	0
2	24319987	rs12328755	T	C	16	10	26	0	0	26	0	0
2	24320527	rs12472421	A	G	10	11	21	0	0	21	0	0
2	24320649	rs11125422	A	G	17	14	31	0	0	31	0	0
2	24321673	rs13022514	G	A	22	21	43	0	1	44	0	0
2	24321753	rs11897230	A	G	16	18	34	0	0	34	0	0
2	24322033	rs540689115	C	A	24	11	35	0	0	35	0	0
2	24322310	rs12713190	C	T	31	23	54	0	0	54	0	0
2	24322312	rs12713191	G	A	31	22	53	0	1	54	0	0
2	24322341	rs12713192	G	A	34	23	57	0	0	57	0	0
2	24322769	rs12713193	C	T	45	24	69	0	0	69	0	0
2	24322874	rs76995310	T	C	33	21	54	0	0	54	0	0
2	24323106	rs12713195	A	G	43	42	85	0	0	85	0	0
2	24323107	rs12713196	G	A	42	42	84	0	0	84	0	0
2	24323610	rs55816106	T	C	63	68	131	0	0	131	0	0
2	24323885	rs10201331	A	T	73	63	136	0	0	136	0	0
2	24323987	rs10164930	G	A	10	16	26	0	0	26	0	0
2	24347093	rs73920010	A	C	5	2	7	0	0	7	0	0
2	24358001	rs12329297	G	C	34	16	50	0	0	50	0	0
2	24426438	rs112277321	C	G	50	59	109	0	0	109	0	0
2	25045195	rs11691159	C	T	21	16	37	0	0	37	0	0
2	25465720	rs13002567	T	C	5	3	8	0	0	8	0	0
2	25526766	rs72810074	C	A	6	0	6	0	0	6	0	0
2	25655772	rs7583475	T	C	14	7	21	0	0	21	0	0
2	26357916	.	A	G	18	16	34	0	1	35	0	0
2	26358156	rs142787485	A	G	3	4	7	0	0	7	0	0
2	26359128	rs3791730	T	A	7	4	11	0	0	11	0	0
2	26481459	rs35488195	G	A	3	9	12	0	0	12	0	0
2	26482129	rs146134032	A	G	1	6	7	0	0	7	0	0
2	26604939	rs2052938	A	C	3	3	6	0	0	6	0	0
2	26612465	rs62128674	G	A	39	38	77	0	0	77	0	0
2	26615902	rs6739625	G	A	16	7	23	0	1	24	0	0
2	26616356	rs6730112	A	G	11	7	18	0	1	19	0	0
2	26616624	rs3820937	G	C	15	12	27	0	1	28	0	0
2	26617209	rs1127261	A	G	12	7	19	0	1	20	0	0
2	26618543	rs7092	G	A	95	78	173	0	3	176	0	0
2	26692316	rs4665854	T	C	1	10	11	0	1	12	0	0
2	26693967	rs2272072	C	T	0	53	53	0	1	54	0	0
2	26697950	rs4458167	G	A	2	25	27	0	0	27	0	0
2	26698019	rs4427975	G	C	0	25	25	0	0	25	0	0
2	26699126	rs4335905	C	G	1	69	70	0	1	71	0	0
2	26699855	rs2272069	G	C	0	62	62	0	3	65	0	0
2	27002655	rs10193936	G	A	5	5	10	0	0	10	0	0
2	27003021	rs10186142	T	C	11	5	16	0	0	16	0	0
2	27004234	rs7561995	G	A	3	5	8	0	0	8	0	0
2	27004470	rs2384465	G	T	1	7	8	0	4	12	0	0
2	27246285	rs10865456	C	T	5	4	9	0	0	9	0	0
2	27249245	rs3754733	A	G	6	6	12	0	0	12	0	0
2	27258761	rs2304713	C	G	4	3	7	0	0	7	0	0
2	27279013	rs2278593	A	G	6	4	10	0	0	10	0	0
2	27288915	rs1078809	C	T	2	5	7	0	0	7	0	0
2	27291061	rs35874715	A	G	4	3	7	0	0	7	0	0
2	27293150	rs1053609	G	T	19	16	35	0	0	35	0	0
2	27324724	rs2384571	G	C	5	2	7	0	1	8	0	0
2	27324751	rs2384572	G	T	9	2	11	0	0	11	0	0
2	27355991	rs2289358	G	T	9	6	15	0	0	15	0	0
2	27356278	rs2289359	T	C	4	5	9	0	0	9	0	0
2	27530355	rs28364045	G	A	8	5	13	0	0	13	0	0
2	27538863	rs113644818	C	T	3	3	6	0	0	6	0	0
2	27547247	rs76164683	G	C	4	6	10	0	0	10	0	0
2	28113911	rs2305929	A	G	34	32	66	0	2	68	0	0
2	28549350	rs876251	C	A	3	3	6	0	0	6	0	0
2	28560427	rs2136379	C	T	4	2	6	0	0	6	0	0
2	28561757	rs58720304	C	T	4	3	7	0	0	7	0	0
2	28561758	rs55977836	T	C	3	3	6	0	0	6	0	0
2	28614794	rs925255	C	T	1	5	6	0	1	7	0	0
2	28617932	rs62143061	C	T	36	22	58	0	0	58	0	0
2	28618161	rs12473028	G	A	39	25	64	0	2	66	0	0
2	28620088	rs10191282	T	A	12	8	20	0	0	20	0	0
2	28620090	rs35387193	A	T	13	7	20	0	0	20	0	0
2	28620092	rs10188821	A	T	12	7	19	0	1	20	0	0
2	28623047	rs4617998	T	C	5	2	7	0	0	7	0	0
2	28623159	rs1039823	G	A	5	1	6	0	0	6	0	0
2	28624833	rs4666070	A	G	6	5	11	0	0	11	0	0
2	28625133	rs11689770	G	C	8	3	11	0	0	11	0	0
2	28633405	rs183109210	C	T	67	50	117	0	0	117	0	0
2	28633551	rs72775173	C	T	34	23	57	0	0	57	0	0
2	28634324	rs72775176	C	G	54	26	80	0	0	80	0	0
2	28984418	rs1471425	C	A	3	3	6	0	0	6	0	0
2	28990202	rs57110040	C	G	4	2	6	0	0	6	0	0
2	28991262	.	G	C	4	2	6	0	0	6	0	0
2	28994537	rs11895787	G	T	2	5	7	0	0	7	0	0
2	28997936	rs10191120	A	G	3	3	6	0	0	6	0	0
2	29005870	rs3768666	C	T	8	3	11	0	0	11	0	0
2	29007855	rs6725177	C	G	3	5	8	0	0	8	0	0
2	29009049	rs4254466	G	A	9	0	9	0	0	9	0	0
2	29010517	rs2045886	A	G	10	14	24	0	1	25	0	0
2	29012201	rs75000701	C	T	11	11	22	0	0	22	0	0
2	29012431	rs114241479	T	G	6	17	23	0	2	25	0	0
2	29012454	rs145583039	T	C	5	4	9	0	0	9	0	0
2	29012657	rs141190576	G	T	10	17	27	0	0	27	0	0
2	29013005	rs7608105	A	G	42	47	89	0	1	90	0	0
2	29014746	rs13011935	C	T	21	8	29	0	0	29	0	0
2	29015982	rs13018031	G	C	24	35	59	0	0	59	0	0
2	29016019	rs13019397	C	T	30	40	70	0	0	70	0	0
2	29016233	rs56342375	A	C	34	19	53	0	0	53	0	0
2	29020279	rs72784031	A	G	1	5	6	0	0	6	0	0
2	29020360	rs72854739	C	G	6	0	6	0	0	6	0	0
2	29022959	rs11687800	T	C	256	308	564	0	4	568	0	0
2	29023749	rs7475	A	G	235	264	499	0	3	502	0	0
2	29135468	rs6715296	C	G	77	85	162	0	1	163	0	0
2	29137278	rs12714250	G	C	4	2	6	0	0	6	0	0
2	29138167	rs12623400	A	G	4	4	8	0	0	8	0	0
2	29139538	rs150072172	C	T	4	5	9	0	0	9	0	0
2	29139542	rs4456657	A	G	4	4	8	0	0	8	0	0
2	29140021	rs10175980	G	A	7	3	10	0	0	10	0	0
2	29140085	rs7419369	G	A	6	5	11	0	0	11	0	0
2	29140170	rs4464230	A	G	5	5	10	0	0	10	0	0
2	29152456	rs1140697	A	G	183	114	297	0	1	298	0	0
2	29158868	rs7573904	A	T	4	4	8	0	0	8	0	0
2	29161010	rs4233731	G	A	2	8	10	0	0	10	0	0
2	29161763	rs7423095	A	G	8	9	17	0	1	18	0	0
2	29162148	rs62132028	C	T	5	2	7	0	0	7	0	0
2	29162754	rs60848661	A	G	2	4	6	0	0	6	0	0
2	29163159	rs7603749	G	A	7	4	11	0	0	11	0	0
2	29163508	rs145130573	A	G	9	5	14	0	0	14	0	0
2	29169194	rs6745598	A	G	3	5	8	0	0	8	0	0
2	29169612	rs3087649	T	C	200	199	399	0	5	404	0	0
2	29274720	rs895591	A	G	2	5	7	0	0	7	0	0
2	29356567	rs17749904	G	C	4	2	6	0	0	6	0	0
2	30371358	rs7588777	T	C	10	26	36	0	0	36	0	0
2	30376345	rs13017699	A	T	15	17	32	0	0	32	0	0
2	30377884	rs6743004	T	C	7	9	16	0	0	16	0	0
2	30380923	rs7600457	A	G	2	5	7	0	0	7	0	0
2	30381187	rs7603324	A	G	4	4	8	0	0	8	0	0
2	30381505	rs1137288	T	C	575	499	1074	0	3	1077	0	0
2	30381867	rs76886327	T	C	575	497	1072	0	8	1080	0	0
2	30480760	rs2279998	G	C	20	14	34	0	0	34	0	0
2	31135184	rs2288101	G	T	18	29	47	0	0	47	0	0
2	31148071	rs6718262	C	T	1	7	8	0	0	8	0	0
2	31149066	rs17010480	C	T	5	2	7	0	0	7	0	0
2	32168123	rs41280625	C	T	11	14	25	0	0	25	0	0
2	32236970	rs116064914	T	G	4	3	7	0	0	7	0	0
2	32264288	rs62142092	C	T	8	0	8	0	0	8	0	0
2	32379663	rs56272862	A	G	29	38	67	0	0	67	0	0
2	32381109	.	G	T	8	7	15	0	2	17	0	0
2	32393076	rs6716179	C	A	3	4	7	0	0	7	0	0
2	32447718	rs177083	C	T	7	9	16	0	0	16	0	0
2	32531463	.	A	G	10	11	21	0	0	21	0	0
2	32537827	rs427177	C	T	5	9	14	0	0	14	0	0
2	32539236	rs466146	T	G	1	5	6	0	0	6	0	0
2	32541107	rs71446062	A	C	6	1	7	0	1	8	0	0
2	32541115	rs35005972	A	C	5	1	6	0	0	6	0	0
2	32620888	rs10172510	G	A	3	4	7	0	0	7	0	0
2	32646847	rs176413	G	A	11	9	20	0	2	22	0	0
2	32696940	rs148716263	G	T	7	2	9	0	0	9	0	0
2	32713706	rs2366894	A	T	18	23	41	0	0	41	0	0
2	32740138	rs34757266	T	C	25	20	45	0	0	45	0	0
2	32750879	rs2249109	G	A	6	5	11	0	0	11	0	0
2	32753491	rs2710613	A	G	14	10	24	0	0	24	0	0
2	32759643	rs2250217	C	G	2	5	7	0	0	7	0	0
2	32822957	rs2710625	G	A	59	64	123	0	1	124	0	0
2	33174252	rs72866295	C	G	5	5	10	0	0	10	0	0
2	33181875	rs150659	C	T	4	8	12	0	0	12	0	0
2	33182615	rs464977	T	C	4	8	12	0	0	12	0	0
2	33182791	rs72789865	C	T	2	8	10	0	2	12	0	0
2	33400040	rs113632096	G	T	7	0	7	0	0	7	0	0
2	33412077	rs1065324	G	A	3	4	7	0	1	8	0	0
2	33415978	rs17641115	C	T	5	1	6	0	0	6	0	0
2	33447202	rs2290448	C	T	5	5	10	0	0	10	0	0
2	33540248	rs1058840	G	A	9	7	16	0	1	17	0	0
2	33623851	rs3731572	A	G	21	6	27	0	0	27	0	0
2	33624232	rs151061295	T	G	7	14	21	0	0	21	0	0
2	33624279	rs1804505	G	A	12	10	22	0	1	23	0	0
2	33701632	rs17594260	C	T	4	3	7	0	0	7	0	0
2	33717435	rs17013137	A	G	9	13	22	0	0	22	0	0
2	33748716	rs2305572	G	A	2	5	7	0	0	7	0	0
2	36605304	rs4670546	G	A	2	4	6	0	0	6	0	0
2	36605585	rs4670548	A	G	23	18	41	0	0	41	0	0
2	37068428	rs711244	C	T	5	4	9	0	0	9	0	0
2	37075013	rs1861435	T	A	18	6	24	0	0	24	0	0
2	37076498	rs62132520	A	C	76	73	149	0	0	149	0	0
2	37076594	rs62132521	T	C	82	73	155	0	1	156	0	0
2	37225646	rs62133077	T	C	3	5	8	0	0	8	0	0
2	37226299	rs62133078	C	T	6	4	10	0	0	10	0	0
2	37226903	rs4670181	G	C	6	4	10	0	0	10	0	0
2	37227112	rs2372788	G	C	4	5	9	0	0	9	0	0
2	37227198	.	C	T	7	1	8	0	0	8	0	0
2	37227544	rs60572996	A	T	2	4	6	0	0	6	0	0
2	37230728	rs1007823	T	C	39	38	77	0	1	78	0	0
2	37233538	rs2110998	T	C	2	4	6	0	0	6	0	0
2	37241050	rs17020125	G	A	22	40	62	0	0	62	0	0
2	37325510	.	T	G	18	17	35	0	3	38	0	0
2	37325512	.	T	G	12	25	37	0	1	38	0	0
2	37327244	rs1127906	A	G	60	68	128	0	1	129	0	0
2	37327684	rs35978346	A	C	44	37	81	0	1	82	0	0
2	37329049	rs35175701	C	A	22	28	50	0	1	51	0	0
2	37431646	rs1137453	C	G	78	70	148	0	1	149	0	0
2	37434380	rs10198835	C	T	4	3	7	0	0	7	0	0
2	37438993	rs1137437	G	A	220	225	445	0	5	450	0	0
2	37458711	rs3213745	G	A	14	13	27	0	0	27	0	0
2	37477914	rs9318	A	G	18	31	49	0	0	49	0	0
2	37479756	rs10184179	C	T	39	31	70	0	0	70	0	0
2	37487723	rs10176949	G	A	8	4	12	0	0	12	0	0
2	37489796	rs6716123	G	T	6	2	8	0	0	8	0	0
2	37489877	rs3770764	G	A	3	4	7	0	0	7	0	0
2	37491032	rs34819784	G	C	3	3	6	0	0	6	0	0
2	37494591	rs2302650	A	G	20	22	42	0	0	42	0	0
2	37496276	rs2300885	T	C	4	2	6	0	0	6	0	0
2	37518045	rs10177176	G	C	32	18	50	0	0	50	0	0
2	37518447	rs9309004	T	A	3	3	6	0	0	6	0	0
2	37518716	rs11124576	T	C	9	15	24	0	0	24	0	0
2	37519710	rs4581878	T	C	1	5	6	0	0	6	0	0
2	37519768	rs11682607	C	T	6	1	7	0	0	7	0	0
2	37519969	rs11693917	A	G	5	2	7	0	0	7	0	0
2	37545203	rs12616151	T	G	5	6	11	0	0	11	0	0
2	37599896	.	A	C	19	13	32	0	0	32	0	0
2	37870570	rs143978408	T	A	38	53	91	0	3	94	0	0
2	37870731	rs17462775	G	C	60	38	98	0	0	98	0	0
2	37899418	rs9309014	A	G	5	1	6	0	0	6	0	0
2	38537579	rs34873284	T	C	61	70	131	0	2	133	0	0
2	38604351	rs3731847	A	G	19	16	35	0	1	36	0	0
2	38895091	rs13387464	A	G	5	2	7	0	0	7	0	0
2	38916970	rs6741892	A	T	13	18	31	0	0	31	0	0
2	38938923	.	G	A	5	10	15	0	2	17	0	0
2	38956947	rs2272445	A	G	8	11	19	0	0	19	0	0
2	38957450	rs13011311	C	T	1	6	7	0	0	7	0	0
2	38960927	rs3731838	G	A	35	56	91	0	1	92	0	0
2	38960967	rs3112178	G	A	59	34	93	0	0	93	0	0
2	38961409	rs1138974	T	C	30	53	83	0	0	83	0	0
2	38961415	rs1138975	C	T	31	52	83	0	0	83	0	0
2	38977371	rs3112183	C	T	10	7	17	0	0	17	0	0
2	38977402	rs3134630	T	C	9	6	15	0	0	15	0	0
2	38977505	rs3134629	T	C	5	7	12	0	0	12	0	0
2	38978078	rs71439230	G	A	2	4	6	0	0	6	0	0
2	39008949	rs1056104	G	A	6	7	13	0	0	13	0	0
2	39025555	rs1530853	G	A	35	37	72	0	1	73	0	0
2	39032703	rs1979142	G	C	5	1	6	0	0	6	0	0
2	39033590	rs3099968	T	C	3	7	10	0	0	10	0	0
2	39050141	rs3770681	A	C	27	20	47	0	1	48	0	0
2	39082344	rs7598922	T	C	5	5	10	0	0	10	0	0
2	39109558	rs3099950	G	A	14	16	30	0	0	30	0	0
2	39209047	rs1043793	A	G	5	2	7	0	0	7	0	0
2	39212160	rs1059313	G	T	38	32	70	0	0	70	0	0
2	39212637	rs1059310	T	C	16	27	43	0	0	43	0	0
2	39280514	rs145990486	C	G	13	22	35	0	0	35	0	0
2	39281312	rs7604229	C	G	30	33	63	0	0	63	0	0
2	39281730	rs997344	G	C	9	14	23	0	0	23	0	0
2	39282888	rs142826932	A	C	4	2	6	0	0	6	0	0
2	39340789	rs114654067	G	A	4	6	10	0	0	10	0	0
2	39341253	rs10200058	C	T	15	12	27	0	0	27	0	0
2	39342534	rs6419600	A	G	4	4	8	0	0	8	0	0
2	39343183	rs12622969	C	G	3	4	7	0	0	7	0	0
2	39343636	rs148543652	C	T	7	2	9	0	0	9	0	0
2	39343711	rs146492624	C	A	5	2	7	0	0	7	0	0
2	39664659	rs56128332	C	T	7	5	12	0	5	17	0	0
2	39892373	rs12989245	A	C	4	2	6	0	0	6	0	0
2	39892377	rs12712652	C	G	4	2	6	0	0	6	0	0
2	39963561	rs3311	T	A	225	219	444	0	0	444	0	0
2	39963667	rs8265	A	G	178	218	396	0	2	398	0	0
2	39972721	rs962262	C	T	6	7	13	0	0	13	0	0
2	39974442	rs4670956	C	T	3	4	7	0	0	7	0	0
2	39985742	rs6722610	C	T	11	10	21	0	0	21	0	0
2	39987287	rs2373689	C	T	6	4	10	0	0	10	0	0
2	39987398	rs1986876	A	G	13	4	17	0	0	17	0	0
2	39993952	rs12712656	C	G	10	10	20	0	0	20	0	0
2	39995885	rs7590912	C	T	12	9	21	0	0	21	0	0
2	39995908	rs13400213	A	G	11	7	18	0	0	18	0	0
2	39996457	rs13428837	C	T	3	4	7	0	0	7	0	0
2	39999157	rs1548877	T	C	4	2	6	0	0	6	0	0
2	39999806	rs1861258	T	A	9	5	14	0	0	14	0	0
2	40002032	rs7560642	G	T	6	2	8	0	0	8	0	0
2	40005290	rs12470473	T	C	2	7	9	0	0	9	0	0
2	42396722	rs7233	A	G	28	34	62	0	0	62	0	0
2	42508359	rs112828938	C	G	5	2	7	0	0	7	0	0
2	42509829	rs6723361	T	C	8	7	15	0	0	15	0	0
2	42510877	rs9636430	A	G	7	10	17	0	0	17	0	0
2	42511313	rs17317481	T	G	15	16	31	0	0	31	0	0
2	42511627	rs2286704	T	G	11	15	26	0	0	26	0	0
2	42511903	rs6744779	A	G	3	7	10	0	0	10	0	0
2	42512638	rs6544531	T	C	5	6	11	0	1	12	0	0
2	42512931	rs1439225	G	C	6	8	14	0	0	14	0	0
2	42512997	rs1837357	C	A	8	16	24	0	0	24	0	0
2	42513098	rs1439226	A	G	4	7	11	0	0	11	0	0
2	42515437	rs28651764	A	G	52	70	122	0	0	122	0	0
2	42553210	rs2286703	C	A	5	2	7	0	0	7	0	0
2	42564237	rs1123701	T	C	5	1	6	0	0	6	0	0
2	42565581	rs17029598	A	G	3	3	6	0	0	6	0	0
2	42567897	rs35574134	G	C	3	4	7	0	0	7	0	0
2	42571486	rs10183278	C	T	5	4	9	0	1	10	0	0
2	42578149	rs8162	A	G	466	532	998	0	8	1006	0	0
2	42583013	rs10179225	A	G	5	3	8	0	0	8	0	0
2	42583667	rs10206058	G	A	4	2	6	0	0	6	0	0
2	42585179	rs11685888	T	C	5	1	6	0	0	6	0	0
2	42588195	rs3764906	T	C	32	21	53	0	0	53	0	0
2	42989994	rs2278585	G	T	5	4	9	0	0	9	0	0
2	42990010	rs12617777	C	A	6	4	10	0	0	10	0	0
2	42990101	rs2278586	G	C	7	4	11	0	0	11	0	0
2	43015704	rs3816182	T	A	10	11	21	0	0	21	0	0
2	43452183	rs7933	A	G	45	36	81	0	0	81	0	0
2	43452334	rs8098	G	A	241	206	447	0	9	456	0	0
2	43452618	rs11675632	C	T	166	144	310	0	4	314	0	0
2	43452793	rs77160973	C	G	204	205	409	0	2	411	0	0
2	43455967	rs11694674	G	A	1	5	6	0	1	7	0	0
2	43458611	rs13402621	T	C	2	16	18	0	0	18	0	0
2	43460514	rs1549723	C	A	17	15	32	0	1	33	0	0
2	44004010	rs2288709	T	C	27	27	54	0	1	55	0	0
2	44020982	rs76224003	A	G	3	11	14	0	0	14	0	0
2	44027302	rs7594731	G	A	3	5	8	0	1	9	0	0
2	44028013	rs11556157	A	T	22	31	53	0	0	53	0	0
2	44036913	rs8302	T	C	14	25	39	0	0	39	0	0
2	44118189	rs12465555	A	G	3	5	8	0	0	8	0	0
2	44118428	rs12473732	C	T	3	4	7	0	0	7	0	0
2	44123073	rs6720846	A	T	4	3	7	0	0	7	0	0
2	44177948	rs4245798	T	C	6	2	8	0	0	8	0	0
2	44178034	rs4953040	T	C	4	2	6	0	0	6	0	0
2	44178778	rs13415134	C	G	4	8	12	0	0	12	0	0
2	44179347	rs56034148	A	C	4	2	6	0	0	6	0	0
2	44179736	rs11898901	C	T	6	1	7	0	0	7	0	0
2	44181176	rs12477013	C	G	4	2	6	0	0	6	0	0
2	44185129	rs4347883	T	C	6	4	10	0	0	10	0	0
2	44209477	rs6741066	C	T	25	24	49	0	1	50	0	0
2	44396235	rs12712912	T	G	18	11	29	0	0	29	0	0
2	44430769	rs59765221	A	G	7	2	9	0	0	9	0	0
2	44433125	rs77764125	A	C	4	3	7	0	0	7	0	0
2	44437217	rs6730278	G	A	5	2	7	0	0	7	0	0
2	44440117	rs10865199	A	G	5	2	7	0	0	7	0	0
2	44440544	rs4953071	C	T	9	5	14	0	0	14	0	0
2	44440853	rs4952703	T	C	20	16	36	0	1	37	0	0
2	44443079	rs2053458	C	G	16	11	27	0	0	27	0	0
2	44447925	rs72800988	T	C	4	4	8	0	0	8	0	0
2	44450435	rs9973609	T	C	7	9	16	0	0	16	0	0
2	44450524	rs7609313	G	A	5	6	11	0	0	11	0	0
2	44450831	rs111762858	T	G	21	19	40	0	1	41	0	0
2	44452154	rs77048434	T	C	7	5	12	0	0	12	0	0
2	44452344	rs920519	T	C	7	3	10	0	0	10	0	0
2	44459275	rs56203913	C	T	9	10	19	0	0	19	0	0
2	44471409	rs12613956	T	G	9	12	21	0	0	21	0	0
2	44546016	rs8410	C	T	5	1	6	0	0	6	0	0
2	44547574	rs698761	G	A	8	1	9	0	0	9	0	0
2	44547909	rs8886	T	C	3	4	7	0	0	7	0	0
2	44549204	rs2241870	A	G	4	2	6	0	0	6	0	0
2	44628529	rs1067327	C	G	6	2	8	0	0	8	0	0
2	44628605	rs1067326	T	A	4	2	6	0	0	6	0	0
2	45640334	rs3755072	T	C	31	21	52	0	1	53	0	0
2	45759068	rs4952765	G	T	4	4	8	0	0	8	0	0
2	45943966	rs10188091	T	A	5	3	8	0	0	8	0	0
2	46414771	rs10472	C	T	1	5	6	0	0	6	0	0
2	46805908	rs35625984	A	G	5	10	15	0	0	15	0	0
2	46818992	rs17818315	C	T	7	12	19	0	0	19	0	0
2	46839477	rs1824050	T	C	4	4	8	0	0	8	0	0
2	46852033	rs3087822	A	G	6	4	10	0	0	10	0	0
2	46987300	rs3768720	T	G	31	32	63	0	0	63	0	0
2	47225891	rs736377	C	T	4	4	8	0	0	8	0	0
2	47391560	.	G	A	3	3	6	0	1	7	0	0
2	47401264	rs1723483	C	G	2	7	9	0	0	9	0	0
2	47402064	rs1693869	G	C	1	6	7	0	0	7	0	0
2	47403129	rs878665	G	T	2	4	6	0	0	6	0	0
2	48010558	rs1042820	C	A	6	15	21	0	0	21	0	0
2	48013238	rs3136249	G	C	2	4	6	0	0	6	0	0
2	48016896	rs3136272	G	T	4	2	6	0	0	6	0	0
2	48018081	rs1800932	A	G	28	35	63	0	1	64	0	0
2	48023115	rs1800935	T	C	43	81	124	0	0	124	0	0
2	48030177	rs3136348	C	T	7	5	12	0	0	12	0	0
2	48573895	rs79073127	G	C	0	7	7	0	0	7	0	0
2	48577401	.	T	C	7	0	7	0	0	7	0	0
2	48594310	rs10495951	C	G	6	10	16	0	0	16	0	0
2	48594595	rs4344965	C	T	6	4	10	0	0	10	0	0
2	48602252	rs17855177	C	T	15	36	51	0	0	51	0	0
2	48603483	rs6705802	A	C	28	55	83	0	0	83	0	0
2	48604978	rs6718068	C	T	50	96	146	0	0	146	0	0
2	53890268	rs11896043	T	C	6	1	7	0	1	8	0	0
2	53890316	rs111416136	A	C	1	7	8	0	0	8	0	0
2	53890393	rs138947663	T	C	5	3	8	0	0	8	0	0
2	53897251	rs80029529	A	G	13	13	26	0	0	26	0	0
2	53922943	rs11684084	C	G	10	2	12	0	0	12	0	0
2	53928266	rs13382257	A	G	7	7	14	0	0	14	0	0
2	53928638	rs13408425	G	A	4	3	7	0	0	7	0	0
2	53929855	rs3755120	C	T	2	5	7	0	0	7	0	0
2	53932669	rs7601692	T	G	6	3	9	0	0	9	0	0
2	53985412	rs116044648	A	C	4	6	10	0	0	10	0	0
2	53992622	rs36020289	G	C	29	40	69	0	0	69	0	0
2	54039565	rs2287347	C	G	3	3	6	0	0	6	0	0
2	54039813	rs2287348	C	T	4	3	7	0	0	7	0	0
2	54041983	rs2542571	G	T	6	3	9	0	0	9	0	0
2	54044560	rs3861570	G	A	5	2	7	0	0	7	0	0
2	54053872	rs698853	A	G	5	10	15	0	0	15	0	0
2	54053921	rs698854	G	C	7	8	15	0	0	15	0	0
2	54091748	rs11125517	T	C	11	14	25	0	0	25	0	0
2	54092984	rs805379	C	T	53	49	102	0	1	103	0	0
2	54093956	rs1049894	G	A	441	359	800	0	2	803	1	0
2	54094284	rs7608085	C	A	12	8	20	0	0	20	0	0
2	54094421	rs805380	G	C	12	7	19	0	0	19	0	0
2	54095288	rs116777637	A	G	7	4	11	0	0	11	0	0
2	54095450	rs28699646	G	A	5	4	9	0	0	9	0	0
2	54097383	rs28396307	C	T	67	52	119	0	2	121	0	0
2	54119571	rs2068017	C	A	5	1	6	0	0	6	0	0
2	54120820	rs805412	G	A	121	103	224	0	1	225	0	0
2	54121960	rs41536750	C	A	15	14	29	0	1	30	0	0
2	54127041	rs805423	C	T	86	87	173	0	0	173	0	0
2	54130835	rs6756424	A	C	6	0	6	0	0	6	0	0
2	54131093	rs6731217	C	T	15	3	18	0	0	18	0	0
2	54198272	rs111363964	C	G	6	4	10	0	1	11	0	0
2	54200930	rs10168293	G	A	5	7	12	0	0	12	0	0
2	54278543	rs1974771	G	A	2	4	6	0	0	6	0	0
2	54785705	rs12987967	T	C	51	33	84	0	0	84	0	0
2	54855137	rs2971887	T	C	6	1	7	0	0	7	0	0
2	54858664	rs2229503	C	T	122	97	219	0	2	221	0	0
2	54884870	rs966003	C	T	10	4	14	0	0	14	0	0
2	54886605	rs2048370	T	C	4	2	6	0	0	6	0	0
2	54888075	rs17046097	G	A	118	79	197	0	2	199	0	0
2	54888497	rs2941587	C	T	120	71	191	0	1	192	0	0
2	54888533	rs2971879	T	C	88	62	150	0	2	152	0	0
2	54889136	rs2971877	G	A	172	107	279	0	2	281	0	0
2	54889149	rs10528	T	C	181	115	296	0	2	298	0	0
2	54889390	rs1047499	C	T	29	37	66	0	1	67	0	0
2	54891017	rs17046108	G	A	57	54	111	0	1	112	0	0
2	54892663	rs72806653	C	A	37	32	69	0	0	69	0	0
2	54892800	rs2292356	G	A	36	24	60	0	0	60	0	0
2	54892805	rs2292357	G	A	35	25	60	0	0	60	0	0
2	54894043	rs907135	T	C	7	3	10	0	0	10	0	0
2	55016676	.	A	G	9	0	9	0	14	23	0	0
2	55200800	rs2255112	T	G	69	56	125	0	2	127	0	0
2	55201038	rs2255026	C	T	63	29	92	0	2	94	0	0
2	55202649	rs2588522	C	T	24	22	46	0	0	46	0	0
2	55203931	rs2588521	C	G	21	16	37	0	0	37	0	0
2	55204028	rs2580765	A	C	20	22	42	0	0	42	0	0
2	55204165	rs6705519	C	T	19	21	40	0	3	43	0	0
2	55205947	rs6739210	A	G	5	5	10	0	0	10	0	0
2	55207895	rs2919126	C	T	14	16	30	0	1	32	1	0
2	55208419	rs2580767	G	T	3	3	6	0	0	6	0	0
2	55208868	rs2588513	G	A	14	3	17	0	0	17	0	0
2	55209177	rs2588514	G	A	5	10	15	0	0	15	0	0
2	55215825	rs2580771	G	A	7	5	12	0	0	12	0	0
2	55216545	rs2919129	C	A	8	9	17	0	0	17	0	0
2	55218805	rs2580772	G	T	3	4	7	0	0	7	0	0
2	55220960	rs2588517	T	C	3	4	7	0	0	7	0	0
2	55222106	rs10170340	C	T	10	2	12	0	0	12	0	0
2	55222132	rs2580776	G	A	2	9	11	0	0	11	0	0
2	55222680	rs55698303	G	T	4	2	6	0	0	6	0	0
2	55225303	rs72795431	T	C	3	3	6	0	0	6	0	0
2	55277226	rs117465650	C	T	17	33	50	0	0	51	1	0
2	55451633	rs2164714	C	T	4	6	10	0	0	10	0	0
2	55480273	rs7595311	G	A	3	3	6	0	0	6	0	0
2	55516090	rs1045613	C	T	75	53	128	0	0	128	0	0
2	55517491	rs1047948	G	A	45	39	84	0	0	84	0	0
2	55756704	rs13028892	A	G	12	10	22	0	2	24	0	0
2	55757885	rs17369191	T	C	7	5	12	0	0	12	0	0
2	55758653	rs6545505	A	G	8	5	13	0	0	13	0	0
2	55760940	rs4671248	G	T	11	11	22	0	0	22	0	0
2	55771161	rs1045910	A	G	161	126	287	0	1	288	0	0
2	55775069	rs1058582	C	T	4	4	8	0	0	8	0	0
2	55776793	rs3748945	G	A	52	64	116	0	0	116	0	0
2	55796544	rs6716100	A	G	5	1	6	0	0	6	0	0
2	55797231	rs4672055	A	G	19	25	44	0	2	46	0	0
2	55797303	rs4672056	T	C	17	23	40	0	0	40	0	0
2	55797507	rs58003472	T	C	15	18	33	0	0	33	0	0
2	55798108	rs6545506	C	T	11	8	19	0	1	20	0	0
2	55798368	rs7574398	A	C	10	1	11	0	0	11	0	0
2	55798409	rs7574409	A	G	14	2	16	0	0	16	0	0
2	55799991	rs4290693	C	G	4	10	14	0	0	14	0	0
2	55803167	rs1975484	T	A	8	2	10	0	0	10	0	0
2	55805172	rs17798852	A	C	11	3	14	0	0	14	0	0
2	55841640	rs782588	T	C	7	6	13	0	0	13	0	0
2	55842021	rs782589	G	A	9	10	19	0	0	19	0	0
2	55843413	rs782590	C	T	4	8	12	0	0	12	0	0
2	55843638	rs782591	C	T	25	29	54	0	0	54	0	0
2	55843875	rs782592	T	A	18	20	38	0	0	38	0	0
2	55844105	rs782593	C	T	23	13	36	0	1	37	0	0
2	55844445	rs782594	T	C	52	68	120	0	2	122	0	0
2	55845287	rs114476378	G	A	25	13	38	0	0	38	0	0
2	55862440	rs782651	T	C	19	7	26	0	0	26	0	0
2	55862775	rs782652	C	A	6	4	10	0	0	10	0	0
2	55883317	rs2627765	G	T	32	18	50	0	0	50	0	0
2	55898203	rs782633	A	G	5	38	43	0	0	43	0	0
2	55898290	rs782632	C	G	8	33	41	0	0	41	0	0
2	55912120	rs782572	T	C	19	30	49	0	1	50	0	0
2	58316814	rs1051061	A	G	16	18	34	0	0	34	0	0
2	58359680	rs17183100	A	G	6	3	9	0	0	9	0	0
2	58361134	rs12999901	G	A	11	7	18	0	0	18	0	0
2	58387000	rs3732136	C	T	4	4	8	0	0	8	0	0
2	58388696	rs848291	A	G	47	42	89	0	1	90	0	0
2	58390679	rs12624152	T	G	4	5	9	0	0	9	0	0
2	58392490	rs35773188	A	T	5	1	6	0	0	6	0	0
2	58395670	rs13032851	T	C	2	5	7	0	0	7	0	0
2	58396442	rs57267169	G	A	4	4	8	0	0	8	0	0
2	58410972	rs768298	C	T	4	8	12	0	0	12	0	0
2	58412968	rs3755296	A	G	5	2	7	0	0	7	0	0
2	58416115	rs1100188	C	A	4	4	8	0	0	8	0	0
2	58459236	rs149726602	G	C	11	6	17	0	0	17	0	0
2	60686893	.	C	T	4	4	8	0	0	8	0	0
2	60720246	rs11886868	C	T	2	4	6	0	0	6	0	0
2	60731339	rs45611940	G	C	1	5	6	0	0	6	0	0
2	60769455	rs3771270	G	A	38	65	103	0	1	104	0	0
2	60770454	rs6739994	C	T	44	35	79	0	0	79	0	0
2	60774773	rs971563	T	C	5	1	6	0	0	6	0	0
2	61108829	rs67574266	G	A	25	38	63	0	0	63	0	0
2	61108996	rs842650	A	T	3	3	6	0	0	6	0	0
2	61116481	rs842648	A	G	9	2	11	0	0	11	0	0
2	61126625	rs842620	A	T	5	6	11	0	0	11	0	0
2	61128286	.	T	C	7	0	7	0	0	7	0	0
2	61130632	rs842621	C	T	4	3	7	0	0	7	0	0
2	61136129	rs13031237	G	T	4	5	9	0	0	9	0	0
2	61136498	rs842616	A	C	3	4	7	0	0	7	0	0
2	61164331	rs13017599	G	A	3	5	8	0	1	9	0	0
2	61183657	rs11691111	A	G	0	6	6	0	0	6	0	0
2	61183901	rs7587324	A	G	3	3	6	0	0	6	0	0
2	61187784	rs79703662	A	C	2	5	7	0	0	7	0	0
2	61372298	rs3213944	C	G	3	7	10	0	0	10	0	0
2	61404905	rs3821224	C	G	20	13	33	0	0	33	0	0
2	61404931	rs2600667	A	T	21	22	43	0	0	43	0	0
2	61405008	rs746032	C	T	39	49	88	0	1	89	0	0
2	61405723	rs3856521	G	A	32	35	67	0	0	67	0	0
2	61405865	rs3856522	C	G	37	33	70	0	0	70	0	0
2	61414470	rs1059541	C	G	10	11	21	0	0	21	0	0
2	61415492	rs14170	A	G	142	158	300	0	1	301	0	0
2	61416366	rs113183256	G	A	13	15	28	0	0	28	0	0
2	61442075	rs2123112	T	G	3	3	6	0	1	7	0	0
2	61495177	rs6545850	C	T	5	2	7	0	0	7	0	0
2	61495193	rs7564507	G	A	4	2	6	0	0	6	0	0
2	61531549	rs72813523	C	G	1	8	9	0	0	9	0	0
2	61533267	rs7370889	G	A	49	16	65	0	0	65	0	0
2	61533480	rs7369217	A	G	32	29	61	0	0	61	0	0
2	61537167	rs17008217	G	C	2	4	6	0	0	6	0	0
2	61577435	rs2166720	T	C	11	14	25	0	0	25	0	0
2	61582603	rs72813558	A	G	7	3	10	0	0	10	0	0
2	61582717	rs2839831	A	G	3	4	7	0	0	7	0	0
2	61582738	rs34606253	A	C	3	3	6	0	0	6	0	0
2	61595416	rs56412918	A	G	17	16	33	0	1	34	0	0
2	61595504	rs55706607	T	C	12	13	25	0	0	25	0	0
2	61613407	rs2694655	C	G	6	2	8	0	0	8	0	0
2	61617681	rs79279844	A	G	4	9	13	0	0	13	0	0
2	61719945	rs41281521	A	G	4	6	10	0	0	10	0	0
2	61721964	rs35400273	T	G	3	3	6	0	0	6	0	0
2	61765074	rs3087898	G	A	9	7	16	0	1	17	0	0
2	62096197	rs13015363	A	C	14	10	24	0	0	24	0	0
2	62098364	rs66650825	A	G	5	5	10	0	0	10	0	0
2	62098772	rs1534646	T	C	14	13	27	0	0	27	0	0
2	62098993	rs7569315	C	T	8	7	15	0	0	15	0	0
2	62099156	rs3828276	T	C	4	3	7	0	0	7	0	0
2	62103724	rs7587722	C	A	3	6	9	0	0	9	0	0
2	62107108	rs56662583	C	T	4	4	8	0	0	8	0	0
2	62107632	rs2272429	G	A	9	12	21	0	0	21	0	0
2	62107846	rs12466630	A	C	6	9	15	0	0	15	0	0
2	62109359	rs11692374	C	T	1	5	6	0	0	6	0	0
2	62110187	rs189539112	A	G	7	4	11	0	0	11	0	0
2	62110228	rs13390881	T	A	4	5	9	0	0	9	0	0
2	62112222	rs67059162	G	A	6	8	14	0	0	14	0	0
2	62112839	rs10167456	G	A	13	10	23	0	1	24	0	0
2	62113174	rs6714793	T	C	4	11	15	0	0	15	0	0
2	62113679	rs6757672	G	A	6	6	12	0	1	13	0	0
2	62114029	rs12185573	G	C	7	6	13	0	0	13	0	0
2	62362995	rs9096	T	C	34	44	78	0	0	78	0	0
2	62373915	rs9752887	T	C	4	2	6	0	0	6	0	0
2	62448399	rs4672482	A	G	5	1	6	0	0	6	0	0
2	62450727	rs141982185	T	C	254	240	494	0	7	502	1	0
2	63401820	rs61734468	T	C	11	6	17	0	0	17	0	0
2	63826164	rs7591566	C	G	5	2	7	0	0	7	0	0
2	64069311	rs4671534	G	C	11	2	13	0	1	14	0	0
2	64124722	rs11558741	C	A	41	48	89	0	0	89	0	0
2	64161656	rs34200806	T	C	4	3	7	0	0	7	0	0
2	64235312	rs72893103	C	T	5	8	13	0	0	13	0	0
2	64235444	rs12463827	A	C	4	5	9	0	0	9	0	0
2	64324076	rs329499	T	G	9	11	20	0	0	20	0	0
2	64327544	rs329498	G	T	272	261	533	0	2	535	0	0
2	64327592	rs329497	T	C	249	259	508	0	6	514	0	0
2	64334879	rs329481	T	C	8	16	24	0	0	24	0	0
2	64367031	rs6726519	C	T	7	5	12	0	0	12	0	0
2	64685903	.	G	A	7	8	15	0	0	15	0	0
2	64811793	rs6755438	T	G	6	7	13	0	0	13	0	0
2	65245365	rs759458	G	A	11	3	14	0	0	14	0	0
2	65287896	rs2249105	A	G	3	3	6	0	0	6	0	0
2	65296798	rs7572857	G	A	9	6	15	0	0	15	0	0
2	65298839	rs17849707	A	G	27	10	37	0	1	38	0	0
2	65310831	rs1050676	A	T	9	9	18	0	0	18	0	0
2	65311031	rs1050675	A	G	14	10	24	0	0	24	0	0
2	65311438	rs1229	G	A	9	4	13	0	0	13	0	0
2	65311555	rs1228	C	T	2	9	11	0	0	11	0	0
2	65312217	rs4671638	C	T	5	8	13	0	0	13	0	0
2	65313758	rs61758846	G	C	32	12	44	0	1	45	0	0
2	65315880	rs1420184	G	C	72	68	140	0	2	142	0	0
2	65315903	rs1420185	G	A	71	78	149	0	0	149	0	0
2	65317117	rs1055903	G	A	40	35	75	0	1	76	0	0
2	65318807	rs112029776	A	G	9	9	18	0	0	18	0	0
2	65321334	rs180844147	A	T	11	7	18	0	0	18	0	0
2	65322667	.	T	G	9	0	9	0	0	9	0	0
2	65324492	rs6713746	G	C	6	10	16	0	0	16	0	0
2	65432857	rs11887325	T	C	25	0	25	0	1	27	1	0
2	65432952	rs35295972	T	C	25	0	25	0	1	26	0	0
2	65433187	rs34004866	G	A	8	0	8	0	0	8	0	0
2	65455301	rs7566950	C	T	7	4	11	0	0	11	0	0
2	65456245	rs6546137	G	C	7	6	13	0	0	13	0	0
2	65475950	rs268856	C	T	3	3	6	0	0	6	0	0
2	65496075	rs8771	C	T	118	114	232	0	0	232	0	0
2	65497634	rs7246	T	C	160	173	333	0	2	335	0	0
2	65497682	rs13812	A	G	177	165	342	0	1	343	0	0
2	65539087	rs14294	A	G	7	19	26	0	0	26	0	0
2	65539596	rs11548392	G	A	8	16	24	0	0	24	0	0
2	65539641	rs11548393	C	T	5	5	10	0	0	10	0	0
2	65569939	rs10188563	A	G	3	4	7	0	0	7	0	0
2	65570009	rs10165161	G	C	5	4	9	0	0	9	0	0
2	65571139	rs35493937	G	C	6	2	8	0	0	8	0	0
2	66670976	rs1401444	C	A	5	3	8	0	0	8	0	0
2	66671858	rs2049019	C	A	6	2	8	0	1	9	0	0
2	66784219	rs11688578	A	G	4	3	7	0	0	7	0	0
2	66784649	rs2284707	A	C	11	9	20	0	0	20	0	0
2	66784943	rs72824824	G	A	19	20	39	0	2	41	0	0
2	66786405	rs10202912	A	G	6	7	13	0	0	13	0	0
2	66792109	rs12614369	A	G	4	4	8	0	0	8	0	0
2	67629662	rs192768961	T	G	1	8	9	0	0	9	0	0
2	67631831	rs61740794	G	A	76	65	141	0	1	142	0	0
2	68473347	rs115554824	C	T	12	4	16	0	0	16	0	0
2	68611112	rs35052538	A	G	33	18	51	0	0	51	0	0
2	68614232	rs146174820	G	A	45	43	88	0	0	88	0	0
2	68962137	rs10048745	G	A	49	19	68	0	0	68	0	0
2	68976604	rs4068868	G	T	5	7	12	0	0	12	0	0
2	68977254	rs13426364	C	T	4	7	11	0	2	13	0	0
2	68978247	rs72828881	A	G	5	4	9	0	0	9	0	0
2	68979141	rs2280246	A	C	4	8	12	0	0	12	0	0
2	68979302	rs2280244	G	A	8	8	16	0	0	16	0	0
2	68979331	rs2280243	G	T	7	4	11	0	0	11	0	0
2	69002281	rs11685672	C	G	49	52	101	0	1	102	0	0
2	69013007	rs11677065	T	C	6	1	7	0	0	7	0	0
2	69014596	rs2292902	C	T	6	0	6	0	0	6	0	0
2	69017904	rs12477343	G	T	7	3	10	0	0	10	0	0
2	69018157	rs12478131	C	T	5	3	8	0	0	8	0	0
2	69024089	rs4854519	G	T	3	5	8	0	0	8	0	0
2	69025676	rs11126197	C	G	2	7	9	0	0	9	0	0
2	69028585	rs7585846	A	G	7	7	14	0	0	14	0	0
2	69028589	rs7585849	A	G	7	7	14	0	0	14	0	0
2	69028821	rs11889350	G	A	6	7	13	0	0	13	0	0
2	69029215	rs13018928	G	A	8	9	17	0	0	17	0	0
2	69029690	rs6712120	G	C	9	10	19	0	0	19	0	0
2	69029707	rs4854457	T	C	10	12	22	0	1	23	0	0
2	69031128	rs11126199	G	A	4	4	8	0	1	9	0	0
2	69031595	rs10496167	G	A	8	4	12	0	0	12	0	0
2	69031778	rs10187087	C	G	14	7	21	0	0	21	0	0
2	69034042	rs17543981	T	G	35	38	73	0	2	75	0	0
2	69034157	rs12992898	T	C	8	14	22	0	0	22	0	0
2	69043121	rs62133268	G	A	4	3	7	0	0	7	0	0
2	69043695	rs868434	G	A	17	22	39	0	0	39	0	0
2	69046719	rs17036006	G	A	8	1	9	0	0	9	0	0
2	69049941	rs10177248	T	C	221	180	401	0	1	402	0	0
2	69050386	rs10167610	G	A	6	12	18	0	0	18	0	0
2	69050788	rs57966372	G	A	7	5	12	0	0	12	0	0
2	69050937	rs11675470	G	A	8	17	25	0	0	25	0	0
2	69051320	rs7605681	G	A	17	6	23	0	0	23	0	0
2	69051420	rs7579103	A	G	10	9	19	0	0	19	0	0
2	69051602	rs13402713	T	C	7	8	15	0	0	15	0	0
2	69052130	rs11689198	A	G	8	15	23	0	1	24	0	0
2	69052293	rs115458822	G	A	19	16	35	0	0	35	0	0
2	69642572	rs4328678	T	C	11	0	11	0	0	11	0	0
2	69686286	rs7577689	A	G	13	12	25	0	1	26	0	0
2	69687726	rs7581876	A	G	6	2	8	0	0	8	0	0
2	69687731	rs7608459	C	G	6	2	8	0	0	8	0	0
2	69737379	rs11692488	C	T	28	27	55	0	0	55	0	0
2	69737948	rs2002879	G	A	16	9	25	0	0	25	0	0
2	69738093	rs2002878	C	T	6	5	11	0	0	11	0	0
2	69739675	rs4852799	C	T	5	3	8	0	0	8	0	0
2	69740091	rs6752846	C	T	5	1	6	0	0	6	0	0
2	69740227	rs11126233	G	C	9	4	13	0	0	13	0	0
2	69740279	rs11126234	T	G	9	2	11	0	1	12	0	0
2	69740765	rs11126235	C	T	6	0	6	0	0	6	0	0
2	69741609	rs2276689	C	T	7	10	17	0	3	20	0	0
2	70017022	rs6546548	A	G	30	43	73	0	0	73	0	0
2	70017103	rs921712	G	T	10	7	17	0	0	17	0	0
2	70017435	rs7577864	A	G	20	47	67	0	0	67	0	0
2	70017663	rs13388084	C	T	3	6	9	0	0	9	0	0
2	70025988	rs13018194	G	A	6	6	12	0	0	12	0	0
2	70057448	rs3732266	T	G	6	9	15	0	0	15	0	0
2	70068635	rs2872075	G	T	15	4	19	0	0	19	0	0
2	70068642	rs13020991	A	G	14	4	18	0	0	18	0	0
2	70079400	rs12614581	C	G	7	2	9	0	0	9	0	0
2	70079420	.	C	G	8	3	11	0	0	11	0	0
2	70093910	rs60207187	G	A	1	6	7	0	0	7	0	0
2	70106832	rs6747542	T	C	39	43	82	0	0	82	0	0
2	70108256	rs1056482	T	A	69	61	130	0	2	132	0	0
2	70131791	rs1048139	T	A	38	23	61	0	0	61	0	0
2	70131964	rs1048165	A	C	56	45	101	0	23	124	0	0
2	70139001	rs6546556	A	G	6	4	10	0	0	10	0	0
2	70139134	rs7592647	C	T	11	2	13	0	0	13	0	0
2	70140271	rs897122	C	T	17	23	40	0	1	41	0	0
2	70145450	rs6718298	A	C	5	4	9	0	0	9	0	0
2	70146625	rs7419837	T	C	2	9	11	0	0	11	0	0
2	70156321	rs12713683	G	A	4	2	6	0	0	6	0	0
2	70156540	rs6712827	C	G	3	4	7	0	0	7	0	0
2	70160658	rs897119	T	C	4	3	7	0	0	7	0	0
2	70161032	rs6729760	C	T	1	6	7	0	0	7	0	0
2	70162534	rs2228183	T	G	431	415	846	0	3	849	0	0
2	70163316	rs34586537	T	G	7	2	9	0	0	9	0	0
2	70163434	rs11126251	T	G	10	3	13	0	1	14	0	0
2	70164034	rs3771531	T	C	8	4	12	0	0	12	0	0
2	70164277	.	G	T	12	11	23	0	0	23	0	0
2	70167197	rs12475412	C	T	92	56	148	0	17	165	0	0
2	70188676	rs3796097	T	C	0	6	6	0	0	6	0	0
2	70276805	.	C	T	27	24	51	0	1	52	0	0
2	70281190	rs35734267	C	T	2	9	11	0	0	11	0	0
2	70308522	rs6546567	G	T	2	4	6	0	0	6	0	0
2	70379868	rs13429940	T	C	9	5	14	0	0	14	0	0
2	70445399	rs2441356	A	G	8	5	13	0	0	13	0	0
2	70446785	rs2921711	A	C	3	4	7	0	0	7	0	0
2	70455907	rs964392	A	G	11	7	18	0	0	18	0	0
2	70504926	rs62151217	A	G	2	8	10	0	0	10	0	0
2	70504972	rs7595934	G	C	3	8	11	0	0	11	0	0
2	70509158	rs6546583	C	T	6	8	14	0	0	14	0	0
2	70524142	rs14234	A	G	64	64	128	0	0	128	0	0
2	70524577	rs2618235	G	A	69	62	131	0	0	131	0	0
2	70889498	rs17698193	A	G	6	3	9	0	0	9	0	0
2	70889611	rs35480486	C	T	4	4	8	0	0	8	0	0
2	71214173	rs1045525	G	C	51	46	97	0	0	97	0	0
2	71297057	rs888352	C	T	16	13	29	0	0	29	0	0
2	71298269	rs1861854	C	T	14	11	25	0	1	26	0	0
2	71302992	rs1861853	T	A	3	4	7	0	0	7	0	0
2	71305456	rs6713	C	T	110	91	201	0	2	203	0	0
2	71337425	rs7564905	G	A	8	1	9	0	0	9	0	0
2	71339008	rs35004255	C	T	13	4	17	0	0	17	0	0
2	71340154	rs61427984	T	G	6	4	10	0	0	10	0	0
2	71351403	rs6748672	C	A	18	24	42	0	0	42	0	0
2	71351487	rs11541017	G	A	23	15	38	0	0	38	0	0
2	71357634	rs1813348	C	T	7	4	11	0	0	11	0	0
2	71360282	rs13010513	G	A	39	27	66	0	1	67	0	0
2	71429725	rs56871884	T	C	4	5	9	0	0	9	0	0
2	71563549	rs17692517	T	G	4	3	7	0	1	8	0	0
2	71565321	rs13391111	G	A	6	5	11	0	0	11	0	0
2	71567964	rs7589244	A	G	9	2	11	0	0	11	0	0
2	71568206	rs1990774	A	G	4	5	9	0	0	9	0	0
2	71578341	rs7583716	G	T	2	4	6	0	0	6	0	0
2	71597387	rs35959683	A	G	8	2	10	0	0	10	0	0
2	71600614	rs9309451	G	A	4	3	7	0	0	7	0	0
2	71602042	rs1558898	A	G	6	5	11	0	0	11	0	0
2	71602535	rs66793870	A	G	15	15	30	0	1	31	0	0
2	71604358	rs4852779	A	C	0	10	10	0	0	10	0	0
2	71604466	rs17749675	A	C	4	5	9	0	0	9	0	0
2	71605131	rs17749725	A	C	4	3	7	0	0	7	0	0
2	71605145	rs17749748	T	G	3	3	6	0	0	6	0	0
2	71606686	rs10199030	A	G	10	7	17	0	0	17	0	0
2	71606904	rs10175747	C	T	8	3	11	0	0	11	0	0
2	71608806	rs78808224	A	T	1	5	6	0	1	7	0	0
2	71612293	rs7606282	A	G	3	3	6	0	0	6	0	0
2	71614443	rs6717013	G	A	5	1	6	0	1	7	0	0
2	71633275	rs3732233	T	C	13	5	18	0	0	18	0	0
2	71633389	rs6714975	C	T	13	6	19	0	0	19	0	0
2	71657168	rs13032033	G	A	3	3	6	0	0	6	0	0
2	71688136	rs11126332	G	A	3	3	6	0	0	6	0	0
2	71688294	rs11126333	C	T	5	6	11	0	0	11	0	0
2	71688588	rs11898330	G	A	4	3	7	0	1	8	0	0
2	71699827	rs62143760	C	T	5	3	8	0	0	8	0	0
2	71738987	rs34603128	C	T	5	10	15	0	0	15	0	0
2	71740958	rs35392229	T	C	10	10	20	0	0	20	0	0
2	71747923	rs36122356	C	T	7	11	18	0	0	18	0	0
2	71900685	rs7604764	G	A	5	1	6	0	0	6	0	0
2	71900961	rs882973	C	T	4	2	6	0	0	6	0	0
2	71907149	rs10187598	T	C	3	3	6	0	0	6	0	0
2	71907930	rs7558412	G	T	7	0	7	0	0	7	0	0
2	72404853	rs62150118	G	T	2	5	7	0	0	7	0	0
2	73226090	rs12233055	G	A	5	5	10	0	0	10	0	0
2	73450610	rs61755313	G	A	19	13	32	0	0	32	0	0
2	73693466	rs142800387	A	G	6	5	11	0	0	11	0	0
2	73716810	rs3820700	G	A	6	2	8	0	0	8	0	0
2	73828538	rs1052161	G	A	5	10	15	0	0	15	0	0
2	73928098	rs2001490	C	G	5	2	7	0	0	7	0	0
2	73956744	rs13020517	C	T	15	9	24	0	1	25	0	0
2	73956846	rs12713794	A	G	21	7	28	0	1	29	0	0
2	73956881	rs12997568	T	C	17	6	23	0	0	23	0	0
2	73957124	rs7210	A	G	145	162	307	0	3	310	0	0
2	73977609	rs2272178	C	T	6	5	11	0	0	11	0	0
2	74007136	rs2272051	T	C	68	64	132	0	2	134	0	0
2	74056564	rs3813229	A	G	6	6	12	0	0	12	0	0
2	74091327	rs6726010	T	C	9	4	13	0	0	13	0	0
2	74091805	rs3738846	C	T	8	10	18	0	0	18	0	0
2	74093652	rs3813230	T	C	14	14	28	0	0	28	0	0
2	74093682	rs3813231	T	A	14	13	27	0	0	27	0	0
2	74185876	rs4777	A	T	214	238	452	0	3	455	0	0
2	74334462	rs828867	G	A	43	41	84	0	1	85	0	0
2	74348125	rs1667616	T	C	4	3	7	0	0	7	0	0
2	74349288	rs1667613	A	G	2	6	8	0	0	8	0	0
2	74350263	rs1667622	G	A	5	4	9	0	0	9	0	0
2	74385705	rs7562297	G	A	2	4	6	0	0	6	0	0
2	74387226	rs1620482	T	C	4	2	6	0	0	6	0	0
2	74402277	rs1667600	C	T	6	0	6	0	0	6	0	0
2	74433952	rs1723281	C	T	6	11	17	0	0	17	0	0
2	74436721	rs828903	A	G	8	15	23	0	1	24	0	0
2	74439180	rs844169	T	G	6	4	10	0	0	10	0	0
2	74441799	rs12196	A	G	227	209	436	0	2	438	0	0
2	74442407	rs8001	A	G	5	7	12	0	0	12	0	0
2	74442431	rs828853	T	G	3	7	10	0	0	10	0	0
2	74687781	rs61733470	G	A	334	362	696	0	7	703	0	0
2	74692191	rs79181168	C	T	23	11	34	0	0	34	0	0
2	75111435	rs3771752	C	T	6	4	10	0	0	10	0	0
2	75111486	rs3771751	A	G	8	6	14	0	0	14	0	0
2	75111950	rs3755450	G	A	11	7	18	0	0	18	0	0
2	75113572	rs2306806	G	A	1	8	9	0	0	9	0	0
2	75113657	rs2229626	C	T	65	70	135	0	3	138	0	0
2	75113789	rs2229627	C	G	55	53	108	0	0	108	0	0
2	75115108	rs10194657	A	G	55	46	101	0	0	101	0	0
2	75118330	rs943	T	G	62	68	130	0	0	130	0	0
2	75118737	rs3821305	C	T	66	62	128	0	0	128	0	0
2	75118856	rs3732295	T	C	28	9	37	0	1	38	0	0
2	75185856	rs12366	G	T	23	20	43	0	1	45	1	0
2	75882576	rs11847	T	C	17	12	29	0	1	30	0	0
2	75882656	rs1049678	G	A	24	25	49	0	0	49	0	0
2	75885132	rs67970377	A	C	15	7	22	0	1	23	0	0
2	75885322	rs72818738	A	G	12	9	21	0	1	22	0	0
2	75907351	rs6722682	T	C	24	5	29	0	1	30	0	0
2	75915035	rs1803196	C	T	25	19	44	0	0	44	0	0
2	75923413	rs7560262	T	C	10	8	18	0	0	18	0	0
2	75929130	rs3088181	C	A	9	2	11	0	0	11	0	0
2	75929238	rs3088180	C	A	9	4	13	0	1	14	0	0
2	75937801	rs10177030	C	T	2	6	8	0	0	8	0	0
2	84653455	rs72830146	A	G	8	7	15	0	0	15	0	0
2	85534392	rs59059406	T	C	5	8	13	0	1	14	0	0
2	85534567	rs61326180	G	A	8	6	14	0	1	15	0	0
2	85534569	rs73943091	G	A	8	7	15	0	0	15	0	0
2	85534574	rs59653199	T	C	8	8	16	0	0	16	0	0
2	85534950	rs4497880	G	A	6	6	12	0	0	12	0	0
2	85535187	rs4641936	C	T	5	6	11	0	0	11	0	0
2	85537312	rs9248	G	A	14	20	34	0	0	34	0	0
2	85542686	rs7608881	G	C	15	22	37	0	0	37	0	0
2	85542718	rs7608892	G	A	17	20	37	0	1	38	0	0
2	85543064	rs4446071	T	C	21	4	25	0	1	26	0	0
2	85543222	rs4599108	C	T	19	9	28	0	0	28	0	0
2	85545490	rs7428	T	C	562	472	1034	0	7	1041	0	0
2	85546052	rs1053561	A	G	392	352	744	0	8	752	0	0
2	85546192	rs1053560	C	T	384	341	725	0	5	730	0	0
2	85546615	rs1061782	C	T	279	224	503	0	3	506	0	0
2	85546932	rs4832164	A	C	333	294	627	0	1	628	0	0
2	85547376	rs7607284	C	G	274	261	535	0	3	538	0	0
2	85547429	rs4459734	G	T	246	253	499	0	6	505	0	0
2	85547963	rs1554110	C	T	299	286	585	0	1	586	0	0
2	85548639	rs6547611	A	G	204	186	390	0	2	392	0	0
2	85549527	rs3184781	T	C	138	130	268	0	1	269	0	0
2	85549547	rs3184780	C	T	117	126	243	0	1	244	0	0
2	85549868	rs4240199	A	G	22	11	33	0	0	33	0	0
2	85549874	rs3637	A	G	22	12	34	0	0	34	0	0
2	85550396	rs72840063	T	A	12	10	22	0	0	22	0	0
2	85550717	rs76482963	G	T	7	9	16	0	0	16	0	0
2	85551184	rs6547612	C	T	25	14	39	0	0	39	0	0
2	85551696	rs17026212	T	G	16	11	27	0	1	28	0	0
2	85551779	rs2366404	G	A	17	10	27	0	1	28	0	0
2	85553784	rs1044973	C	T	195	174	369	0	2	371	0	0
2	85554080	rs4247303	G	A	151	141	292	0	0	292	0	0
2	85555262	rs10460585	T	G	3	12	15	0	0	15	0	0
2	85555277	rs10460586	G	A	3	10	13	0	1	14	0	0
2	85569877	rs9808566	C	T	25	10	35	0	0	35	0	0
2	85571710	rs4832171	A	G	6	2	8	0	0	8	0	0
2	85572223	rs3755019	A	T	3	12	15	0	0	15	0	0
2	85572227	rs3755018	C	T	3	12	15	0	0	15	0	0
2	85573033	rs908302	G	A	5	3	8	0	0	8	0	0
2	85573049	rs908304	G	A	5	4	9	0	0	9	0	0
2	85584988	rs56352074	T	C	20	10	30	0	0	30	0	0
2	85615287	rs6707822	T	A	4	3	7	0	0	7	0	0
2	85622059	rs6886	T	C	209	298	507	0	3	510	0	0
2	85767866	rs11675092	T	A	7	6	13	0	0	13	0	0
2	85808087	rs72843861	C	T	5	1	6	0	0	6	0	0
2	85856464	rs72846619	G	A	9	9	18	0	0	18	0	0
2	85923936	rs13408224	C	T	5	2	7	0	0	7	0	0
2	85923997	rs34943381	A	G	6	3	9	0	0	9	0	0
2	85924295	rs1561284	C	A	21	2	23	0	1	24	0	0
2	85924384	rs1561285	C	G	15	1	16	0	0	16	0	0
2	85924729	rs11127	C	T	52	14	66	0	1	67	0	0
2	85924899	rs1437742	T	A	17	5	22	0	0	22	0	0
2	85924989	rs1437743	C	T	13	2	15	0	1	16	0	0
2	85925084	rs1437744	G	A	16	5	21	0	0	21	0	0
2	85925386	rs1866141	T	C	13	12	25	0	1	26	0	0
2	85925529	rs4240200	A	G	24	7	31	0	0	31	0	0
2	85925667	rs4240201	G	A	36	5	41	0	1	42	0	0
2	85925680	rs4240202	T	G	36	4	40	0	1	41	0	0
2	85925756	rs7908	C	G	269	44	313	0	1	314	0	0
2	85925848	rs12845	C	G	59	6	65	0	1	66	0	0
2	86668822	rs111226991	C	A	7	6	13	0	0	13	0	0
2	86670200	rs75084119	G	A	19	14	33	0	0	33	0	0
2	86693826	rs34605051	T	C	135	126	261	0	3	264	0	0
2	86705565	rs2292887	T	C	3	5	8	0	0	8	0	0
2	86706188	rs150660157	A	C	7	4	11	0	0	11	0	0
2	86706693	rs59255035	A	G	22	19	41	0	0	41	0	0
2	86706834	rs60717666	G	A	11	9	20	0	0	20	0	0
2	86710359	rs3770058	G	C	27	25	52	0	0	52	0	0
2	86712731	rs72932310	G	C	11	21	32	0	0	32	0	0
2	86712820	rs72932311	A	T	6	25	31	0	0	31	0	0
2	86714277	rs3755002	T	C	6	2	8	0	0	8	0	0
2	86714431	rs56085540	C	T	6	5	11	0	0	11	0	0
2	86715696	rs1518812	C	T	13	17	30	0	0	30	0	0
2	86715894	rs17027265	T	C	9	9	18	0	2	20	0	0
2	86716081	rs61028062	C	A	8	10	18	0	0	18	0	0
2	86717869	rs17027270	G	T	3	4	7	0	0	7	0	0
2	86717927	rs72932316	C	A	3	7	10	0	1	11	0	0
2	86731290	rs1137684	T	C	51	86	137	0	0	137	0	0
2	86731632	.	T	G	41	3	44	0	3	47	0	0
2	86732524	rs3201448	C	T	30	24	54	0	2	56	0	0
2	86732576	rs3731812	A	G	22	19	41	0	0	41	0	0
2	86756381	rs11548929	T	G	92	71	163	0	0	163	0	0
2	86775189	rs10187880	T	C	36	42	78	0	0	78	0	0
2	86775305	.	T	C	54	2	56	0	2	58	0	0
2	86775323	rs56059606	T	A	22	23	45	0	2	47	0	0
2	86776125	rs11890027	G	A	17	12	29	0	2	31	0	0
2	86776139	.	G	A	17	12	29	0	3	32	0	0
2	86776235	rs181394970	C	T	4	4	8	0	0	8	0	0
2	86776240	rs4832299	C	T	3	4	7	0	0	7	0	0
2	86776466	rs4832041	G	A	21	10	31	0	0	31	0	0
2	86776683	rs6710780	G	T	21	23	44	0	3	47	0	0
2	86778105	rs186767932	C	T	15	8	23	0	0	23	0	0
2	86778868	rs72932380	G	C	12	14	26	0	0	28	2	0
2	86780087	rs59613942	A	G	3	10	13	0	1	14	0	0
2	86780540	rs60073472	C	T	4	3	7	0	0	7	0	0
2	86780582	rs59521243	G	A	4	4	8	0	0	8	0	0
2	86782957	rs6750226	T	C	5	5	10	0	0	10	0	0
2	86784081	rs12613282	G	A	5	1	6	0	0	6	0	0
2	86787598	rs56227180	C	T	3	3	6	0	0	6	0	0
2	86789525	rs61465748	T	G	5	3	8	0	0	8	0	0
2	86789596	rs12987172	G	A	3	5	8	0	0	8	0	0
2	86826271	rs56378606	T	C	4	3	7	0	0	7	0	0
2	86829355	rs113374671	C	T	5	14	19	0	0	19	0	0
2	86830514	rs4832304	T	C	6	4	10	0	0	10	0	0
2	86840286	rs4240204	A	G	14	11	25	0	2	27	0	0
2	86840294	rs737463	A	T	14	14	28	0	0	28	0	0
2	86840351	rs737462	C	A	16	13	29	0	0	29	0	0
2	86841069	rs745109	T	A	16	19	35	0	0	35	0	0
2	86841586	rs218059	C	T	13	14	27	0	1	28	0	0
2	86842174	rs4832045	G	A	41	58	99	0	0	99	0	0
2	86843488	rs308903	C	T	10	21	31	0	0	31	0	0
2	86843758	rs308902	C	G	87	89	176	0	0	176	0	0
2	86845509	rs74443614	G	C	62	61	123	0	2	125	0	0
2	86846399	rs56304923	T	C	51	49	100	0	1	101	0	0
2	86847269	rs308900	T	C	46	42	88	0	1	89	0	0
2	86948314	rs2674826	T	C	15	11	26	0	0	26	0	0
2	86979093	rs10186663	G	A	102	96	198	0	1	199	0	0
2	86987771	rs6726451	T	C	8	5	13	0	0	13	0	0
2	86987983	rs6711696	G	C	6	1	7	0	0	7	0	0
2	87002229	rs1193	C	T	210	219	429	0	1	430	0	0
2	87002706	rs13297	G	A	53	63	116	0	0	116	0	0
2	87003028	rs1049457	C	T	63	84	147	0	0	147	0	0
2	87003197	rs1049458	C	G	85	76	161	0	1	162	0	0
2	87003846	rs11547281	C	A	133	126	259	0	2	261	0	0
2	87012073	rs1051386	A	G	16	19	35	0	0	35	0	0
2	87012293	rs3020729	A	G	13	18	31	0	1	32	0	0
2	87016506	rs3020726	A	G	3	3	6	0	0	6	0	0
2	87260509	rs4082931	C	T	10	10	20	0	1	21	0	0
2	87260648	rs4082930	C	T	24	25	49	0	2	51	0	0
2	87276811	rs34148650	T	C	147	153	300	0	0	300	0	0
2	87277202	rs35084227	T	C	11	9	20	0	0	20	0	0
2	87278884	rs10203656	G	A	6	4	10	0	0	10	0	0
2	87279109	rs10205992	C	T	23	13	36	0	0	36	0	0
2	87302879	rs3747651	A	G	6	4	10	0	0	10	0	0
2	87303060	rs62144417	C	G	86	70	156	0	2	158	0	0
2	87755101	rs1262	C	T	436	368	804	0	3	807	0	0
2	87758199	rs13421405	T	A	5	2	7	0	0	7	0	0
2	87781432	rs55943039	A	G	5	2	7	0	0	7	0	0
2	87781442	rs148716323	G	A	5	2	7	0	0	7	0	0
2	87819221	.	T	C	4	10	14	0	0	14	0	0
2	88055705	.	C	G	21	0	21	0	0	21	0	0
2	88055889	.	G	A	136	0	136	0	3	139	0	0
2	88055929	.	A	C	219	0	219	0	1	222	2	0
2	88056000	rs1983317	T	C	245	0	245	0	2	247	0	0
2	88056120	.	A	G	50	0	50	0	2	52	0	0
2	88056128	.	G	A	46	0	46	0	1	47	0	0
2	88056189	.	A	T	34	0	34	0	0	34	0	0
2	88056464	rs1065526	T	C	244	0	244	0	3	247	0	0
2	88105100	.	G	A	41	0	41	0	1	42	0	0
2	88105118	.	T	C	55	0	55	0	1	56	0	0
2	88105272	.	G	A	66	0	66	0	0	66	0	0
2	91805928	.	T	C	12	0	12	0	0	12	0	0
2	91805938	.	A	G	13	0	13	0	0	13	0	0
2	95757556	.	T	C	5	3	8	0	0	8	0	0
2	96080548	rs78833378	T	G	8	5	13	0	0	13	0	0
2	96081230	rs3866290	T	C	2	10	12	0	0	12	0	0
2	96476000	rs113251512	A	G	3	4	7	0	1	8	0	0
2	96480181	rs1043092	G	A	42	30	72	0	0	72	0	0
2	96481071	rs4062989	G	A	17	12	29	0	0	29	0	0
2	96515815	.	T	A	12	0	12	0	0	12	0	0
2	96515840	.	A	T	12	0	12	0	1	13	0	0
2	96516007	.	T	A	16	0	16	0	0	16	0	0
2	96516026	.	A	G	12	0	12	0	0	12	0	0
2	96516050	.	C	T	14	0	14	0	0	14	0	0
2	96516082	.	G	A	18	0	18	0	0	18	0	0
2	96516084	.	A	G	19	0	19	0	0	19	0	0
2	96516096	.	A	G	17	0	17	0	0	17	0	0
2	96516117	.	A	G	16	0	16	0	0	16	0	0
2	96516118	.	G	C	16	0	16	0	0	16	0	0
2	96516125	.	T	C	14	0	14	0	1	15	0	0
2	96523096	rs10211258	T	C	12	12	24	0	0	24	0	0
2	96546352	rs189877528	G	A	30	13	43	0	0	43	0	0
2	96548068	rs11695514	C	T	14	13	27	0	0	27	0	0
2	96563206	rs4907220	A	T	5	1	6	0	0	6	0	0
2	96603068	rs11684258	G	A	4	2	6	0	0	6	0	0
2	96603518	rs59033856	C	G	4	3	7	0	0	7	0	0
2	96685021	rs2969475	A	G	5	5	10	0	0	10	0	0
2	96809331	rs1724120	T	C	242	269	511	0	0	511	0	0
2	96850885	rs4826	T	C	270	303	573	0	8	581	0	0
2	96858914	rs997548	A	G	6	14	20	0	0	20	0	0
2	96859034	rs997547	A	G	81	65	146	0	3	149	0	0
2	96861159	rs2276650	C	G	58	55	113	0	1	114	0	0
2	96914636	rs11551400	T	C	91	74	165	0	2	167	0	0
2	96917588	rs7058	T	G	147	153	300	0	3	303	0	0
2	96919642	rs3852673	C	T	75	79	154	0	0	154	0	0
2	96941820	rs62153036	G	A	9	3	12	0	0	12	0	0
2	97203137	rs749027	A	C	17	10	27	0	0	27	0	0
2	97209159	rs13026942	C	T	17	13	30	0	0	30	0	0
2	97212693	rs2278563	C	T	39	36	75	0	0	75	0	0
2	97212755	rs1011040	T	C	27	33	60	0	1	61	0	0
2	97300105	.	T	C	4	4	8	0	0	8	0	0
2	97528365	rs6758174	T	C	4	8	12	0	0	12	0	0
2	97559759	rs11677797	G	A	16	13	29	0	0	29	0	0
2	97860487	.	T	C	3	31	34	0	0	34	0	0
2	97865041	.	C	A	3	3	6	0	0	6	0	0
2	97874350	.	A	C	5	1	6	0	0	6	0	0
2	97877440	rs35711845	T	C	35	49	84	0	0	84	0	0
2	97877478	.	G	A	38	25	63	0	0	63	0	0
2	97883087	.	A	G	34	6	40	0	2	42	0	0
2	97883094	.	T	G	37	6	43	0	0	43	0	0
2	98191011	.	C	G	4	8	12	0	0	12	0	0
2	98350346	rs895437	C	T	6	10	16	0	0	16	0	0
2	98354511	rs3192177	G	A	32	36	68	0	1	69	0	0
2	98355990	rs11678558	G	A	32	24	56	0	0	56	0	0
2	98372980	rs6875	A	G	44	61	105	0	1	106	0	0
2	98377512	rs2044458	A	T	3	3	6	0	0	6	0	0
2	98389086	rs12712117	C	T	2	4	6	0	0	6	0	0
2	98391887	rs3821053	G	A	6	2	8	0	0	8	0	0
2	98392302	rs17489259	G	A	11	7	18	0	0	18	0	0
2	98409046	rs12995673	G	A	15	19	34	0	1	35	0	0
2	98511611	rs10175129	G	A	5	1	6	0	0	6	0	0
2	98600082	rs10210880	C	A	18	12	30	0	0	30	0	0
2	99232873	rs6711099	T	C	7	13	20	0	0	20	0	0
2	99339122	rs4851150	C	T	6	2	8	0	0	8	0	0
2	99342162	rs1514916	A	T	9	10	19	0	0	19	0	0
2	99929028	rs2141908	A	T	6	6	12	0	1	13	0	0
2	99929391	rs6728936	C	T	4	5	9	0	0	9	0	0
2	99930600	rs72954262	C	T	5	4	9	0	0	9	0	0
2	99930910	rs12475639	A	G	2	5	7	0	0	7	0	0
2	99978048	rs12233086	G	A	126	72	198	0	3	201	0	0
2	99992822	rs7558074	A	C	71	77	148	0	2	150	0	0
2	99995804	rs1376443	T	C	78	62	140	0	1	141	0	0
2	99999882	rs58123905	T	C	5	2	7	0	0	7	0	0
2	100006620	rs10187843	G	T	4	5	9	0	0	9	0	0
2	100016713	rs2290257	G	C	12	8	20	0	1	21	0	0
2	100019496	rs2305354	A	G	25	24	49	0	0	49	0	0
2	100020742	rs6711073	G	A	20	10	30	0	1	31	0	0
2	100021184	rs2290261	A	G	8	10	18	0	0	18	0	0
2	100022270	rs1053544	G	A	14	10	24	0	0	24	0	0
2	100022772	rs717454	T	C	30	30	60	0	0	60	0	0
2	100026940	rs3749087	A	G	4	4	8	0	1	9	0	0
2	100055506	rs3087386	A	G	45	43	88	0	0	88	0	0
2	100165648	rs74906728	C	T	2	5	7	0	0	7	0	0
2	101186088	rs1052117	C	T	43	63	106	0	1	107	0	0
2	101868160	rs13022537	C	T	3	3	6	0	0	6	0	0
2	101869588	rs2272320	G	T	10	5	15	0	2	17	0	0
2	101872281	rs2463235	G	A	2	6	8	0	0	8	0	0
2	101874442	rs6757365	C	T	3	5	8	0	0	8	0	0
2	101877409	rs1554777	G	A	5	3	8	0	0	8	0	0
2	101877936	rs34030592	A	G	3	13	16	0	0	16	0	0
2	101881549	rs3768995	A	T	4	2	6	0	0	6	0	0
2	101881980	rs13015194	T	G	3	5	8	0	0	8	0	0
2	101882244	rs1624668	G	A	4	4	8	0	0	8	0	0
2	101883046	rs1660694	A	G	3	10	13	0	0	13	0	0
2	101885022	rs1192791	C	T	7	2	9	0	0	9	0	0
2	101889306	rs750783	A	G	41	71	112	0	0	112	0	0
2	101891736	rs189471783	C	A	98	83	181	0	0	181	0	0
2	101892105	rs1192808	G	A	46	62	108	0	1	109	0	0
2	101892138	rs13017536	C	T	71	49	120	0	2	122	0	0
2	101897295	rs12612035	A	G	3	3	6	0	0	6	0	0
2	101897325	rs12621632	C	T	4	4	8	0	0	8	0	0
2	101898222	rs1192794	G	A	8	11	19	0	0	19	0	0
2	101901004	rs12712093	T	C	2	7	9	0	0	9	0	0
2	101901049	rs12712094	C	A	3	3	6	0	0	6	0	0
2	101903536	rs1192797	C	T	13	9	22	0	0	22	0	0
2	101904107	rs17020684	C	T	23	13	36	0	0	36	0	0
2	101922187	rs6721662	G	A	1	6	7	0	0	7	0	0
2	101922360	rs12993457	A	G	3	4	7	0	0	7	0	0
2	102018908	rs2175968	A	G	38	34	72	0	1	73	0	0
2	102029548	rs1554070	G	A	15	10	25	0	0	25	0	0
2	102036455	rs7565429	C	T	2	4	6	0	0	6	0	0
2	102079446	rs6705707	T	A	4	3	7	0	0	7	0	0
2	102079525	rs9678978	C	T	17	6	23	0	0	23	0	0
2	102079624	rs11904192	A	C	2	6	8	0	0	8	0	0
2	102079764	rs11904250	A	G	1	7	8	0	0	8	0	0
2	102079769	rs11884069	T	C	1	8	9	0	0	9	0	0
2	102080307	rs11123887	G	T	3	4	7	0	0	7	0	0
2	102080308	rs11123888	C	T	3	4	7	0	0	7	0	0
2	102089738	rs6707298	C	T	4	7	11	0	0	11	0	0
2	102091075	rs6742474	G	A	4	2	6	0	0	6	0	0
2	102472459	rs1139583	A	G	91	101	192	0	12	204	0	0
2	102508146	rs6705975	G	A	47	35	82	0	0	82	0	0
2	102509363	rs112872541	A	T	21	14	35	0	0	35	0	0
2	103332590	rs1051783	T	G	2	5	7	0	0	7	0	0
2	103333230	rs17833879	A	G	4	5	9	0	0	9	0	0
2	103333633	rs111545858	C	T	2	4	6	0	0	6	0	0
2	103333638	rs6725185	G	A	4	2	6	0	0	6	0	0
2	103334969	rs1052431	G	A	13	14	27	0	0	27	0	0
2	103335441	rs33993717	A	G	4	7	11	0	0	11	0	0
2	105882780	rs11685266	C	T	139	138	277	0	0	277	0	0
2	105885961	rs2241797	T	C	92	81	173	0	1	174	0	0
2	105888839	rs2576735	C	T	3	3	6	0	0	6	0	0
2	105889349	rs11676273	G	A	76	69	145	0	0	145	0	0
2	105897261	rs2679833	C	T	2	4	6	0	0	6	0	0
2	105897740	rs1020064	T	G	6	4	10	0	0	10	0	0
2	105897964	rs2576741	T	C	4	6	10	0	0	10	0	0
2	105898822	rs2576742	T	A	4	2	6	0	0	6	0	0
2	105901908	rs3792049	A	C	6	3	9	0	0	9	0	0
2	105992771	rs10193943	T	G	3	4	7	0	0	7	0	0
2	105994498	rs13386004	C	A	3	3	6	0	0	6	0	0
2	105997385	rs10190186	A	G	2	9	11	0	0	11	0	0
2	105997496	rs10178109	C	T	4	12	16	0	0	16	0	0
2	105997966	rs13421905	G	A	4	2	6	0	0	6	0	0
2	105998627	rs6753046	G	A	1	6	7	0	0	7	0	0
2	105999683	rs56307904	C	T	3	5	8	0	0	8	0	0
2	106015412	rs76810592	G	C	11	10	21	0	0	21	0	0
2	106015482	.	T	C	3	3	6	0	0	6	0	0
2	106374026	rs56051993	T	C	4	3	7	0	0	7	0	0
2	106375740	rs12616493	C	T	9	4	13	0	1	14	0	0
2	106376233	rs1114475	T	G	5	7	12	0	1	13	0	0
2	106376569	rs1114882	A	G	7	3	10	0	0	10	0	0
2	106377839	rs72823399	A	G	6	8	14	0	0	14	0	0
2	106378341	rs4851843	T	C	2	6	8	0	0	8	0	0
2	106378488	rs4851844	C	A	7	6	13	0	0	13	0	0
2	106378613	rs4851845	A	C	8	10	18	0	0	18	0	0
2	106510184	rs62148194	C	T	25	22	47	0	1	48	0	0
2	109071974	rs10865019	C	T	0	7	7	0	0	7	0	0
2	109090111	rs2718704	G	A	3	3	6	0	0	6	0	0
2	109091479	rs6719131	C	G	43	70	113	0	0	113	0	0
2	109091555	rs1053027	G	C	47	87	134	0	1	135	0	0
2	109092513	.	T	C	7	0	7	0	0	7	0	0
2	109102491	rs12619704	C	A	4	3	7	0	0	7	0	0
2	109106381	rs12104502	A	G	34	47	81	0	1	82	0	0
2	109115192	rs2953736	A	G	7	0	7	0	0	7	0	0
2	109124356	rs13386343	C	A	53	48	101	0	0	101	0	0
2	109124777	rs13082	A	G	8	1	9	0	0	9	0	0
2	109125793	rs143276373	T	C	4	4	8	0	0	8	0	0
2	111144360	.	G	A	4	3	7	0	0	7	0	0
2	111877104	rs56952027	C	T	2	5	7	0	0	7	0	0
2	111884418	rs137973786	G	A	8	6	14	0	0	14	0	0
2	111886332	rs13429049	C	T	28	19	47	0	0	47	0	0
2	111907691	rs724710	T	C	27	29	56	0	1	57	0	0
2	111920741	rs3827536	G	T	4	3	7	0	0	7	0	0
2	111923630	rs6753785	T	G	28	34	62	0	0	62	0	0
2	112227415	rs11673866	A	T	12	4	16	0	0	16	0	0
2	112227580	rs11675353	T	C	8	4	12	0	0	12	0	0
2	112228048	.	G	T	5	3	8	0	0	8	0	0
2	112237612	rs55690911	C	T	6	7	13	0	0	14	1	0
2	112268285	rs1448203	T	C	16	12	28	0	0	28	0	0
2	112268440	rs62162286	A	C	15	15	30	0	0	30	0	0
2	112526866	rs1044864	G	A	41	71	112	0	1	113	0	0
2	112552427	rs56780932	C	T	19	23	42	0	0	42	0	0
2	112637277	rs10178836	G	A	1	5	6	0	0	6	0	0
2	112637700	rs11692140	C	A	3	5	8	0	0	8	0	0
2	112637867	rs13000524	T	G	6	4	10	0	0	10	0	0
2	112686988	rs13027171	G	A	7	10	17	0	0	17	0	0
2	112751928	rs7604639	G	A	11	9	20	0	0	20	0	0
2	112754943	rs3811634	C	T	11	8	19	0	0	19	0	0
2	112755001	rs2230515	A	G	7	9	16	0	0	16	0	0
2	112763640	rs7583987	C	G	2	6	8	0	0	8	0	0
2	112763710	rs4511729	T	C	2	6	8	0	0	8	0	0
2	112765973	rs1131244	A	G	27	25	52	0	0	52	0	0
2	112776726	rs3811638	A	G	3	3	6	0	0	6	0	0
2	112777853	rs13025651	A	G	4	2	6	0	0	6	0	0
2	112785775	rs4848958	T	C	3	3	6	0	0	6	0	0
2	112876039	rs75229801	T	C	23	36	59	0	1	60	0	0
2	113089267	rs7601200	T	C	2	4	6	0	0	6	0	0
2	113145814	.	C	T	7	24	31	0	0	31	0	0
2	113147159	.	G	A	24	0	24	0	0	24	0	0
2	113147238	.	A	G	6	0	6	0	0	6	0	0
2	113166279	.	C	T	7	4	11	0	0	11	0	0
2	113168506	.	C	T	5	5	10	0	1	11	0	0
2	113168799	.	A	G	5	6	11	0	1	12	0	0
2	113240917	rs11891971	G	C	15	18	33	0	0	33	0	0
2	113312117	rs11689338	A	G	4	7	11	0	0	11	0	0
2	113334178	rs66487864	A	T	8	7	15	0	2	17	0	0
2	113334357	rs7578724	G	A	17	18	35	0	0	35	0	0
2	113342682	rs719667	C	T	4	2	6	0	0	6	0	0
2	113371982	rs35743012	T	A	2	4	6	0	0	6	0	0
2	113404708	rs4849091	G	A	39	32	71	0	0	71	0	0
2	113409837	rs1053652	G	C	4	5	9	0	0	9	0	0
2	113410015	rs10758	A	G	4	3	7	0	0	7	0	0
2	113412003	rs10184339	C	T	9	7	16	0	0	16	0	0
2	113414986	rs3827758	A	G	23	27	50	0	0	50	0	0
2	113417501	rs62159880	G	A	3	6	9	0	0	9	0	0
2	113417579	rs58662040	G	A	8	2	10	0	0	10	0	0
2	113494520	rs4261731	T	C	14	6	20	0	1	21	0	0
2	113494529	rs10203064	A	C	11	8	19	0	0	19	0	0
2	113498566	rs3811040	A	G	5	9	14	0	0	14	0	0
2	113499249	rs6753803	C	T	1	5	6	0	0	6	0	0
2	113520129	rs36093393	G	A	9	10	19	0	1	20	0	0
2	113587433	rs1071676	C	G	80	61	141	0	0	141	0	0
2	113588302	rs1143643	C	T	5	2	7	0	0	7	0	0
2	113589333	rs1143637	C	T	3	6	9	0	0	9	0	0
2	113590390	rs1143634	G	A	111	107	218	0	1	219	0	0
2	113590467	rs1143633	C	T	7	10	17	0	1	18	0	0
2	113890284	rs45507693	G	A	42	28	70	0	1	71	0	0
2	113890304	rs315952	T	C	42	29	71	0	0	71	0	0
2	113890586	rs315951	C	G	40	33	73	0	0	73	0	0
2	113940681	rs3748914	T	C	6	17	23	0	0	23	0	0
2	113940839	rs4849167	G	C	9	14	23	0	2	25	0	0
2	113942903	rs1975535	A	C	7	3	10	0	0	10	0	0
2	113943470	rs2241976	A	G	13	18	31	0	0	31	0	0
2	113944460	rs4849168	A	C	3	4	7	0	0	7	0	0
2	113945455	rs3791337	T	C	5	3	8	0	0	8	0	0
2	113945695	rs3791338	C	A	6	1	7	0	0	7	0	0
2	113945902	rs12614146	C	T	7	1	8	0	0	8	0	0
2	113948915	rs10469812	C	T	5	1	6	0	0	6	0	0
2	113954006	rs2241978	A	G	2	4	6	0	0	6	0	0
2	113956371	rs2276561	G	C	11	9	20	0	1	21	0	0
2	113962071	rs3811059	C	T	6	11	17	0	0	17	0	0
2	113975110	rs1049137	A	G	7	0	7	0	0	7	0	0
2	113993344	rs7589901	A	C	12	0	12	0	1	13	0	0
2	113993385	rs7576384	C	G	15	0	15	0	0	15	0	0
2	113994417	rs1110839	G	T	0	20	20	0	0	20	0	0
2	113994461	rs3738913	G	A	14	0	14	0	0	14	0	0
2	113995668	rs6734596	C	T	0	9	9	0	0	9	0	0
2	113995934	rs3762497	G	A	32	0	32	0	0	32	0	0
2	113996339	rs35920363	T	C	33	0	33	0	0	33	0	0
2	113996888	rs1139015	A	G	45	0	45	0	0	45	0	0
2	114342442	.	C	A	4	3	7	0	0	7	0	0
2	114342646	.	C	A	3	3	6	0	0	6	0	0
2	114342677	.	G	A	4	4	8	0	0	8	0	0
2	114342688	.	C	G	5	3	8	0	0	8	0	0
2	114342778	.	C	G	6	5	11	0	0	11	0	0
2	114342918	.	A	G	5	6	11	0	0	11	0	0
2	114342946	.	G	C	4	5	9	0	0	9	0	0
2	114343971	.	T	C	4	5	9	0	0	9	0	0
2	114343984	.	C	A	4	6	10	0	0	10	0	0
2	114343989	.	C	T	9	2	11	0	0	11	0	0
2	114343997	.	T	C	5	3	8	0	0	8	0	0
2	114344007	.	C	T	6	1	7	0	0	7	0	0
2	114345004	.	T	C	7	0	7	0	0	7	0	0
2	114345026	.	A	G	7	0	7	0	0	7	0	0
2	114345645	.	G	A	6	2	8	0	0	8	0	0
2	114345654	rs4849245	G	A	4	3	7	0	0	7	0	0
2	114345790	.	A	G	7	1	8	0	0	8	0	0
2	114345865	rs7355563	C	G	9	3	12	0	0	12	0	0
2	114345906	.	C	T	8	7	15	0	0	15	0	0
2	114345934	.	G	A	12	2	14	0	0	14	0	0
2	114346567	.	G	A	6	2	8	0	0	8	0	0
2	114346873	.	C	T	13	0	13	0	0	13	0	0
2	114346904	.	T	A	7	0	7	0	0	7	0	0
2	114346919	.	G	T	7	0	7	0	0	7	0	0
2	114347577	rs2900687	T	C	17	8	25	0	0	25	0	0
2	114349085	.	C	T	11	1	12	0	0	12	0	0
2	114349178	.	G	A	7	2	9	0	0	9	0	0
2	114349556	.	A	T	13	8	21	0	1	22	0	0
2	114349599	.	C	T	17	3	20	0	0	20	0	0
2	114349866	.	T	C	9	6	15	0	0	15	0	0
2	114349993	.	C	G	12	3	15	0	0	15	0	0
2	114350009	.	C	T	9	2	11	0	0	11	0	0
2	114350020	.	T	C	6	5	11	0	0	11	0	0
2	114350105	.	T	G	16	5	21	0	0	21	0	0
2	114350276	.	G	A	6	6	12	0	0	12	0	0
2	114351244	.	A	G	16	5	21	0	0	21	0	0
2	114352071	rs420746	T	C	27	4	31	0	0	31	0	0
2	114352750	.	G	C	9	4	13	0	0	13	0	0
2	114352806	rs2974807	T	C	11	7	18	0	1	19	0	0
2	114352820	.	C	T	12	6	18	0	0	18	0	0
2	114353351	rs11691138	C	T	33	15	48	0	2	50	0	0
2	114354918	.	T	C	18	5	23	0	1	24	0	0
2	114355307	.	A	C	6	3	9	0	0	9	0	0
2	114356066	.	G	A	73	10	83	0	2	85	0	0
2	114356239	rs11490622	T	C	152	116	268	0	4	272	0	0
2	114357350	rs67465876	T	C	2	14	16	0	1	17	0	0
2	114460517	rs7586800	T	C	13	9	22	0	0	22	0	0
2	114461377	rs7590375	T	C	6	11	17	0	0	17	0	0
2	114461550	rs7599741	G	T	2	4	6	0	0	6	0	0
2	114461585	rs7599832	G	A	4	2	6	0	0	6	0	0
2	114462814	rs11685171	G	A	8	1	9	0	1	10	0	0
2	114466193	rs58473055	G	T	7	14	21	0	0	21	0	0
2	114466994	rs935644	T	C	8	7	15	0	0	15	0	0
2	114467550	rs72833634	G	A	7	6	13	0	0	13	0	0
2	114469135	rs6731402	C	G	3	3	6	0	0	6	0	0
2	114471061	rs2290107	T	C	5	8	13	0	0	13	0	0
2	114488241	rs73955058	C	T	4	4	8	0	0	8	0	0
2	114488711	rs62170065	A	G	3	4	7	0	0	7	0	0
2	114499605	rs13029093	A	C	12	5	17	0	0	17	0	0
2	114500131	rs13004622	C	A	7	5	12	0	0	12	0	0
2	114513901	rs4321376	C	T	1	6	7	0	0	7	0	0
2	115902495	rs13549	T	A	5	3	8	0	0	8	0	0
2	116600388	rs72830516	A	G	4	3	7	0	0	7	0	0
2	116601631	rs272008	C	T	1	5	6	0	0	6	0	0
2	118673663	rs1046330	T	C	86	77	163	0	1	164	0	0
2	118675578	rs12711888	C	T	38	38	76	0	0	76	0	0
2	118675743	rs11123466	G	A	40	32	72	0	0	72	0	0
2	118676429	rs11556267	C	T	20	23	43	0	0	43	0	0
2	118676836	rs1863040	T	C	17	23	40	0	0	40	0	0
2	118677500	.	G	A	24	27	51	0	0	51	0	0
2	118695432	rs1541715	G	A	3	3	6	0	0	6	0	0
2	118708813	rs3771941	C	T	6	5	11	0	0	11	0	0
2	118708850	rs3771942	C	G	7	10	17	0	0	17	0	0
2	118859556	rs10490625	G	A	2	4	6	0	0	6	0	0
2	120022390	.	G	C	2	5	7	0	0	7	0	0
2	120059988	rs1890	T	C	2	5	7	0	1	8	0	0
2	120060082	rs1052500	T	C	8	9	17	0	0	17	0	0
2	120078778	rs1132267	T	C	7	5	12	0	0	12	0	0
2	120125053	rs3731608	C	G	3	3	6	0	0	6	0	0
2	120125058	rs3731607	C	T	4	2	6	0	1	7	0	0
2	120438515	rs11684353	G	C	4	2	6	0	0	6	0	0
2	120438523	rs13011768	A	G	2	4	6	0	0	6	0	0
2	120439230	rs1983406	C	G	7	3	10	0	1	11	0	0
2	121026582	rs11688038	A	G	3	8	11	0	0	11	0	0
2	121976519	rs6541771	G	A	11	3	14	0	0	14	0	0
2	121976642	rs17794420	G	A	5	6	11	0	1	12	0	0
2	121977438	rs17006183	G	A	3	3	6	0	0	6	0	0
2	121981210	rs10200387	G	A	2	4	6	0	0	6	0	0
2	121981950	rs11890430	A	G	6	2	8	0	0	8	0	0
2	122134309	rs74782141	C	G	7	5	12	0	0	12	0	0
2	122134755	rs34660850	A	C	5	6	11	0	0	11	0	0
2	122156521	rs7569666	A	G	3	3	6	0	0	6	0	0
2	122159694	rs12614362	T	C	2	6	8	0	0	8	0	0
2	122216419	rs2304560	A	G	26	17	43	0	0	43	0	0
2	122275310	rs76971393	C	G	3	5	8	0	0	8	0	0
2	122288029	rs2289192	T	C	2	5	7	0	0	7	0	0
2	122288656	rs9678017	A	G	4	3	7	0	0	7	0	0
2	122302563	rs2312588	T	C	5	1	6	0	0	6	0	0
2	122317470	rs10173575	T	C	2	8	10	0	0	10	0	0
2	122318184	rs10208901	C	T	6	2	8	0	0	8	0	0
2	122318322	rs10176760	T	C	3	5	8	0	0	8	0	0
2	122408085	rs3738917	T	C	1	10	11	0	0	11	0	0
2	122484839	.	A	G	61	76	137	0	2	139	0	0
2	127414593	rs13008888	G	C	3	4	7	0	0	7	0	0
2	127414661	rs6729097	C	T	2	5	7	0	0	7	0	0
2	127434767	rs28387155	G	C	4	2	6	0	0	6	0	0
2	127439216	rs28387174	A	T	11	9	20	0	0	20	0	0
2	127439981	rs2099734	T	C	5	5	10	0	0	10	0	0
2	127440273	rs9646710	A	G	11	7	18	0	0	18	0	0
2	127445822	rs6713073	C	G	5	3	8	0	0	8	0	0
2	127446220	rs2018638	G	A	9	7	16	0	0	16	0	0
2	127446489	rs935019	A	G	4	6	10	0	0	10	0	0
2	127446529	rs28647563	G	A	2	12	14	0	0	14	0	0
2	127446937	rs730664	C	T	1	7	8	0	0	8	0	0
2	127447379	.	A	G	12	6	18	0	0	18	0	0
2	127447475	rs28369995	T	C	6	9	15	0	0	15	0	0
2	127448415	rs74499727	C	T	2	6	8	0	1	9	0	0
2	127448802	.	C	T	17	12	29	0	0	29	0	0
2	127449447	.	C	G	2	5	7	0	0	7	0	0
2	127454230	rs6568	T	G	114	103	217	0	0	217	0	0
2	127807019	rs3768865	A	G	3	4	7	0	0	7	0	0
2	127814781	rs3754618	G	A	4	4	8	0	0	8	0	0
2	128259569	.	G	T	5	1	6	0	0	6	0	0
2	128458958	rs6713423	A	G	46	34	80	0	0	80	0	0
2	128459039	rs1048211	A	G	19	8	27	0	1	28	0	0
2	128459214	rs10206957	C	G	2	5	7	0	0	7	0	0
2	128461524	rs7584783	G	T	12	13	25	0	0	25	0	0
2	128461556	rs7575478	A	G	12	13	25	0	0	25	0	0
2	128495645	rs6754215	G	A	3	4	7	0	0	7	0	0
2	128528508	rs55916728	C	T	20	33	53	0	0	53	0	0
2	128562813	rs7578247	A	G	7	2	9	0	0	9	0	0
2	128601490	rs11688522	T	C	21	14	35	0	0	35	0	0
2	128601602	rs12692069	T	C	21	12	33	0	1	34	0	0
2	128602341	rs6746537	T	C	15	8	23	0	0	23	0	0
2	128603026	rs71420810	C	T	5	3	8	0	0	8	0	0
2	128604232	rs1061056	A	T	9	10	19	0	0	19	0	0
2	128608290	rs6713679	T	C	3	8	11	0	0	11	0	0
2	128608384	rs34706819	G	T	5	3	8	0	0	8	0	0
2	128620372	rs2261682	T	C	29	38	67	0	0	67	0	0
2	128621094	rs1045832	A	G	44	42	86	0	0	86	0	0
2	128622491	rs13411546	G	A	48	37	85	0	0	85	0	0
2	128629552	rs7584140	A	C	4	4	8	0	0	8	0	0
2	128736686	rs6707284	T	C	1	6	7	0	0	7	0	0
2	128948226	rs34362305	C	T	14	22	36	0	0	36	0	0
2	129035892	rs4662786	T	C	5	5	10	0	0	10	0	0
2	129035977	rs4662787	C	T	8	6	14	0	0	14	0	0
2	129040076	rs4662599	C	T	4	2	6	0	0	6	0	0
2	129040160	rs4662788	G	A	2	4	6	0	0	6	0	0
2	129075961	rs1133923	T	C	10	2	12	0	0	12	0	0
2	130909081	rs139458844	C	A	163	2	165	0	9	174	0	0
2	130909819	rs3192417	G	C	182	178	360	0	0	360	0	0
2	130909882	rs3192414	C	G	220	233	453	0	1	454	0	0
2	130910847	rs4511676	G	A	6	6	12	0	0	12	0	0
2	130912514	rs10928960	A	G	7	8	15	0	0	15	0	0
2	130913460	rs11679878	C	T	5	10	15	0	0	15	0	0
2	130914655	rs13024697	G	A	3	8	11	0	0	11	0	0
2	130914797	.	T	C	4	6	10	0	0	10	0	0
2	130916286	rs11684431	C	T	33	28	61	0	0	61	0	0
2	130916415	rs2084784	A	G	32	16	48	0	0	48	0	0
2	130918026	rs3990508	G	A	24	21	45	0	0	45	0	0
2	130918458	rs13427291	A	G	13	10	23	0	0	23	0	0
2	130919226	rs34463896	C	T	8	7	15	0	0	15	0	0
2	130919308	rs13411684	A	G	8	9	17	0	0	17	0	0
2	130920763	rs12620443	A	G	4	3	7	0	1	8	0	0
2	130920774	rs10198100	A	G	5	3	8	0	0	8	0	0
2	130925088	rs10909567	C	T	61	87	148	0	2	150	0	0
2	130930819	rs2290295	C	T	2	7	9	0	0	9	0	0
2	130932371	rs111636541	C	A	3	5	8	0	0	8	0	0
2	130939288	rs1968676	A	G	12	10	22	0	0	22	0	0
2	130939348	rs1817097	G	A	12	8	20	0	0	20	0	0
2	130940090	rs1968675	G	T	8	18	26	0	1	27	0	0
2	130941820	rs3748890	A	G	2	4	6	0	0	6	0	0
2	130942136	rs114155192	C	T	3	6	9	0	0	9	0	0
2	130943513	rs10198499	T	C	0	11	11	0	0	11	0	0
2	130943563	rs10200780	T	C	1	6	7	0	0	7	0	0
2	130944088	rs114592060	G	A	7	4	11	0	0	11	0	0
2	130944625	rs74466671	T	C	7	3	10	0	0	10	0	0
2	130944634	rs76995463	G	C	7	3	10	0	0	10	0	0
2	130944652	rs113906323	G	C	7	2	9	0	0	9	0	0
2	130946937	rs10211127	T	G	5	3	8	0	0	8	0	0
2	130947037	rs13029827	A	G	6	4	10	0	0	10	0	0
2	130947167	rs10211408	T	G	5	3	8	0	0	8	0	0
2	130947652	rs3856376	G	T	8	2	10	0	0	10	0	0
2	130947848	rs3856377	C	T	8	6	14	0	0	14	0	0
2	130947887	rs1975671	G	C	9	4	13	0	0	13	0	0
2	131100496	rs11542416	G	A	13	6	19	0	1	20	0	0
2	131100734	rs11542411	G	A	34	48	82	0	0	82	0	0
2	131102538	rs2292850	A	C	12	4	16	0	0	16	0	0
2	131104524	rs55872863	G	A	34	44	78	0	3	81	0	0
2	131849413	rs76031068	T	A	13	2	15	0	0	15	0	0
2	131865037	rs111727878	G	A	7	2	9	0	0	9	0	0
2	131866050	rs4850126	T	A	11	4	15	0	0	15	0	0
2	131869747	rs918958	G	A	6	6	12	0	0	12	0	0
2	131876030	rs2059421	A	G	13	3	16	0	0	16	0	0
2	131877473	rs4508641	A	G	2	5	7	0	0	7	0	0
2	131898552	rs184102086	G	A	2	5	7	0	0	7	0	0
2	132246661	.	G	C	4	2	6	0	0	6	0	0
2	132246765	.	C	T	4	2	6	0	1	7	0	0
2	132256505	rs3817572	A	C	27	32	59	0	0	59	0	0
2	132262378	rs6705416	G	T	4	4	8	0	0	8	0	0
2	132264299	rs115471167	C	A	2	12	14	0	0	14	0	0
2	132264958	rs7565546	G	A	8	4	12	0	0	12	0	0
2	132266142	rs12691988	G	C	67	51	118	0	2	120	0	0
2	132266246	rs7591223	T	C	4	4	8	0	0	8	0	0
2	132266537	rs7572535	G	A	5	7	12	0	0	12	0	0
2	132267689	rs6430835	G	A	12	10	22	0	0	22	0	0
2	132270689	rs12691994	A	G	23	29	52	0	0	52	0	0
2	132271874	rs6741682	T	C	42	36	78	0	0	78	0	0
2	132272057	rs6735570	C	G	24	22	46	0	1	47	0	0
2	132274370	rs113719235	C	T	19	7	26	0	0	26	0	0
2	132275343	rs12691998	G	T	119	119	238	0	3	241	0	0
2	132275396	rs2277878	T	C	125	124	249	0	1	250	0	0
2	132277962	rs7560296	T	C	143	147	290	0	1	291	0	0
2	132278118	rs143759515	C	T	261	211	472	0	1	473	0	0
2	132278176	rs12469409	T	G	282	216	498	0	5	504	1	0
2	132278419	rs59594934	G	A	257	227	484	0	4	488	0	0
2	132278640	rs705090	G	C	332	99	431	0	1	432	0	0
2	135206618	rs115651006	G	A	17	7	24	0	0	24	0	0
2	135206934	rs681148	C	T	9	6	15	0	0	15	0	0
2	135208077	rs651970	A	G	2	11	13	0	1	14	0	0
2	135208213	rs626540	A	G	10	8	18	0	0	18	0	0
2	135209142	rs2439568	G	A	10	8	18	0	0	18	0	0
2	135209154	rs636975	A	G	11	7	18	0	0	18	0	0
2	135209591	rs669740	C	T	13	24	37	0	0	37	0	0
2	135214017	rs78198285	C	A	5	6	11	0	0	11	0	0
2	136874004	rs2471859	A	G	22	32	54	0	1	55	0	0
2	136874906	rs11682928	G	A	37	36	73	0	0	73	0	0
2	143886953	rs354709	T	C	12	11	23	0	0	23	0	0
2	143923529	.	G	A	13	6	19	0	1	20	0	0
2	144081319	rs12623224	T	G	8	3	11	0	0	11	0	0
2	144087761	rs4008340	C	A	2	5	7	0	0	7	0	0
2	144371873	rs72857975	A	G	29	47	76	0	1	77	0	0
2	144380542	rs11693600	C	T	5	7	12	0	0	12	0	0
2	144422572	.	T	G	4	2	6	0	0	6	0	0
2	144524235	rs12691692	T	C	4	2	6	0	0	6	0	0
2	144763897	rs72852969	C	T	10	4	14	0	0	14	0	0
2	145173029	rs16823675	T	C	6	1	7	0	0	7	0	0
2	145174019	rs72858441	C	T	5	4	9	0	0	9	0	0
2	145186749	rs12614546	C	T	1	5	6	0	0	6	0	0
2	145271933	rs140430007	G	A	10	9	19	0	0	19	0	0
2	148687731	rs17692648	A	C	13	4	17	0	0	17	0	0
2	148690055	rs2059422	A	G	3	4	7	0	0	7	0	0
2	148692233	rs17225677	A	G	24	12	36	0	0	36	0	0
2	148695541	rs17232029	G	A	3	4	7	0	0	7	0	0
2	148695748	.	G	A	102	67	169	0	6	175	0	0
2	148717497	rs17219071	T	C	3	8	11	0	0	11	0	0
2	148718920	rs4972317	T	C	11	9	20	0	0	20	0	0
2	148720724	rs143317962	C	T	3	4	7	0	0	7	0	0
2	148778272	rs897172	A	G	19	14	33	0	0	33	0	0
2	150426362	rs6923	T	C	78	80	158	0	0	158	0	0
2	152105759	rs289882	A	G	6	20	26	0	0	26	0	0
2	152106653	rs289883	G	A	8	16	24	0	0	24	0	0
2	152112161	rs147060862	C	G	16	4	20	0	0	20	0	0
2	152117780	rs2271811	T	C	14	10	24	0	0	24	0	0
2	152118271	rs55775354	G	A	16	9	25	0	0	25	0	0
2	152118275	rs56376752	A	G	16	10	26	0	0	26	0	0
2	152127011	rs11730	A	G	8	3	11	0	0	11	0	0
2	152127699	rs13004590	G	T	9	7	16	0	0	16	0	0
2	152128760	rs394884	C	T	3	5	8	0	0	8	0	0
2	152129295	rs4665137	A	G	5	10	15	0	0	15	0	0
2	152129879	rs446791	C	T	4	4	8	0	0	8	0	0
2	152132130	rs289834	A	G	151	189	340	0	4	344	0	0
2	152139416	rs1048135	G	A	85	71	156	0	0	156	0	0
2	152144766	rs6744327	G	A	1	5	6	0	0	6	0	0
2	152145102	rs10172069	C	T	3	8	11	0	0	11	0	0
2	152145654	rs2113508	C	T	4	3	7	0	0	7	0	0
2	152146194	rs2194492	G	C	45	65	110	0	1	111	0	0
2	152996974	rs17398329	C	T	6	2	8	0	0	8	0	0
2	153495973	rs3811568	A	G	3	6	9	0	0	9	0	0
2	153511976	rs17400436	A	G	182	153	335	0	2	337	0	0
2	153513258	rs71417235	C	T	15	17	32	0	1	33	0	0
2	153513857	rs17400456	T	C	22	14	36	0	0	36	0	0
2	153521271	rs77115856	C	T	11	4	15	0	1	16	0	0
2	153524293	rs7582253	G	A	3	6	9	0	0	9	0	0
2	153524311	rs7556673	C	A	4	7	11	0	0	11	0	0
2	153525971	rs6727279	A	C	1	5	6	0	0	6	0	0
2	153528136	rs1437677	A	G	2	4	6	0	0	6	0	0
2	153549819	rs13003670	C	T	30	34	64	0	0	64	0	0
2	153574266	rs7598878	G	A	1	5	6	0	0	6	0	0
2	153575729	rs1135617	T	G	11	23	34	0	1	35	0	0
2	153575962	rs13006652	T	C	7	44	51	0	0	51	0	0
2	153575972	rs3748938	A	G	40	8	48	0	0	48	0	0
2	153576006	rs3748937	T	C	43	13	56	0	0	56	0	0
2	153576279	rs7594309	A	C	12	4	16	0	0	16	0	0
2	153614359	rs13419134	G	C	2	4	6	0	0	6	0	0
2	158157361	rs3214040	C	T	4	9	13	0	0	13	0	0
2	158157745	rs11899055	G	C	4	3	7	0	0	7	0	0
2	158271512	rs267992	C	T	15	17	32	0	0	32	0	0
2	158272450	.	G	T	135	154	289	0	0	289	0	0
2	158274853	rs36100105	T	C	6	5	11	0	0	11	0	0
2	159327551	rs55690795	C	T	3	3	6	0	0	6	0	0
2	159413406	rs10933490	A	G	7	1	8	0	0	8	0	0
2	159413799	rs10168054	A	C	13	2	15	0	2	17	0	0
2	159491032	rs72942738	A	T	2	7	9	0	0	9	0	0
2	159519368	rs3764835	G	A	6	3	9	0	0	9	0	0
2	160261387	rs11551108	T	C	21	17	38	0	0	38	0	0
2	160453305	rs6738215	C	T	2	6	8	0	0	8	0	0
2	160461478	rs10195287	C	T	2	4	6	0	0	6	0	0
2	160468346	rs72954376	A	G	4	3	7	0	0	7	0	0
2	160587525	rs4665110	C	T	5	9	14	0	0	14	0	0
2	160588777	rs34893664	T	A	4	3	7	0	0	7	0	0
2	160589185	rs10204867	C	A	3	7	10	0	0	10	0	0
2	160589343	rs10170336	T	C	9	4	13	0	0	13	0	0
2	160589492	rs13022404	C	A	9	7	16	0	0	16	0	0
2	160589777	rs35196716	T	G	8	6	14	0	0	14	0	0
2	160592210	rs6432557	A	G	5	10	15	0	0	15	0	0
2	160592690	rs7603274	G	C	4	21	25	0	0	25	0	0
2	160604812	rs1427329	C	T	57	42	99	0	0	99	0	0
2	160605268	rs1365803	T	C	93	46	139	0	0	139	0	0
2	160620769	rs5835759	G	A	6	2	8	0	1	9	0	0
2	160622365	rs9784044	C	T	4	2	6	0	0	6	0	0
2	160623366	rs4664301	C	T	8	6	14	0	0	14	0	0
2	160623590	rs12617546	G	A	10	6	16	0	0	16	0	0
2	160625727	rs13432	C	G	45	38	83	0	1	84	0	0
2	160626152	rs13939	A	G	17	16	33	0	0	33	0	0
2	160627317	rs1126842	C	G	42	23	65	0	1	66	0	0
2	160628155	rs3771721	C	G	20	13	33	0	0	33	0	0
2	160629393	rs11681245	A	G	4	3	7	0	0	7	0	0
2	160632123	rs7564606	G	A	3	8	11	0	0	11	0	0
2	160639970	rs2114626	T	C	19	16	35	0	1	36	0	0
2	160653356	rs11682886	C	T	16	12	28	0	0	28	0	0
2	160660165	rs2114628	C	T	5	5	10	0	0	10	0	0
2	160662058	rs2042772	T	C	4	4	8	0	0	8	0	0
2	160695316	rs7571170	T	A	4	2	6	0	0	6	0	0
2	160696209	rs11675986	A	G	6	2	8	0	0	8	0	0
2	160696242	rs11896565	C	T	3	5	8	0	0	8	0	0
2	160710922	rs2729705	T	C	9	8	17	0	0	17	0	0
2	160711045	rs3951216	G	C	4	6	10	0	0	10	0	0
2	160714958	.	C	T	3	3	6	0	0	6	0	0
2	161265071	rs13009192	C	T	13	6	19	0	0	19	0	0
2	161265099	rs13009374	C	A	14	8	22	0	0	22	0	0
2	162018643	rs1267059	A	C	6	13	19	0	0	19	0	0
2	162020542	rs1267060	C	T	7	5	12	0	0	12	0	0
2	162034536	rs11684253	G	T	4	6	10	0	0	10	0	0
2	162059817	rs1267075	G	A	3	3	6	0	0	6	0	0
2	162059969	rs11884495	A	T	6	3	9	0	0	9	0	0
2	162092640	rs7309	G	A	4	2	6	0	0	6	0	0
2	162104784	rs1146030	C	G	3	6	9	0	1	10	0	0
2	162107295	rs3731769	G	T	6	4	10	0	0	10	0	0
2	162111163	rs1267052	G	A	5	2	7	0	0	7	0	0
2	162165008	rs9713	A	T	54	61	115	0	0	115	0	0
2	162182801	rs6713728	G	C	12	12	24	0	1	25	0	0
2	162212227	rs1111416	A	G	7	9	16	0	0	16	0	0
2	162226336	rs10497214	G	T	5	1	6	0	0	6	0	0
2	162229061	rs4664421	G	A	19	24	43	0	0	43	0	0
2	162257799	rs1863177	T	A	8	6	14	0	0	14	0	0
2	162258433	rs6733456	C	T	12	5	17	0	0	17	0	0
2	162261389	rs3769958	C	T	4	2	6	0	0	6	0	0
2	163124104	rs36070180	C	T	16	20	36	0	0	36	0	0
2	163165574	rs74690496	A	G	188	182	370	0	2	372	0	0
2	163208877	rs79565841	G	T	165	121	286	0	2	288	0	0
2	163208893	rs17783344	T	G	130	158	288	0	0	288	0	0
2	166605010	rs13429321	A	T	36	43	79	0	1	80	0	0
2	166605927	rs2303394	A	C	4	2	6	0	0	6	0	0
2	166606993	rs11686403	G	T	6	5	11	0	0	11	0	0
2	166614577	rs13431319	T	C	14	14	28	0	0	28	0	0
2	166614779	rs3762552	G	A	2	4	6	0	0	6	0	0
2	166615555	rs4667835	C	T	6	4	10	0	0	10	0	0
2	166616667	rs62174820	A	G	7	3	10	0	0	10	0	0
2	166616912	.	T	C	4	4	8	0	1	9	0	0
2	166618036	rs11893583	A	G	2	6	8	0	0	8	0	0
2	166618262	rs1968294	C	T	5	3	8	0	1	9	0	0
2	166624047	rs2059435	C	A	3	3	6	0	0	6	0	0
2	166627079	.	T	C	25	50	75	0	0	76	1	0
2	166649615	rs79624426	G	A	6	3	9	0	0	9	0	0
2	166730734	rs56115495	T	C	47	35	82	0	0	82	0	0
2	166730748	rs77199262	C	T	49	31	80	0	1	81	0	0
2	166773820	rs139441507	G	A	15	16	31	0	1	32	0	0
2	168008761	rs73017965	G	T	6	1	7	0	0	7	0	0
2	168008776	rs73017968	A	G	6	2	8	0	0	8	0	0
2	169092450	rs75978941	A	C	5	10	15	0	0	15	0	0
2	169092692	rs74468373	C	G	8	1	9	0	0	9	0	0
2	169093390	rs4315488	T	C	4	2	6	0	0	6	0	0
2	169578221	rs933782	T	C	2	4	6	0	0	6	0	0
2	169690089	rs549582	C	T	1	7	8	0	0	8	0	0
2	169690729	rs522893	T	C	0	7	7	0	0	7	0	0
2	169702929	rs559113	A	T	6	4	10	0	0	10	0	0
2	169709104	rs577192	C	T	4	2	6	0	0	6	0	0
2	169719951	rs2685801	T	G	5	6	11	0	0	11	0	0
2	170662634	rs13393212	C	A	13	16	29	0	0	29	0	0
2	170665108	rs2556352	G	A	47	84	131	0	0	131	0	0
2	170762566	rs10194785	A	T	8	14	22	0	0	22	0	0
2	170800441	rs1461961	C	T	3	4	7	0	0	7	0	0
2	170800537	rs11681209	A	G	4	4	8	0	0	8	0	0
2	170801244	rs12989755	G	T	1	5	6	0	0	6	0	0
2	170917648	rs10203212	A	G	16	26	42	0	1	43	0	0
2	170939368	rs13781	G	A	15	9	24	0	0	24	0	0
2	171716803	rs769395	G	A	8	5	13	0	0	13	0	0
2	171821118	rs35890547	G	A	6	2	8	0	0	8	0	0
2	171847517	rs202107503	A	T	6	4	10	0	0	10	0	0
2	171847832	rs16859081	G	C	10	11	21	0	0	21	0	0
2	171849612	rs1045327	T	C	61	61	122	0	1	123	0	0
2	171852372	rs12988738	C	T	8	0	8	0	0	8	0	0
2	171910313	rs11553951	C	T	41	40	81	0	1	82	0	0
2	171928320	rs6742854	T	A	3	5	8	0	0	8	0	0
2	171943358	rs13010307	C	T	7	3	10	0	1	11	0	0
2	171946197	rs13030784	A	G	9	3	12	0	0	12	0	0
2	171946572	rs10930455	T	C	12	4	16	0	0	16	0	0
2	171946614	rs10930456	C	T	7	5	12	0	0	12	0	0
2	171946911	rs10930457	A	G	5	8	13	0	0	13	0	0
2	171947615	rs13411575	C	G	10	6	16	0	0	16	0	0
2	171947799	rs13425247	T	A	23	15	38	0	0	38	0	0
2	172291616	rs6751956	C	T	4	10	14	0	0	14	0	0
2	172338194	rs3795998	G	A	6	5	11	0	0	11	0	0
2	172338300	rs3821084	T	G	3	3	6	0	0	6	0	0
2	172340049	rs12151641	T	A	8	9	17	0	0	17	0	0
2	172340419	rs17221346	T	C	17	19	36	0	0	36	0	0
2	172340736	rs17221367	C	G	11	11	22	0	1	23	0	0
2	172341327	rs9789572	A	G	21	21	42	0	0	42	0	0
2	172397677	rs12476341	G	A	5	4	9	0	0	9	0	0
2	172411273	rs10455	G	A	16	15	31	0	0	31	0	0
2	172411644	rs1060248	C	T	8	4	12	0	0	12	0	0
2	172411737	rs950163	C	A	4	2	6	0	0	6	0	0
2	172413018	rs2542939	A	G	8	6	14	0	0	14	0	0
2	172414102	rs72884394	G	A	6	6	12	0	0	12	0	0
2	172711138	rs3770443	G	C	0	6	6	0	0	6	0	0
2	172723476	rs193282261	A	G	6	3	9	0	0	9	0	0
2	172723828	rs11695029	A	G	5	2	7	0	0	7	0	0
2	172725301	rs1878583	A	G	36	26	62	0	0	62	0	0
2	172787739	rs12467010	A	G	3	3	6	0	0	6	0	0
2	172792159	rs7597525	C	A	6	0	6	0	0	6	0	0
2	172792599	rs11692418	C	G	5	2	7	0	0	7	0	0
2	172813218	rs4280427	G	A	5	1	6	0	0	6	0	0
2	172813219	rs4280428	G	A	5	1	6	0	0	6	0	0
2	172813245	rs4324292	C	G	5	1	6	0	0	6	0	0
2	172847995	rs77465418	G	T	2	4	6	0	0	6	0	0
2	172851552	rs11695630	T	C	1	6	7	0	0	7	0	0
2	172851590	rs190074028	G	A	6	0	6	0	0	6	0	0
2	172945107	rs12473549	C	T	12	8	20	0	0	20	0	0
2	172945529	rs705869	G	A	16	9	25	0	0	25	0	0
2	172946315	rs788160	T	G	7	4	11	0	0	11	0	0
2	172946864	rs74483458	C	T	8	8	16	0	3	19	0	0
2	173367301	.	T	C	3	5	8	0	0	8	0	0
2	173368330	rs147970002	A	G	5	10	15	0	0	15	0	0
2	174075194	rs10930579	T	C	6	14	20	0	0	20	0	0
2	174075761	rs1866631	G	A	5	10	15	0	0	15	0	0
2	174076273	rs4972536	T	C	19	22	41	0	0	41	0	0
2	174076457	rs10185321	A	G	9	18	27	0	0	27	0	0
2	174077015	rs12693019	G	A	3	6	9	0	0	9	0	0
2	174077289	rs59500540	G	A	6	1	7	0	0	7	0	0
2	174077458	rs56980119	T	G	5	8	13	0	0	13	0	0
2	174078135	rs7567355	C	G	9	9	18	0	0	18	0	0
2	174086285	rs74417392	C	T	9	7	16	0	0	16	0	0
2	174086492	rs16861363	C	T	7	2	9	0	0	9	0	0
2	174087309	rs6731949	G	A	5	7	12	0	1	13	0	0
2	174087310	rs6746658	T	A	5	7	12	0	1	13	0	0
2	174087747	rs2028382	A	C	2	5	7	0	0	7	0	0
2	174088266	rs10497402	G	A	8	5	13	0	0	13	0	0
2	174089399	.	T	C	10	16	26	0	0	26	0	0
2	174228744	rs1529887	T	C	56	72	128	0	1	129	0	0
2	174229122	rs11078	G	A	47	45	92	0	0	92	0	0
2	174229226	rs2288995	C	T	37	29	66	0	0	66	0	0
2	174232845	rs10193202	T	C	120	80	200	0	2	202	0	0
2	174233041	rs1047885	A	G	197	210	407	0	4	412	1	0
2	174772660	rs72911133	G	A	150	97	247	0	0	247	0	0
2	174772928	rs7349378	C	T	22	4	26	0	0	26	0	0
2	174784505	rs4508563	C	T	3	5	8	0	0	8	0	0
2	174792769	rs9287968	A	G	15	9	24	0	0	24	0	0
2	174793571	rs78325397	A	G	4	6	10	0	0	10	0	0
2	174793940	rs7579338	G	A	35	14	49	0	1	50	0	0
2	174794547	rs10930625	G	A	17	10	27	0	0	27	0	0
2	174794648	rs72911163	C	G	8	16	24	0	0	24	0	0
2	174795841	rs77788691	C	T	8	25	33	0	1	34	0	0
2	174797031	rs11902916	T	A	14	7	21	0	0	21	0	0
2	174797581	rs6757221	T	G	4	3	7	0	0	7	0	0
2	174798731	rs115071937	G	A	4	3	7	0	0	7	0	0
2	174818970	rs4972624	C	T	6	2	8	0	0	8	0	0
2	174830266	rs111903923	T	G	5	5	10	0	0	10	0	0
2	174939984	.	G	A	105	143	248	0	53	302	1	0
2	174943876	rs3754812	C	T	4	2	6	0	0	6	0	0
2	175213041	rs3192048	T	C	53	69	122	0	0	122	0	0
2	175217236	rs4972649	A	G	23	21	44	0	1	45	0	0
2	175218473	rs4972437	C	T	13	7	20	0	0	20	0	0
2	175221259	rs112567731	A	G	3	5	8	0	0	8	0	0
2	175222418	rs6433473	T	C	6	4	10	0	0	10	0	0
2	175227814	rs1597418	A	T	2	4	6	0	0	6	0	0
2	175230862	rs7606312	G	A	17	7	24	0	0	24	0	0
2	175234490	rs10930659	C	A	4	2	6	0	0	6	0	0
2	175261148	rs13009079	T	C	3	5	8	0	0	8	0	0
2	175263063	rs10497410	G	A	3	3	6	0	0	6	0	0
2	175292888	rs1045661	G	C	3	3	6	0	0	6	0	0
2	175422852	rs9287977	T	A	5	1	6	0	0	6	0	0
2	175422978	rs13008567	A	T	1	5	6	0	0	6	0	0
2	175424779	rs3087907	T	G	2	5	7	0	0	7	0	0
2	175424958	rs113707857	G	T	13	9	22	0	0	22	0	0
2	175425346	rs3205060	C	T	6	6	12	0	0	12	0	0
2	175434640	rs7562798	C	T	3	3	6	0	0	6	0	0
2	175440316	rs11675139	G	A	6	4	10	0	0	10	0	0
2	175469533	rs2358890	C	T	5	6	11	0	0	11	0	0
2	175469948	rs6743223	A	G	5	3	8	0	0	8	0	0
2	175470048	rs6714963	C	T	3	6	9	0	0	9	0	0
2	175494056	rs28485554	C	T	4	13	17	0	0	17	0	0
2	175494057	rs28458405	A	T	3	13	16	0	1	17	0	0
2	175495311	rs1991600	C	T	8	5	13	0	0	13	0	0
2	175496835	rs1864453	T	C	5	1	6	0	0	6	0	0
2	175498386	rs6707162	G	T	5	4	9	0	0	9	0	0
2	175498390	rs6735680	A	C	5	2	7	0	0	7	0	0
2	175941263	rs116608270	C	T	8	3	11	0	0	11	0	0
2	175943281	rs212352	T	C	7	7	14	0	0	14	0	0
2	176789409	rs2166527	A	C	9	9	18	0	1	19	0	0
2	176789427	rs74954281	A	C	10	8	18	0	0	18	0	0
2	176789816	rs12477861	C	T	9	8	17	0	0	17	0	0
2	176790182	rs12469909	A	G	10	11	21	0	0	21	0	0
2	176790393	.	C	T	9	3	12	0	6	18	0	0
2	176791329	rs76606171	T	C	7	4	11	0	0	11	0	0
2	176791642	rs12621733	G	A	8	6	14	0	0	14	0	0
2	176791882	rs12615252	A	G	7	3	10	0	0	10	0	0
2	176792116	rs76675199	C	G	5	8	13	0	0	13	0	0
2	176792330	rs78714646	C	A	6	8	14	0	0	14	0	0
2	176792357	rs62186993	A	G	6	6	12	0	0	12	0	0
2	176792805	rs12613220	T	A	11	9	20	0	0	20	0	0
2	176792929	rs12622749	G	A	19	18	37	0	0	37	0	0
2	176793016	rs12622783	G	A	27	23	50	0	0	50	0	0
2	176794388	rs2289966	C	T	18	9	27	0	0	27	0	0
2	176866967	rs935492	C	T	5	4	9	0	0	9	0	0
2	178085137	rs9068	G	A	83	66	149	0	0	149	0	0
2	178085827	rs8470	C	T	108	97	205	0	0	206	1	0
2	178087165	rs2588882	G	T	159	166	325	0	2	327	0	0
2	178087387	rs1142940	T	C	131	152	283	0	7	290	0	0
2	178087779	rs8334	T	G	267	250	517	0	3	520	0	0
2	178088144	rs2588881	A	C	29	27	56	0	8	64	0	0
2	178097666	rs10183914	C	T	3	3	6	0	2	8	0	0
2	178099653	rs144668476	G	C	4	3	7	0	0	7	0	0
2	178100425	rs2001350	C	T	6	4	10	0	0	10	0	0
2	178105144	rs2364720	A	G	5	3	8	0	0	8	0	0
2	178114632	rs10930781	A	G	17	10	27	0	0	27	0	0
2	178117765	rs4243387	C	T	7	7	14	0	0	14	0	0
2	178118152	rs1806649	C	T	6	4	10	0	0	10	0	0
2	178118990	rs13001694	A	G	2	4	6	0	0	6	0	0
2	178120312	rs10188107	T	G	1	5	6	0	0	6	0	0
2	178121112	rs13005431	T	C	3	5	8	0	0	8	0	0
2	178125142	rs34468415	A	G	3	4	7	0	0	7	0	0
2	178127040	rs34551701	A	C	8	6	14	0	0	14	0	0
2	178128693	rs17524059	A	C	10	8	18	0	0	18	0	0
2	178130037	rs6721961	T	G	38	25	63	0	2	65	0	0
2	178329935	rs9789580	C	T	8	6	14	0	1	15	0	0
2	178406481	rs8941	C	T	16	24	40	0	1	41	0	0
2	178407176	rs10803912	C	A	15	14	29	0	0	29	0	0
2	178407897	rs2293475	T	C	28	32	60	0	0	60	0	0
2	179311360	rs72953355	G	C	3	4	7	0	0	7	0	0
2	179325735	rs17304212	C	T	6	7	13	0	0	13	0	0
2	179979930	rs2289993	T	C	10	8	18	0	0	18	0	0
2	180810180	rs6433817	C	T	79	76	155	0	2	157	0	0
2	180810264	rs6433818	A	T	55	60	115	0	1	116	0	0
2	180841914	rs12693217	T	G	2	4	6	0	0	6	0	0
2	181889062	rs4362519	G	C	3	4	7	0	0	7	0	0
2	181894518	.	T	C	8	2	10	0	0	10	0	0
2	181894898	rs62180157	G	A	5	3	8	0	0	8	0	0
2	181897419	rs57230918	C	A	23	20	43	0	0	43	0	0
2	181897869	rs62180159	G	C	52	41	93	0	3	96	0	0
2	181898087	rs6713336	T	C	57	34	91	0	3	94	0	0
2	181898629	rs113365767	T	C	73	25	98	0	0	98	0	0
2	181899324	rs62181560	A	G	19	12	31	0	0	31	0	0
2	181899325	rs10930948	G	A	19	12	31	0	0	31	0	0
2	181905670	rs72885247	C	A	1	6	7	0	0	7	0	0
2	181910882	rs6433883	A	C	2	4	6	0	0	6	0	0
2	181912401	rs62181571	C	T	2	10	12	0	0	12	0	0
2	181914761	rs7371242	A	G	5	8	13	0	0	13	0	0
2	181917754	rs62181573	A	G	9	12	21	0	0	21	0	0
2	181918896	rs7562697	A	G	17	30	47	0	2	49	0	0
2	181919490	rs10171998	G	C	6	8	14	0	0	14	0	0
2	181920129	rs56970984	C	G	7	6	13	0	0	13	0	0
2	181920762	rs78590213	T	G	11	6	17	0	0	17	0	0
2	181920763	rs79719017	T	C	11	6	17	0	0	17	0	0
2	181921417	rs62181575	G	A	15	31	46	0	2	48	0	0
2	181921679	rs7370006	C	A	22	17	39	0	1	40	0	0
2	181921999	rs7371639	A	G	11	25	36	0	1	37	0	0
2	181922014	rs7370048	G	A	13	27	40	0	1	41	0	0
2	181923066	rs62181577	G	A	1	5	6	0	0	6	0	0
2	181925041	rs62181579	T	C	1	6	7	0	0	7	0	0
2	181927195	rs3792220	A	G	4	5	9	0	0	9	0	0
2	182323766	rs1375493	G	A	42	46	88	0	0	88	0	0
2	182325296	rs73974899	G	A	4	2	6	0	0	6	0	0
2	182340214	rs2305591	A	T	4	4	8	0	0	8	0	0
2	182341971	rs62191406	C	T	3	4	7	0	0	7	0	0
2	182351184	rs17224872	C	T	4	4	8	0	0	8	0	0
2	182352296	rs155108	G	A	16	14	30	0	0	30	0	0
2	182352568	rs10172410	T	C	6	3	9	0	0	9	0	0
2	182372497	rs11675166	A	G	8	0	8	0	0	8	0	0
2	182373363	rs4368293	T	C	2	5	7	0	0	7	0	0
2	182373863	.	A	T	22	2	24	0	11	35	0	0
2	182374534	rs1143674	A	G	74	67	141	0	3	144	0	0
2	182381549	rs1551031	C	T	3	4	7	0	0	7	0	0
2	182382367	rs3770110	G	T	3	4	7	0	0	7	0	0
2	182392143	rs56095368	G	C	10	13	23	0	0	23	0	0
2	182393068	rs6757312	A	G	7	5	12	0	0	12	0	0
2	182393109	rs6728886	C	T	3	4	7	0	0	7	0	0
2	182393759	rs3770105	C	T	4	12	16	0	0	16	0	0
2	182394145	rs3770104	C	T	8	16	24	0	0	24	0	0
2	182394567	rs921257	A	G	5	2	7	0	0	7	0	0
2	182394954	rs6707704	A	G	2	6	8	0	0	8	0	0
2	182395345	rs1143676	G	A	105	113	218	0	3	221	0	0
2	182396032	rs6433921	T	G	15	31	46	0	1	47	0	0
2	182396054	rs6433922	C	T	11	30	41	0	0	41	0	0
2	182399097	rs7562325	T	C	122	165	287	0	1	288	0	0
2	182401752	rs1047307	G	A	251	322	573	0	1	574	0	0
2	182402790	rs6747500	G	A	7	10	17	0	0	17	0	0
2	183616913	rs61748254	A	C	22	34	56	0	0	56	0	0
2	184025875	rs74849582	G	T	19	15	34	0	0	34	0	0
2	184025876	rs79259445	A	T	19	15	34	0	0	34	0	0
2	185463185	rs359895	T	A	9	5	14	0	0	14	0	0
2	185463535	rs73041379	G	A	6	3	9	0	0	9	0	0
2	185479385	rs73041394	A	G	4	7	11	0	0	11	0	0
2	185480633	rs1427150	T	C	8	7	15	0	0	15	0	0
2	185497969	rs12990519	A	G	3	3	6	0	0	6	0	0
2	185498003	rs6434092	C	G	6	4	10	0	0	10	0	0
2	185545033	rs10188162	G	A	6	3	9	0	1	10	0	0
2	187363779	rs4666705	G	A	4	2	6	0	0	6	0	0
2	187367534	rs3768776	T	C	12	19	31	0	1	32	0	0
2	187367752	rs2119861	G	A	12	13	25	0	0	25	0	0
2	187368194	rs1470230	T	C	25	10	35	0	0	35	0	0
2	187369832	rs988110	T	C	12	9	21	0	1	22	0	0
2	187370673	rs11690758	G	C	4	2	6	0	0	6	0	0
2	187371786	rs11692347	C	T	5	1	6	0	0	6	0	0
2	187373054	rs11903027	G	A	12	9	21	0	0	21	0	0
2	187490371	rs2197787	T	G	10	5	15	0	2	17	0	0
2	187490389	rs5836987	G	T	11	5	16	0	0	16	0	0
2	187491140	rs1992898	G	A	4	4	8	0	0	8	0	0
2	187492460	rs10171481	G	A	2	5	7	0	0	7	0	0
2	187492742	rs10174098	G	A	6	5	11	0	0	11	0	0
2	187493431	rs17334072	G	A	3	4	7	0	0	7	0	0
2	187494427	rs7596996	G	A	6	2	8	0	0	8	0	0
2	188342833	rs8176620	G	A	10	13	23	0	0	23	0	0
2	190315001	rs4667281	G	T	5	5	10	0	0	10	0	0
2	190322196	rs10497700	T	C	6	6	12	0	0	12	0	0
2	190323177	rs2351933	A	C	6	9	15	0	0	15	0	0
2	190323530	rs1157910	A	G	31	40	71	0	2	73	0	0
2	190330049	rs78713882	A	G	5	2	7	0	0	7	0	0
2	190330761	rs1520866	G	A	4	5	9	0	0	9	0	0
2	190336705	rs10166420	A	T	6	2	8	0	0	8	0	0
2	190425474	rs11539983	T	C	80	85	165	0	0	165	0	0
2	190445936	rs13015236	C	T	4	2	6	0	0	6	0	0
2	190526205	rs2289226	C	T	16	15	31	0	0	31	0	0
2	190526224	rs1132360	C	T	24	34	58	0	0	58	0	0
2	190629694	rs10931433	G	A	2	4	6	0	0	6	0	0
2	190635143	rs1055091	C	T	15	0	15	0	0	15	0	0
2	190636014	rs2289404	G	A	2	6	8	0	0	8	0	0
2	190636039	rs2289405	C	T	14	10	24	0	0	24	0	0
2	190636411	rs6942	C	G	210	185	395	0	2	397	0	0
2	190639915	rs3791767	A	C	4	6	10	0	0	10	0	0
2	190648805	rs5742926	G	T	18	18	36	0	2	38	0	0
2	190649154	.	G	A	12	5	17	0	0	17	0	0
2	190649316	rs5742933	G	C	6	10	16	0	0	16	0	0
2	190649582	rs1899025	C	T	32	30	62	0	0	62	0	0
2	190649958	rs5742938	G	A	15	15	30	0	0	30	0	0
2	191184475	rs291466	A	G	15	10	25	0	0	25	0	0
2	191301368	rs9646748	A	G	12	13	25	0	0	25	0	0
2	191319061	rs13410179	T	C	6	10	16	0	0	16	0	0
2	191365043	rs61742316	A	G	8	9	17	0	1	18	0	0
2	191365777	.	G	A	6	10	16	0	0	16	0	0
2	191371041	rs13392968	A	G	1	6	7	0	0	7	0	0
2	191371649	rs8962	G	A	9	6	15	0	1	16	0	0
2	191373446	rs11553601	G	A	2	4	6	0	0	6	0	0
2	191373775	rs6707244	C	T	7	8	15	0	0	15	0	0
2	191514655	.	G	A	3	6	9	0	0	9	0	0
2	191520845	rs2293765	C	A	10	4	14	0	0	14	0	0
2	191555630	rs11552967	G	A	15	6	21	0	1	22	0	0
2	191749035	rs3771316	A	C	2	5	7	0	0	7	0	0
2	191753289	rs11681912	T	G	1	5	6	0	0	6	0	0
2	191759564	rs12990256	G	A	4	8	12	0	0	12	0	0
2	191763485	rs2108818	G	C	30	20	50	0	0	50	0	0
2	191765206	rs3771313	T	C	21	15	36	0	0	36	0	0
2	191770613	rs3771311	T	G	64	75	139	0	4	143	0	0
2	191770894	rs12998878	G	A	22	26	48	0	0	48	0	0
2	191789523	rs3732212	C	T	6	4	10	0	0	10	0	0
2	191799600	rs60202309	T	G	76	82	158	0	3	161	0	0
2	191801975	rs59981934	T	G	2	4	6	0	0	6	0	0
2	191805546	rs73054727	A	G	8	10	18	0	1	19	0	0
2	191807453	rs11688967	A	G	5	1	6	0	0	6	0	0
2	191818065	rs6434430	T	C	9	11	20	0	0	20	0	0
2	191819039	rs13001395	A	G	4	5	9	0	0	9	0	0
2	191825063	rs4853454	T	C	11	9	20	0	1	21	0	0
2	191825769	rs883844	T	C	14	9	23	0	0	23	0	0
2	191826382	rs867637	A	G	5	5	10	0	1	11	0	0
2	191827011	rs11692579	G	C	15	15	30	0	0	30	0	0
2	191828203	.	A	T	6	8	14	0	0	14	0	0
2	191828205	rs1546647	C	A	6	8	14	0	0	14	0	0
2	191828596	rs1546646	A	G	2	8	10	0	0	10	0	0
2	191829353	rs13035504	C	G	14	8	22	0	0	22	0	0
2	191830867	rs12987796	T	G	35	39	74	0	0	74	0	0
2	191831301	.	T	C	4	3	7	0	1	8	0	0
2	191832264	rs12468579	A	G	7	5	12	0	0	12	0	0
2	191832492	rs12693588	T	C	9	8	17	0	0	17	0	0
2	191833540	rs1400657	G	T	13	11	24	0	0	24	0	0
2	191835918	rs7575823	T	C	8	7	15	0	1	16	0	0
2	191836553	rs6711082	C	T	11	14	25	0	0	25	0	0
2	191836562	rs7562400	C	G	13	14	27	0	0	27	0	0
2	191836671	rs4853532	G	T	6	13	19	0	0	19	0	0
2	191836771	rs4853533	T	C	12	5	17	0	2	19	0	0
2	191837585	rs67960489	G	T	18	12	30	0	1	31	0	0
2	191837634	rs16824035	C	T	17	12	29	0	1	30	0	0
2	191837841	rs11894425	T	C	11	8	19	0	1	20	0	0
2	191838514	rs13395505	G	A	7	7	14	0	0	14	0	0
2	191839464	rs2066793	G	A	4	12	16	0	0	16	0	0
2	191875035	rs36077929	C	T	4	8	12	0	0	12	0	0
2	191876329	.	C	T	4	4	8	0	0	8	0	0
2	191896045	rs1517351	T	G	13	5	18	0	0	18	0	0
2	191896054	rs3024935	G	T	5	12	17	0	0	17	0	0
2	191923026	rs1818625	T	C	5	3	8	0	0	8	0	0
2	191924606	rs3024861	T	A	2	5	7	0	0	7	0	0
2	191927565	.	A	G	11	8	19	0	0	19	0	0
2	192699699	rs12477095	G	A	3	5	8	0	0	8	0	0
2	192701393	rs10167187	A	G	52	52	104	0	0	104	0	0
2	192701407	rs61735649	G	C	50	49	99	0	1	100	0	0
2	196525395	rs11553708	G	C	10	10	20	0	0	20	0	0
2	197020456	.	C	T	9	4	13	0	0	13	0	0
2	197034475	rs575000490	A	G	5	7	12	0	0	12	0	0
2	197594203	rs2577580	G	C	2	4	6	0	0	6	0	0
2	197870536	.	T	C	6	2	8	0	0	8	0	0
2	198122357	rs114279581	G	A	8	4	12	0	0	12	0	0
2	198122900	rs2697287	T	C	9	5	14	0	0	14	0	0
2	198125341	.	G	C	21	17	38	0	0	38	0	0
2	198125499	.	T	C	9	4	13	0	0	13	0	0
2	198126163	rs1976965	A	C	8	12	20	0	0	20	0	0
2	198126737	rs2697286	G	A	6	4	10	0	0	10	0	0
2	198126797	rs2712873	A	G	7	2	9	0	0	9	0	0
2	198126979	rs12468436	C	T	4	3	7	0	0	7	0	0
2	198127129	rs2697285	G	A	2	5	7	0	0	7	0	0
2	198127399	rs2178202	G	A	6	5	11	0	0	11	0	0
2	198127968	rs2697282	T	C	6	1	7	0	0	7	0	0
2	198128006	rs2697281	A	G	4	3	7	0	0	7	0	0
2	198128280	rs16863762	A	G	6	5	11	0	0	11	0	0
2	198128642	rs2697280	C	T	3	3	6	0	0	6	0	0
2	198128741	rs117341830	G	C	4	3	7	0	0	7	0	0
2	198128894	rs2697278	T	C	5	3	8	0	0	8	0	0
2	198129143	rs2697277	T	A	2	4	6	0	0	6	0	0
2	198129160	rs2712870	T	C	2	5	7	0	0	7	0	0
2	198129619	rs962697	C	A	4	3	7	0	0	7	0	0
2	198131097	rs2564393	G	C	4	2	6	0	0	6	0	0
2	198283364	rs138330846	C	G	35	32	67	0	0	67	0	0
2	200792498	rs3098341	G	T	24	21	45	0	1	46	0	0
2	200792881	rs971232	C	T	43	29	72	0	0	72	0	0
2	200794445	rs13389195	T	C	7	17	24	0	0	24	0	0
2	200794870	rs281763	C	T	13	17	30	0	0	30	0	0
2	200795571	rs6435036	A	G	8	13	21	0	0	21	0	0
2	200800493	.	A	G	10	4	14	0	0	14	0	0
2	200809709	rs281769	T	C	5	6	11	0	1	12	0	0
2	200810957	rs11680723	C	G	5	2	7	0	0	7	0	0
2	200830137	rs4263095	G	T	2	5	7	0	0	7	0	0
2	200834282	rs281776	T	G	4	2	6	0	0	6	0	0
2	200838613	rs11895190	G	A	4	6	10	0	0	10	0	0
2	200846666	rs281794	C	T	1	10	11	0	0	11	0	0
2	201337667	rs6723687	A	C	5	4	9	0	0	9	0	0
2	201354244	rs17630981	G	A	82	50	132	0	1	133	0	0
2	201354935	rs3795969	C	G	50	71	121	0	0	121	0	0
2	201358423	rs11884301	C	T	4	5	9	0	1	10	0	0
2	201358597	rs7591915	A	G	4	2	6	0	0	6	0	0
2	201359381	rs6718287	C	T	2	4	6	0	0	6	0	0
2	201361688	rs12693915	G	T	3	3	6	0	0	6	0	0
2	201437214	rs17532679	A	G	7	2	9	0	0	9	0	0
2	201437328	rs35987478	C	A	2	6	8	0	0	8	0	0
2	201560605	rs2247030	T	G	11	0	11	0	0	11	0	0
2	201565970	rs2540054	A	G	0	10	10	0	0	10	0	0
2	201571143	rs2540051	G	A	0	10	10	0	0	10	0	0
2	201574111	rs34827486	T	C	7	0	7	0	0	7	0	0
2	201638647	rs12622452	A	G	6	0	6	0	0	6	0	0
2	201717910	rs7224	T	G	444	362	806	0	17	824	1	0
2	201719916	rs72927093	A	G	11	9	20	0	0	20	0	0
2	201720172	rs112313977	G	A	21	11	32	0	0	32	0	0
2	201721134	rs13405189	G	A	10	11	21	0	0	21	0	0
2	201721782	rs41271451	C	T	73	48	121	0	0	121	0	0
2	201722827	rs17383109	C	A	68	24	92	0	1	93	0	0
2	201724114	rs11903236	T	C	41	13	54	0	0	54	0	0
2	201728141	rs6757272	A	G	13	16	29	0	1	30	0	0
2	201742345	rs2136600	C	T	4	2	6	0	0	6	0	0
2	201747351	rs72929010	C	T	8	6	14	0	0	14	0	0
2	201747681	rs17467707	C	T	8	2	10	0	0	10	0	0
2	201752651	rs145079048	G	A	4	5	9	0	0	9	0	0
2	201752652	rs148324804	C	A	4	5	9	0	0	9	0	0
2	201766236	rs10497855	G	A	4	2	6	0	0	6	0	0
2	201768238	rs7917	C	T	10	7	17	0	0	17	0	0
2	201843530	rs72929040	G	A	10	7	17	0	2	19	0	0
2	201881488	rs55711804	A	G	5	5	10	0	0	10	0	0
2	201881493	rs4377317	C	T	4	5	9	0	0	9	0	0
2	201928945	.	G	A	12	0	12	0	0	12	0	0
2	201936311	.	C	T	3	3	6	0	0	6	0	0
2	201982544	rs2881928	T	C	13	5	18	0	0	18	0	0
2	201983057	rs72931016	A	G	32	21	53	0	1	54	0	0
2	201993551	rs72931023	C	T	3	3	6	0	0	6	0	0
2	201993688	rs6706980	A	T	5	2	7	0	0	7	0	0
2	201995779	rs12620435	A	G	10	12	22	0	0	22	0	0
2	201997292	rs55953858	G	A	6	10	16	0	1	17	0	0
2	201999283	rs58886660	A	G	5	1	6	0	0	6	0	0
2	201999845	rs16836710	C	T	4	3	7	0	0	7	0	0
2	202003010	rs7560613	T	C	32	42	74	0	0	74	0	0
2	202003170	rs7573256	A	G	46	42	88	0	0	88	0	0
2	202003767	rs113350756	G	A	50	55	105	0	0	105	0	0
2	202004190	rs10184098	G	C	78	85	163	0	2	165	0	0
2	202006096	rs10190751	G	A	4	43	47	0	3	50	0	0
2	202019094	rs56009967	C	G	5	5	10	0	0	10	0	0
2	202025131	rs2518142	G	A	3	3	6	0	0	6	0	0
2	202025621	rs1594	A	G	49	79	128	0	3	131	0	0
2	202028491	rs72931066	G	A	35	42	77	0	0	77	0	0
2	202029803	rs11545280	A	G	11	18	29	0	0	29	0	0
2	202030991	rs13417405	A	C	3	4	7	0	0	7	0	0
2	202031204	rs9277311	G	A	17	16	33	0	4	37	0	0
2	202031483	rs187158152	C	T	24	31	55	0	0	55	0	0
2	202031516	rs13033140	T	C	27	26	53	0	1	54	0	0
2	202031698	rs58679595	G	A	5	7	12	0	1	13	0	0
2	202032171	rs11899871	A	G	49	47	96	0	0	96	0	0
2	202032427	rs10200857	A	G	27	31	58	0	0	58	0	0
2	202033322	rs76410935	T	C	26	25	51	0	1	52	0	0
2	202033757	rs6754832	C	T	22	21	43	0	0	43	0	0
2	202035064	rs13034255	G	A	15	14	29	0	0	29	0	0
2	202036044	rs72931076	A	T	23	25	48	0	0	48	0	0
2	202036235	rs116616115	C	T	61	80	141	0	1	142	0	0
2	202039524	rs72931083	G	A	5	1	6	0	0	6	0	0
2	202050677	rs3900115	A	G	21	19	40	0	1	41	0	0
2	202061050	rs13391950	C	G	5	2	7	0	0	7	0	0
2	202062389	rs41397649	C	T	2	4	6	0	0	6	0	0
2	202063350	rs41504752	G	A	5	2	7	0	0	7	0	0
2	202064766	rs41519249	C	T	13	8	21	0	0	21	0	0
2	202073232	rs17672977	A	G	6	6	12	0	0	12	0	0
2	202082741	rs3931696	G	A	21	19	40	0	3	43	0	0
2	202082749	rs3851974	G	A	22	16	38	0	1	39	0	0
2	202083279	rs17860409	C	T	49	28	77	0	1	78	0	0
2	202083984	rs41331447	C	T	49	44	93	0	0	93	0	0
2	202100958	rs13390902	C	T	2	4	6	0	0	6	0	0
2	202142039	rs13424920	T	C	1	15	16	0	0	16	0	0
2	202143032	rs8179786	C	T	10	6	16	0	0	16	0	0
2	202143257	rs13027605	T	A	8	1	9	0	0	9	0	0
2	202145606	rs11681399	A	G	31	3	34	0	0	34	0	0
2	202145612	rs10804111	C	T	32	3	35	0	0	35	0	0
2	202151439	rs3185378	G	C	146	191	337	0	2	339	0	0
2	202151492	rs2141331	C	T	215	127	342	0	0	342	0	0
2	202151728	rs17860432	G	C	230	157	387	0	11	398	0	0
2	202152162	rs13113	T	A	90	130	220	0	4	224	0	0
2	202161033	rs13029511	T	C	4	2	6	0	0	6	0	0
2	202242135	rs8105	T	C	6	6	12	0	0	12	0	0
2	202242307	rs7616	C	G	4	2	6	0	0	6	0	0
2	202337730	rs1019299	A	G	16	10	26	0	0	26	0	0
2	202342402	rs12990557	G	T	17	11	28	0	0	28	0	0
2	202345476	rs2110748	C	A	11	9	20	0	0	20	0	0
2	206862015	rs10192718	G	A	26	32	58	0	1	59	0	0
2	206863874	rs818026	C	T	42	36	78	0	0	78	0	0
2	206864764	rs818025	C	T	10	12	22	0	0	22	0	0
2	206865246	rs115189804	A	G	17	18	35	0	0	35	0	0
2	206866780	rs4675582	C	T	14	13	27	0	0	27	0	0
2	206867762	rs17309042	A	G	7	9	16	0	0	16	0	0
2	206868722	rs1062344	C	T	12	9	21	0	0	21	0	0
2	206875563	rs35359010	G	A	6	4	10	0	0	10	0	0
2	206892406	rs2199570	C	T	6	4	10	0	0	10	0	0
2	206921451	rs818009	G	A	12	18	30	0	0	30	0	0
2	206979680	rs10479	C	T	16	11	27	0	1	28	0	0
2	207006676	rs1801318	T	C	58	47	105	0	0	105	0	0
2	207025660	rs141966094	A	G	46	46	92	0	1	93	0	0
2	207564996	rs16838601	G	A	3	5	8	0	0	8	0	0
2	207603234	rs2287631	T	G	3	6	9	0	0	9	0	0
2	207941850	rs1263599	C	T	43	48	91	0	0	91	0	0
2	207942712	rs77710710	A	G	47	48	95	0	0	95	0	0
2	207942862	rs13035688	T	A	36	33	69	0	1	70	0	0
2	207942894	rs6725221	C	G	45	50	95	0	0	95	0	0
2	207943635	.	A	C	52	50	102	0	1	103	0	0
2	207975211	rs2269079	T	C	3	8	11	0	0	11	0	0
2	207975577	rs1881933	C	T	4	10	14	0	0	14	0	0
2	207975591	rs1881934	A	T	3	9	12	0	0	12	0	0
2	207976051	rs2244781	G	C	1	5	6	0	0	6	0	0
2	207981241	rs2244089	T	G	7	9	16	0	0	16	0	0
2	207981258	rs12328563	C	T	10	8	18	0	0	18	0	0
2	207981781	rs1263623	T	C	16	21	37	0	1	38	0	0
2	207982585	rs2287503	C	A	10	10	20	0	0	20	0	0
2	207983196	rs1263621	A	G	8	11	19	0	0	19	0	0
2	207983477	rs1270789	T	C	5	2	7	0	0	7	0	0
2	207983701	rs10170498	A	T	6	6	12	0	0	12	0	0
2	207984514	rs4675647	G	A	11	12	23	0	0	23	0	0
2	207984651	rs2284936	C	T	45	41	86	0	0	86	0	0
2	207985071	rs2254807	T	G	32	13	45	0	0	45	0	0
2	207985464	rs2284935	C	A	43	30	73	0	1	74	0	0
2	207986063	rs2269078	T	A	40	28	68	0	0	68	0	0
2	207986109	rs2254694	C	T	26	30	56	0	0	56	0	0
2	207986297	rs2269077	C	T	44	32	76	0	0	76	0	0
2	207986713	rs2543596	C	T	41	30	71	0	2	73	0	0
2	207987403	rs2254502	C	T	28	21	49	0	1	50	0	0
2	207987739	rs2269076	C	T	9	15	24	0	0	24	0	0
2	208010353	rs3791995	C	G	19	25	44	0	1	45	0	0
2	208012509	rs2284932	G	A	13	12	25	0	1	26	0	0
2	208013555	rs12466923	C	A	17	19	36	0	0	36	0	0
2	208031724	rs2269070	G	C	4	7	11	0	0	11	0	0
2	208434780	rs571279257	A	C	4	3	7	0	0	7	0	0
2	208619712	rs146898844	G	A	13	3	16	0	0	16	0	0
2	208732702	rs17537190	T	C	4	8	12	0	0	12	0	0
2	208841133	rs4021953	A	G	2	5	7	0	0	7	0	0
2	208841964	rs4441448	A	G	13	7	20	0	0	20	0	0
2	208863285	rs930746	G	T	6	1	7	0	0	7	0	0
2	209200005	rs41308216	A	G	4	4	8	0	0	8	0	0
2	209332455	rs2576810	T	C	6	1	7	0	0	7	0	0
2	209358027	rs3820900	C	T	16	17	33	0	0	33	0	0
2	209359062	rs1057392	T	C	24	25	49	0	0	49	0	0
2	213866353	rs12996008	A	G	3	4	7	0	1	8	0	0
2	213866691	.	A	G	9	14	23	0	1	24	0	0
2	213866803	rs73087329	T	C	7	7	14	0	1	15	0	0
2	213868435	rs72944379	A	G	4	7	11	0	1	12	0	0
2	213869354	rs17277107	C	T	9	8	17	0	1	18	0	0
2	213870535	rs72944382	C	T	12	9	21	0	0	21	0	0
2	213870678	rs7607184	T	C	6	7	13	0	1	14	0	0
2	213870875	rs12622131	T	C	4	6	10	0	0	10	0	0
2	213870894	rs7593379	C	T	5	7	12	0	0	12	0	0
2	213870965	rs72944387	C	T	5	3	8	0	0	8	0	0
2	214012508	rs6709554	C	T	21	13	34	0	2	36	0	0
2	214018324	rs7583371	C	T	1	5	6	0	0	6	0	0
2	215638662	rs6750341	A	G	11	6	17	0	0	17	0	0
2	215645545	rs2070096	C	G	21	20	41	0	0	41	0	0
2	215674224	rs1048108	G	A	6	6	12	0	0	12	0	0
2	215674323	rs1129804	C	G	4	2	6	0	0	6	0	0
2	215674371	rs34732883	C	T	4	2	6	0	0	6	0	0
2	216190020	rs2372536	C	G	27	6	33	0	0	33	0	0
2	216190832	.	T	C	39	28	67	0	1	68	0	0
2	216198957	rs79077644	C	T	1	6	7	0	0	7	0	0
2	216212089	rs4673991	C	T	8	7	15	0	0	15	0	0
2	216212339	rs4673993	T	C	13	17	30	0	0	30	0	0
2	216820354	rs10211101	C	T	2	4	6	0	0	6	0	0
2	216975305	rs828909	G	A	20	20	40	0	1	41	0	0
2	216977028	rs828910	A	G	24	19	43	0	0	43	0	0
2	216977323	rs828911	G	A	23	13	36	0	0	36	0	0
2	216978518	rs1364724	A	T	28	26	54	0	0	54	0	0
2	216978522	rs1364725	T	C	29	28	57	0	0	57	0	0
2	216981186	rs705649	G	A	80	50	130	0	0	130	0	0
2	216982178	rs705650	G	A	42	53	95	0	2	97	0	0
2	217012901	rs207906	A	G	326	286	612	0	3	615	0	0
2	217070248	rs1051677	T	C	106	126	232	0	0	232	0	0
2	217070652	rs6941	C	A	237	250	487	0	4	491	0	0
2	217315787	rs2066527	T	C	7	3	10	0	0	10	0	0
2	217364539	rs284572	C	T	21	15	36	0	0	36	0	0
2	217365238	rs72950603	A	G	25	21	46	0	0	46	0	0
2	217366995	rs3108223	G	A	130	64	194	0	0	194	0	0
2	217367270	rs3087590	G	A	49	61	110	0	0	110	0	0
2	218290048	rs10804260	C	T	2	4	6	0	0	6	0	0
2	218666889	rs4674215	G	A	7	11	18	0	0	18	0	0
2	218667372	rs3791979	T	C	4	7	11	0	0	11	0	0
2	218667836	rs3088214	G	A	8	12	20	0	1	21	0	0
2	218668732	rs1063281	C	T	16	18	34	0	0	34	0	0
2	218674697	rs918949	C	T	7	14	21	0	0	21	0	0
2	218683154	rs2571445	A	G	5	3	8	0	0	8	0	0
2	218747073	rs11680854	A	C	11	6	17	0	0	17	0	0
2	219115080	rs149752174	T	C	4	2	6	0	0	6	0	0
2	219205954	rs58042983	T	C	20	23	43	0	0	43	0	0
2	219208477	rs2279016	C	G	2	5	7	0	0	7	0	0
2	219209796	rs921970	C	A	85	95	180	0	5	185	0	0
2	219209885	rs73088173	G	C	85	96	181	0	2	186	3	0
2	219210211	rs7586140	G	C	111	109	220	0	0	220	0	0
2	219252630	rs17221959	C	T	13	8	21	0	0	21	0	0
2	219259844	rs1059823	A	G	23	40	63	0	1	64	0	0
2	219260031	rs17229016	G	A	20	24	44	0	0	44	0	0
2	219260651	rs13062	C	A	15	23	38	0	1	39	0	0
2	219261176	rs2279014	C	T	29	29	58	0	0	59	1	0
2	219264107	rs2739049	G	A	6	3	9	0	0	9	0	0
2	219266423	rs2227251	C	A	73	91	164	0	2	166	0	0
2	219267781	rs2227255	C	T	92	68	160	0	2	162	0	0
2	219267913	rs2227258	A	G	4	7	11	0	0	11	0	0
2	219268698	rs2695339	A	G	4	9	13	0	0	13	0	0
2	219268803	rs2579959	G	A	16	14	30	0	0	30	0	0
2	219269729	rs3770211	G	T	115	127	242	0	3	245	0	0
2	219316303	rs2178019	G	A	5	3	8	0	0	8	0	0
2	219317248	rs3755042	T	C	21	22	43	0	0	43	0	0
2	219317695	rs115806209	A	G	17	6	23	0	0	23	0	0
2	219318078	rs4674310	T	C	20	9	29	0	0	29	0	0
2	219334613	rs511080	G	A	4	2	6	0	0	6	0	0
2	219335935	rs659185	C	T	13	9	22	0	0	22	0	0
2	219335944	rs10200507	C	A	5	2	7	0	0	7	0	0
2	219384384	rs667251	C	G	3	7	10	0	0	10	0	0
2	219386899	rs832802	C	T	6	2	8	0	0	8	0	0
2	219390967	rs10179708	T	A	32	34	66	0	1	67	0	0
2	219427597	rs593888	A	G	11	11	22	0	0	22	0	0
2	219428299	rs483172	T	C	7	4	11	0	0	11	0	0
2	219432569	rs496674	G	A	3	3	6	0	0	6	0	0
2	219432953	rs500317	G	C	40	19	59	0	0	59	0	0
2	219432995	rs500422	C	A	28	19	47	0	0	47	0	0
2	219433597	rs526897	G	A	10	7	17	0	0	17	0	0
2	219441428	rs647990	T	C	3	3	6	0	0	6	0	0
2	219443001	rs562510	A	C	6	2	8	0	0	8	0	0
2	219457731	rs10190250	C	T	14	19	33	0	0	33	0	0
2	219457741	rs585185	G	A	20	14	34	0	0	34	0	0
2	219458656	rs538483	T	C	21	9	30	0	0	30	0	0
2	219498759	rs7574429	T	G	12	6	18	0	0	18	0	0
2	219501133	rs2278530	G	A	5	6	11	0	0	11	0	0
2	219501328	rs1055816	G	A	13	7	20	0	0	20	0	0
2	219508372	rs3770213	A	T	10	12	22	0	0	22	0	0
2	219508988	rs3770214	T	C	15	16	31	0	0	31	0	0
2	219509618	rs2230115	C	A	11	14	25	0	0	25	0	0
2	219523433	rs4674324	T	G	11	3	14	0	0	14	0	0
2	219525335	rs3770218	C	T	2	5	7	0	0	7	0	0
2	219527005	rs2303561	C	T	33	35	68	0	0	68	0	0
2	219532903	rs2556384	C	T	4	3	7	0	0	7	0	0
2	219532905	rs2556385	G	A	4	3	7	0	0	7	0	0
2	219555262	rs1344642	G	A	6	6	12	0	0	12	0	0
2	219562675	rs1863704	G	A	6	13	19	0	0	19	0	0
2	219618497	rs6757772	T	G	3	3	6	0	0	6	0	0
2	219941063	rs897477	G	A	16	14	30	0	0	30	0	0
2	220037097	rs11236	C	T	208	211	419	0	5	424	0	0
2	220037666	rs1127102	A	G	157	149	306	0	1	307	0	0
2	220037756	rs1043160	A	G	195	215	410	0	3	413	0	0
2	220040330	rs1127101	A	G	133	150	283	0	4	287	0	0
2	220041091	rs6436123	G	A	3	4	7	0	0	7	0	0
2	220046349	rs2272017	G	C	2	5	7	0	0	7	0	0
2	220046975	rs3731900	C	A	83	71	154	0	8	162	0	0
2	220047393	rs3731901	C	T	95	98	193	0	1	194	0	0
2	220048150	rs7017	C	T	173	165	338	0	1	339	0	0
2	220048721	rs12694453	A	G	7	13	20	0	0	20	0	0
2	220048796	rs34157145	C	T	15	15	30	0	0	30	0	0
2	220048907	rs10932798	A	G	16	18	34	0	0	34	0	0
2	220049128	rs2385395	G	T	24	8	32	0	1	33	0	0
2	220049290	rs2385394	C	T	33	21	54	0	0	54	0	0
2	220049511	rs2385392	T	C	31	15	46	0	3	49	0	0
2	220072852	rs4674367	C	T	8	6	14	0	0	14	0	0
2	220084938	rs10799	C	T	181	171	352	0	1	353	0	0
2	220086541	rs72955431	A	G	13	9	22	0	0	22	0	0
2	220113384	rs8447	G	A	109	99	208	0	4	212	0	0
2	220113728	rs885854	G	A	35	23	58	0	0	58	0	0
2	220363917	rs719337	G	A	5	2	7	0	0	7	0	0
2	220371035	rs1046474	C	G	33	25	58	0	0	58	0	0
2	220404648	rs1043833	C	T	8	8	16	0	0	16	0	0
2	220404726	rs1043832	G	A	5	3	8	0	0	8	0	0
2	220405230	rs6436154	G	A	5	1	6	0	1	7	0	0
2	220406722	rs3731912	T	C	6	5	11	0	0	11	0	0
2	220415717	rs3731918	G	A	3	4	7	0	0	7	0	0
2	220420172	rs35372421	T	C	6	10	16	0	0	16	0	0
2	220420785	rs3087971	G	A	7	10	17	0	0	17	0	0
2	220421417	rs1983210	C	G	7	7	14	0	0	14	0	0
2	220422774	rs2278201	A	G	3	9	12	0	0	12	0	0
2	220427347	rs10804275	G	T	39	62	101	0	0	101	0	0
2	220427395	rs3183099	G	A	44	53	97	0	1	98	0	0
2	220430203	rs1039898	C	T	26	42	68	0	1	69	0	0
2	220435034	rs10180675	A	G	12	6	18	0	0	18	0	0
2	220438264	rs4674413	G	A	4	3	7	0	0	7	0	0
2	220439678	rs12720063	C	T	4	6	10	0	0	10	0	0
2	223488926	rs116721296	C	G	1	6	7	0	1	8	0	0
2	223765491	rs2119160	C	T	24	23	47	0	0	47	0	0
2	223804110	.	C	T	10	6	16	0	0	16	0	0
2	224743373	rs571111	C	T	92	88	180	0	3	183	0	0
2	224760007	rs34870657	T	G	4	9	13	0	0	13	0	0
2	224763918	rs73994414	G	A	12	11	23	0	1	24	0	0
2	224822669	rs1347818	T	C	4	8	12	0	0	12	0	0
2	224824002	rs13022402	C	A	5	2	7	0	0	7	0	0
2	224832115	.	A	G	182	188	370	0	4	375	1	0
2	224832136	rs1138616	C	G	198	180	378	0	5	384	1	0
2	224832161	rs1142417	G	A	199	192	391	0	0	391	0	0
2	224832346	rs10980	G	C	75	50	125	0	0	125	0	0
2	224842765	rs11689646	T	G	8	7	15	0	0	15	0	0
2	224847005	rs6754490	G	A	9	3	12	0	0	12	0	0
2	224862842	rs12457	A	G	30	32	62	0	1	63	0	0
2	224864185	rs13392268	G	A	47	30	77	0	0	77	0	0
2	224864256	rs13392374	G	A	45	29	74	0	0	74	0	0
2	224864350	rs13392495	G	A	44	21	65	0	0	65	0	0
2	224864440	rs13392412	C	T	33	17	50	0	0	50	0	0
2	224864508	rs13392722	G	C	28	13	41	0	1	42	0	0
2	224865006	rs10177151	G	C	28	10	38	0	0	38	0	0
2	224865065	rs10189547	T	C	15	12	27	0	0	27	0	0
2	224865817	rs10203588	A	C	12	9	21	0	0	21	0	0
2	224866088	rs150970371	G	A	13	5	18	0	0	18	0	0
2	224866177	rs3795877	A	G	13	4	17	0	0	17	0	0
2	225338022	rs3768897	G	A	16	13	29	0	1	30	0	0
2	225343447	rs3768895	T	G	2	4	6	0	0	6	0	0
2	225346646	rs2070127	T	C	282	284	566	0	4	571	1	0
2	225347445	rs3754631	C	T	4	5	9	0	0	9	0	0
2	225348820	rs62186973	C	A	6	3	9	0	0	9	0	0
2	225350420	rs2396093	T	C	6	1	7	0	1	8	0	0
2	225350434	rs2396094	T	C	45	2	47	0	0	47	0	0
2	225359866	rs11688506	A	C	3	4	7	0	0	7	0	0
2	225362798	rs3820762	A	G	3	3	6	0	0	6	0	0
2	225363117	rs3768893	A	G	1	11	12	0	0	12	0	0
2	225363373	rs3768892	G	A	5	7	12	0	0	12	0	0
2	225364937	rs3768890	T	C	1	11	12	0	0	12	0	0
2	225365056	rs3768889	A	G	6	6	12	0	0	12	0	0
2	225365109	rs41373148	T	A	242	232	474	0	4	478	0	0
2	225366401	rs3768888	A	G	6	3	9	0	0	9	0	0
2	225369532	rs62186981	G	C	5	6	11	0	0	11	0	0
2	225370005	rs1963593	C	T	4	5	9	0	0	9	0	0
2	225373897	rs7585047	C	T	5	5	10	0	0	10	0	0
2	225374120	rs13027922	G	T	7	4	11	0	0	11	0	0
2	225376034	rs11686067	G	A	3	3	6	0	0	6	0	0
2	225376653	rs13024297	T	A	5	6	11	0	0	11	0	0
2	225377607	rs1523917	T	G	4	3	7	0	0	7	0	0
2	225380068	rs13019746	A	G	41	36	77	0	0	77	0	0
2	225380370	rs4673110	T	C	32	30	62	0	0	62	0	0
2	225383338	rs35324221	T	C	4	7	11	0	0	11	0	0
2	225385542	rs6759332	C	T	5	6	11	0	0	11	0	0
2	225390089	rs3912999	G	A	6	1	7	0	0	7	0	0
2	225416039	rs143450772	C	A	3	3	6	0	0	6	0	0
2	227795464	rs2396436	G	A	3	3	6	0	0	6	0	0
2	228189985	rs28365988	C	A	5	1	6	0	0	6	0	0
2	228190002	rs7562498	C	G	3	6	9	0	0	9	0	0
2	228194480	rs3211097	A	T	22	17	39	0	0	39	0	0
2	228194481	rs3211098	G	T	22	17	39	0	0	39	0	0
2	228205435	rs79662850	C	T	4	2	6	0	0	6	0	0
2	228211470	rs10177414	T	C	5	4	9	0	0	9	0	0
2	228216616	rs73994254	G	A	8	12	20	0	0	20	0	0
2	228216992	rs73997104	G	A	5	4	9	0	0	9	0	0
2	228220161	rs58426936	C	T	13	13	26	0	0	26	0	0
2	228220288	rs56310237	A	G	9	9	18	0	0	18	0	0
2	228221725	rs4844	A	G	414	339	753	0	3	756	0	0
2	228389979	rs4365454	G	C	5	5	10	0	0	10	0	0
2	228390260	rs4309569	G	A	5	1	6	0	0	6	0	0
2	228391002	rs10804334	T	C	5	6	11	0	0	11	0	0
2	228391234	rs4972992	A	G	7	4	11	0	0	11	0	0
2	228392630	rs6436700	C	G	2	4	6	0	0	6	0	0
2	228393168	rs4972983	C	A	22	12	34	0	0	34	0	0
2	228393823	rs7608104	C	T	42	31	73	0	1	74	0	0
2	228393924	rs7569200	T	A	38	24	62	0	2	64	0	0
2	228394067	rs6436701	T	G	36	26	62	0	3	65	0	0
2	228395006	rs6707385	G	C	103	51	154	0	1	155	0	0
2	228411187	rs10933192	T	C	4	3	7	0	0	7	0	0
2	228416712	rs13426457	A	G	251	184	435	0	2	437	0	0
2	228423689	rs4555337	G	A	33	24	57	0	1	58	0	0
2	228423771	rs4312485	C	G	74	47	121	0	0	121	0	0
2	228424730	rs6706723	C	T	40	37	77	0	0	77	0	0
2	230630632	rs35381244	G	A	8	15	23	0	0	23	0	0
2	230634948	rs13015202	G	A	5	3	8	0	0	8	0	0
2	230637272	rs7565780	T	C	9	8	17	0	0	17	0	0
2	230659045	rs60094003	G	A	4	4	8	0	0	8	0	0
2	230659346	rs146786682	G	C	5	7	12	0	1	13	0	0
2	230668858	rs13018957	T	C	41	28	69	0	0	69	0	0
2	230723057	rs59234368	C	T	3	5	8	0	0	8	0	0
2	230723777	rs544480	G	C	59	50	109	0	0	109	0	0
2	230786689	rs113340201	G	C	6	1	7	0	0	7	0	0
2	230861519	rs1035834	G	T	4	4	8	0	0	8	0	0
2	230901647	rs13432082	A	G	2	4	6	0	0	6	0	0
2	231030411	rs1060759	A	G	8	4	12	0	0	12	0	0
2	231030733	rs1137605	T	C	14	8	22	0	1	23	0	0
2	231031000	rs1137604	T	G	12	10	22	0	0	22	0	0
2	231031009	rs4624369	G	A	13	11	24	0	1	25	0	0
2	231031039	rs4283410	T	C	16	14	30	0	0	30	0	0
2	231031321	rs72992486	C	T	6	6	12	0	0	12	0	0
2	231031365	rs13026113	A	G	5	13	18	0	0	18	0	0
2	231031376	rs13026121	A	G	7	16	23	0	0	23	0	0
2	231031467	rs13026878	G	C	16	25	41	0	1	42	0	0
2	231031811	rs2162479	G	C	10	0	10	0	3	13	0	0
2	231031921	rs2114586	C	T	10	4	14	0	0	14	0	0
2	231032048	rs4973278	C	G	2	6	8	0	0	8	0	0
2	231032372	rs10210254	A	G	11	15	26	0	0	26	0	0
2	231033288	rs7583955	A	C	6	8	14	0	0	14	0	0
2	231036860	rs3948463	C	T	7	5	12	0	0	12	0	0
2	231036866	rs13018234	G	A	6	7	13	0	0	13	0	0
2	231037481	rs12995739	T	G	5	3	8	0	0	8	0	0
2	231037616	rs35495464	A	G	4	2	6	0	0	6	0	0
2	231038640	rs2162478	G	A	3	4	7	0	0	7	0	0
2	231041106	rs41309112	A	G	6	2	8	0	0	8	0	0
2	231041940	rs41543719	G	C	19	13	32	0	0	32	0	0
2	231043270	rs957682	A	C	1	5	6	0	0	7	1	0
2	231050715	rs3948464	A	G	69	52	121	0	2	123	0	0
2	231062616	rs1007661	T	C	2	4	6	0	0	6	0	0
2	231077112	rs28930679	G	A	61	46	107	0	2	109	0	0
2	231077725	rs1129411	A	G	44	47	91	0	2	93	0	0
2	231322831	rs112983309	G	T	3	8	11	0	0	11	0	0
2	231326188	rs11692640	A	G	13	7	20	0	0	20	0	0
2	231326201	rs11681514	C	G	13	7	20	0	0	20	0	0
2	231407663	rs9288668	C	T	36	23	59	0	0	59	0	0
2	231409760	rs6728689	G	A	83	95	178	0	4	182	0	0
2	231409854	rs1678185	C	T	98	87	185	0	1	186	0	0
2	231410149	rs1649901	G	A	65	47	112	0	2	114	0	0
2	231587108	rs62193606	G	A	8	7	15	0	0	15	0	0
2	231663955	rs115155017	C	T	41	28	69	0	0	69	0	0
2	231665946	rs3792074	T	C	4	2	6	0	0	6	0	0
2	231668397	rs9752613	G	A	9	10	19	0	0	19	0	0
2	231681301	rs2438298	A	G	2	4	6	0	0	6	0	0
2	231685198	rs726379	A	G	204	189	393	0	8	401	0	0
2	231685205	rs10006	T	C	209	191	400	0	7	407	0	0
2	231995770	rs59886388	G	C	3	3	6	0	0	6	0	0
2	232030861	rs2303349	A	G	4	5	9	0	0	9	0	0
2	232031217	rs77542239	G	A	4	3	7	0	0	7	0	0
2	232034342	rs1025107	C	T	18	12	30	0	0	30	0	0
2	232035429	rs6749	G	A	137	174	311	0	2	313	0	0
2	232035793	rs2032953	C	T	66	11	77	0	1	78	0	0
2	232573292	rs12415	T	C	737	724	1461	0	8	1469	0	0
2	232573301	rs8868	C	T	837	805	1642	0	10	1652	0	0
2	232573780	rs3087853	C	G	9	10	19	0	0	19	0	0
2	232574504	rs2060412	C	T	14	3	17	0	0	17	0	0
2	232574807	rs2241742	C	G	33	20	53	0	0	53	0	0
2	232656297	rs41265109	G	A	3	5	8	0	0	8	0	0
2	232952286	rs11887184	A	G	10	11	21	0	1	22	0	0
2	232998932	.	G	C	3	3	6	0	0	6	0	0
2	233000699	rs3103258	G	A	8	4	12	0	0	12	0	0
2	233181344	rs6743962	G	C	2	4	6	0	0	6	0	0
2	233199246	rs1814893	G	A	6	9	15	0	0	15	0	0
2	233200849	rs9678004	A	G	7	9	16	0	0	16	0	0
2	233205600	rs56083600	A	G	3	4	7	0	0	7	0	0
2	233207862	rs3924438	C	T	2	5	7	0	0	7	0	0
2	233207977	rs1125045	C	G	2	5	7	0	1	8	0	0
2	233208534	rs6711186	T	C	5	4	9	0	0	9	0	0
2	233412820	rs4973539	A	G	11	14	25	0	1	26	0	0
2	233413648	rs72991949	G	A	26	17	43	0	0	43	0	0
2	233413771	rs6752614	C	T	12	10	22	0	1	23	0	0
2	233414341	rs4973540	C	T	8	9	17	0	1	18	0	0
2	233414660	rs4973541	G	A	6	12	18	0	0	18	0	0
2	233414721	rs11683262	C	T	8	6	14	0	0	14	0	0
2	233414832	rs11689217	T	G	10	3	13	0	0	13	0	0
2	233432633	rs3791712	A	T	7	7	14	0	0	14	0	0
2	233432883	rs3791711	A	G	9	9	18	0	0	18	0	0
2	233446821	rs6437068	A	G	8	10	18	0	0	18	0	0
2	233599904	rs11555646	A	C	18	7	25	0	0	25	0	0
2	233602028	rs6738386	T	C	6	3	9	0	0	9	0	0
2	233602293	rs66549961	A	G	14	7	21	0	0	21	0	0
2	233603065	rs2344613	C	G	6	11	17	0	0	17	0	0
2	233606740	rs7606090	T	C	2	4	6	0	0	6	0	0
2	233608901	rs11687128	T	C	5	2	7	0	0	7	0	0
2	233681512	rs1078323	T	G	13	16	29	0	1	30	0	0
2	233683245	rs1446310	G	C	2	4	6	0	0	6	0	0
2	233683984	rs13001052	C	T	4	2	6	0	0	6	0	0
2	233708806	rs3816334	A	G	65	43	108	0	3	111	0	0
2	233712296	rs6437074	G	A	11	0	11	0	0	11	0	0
2	233721455	rs1947105	G	A	8	5	13	0	0	13	0	0
2	233723182	rs1284	G	A	82	81	163	0	3	166	0	0
2	233724536	rs7589201	A	G	5	2	7	0	0	7	0	0
2	233942699	rs7598195	G	A	1	6	7	0	0	7	0	0
2	233953940	rs7566856	G	A	5	3	8	0	0	8	0	0
2	233956424	rs57905758	A	G	2	4	6	0	0	6	0	0
2	233957464	rs10201551	A	G	2	7	9	0	0	9	0	0
2	233958813	rs538059023	C	A	8	5	13	0	0	13	0	0
2	233959770	rs74775430	G	A	8	5	13	0	0	13	0	0
2	233963437	rs72984219	C	G	5	3	8	0	0	8	0	0
2	234054873	rs1135173	G	A	65	67	132	0	1	133	0	0
2	234066969	rs36127492	C	G	85	85	170	0	1	171	0	0
2	234067884	rs36133610	G	A	2	4	6	0	0	6	0	0
2	234068006	rs74222529	C	T	2	4	6	0	0	6	0	0
2	234068068	rs67498812	A	G	2	4	6	0	0	6	0	0
2	234069266	rs28534487	C	A	9	11	20	0	1	21	0	0
2	234069323	rs28655385	C	A	22	17	39	0	0	39	0	0
2	234069512	rs28459768	A	C	16	7	23	0	0	23	0	0
2	234069520	rs28538620	A	G	6	13	19	0	1	20	0	0
2	234069537	rs28593218	T	C	7	12	19	0	0	19	0	0
2	234069764	rs28478933	C	A	14	12	26	0	1	27	0	0
2	234069811	rs28429042	C	T	16	11	27	0	1	28	0	0
2	234069980	rs28631646	C	T	10	7	17	0	0	17	0	0
2	234070042	rs28539971	G	A	13	8	21	0	0	21	0	0
2	234070085	rs35877172	C	T	14	7	21	0	1	22	0	0
2	234070171	rs28605534	G	C	21	22	43	0	0	43	0	0
2	234070190	rs28609111	G	A	19	19	38	0	3	41	0	0
2	234070233	rs28576692	T	C	17	17	34	0	0	34	0	0
2	234078333	rs10803668	G	T	35	34	69	0	0	69	0	0
2	234078582	rs10754947	G	A	28	20	48	0	1	49	0	0
2	234109422	rs150889258	C	T	5	6	11	0	0	11	0	0
2	234110944	rs6760912	A	G	2	4	6	0	0	6	0	0
2	234113545	rs1135727	A	G	13	12	25	0	0	25	0	0
2	234114243	rs62192898	G	C	9	8	17	0	0	17	0	0
2	234114837	rs4663784	C	T	7	13	20	0	1	21	0	0
2	234114942	rs13408498	T	C	5	7	12	0	0	12	0	0
2	234115739	rs14243	A	G	194	154	348	0	1	349	0	0
2	234199461	rs6754677	G	A	11	5	16	0	0	16	0	0
2	234199537	rs6431262	G	T	8	7	15	0	0	15	0	0
2	234202321	rs3749079	C	T	11	4	15	0	0	15	0	0
2	234203547	rs1045095	T	C	119	112	231	0	0	231	0	0
2	234203597	rs1045100	T	C	101	89	190	0	3	193	0	0
2	234355898	rs2971859	G	C	24	10	34	0	1	35	0	0
2	234356807	rs10208953	G	A	46	45	91	0	0	91	0	0
2	234373701	rs116663413	C	T	6	6	12	0	0	12	0	0
2	234378745	rs2971873	G	A	76	92	168	0	1	169	0	0
2	234380308	.	A	G	141	147	288	0	4	292	0	0
2	234380666	rs2026	C	T	77	80	157	0	1	158	0	0
2	234385585	rs13408490	G	A	10	20	30	0	0	30	0	0
2	234385874	rs150881606	G	T	18	15	33	0	0	33	0	0
2	234456041	rs148910750	T	C	5	5	10	0	0	10	0	0
2	234749258	rs10511	T	C	178	178	356	0	2	358	0	0
2	234749354	rs12582	G	A	124	132	256	0	1	257	0	0
2	234749780	rs3821238	G	C	98	109	207	0	1	208	0	0
2	235950187	rs1469375	T	C	17	16	33	0	0	33	0	0
2	235951183	rs140262787	G	A	11	22	33	0	0	33	0	0
2	235951819	rs3795962	A	G	14	19	33	0	0	33	0	0
2	235952592	rs67041420	C	T	8	9	17	0	0	17	0	0
2	235953160	rs6757025	G	A	11	15	26	0	1	27	0	0
2	235954162	rs2379178	A	G	10	9	19	0	2	21	0	0
2	237996889	rs72973998	A	G	7	6	13	0	1	14	0	0
2	238617753	rs3769095	C	T	2	5	7	0	0	7	0	0
2	238621790	rs3769090	C	T	6	2	8	0	0	8	0	0
2	238623413	rs2047169	G	A	4	3	7	0	0	7	0	0
2	238630553	rs1038986	T	C	9	7	16	0	0	16	0	0
2	238631222	rs45578339	A	G	5	1	6	0	0	6	0	0
2	238631747	rs3769086	C	T	9	10	19	0	0	19	0	0
2	238631907	rs3820813	A	G	10	7	17	0	0	17	0	0
2	238635137	rs10177762	A	C	21	14	35	0	0	35	0	0
2	238638497	rs869435	T	C	4	2	6	0	1	7	0	0
2	238638531	rs869434	A	G	6	2	8	0	0	8	0	0
2	238640305	rs3820811	G	T	4	3	7	0	0	7	0	0
2	238641117	rs56182016	C	T	3	3	6	0	0	6	0	0
2	238641521	rs3769080	C	T	4	3	7	0	0	7	0	0
2	238641963	rs3754721	G	A	5	8	13	0	0	13	0	0
2	238643907	rs3769078	G	A	7	8	15	0	0	15	0	0
2	238649173	rs55948570	C	T	4	3	7	0	0	7	0	0
2	238651706	rs2279647	C	T	1	5	6	0	1	7	0	0
2	238655484	rs3754717	G	A	4	5	9	0	1	10	0	0
2	238668802	rs3213868	A	G	96	80	176	0	8	184	0	0
2	238669150	rs56230769	G	C	27	16	43	0	0	43	0	0
2	238669484	rs56001807	T	C	19	15	34	0	0	34	0	0
2	238670016	rs12613148	G	A	12	17	29	0	0	29	0	0
2	238671117	rs734388	A	G	18	32	50	0	1	51	0	0
2	238671328	rs868119	A	G	126	99	225	0	2	227	0	0
2	238672703	rs3739038	C	G	184	163	347	0	0	347	0	0
2	238673302	rs55874185	T	A	87	77	164	0	0	164	0	0
2	238674555	rs62194228	G	A	15	6	21	0	0	21	0	0
2	238675892	rs10179864	A	G	9	13	22	0	0	22	0	0
2	238676449	rs3806505	A	G	15	17	32	0	0	32	0	0
2	238676835	rs3806504	A	G	5	10	15	0	0	15	0	0
2	238676956	rs3806503	A	G	5	5	10	0	0	10	0	0
2	238677188	rs62194229	C	T	5	11	16	0	1	17	0	0
2	238677230	rs77742279	G	A	1	10	11	0	0	11	0	0
2	238677316	rs62194230	T	C	6	9	15	0	0	15	0	0
2	238677614	rs12617354	A	G	34	25	59	0	0	59	0	0
2	238677841	rs55663452	C	T	48	48	96	0	0	96	0	0
2	238678001	rs76248225	T	G	40	42	82	0	0	82	0	0
2	238678002	rs76642509	C	G	40	41	81	0	1	82	0	0
2	238678004	rs75319932	A	G	36	41	77	0	3	80	0	0
2	238678875	rs6719679	A	G	6	3	9	0	0	9	0	0
2	238680442	rs2289094	T	C	8	11	19	0	0	19	0	0
2	238689063	rs11694510	T	C	2	4	6	0	0	6	0	0
2	238689369	rs6739130	A	G	7	10	17	0	0	17	0	0
2	238689558	rs11686141	A	G	7	8	15	0	2	17	0	0
2	238689938	rs56109444	T	G	11	12	23	0	0	23	0	0
2	238689995	rs55711794	C	T	12	11	23	0	0	23	0	0
2	238690424	rs13411625	A	T	6	6	12	0	0	12	0	0
2	238692996	rs35828868	T	C	4	4	8	0	0	8	0	0
2	238694547	rs1151800	G	A	1	6	7	0	0	7	0	0
2	238733016	rs4663795	G	A	5	3	8	0	0	8	0	0
2	238751083	rs62196146	C	G	14	10	24	0	0	24	0	0
2	239079986	rs111284824	G	C	12	22	34	0	0	34	0	0
2	239080093	rs12616232	C	T	13	20	33	0	1	34	0	0
2	239080812	rs62194872	C	T	10	8	18	0	0	18	0	0
2	239081808	rs7568705	C	T	5	6	11	0	1	12	0	0
2	239082976	rs2880132	G	A	25	22	47	0	0	47	0	0
2	239083167	rs4663854	T	C	23	26	49	0	1	50	0	0
2	239083826	rs2121404	A	G	14	19	33	0	0	33	0	0
2	239084104	rs13001876	C	A	14	13	27	0	0	27	0	0
2	239084119	rs6726348	C	T	13	11	24	0	0	24	0	0
2	239084197	rs13000667	G	A	16	15	31	0	1	32	0	0
2	239084602	rs67102443	A	G	9	12	21	0	0	21	0	0
2	239085687	rs1374387	T	G	2	6	8	0	1	9	0	0
2	239087912	rs12731	G	A	15	20	35	0	0	35	0	0
2	239089151	rs2880131	A	C	8	13	21	0	0	21	0	0
2	239089624	rs4663856	C	A	14	21	35	0	1	36	0	0
2	239089937	rs4663857	A	G	9	8	17	0	0	17	0	0
2	239091086	rs56236115	T	C	4	3	7	0	0	7	0	0
2	239092054	rs11677230	T	C	10	6	16	0	1	17	0	0
2	239092544	rs74653364	G	A	7	3	10	0	0	10	0	0
2	239092893	rs12623230	C	T	10	9	19	0	0	19	0	0
2	239094338	rs34413717	G	C	8	12	20	0	0	20	0	0
2	239095422	rs12472274	G	A	14	7	21	0	1	22	0	0
2	239095671	rs35776070	T	C	9	12	21	0	1	22	0	0
2	239095763	rs34953477	A	G	9	7	16	0	0	16	0	0
2	239097959	rs68054903	G	A	15	14	29	0	2	31	0	0
2	239098006	rs35165235	C	G	25	20	45	0	0	45	0	0
2	239098871	rs57094190	C	A	6	7	13	0	0	13	0	0
2	239099917	rs34072650	A	C	7	5	12	0	0	12	0	0
2	239100344	rs34464738	G	T	4	3	7	0	0	7	0	0
2	239100503	rs112667120	G	A	3	6	9	0	1	10	0	0
2	239100584	rs34700572	C	A	6	7	13	0	0	13	0	0
2	239101116	rs56202577	G	A	3	5	8	0	0	8	0	0
2	239102292	rs62194900	A	G	5	4	9	0	0	9	0	0
2	239134803	rs1199033	C	T	6	6	12	0	0	12	0	0
2	239134852	rs78323382	G	A	3	8	11	0	0	11	0	0
2	239155971	rs36124720	C	G	2	5	7	0	0	7	0	0
2	239237953	rs12464423	G	T	3	6	9	0	0	9	0	0
2	239357687	.	C	G	2	4	6	0	0	6	0	0
2	239358852	rs514795	A	T	6	7	13	0	0	13	0	0
2	239972080	rs74759164	T	A	4	3	7	0	0	7	0	0
2	239973454	rs79925675	T	C	2	6	8	0	0	8	0	0
2	240890391	rs11684940	C	T	4	2	6	0	0	6	0	0
2	240897085	rs7573892	C	T	41	50	91	0	0	91	0	0
2	240897331	rs34277046	G	A	43	51	94	0	1	95	0	0
2	240898226	rs1132778	C	T	13	18	31	0	0	31	0	0
2	240899346	rs66534347	G	A	16	17	33	0	0	33	0	0
2	240900121	rs13424612	C	T	8	7	15	0	0	15	0	0
2	240900227	rs8369	G	A	94	75	169	0	0	169	0	0
2	240900691	rs4077387	C	G	7	3	10	0	0	10	0	0
2	240900919	rs10206993	C	A	7	5	12	0	0	12	0	0
2	240900947	rs7590071	G	C	6	5	11	0	1	12	0	0
2	240901290	rs7577635	T	C	3	5	8	0	0	8	0	0
2	240902511	rs6748327	G	A	3	5	8	0	0	8	0	0
2	240902988	rs4076744	G	C	3	3	6	0	1	7	0	0
2	240904088	rs56780904	G	A	5	1	6	0	0	6	0	0
2	240905550	rs6437355	G	C	3	3	6	0	0	6	0	0
2	240908800	rs10189996	G	A	3	3	6	0	0	6	0	0
2	240946766	rs13848	T	C	81	115	196	0	0	196	0	0
2	240951603	rs12478169	C	T	8	6	14	0	0	14	0	0
2	240952002	rs34789127	C	T	6	10	16	0	1	17	0	0
2	240953374	rs2278592	G	A	7	8	15	0	0	15	0	0
2	240954079	rs11693245	G	A	6	6	12	0	1	13	0	0
2	240954110	rs2289407	A	G	5	7	12	0	0	12	0	0
2	240964714	rs11541494	G	C	24	19	43	0	0	43	0	0
2	241463639	rs3796119	C	T	7	3	10	0	0	10	0	0
2	241501589	rs138169951	C	A	4	4	8	0	0	8	0	0
2	241503242	rs1128152	C	T	57	54	111	0	0	111	0	0
2	241507613	rs115219347	G	A	2	9	11	0	0	11	0	0
2	241512328	rs3762628	C	T	3	3	6	0	0	6	0	0
2	241512470	rs2001823	G	T	4	2	6	0	1	7	0	0
2	241515252	rs2953146	G	A	8	12	20	0	0	20	0	0
2	241515596	rs2953145	G	C	14	20	34	0	0	34	0	0
2	241515813	rs2975794	C	T	56	49	105	0	0	105	0	0
2	241517770	rs8662	G	A	223	222	445	0	5	450	0	0
2	241522634	rs2975754	G	A	5	5	10	0	0	10	0	0
2	241529215	rs12620622	G	A	4	2	6	0	0	6	0	0
2	241530616	rs2975757	A	T	11	5	16	0	0	16	0	0
2	241530750	rs2975758	G	A	10	3	13	0	0	13	0	0
2	241530793	rs2975759	A	G	15	5	20	0	0	20	0	0
2	241531163	rs2975760	T	C	6	4	10	0	0	10	0	0
2	241531479	rs3792269	A	G	21	13	34	0	1	35	0	0
2	241531584	rs2975761	G	A	6	4	10	0	0	10	0	0
2	241532559	rs41266975	G	C	11	6	17	0	0	17	0	0
2	241532620	rs56783920	C	A	13	5	18	0	0	18	0	0
2	241533030	rs3792273	T	C	12	4	16	0	0	16	0	0
2	241533512	rs17846970	T	A	6	1	7	0	0	7	0	0
2	241533559	rs17846971	C	T	7	6	13	0	0	13	0	0
2	241533845	rs2975763	T	C	6	4	10	0	0	10	0	0
2	241536053	rs2953171	C	T	12	2	14	0	0	14	0	0
2	241536126	rs7607759	A	G	18	4	22	0	0	22	0	0
2	241538061	rs55878652	T	C	6	1	7	0	0	7	0	0
2	241538229	rs2975767	A	G	80	21	101	0	0	101	0	0
2	241540110	rs12616820	A	G	3	3	6	0	0	6	0	0
2	242013387	rs13030338	C	T	5	2	7	0	0	7	0	0
2	242037409	rs140140457	T	G	3	5	8	0	0	8	0	0
2	242099784	.	G	A	64	57	121	0	1	122	0	0
2	242141719	rs2074840	C	T	8	2	10	0	0	10	0	0
2	242157241	rs76832527	G	A	1	5	6	0	0	6	0	0
2	242164562	rs7568928	C	T	13	7	20	0	0	20	0	0
2	242168518	rs62186361	G	A	43	50	93	0	0	93	0	0
2	242173916	rs3755325	G	A	2	9	11	0	0	11	0	0
2	242176188	rs2305071	G	C	3	8	11	0	0	11	0	0
2	242176549	rs7607714	A	G	2	6	8	0	0	8	0	0
2	242177265	rs2289796	A	G	3	3	6	0	0	6	0	0
2	242210408	.	A	G	12	13	25	0	0	25	0	0
2	242211554	.	G	A	4	5	9	0	0	9	0	0
2	242212672	.	A	G	4	4	8	0	0	8	0	0
2	242255378	.	G	A	38	36	74	0	0	74	0	0
2	242257835	.	A	G	2	5	7	0	0	7	0	0
2	242257859	.	G	A	4	4	8	0	0	8	0	0
2	242259614	.	G	A	5	1	6	0	0	6	0	0
2	242261240	.	T	A	4	2	6	0	0	6	0	0
2	242261802	.	T	C	1	7	8	0	0	8	0	0
2	242263223	.	G	A	4	4	8	0	0	8	0	0
2	242266963	.	G	C	5	1	6	0	0	6	0	0
2	242268994	.	T	C	9	6	15	0	0	15	0	0
2	242269024	.	A	G	8	6	14	0	0	14	0	0
2	242272388	.	A	G	3	6	9	0	0	9	0	0
2	242275579	.	G	A	5	11	16	0	0	16	0	0
2	242276441	.	A	G	72	60	132	0	1	133	0	0
2	242276523	.	C	A	97	73	170	0	2	172	0	0
2	242277689	.	G	A	2	5	7	0	1	8	0	0
2	242292307	.	T	C	163	169	332	0	6	338	0	0
2	242292378	.	G	T	256	244	500	0	5	505	0	0
2	242312543	.	A	C	5	7	12	0	0	12	0	0
2	242336614	.	G	A	4	15	19	0	0	19	0	0
2	242382192	.	C	T	4	2	6	0	0	6	0	0
2	242382864	.	C	T	6	5	11	0	1	12	0	0
2	242384194	.	C	G	4	4	8	0	0	8	0	0
2	242384581	.	C	A	4	6	10	0	0	10	0	0
2	242393574	.	T	A	3	6	9	0	0	9	0	0
2	242434809	.	G	T	72	108	180	0	1	181	0	0
2	242439071	.	G	A	10	4	14	0	1	15	0	0
2	242597897	.	T	G	3	4	7	0	0	7	0	0
2	242620818	.	T	G	9	5	14	0	0	14	0	0
2	242687274	.	G	A	5	3	8	0	0	8	0	0
2	242708045	.	C	T	79	64	143	0	3	146	0	0
2	242740591	.	T	C	3	5	8	0	0	8	0	0
2	242740851	.	C	A	3	4	7	0	0	7	0	0
2	242749596	.	T	C	60	45	105	0	0	105	0	0
2	242749764	.	C	T	18	19	37	0	0	37	0	0
2	242749988	.	A	C	17	6	23	0	0	23	0	0
2	242750460	.	T	C	7	14	21	0	0	21	0	0
2	242750980	.	T	C	3	3	6	0	0	6	0	0
2	242752281	.	G	C	6	6	12	0	0	12	0	0
2	242752763	.	A	G	2	5	7	0	0	7	0	0
2	242754192	.	A	G	2	9	11	0	0	11	0	0
2	242755465	.	C	G	10	9	19	0	0	19	0	0
2	242757820	.	G	A	147	155	302	0	5	307	0	0
2	242758447	.	G	A	140	127	267	0	3	270	0	0
2	242793273	.	A	G	2	7	9	0	0	9	0	0
2	242793559	.	T	C	4	3	7	0	0	7	0	0
2	242796574	.	G	A	2	5	7	0	0	7	0	0
2	242796660	.	A	G	5	3	8	0	0	8	0	0
2	242796828	.	C	T	3	5	8	0	0	8	0	0
2	242798018	.	T	C	2	7	9	0	0	9	0	0
2	242798643	.	C	G	5	1	6	0	0	6	0	0
2	242799578	.	C	T	11	8	19	0	0	19	0	0
2	242799584	.	G	A	12	9	21	0	0	21	0	0
2	242799638	.	G	C	9	13	22	0	0	22	0	0
2	242814009	.	G	A	4	4	8	0	0	8	0	0
2	242832543	.	G	A	4	3	7	0	0	7	0	0
2	242923648	.	C	T	1	5	6	0	0	6	0	0
2	243160790	.	G	C	10	2	12	0	0	12	0	0
20	251604	rs117858420	G	C	22	13	35	0	1	36	0	0
20	256727	rs3827147	T	A	53	35	88	0	0	88	0	0
20	256866	rs3827149	G	A	21	24	45	0	0	45	0	0
20	256886	rs3827150	A	G	19	23	42	0	1	43	0	0
20	256992	rs3827151	A	G	13	20	33	0	1	34	0	0
20	257032	rs3827153	A	G	13	17	30	0	0	30	0	0
20	257229	.	T	C	6	10	16	0	0	16	0	0
20	257320	rs2277779	G	A	6	15	21	0	0	21	0	0
20	257658	rs45503891	G	A	5	2	7	0	0	7	0	0
20	257733	rs2277781	A	G	38	31	69	0	1	70	0	0
20	259818	rs6035541	G	A	46	39	85	0	1	86	0	0
20	259969	rs7271033	G	C	32	30	62	0	0	62	0	0
20	277832	rs1997793	C	T	40	53	93	0	0	93	0	0
20	301305	rs73574568	A	G	7	5	12	0	0	12	0	0
20	307627	rs6050030	G	C	40	25	65	0	4	69	0	0
20	307966	rs139428694	T	C	46	16	62	0	1	64	1	0
20	308189	rs1047506	G	C	90	48	138	0	1	139	0	0
20	308193	rs1047507	A	G	91	47	138	0	0	138	0	0
20	310269	rs6050323	C	G	2	10	12	0	1	13	0	0
20	310493	rs6050344	G	C	5	12	17	0	0	17	0	0
20	334123	.	C	T	28	25	53	0	0	53	0	0
20	334550	rs73576416	G	A	60	57	117	0	1	118	0	0
20	335217	rs111385797	A	G	73	65	138	0	0	138	0	0
20	335225	rs1001549	G	T	69	66	135	0	1	136	0	0
20	368905	rs2295490	A	G	35	25	60	0	0	60	0	0
20	377547	rs4352283	C	A	88	64	152	0	2	154	0	0
20	377810	rs11537607	C	T	116	179	295	0	0	295	0	0
20	391170	rs7059	C	T	101	66	167	0	1	168	0	0
20	400872	rs35073025	A	C	5	8	13	0	1	14	0	0
20	402171	rs6051900	T	C	2	6	8	0	0	8	0	0
20	419067	rs3746794	C	T	51	56	107	0	1	108	0	0
20	425434	rs2273463	C	T	20	6	26	0	0	26	0	0
20	425606	rs2273465	C	A	16	10	26	0	0	26	0	0
20	442323	rs157800	T	A	5	1	6	0	0	6	0	0
20	481929	rs149680344	G	A	7	3	10	0	0	10	0	0
20	740833	rs1053018	G	C	5	5	10	0	1	11	0	0
20	816394	rs7271234	C	T	6	2	8	0	0	8	0	0
20	819662	rs6108038	G	A	4	8	12	0	0	12	0	0
20	820012	rs6108039	A	C	3	4	7	0	0	7	0	0
20	820143	rs11906867	C	T	11	6	17	0	1	18	0	0
20	820203	rs11905405	G	A	14	7	21	0	0	21	0	0
20	823504	rs552367	T	G	8	2	10	0	0	10	0	0
20	823791	rs6055271	A	T	2	4	6	0	0	6	0	0
20	823792	rs6038939	C	T	2	4	6	0	0	6	0	0
20	824422	rs636681	C	A	10	7	17	0	0	17	0	0
20	824522	rs66496369	G	T	16	13	29	0	0	29	0	0
20	1099294	rs2072963	T	C	63	30	93	0	0	93	0	0
20	1099329	rs2072962	A	G	73	104	177	0	1	178	0	0
20	1099523	rs1803415	T	G	106	116	222	0	1	223	0	0
20	1115919	rs2235587	A	G	280	212	492	0	9	501	0	0
20	1126724	rs1883522	G	A	2	5	7	0	0	7	0	0
20	1127819	.	T	C	8	13	21	0	0	21	0	0
20	1127822	rs6040141	C	T	14	7	21	0	0	21	0	0
20	1128013	rs4813941	G	A	16	14	30	0	0	30	0	0
20	1290699	.	G	C	15	10	25	0	0	25	0	0
20	1291018	rs11449	G	A	23	22	45	0	0	45	0	0
20	1291076	rs1048628	G	C	23	21	44	0	0	44	0	0
20	1291778	rs2273957	T	A	5	1	6	0	0	6	0	0
20	1291826	rs6109390	G	A	2	4	6	0	1	7	0	0
20	1293008	rs2273958	C	T	18	16	34	0	0	34	0	0
20	1293046	rs1048621	G	A	17	16	33	0	0	33	0	0
20	1293247	rs2273959	C	T	23	9	32	0	0	32	0	0
20	1293536	rs2281711	A	G	5	8	13	0	1	14	0	0
20	1350709	rs8392	T	C	222	213	435	0	3	438	0	0
20	1351846	rs62187547	G	C	16	31	47	0	0	47	0	0
20	1355044	rs1951765	T	A	11	4	15	0	0	15	0	0
20	1357193	rs148291539	G	A	5	8	13	0	0	13	0	0
20	1359238	rs395071	G	A	4	5	9	0	0	9	0	0
20	1359352	rs6105031	C	A	6	6	12	0	0	12	0	0
20	1369825	rs6109740	C	G	1	5	6	0	0	6	0	0
20	1423848	rs13063	G	T	147	122	269	0	3	272	0	0
20	1423909	rs3171292	C	T	110	108	218	0	1	219	0	0
20	1426685	rs2064645	C	T	10	1	11	0	0	11	0	0
20	1426861	rs2064646	A	G	9	2	11	0	0	11	0	0
20	1436391	rs41310181	T	A	6	3	9	0	0	9	0	0
20	1436445	rs41308086	T	A	5	2	7	0	0	7	0	0
20	1437148	rs16994239	A	G	6	6	12	0	0	12	0	0
20	1438230	rs4546067	C	T	7	3	10	0	0	10	0	0
20	1455664	rs112397058	G	A	5	1	6	0	0	6	0	0
20	1542232	rs2422615	A	G	16	14	30	0	0	30	0	0
20	1543409	rs2263664	T	G	3	9	12	0	0	12	0	0
20	1543505	rs117655844	A	G	6	8	14	0	0	14	0	0
20	1544469	rs1142198	A	T	8	12	20	0	0	20	0	0
20	1544929	.	C	T	4	7	11	0	0	11	0	0
20	1600617	.	T	C	8	11	19	0	0	19	0	0
20	1885099	rs6045331	C	G	4	2	6	0	0	6	0	0
20	1887584	rs754829	C	A	4	2	6	0	0	6	0	0
20	1889477	rs4814734	T	A	3	5	8	0	0	8	0	0
20	1894689	rs56380582	G	T	1	5	6	0	0	6	0	0
20	1894690	rs55797358	T	A	1	5	6	0	0	6	0	0
20	1894847	rs67558779	C	G	3	3	6	0	0	6	0	0
20	1894872	rs68178619	T	C	3	4	7	0	0	7	0	0
20	1894881	rs72620869	T	C	3	3	6	0	0	6	0	0
20	1894977	rs17775933	A	G	3	6	9	0	0	9	0	0
20	1895016	rs68064046	G	A	3	8	11	0	0	11	0	0
20	1895164	.	T	C	6	0	6	0	0	6	0	0
20	1895177	.	C	T	6	0	6	0	0	6	0	0
20	1895184	.	A	T	6	0	6	0	0	6	0	0
20	1895794	rs1135192	G	A	13	3	16	0	0	16	0	0
20	1895796	rs143735290	T	C	13	3	16	0	0	16	0	0
20	1895797	rs146490405	G	A	13	3	16	0	0	16	0	0
20	1895813	rs17855609	A	T	17	0	17	0	0	17	0	0
20	1895815	rs17853846	A	G	17	0	17	0	0	17	0	0
20	1895820	rs17855610	C	T	17	0	17	0	0	17	0	0
20	1895826	rs17855611	G	A	17	1	18	0	0	18	0	0
20	1895835	rs17855612	C	T	15	2	17	0	0	17	0	0
20	1895842	rs17853847	T	C	15	5	20	0	0	20	0	0
20	1895889	rs1057114	G	C	18	13	31	0	0	31	0	0
20	1895963	rs17855613	A	G	32	5	37	0	0	37	0	0
20	1895965	rs17855614	C	A	31	4	35	0	2	37	0	0
20	1895984	.	C	A	27	7	34	0	1	35	0	0
20	1895990	.	G	A	29	7	36	0	1	37	0	0
20	1896059	rs115287948	G	A	31	6	37	0	0	37	0	0
20	1896060	rs114499682	T	C	30	6	36	0	1	37	0	0
20	1896100	.	C	T	32	14	46	0	0	46	0	0
20	1917247	rs3790340	A	T	6	2	8	0	0	8	0	0
20	1917290	rs3828016	A	G	5	1	6	0	0	6	0	0
20	2443116	rs6036572	G	A	14	18	32	0	1	33	0	0
20	2443441	rs2143862	G	A	5	10	15	0	2	17	0	0
20	2444744	rs6076161	C	T	13	35	48	0	0	48	0	0
20	2450669	rs6049283	C	A	6	7	13	0	0	13	0	0
20	2451503	rs4815262	G	A	3	5	8	0	0	8	0	0
20	2775332	rs127078	T	C	64	78	142	0	1	143	0	0
20	2777167	.	C	T	283	260	543	0	3	546	0	0
20	2777828	rs742707	G	T	20	18	38	0	0	38	0	0
20	2780734	rs215544	T	C	7	13	20	0	1	21	0	0
20	2816821	rs2274669	C	T	113	106	219	0	9	228	0	0
20	2840773	rs3818605	C	T	25	27	52	0	1	53	0	0
20	2842685	rs6051449	A	C	8	6	14	0	0	14	0	0
20	2843053	rs632080	A	G	6	5	11	0	1	12	0	0
20	2846289	rs677344	G	A	4	8	12	0	0	12	0	0
20	2846397	rs555502	G	A	4	4	8	0	0	8	0	0
20	2856288	rs6051456	T	A	3	5	8	0	1	9	0	0
20	2865776	rs1748066	G	A	1	6	7	0	0	7	0	0
20	2865976	rs7262267	A	G	2	6	8	0	0	8	0	0
20	2870285	rs577116	A	G	3	3	6	0	0	6	0	0
20	2872458	rs6138927	T	C	2	4	6	0	0	6	0	0
20	2873460	rs598147	A	G	3	8	11	0	0	11	0	0
20	2873606	.	T	G	27	67	94	0	0	94	0	0
20	2873629	.	G	C	26	62	88	0	0	88	0	0
20	2996497	rs1178016	C	T	60	42	102	0	1	103	0	0
20	3090124	rs913555	A	G	11	17	28	0	0	28	0	0
20	3090516	rs10720	G	T	45	44	89	0	2	91	0	0
20	3090848	rs708973	T	G	29	29	58	0	0	58	0	0
20	3144664	rs911112	T	C	39	25	64	0	1	65	0	0
20	3149214	rs1006374	G	C	4	3	7	0	0	7	0	0
20	3149408	rs41281242	C	T	5	4	9	0	0	9	0	0
20	3150387	rs3761251	C	T	6	0	6	0	0	6	0	0
20	3153236	rs73075048	C	G	4	4	8	0	0	8	0	0
20	3171337	rs11591	C	T	112	111	223	0	3	226	0	0
20	3203950	rs2236206	T	A	3	3	6	0	0	6	0	0
20	3231134	rs1207	C	T	40	28	68	0	0	68	0	0
20	3231340	rs732923	C	G	32	36	68	0	0	68	0	0
20	3231457	rs1543435	C	A	33	19	52	0	0	52	0	0
20	3232099	rs8774	C	A	15	13	28	0	0	28	0	0
20	3241613	rs6051689	C	T	2	4	6	0	0	6	0	0
20	3278682	rs41281886	G	A	20	21	41	0	0	41	0	0
20	3285126	rs2254916	A	T	12	17	29	0	0	29	0	0
20	3317761	rs2092992	C	T	3	3	6	0	0	6	0	0
20	3784110	rs1056720	C	T	32	23	55	0	1	56	0	0
20	3842984	rs2326369	C	T	23	13	36	0	0	36	0	0
20	3844929	rs45437096	C	T	13	20	33	0	0	33	0	0
20	3846843	rs3746660	C	T	4	11	15	0	0	15	0	0
20	3847142	rs3746661	G	C	19	3	22	0	0	22	0	0
20	3848416	rs16989000	A	C	3	5	8	0	0	8	0	0
20	3870079	rs71647828	T	A	4	6	10	0	0	10	0	0
20	3895112	rs12480808	A	G	5	1	6	0	0	6	0	0
20	3896539	rs62210557	T	A	4	3	7	0	0	7	0	0
20	3899743	rs8121855	G	A	4	3	7	0	0	7	0	0
20	3905730	rs6037695	C	T	1	7	8	0	0	8	0	0
20	3905941	rs241596	G	T	3	3	6	0	0	6	0	0
20	3910169	rs7270329	G	C	117	86	203	0	0	203	0	0
20	3911420	.	C	T	85	63	148	0	1	149	0	0
20	3912189	rs148946708	G	C	39	90	129	0	1	130	0	0
20	3913988	rs141787655	G	T	34	48	82	0	1	83	0	0
20	3916449	rs241607	C	A	4	3	7	0	0	7	0	0
20	3916592	rs909885	T	C	10	2	12	0	0	12	0	0
20	3921667	rs1003380	G	A	6	4	10	0	1	11	0	0
20	3942178	rs17287269	A	C	1	11	12	0	0	12	0	0
20	4158980	rs13040752	G	A	1	5	6	0	0	6	0	0
20	4159584	rs1741324	T	C	2	4	6	0	0	6	0	0
20	4161923	rs73076578	C	T	8	2	10	0	1	11	0	0
20	4162287	rs6037781	T	G	7	9	16	0	0	16	0	0
20	4162411	rs1124983	T	C	7	9	16	0	0	16	0	0
20	4176341	rs6084660	C	T	5	2	7	0	0	7	0	0
20	4673532	rs35643278	G	A	3	3	6	0	0	6	0	0
20	4675980	rs6052772	G	A	2	6	8	0	0	8	0	0
20	4677092	rs6107516	G	A	1	5	6	0	0	6	0	0
20	4677207	rs6116474	T	C	3	5	8	0	0	8	0	0
20	4677369	rs6116475	A	G	1	5	6	0	0	6	0	0
20	4680251	rs1799990	A	G	176	174	350	0	2	352	0	0
20	4761725	rs150370844	T	G	247	252	499	0	1	500	0	0
20	4762577	rs3746673	C	G	162	194	356	0	1	357	0	0
20	4762701	rs2422973	A	G	148	148	296	0	1	297	0	0
20	4762736	rs2422974	G	C	167	156	323	0	2	325	0	0
20	4762869	rs2422975	G	A	170	158	328	0	1	329	0	0
20	4763084	rs2422976	G	C	149	133	282	0	1	283	0	0
20	4763108	rs2422978	G	A	150	121	271	0	6	277	0	0
20	4764003	rs1535381	C	T	102	121	223	0	0	223	0	0
20	4764682	rs2422979	T	C	50	73	123	0	1	124	0	0
20	4766010	rs2422981	A	G	4	6	10	0	1	11	0	0
20	4766569	rs58378773	T	C	10	10	20	0	0	20	0	0
20	4767346	rs7274162	C	T	5	10	15	0	0	15	0	0
20	4768136	rs55900827	T	C	6	9	15	0	0	15	0	0
20	4769177	rs6139553	G	C	6	9	15	0	0	15	0	0
20	4769183	rs2422987	G	A	8	11	19	0	0	19	0	0
20	4769374	rs6139554	T	C	4	9	13	0	0	13	0	0
20	4769795	rs12624782	C	T	10	8	18	0	0	18	0	0
20	4803608	rs2326552	C	T	1	7	8	0	0	8	0	0
20	4834338	rs1131382	C	T	26	26	52	0	1	53	0	0
20	4834894	rs35560557	G	A	21	21	42	0	0	42	0	0
20	4948248	rs2748901	G	A	4	16	20	0	0	20	0	0
20	4948389	rs1879176	T	C	7	18	25	0	0	25	0	0
20	4948435	rs1879177	C	T	7	18	25	0	0	25	0	0
20	4949523	rs6038025	C	T	0	8	8	0	0	8	0	0
20	5097323	rs3730433	G	A	5	1	6	0	0	6	0	0
20	5160829	rs1040759	G	A	3	3	6	0	0	6	0	0
20	5169877	rs6038087	A	G	12	6	18	0	0	18	0	0
20	5172034	rs3746677	C	T	33	28	61	0	0	61	0	0
20	5173472	rs17785402	C	T	26	31	57	0	0	57	0	0
20	5174039	rs6053188	C	T	28	28	56	0	0	56	0	0
20	5174600	rs6038088	G	A	50	70	120	0	0	120	0	0
20	5175237	rs732817	C	T	55	65	120	0	0	120	0	0
20	5731711	rs6116933	A	G	5	12	17	0	0	17	0	0
20	5731803	rs6116934	T	C	25	13	38	0	1	39	0	0
20	5731955	rs6107683	C	T	27	14	41	0	1	42	0	0
20	5753865	rs13043139	C	A	15	9	24	0	0	24	0	0
20	5992887	rs6085347	G	A	4	4	8	0	0	8	0	0
20	5993194	rs73603034	T	C	4	3	7	0	0	7	0	0
20	6004157	rs6085352	G	A	27	59	86	0	0	86	0	0
20	6005485	rs6076910	G	A	6	2	8	0	0	8	0	0
20	6007016	rs6085354	A	G	4	3	7	0	0	7	0	0
20	6008115	rs113705040	G	A	4	3	7	0	0	7	0	0
20	6008226	rs111593423	A	C	5	1	6	0	0	6	0	0
20	6008509	rs73603051	G	A	12	2	14	0	0	14	0	0
20	6011122	rs6053835	A	G	8	2	10	0	0	10	0	0
20	6011934	rs41282950	C	T	58	50	108	0	0	108	0	0
20	6760201	rs3178250	T	C	9	6	15	0	0	15	0	0
20	7959777	rs6038995	C	T	10	8	18	0	0	18	0	0
20	7962072	rs8764	A	C	28	24	52	0	1	53	0	0
20	8388859	rs6086435	T	A	10	9	19	0	0	19	0	0
20	8389162	rs73090244	T	A	12	19	31	0	0	31	0	0
20	8633433	rs6133597	T	C	6	5	11	0	0	11	0	0
20	8633733	rs6055978	C	T	4	7	11	0	0	11	0	0
20	8737734	rs2076413	G	A	8	3	11	0	0	11	0	0
20	8770822	rs2294597	C	T	16	15	31	0	0	31	0	0
20	8864177	rs1047381	T	C	10	10	20	0	0	20	0	0
20	8864203	rs708910	A	G	7	8	15	0	0	15	0	0
20	8865006	rs1047383	C	T	19	29	48	0	0	48	0	0
20	8942954	rs6086714	G	A	2	10	12	0	1	13	0	0
20	8945202	rs2206265	C	G	4	2	6	0	0	6	0	0
20	10414818	rs143390703	A	T	18	15	33	0	0	34	1	0
20	10619014	rs7828	A	C	115	140	255	0	2	257	0	0
20	10621305	rs6074164	A	C	2	4	6	0	1	7	0	0
20	10624190	rs889509	A	G	6	6	12	0	0	12	0	0
20	10624928	.	A	T	6	2	8	0	0	8	0	0
20	10633237	rs1131695	G	A	37	23	60	0	0	60	0	0
20	13340126	rs149938957	T	C	5	1	6	0	0	6	0	0
20	13349512	rs518981	C	A	3	3	6	0	0	6	0	0
20	13351286	rs8120446	G	A	7	3	10	0	0	10	0	0
20	13410638	rs6105094	C	T	5	2	7	0	0	7	0	0
20	13695498	rs6079146	G	A	12	9	21	0	0	21	0	0
20	13695607	rs34414644	T	G	29	19	48	0	0	48	0	0
20	13706428	rs4813139	A	G	5	5	10	0	0	10	0	0
20	13740827	rs6134968	C	G	13	4	17	0	0	17	0	0
20	13741079	.	C	T	4	3	7	0	1	8	0	0
20	13741587	rs6033816	G	T	15	8	23	0	0	23	0	0
20	13747441	rs3180370	A	G	15	21	36	0	0	36	0	0
20	13775032	rs4814260	A	T	18	25	43	0	1	44	0	0
20	13794566	rs2423750	G	A	3	3	6	0	0	6	0	0
20	13795860	rs6074644	A	G	9	11	20	0	0	20	0	0
20	13798676	rs2423751	C	T	3	5	8	0	1	9	0	0
20	16253819	rs4814466	G	A	7	2	9	0	0	9	0	0
20	16710930	rs2073054	G	A	2	7	9	0	0	9	0	0
20	16711466	rs6131860	A	G	6	5	11	0	0	11	0	0
20	16716644	rs6044275	T	C	2	4	6	0	0	6	0	0
20	16718392	rs6044279	A	G	3	5	8	0	0	8	0	0
20	16718542	rs6111265	G	A	4	7	11	0	0	11	0	0
20	16719754	rs6044281	T	G	2	4	6	0	0	6	0	0
20	16721892	rs1051179	T	G	8	5	13	0	0	13	0	0
20	17474968	rs6080718	T	C	8	7	15	0	0	15	0	0
20	17588791	.	C	T	226	179	405	0	1	406	0	0
20	17598767	.	T	C	12	9	21	0	0	21	0	0
20	17923379	rs8121298	A	G	2	12	14	0	0	14	0	0
20	17924591	rs2145020	T	C	8	15	23	0	0	23	0	0
20	17924633	rs984853	T	C	7	9	16	0	0	16	0	0
20	17925870	rs1884709	A	G	16	6	22	0	0	22	0	0
20	17927003	rs11696758	A	G	3	4	7	0	0	7	0	0
20	17927028	rs6136233	C	T	4	3	7	0	0	7	0	0
20	17931307	rs6111753	G	A	11	11	22	0	0	22	0	0
20	17931513	rs6111754	C	T	9	6	15	0	0	15	0	0
20	17932210	rs2273448	C	T	206	177	383	0	1	384	0	0
20	17932415	rs2273449	T	C	20	58	78	0	0	78	0	0
20	17932978	rs6111755	A	T	6	4	10	0	0	10	0	0
20	17934961	rs2236158	T	C	14	9	23	0	0	23	0	0
20	17935822	rs10485575	T	C	9	7	16	0	0	16	0	0
20	17942398	rs6080918	T	C	10	4	14	0	0	14	0	0
20	17942616	rs2328231	T	C	10	6	16	0	0	16	0	0
20	17942651	rs2328232	C	T	10	4	14	0	0	14	0	0
20	17942792	rs2328233	G	T	13	13	26	0	0	26	0	0
20	17943138	rs2004931	G	A	3	10	13	0	0	13	0	0
20	17943492	rs753213	A	T	12	10	22	0	0	22	0	0
20	17947646	rs4519603	G	A	24	16	40	0	0	40	0	0
20	17948082	rs2295457	T	C	28	22	50	0	0	50	0	0
20	17948171	rs34208662	C	A	21	16	37	0	0	37	0	0
20	17948894	rs6111762	G	A	42	69	111	0	0	111	0	0
20	17949452	rs910902	C	T	10	4	14	0	0	14	0	0
20	17950337	rs142001430	T	G	5	5	10	0	0	10	0	0
20	17950772	rs73107120	A	G	51	58	109	0	0	109	0	0
20	17968923	rs28455091	T	C	66	47	113	0	1	114	0	0
20	17971273	rs3748494	C	T	78	77	155	0	3	158	0	0
20	17971553	rs7010	T	G	87	104	191	0	3	194	0	0
20	17981054	rs12480848	G	C	0	6	6	0	0	6	0	0
20	18364698	rs117284453	T	C	17	17	34	0	0	34	0	0
20	18364964	rs36048101	A	G	23	10	33	0	0	33	0	0
20	18366623	rs17733134	G	A	8	7	15	0	0	15	0	0
20	18369847	rs6105911	C	T	4	3	7	0	0	7	0	0
20	18393312	rs6075337	C	G	4	8	12	0	0	12	0	0
20	18457986	rs73108909	T	C	3	4	7	0	0	7	0	0
20	18460044	rs6111982	C	T	4	2	6	0	0	6	0	0
20	18460614	rs6035056	A	T	4	6	10	0	0	10	0	0
20	18462421	rs1055171	A	G	27	46	73	0	1	74	0	0
20	18464110	rs3827965	T	C	4	2	6	0	0	6	0	0
20	18464673	rs1055177	G	T	32	45	77	0	3	80	0	0
20	18465001	rs5867	C	A	71	72	143	0	1	144	0	0
20	18465004	rs1133724	C	G	79	72	151	0	2	153	0	0
20	18520567	rs2328309	C	T	4	7	11	0	0	11	0	0
20	18523002	rs2273526	C	G	57	51	108	0	3	111	0	0
20	18539438	rs6075364	A	C	5	2	7	0	0	8	1	0
20	18539446	rs2328310	A	T	3	5	8	0	0	8	0	0
20	18548411	rs6035077	T	G	6	7	13	0	0	13	0	0
20	18548444	rs6035078	T	A	5	8	13	0	0	13	0	0
20	18549300	rs6132080	C	T	8	6	14	0	1	15	0	0
20	18549325	rs67499983	C	T	8	7	15	0	0	15	0	0
20	18549398	rs6132081	G	A	7	9	16	0	0	16	0	0
20	18549503	rs6132082	C	T	7	10	17	0	2	19	0	0
20	18776488	rs77335096	G	C	11	2	13	0	0	13	0	0
20	19215642	rs723768	A	G	4	3	7	0	0	7	0	0
20	19216527	rs6136659	T	C	8	4	12	0	0	12	0	0
20	19216528	rs6035261	G	A	8	4	12	0	0	12	0	0
20	19261623	rs1569767	G	A	7	12	19	0	1	20	0	0
20	19343334	rs6046019	A	T	5	1	6	0	0	6	0	0
20	19592604	rs6136792	C	T	1	5	6	0	0	6	0	0
20	19592790	rs6136793	C	T	3	3	6	0	0	6	0	0
20	19634732	rs3790278	G	A	6	6	12	0	1	13	0	0
20	19634747	rs3790279	T	C	4	6	10	0	1	11	0	0
20	19701943	rs2277866	A	C	13	12	25	0	0	25	0	0
20	19702049	rs3828002	G	A	7	4	11	0	0	11	0	0
20	19702171	rs6046271	G	A	13	10	23	0	1	24	0	0
20	19702694	rs3748484	C	G	15	9	24	0	0	24	0	0
20	20003428	rs2073122	G	A	12	8	20	0	0	20	0	0
20	20004574	.	T	C	7	8	15	0	0	15	0	0
20	20004863	rs62203272	T	G	10	10	20	0	0	20	0	0
20	20005431	rs6136916	G	A	14	9	23	0	0	23	0	0
20	20006368	rs7263	T	C	97	95	192	0	1	194	1	0
20	20008396	rs6132260	T	A	5	3	8	0	0	8	0	0
20	20011003	rs57221371	A	G	7	6	13	0	0	13	0	0
20	20011094	rs6035526	A	G	4	6	10	0	0	10	0	0
20	20011645	.	G	C	7	4	11	0	0	11	0	0
20	20016345	rs12624987	C	T	6	6	12	0	0	12	0	0
20	20023174	rs3828004	C	G	6	0	6	0	0	6	0	0
20	20024988	rs10439581	C	T	16	13	29	0	0	29	0	0
20	20025126	rs59851805	G	A	13	6	19	0	0	19	0	0
20	20025221	rs6132263	G	A	7	8	15	0	0	15	0	0
20	20026255	rs73605567	C	A	2	5	7	0	0	7	0	0
20	20032998	rs2255255	T	C	35	33	68	0	1	69	0	0
20	20493222	rs35039408	G	A	22	16	38	0	0	38	0	0
20	21135126	rs6047274	T	C	3	3	6	0	0	6	0	0
20	21135726	rs6047275	A	G	4	2	6	0	0	6	0	0
20	21142523	rs4815025	C	G	21	9	30	0	0	30	0	0
20	21142813	rs2236178	T	C	22	24	46	0	0	46	0	0
20	21145885	rs6035795	A	G	9	1	10	0	0	10	0	0
20	21146468	rs6047282	A	T	5	4	9	0	0	9	0	0
20	21146816	rs6137276	A	G	33	0	33	0	0	33	0	0
20	21146839	rs2876595	T	C	34	0	34	0	1	35	0	0
20	21147009	rs6047283	A	G	4	11	15	0	0	15	0	0
20	21147407	rs6035796	A	G	9	5	14	0	0	14	0	0
20	21147968	rs4625995	G	C	5	3	8	0	0	8	0	0
20	21149971	rs4815027	T	C	15	9	24	0	0	24	0	0
20	21150267	rs6132402	G	C	20	15	35	0	0	35	0	0
20	21150633	rs4815028	T	C	10	5	15	0	0	15	0	0
20	21151067	rs6047286	C	T	1	5	6	0	1	7	0	0
20	21151117	rs6047287	T	C	2	7	9	0	1	10	0	0
20	21151319	rs113854514	C	T	2	4	6	0	0	6	0	0
20	21151324	rs6047288	G	A	5	2	7	0	0	7	0	0
20	21151328	rs6035799	A	G	5	3	8	0	0	8	0	0
20	21151348	rs6035800	C	T	6	4	10	0	0	10	0	0
20	21151377	rs1072271	G	A	8	2	10	0	0	10	0	0
20	21218345	rs6047319	G	A	0	6	6	0	0	6	0	0
20	21326098	rs13043724	T	C	9	2	11	0	0	11	0	0
20	21329780	rs1958122	T	C	13	7	20	0	0	20	0	0
20	21330991	rs202851	C	T	5	2	7	0	0	7	0	0
20	21336825	rs3787500	G	A	6	4	10	0	0	10	0	0
20	21339857	rs1409816	A	G	5	4	9	0	0	9	0	0
20	21342378	rs4497932	T	C	3	4	7	0	0	7	0	0
20	21342970	rs713479	G	C	5	4	9	0	0	9	0	0
20	21343944	rs3848794	G	A	1	5	6	0	1	7	0	0
20	21344454	rs4815040	G	A	5	4	9	0	0	9	0	0
20	21348430	rs6082397	C	G	4	3	7	0	0	7	0	0
20	21362758	rs6047417	T	G	2	6	8	0	0	8	0	0
20	21366260	rs6035864	T	C	5	6	11	0	0	11	0	0
20	21368363	rs6047421	G	A	5	8	13	0	0	13	0	0
20	21368932	rs6035865	G	T	13	9	22	0	0	22	0	0
20	23027413	rs3176123	T	G	83	37	120	0	0	120	0	0
20	23028063	rs11696919	T	C	28	37	65	0	0	65	0	0
20	23028724	rs1042579	G	A	39	20	59	0	0	59	0	0
20	23060257	rs7492	A	G	4	14	18	0	0	18	0	0
20	23062927	rs2749812	A	G	2	6	8	0	0	8	0	0
20	23062984	rs2749813	T	C	1	5	6	0	0	6	0	0
20	23065342	rs3746732	A	G	2	4	6	0	0	6	0	0
20	23331141	rs4815196	T	G	3	8	11	0	0	11	0	0
20	23350796	.	C	T	76	73	149	0	0	149	0	0
20	23355423	rs8615	C	T	94	69	163	0	1	164	0	0
20	24929913	rs11087490	A	G	109	107	216	0	2	218	0	0
20	24934970	rs6050197	C	T	7	2	9	0	0	9	0	0
20	24939590	rs1056033	G	C	861	1723	2584	0	20	2604	0	0
20	24940467	rs6106979	C	G	724	265	989	0	6	995	0	0
20	24944166	rs6707	C	T	147	119	266	0	7	273	0	0
20	24944447	rs1045772	G	A	125	111	236	0	1	237	0	0
20	24945581	rs6138435	G	C	6	8	14	0	0	14	0	0
20	24946372	rs7271963	A	C	12	12	24	0	0	24	0	0
20	24946855	rs910132	T	C	16	8	24	0	0	24	0	0
20	24946861	rs910133	A	T	17	8	25	0	0	25	0	0
20	24948851	rs4815351	T	C	7	4	11	0	0	11	0	0
20	24948945	rs6050216	A	T	6	2	8	0	0	8	0	0
20	24949144	rs6050217	G	A	7	9	16	0	0	16	0	0
20	24949159	rs6138437	G	A	9	5	14	0	0	14	0	0
20	24950583	rs6114966	T	C	6	5	11	0	0	11	0	0
20	24950781	rs6050218	A	G	3	4	7	0	1	8	0	0
20	24957737	rs59744473	A	G	1	5	6	0	0	6	0	0
20	24957891	rs6106981	G	A	4	2	6	0	0	6	0	0
20	24964722	rs727964	G	A	3	6	9	0	0	9	0	0
20	24966357	rs62215127	T	G	5	6	11	0	0	11	0	0
20	24966400	rs6037001	T	G	3	8	11	0	0	11	0	0
20	24966960	rs6050234	G	A	1	6	7	0	0	7	0	0
20	24972333	rs7268095	C	T	1	8	9	0	0	9	0	0
20	24973005	rs8184053	C	T	7	1	8	0	0	8	0	0
20	24973247	rs11550623	C	A	50	42	92	0	1	93	0	0
20	24973363	rs11087492	A	G	4	2	6	0	0	6	0	0
20	24988048	rs6114998	C	T	22	25	47	0	0	47	0	0
20	24988082	rs6114999	C	T	21	25	46	0	1	47	0	0
20	24994275	rs6115001	G	A	14	8	22	0	0	22	0	0
20	25000734	rs6115003	G	A	6	4	10	0	0	10	0	0
20	25011423	rs6050259	T	C	10	17	27	0	0	27	0	0
20	25036163	rs4815365	G	A	23	11	34	0	0	34	0	0
20	25202892	rs6037062	G	A	4	9	13	0	0	13	0	0
20	25202950	rs77016428	C	T	6	13	19	0	0	19	0	0
20	25202984	rs115419357	G	A	6	14	20	0	0	20	0	0
20	25203312	rs111399370	C	T	10	5	15	0	0	15	0	0
20	25231545	.	A	G	3	4	7	0	0	7	0	0
20	25277244	rs9927	A	G	17	10	27	0	0	27	0	0
20	25282967	rs746748	C	T	79	57	136	0	2	138	0	0
20	25672341	rs6050790	A	G	12	10	22	0	0	22	0	0
20	29623223	.	T	C	103	0	103	0	1	104	0	0
20	29625876	.	C	T	116	0	116	0	1	117	0	0
20	29625935	.	A	G	122	0	122	0	2	124	0	0
20	29626607	.	T	G	7	0	7	0	0	7	0	0
20	29626672	.	C	G	7	0	7	0	0	7	0	0
20	29626720	.	C	T	18	0	18	0	0	18	0	0
20	29626773	.	A	T	0	22	22	0	0	22	0	0
20	29626826	.	A	T	10	0	10	0	0	10	0	0
20	29628271	.	C	T	126	0	126	0	0	126	0	0
20	29632714	.	C	A	109	0	109	0	0	109	0	0
20	29633916	.	G	T	73	0	73	0	1	74	0	0
20	29633927	rs62196372	C	A	60	0	60	0	1	61	0	0
20	29633929	rs7509092	A	G	59	0	59	0	0	59	0	0
20	29633952	.	C	T	39	0	39	0	1	40	0	0
20	29633986	rs2379676	A	C	11	0	11	0	0	11	0	0
20	30150324	rs73116296	G	A	3	6	9	0	0	9	0	0
20	30158298	rs73116297	G	A	6	6	12	0	0	12	0	0
20	30193954	rs8116155	G	C	214	189	403	0	4	407	0	0
20	30389005	.	C	T	56	47	103	0	0	103	0	0
20	30738978	rs6142622	A	G	3	4	7	0	0	7	0	0
20	30744218	rs1321415	T	C	4	3	7	0	0	7	0	0
20	30752970	rs6061203	A	G	4	4	8	0	0	8	0	0
20	30753270	rs14316	T	C	23	21	44	0	2	46	0	0
20	30782113	rs6061216	A	G	47	48	95	0	1	96	0	0
20	30920947	rs2151437	A	C	15	10	25	0	1	26	0	0
20	30922398	rs14353	C	T	58	39	97	0	0	98	1	0
20	30948281	rs2208131	A	G	12	12	24	0	0	24	0	0
20	30953162	rs6141294	T	C	4	5	9	0	0	9	0	0
20	30957801	rs9798511	C	T	2	4	6	0	0	6	0	0
20	31024274	rs4911231	T	C	150	145	295	0	0	295	0	0
20	31025163	rs2295764	A	G	26	32	58	0	0	58	0	0
20	31025231	rs2295763	T	C	17	28	45	0	0	45	0	0
20	31025535	rs2295762	A	G	33	46	79	0	0	79	0	0
20	31033574	rs3746611	G	A	69	70	139	0	3	142	0	0
20	31035936	rs3746612	G	C	3	5	8	0	1	9	0	0
20	31037635	rs6141724	T	G	4	4	8	0	0	8	0	0
20	31042169	rs6141311	C	T	14	12	26	0	0	26	0	0
20	31054702	rs1737894	C	G	7	9	16	0	0	16	0	0
20	31055226	rs34310097	G	A	5	8	13	0	0	13	0	0
20	31055792	rs2143534	T	C	8	3	11	0	0	11	0	0
20	31058362	rs4911234	A	G	6	4	10	0	0	10	0	0
20	31062176	rs1742983	T	C	4	2	6	0	1	7	0	0
20	31076359	rs293544	C	T	8	7	15	0	0	15	0	0
20	31291161	rs9421	C	T	188	184	372	0	4	376	0	0
20	31291483	rs28482886	C	A	27	28	55	0	0	55	0	0
20	31291625	rs28620238	A	G	29	38	67	0	0	67	0	0
20	31435260	rs242536	T	G	34	45	79	0	0	79	0	0
20	31436747	rs242538	C	T	296	300	596	0	4	600	0	0
20	31445466	rs242532	T	C	6	9	15	0	1	16	0	0
20	31954535	rs111360441	G	A	1	6	7	0	0	7	0	0
20	31961860	rs291676	T	C	16	23	39	0	1	40	0	0
20	32212690	rs3803939	C	T	5	1	6	0	0	6	0	0
20	32265747	rs2071055	T	A	5	5	10	0	0	10	0	0
20	32379263	rs2626551	T	C	5	6	11	0	0	11	0	0
20	32379631	rs2747566	C	T	9	11	20	0	1	21	0	0
20	32437142	rs1810534	C	T	7	9	16	0	0	16	0	0
20	32668527	.	C	G	15	9	24	0	0	24	0	0
20	32668624	rs77042903	C	T	12	13	25	0	0	25	0	0
20	32883308	rs13043752	G	A	83	64	147	0	0	147	0	0
20	33191027	rs7264012	T	C	4	2	6	0	0	6	0	0
20	33592490	.	A	G	173	155	328	0	0	328	0	0
20	33595525	rs13045538	T	C	93	82	175	0	3	178	0	0
20	33856627	rs2425038	A	G	6	1	7	0	0	7	0	0
20	33864247	rs34569456	G	A	118	109	227	0	0	227	0	0
20	34061918	rs35395621	T	C	9	5	14	0	0	14	0	0
20	34329730	.	T	C	6	3	9	0	0	9	0	0
20	34537180	rs34977741	G	A	52	47	99	0	0	99	0	0
20	34635441	rs7265718	T	G	166	177	343	0	2	345	0	0
20	35211025	rs142528335	C	T	7	4	11	0	0	11	0	0
20	35401424	rs117965530	G	C	7	7	14	0	1	15	0	0
20	35519475	rs6029941	G	A	12	7	19	0	0	19	0	0
20	35661837	rs6030887	C	T	5	1	6	0	0	6	0	0
20	35843707	rs118036734	C	T	5	3	8	0	0	8	0	0
20	35857466	rs3817882	G	A	8	3	11	0	0	11	0	0
20	35925296	rs6074018	G	A	3	3	6	0	0	6	0	0
20	35927179	rs1127262	G	A	0	8	8	0	0	8	0	0
20	35945174	rs1806940	G	T	12	19	31	0	0	31	0	0
20	36030658	rs56273506	C	T	4	7	11	0	0	11	0	0
20	36129809	rs6066642	A	T	4	2	6	0	0	6	0	0
20	36147828	.	A	G	8	0	8	0	4	12	0	0
20	36148497	rs3795148	T	C	9	2	11	0	0	11	0	0
20	36148985	rs6019062	T	C	6	9	15	0	1	16	0	0
20	36153821	rs73101504	C	T	2	4	6	0	0	6	0	0
20	36487314	rs113505047	C	T	2	8	10	0	0	10	0	0
20	36611664	rs2037	C	T	35	21	56	0	1	57	0	0
20	36611719	rs55960840	G	A	32	21	53	0	0	53	0	0
20	36662255	rs881556	C	T	7	10	17	0	0	17	0	0
20	36668874	rs2273353	G	A	11	10	21	0	0	21	0	0
20	36677002	rs2273354	C	G	5	1	6	0	0	6	0	0
20	36699860	rs6022804	G	T	12	3	15	0	0	15	0	0
20	36702543	rs6064017	G	T	8	3	11	0	0	11	0	0
20	36704226	rs6097662	G	A	3	7	10	0	0	10	0	0
20	36706812	rs139678670	T	G	3	4	7	0	0	7	0	0
20	36709997	rs6068740	G	A	12	11	23	0	1	24	0	0
20	36711395	rs6068747	C	A	19	23	42	0	0	42	0	0
20	36713579	rs6064028	G	T	22	25	47	0	0	47	0	0
20	36713594	rs6064029	C	T	21	24	45	0	1	46	0	0
20	36714612	rs6064031	G	C	17	16	33	0	0	33	0	0
20	36715450	rs6022919	G	C	22	20	42	0	0	42	0	0
20	36715822	rs12625508	G	A	28	30	58	0	0	58	0	0
20	36716942	rs6097732	C	A	26	24	50	0	1	51	0	0
20	36718059	rs3746466	G	A	21	23	44	0	0	44	0	0
20	36932660	rs1341023	C	T	117	270	387	0	3	390	0	0
20	36932676	rs1341024	G	C	133	310	443	0	1	444	0	0
20	36937881	rs13039113	T	A	12	5	17	0	0	17	0	0
20	36938121	rs6064367	G	C	7	18	25	0	1	26	0	0
20	36946848	rs4358188	G	A	636	367	1003	0	6	1009	0	0
20	36952961	rs6069741	C	A	3	4	7	0	0	7	0	0
20	36953097	rs5741806	C	T	5	1	6	0	0	6	0	0
20	37383640	rs2748663	T	C	22	25	47	0	1	48	0	0
20	37390617	rs6124011	C	G	6	6	12	0	0	12	0	0
20	37391432	rs6128918	G	A	4	4	8	0	0	8	0	0
20	37392106	rs2244791	G	A	7	10	17	0	1	18	0	0
20	37392189	rs2244797	A	G	4	6	10	0	0	10	0	0
20	37392498	rs6124014	C	A	5	6	11	0	0	11	0	0
20	37392789	rs6124015	A	G	3	5	8	0	0	8	0	0
20	37395112	rs2243520	A	G	2	4	6	0	0	6	0	0
20	37396262	rs2245237	A	G	3	3	6	0	0	6	0	0
20	37397158	rs2263750	A	G	6	2	8	0	1	9	0	0
20	37397511	rs2757522	A	G	2	4	6	0	0	6	0	0
20	37397909	rs2247983	A	G	5	2	7	0	0	7	0	0
20	37398041	rs75612781	A	G	4	2	6	0	1	7	0	0
20	37399152	rs6128946	C	A	3	5	8	0	0	8	0	0
20	37399219	rs6124025	A	T	3	4	7	0	0	7	0	0
20	37399488	rs6128947	C	T	14	10	24	0	0	24	0	0
20	37399739	rs78239530	G	A	16	11	27	0	0	27	0	0
20	37399874	rs911721	C	T	9	13	22	0	0	22	0	0
20	37399942	rs911720	G	A	9	20	29	0	0	29	0	0
20	37399987	rs6124026	A	G	18	11	29	0	0	29	0	0
20	37400490	rs6128952	G	A	123	85	208	0	1	209	0	0
20	37400515	rs6128953	T	A	124	97	221	0	3	224	0	0
20	37435992	rs74823004	G	A	3	6	9	0	0	9	0	0
20	37436005	rs74698215	G	A	3	6	9	0	0	9	0	0
20	37438465	rs146922001	A	G	1	27	28	0	1	29	0	0
20	37439403	rs79251793	C	T	5	1	6	0	0	6	0	0
20	37455995	rs2015901	C	T	5	6	11	0	0	11	0	0
20	37456165	rs77170256	T	G	7	6	13	0	0	13	0	0
20	37456205	rs2016946	T	C	4	4	8	0	0	8	0	0
20	37457184	rs6101326	C	G	3	3	6	0	0	6	0	0
20	37459695	rs77950902	A	G	12	14	26	0	0	26	0	0
20	37460030	rs926484	G	A	18	24	42	0	0	42	0	0
20	37460606	rs117386150	T	A	6	9	15	0	0	15	0	0
20	37461311	rs6015966	G	C	5	3	8	0	0	8	0	0
20	37461354	rs6028157	C	G	5	2	7	0	0	7	0	0
20	37470175	rs77025875	A	G	8	14	22	0	0	22	0	0
20	37485233	rs4812323	T	C	3	3	6	0	0	6	0	0
20	37534665	rs4812332	C	T	83	86	169	0	0	169	0	0
20	37536119	rs4812333	T	A	5	3	8	0	0	8	0	0
20	37547374	rs4812336	G	A	86	78	164	0	1	165	0	0
20	37548730	rs748063	A	G	89	108	197	0	2	199	0	0
20	37549309	rs4810245	G	A	136	162	298	0	3	301	0	0
20	37550935	rs10392	G	A	338	302	640	0	7	647	0	0
20	37570725	rs3752293	C	T	32	35	67	0	0	67	0	0
20	37581437	rs1130247	A	G	26	20	46	0	1	47	0	0
20	37581506	rs1733	G	A	28	14	42	0	0	42	0	0
20	37600036	rs6028232	T	G	8	5	13	0	0	13	0	0
20	37600887	rs8118646	A	G	8	1	9	0	0	9	0	0
20	37601243	rs16987712	A	G	22	16	38	0	1	39	0	0
20	37639209	rs73621984	A	G	4	9	13	0	0	13	0	0
20	37668272	rs6729	A	G	12	16	28	0	1	29	0	0
20	39314670	rs3577	G	A	47	48	95	0	0	95	0	0
20	39657625	rs34282819	C	A	32	31	63	0	1	64	0	0
20	39660608	rs75534547	G	T	18	7	25	0	0	25	0	0
20	39660687	rs6129731	A	C	10	4	14	0	0	14	0	0
20	39689929	rs111990613	T	C	3	3	6	0	0	6	0	0
20	39713869	rs2223745	G	A	5	1	6	0	0	6	0	0
20	39718209	rs78668007	G	A	8	2	10	0	0	10	0	0
20	39719202	rs6124315	A	G	7	3	10	0	0	10	0	0
20	39720615	rs75338731	G	A	9	8	17	0	0	17	0	0
20	39721373	rs2076574	A	G	12	8	20	0	0	20	0	0
20	39723683	rs6129753	T	A	20	14	34	0	1	35	0	0
20	39724338	rs6065311	T	C	39	36	75	0	0	75	0	0
20	39794489	rs6124323	G	A	3	4	7	0	0	7	0	0
20	39796067	rs33947984	T	G	14	2	16	0	0	16	0	0
20	39796713	rs55698162	T	C	1	8	9	0	0	9	0	0
20	39798418	rs2076146	G	C	1	6	7	0	0	7	0	0
20	39808660	rs2235366	G	T	3	3	6	0	0	6	0	0
20	39811275	rs4297946	G	C	6	21	27	0	0	27	0	0
20	39829713	rs148384567	C	T	4	8	12	0	0	12	0	0
20	40032029	rs1156	T	G	64	65	129	0	1	130	0	0
20	42087467	rs6103331	C	T	13	11	24	0	1	25	0	0
20	42088658	rs117222808	A	C	17	12	29	0	0	29	0	0
20	42088773	.	G	A	358	319	677	0	0	677	0	0
20	42089140	rs34934568	T	A	10	4	14	0	0	14	0	0
20	42089804	rs117799664	G	C	406	407	813	0	2	815	0	0
20	42178435	rs2269623	T	C	19	0	19	0	0	19	0	0
20	42178556	rs2269622	G	C	27	0	27	0	0	27	0	0
20	42179558	rs41279270	C	T	8	0	8	0	0	8	0	0
20	42264653	rs41296223	G	A	39	28	67	0	0	67	0	0
20	42331457	rs2070235	A	G	154	136	290	0	0	290	0	0
20	42336205	rs826955	C	G	3	8	11	0	0	11	0	0
20	42336280	rs34112567	C	T	5	2	7	0	0	7	0	0
20	42336684	rs420755	C	G	2	7	9	0	0	9	0	0
20	42337875	rs285171	C	G	7	6	13	0	0	13	0	0
20	42341564	rs12625913	A	G	4	4	8	0	0	8	0	0
20	42343821	rs11556379	C	G	278	255	533	0	2	535	0	0
20	42825929	rs8268	C	T	609	547	1156	0	6	1162	0	0
20	42826350	rs9346	A	C	430	374	804	0	2	806	0	0
20	42826379	rs11274	C	T	444	334	778	0	2	780	0	0
20	42826555	rs1971447	C	A	9	8	17	0	0	17	0	0
20	42826710	rs6103674	C	T	8	8	16	0	0	16	0	0
20	42832193	rs6130566	C	A	3	4	7	0	0	7	0	0
20	42838550	rs2143606	A	G	41	40	81	0	0	81	0	0
20	42838640	rs41282016	G	C	34	43	77	0	1	78	0	0
20	42838712	rs2143607	C	G	50	41	91	0	1	92	0	0
20	43123028	rs1983	G	A	13	14	27	0	0	27	0	0
20	43125581	rs11696879	G	C	9	5	14	0	0	14	0	0
20	43531440	rs117690200	C	A	7	6	13	0	0	13	0	0
20	43584561	rs188226901	A	G	2	4	6	0	0	6	0	0
20	43601921	rs910671	G	T	9	5	14	0	0	14	0	0
20	43603533	rs6073582	A	C	4	5	9	0	1	10	0	0
20	43604003	rs6017452	C	T	10	7	17	0	1	18	0	0
20	43626696	rs7271519	T	C	78	61	139	0	0	139	0	0
20	43627127	rs34131103	G	A	58	51	109	0	1	110	0	0
20	43629135	rs17420378	G	A	43	52	95	0	2	97	0	0
20	43696456	rs2267861	A	T	5	4	9	0	0	9	0	0
20	43704937	rs6017482	A	G	80	89	169	0	0	169	0	0
20	43704943	rs6031972	T	C	80	85	165	0	0	165	0	0
20	43704963	rs6031973	C	G	91	79	170	0	0	170	0	0
20	43708297	rs8000	T	G	134	166	300	0	12	312	0	0
20	43974319	rs2741454	C	T	4	3	7	0	0	7	0	0
20	43975451	rs1981431	C	A	5	3	8	0	0	8	0	0
20	43975871	rs6104124	C	T	4	2	6	0	0	6	0	0
20	43976281	rs2072786	G	C	4	2	6	0	0	6	0	0
20	43976991	rs2228384	A	G	35	37	72	0	1	73	0	0
20	44050342	rs4812899	T	C	13	16	29	0	0	29	0	0
20	44051036	rs6032172	C	A	14	22	36	0	0	36	0	0
20	44051444	rs4810449	G	A	12	16	28	0	2	30	0	0
20	44051497	rs4812900	T	C	12	21	33	0	0	33	0	0
20	44052992	rs13217	G	A	397	438	835	0	2	837	0	0
20	44053577	.	G	T	15	10	25	0	0	25	0	0
20	44428561	rs139393795	G	A	9	10	19	0	0	19	0	0
20	44470923	rs56204716	C	T	19	15	34	0	0	34	0	0
20	44485670	rs75498225	G	A	15	5	20	0	0	20	0	0
20	44511627	rs11086984	C	T	10	15	25	0	0	25	0	0
20	44512638	rs34017227	G	T	29	21	50	0	1	51	0	0
20	44701824	rs16985456	A	C	4	2	6	0	0	6	0	0
20	44702550	rs112669547	C	T	5	4	9	0	0	9	0	0
20	45027364	rs6065979	C	T	32	29	61	0	1	62	0	0
20	45839078	rs3204475	C	T	28	35	63	0	6	71	2	0
20	45840459	rs6063085	A	C	5	2	7	0	0	7	0	0
20	45841052	rs910187	G	A	4	4	8	0	0	8	0	0
20	45848956	.	G	C	73	65	138	0	0	138	0	0
20	45865978	rs8121471	T	C	4	3	7	0	0	7	0	0
20	45905095	.	C	T	24	20	44	0	0	44	0	0
20	45918289	rs6018395	A	G	5	5	10	0	0	10	0	0
20	46264888	rs2230782	G	C	45	34	79	0	0	79	0	0
20	46282346	rs3092417	A	G	106	56	162	0	0	173	11	0
20	46284584	rs2179591	A	G	9	12	21	0	1	22	0	0
20	46294725	rs2076545	C	T	1	7	8	0	0	8	0	0
20	46399895	rs6090728	A	G	3	5	8	0	0	8	0	0
20	47241117	rs7403	G	A	234	203	437	0	3	440	0	0
20	47241358	rs2664570	C	T	179	132	311	0	3	314	0	0
20	47241618	rs2598	A	G	160	114	274	0	1	275	0	0
20	47242313	rs11553082	G	A	143	149	292	0	2	294	0	0
20	47242739	.	T	C	8	4	12	0	0	12	0	0
20	47242971	rs6095216	T	G	10	5	15	0	0	15	0	0
20	47244598	rs6095217	A	G	3	6	9	0	0	9	0	0
20	47244931	rs3935522	A	G	6	6	12	0	0	12	0	0
20	47245076	rs13040578	G	A	3	8	11	0	1	12	0	0
20	47245510	rs6125404	A	G	1	10	11	0	1	12	0	0
20	47254947	rs66487963	C	T	16	7	23	0	0	23	0	0
20	47255673	rs6095223	C	T	17	5	22	0	0	22	0	0
20	47256064	rs73140181	A	G	18	13	31	0	0	31	0	0
20	47256479	rs4611698	T	C	21	12	33	0	0	33	0	0
20	47257296	rs35010397	A	G	8	16	24	0	0	24	0	0
20	47257393	rs533276395	A	C	9	2	11	0	0	11	0	0
20	47258763	rs16993997	C	T	103	107	210	0	1	211	0	0
20	47261017	rs6066802	T	C	61	49	110	0	1	111	0	0
20	47267480	rs41283556	A	G	81	55	136	0	1	137	0	0
20	47267940	rs61748372	G	A	67	55	122	0	0	122	0	0
20	47269233	rs41283558	C	G	73	73	146	0	0	146	0	0
20	47273726	rs55904123	C	T	69	62	131	0	2	133	0	0
20	47275496	rs56012801	A	G	4	4	8	0	0	8	0	0
20	47277187	rs56172784	A	G	6	5	11	0	0	11	0	0
20	47279830	rs73144013	A	G	3	6	9	0	0	9	0	0
20	47281174	rs56313864	A	G	2	6	8	0	0	8	0	0
20	47281558	.	C	T	5	1	6	0	0	6	0	0
20	47290619	rs6063305	C	T	5	2	7	0	0	7	0	0
20	47586590	rs4810902	A	G	4	2	6	0	0	6	0	0
20	47588568	rs6066932	G	A	5	1	6	0	1	7	0	0
20	47589122	rs2273102	T	C	10	6	16	0	0	16	0	0
20	47614497	rs3764682	C	A	10	17	27	0	0	27	0	0
20	47627170	rs6095396	G	T	4	3	7	0	0	7	0	0
20	47628363	rs1535268	G	A	6	2	8	0	0	8	0	0
20	47630449	rs2281582	C	T	77	64	141	0	1	142	0	0
20	47682893	rs2246266	C	T	7	6	13	0	0	13	0	0
20	47707944	rs6063351	C	T	5	5	10	0	0	10	0	0
20	47708434	rs149219789	A	G	6	5	11	0	0	11	0	0
20	47712409	rs2426128	A	G	10	10	20	0	0	20	0	0
20	47713063	rs17632	C	T	103	126	229	0	1	230	0	0
20	47731158	rs1043361	T	C	144	130	274	0	1	276	1	0
20	47731228	rs1043357	A	C	156	130	286	0	2	288	0	0
20	47741556	rs3818262	C	T	7	2	9	0	0	9	0	0
20	47760856	rs6066979	A	G	15	21	36	0	1	37	0	0
20	47760857	rs6066980	G	C	16	21	37	0	0	37	0	0
20	47763734	rs348279	T	C	4	4	8	0	0	8	0	0
20	47766197	rs7272164	T	C	3	4	7	0	0	7	0	0
20	47847732	rs41310030	C	T	4	4	8	0	0	8	0	0
20	47848037	rs238171	G	A	4	7	11	0	0	11	0	0
20	47848214	rs238172	C	T	5	4	9	0	0	9	0	0
20	47848715	rs761499	T	G	4	5	9	0	0	9	0	0
20	47849526	rs761497	G	A	4	9	13	0	0	13	0	0
20	47849546	rs6122768	T	C	5	11	16	0	0	16	0	0
20	47850182	rs238148	C	T	107	95	202	0	0	202	0	0
20	47850614	rs1079661	A	T	14	9	23	0	0	23	0	0
20	47850757	rs238149	T	G	14	6	20	0	0	20	0	0
20	47852349	rs487639	T	C	15	9	24	0	0	24	0	0
20	47852354	rs487644	T	C	15	11	26	0	0	26	0	0
20	47852822	rs238152	G	A	3	4	7	0	0	7	0	0
20	47855159	rs238155	C	G	4	3	7	0	0	7	0	0
20	47858135	rs6067028	A	G	5	2	7	0	0	7	0	0
20	47858922	rs238203	T	G	6	4	10	0	0	10	0	0
20	47859015	rs238204	A	G	4	6	10	0	0	10	0	0
20	47859217	rs1130146	G	A	237	203	440	0	3	443	0	0
20	47862103	rs238206	A	G	2	6	8	0	0	8	0	0
20	47862450	rs7689	T	C	16	27	43	0	2	45	0	0
20	47865372	rs238208	G	A	149	118	267	0	2	269	0	0
20	47865509	rs238209	G	A	114	123	237	0	0	237	0	0
20	47866411	rs6063378	G	A	27	21	48	0	0	48	0	0
20	47866522	rs238210	T	A	11	8	19	0	0	19	0	0
20	47866880	rs190220	A	G	8	17	25	0	0	25	0	0
20	47867028	rs171131	A	T	17	13	30	0	0	30	0	0
20	47867287	rs238211	C	T	5	4	9	0	0	9	0	0
20	47867309	rs238212	C	A	6	3	9	0	0	9	0	0
20	47867592	rs238213	A	G	18	18	36	0	0	36	0	0
20	47867599	rs11696801	T	G	17	15	32	0	0	32	0	0
20	47868862	rs238214	A	T	13	14	27	0	0	27	0	0
20	47870752	rs238216	T	C	24	17	41	0	1	42	0	0
20	47871624	rs238218	C	T	8	7	15	0	0	15	0	0
20	47871729	rs238219	G	A	11	9	20	0	0	20	0	0
20	47872327	rs238220	A	G	17	18	35	0	0	35	0	0
20	47872377	rs238221	C	G	75	70	145	0	0	145	0	0
20	47872900	rs6125600	T	C	14	15	29	0	0	29	0	0
20	47879382	rs238175	T	C	3	5	8	0	0	8	0	0
20	47881581	rs6063380	A	C	6	4	10	0	0	10	0	0
20	47881597	rs238176	A	G	6	2	8	0	0	8	0	0
20	47881890	rs238177	T	G	5	4	9	0	0	9	0	0
20	47883037	rs238179	C	T	3	3	6	0	0	6	0	0
20	47886684	rs57950	G	A	47	44	91	0	1	92	0	0
20	47895197	rs479474	C	T	227	186	413	0	0	413	0	0
20	47898217	rs238196	G	A	2	8	10	0	0	10	0	0
20	47899486	rs238199	C	T	12	7	19	0	0	19	0	0
20	47899889	rs238201	T	C	10	6	16	0	0	16	0	0
20	47900164	rs6067034	G	A	1	10	11	0	1	12	0	0
20	47900336	rs238202	G	C	10	11	21	0	1	22	0	0
20	47903344	rs237742	T	C	19	15	34	0	0	34	0	0
20	47903784	rs237740	T	C	5	10	15	0	0	15	0	0
20	47903826	rs6122781	T	G	5	14	19	0	0	19	0	0
20	47904143	rs237739	C	T	21	13	34	0	0	34	0	0
20	47904298	rs6125610	C	T	17	28	45	0	1	46	0	0
20	47904734	rs6125611	G	T	15	15	30	0	0	30	0	0
20	47904920	rs237738	T	C	10	17	27	0	0	27	0	0
20	47905008	rs237737	G	A	24	25	49	0	1	50	0	0
20	47905475	rs80306164	G	A	66	63	129	0	2	131	0	0
20	47905508	rs8197	G	A	64	66	130	0	1	131	0	0
20	48705287	rs6020246	A	C	123	54	177	0	1	178	0	0
20	48708007	rs8125336	C	T	6	1	7	0	0	7	0	0
20	48729677	rs126907	C	G	35	20	55	0	0	55	0	0
20	49191904	rs754118	T	C	3	3	6	0	0	6	0	0
20	49194096	rs2426162	T	C	4	5	9	0	0	9	0	0
20	49194607	rs6020611	A	G	1	6	7	0	0	7	0	0
20	49194615	rs2426163	A	G	1	5	6	0	0	6	0	0
20	49195248	rs968701	G	A	11	7	18	0	0	18	0	0
20	49195493	rs4809800	C	A	9	10	19	0	0	19	0	0
20	49196167	rs2282147	T	C	13	4	17	0	0	17	0	0
20	49196599	rs718049	C	T	7	3	10	0	0	10	0	0
20	49196602	rs718053	G	A	7	3	10	0	0	10	0	0
20	49196930	rs718050	A	G	8	6	14	0	0	14	0	0
20	49196998	rs3787348	G	T	8	5	13	0	0	13	0	0
20	49197203	rs914460	C	T	9	13	22	0	0	22	0	0
20	49198327	rs2426164	G	A	16	14	30	0	0	30	0	0
20	49205095	rs1060402	G	A	5	3	8	0	0	8	0	0
20	49205492	rs9305104	G	A	2	4	6	0	0	6	0	0
20	49214156	rs6020624	A	G	16	14	30	0	0	30	0	0
20	49214383	rs6012972	G	C	3	6	9	0	0	9	0	0
20	49215719	rs2904273	C	A	4	2	6	0	0	6	0	0
20	49216966	rs4811082	C	T	4	7	11	0	0	11	0	0
20	49222999	rs62202770	C	T	1	5	6	0	0	6	0	0
20	49493609	rs6702	G	A	8	5	13	0	0	13	0	0
20	49506195	rs875068	C	G	50	37	87	0	0	87	0	0
20	49506698	rs910072	A	C	6	5	11	0	3	14	0	0
20	49514013	rs4811100	T	C	5	1	6	0	0	6	0	0
20	49517246	rs17726865	G	C	3	4	7	0	0	7	0	0
20	49520193	rs6020837	C	T	3	3	6	0	1	7	0	0
20	49522796	rs6126123	A	G	3	3	6	0	0	6	0	0
20	49527913	rs59916803	G	A	4	4	8	0	0	8	0	0
20	49552904	rs2294902	A	G	4	13	17	0	3	20	0	0
20	49554352	rs6020858	A	T	2	6	8	0	0	8	0	0
20	49568605	rs2426213	G	A	2	5	7	0	1	8	0	0
20	50004654	rs1052653	T	C	20	30	50	0	0	50	0	0
20	50005077	rs1052649	C	T	5	1	6	0	0	6	0	0
20	50005736	rs2869419	G	C	24	23	47	0	0	47	0	0
20	50007215	rs763944	T	C	6	2	8	0	0	8	0	0
20	50092027	rs6013193	T	G	16	13	29	0	1	30	0	0
20	50213722	rs13128	T	C	8	2	10	0	0	10	0	0
20	50215554	rs41274694	A	C	3	3	6	0	0	6	0	0
20	50216286	rs3827044	A	C	2	4	6	0	0	6	0	0
20	52192595	rs61748378	C	T	52	55	107	0	0	107	0	0
20	54941905	rs1044377	G	T	9	11	20	0	0	20	0	0
20	54942032	.	A	G	7	11	18	0	0	18	0	0
20	54944791	rs8173	C	G	29	20	49	0	0	49	0	0
20	54961463	rs1047972	T	C	10	10	20	0	0	20	0	0
20	54961541	rs2273535	A	T	4	13	17	0	0	17	0	0
20	54978835	rs6024853	G	A	77	79	156	0	0	156	0	0
20	54979171	rs7806	C	T	60	42	102	0	0	102	0	0
20	54988502	rs6024864	G	A	5	1	6	0	0	6	0	0
20	55026686	rs79282013	A	G	4	2	6	0	0	6	0	0
20	55028167	rs2870738	G	A	31	20	51	0	0	51	0	0
20	55029388	rs4811694	A	G	7	6	13	0	0	13	0	0
20	55029758	rs401897	T	C	17	9	26	0	0	26	0	0
20	55033476	rs3746623	C	G	22	27	49	0	0	49	0	0
20	55033635	rs3746624	C	T	23	29	52	0	0	52	0	0
20	55033647	rs3746625	T	C	20	27	47	0	1	48	0	0
20	55033713	rs3746626	G	A	33	40	73	0	2	75	0	0
20	55033856	rs4811697	A	C	32	46	78	0	0	78	0	0
20	55035365	rs67266356	G	A	1	8	9	0	3	12	0	0
20	55045843	rs6014740	T	C	14	13	27	0	1	28	0	0
20	55070946	rs6064405	C	G	5	1	6	0	0	6	0	0
20	55071192	rs4811709	C	T	6	3	9	0	0	9	0	0
20	55077967	rs2144609	G	A	4	2	6	0	0	6	0	0
20	55078533	rs3827108	T	C	4	4	8	0	0	8	0	0
20	55078573	rs3787395	G	A	3	4	7	0	0	7	0	0
20	55079380	rs34983295	G	A	3	6	9	0	0	9	0	0
20	55079958	rs6024913	T	C	2	4	6	0	0	6	0	0
20	55081353	rs13041953	C	T	2	6	8	0	0	8	0	0
20	55081379	rs6092324	A	G	5	3	8	0	0	8	0	0
20	55085062	rs12480844	A	G	3	7	10	0	1	11	0	0
20	55086063	rs12106067	T	C	3	3	6	0	0	6	0	0
20	55087041	rs11699883	A	C	4	6	10	0	0	10	0	0
20	55087964	rs11699551	T	C	10	11	21	0	0	21	0	0
20	55088798	rs13043526	T	C	5	5	10	0	0	10	0	0
20	55089031	rs1061532	G	A	5	4	9	0	0	9	0	0
20	55093901	rs6999	A	G	80	110	190	0	2	192	0	0
20	55096042	rs4811711	T	G	6	3	9	0	0	9	0	0
20	55096136	rs4810024	A	G	5	6	11	0	0	11	0	0
20	55096228	rs6099183	T	G	4	2	6	0	0	6	0	0
20	55097048	rs4810025	G	A	5	3	8	0	0	8	0	0
20	55097232	rs4810026	A	C	5	2	7	0	0	7	0	0
20	55097478	rs6099184	A	G	8	7	15	0	0	15	0	0
20	55097788	rs6092325	C	T	6	0	6	0	0	6	0	0
20	55099008	rs142735535	G	A	9	10	19	0	0	19	0	0
20	55108617	rs3209183	C	A	88	84	172	0	2	174	0	0
20	55109304	rs6024938	C	T	6	1	7	0	0	7	0	0
20	55111371	rs2296130	G	A	119	94	213	0	2	215	0	0
20	55927472	rs2038612	C	G	3	6	9	0	0	9	0	0
20	55940921	rs6025517	T	C	5	2	7	0	0	7	0	0
20	55951474	rs7270995	A	G	8	8	16	0	0	16	0	0
20	55952187	rs911901	A	G	5	5	10	0	0	10	0	0
20	55952591	rs4810064	G	A	11	5	16	0	0	16	0	0
20	55952702	rs2426710	T	A	7	5	12	0	0	12	0	0
20	55953682	rs6070089	C	T	4	4	8	0	0	8	0	0
20	55978153	rs13037066	A	G	8	10	18	0	0	18	0	0
20	56941286	rs35136891	C	A	6	4	10	0	0	10	0	0
20	56942082	rs1045408	A	T	12	17	29	0	0	29	0	0
20	56942312	rs707557	C	T	16	19	35	0	0	35	0	0
20	56998203	rs62205707	T	C	5	1	6	0	0	6	0	0
20	56998249	rs62205708	C	T	6	2	8	0	0	8	0	0
20	57020573	rs1802459	A	G	15	29	44	0	0	44	0	0
20	57227209	rs139859128	G	A	4	5	9	0	0	9	0	0
20	57235374	rs16982218	T	C	3	5	8	0	0	8	0	0
20	57244493	rs2296524	G	A	41	43	84	0	0	84	0	0
20	57248951	.	A	C	4	2	6	0	0	6	0	0
20	57250764	rs6123818	G	A	6	1	7	0	0	7	0	0
20	57253275	rs11578	C	T	113	106	219	0	1	220	0	0
20	57253404	rs7683	G	A	112	87	199	0	1	200	0	0
20	57253712	rs189786439	A	T	119	66	185	0	11	196	0	0
20	57258163	rs2031538	A	T	4	3	7	0	0	7	0	0
20	57261336	rs6128399	T	C	4	4	8	0	0	8	0	0
20	57266072	rs200804226	G	A	4	4	8	0	0	8	0	0
20	57269495	rs7262862	G	A	71	78	149	0	2	151	0	0
20	57278244	rs6026456	C	T	22	8	30	0	0	30	0	0
20	57278450	rs6100172	G	A	14	19	33	0	0	33	0	0
20	57278529	rs745268	G	A	22	12	34	0	0	34	0	0
20	57278967	rs3746395	C	A	19	17	36	0	0	36	0	0
20	57279854	rs6015342	C	T	19	20	39	0	0	39	0	0
20	57282381	rs2296529	T	C	2	4	6	0	2	8	0	0
20	57284136	rs11698363	G	A	7	2	9	0	2	11	0	0
20	57284759	rs6100177	G	C	8	4	12	0	0	12	0	0
20	57285380	rs6026465	G	C	5	3	8	0	0	8	0	0
20	57285847	rs73124388	G	T	3	6	9	0	0	9	0	0
20	57285935	rs74338216	C	G	3	3	6	0	0	6	0	0
20	57286576	rs73124390	T	C	8	2	10	0	0	10	0	0
20	57288744	rs1570894	G	A	101	78	179	0	10	189	0	0
20	57289675	.	C	T	227	203	430	0	1	431	0	0
20	57293477	rs2426778	G	A	4	4	8	0	0	8	0	0
20	57293988	rs2246228	C	T	7	4	11	0	0	11	0	0
20	57478807	rs7121	C	T	1276	1332	2608	0	27	2635	0	0
20	57480933	rs919197	T	C	3	10	13	0	0	13	0	0
20	57481148	rs3787493	A	G	10	9	19	0	0	19	0	0
20	57481587	rs6015400	C	G	11	2	13	0	0	13	0	0
20	57483655	rs234630	T	C	35	18	53	0	1	54	0	0
20	57483948	rs234629	G	A	33	21	54	0	0	54	0	0
20	57485611	rs234628	T	C	7	5	12	0	0	12	0	0
20	57564489	rs41314904	G	A	13	4	17	0	0	17	0	0
20	57564695	rs17851253	C	T	93	32	125	0	3	128	0	0
20	57566637	rs149265	C	T	12	18	30	0	0	30	0	0
20	57569816	rs7341	G	T	138	247	385	0	3	388	0	0
20	57571763	rs9760	A	G	63	76	139	0	4	143	0	0
20	57572839	rs2295357	G	T	1	5	6	0	0	6	0	0
20	57604343	rs151353	A	C	3	5	8	0	0	8	0	0
20	57609055	rs151357	A	G	62	47	109	0	3	112	0	0
20	57610059	rs151358	C	A	111	95	206	0	1	207	0	0
20	58644995	rs6071100	T	C	3	3	6	0	0	6	0	0
20	58900594	rs7261471	T	C	4	3	7	0	0	7	0	0
20	60579138	rs2273989	G	A	4	7	11	0	0	11	0	0
20	60637637	rs4925337	T	C	4	2	6	0	0	6	0	0
20	60700129	rs2002239	G	T	4	4	8	0	0	8	0	0
20	60700554	rs4538273	C	T	8	11	19	0	0	19	0	0
20	60702503	rs6089656	G	T	3	8	11	0	0	11	0	0
20	60703707	rs6121904	C	G	4	6	10	0	0	10	0	0
20	60706836	rs1555578	C	G	5	6	11	0	0	11	0	0
20	60706922	rs4925347	A	T	2	6	8	0	1	9	0	0
20	60707040	rs2038687	G	A	6	2	8	0	0	8	0	0
20	60708216	rs6089657	G	A	9	8	17	0	0	17	0	0
20	60708734	rs6089658	T	C	9	10	19	0	0	19	0	0
20	60708790	rs6089659	G	C	7	9	16	0	0	16	0	0
20	60708882	rs6089660	G	A	6	8	14	0	0	14	0	0
20	60708909	rs6142961	G	C	5	6	11	0	0	11	0	0
20	60712284	rs2057169	G	A	51	25	76	0	0	76	0	0
20	60712347	rs2057168	G	A	66	45	111	0	0	111	0	0
20	60712511	rs2281740	A	G	37	35	72	0	1	73	0	0
20	60713038	rs2281739	T	C	46	40	86	0	0	86	0	0
20	60713311	rs7076	G	A	671	714	1385	0	4	1389	0	0
20	60713332	rs1135961	A	G	614	661	1275	0	0	1276	1	0
20	60713571	rs6062077	G	A	14	13	27	0	0	27	0	0
20	60713906	rs3827118	G	A	19	11	30	0	1	31	0	0
20	60714525	rs6089664	G	A	84	85	169	0	0	169	0	0
20	60717203	rs6089665	G	T	5	10	15	0	0	15	0	0
20	60717681	rs4141921	C	G	4	2	6	0	0	6	0	0
20	60718420	rs3746651	C	T	23	26	49	0	1	50	0	0
20	60757341	rs554330077	C	A	32	28	60	0	0	60	0	0
20	60768497	rs2236527	C	T	1	5	6	0	0	6	0	0
20	60776182	rs1054885	G	A	7	10	17	0	0	17	0	0
20	60776996	rs12625898	C	T	7	1	8	0	0	8	0	0
20	60777070	rs2144279	A	G	5	2	7	0	0	7	0	0
20	60777232	rs6061457	C	T	6	0	6	0	0	6	0	0
20	60848948	rs2236524	G	A	8	4	12	0	0	12	0	0
20	60849854	rs117445240	G	A	3	3	6	0	0	6	0	0
20	60852398	rs6062183	C	T	6	6	12	0	0	12	0	0
20	60852517	rs6089718	C	T	9	2	11	0	1	12	0	0
20	60853562	rs7262431	T	G	10	5	15	0	1	16	0	0
20	60856281	rs2282213	G	A	4	5	9	0	0	9	0	0
20	60857034	rs2274938	G	A	3	3	6	0	0	6	0	0
20	60858776	rs6121538	A	G	2	4	6	0	0	6	0	0
20	60859537	rs6121978	A	G	6	5	11	0	0	11	0	0
20	60860916	rs4925367	G	A	36	39	75	0	0	75	0	0
20	60860944	rs4925368	C	T	34	37	71	0	2	73	0	0
20	60861061	rs6089342	G	A	52	37	89	0	0	89	0	0
20	60861782	rs2297592	A	G	16	9	25	0	0	25	0	0
20	60864390	rs3746657	C	T	4	7	11	0	0	11	0	0
20	60867509	rs2379131	T	C	8	2	10	0	0	10	0	0
20	60867510	rs2379130	G	A	8	2	10	0	0	10	0	0
20	60867591	rs4925370	A	G	5	7	12	0	0	12	0	0
20	60867854	rs4925372	G	A	5	2	7	0	0	7	0	0
20	60867993	rs6062198	G	A	5	4	9	0	0	9	0	0
20	60868251	rs56237636	T	C	4	2	6	0	0	6	0	0
20	60879829	rs7264166	C	T	6	6	12	0	0	12	0	0
20	60880653	rs3088238	G	A	15	15	30	0	0	30	0	0
20	60884339	rs3184293	G	A	50	33	83	0	0	83	0	0
20	60963055	rs911077	T	C	32	32	64	0	0	64	0	0
20	60963188	rs6121395	G	C	29	25	54	0	1	55	0	0
20	60963775	rs709206	T	A	6	10	16	0	0	16	0	0
20	60964122	rs747949	G	A	16	21	37	0	0	37	0	0
20	60964301	rs747948	C	T	11	19	30	0	0	30	0	0
20	60972881	rs11906036	C	G	3	4	7	0	0	7	0	0
20	61300863	rs8124538	G	A	3	5	8	0	0	8	0	0
20	61302240	rs182837828	A	G	8	6	14	0	0	14	0	0
20	61302510	rs6062771	C	T	8	5	13	0	1	14	0	0
20	61303004	rs3787538	T	C	14	12	26	0	0	26	0	0
20	61303346	rs117035894	C	T	18	14	32	0	1	33	0	0
20	61303566	rs1055196	T	C	10	8	18	0	0	18	0	0
20	61393382	rs2427441	C	T	5	6	11	0	0	11	0	0
20	61393445	rs2427442	A	G	7	3	10	0	0	10	0	0
20	61393458	rs2427443	C	T	8	4	12	0	0	12	0	0
20	61393873	rs2427444	C	T	12	9	21	0	0	21	0	0
20	61431503	rs7396	T	C	71	65	136	0	0	136	0	0
20	61431531	rs56005449	C	T	69	76	145	0	1	146	0	0
20	61438159	rs7266184	C	G	18	17	35	0	1	36	0	0
20	61439393	rs41306384	C	T	15	10	25	0	0	25	0	0
20	61444785	rs28368556	G	A	63	41	104	0	8	112	0	0
20	61512117	.	C	T	4	2	6	0	0	6	0	0
20	61519042	rs1056984	T	C	25	15	40	0	0	40	0	0
20	61519232	rs6011447	C	T	27	22	49	0	0	49	0	0
20	61519618	rs3746769	T	C	19	20	39	0	0	39	0	0
20	61519866	rs3746767	C	T	12	19	31	0	1	32	0	0
20	61519988	rs3746766	A	G	12	22	34	0	0	34	0	0
20	61520794	rs3746765	C	T	10	12	22	0	2	24	0	0
20	61521183	rs6090153	C	T	9	3	12	0	0	12	0	0
20	61521515	rs2273083	C	T	3	7	10	0	0	10	0	0
20	61522019	rs6010778	T	C	3	7	10	0	0	10	0	0
20	61527378	rs6090155	G	A	5	2	7	0	0	7	0	0
20	61528271	rs1883847	C	T	3	8	11	0	0	11	0	0
20	61532591	rs6011458	C	T	3	3	6	0	0	6	0	0
20	61535237	rs3746760	C	T	4	3	7	0	0	7	0	0
20	61536938	rs2295000	G	A	89	90	179	0	0	179	0	0
20	61537999	rs6010781	C	T	23	28	51	0	1	52	0	0
20	61538090	rs6011465	G	A	18	7	25	0	1	26	0	0
20	61538110	rs6011466	C	T	14	9	23	0	0	23	0	0
20	61541028	rs2295001	C	G	8	1	9	0	0	9	0	0
20	61543606	rs12480870	A	C	6	2	8	0	0	8	0	0
20	61560004	rs3746759	T	G	4	3	7	0	0	7	0	0
20	61564901	rs73619441	T	G	3	7	10	0	0	10	0	0
20	61565006	rs67165375	G	C	2	8	10	0	0	10	0	0
20	61565174	rs6011487	A	G	3	6	9	0	0	9	0	0
20	61565255	rs6011488	G	A	3	6	9	0	0	9	0	0
20	61565485	rs749812	G	A	5	4	9	0	0	9	0	0
20	61565511	rs749813	C	T	6	5	11	0	0	11	0	0
20	61565514	rs749814	G	A	6	4	10	0	0	10	0	0
20	61566716	rs6090171	G	C	3	4	7	0	0	7	0	0
20	61569523	rs8120151	G	C	32	22	54	0	0	54	0	0
20	61571208	rs1054866	C	A	7	11	18	0	0	18	0	0
20	61572760	rs13039291	C	T	15	19	34	0	0	34	0	0
20	61573736	rs3787513	G	A	5	3	8	0	0	8	0	0
20	61574660	rs2254953	A	G	33	16	49	0	6	55	0	0
20	61574727	rs2295481	C	T	26	28	54	0	0	54	0	0
20	61576777	rs1052826	A	G	187	142	329	0	2	331	0	0
20	61587698	rs6062384	C	T	5	2	7	0	0	7	0	0
20	61588159	rs2245341	A	G	111	54	165	0	2	167	0	0
20	61594349	.	G	A	97	131	228	0	1	229	0	0
20	61594353	rs3810459	A	G	134	97	231	0	4	235	0	0
20	61594433	rs3810460	G	A	128	82	210	0	0	210	0	0
20	61594493	rs3729555	G	A	81	96	177	0	0	177	0	0
20	61595498	rs529430191	G	A	74	77	151	0	4	155	0	0
20	61595636	rs2248900	C	T	160	136	296	0	4	300	0	0
20	61598348	rs3746753	C	T	10	12	22	0	0	22	0	0
20	61598352	rs3746752	T	G	11	13	24	0	0	24	0	0
20	61598574	rs3746751	C	T	14	17	31	0	0	31	0	0
20	61598899	rs3746750	A	G	229	207	436	0	9	445	0	0
20	61599388	rs752430	C	T	304	176	480	0	2	482	0	0
20	61599474	rs1047126	C	T	266	163	429	0	5	434	0	0
20	61735509	rs750698	T	G	5	4	9	0	1	10	0	0
20	61830133	rs3787511	G	A	4	3	7	0	0	7	0	0
20	61831003	rs6090293	C	T	4	3	7	0	0	7	0	0
20	61834695	rs6122103	G	A	102	151	253	0	0	253	0	0
20	61835933	rs6090296	T	C	3	8	11	0	1	12	0	0
20	61836263	rs11906847	G	A	1	9	10	0	0	10	0	0
20	61837875	rs6122104	T	C	3	3	6	0	0	6	0	0
20	61837923	rs6090303	T	C	5	4	9	0	0	9	0	0
20	61841612	rs6090307	C	T	4	6	10	0	0	10	0	0
20	61843727	rs11906654	A	G	5	1	6	0	0	6	0	0
20	61847068	rs6090310	C	G	5	7	12	0	0	12	0	0
20	61868017	rs4809511	T	C	1	7	8	0	0	8	0	0
20	61868397	rs6090320	T	C	5	15	20	0	0	20	0	0
20	61868493	rs6090321	C	G	5	20	25	0	0	25	0	0
20	61869607	rs6010878	C	A	3	3	6	0	0	6	0	0
20	61870727	rs1077019	G	C	13	39	52	0	0	52	0	0
20	61882988	rs6122412	C	T	1	5	6	0	0	6	0	0
20	61904625	rs4809517	C	T	4	3	7	0	0	7	0	0
20	61905015	rs77044240	G	C	4	2	6	0	0	6	0	0
20	61906696	rs4809518	A	T	2	4	6	0	0	6	0	0
20	61907982	rs11542296	C	T	23	27	50	0	1	51	0	0
20	61908951	rs76055528	G	A	9	7	16	0	0	16	0	0
20	61909041	rs6011715	A	G	10	6	16	0	0	16	0	0
20	61913269	rs80001097	C	T	6	4	10	0	0	10	0	0
20	61914465	rs911065	A	G	24	10	34	0	0	34	0	0
20	61915374	rs78423273	C	T	29	34	63	0	0	63	0	0
20	61915375	rs11086161	G	T	36	28	64	0	0	64	0	0
20	61916379	rs13042357	C	T	13	5	18	0	0	18	0	0
20	61917425	rs78818145	G	A	19	10	29	0	0	29	0	0
20	61917636	rs911066	T	C	23	11	34	0	0	34	0	0
20	61918286	rs8115872	T	G	5	6	11	0	0	11	0	0
20	61918421	rs77114045	A	G	4	5	9	0	0	9	0	0
20	61918796	rs4809282	C	G	3	13	16	0	0	16	0	0
20	61918799	rs4809520	T	C	3	13	16	0	0	16	0	0
20	61919481	rs13865	C	T	95	83	178	0	2	180	0	0
20	62162235	.	G	A	7	3	10	0	0	10	0	0
20	62162340	rs191090	T	C	4	2	6	0	0	6	0	0
20	62189671	.	C	T	9	21	30	0	1	31	0	0
20	62190412	rs310628	G	A	59	68	127	0	1	128	0	0
20	62191321	rs3810477	A	G	47	55	102	0	0	102	0	0
20	62191937	rs11551685	G	A	65	69	134	0	0	134	0	0
20	62193587	rs3810482	T	C	4	2	6	0	0	6	0	0
20	62194030	rs3810483	G	C	20	29	49	0	0	49	0	0
20	62194103	rs3810484	A	G	11	18	29	0	0	29	0	0
20	62194128	rs3810485	G	A	8	19	27	0	0	27	0	0
20	62195087	rs310630	A	G	9	14	23	0	0	23	0	0
20	62196253	rs310631	C	A	29	24	53	0	1	54	0	0
20	62219837	rs1151621	A	G	126	129	255	0	2	257	0	0
20	62221249	rs311497	A	G	67	69	136	0	1	137	0	0
20	62221610	rs311496	T	C	43	40	83	0	1	84	0	0
20	62224797	rs188719	C	T	4	2	6	0	0	6	0	0
20	62227081	rs311489	A	G	62	64	126	0	0	126	0	0
20	62230107	.	C	G	2	6	8	0	0	8	0	0
20	62230557	rs446267	T	C	2	5	7	0	0	7	0	0
20	62230585	rs443147	T	G	2	4	6	0	0	6	0	0
20	62230706	rs453481	G	A	7	7	14	0	0	14	0	0
20	62230933	rs445328	G	A	5	4	9	0	0	9	0	0
20	62230974	rs432717	G	A	3	5	8	0	0	8	0	0
20	62233190	rs1151619	C	T	2	4	6	0	0	6	0	0
20	62233357	rs1151618	A	G	3	6	9	0	0	9	0	0
20	62233638	rs35897249	G	A	3	4	7	0	0	7	0	0
20	62233764	rs4809311	G	T	3	7	10	0	0	10	0	0
20	62234241	rs2145262	A	G	4	6	10	0	0	10	0	0
20	62235052	rs6122488	G	A	4	9	13	0	0	13	0	0
20	62235279	rs6010970	T	C	9	6	15	0	0	15	0	0
20	62258892	rs35096459	C	G	21	31	52	0	0	52	0	0
20	62259368	rs112359937	G	T	56	19	75	0	14	90	1	0
20	62273130	rs13042091	C	T	4	4	8	0	0	8	0	0
20	62293272	rs3848668	A	G	21	10	31	0	0	31	0	0
20	62297400	rs73920935	T	C	13	8	21	0	0	21	0	0
20	62312531	rs75123278	G	A	5	1	6	0	0	6	0	0
20	62319284	rs76364377	G	A	14	0	14	0	0	14	0	0
20	62321189	rs61753459	C	T	29	20	49	0	1	50	0	0
20	62324289	rs3848672	C	T	42	51	93	0	0	93	0	0
20	62328375	rs2738787	A	G	12	14	26	0	0	26	0	0
20	62340115	rs1291212	C	G	53	49	102	0	0	103	1	0
20	62362322	.	C	G	5	2	7	0	2	9	0	0
20	62363838	rs6010634	T	C	2	4	6	0	0	6	0	0
20	62364885	rs6011068	T	A	5	8	13	0	0	13	0	0
20	62367377	rs2427535	A	G	120	120	240	0	1	241	0	0
20	62370349	rs1056441	T	C	17	13	30	0	0	30	0	0
20	62372148	rs6062510	G	C	16	13	29	0	1	30	0	0
20	62372706	rs4809221	G	A	57	38	95	0	2	97	0	0
20	62372813	rs2427536	G	A	138	121	259	0	1	260	0	0
20	62373707	rs8957	G	T	178	149	327	0	3	330	0	0
20	62374441	rs6742	T	C	59	79	138	0	0	138	0	0
20	62376939	rs2296763	A	C	30	26	56	0	0	56	0	0
20	62387549	rs4809223	C	G	4	6	10	0	0	10	0	0
20	62387830	rs4809224	T	A	2	4	6	0	0	6	0	0
20	62407104	rs3827026	C	T	4	3	7	0	0	7	0	0
20	62492772	rs6011193	C	G	4	11	15	0	0	15	0	0
20	62512996	rs6122205	A	G	15	9	24	0	0	24	0	0
20	62515177	rs35438264	G	C	13	4	17	0	1	18	0	0
20	62517549	rs4809241	A	G	18	13	31	0	2	33	0	0
20	62518441	rs3795154	C	T	20	23	43	0	0	43	0	0
20	62518689	rs3795155	C	G	26	32	58	0	0	58	0	0
20	62518729	rs3795156	A	G	27	32	59	0	0	59	0	0
20	62518766	rs3795157	C	T	25	31	56	0	0	56	0	0
20	62520671	rs6062569	T	C	13	5	18	0	0	18	0	0
20	62520674	rs6010690	G	T	13	5	18	0	0	18	0	0
20	62522315	rs8567	A	G	422	367	789	0	2	792	1	0
20	62522466	rs7000	A	G	378	340	718	0	4	722	0	0
20	62529758	rs6011209	C	T	4	2	6	0	0	6	0	0
20	62558127	rs12481368	C	T	4	2	6	0	0	6	0	0
20	62573064	rs817370	T	C	22	22	44	0	0	44	0	0
20	62578700	rs4606988	C	T	4	3	7	0	0	7	0	0
20	62579209	rs6011235	G	A	4	4	8	0	1	9	0	0
20	62585943	rs76321513	G	A	4	2	6	0	0	6	0	0
20	62589377	rs748251	G	A	97	123	220	0	2	222	0	0
20	62592063	rs112303344	A	G	6	5	11	0	0	11	0	0
20	62592903	rs79864192	T	G	11	3	14	0	1	15	0	0
20	62592905	rs73147087	A	G	11	3	14	0	1	15	0	0
20	62594831	rs41278228	G	A	5	7	12	0	0	12	0	0
20	62598815	rs817330	C	T	51	40	91	0	0	91	0	0
20	62599357	rs56015416	C	T	8	7	15	0	1	16	0	0
20	62599442	rs3810501	C	T	10	14	24	0	0	24	0	0
20	62599471	rs3810502	G	C	10	14	24	0	0	24	0	0
20	62599612	rs817332	C	T	6	9	15	0	0	15	0	0
20	62605984	rs817339	G	A	30	15	45	0	2	47	0	0
20	62606617	rs41278232	G	A	10	6	16	0	0	16	0	0
20	62641575	rs2427588	G	A	105	98	203	0	0	203	0	0
20	62661027	rs816932	G	C	7	7	14	0	0	14	0	0
20	62661274	rs73916684	T	C	15	4	19	0	2	21	0	0
20	62663037	rs559029954	A	C	10	2	12	0	0	12	0	0
20	62663136	rs7260907	A	C	20	19	39	0	0	39	0	0
20	62663143	rs816934	G	C	19	22	41	0	0	41	0	0
20	62663416	rs816935	C	T	4	3	7	0	0	7	0	0
20	62663641	rs816936	T	C	9	4	13	0	0	13	0	0
20	62695634	rs6062625	T	A	6	2	8	0	0	8	0	0
20	62695878	rs6062342	C	A	2	4	6	0	1	7	0	0
20	62698188	rs34848242	G	A	5	6	11	0	0	11	0	0
20	62698484	rs10460612	G	A	6	5	11	0	0	11	0	0
20	62700228	rs6011275	T	G	1	7	8	0	0	8	0	0
20	62701092	rs4809393	A	C	26	25	51	0	0	51	0	0
20	62703490	rs13039439	C	T	30	68	98	0	0	98	0	0
20	62705140	rs6011280	A	C	58	52	110	0	1	111	0	0
20	62705807	rs111477741	C	T	8	4	12	0	0	12	0	0
20	62706105	rs4408777	A	G	4	7	11	0	0	11	0	0
20	62714783	rs6010717	C	G	3	4	7	0	0	7	0	0
20	62890095	rs111732137	G	A	3	8	11	0	0	11	0	0
20	62890877	rs60417583	G	T	5	5	10	0	0	10	0	0
20	62903535	rs11906201	T	C	3	4	7	0	0	7	0	0
20	62906157	rs1060285	G	C	77	61	138	0	1	139	0	0
20	62906433	rs11907846	T	C	120	110	230	0	2	232	0	0
20	62906514	rs10485816	G	A	101	89	190	0	0	190	0	0
20	62907521	rs1060347	G	T	4	4	8	0	0	8	0	0
21	9907271	.	A	G	9	1	10	0	0	10	0	0
21	9907345	.	C	T	14	4	18	0	0	18	0	0
21	9907375	.	T	C	13	4	17	0	0	17	0	0
21	9907384	.	G	A	12	4	16	0	0	16	0	0
21	9907416	rs3887623	C	T	10	1	11	0	0	11	0	0
21	9908223	rs374471127	G	A	8	0	8	0	0	8	0	0
21	15456403	rs62209955	T	A	3	4	7	0	0	7	0	0
21	15859450	rs406209	C	T	6	9	15	0	0	15	0	0
21	15884949	rs3761320	A	T	9	3	12	0	0	12	0	0
21	15884955	rs3761321	A	T	8	2	10	0	0	10	0	0
21	15885104	rs2049857	C	T	7	6	13	0	0	13	0	0
21	15886616	rs2822711	T	C	11	17	28	0	0	28	0	0
21	15886991	rs7282239	A	C	6	10	16	0	0	16	0	0
21	15887545	rs991249	A	G	6	7	13	0	0	13	0	0
21	15890220	rs2822715	T	C	3	3	6	0	0	6	0	0
21	15890471	rs8134290	C	T	4	4	8	0	0	8	0	0
21	15893134	rs2822719	G	C	5	1	6	0	2	8	0	0
21	15893228	rs760343	C	T	6	1	7	0	0	7	0	0
21	16334027	rs76206782	T	A	315	308	623	0	2	625	0	0
21	16334658	rs1056947	C	T	211	203	414	0	3	417	0	0
21	16335402	rs2142450	C	T	98	93	191	0	1	192	0	0
21	16336804	rs1056930	T	C	44	54	98	0	1	99	0	0
21	16347460	rs2736089	T	C	9	9	18	0	0	18	0	0
21	16349257	rs909385	T	A	4	2	6	0	0	6	0	0
21	16352070	rs2776041	C	T	6	5	11	0	0	11	0	0
21	16359460	rs1297215	T	C	11	10	21	0	0	21	0	0
21	16363533	rs34570637	G	A	18	2	20	0	0	20	0	0
21	16372686	rs73172382	A	G	4	2	6	0	0	6	0	0
21	17111101	rs1989381	A	G	6	6	12	0	0	12	0	0
21	18971359	rs7276872	A	C	13	12	25	0	0	25	0	0
21	18971735	rs9976768	A	C	3	7	10	0	0	10	0	0
21	18973620	rs35432050	G	A	4	5	9	0	0	9	0	0
21	18974450	rs7281633	G	A	5	1	6	0	0	6	0	0
21	18974894	rs13046207	G	C	4	5	9	0	0	9	0	0
21	18976385	rs67787603	C	A	6	4	10	0	0	10	0	0
21	18978176	rs2824389	G	C	25	36	61	0	1	62	0	0
21	18980283	rs77118758	G	C	14	11	25	0	0	25	0	0
21	18981962	rs77661407	G	A	28	27	55	0	0	55	0	0
21	19163803	rs2257906	T	C	21	27	48	0	0	48	0	0
21	19169155	rs1047978	G	C	41	53	94	0	2	96	0	0
21	20230102	rs2825212	C	T	31	0	31	0	1	32	0	0
21	21629450	rs9974943	A	G	31	23	54	0	0	54	0	0
21	21630425	rs2826108	C	T	17	6	23	0	0	23	0	0
21	21630537	rs2826109	C	T	10	16	26	0	1	27	0	0
21	21630788	rs2826110	G	T	15	25	40	0	1	41	0	0
21	25815326	rs116518605	A	T	3	4	7	0	0	7	0	0
21	25861576	rs111587366	T	A	4	6	10	0	0	10	0	0
21	25861913	rs80351145	C	A	4	5	9	0	0	9	0	0
21	25861961	rs74950746	T	C	2	6	8	0	0	8	0	0
21	25862092	rs145974877	G	A	3	3	6	0	0	6	0	0
21	25862282	rs56942176	T	C	3	5	8	0	0	8	0	0
21	26961086	rs2829807	T	C	4	6	10	0	0	10	0	0
21	26974922	rs139730845	C	T	3	3	6	0	0	6	0	0
21	26976897	rs7279263	C	T	3	5	8	0	0	8	0	0
21	26977844	rs4817038	G	A	3	3	6	0	0	6	0	0
21	27106656	rs17001334	A	G	40	87	127	0	1	128	0	0
21	27108744	rs71649650	T	C	4	3	7	0	0	7	0	0
21	27111913	rs67271845	T	C	6	8	14	0	0	14	0	0
21	27112274	rs59288687	T	C	4	3	7	0	0	7	0	0
21	27121792	rs928265	A	G	1	7	8	0	0	8	0	0
21	27122451	rs8128535	A	G	3	3	6	0	0	6	0	0
21	27367821	rs9974796	C	G	5	13	18	0	0	18	0	0
21	27368698	rs9983719	G	A	10	6	16	0	0	16	0	0
21	27368761	rs45567540	G	C	6	6	12	0	0	12	0	0
21	27368994	rs45498998	A	G	5	8	13	0	0	13	0	0
21	27369222	rs8131144	G	A	5	5	10	0	0	10	0	0
21	27369409	rs8132220	T	C	5	3	8	0	0	8	0	0
21	27495768	rs2000988	A	G	7	7	14	0	0	14	0	0
21	27496667	rs2830068	T	C	3	4	7	0	0	7	0	0
21	27839251	rs1478108	A	G	7	7	14	0	1	15	0	0
21	27840297	rs2830239	G	A	14	6	20	0	0	20	0	0
21	27850971	rs2830249	G	A	8	2	10	0	0	10	0	0
21	27852724	rs966410	A	G	18	18	36	0	1	37	0	0
21	27930900	rs13052533	A	T	10	24	34	0	0	34	0	0
21	27931248	rs1395053	T	C	15	14	29	0	0	29	0	0
21	28208954	rs8992	A	G	2	21	23	0	0	23	0	0
21	28212760	rs436525	G	A	1	9	10	0	0	10	0	0
21	30341891	rs2254796	A	G	9	7	16	0	1	17	0	0
21	30408670	rs2274802	A	T	67	41	108	0	0	108	0	0
21	30414724	rs2254872	C	T	16	12	28	0	0	28	0	0
21	30415629	rs2832157	A	G	6	4	10	0	0	10	0	0
21	30416824	rs2853830	A	G	6	11	17	0	2	19	0	0
21	30425212	rs56404428	C	T	9	5	14	0	0	14	0	0
21	30436514	rs190594785	C	T	12	9	21	0	0	21	0	0
21	30443596	rs2853827	T	C	3	5	8	0	0	8	0	0
21	30445961	rs2012645	G	A	9	6	15	0	0	15	0	0
21	30467677	rs1054718	C	G	7	6	13	0	1	14	0	0
21	30714598	rs411697	G	A	5	2	7	0	0	7	0	0
21	30714776	rs388707	T	C	54	76	130	0	2	132	0	0
21	30715275	rs425989	T	C	54	52	106	0	1	107	0	0
21	30717151	rs368322	C	T	95	73	168	0	1	169	0	0
21	30717737	rs372883	T	C	57	98	155	0	4	159	0	0
21	30718201	rs15092	G	A	68	46	114	0	2	116	0	0
21	33037958	rs118132937	C	T	4	7	11	0	0	11	0	0
21	33040162	rs1041740	C	T	56	33	89	0	1	90	0	0
21	33040371	rs4817420	C	T	29	11	40	0	0	40	0	0
21	33053860	rs2298366	T	C	85	36	121	0	1	122	0	0
21	33053880	rs2298367	G	A	114	66	180	0	1	181	0	0
21	33054761	rs2833480	G	A	30	26	56	0	2	58	0	0
21	33056573	rs4816408	G	A	48	31	79	0	0	79	0	0
21	33068937	rs78537042	C	A	71	64	135	0	1	137	1	0
21	33068962	rs7280330	T	C	60	80	140	0	0	140	0	0
21	33073125	rs8132845	A	T	4	5	9	0	0	9	0	0
21	33640966	rs56768797	T	C	16	14	30	0	0	30	0	0
21	33641152	rs8129993	A	G	29	23	52	0	1	53	0	0
21	33691546	rs62620710	C	T	3	5	8	0	0	8	0	0
21	33694586	rs2833766	A	T	3	6	9	0	0	9	0	0
21	33765496	rs112644530	A	C	22	3	25	0	0	25	0	0
21	33765560	rs11702306	C	T	41	23	64	0	1	65	0	0
21	34124296	rs2011397	C	G	3	4	7	0	0	7	0	0
21	34443781	rs762180	C	G	23	3	26	0	0	26	0	0
21	34444137	rs11554600	G	A	16	5	21	0	0	21	0	0
21	34613967	rs8128785	C	A	5	3	8	0	0	8	0	0
21	34638699	rs45607743	C	A	6	3	9	0	0	9	0	0
21	34640788	rs2834167	A	G	19	39	58	0	0	58	0	0
21	34668747	rs3171425	A	G	45	59	104	0	1	105	0	0
21	34669381	rs1058867	G	A	58	86	144	0	0	144	0	0
21	34715699	rs2257167	G	C	79	62	141	0	2	143	0	0
21	34801908	rs8128483	T	C	9	10	19	0	0	19	0	0
21	34802610	rs17879705	C	T	7	4	11	0	0	11	0	0
21	34806218	rs2284554	T	C	11	3	14	0	0	14	0	0
21	34806288	rs2284555	G	A	12	2	14	0	1	15	0	0
21	34806305	rs2284556	G	A	12	3	15	0	0	15	0	0
21	34808289	rs2409493	A	G	5	2	7	0	0	7	0	0
21	34808408	rs2409494	C	T	3	5	8	0	1	9	0	0
21	34808649	rs73195828	T	G	10	7	17	0	0	17	0	0
21	34809049	rs2040120	T	A	4	2	6	0	0	6	0	0
21	34809693	rs1059293	C	T	124	103	227	0	2	229	0	0
21	34821131	rs8134200	C	T	30	7	37	0	0	37	0	0
21	34821570	rs1044218	G	A	30	26	56	0	0	56	0	0
21	34821691	rs1044213	G	C	37	30	67	0	0	67	0	0
21	34821807	rs1044195	C	T	30	48	78	0	1	79	0	0
21	34822150	rs2834217	T	A	23	21	44	0	2	46	0	0
21	34822629	rs9983740	T	C	13	9	22	0	0	22	0	0
21	34822636	rs3183852	T	C	12	10	22	0	0	22	0	0
21	34833553	rs2834228	T	C	5	5	10	0	0	10	0	0
21	34835774	rs7278056	C	G	6	1	7	0	0	7	0	0
21	34905758	.	T	A	4	3	7	0	0	7	0	0
21	34924228	rs61746013	G	A	86	81	167	0	0	167	0	0
21	35074421	.	T	G	6	0	6	0	3	9	0	0
21	35274135	rs117932060	C	T	3	4	7	0	0	7	0	0
21	35466375	rs2834378	C	G	3	8	11	0	0	11	0	0
21	35474410	rs2244724	G	A	6	5	11	0	0	11	0	0
21	35478063	rs9984245	G	T	7	7	14	0	0	14	0	0
21	35515117	rs7115	G	A	49	45	94	0	1	95	0	0
21	36164605	.	A	C	19	0	19	0	66	95	10	0
21	36232156	rs2248720	C	A	5	4	9	0	0	9	0	0
21	36232856	rs11702579	T	C	4	4	8	0	0	8	0	0
21	36233905	rs7280216	C	G	11	11	22	0	0	22	0	0
21	36235047	rs1003574	G	T	8	11	19	0	0	19	0	0
21	36235739	rs2251826	A	G	8	9	17	0	1	18	0	0
21	36236101	rs7282616	T	C	7	7	14	0	0	14	0	0
21	36236819	rs2268291	G	A	9	8	17	0	1	18	0	0
21	36241929	rs2252585	T	C	2	4	6	0	0	6	0	0
21	36243213	rs2268293	A	C	5	4	9	0	0	9	0	0
21	36243258	rs2268294	A	G	5	5	10	0	1	11	0	0
21	36357612	rs990116	G	A	6	1	7	0	0	7	0	0
21	36386924	rs76691544	T	C	0	7	7	0	0	7	0	0
21	36387233	rs76582412	A	G	1	7	8	0	0	8	0	0
21	36421036	rs8133634	T	C	4	2	6	0	0	6	0	0
21	37406849	rs762364	G	A	5	2	7	0	0	7	0	0
21	37410477	rs2835239	T	C	7	7	14	0	0	14	0	0
21	37410633	rs2835240	T	C	4	2	6	0	0	6	0	0
21	37443169	.	T	G	4	3	7	0	1	8	0	0
21	37444697	rs2835266	G	A	11	11	22	0	0	22	0	0
21	37609571	rs2835322	T	C	7	10	17	0	0	17	0	0
21	37617630	rs4817788	T	G	6	6	12	0	0	12	0	0
21	37617724	rs3746866	C	A	8	5	13	0	0	13	0	0
21	37649643	rs61612333	C	T	2	6	8	0	0	8	0	0
21	37661405	rs3827183	G	A	31	38	69	0	0	69	0	0
21	37727563	rs8132514	A	G	5	1	6	0	0	6	0	0
21	37733357	rs9978830	T	C	8	2	10	0	0	10	0	0
21	37784070	rs218630	G	A	7	4	11	0	0	11	0	0
21	37784285	.	C	G	4	8	12	0	0	12	0	0
21	38337916	rs12626528	G	C	4	3	7	0	0	7	0	0
21	38455599	rs62223591	A	G	2	8	10	0	0	10	0	0
21	38563639	rs61740519	C	T	33	43	76	0	0	76	0	0
21	38572258	rs79863595	G	A	4	6	10	0	0	10	0	0
21	38575262	.	A	C	186	165	351	0	2	353	0	0
21	38603369	rs12482772	G	C	2	5	7	0	0	7	0	0
21	38604570	rs2835680	C	T	4	2	6	0	0	6	0	0
21	38738173	.	C	A	6	8	14	0	0	14	0	0
21	38885506	rs17193211	C	T	172	170	342	0	0	342	0	0
21	39752673	rs6517463	C	T	7	14	21	0	0	21	0	0
21	39753346	rs2836353	A	C	8	11	19	0	0	19	0	0
21	39753375	rs2836354	T	C	5	10	15	0	0	15	0	0
21	39755976	rs12233325	T	A	6	7	13	0	0	13	0	0
21	39760711	rs2836356	C	T	28	16	44	0	1	45	0	0
21	39764588	rs2836361	G	A	4	4	8	0	0	8	0	0
21	39764784	rs2836362	T	C	7	2	9	0	0	9	0	0
21	39766031	rs2836363	C	T	3	6	9	0	0	9	0	0
21	39768274	rs2836365	A	G	6	5	11	0	0	11	0	0
21	39768750	rs2836366	T	C	3	5	8	0	0	8	0	0
21	39769032	rs2836367	T	C	3	8	11	0	0	11	0	0
21	39769113	rs2836368	T	C	2	6	8	0	0	8	0	0
21	39769249	rs12053730	T	C	5	2	7	0	0	7	0	0
21	39769817	rs2836369	G	C	4	2	6	0	0	6	0	0
21	39770364	rs2836370	T	C	21	12	33	0	0	33	0	0
21	39770856	rs3787889	A	T	5	4	9	0	1	10	0	0
21	39771629	rs79968499	T	A	19	13	32	0	0	32	0	0
21	39774348	rs2836372	C	G	2	5	7	0	0	7	0	0
21	39795202	rs3746880	T	G	6	14	20	0	0	20	0	0
21	40178042	rs185407591	A	G	75	77	152	0	5	157	0	0
21	40178043	rs190801053	G	C	78	79	157	0	0	157	0	0
21	40178381	rs714781	C	T	10	24	34	0	0	34	0	0
21	40178517	rs714780	G	T	34	10	44	0	0	44	0	0
21	40180659	rs57740627	C	T	40	8	48	0	0	48	0	0
21	40181026	rs73450552	A	G	17	7	24	0	1	25	0	0
21	40182177	rs3746882	T	C	3	3	6	0	0	6	0	0
21	40190620	rs10854389	C	G	5	3	8	0	0	8	0	0
21	40191389	rs79406319	T	G	5	5	10	0	0	10	0	0
21	40194216	rs2070531	C	T	8	6	14	0	0	14	0	0
21	40194308	rs6517481	A	G	10	9	19	0	0	19	0	0
21	40194350	rs7276961	A	G	9	13	22	0	0	22	0	0
21	40195059	rs711	A	G	643	612	1255	0	10	1266	1	0
21	40195277	rs530	T	A	352	287	639	0	2	641	0	0
21	40195464	rs1051420	A	C	531	543	1074	0	15	1089	0	0
21	40195485	rs1051425	T	C	474	472	946	0	12	959	1	0
21	40195828	rs1051475	T	C	68	93	161	0	3	164	0	0
21	40195836	rs1051476	C	G	65	96	161	0	3	164	0	0
21	40196388	rs11254	C	T	270	277	547	0	4	551	0	0
21	40550718	rs145238032	C	T	19	27	46	0	0	46	0	0
21	40642210	.	A	G	26	19	45	0	0	45	0	0
21	42515277	rs1001453	G	A	6	2	8	0	0	8	0	0
21	42541202	rs8134160	A	T	9	3	12	0	0	12	0	0
21	42749189	rs379839	A	G	9	7	16	0	0	16	0	0
21	42758383	.	G	A	5	2	7	0	0	7	0	0
21	42798173	rs464138	A	C	27	17	44	0	1	45	0	0
21	42800190	rs461093	C	G	1	6	7	0	0	7	0	0
21	42800518	rs464397	T	C	4	5	9	0	0	9	0	0
21	42800923	rs461448	C	A	4	3	7	0	0	7	0	0
21	42801128	rs458255	G	A	3	4	7	0	1	8	0	0
21	42802062	rs466866	A	G	3	13	16	0	0	16	0	0
21	42803126	rs466112	A	C	3	7	10	0	0	10	0	0
21	42803244	rs466135	T	C	5	10	15	0	0	15	0	0
21	42803526	rs466591	T	C	7	6	13	0	1	14	0	0
21	42803615	rs446742	G	A	5	8	13	0	1	14	0	0
21	42803840	rs456657	C	T	6	8	14	0	0	14	0	0
21	42803858	rs463856	A	G	7	10	17	0	1	18	0	0
21	42808716	rs469083	C	T	3	3	6	0	0	6	0	0
21	42809547	rs468867	A	G	5	6	11	0	0	11	0	0
21	42809722	rs467692	T	C	8	0	8	0	0	8	0	0
21	42809805	rs468917	A	G	9	1	10	0	0	10	0	0
21	42809806	rs469581	G	A	9	1	10	0	0	10	0	0
21	42809984	rs118088789	C	T	5	2	7	0	0	7	0	0
21	42810429	rs469153	A	C	7	4	11	0	0	11	0	0
21	42810505	rs469397	C	T	10	7	17	0	0	17	0	0
21	42811395	rs467558	C	T	13	5	18	0	0	18	0	0
21	42819205	rs467574	G	A	9	55	64	0	0	64	0	0
21	42819564	rs467639	T	A	4	28	32	0	0	32	0	0
21	42819922	rs468699	T	C	5	19	24	0	0	24	0	0
21	42819974	rs8133682	C	T	23	3	26	0	0	26	0	0
21	42820796	rs117833201	G	A	37	14	51	0	0	51	0	0
21	42821113	rs2070229	T	C	128	33	161	0	2	163	0	0
21	42821614	rs2075807	G	T	22	4	26	0	0	26	0	0
21	42821646	rs363976	A	G	5	18	23	0	1	24	0	0
21	42821648	rs2075808	G	A	19	5	24	0	1	25	0	0
21	42821696	rs2075809	C	G	18	8	26	0	0	26	0	0
21	42821747	rs468444	G	A	5	11	16	0	0	16	0	0
21	42821749	rs2075810	G	A	11	5	16	0	0	16	0	0
21	42822036	rs6517666	C	A	9	6	15	0	0	15	0	0
21	42822037	rs6517667	C	T	9	6	15	0	0	15	0	0
21	42822144	rs6517668	A	G	15	11	26	0	0	26	0	0
21	42822426	rs469126	A	T	6	23	29	0	0	29	0	0
21	42822432	rs13050773	G	A	20	6	26	0	1	27	0	0
21	42822641	rs34223646	C	A	4	2	6	0	0	6	0	0
21	42822704	rs34955673	T	A	3	3	6	0	0	6	0	0
21	42822983	rs1050080	G	A	22	8	30	0	0	30	0	0
21	42823372	rs3737399	C	T	14	5	19	0	0	19	0	0
21	42823389	rs3737400	A	G	10	3	13	0	0	13	0	0
21	42823395	rs3737401	C	T	9	2	11	0	0	11	0	0
21	42823532	rs13047535	C	T	4	3	7	0	0	7	0	0
21	42823552	rs62217502	G	A	5	4	9	0	0	9	0	0
21	42823623	rs13050726	G	A	4	4	8	0	0	8	0	0
21	42823785	rs117589529	A	G	11	1	12	0	1	13	0	0
21	42823805	rs7276891	T	C	9	2	11	0	1	12	0	0
21	42824733	rs469304	G	A	120	306	426	0	4	430	0	0
21	42825149	rs468259	G	C	2	6	8	0	0	8	0	0
21	42825736	rs467519	G	A	0	7	7	0	0	7	0	0
21	42826551	rs467593	G	A	2	5	7	0	0	7	0	0
21	42826763	rs467512	A	G	0	8	8	0	0	8	0	0
21	42827330	rs468904	C	T	4	3	7	0	0	7	0	0
21	42827478	rs468397	G	C	3	4	7	0	0	7	0	0
21	43274844	rs116907174	C	T	4	13	17	0	0	17	0	0
21	43305592	rs1045071	T	G	10	22	32	0	1	33	0	0
21	43305619	rs10368	C	T	13	22	35	0	0	35	0	0
21	43306075	rs2236439	G	C	9	5	14	0	0	14	0	0
21	43306101	rs2236440	A	G	8	7	15	0	0	15	0	0
21	43338302	rs2839421	A	G	4	4	8	0	0	8	0	0
21	43338328	rs2839422	C	A	5	2	7	0	0	7	0	0
21	43408618	rs2839430	T	A	8	6	14	0	0	14	0	0
21	43422525	rs928874	C	T	41	40	81	0	0	81	0	0
21	43425520	rs116978718	C	T	6	6	12	0	0	12	0	0
21	43426393	rs143032437	G	A	4	2	6	0	0	6	0	0
21	43428025	rs7277270	G	C	6	3	9	0	0	9	0	0
21	43431575	rs1054526	C	T	38	29	67	0	0	67	0	0
21	43652782	rs915846	C	G	7	3	10	0	0	10	0	0
21	43653053	rs225440	C	T	6	5	11	0	0	11	0	0
21	43653200	rs225441	C	G	2	6	8	0	1	9	0	0
21	43654061	rs9984192	G	T	7	3	10	0	0	10	0	0
21	43716901	rs1044317	A	G	6	9	15	0	0	15	0	0
21	43938465	rs62215906	C	T	52	63	115	0	1	116	0	0
21	43942135	rs6586324	C	T	4	4	8	0	0	8	0	0
21	43942307	rs6586326	T	C	4	6	10	0	0	10	0	0
21	43944231	rs875060	G	A	3	7	10	0	0	10	0	0
21	43944573	rs875061	C	T	1	9	10	0	0	10	0	0
21	43945703	rs2839539	C	T	3	3	6	0	0	6	0	0
21	43950053	rs62215925	T	C	6	2	8	0	0	8	0	0
21	43950304	rs228042	C	T	3	5	8	0	0	8	0	0
21	43952437	rs228049	C	T	2	4	6	0	0	6	0	0
21	43954292	rs73227564	T	C	7	5	12	0	0	12	0	0
21	43960077	rs228067	C	A	3	5	8	0	0	8	0	0
21	43981654	rs228096	G	A	23	13	36	0	0	36	0	0
21	43988736	rs1018307	C	G	27	22	49	0	0	49	0	0
21	43989704	rs55833159	C	G	23	24	47	0	0	47	0	0
21	43990177	rs9977798	G	A	11	7	18	0	2	20	0	0
21	43990667	rs4920123	C	T	31	36	67	0	0	67	0	0
21	43992477	rs12483004	A	C	3	9	12	0	0	12	0	0
21	43995327	rs62213023	C	T	3	5	8	0	0	8	0	0
21	44263321	rs76271836	G	A	7	3	10	0	0	10	0	0
21	44268289	rs111583381	T	C	1	8	9	0	0	9	0	0
21	44269860	rs60406170	A	C	6	9	15	0	0	15	0	0
21	44283574	rs11911090	C	T	8	9	17	0	0	17	0	0
21	44310364	rs11203163	G	A	13	11	24	0	0	24	0	0
21	44310630	rs11203164	A	G	12	12	24	0	0	24	0	0
21	44311517	rs13047779	C	T	15	9	24	0	1	25	0	0
21	44313530	rs146258645	G	A	8	0	8	0	0	8	0	0
21	44323590	rs4148973	T	G	12	9	21	0	1	22	0	0
21	44324365	rs10595	G	A	17	12	29	0	0	29	0	0
21	44331003	rs12627221	G	A	17	19	36	0	0	36	0	0
21	44331615	rs79511125	G	A	7	6	13	0	0	13	0	0
21	44331677	rs4920009	T	C	10	10	20	0	1	21	0	0
21	44331724	rs4920010	C	G	19	13	32	0	0	32	0	0
21	44331779	rs1132437	T	G	27	21	48	0	0	48	0	0
21	44332583	rs7278812	T	C	5	5	10	0	0	10	0	0
21	44443810	rs234717	C	T	3	4	7	0	0	7	0	0
21	44450938	rs3403	T	C	2	4	6	0	0	6	0	0
21	44452763	rs234737	C	T	4	3	7	0	0	7	0	0
21	44452813	rs234738	A	G	4	3	7	0	0	7	0	0
21	44452838	rs234739	C	A	2	4	6	0	0	6	0	0
21	44452948	rs234740	G	C	6	8	14	0	0	14	0	0
21	44453277	rs438889	C	T	7	6	13	0	0	13	0	0
21	44453278	rs373477	A	G	7	6	13	0	0	13	0	0
21	44453372	rs7936	G	C	10	5	15	0	0	15	0	0
21	44514488	rs3188479	G	A	54	45	99	0	4	103	0	0
21	44515346	rs4920039	T	C	137	105	242	0	0	243	1	0
21	44515504	rs4920040	T	C	153	126	279	0	3	282	0	0
21	44515685	rs2839634	T	C	153	105	258	0	4	262	0	0
21	44517072	rs7282749	G	A	51	28	79	0	0	79	0	0
21	44517755	rs4919962	G	A	47	18	65	0	2	67	0	0
21	44517914	rs1060112	C	T	45	30	75	0	0	75	0	0
21	44518028	rs1060111	G	A	74	45	119	0	1	120	0	0
21	44518691	rs2839635	C	G	7	12	19	0	0	19	0	0
21	44524006	rs1455979	G	A	37	20	57	0	2	59	0	0
21	44524900	rs2255829	C	G	31	25	56	0	0	56	0	0
21	44525219	rs1888523	G	A	41	31	72	0	0	72	0	0
21	44525501	rs1888524	A	G	31	16	47	0	0	47	0	0
21	44527249	rs4920043	T	C	26	13	39	0	0	39	0	0
21	44527289	rs4920044	C	T	18	4	22	0	0	22	0	0
21	44527351	rs1970689	G	C	4	2	6	0	0	6	0	0
21	44527669	rs17115876	T	G	7	4	11	0	0	11	0	0
21	44834807	rs10340	G	A	409	476	885	0	5	890	0	0
21	44835347	rs73380290	G	A	234	179	413	0	0	413	0	0
21	44836213	rs229343	C	T	103	190	293	0	4	297	0	0
21	44837359	rs2838300	G	A	4	2	6	0	0	6	0	0
21	44837551	rs430552	G	A	38	68	106	0	1	107	0	0
21	44837829	rs229345	C	T	8	8	16	0	0	16	0	0
21	44837889	rs762389	C	T	6	4	10	0	0	10	0	0
21	44837968	rs762390	G	A	5	3	8	0	0	8	0	0
21	44838330	rs34487963	C	A	55	87	142	0	2	144	0	0
21	44839153	rs2838302	A	G	15	9	24	0	0	24	0	0
21	44840382	rs657978	G	C	4	2	6	0	0	6	0	0
21	44840386	rs117253106	C	T	4	2	6	0	0	6	0	0
21	44841036	rs2006191	A	G	10	6	16	0	0	16	0	0
21	44841052	rs2006112	T	C	9	5	14	0	0	14	0	0
21	44841804	rs56265008	G	A	4	3	7	0	0	7	0	0
21	44841945	rs59151119	C	T	10	5	15	0	0	15	0	0
21	44842226	rs60567075	A	C	6	7	13	0	0	13	0	0
21	44842438	rs60022979	C	T	5	3	8	0	0	8	0	0
21	44842510	rs60066227	C	T	6	1	7	0	0	7	0	0
21	44842716	rs60054163	T	C	16	4	20	0	0	20	0	0
21	44843180	rs112212008	C	T	2	6	8	0	0	8	0	0
21	44844223	rs59900126	A	C	5	4	9	0	0	9	0	0
21	44844361	rs74472726	T	C	10	3	13	0	0	13	0	0
21	44844486	rs55707874	G	C	9	8	17	0	0	17	0	0
21	44844704	rs58117343	G	C	4	5	9	0	0	9	0	0
21	45047992	rs6518309	C	A	4	2	6	0	0	6	0	0
21	45114698	rs144718903	G	A	11	18	29	0	0	29	0	0
21	45155876	rs9985073	C	T	6	0	6	0	0	6	0	0
21	45157128	rs73373294	G	A	10	5	15	0	0	15	0	0
21	45388735	.	G	A	4	3	7	0	0	7	0	0
21	45403358	rs11537799	A	G	9	5	14	0	0	14	0	0
21	45404120	rs1058694	C	T	22	34	56	0	1	57	0	0
21	45404338	rs7435	A	G	13	15	28	0	0	28	0	0
21	45406095	rs14151	C	G	9	18	27	0	0	27	0	0
21	45527291	rs11550376	G	A	4	5	9	0	0	9	0	0
21	45564279	rs117310584	C	T	6	7	13	0	1	14	0	0
21	45643008	rs1048710	A	G	45	64	109	0	4	113	0	0
21	45643396	rs2298565	G	C	74	71	145	0	0	145	0	0
21	45644504	rs8127114	T	C	28	25	53	0	0	54	1	0
21	45644950	rs4818887	T	C	16	15	31	0	0	31	0	0
21	45645307	rs4818888	C	T	13	16	29	0	1	30	0	0
21	45645308	rs4818889	A	G	13	16	29	0	1	30	0	0
21	45646256	rs4818890	C	A	17	16	33	0	0	33	0	0
21	45646698	rs6518352	A	G	27	22	49	0	1	50	0	0
21	45647202	rs4819387	C	T	44	35	79	0	1	80	0	0
21	45647421	rs4819388	T	C	30	24	54	0	0	54	0	0
21	45648069	rs527776084	G	A	35	34	69	0	1	70	0	0
21	45648992	rs7278940	T	C	10	12	22	0	0	22	0	0
21	45649778	rs4568033	A	G	9	13	22	0	0	22	0	0
21	45649848	rs13052840	T	C	8	11	19	0	0	19	0	0
21	45652644	rs2329717	G	A	4	4	8	0	0	8	0	0
21	45653764	rs7278257	G	C	1	5	6	0	0	6	0	0
21	45655658	rs2070558	G	A	3	4	7	0	0	7	0	0
21	45656774	rs11558819	C	T	60	49	109	0	2	111	0	0
21	45660835	rs2847224	C	A	2	7	9	0	0	9	0	0
21	45732116	rs1057034	C	T	106	84	190	0	0	190	0	0
21	45734831	rs8127589	G	A	3	6	9	0	0	9	0	0
21	45735363	rs59952509	A	G	4	4	8	0	1	9	0	0
21	45744110	rs7279267	A	G	13	9	22	0	0	22	0	0
21	45745416	rs9981333	G	A	107	102	209	0	2	211	0	0
21	45750248	rs11552067	G	A	15	34	49	0	0	49	0	0
21	45750346	rs2070573	C	A	40	26	66	0	1	67	0	0
21	45750355	rs142932867	C	T	30	43	73	0	0	73	0	0
21	45751822	rs2277809	G	A	97	124	221	0	1	222	0	0
21	45753117	rs75087725	C	A	55	45	100	0	0	100	0	0
21	45753891	rs35498868	C	T	8	7	15	0	0	15	0	0
21	45755360	rs2236441	C	T	8	5	13	0	0	13	0	0
21	45756069	rs66916924	T	C	2	6	8	0	0	8	0	0
21	45756344	rs4818710	G	A	4	6	10	0	0	10	0	0
21	45756900	rs3788121	A	G	8	5	13	0	1	14	0	0
21	45757888	rs56212056	G	A	4	2	6	0	0	6	0	0
21	45759045	rs11870	C	T	16	19	35	0	0	35	0	0
21	45759197	rs73374031	G	C	2	5	7	0	0	7	0	0
21	45855678	.	C	T	6	3	9	0	0	9	0	0
21	46189230	rs8103	A	T	127	109	236	0	7	243	0	0
21	46189651	rs760431	A	C	99	120	219	0	2	221	0	0
21	46189652	rs760432	G	A	99	120	219	0	2	221	0	0
21	46189838	rs235355	C	A	105	73	178	0	3	181	0	0
21	46190410	rs1071792	G	A	55	42	97	0	2	99	0	0
21	46190842	rs2838678	A	G	46	35	81	0	0	81	0	0
21	46191117	rs173097	A	G	56	42	98	0	4	102	0	0
21	46191256	rs4818975	C	A	54	57	111	0	0	111	0	0
21	46194843	rs235359	C	T	15	6	21	0	0	21	0	0
21	46195108	rs73232942	C	A	12	18	30	0	0	30	0	0
21	46196103	rs73232943	A	G	9	7	16	0	0	16	0	0
21	46196728	rs1821431	C	A	9	7	16	0	0	16	0	0
21	46225665	rs235292	T	G	373	341	714	0	6	720	0	0
21	46226566	rs8645	T	G	382	282	664	0	10	674	0	0
21	46226786	rs1051331	A	G	370	300	670	0	2	672	0	0
21	46227603	rs9984357	T	C	5	2	7	0	0	7	0	0
21	46228748	rs873301	C	T	4	7	11	0	0	11	0	0
21	46228930	rs235293	C	T	3	4	7	0	0	7	0	0
21	46229393	rs2017089	C	T	6	1	7	0	0	7	0	0
21	46269526	rs741951	G	A	29	21	50	0	0	50	0	0
21	46273538	rs78467371	G	A	4	5	9	0	0	9	0	0
21	46274150	rs9985043	T	C	3	3	6	0	0	6	0	0
21	46276825	rs235318	G	A	30	27	57	0	0	57	0	0
21	46278047	rs235323	G	C	26	24	50	0	0	50	0	0
21	46278362	rs75778829	C	T	21	20	41	0	2	43	0	0
21	46281998	rs55745009	T	A	14	16	30	0	1	31	0	0
21	46287346	.	G	A	18	10	28	0	5	33	0	0
21	46288005	rs117729870	C	T	8	10	18	0	3	21	0	0
21	46292613	rs79999188	T	A	5	6	11	0	0	11	0	0
21	46310445	rs2075883	G	A	6	4	10	0	0	10	0	0
21	46328071	rs145977769	G	T	8	13	21	0	0	21	0	0
21	46328488	rs2011655	C	G	18	6	24	0	0	24	0	0
21	46328917	rs760458	C	A	5	4	9	0	0	9	0	0
21	46329312	rs760457	T	C	10	2	12	0	0	12	0	0
21	46334993	rs13047425	C	T	9	1	10	0	0	10	0	0
21	46643029	rs78107327	C	T	9	0	9	0	0	9	0	0
21	46643443	rs73233871	C	T	4	12	16	0	1	17	0	0
21	46645715	rs4819035	T	G	18	20	38	0	0	38	0	0
21	46684517	rs2838859	C	T	33	26	59	0	0	59	0	0
21	46684904	rs2838860	A	G	33	32	65	0	2	67	0	0
21	46685175	rs11558445	A	G	32	30	62	0	1	63	0	0
21	46685909	rs2256000	T	C	3	6	9	0	0	9	0	0
21	46686619	rs2838861	C	T	5	4	9	0	0	9	0	0
21	46686726	rs2838862	C	T	6	4	10	0	0	10	0	0
21	46686754	.	G	A	5	7	12	0	0	12	0	0
21	46688690	rs200043293	G	A	6	2	8	0	0	8	0	0
21	46689140	.	C	T	4	7	11	0	0	11	0	0
21	46689546	rs140195034	A	C	5	1	6	0	0	6	0	0
21	46689547	rs150360740	T	C	5	1	6	0	0	6	0	0
21	46689999	rs2246697	G	A	9	4	13	0	0	13	0	0
21	46690633	rs8128636	G	T	2	4	6	0	0	6	0	0
21	46690968	rs2330102	C	G	3	4	7	0	1	8	0	0
21	46697820	rs914214	G	T	5	4	9	0	0	9	0	0
21	46698256	rs914215	T	C	0	6	6	0	0	6	0	0
21	46705621	rs2297285	G	A	32	26	58	0	1	59	0	0
21	46711357	rs4819053	T	C	7	4	11	0	0	11	0	0
21	46711474	rs2838864	T	A	6	3	9	0	1	10	0	0
21	46711580	rs3746980	C	T	4	3	7	0	0	7	0	0
21	46716035	rs117727881	T	A	5	10	15	0	1	16	0	0
21	46716223	rs117903119	G	A	11	11	22	0	0	22	0	0
21	46716805	rs9977389	T	C	4	8	12	0	0	12	0	0
21	46896303	rs2230687	C	G	5	6	11	0	0	11	0	0
21	46896312	rs2230688	G	T	5	5	10	0	0	10	0	0
21	46908355	rs11702425	T	C	32	25	57	0	0	57	0	0
21	46909426	rs61731167	G	A	22	20	42	0	0	42	0	0
21	46910210	rs62000962	G	A	24	27	51	0	2	53	0	0
21	46911188	rs79980197	C	G	25	36	61	0	1	62	0	0
21	46929467	rs1050351	G	A	6	10	16	0	0	16	0	0
21	46932328	rs7499	G	A	45	33	78	0	0	78	0	0
21	46932383	rs8199	G	A	44	43	87	0	0	87	0	0
21	46932652	rs7867	G	A	33	19	52	0	0	52	0	0
21	46934518	rs2838955	T	C	9	4	13	0	0	13	0	0
21	46934826	rs1051298	G	A	21	14	35	0	1	36	0	0
21	46934861	rs1051296	A	C	27	15	42	0	0	42	0	0
21	46951556	rs12659	A	G	17	10	27	0	0	27	0	0
21	46957794	rs1051266	T	C	10	12	22	0	0	22	0	0
21	46957916	rs1131596	G	A	2	9	11	0	0	11	0	0
21	47155316	rs914243	A	G	4	2	6	0	0	6	0	0
21	47329352	rs2277812	T	C	8	7	15	0	0	15	0	0
21	47351726	.	T	C	4	3	7	0	0	7	0	0
21	47353016	rs413886	G	A	3	5	8	0	0	8	0	0
21	47420912	rs11700421	G	A	5	3	8	0	0	8	0	0
21	47545768	rs1042917	G	A	17	42	59	0	2	62	1	0
21	47545823	rs13052956	G	A	18	59	77	0	0	77	0	0
21	47545826	rs13046639	C	T	18	55	73	0	3	76	0	0
21	47545913	rs2839114	G	A	20	50	70	0	5	75	0	0
21	47549510	rs7717	G	C	8	3	11	0	0	11	0	0
21	47549569	rs559	T	C	8	2	10	0	0	10	0	0
21	47549629	rs1044598	T	A	2	6	8	0	0	8	0	0
21	47551833	rs7279622	C	T	5	6	11	0	0	11	0	0
21	47552624	rs11554666	C	T	24	7	31	0	2	33	0	0
21	47614443	rs2254522	A	G	23	9	32	0	0	32	0	0
21	47617489	rs11909555	T	G	2	4	6	0	0	6	0	0
21	47653345	rs17183473	C	G	8	10	18	0	0	18	0	0
21	47653422	rs8133857	T	C	5	7	12	0	1	13	0	0
21	47653704	rs9984708	T	C	9	9	18	0	0	18	0	0
21	47654666	rs17177030	C	A	3	4	7	0	0	7	0	0
21	47654667	rs17177023	C	T	3	3	6	0	1	7	0	0
21	47661158	rs17176926	C	T	6	7	13	0	0	13	0	0
21	47661235	rs3788252	C	T	5	3	8	0	0	8	0	0
21	47661587	rs2839167	A	G	4	5	9	0	0	9	0	0
21	47661900	rs17176905	G	C	3	3	6	0	1	7	0	0
21	47666332	rs2839169	A	G	38	44	82	0	0	82	0	0
21	47666744	rs17183220	G	T	70	79	149	0	2	151	0	0
21	47676180	rs2839172	A	G	3	4	7	0	0	7	0	0
21	47685939	rs2839181	A	G	48	40	88	0	0	88	0	0
21	47686152	rs2839182	C	T	2	5	7	0	0	7	0	0
21	47686174	rs4818831	T	C	2	4	6	0	0	6	0	0
21	47687652	rs117906089	T	A	8	8	16	0	0	16	0	0
21	47687808	rs8131960	G	C	8	9	17	0	0	17	0	0
21	47689062	rs116906806	G	A	10	5	15	0	0	15	0	0
21	47690068	rs2839186	C	T	9	7	16	0	0	16	0	0
21	47691729	rs7409792	C	A	2	4	6	0	0	6	0	0
21	47692209	rs17182746	C	G	8	7	15	0	0	15	0	0
21	47692531	rs17182739	T	C	46	32	78	0	2	80	0	0
21	47692798	rs2839188	C	T	14	15	29	0	0	29	0	0
21	47693014	rs55774624	G	A	9	7	16	0	0	16	0	0
21	47705237	rs17176131	T	C	14	11	25	0	0	25	0	0
21	47705673	rs17182538	C	A	4	2	6	0	0	6	0	0
21	47717493	rs61736728	G	T	15	16	31	0	0	31	0	0
21	47717616	rs8651	G	A	3	3	6	0	0	6	0	0
21	47720481	rs184847845	G	A	5	2	7	0	0	7	0	0
21	47744127	rs138595914	G	T	10	8	18	0	0	18	0	0
21	47766113	rs34500739	T	G	12	6	18	0	0	18	0	0
21	47773177	rs2249060	C	T	14	17	31	0	0	31	0	0
21	47777063	rs2839223	G	A	15	14	29	0	0	29	0	0
21	47783796	rs8131546	T	C	13	20	33	0	0	33	0	0
21	47786524	rs2839227	A	G	10	4	14	0	0	14	0	0
21	47786817	rs2839228	C	G	20	25	45	0	1	46	0	0
21	47787002	rs6518289	T	C	18	24	42	0	0	42	0	0
21	47808679	rs7279204	C	T	21	20	41	0	0	41	0	0
21	47831309	rs58559714	G	A	1	8	9	0	0	9	0	0
21	47831509	rs35940413	A	G	5	3	8	0	1	9	0	0
21	47831845	rs34268261	G	A	6	4	10	0	0	10	0	0
21	47836122	rs2839245	T	C	25	17	42	0	1	43	0	0
21	47836206	rs35978208	A	C	22	18	40	0	0	40	0	0
21	47836216	rs60444527	A	G	20	20	40	0	0	40	0	0
21	47836395	rs1044998	T	G	19	19	38	0	0	38	0	0
21	47836547	rs35346764	T	C	18	27	45	0	0	45	0	0
21	47838123	rs2839246	A	G	26	16	42	0	0	42	0	0
21	47841933	rs61735815	T	C	11	16	27	0	0	27	0	0
21	47841941	rs7277175	A	G	11	17	28	0	0	28	0	0
21	47841989	rs61735814	C	T	17	16	33	0	0	33	0	0
21	47847700	rs61735817	C	T	15	22	37	0	0	37	0	0
21	47848350	rs61735818	G	A	16	17	33	0	0	33	0	0
21	47848459	rs2839256	G	A	12	14	26	0	3	29	0	0
21	47850484	rs2070426	G	C	20	20	40	0	0	40	0	0
21	47851636	rs743346	G	A	29	35	64	0	0	64	0	0
21	47851796	rs9983522	G	A	26	33	59	0	0	59	0	0
21	47855876	rs17371795	A	G	28	36	64	0	1	65	0	0
21	47861347	rs117443010	G	A	1	5	6	0	0	6	0	0
21	47862624	rs2839262	A	G	26	13	39	0	0	39	0	0
21	47862654	rs17372047	C	T	24	13	37	0	1	38	0	0
21	47888333	rs550612084	A	C	5	3	8	0	1	9	0	0
21	47964135	rs17302525	A	G	1	5	6	0	0	6	0	0
21	47964208	rs77407175	C	T	4	7	11	0	0	11	0	0
21	47964272	rs11089076	G	A	5	7	12	0	0	12	0	0
21	47981878	rs2839326	T	C	5	4	9	0	0	9	0	0
21	47982145	rs7281133	C	G	5	4	9	0	0	9	0	0
21	47983089	rs743349	C	T	5	3	8	0	0	8	0	0
21	47983657	rs762253	G	A	7	7	14	0	0	14	0	0
21	47983680	rs762254	G	A	6	6	12	0	0	12	0	0
21	47987547	rs8127941	C	T	12	11	23	0	0	23	0	0
21	47988142	rs9941869	G	A	11	10	21	0	0	21	0	0
21	47988153	rs9941870	G	A	9	7	16	0	0	16	0	0
21	47988169	rs9941896	T	C	8	4	12	0	0	12	0	0
21	47988228	rs9941875	C	T	8	4	12	0	0	12	0	0
21	47988229	rs9941876	C	T	8	4	12	0	0	12	0	0
21	47988275	rs9941793	T	C	5	8	13	0	0	13	0	0
21	47988346	rs9941794	T	C	8	5	13	0	0	13	0	0
21	47988382	rs9941889	G	A	9	6	15	0	1	16	0	0
21	47988398	rs9941897	A	G	10	7	17	0	0	17	0	0
21	48055659	rs17305503	G	C	33	16	49	0	2	51	0	0
21	48059661	rs7349012	G	A	6	0	6	0	1	7	0	0
21	48060825	rs2839371	C	T	31	5	36	0	0	36	0	0
21	48062080	rs2256207	T	C	4	2	6	0	0	6	0	0
21	48062091	rs2256208	G	A	2	4	6	0	0	6	0	0
21	48063476	rs10854485	C	G	31	48	79	0	0	79	0	0
21	48079463	rs1054420	T	C	9	11	20	0	0	20	0	0
22	17095652	rs56179345	A	G	14	10	24	0	0	24	0	0
22	17569017	rs5746991	T	A	5	4	9	0	0	9	0	0
22	17580813	rs9606615	T	C	7	13	20	0	0	20	0	0
22	17582776	rs17807076	C	T	5	3	8	0	0	8	0	0
22	17585441	rs2302519	C	T	6	5	11	0	0	11	0	0
22	17585465	rs2302520	G	T	8	6	14	0	0	14	0	0
22	17586583	rs2241047	C	G	3	6	9	0	0	9	0	0
22	17586595	rs34484815	G	A	3	5	8	0	0	8	0	0
22	17587515	rs2241048	T	C	3	3	6	0	0	6	0	0
22	17587975	rs6518661	G	A	1	8	9	0	1	10	0	0
22	17589209	rs879577	C	T	80	43	123	0	1	124	0	0
22	17589567	rs879575	C	T	53	37	90	0	0	90	0	0
22	17590269	rs4819555	C	T	48	29	77	0	0	77	0	0
22	17590744	rs1468488	T	C	157	97	254	0	4	258	0	0
22	17591089	rs2895332	G	A	81	41	122	0	0	122	0	0
22	17591144	rs3179921	C	T	76	38	114	0	0	114	0	0
22	17591697	rs882644	G	A	57	45	102	0	2	104	0	0
22	17594886	rs738035	T	C	2	5	7	0	0	7	0	0
22	17596229	rs1047929	T	C	1	7	8	0	0	8	0	0
22	17596388	rs1654	G	C	6	5	11	0	0	11	0	0
22	17597297	rs11160	G	A	14	9	23	0	0	23	0	0
22	17597713	rs9605217	G	C	19	12	31	0	0	31	0	0
22	17597768	rs7289082	A	G	14	6	20	0	0	20	0	0
22	17598310	rs9606619	C	T	7	4	11	0	0	11	0	0
22	17598409	rs12170331	G	A	10	6	16	0	0	16	0	0
22	17598813	rs35597091	G	A	8	4	12	0	0	12	0	0
22	17600148	rs9605220	A	G	4	6	10	0	0	10	0	0
22	17626236	rs3815480	C	T	14	18	32	0	0	32	0	0
22	17626466	rs4819967	C	A	10	10	20	0	1	21	0	0
22	17626665	rs3788268	T	C	12	7	19	0	0	19	0	0
22	17627226	rs5994177	T	C	5	2	7	0	1	8	0	0
22	17627366	.	C	T	7	5	12	0	1	13	0	0
22	18081830	rs5992074	A	G	4	2	6	0	0	6	0	0
22	18082079	rs2111348	G	A	4	3	7	0	0	7	0	0
22	18082669	rs5992075	A	G	2	4	6	0	0	6	0	0
22	18083260	rs5747252	T	C	7	2	9	0	0	9	0	0
22	18084303	rs2080549	C	A	3	5	8	0	0	8	0	0
22	18084331	rs5992754	G	C	4	3	7	0	0	7	0	0
22	18084977	rs5747256	T	C	4	2	6	0	0	6	0	0
22	18101834	rs5746446	C	T	15	17	32	0	0	32	0	0
22	18102393	rs737995	C	T	6	5	11	0	0	11	0	0
22	18102627	rs5992761	A	G	6	9	15	0	0	15	0	0
22	18102837	rs5747283	C	A	0	8	8	0	0	8	0	0
22	18103861	rs9605348	C	T	6	6	12	0	0	12	0	0
22	18103973	rs5992766	G	C	7	5	12	0	0	12	0	0
22	18104619	rs5747285	C	T	4	7	11	0	0	11	0	0
22	18105457	rs2160628	T	C	23	26	49	0	0	49	0	0
22	18107966	rs35011727	G	A	3	3	6	0	0	6	0	0
22	18111431	rs7751	T	C	126	109	235	0	2	237	0	0
22	18209613	rs4488761	A	G	18	15	33	0	1	34	0	0
22	18210704	rs2587100	G	C	18	18	36	0	0	36	0	0
22	18211205	rs9967	T	C	25	29	54	0	1	55	0	0
22	18221958	rs4819626	T	G	4	3	7	0	0	7	0	0
22	18221966	rs181389	A	G	4	3	7	0	0	7	0	0
22	18221985	rs5992809	C	T	3	3	6	0	0	6	0	0
22	18222263	rs181390	A	G	2	7	9	0	0	9	0	0
22	18222665	rs181392	T	C	6	6	12	0	0	12	0	0
22	18223228	rs181393	C	T	3	5	8	0	0	8	0	0
22	18238786	rs181412	A	G	15	4	19	0	0	19	0	0
22	18240907	rs78941362	T	C	2	5	7	0	0	7	0	0
22	18250892	rs2268786	A	G	3	4	7	0	0	7	0	0
22	18261028	rs454566	A	G	20	20	40	0	1	41	0	0
22	18261587	rs391085	T	C	32	27	59	0	0	60	1	0
22	18642645	.	C	T	3	6	9	0	0	9	0	0
22	18655510	rs2543695	C	G	5	1	6	0	0	6	0	0
22	18910355	rs5747933	G	T	4	12	16	0	0	16	0	0
22	18912678	rs4819756	A	G	9	15	24	0	0	24	0	0
22	19025330	rs8399	A	C	12	17	29	0	0	29	0	0
22	19025897	rs1894262	C	T	21	25	46	0	1	47	0	0
22	19026025	rs10160	A	G	20	23	43	0	1	44	0	0
22	19026613	rs2072123	A	G	11	10	21	0	0	21	0	0
22	19028320	rs9618453	C	G	7	9	16	0	0	16	0	0
22	19028476	rs2073775	T	C	7	6	13	0	0	13	0	0
22	19028480	rs2073774	T	C	7	6	13	0	0	13	0	0
22	19034079	rs715539	A	T	3	5	8	0	0	8	0	0
22	19034240	rs2012929	A	G	1	6	7	0	0	7	0	0
22	19034829	rs2000996	A	G	4	4	8	0	0	8	0	0
22	19049278	rs2238742	T	C	4	3	7	0	0	7	0	0
22	19082535	rs2525036	T	C	7	6	13	0	0	13	0	0
22	19082736	rs7285610	G	A	5	6	11	0	0	11	0	0
22	19084555	rs17743642	A	G	1	6	7	0	0	7	0	0
22	19109764	rs11550626	A	G	10	1	11	0	0	11	0	0
22	19109812	rs11550627	A	G	12	7	19	0	0	19	0	0
22	19122665	rs2240111	C	T	145	142	287	0	25	312	0	0
22	19123075	rs2240112	T	C	12	6	18	0	0	18	0	0
22	19124375	rs5747997	C	T	3	4	7	0	0	7	0	0
22	19125136	rs3765612	G	A	7	7	14	0	0	14	0	0
22	19125383	rs56326510	A	C	9	10	19	0	0	19	0	0
22	19126631	rs2298273	T	C	13	8	21	0	0	21	0	0
22	19128169	rs7285177	G	A	17	11	28	0	1	29	0	0
22	19128559	rs55754617	C	T	27	17	44	0	0	44	0	0
22	19129672	rs55694607	A	G	12	11	23	0	0	23	0	0
22	19441708	rs140846571	C	A	17	17	34	0	0	34	0	0
22	19467510	.	C	G	25	19	44	0	0	44	0	0
22	19493253	rs13447253	G	C	13	12	25	0	0	25	0	0
22	19493311	rs5748251	C	G	11	20	31	0	0	31	0	0
22	19493780	rs5748252	G	A	14	14	28	0	1	29	0	0
22	19494413	rs7364291	T	C	17	10	27	0	2	29	0	0
22	19503274	rs1548359	G	C	13	5	18	0	0	18	0	0
22	19510718	rs10314	C	G	4	4	8	0	0	8	0	0
22	19712094	rs1059196	C	T	204	155	359	0	1	360	0	0
22	19776019	rs2073768	G	A	4	5	9	0	0	9	0	0
22	19789541	rs2073770	A	C	6	7	13	0	0	13	0	0
22	19959227	rs62223683	G	A	17	7	24	0	0	24	0	0
22	19960198	rs71313932	G	C	1	6	7	0	0	7	0	0
22	19967980	rs12628032	C	T	2	7	9	0	0	9	0	0
22	19968971	rs2073748	G	A	7	15	22	0	0	22	0	0
22	19969106	rs2240717	A	G	7	12	19	0	0	19	0	0
22	19970502	rs1990277	G	A	9	1	10	0	0	10	0	0
22	19970547	rs2238781	G	T	0	9	9	0	0	9	0	0
22	19970583	rs2238782	A	G	0	10	10	0	0	10	0	0
22	19971552	rs758374	T	C	1	5	6	0	1	7	0	0
22	20093126	rs443678	T	C	6	3	9	0	0	9	0	0
22	20098359	rs1640299	T	G	58	49	107	0	1	108	0	0
22	20098882	rs720014	T	C	86	61	147	0	2	149	0	0
22	20099331	rs3757	G	A	13	19	32	0	0	32	0	0
22	20100596	rs1633445	T	C	3	6	9	0	0	9	0	0
22	20136263	rs175181	G	A	11	8	19	0	0	19	0	0
22	20296321	.	G	A	6	0	6	0	0	6	0	0
22	20301800	rs3890996	T	G	6	0	6	0	0	6	0	0
22	20307256	rs7235	G	A	34	46	80	0	0	80	0	0
22	20385706	.	G	T	10	21	31	0	0	31	0	0
22	20387160	rs202117096	G	A	22	10	32	0	0	33	1	0
22	20394526	rs457751	C	T	124	1	125	0	1	126	0	0
22	20761566	rs117506051	G	A	6	9	15	0	0	15	0	0
22	20796117	rs8353	G	T	23	9	32	0	0	32	0	0
22	20924028	rs165846	A	G	5	4	9	0	0	9	0	0
22	20924813	rs146839104	G	A	6	4	10	0	0	10	0	0
22	20926295	rs165620	G	C	12	8	20	0	0	20	0	0
22	20926559	rs79995359	G	A	7	2	9	0	0	9	0	0
22	20928130	rs11704626	C	T	10	10	20	0	0	20	0	0
22	20929286	rs165842	C	G	21	9	30	0	0	30	0	0
22	20929782	rs177426	C	A	11	12	23	0	0	23	0	0
22	20932279	rs94001	C	T	27	18	45	0	0	45	0	0
22	20935946	rs73159140	G	A	41	33	74	0	0	74	0	0
22	20940208	rs165615	T	C	2	5	7	0	0	7	0	0
22	21022308	rs140641319	G	A	10	0	10	0	0	10	0	0
22	21049940	.	C	T	14	0	14	0	0	14	0	0
22	21050201	.	C	T	32	0	32	0	0	32	0	0
22	21051739	.	A	G	17	1	18	0	0	18	0	0
22	21051802	.	C	T	23	0	23	0	0	23	0	0
22	21051859	rs1042668	G	A	13	8	21	0	1	22	0	0
22	21064356	.	A	C	4	6	10	0	0	10	0	0
22	21065285	.	A	G	42	39	81	0	2	83	0	0
22	21065433	rs440844	T	C	36	0	36	0	0	36	0	0
22	21065932	rs5751786	A	T	5	6	11	0	0	11	0	0
22	21066502	rs6004026	T	C	6	4	10	0	0	10	0	0
22	21066789	.	A	G	52	25	77	0	1	78	0	0
22	21066897	rs1135929	G	A	28	31	59	0	0	59	0	0
22	21073122	rs1807692	G	A	2	6	8	0	0	8	0	0
22	21074037	rs2080335	G	A	2	4	6	0	1	7	0	0
22	21075537	rs5751800	A	C	4	6	10	0	0	10	0	0
22	21076129	rs4820579	C	T	1	8	9	0	0	9	0	0
22	21076208	rs4822471	G	T	3	8	11	0	0	11	0	0
22	21076753	rs5760196	T	G	8	5	13	0	0	13	0	0
22	21076754	rs5760197	T	C	6	7	13	0	0	13	0	0
22	21076916	rs59987153	A	T	3	7	10	0	0	10	0	0
22	21077279	.	C	G	6	0	6	0	1	7	0	0
22	21079909	rs5751806	A	G	4	4	8	0	0	8	0	0
22	21082748	rs56836387	A	C	3	6	9	0	0	9	0	0
22	21090700	rs3091348	C	T	15	4	19	0	1	20	0	0
22	21090744	rs3859860	C	T	12	4	16	0	1	17	0	0
22	21091874	rs151054455	C	A	7	1	8	0	0	8	0	0
22	21091887	rs2002525	A	G	7	1	8	0	0	8	0	0
22	21092246	rs9612833	G	A	5	1	6	0	0	6	0	0
22	21108383	rs76886969	T	A	5	3	8	0	0	8	0	0
22	21110634	rs139755157	G	A	5	1	6	0	0	6	0	0
22	21113161	rs75177245	G	A	7	13	20	0	0	20	0	0
22	21113852	rs114772353	C	T	4	6	10	0	1	11	0	0
22	21113911	rs117662569	T	C	2	8	10	0	0	10	0	0
22	21114132	rs5751874	T	C	4	6	10	0	0	10	0	0
22	21213380	rs1061063	C	T	12	7	19	0	0	19	0	0
22	21213416	rs1061064	A	G	15	15	30	0	0	30	0	0
22	21242864	rs79383799	C	T	47	46	93	0	0	93	0	0
22	21243687	rs11577	T	G	61	59	120	0	1	121	0	0
22	21244940	rs165739	A	G	52	79	131	0	1	132	0	0
22	21245139	rs145199625	G	A	74	94	168	0	1	169	0	0
22	21305049	rs57573660	G	A	129	96	225	0	1	226	0	0
22	21306400	rs1043235	A	G	152	134	286	0	4	290	0	0
22	21306743	rs1043242	A	G	123	135	258	0	2	260	0	0
22	21307388	rs115497413	T	C	140	114	254	0	1	255	0	0
22	21350880	rs178295	T	C	5	1	6	0	0	6	0	0
22	21350936	rs11704198	G	A	2	6	8	0	0	8	0	0
22	21350947	rs12484759	A	G	7	2	9	0	0	9	0	0
22	21351018	.	C	T	15	23	38	0	0	38	0	0
22	21351878	rs62238542	C	T	33	20	53	0	0	53	0	0
22	21357006	rs4822808	C	T	5	5	10	0	0	10	0	0
22	21357153	rs1053775	C	T	2	4	6	0	0	6	0	0
22	21474747	.	T	C	20	0	20	0	1	21	0	0
22	21474762	.	T	C	21	0	21	0	0	21	0	0
22	21801489	rs464694	C	A	16	16	32	0	1	33	0	0
22	21802961	rs3747086	T	G	13	11	24	0	1	25	0	0
22	21830934	.	G	A	37	43	80	0	0	80	0	0
22	21969640	rs8137950	T	C	2	4	6	0	0	6	0	0
22	21972401	rs2876971	T	G	4	3	7	0	0	7	0	0
22	21973319	rs4821116	C	T	3	5	8	0	0	8	0	0
22	21974703	rs5754387	G	C	3	3	6	0	0	6	0	0
22	21976934	rs7444	T	C	50	61	111	0	0	111	0	0
22	21977047	rs7445	C	T	40	78	118	0	0	118	0	0
22	21982892	rs2298428	C	T	17	32	49	0	0	49	0	0
22	21984205	rs710177	A	G	22	14	36	0	0	36	0	0
22	22015234	rs369463	C	T	14	6	20	0	0	20	0	0
22	22044386	rs370039	G	A	4	5	9	0	0	9	0	0
22	22046111	rs5754659	G	A	4	15	19	0	0	19	0	0
22	22048862	rs5999098	C	T	15	5	20	0	0	20	0	0
22	22049783	rs12484060	C	T	34	25	59	0	1	60	0	0
22	22051107	rs45621440	C	A	48	61	109	0	0	109	0	0
22	22115004	rs6928	C	G	112	90	202	0	1	203	0	0
22	22115353	rs9340	G	A	44	32	76	0	0	76	0	0
22	22115498	rs3810610	T	C	71	46	117	0	0	117	0	0
22	22116202	rs13943	C	G	35	26	61	0	0	61	0	0
22	22116467	rs1063311	C	T	38	39	77	0	2	79	0	0
22	22178334	rs55899028	C	T	3	6	9	0	0	9	0	0
22	22180873	rs9610371	A	C	2	4	6	0	0	6	0	0
22	22187660	rs5999749	A	C	1	32	33	0	0	33	0	0
22	22274021	rs16979617	C	T	252	229	481	0	3	484	0	0
22	22275524	rs41283227	C	T	159	171	330	0	1	331	0	0
22	22287862	rs2027789	G	A	84	86	170	0	1	171	0	0
22	22305629	rs381523	A	G	1	6	7	0	0	7	0	0
22	22311882	.	G	A	33	27	60	0	0	60	0	0
22	22311994	rs549948058	G	A	6	0	6	0	0	6	0	0
22	22312502	rs239920	C	T	15	11	26	0	1	27	0	0
22	22313829	rs239918	A	C	16	15	31	0	0	31	0	0
22	22316272	rs239916	G	A	6	4	10	0	0	10	0	0
22	22316540	rs56138298	G	A	22	15	37	0	1	38	0	0
22	22316631	rs239915	G	A	19	9	28	0	0	28	0	0
22	22317337	rs239914	C	T	18	10	28	0	0	28	0	0
22	22330082	rs239927	T	C	29	22	51	0	1	52	0	0
22	22333062	rs75599828	G	C	13	4	17	0	0	17	0	0
22	22333218	rs5756306	C	T	10	0	10	0	0	10	0	0
22	22334795	rs5756323	C	T	2	4	6	0	0	6	0	0
22	22469925	rs149227277	A	G	0	11	11	0	0	11	0	0
22	22469950	rs115578089	G	C	0	10	10	0	1	11	0	0
22	22470013	.	T	G	0	6	6	0	0	6	0	0
22	22470022	rs80112051	C	T	0	7	7	0	0	7	0	0
22	22471077	rs8139985	C	A	0	8	8	0	0	8	0	0
22	22471635	rs7293130	G	A	10	0	10	0	0	10	0	0
22	22471722	rs6000997	A	C	0	6	6	0	0	6	0	0
22	22471884	rs1934535	T	C	1	5	6	0	0	6	0	0
22	22471985	rs6000999	A	G	0	18	18	0	0	18	0	0
22	22472029	rs6001000	T	C	0	11	11	0	0	11	0	0
22	22472059	rs8136946	A	G	0	8	8	0	0	8	0	0
22	22472099	rs8135482	G	A	0	6	6	0	0	6	0	0
22	22891081	rs2072049	G	T	34	22	56	0	3	59	0	0
22	22893756	rs6002689	T	C	15	6	21	0	0	21	0	0
22	22894053	rs6002690	C	A	10	6	16	0	0	16	0	0
22	22895569	rs1076163	G	T	5	5	10	0	0	10	0	0
22	22896719	rs6002703	C	G	5	5	10	0	0	10	0	0
22	22896851	rs2266981	C	T	10	3	13	0	1	14	0	0
22	22896912	rs2266982	C	T	12	3	15	0	0	15	0	0
22	22897115	rs2266983	A	G	8	6	14	0	0	14	0	0
22	22897261	rs2266984	A	G	3	3	6	0	0	6	0	0
22	22897314	rs9623773	C	T	4	2	6	0	0	6	0	0
22	22897322	rs2266985	A	G	7	1	8	0	0	8	0	0
22	22898802	rs8139480	C	T	7	2	9	0	0	9	0	0
22	22898892	rs2266986	A	G	10	2	12	0	0	12	0	0
22	22898907	rs2266987	C	T	7	2	9	0	1	10	0	0
22	22899234	rs1129172	A	G	576	430	1006	0	10	1017	1	0
22	22899363	rs8139318	G	A	194	142	336	0	4	340	0	0
22	22899364	rs2283799	A	G	192	141	333	0	2	335	0	0
22	22899414	rs2283800	A	G	240	188	428	0	2	430	0	0
22	22900005	rs8136728	A	G	42	21	63	0	0	63	0	0
22	22901408	rs6002723	A	G	92	75	167	0	1	168	0	0
22	23523630	rs5751602	C	A	46	56	102	0	0	102	0	0
22	23523644	rs148370562	G	A	64	61	125	0	0	125	0	0
22	23535135	rs5996483	A	G	8	4	12	0	0	12	0	0
22	23537143	rs9624047	G	C	3	3	6	0	0	6	0	0
22	23537229	rs9624049	C	T	5	2	7	0	0	7	0	0
22	23537397	rs9624050	C	T	1	6	7	0	0	7	0	0
22	23538357	rs5751606	T	C	8	1	9	0	0	9	0	0
22	23538587	rs5759635	G	A	8	2	10	0	0	10	0	0
22	23538698	rs5759636	T	C	8	4	12	0	0	12	0	0
22	23538737	rs5759637	T	C	5	6	11	0	0	11	0	0
22	23538969	rs8137846	C	A	11	6	17	0	0	17	0	0
22	23538970	rs8138361	A	G	11	6	17	0	0	17	0	0
22	23539311	rs5751607	A	G	3	3	6	0	0	6	0	0
22	23539440	rs12484280	G	A	4	3	7	0	0	7	0	0
22	23540799	rs2071432	A	G	4	3	7	0	0	7	0	0
22	23541488	rs2071436	C	T	48	8	56	0	1	57	0	0
22	23542535	rs4820543	A	G	2	7	9	0	0	9	0	0
22	23542539	rs4820544	C	T	7	2	9	0	0	9	0	0
22	23543186	rs4822372	T	C	4	5	9	0	0	9	0	0
22	23545302	rs5759645	T	C	12	9	21	0	0	21	0	0
22	23546579	rs4822373	T	G	22	14	36	0	0	36	0	0
22	23575642	rs4822375	A	G	6	5	11	0	1	12	0	0
22	23639534	rs5751624	A	G	3	3	6	0	0	6	0	0
22	23639971	rs73152664	A	G	4	2	6	0	0	6	0	0
22	23640470	rs5759687	G	C	4	8	12	0	0	12	0	0
22	23642989	rs530451368	G	A	5	16	21	0	1	22	0	0
22	23643247	rs5751625	T	C	7	4	11	0	0	11	0	0
22	23643390	rs5759689	A	G	1	9	10	0	1	11	0	0
22	23643530	rs5759691	G	T	6	10	16	0	0	16	0	0
22	23644314	rs5759692	G	A	7	9	16	0	0	16	0	0
22	23650847	rs5751628	A	G	1	8	9	0	0	9	0	0
22	23652956	rs180797	C	T	9	7	16	0	0	16	0	0
22	23653880	rs180801	G	A	7	8	15	0	1	16	0	0
22	23654436	rs5759698	A	G	14	7	21	0	0	21	0	0
22	23654807	rs56024092	C	A	10	7	17	0	0	17	0	0
22	23654993	rs180805	A	G	11	12	23	0	0	23	0	0
22	23655084	rs11558697	C	T	350	368	718	0	9	727	0	0
22	23655219	rs180806	G	A	8	15	23	0	0	23	0	0
22	23655620	rs180807	T	C	2	13	15	0	0	15	0	0
22	23656148	rs66569843	T	G	6	37	43	0	0	43	0	0
22	23656776	.	C	T	415	429	844	0	2	846	0	0
22	23657226	rs570445890	G	A	4	5	9	0	0	9	0	0
22	23657495	rs180811	C	G	1	5	6	0	0	6	0	0
22	23657735	rs180812	G	A	598	543	1141	0	4	1145	0	0
22	23657874	rs392389	A	G	515	339	854	0	4	858	0	0
22	23657875	rs440531	A	C	508	339	847	0	7	854	0	0
22	23657881	rs9155	C	T	498	355	853	0	2	855	0	0
22	23657939	rs113629387	T	C	495	402	897	0	6	903	0	0
22	23657970	rs28573708	T	G	390	458	848	0	5	854	1	0
22	23658007	rs180817	G	A	361	339	700	0	4	704	0	0
22	23658094	.	T	C	143	138	281	0	6	287	0	0
22	23659270	rs180823	C	A	54	3	57	0	0	57	0	0
22	23659362	rs4459819	G	T	87	21	108	0	0	108	0	0
22	23659749	rs199867487	A	G	6	12	18	0	0	19	1	0
22	23982724	rs56397271	T	C	3	4	7	0	0	7	0	0
22	23982727	rs28645846	A	G	3	4	7	0	0	7	0	0
22	23990434	rs3939921	T	G	4	2	6	0	0	6	0	0
22	24000486	rs5759939	C	T	2	4	6	0	0	6	0	0
22	24001094	rs6519465	C	T	5	2	7	0	1	8	0	0
22	24024430	rs2330579	C	T	6	7	13	0	0	13	0	0
22	24026415	rs5759963	G	C	2	4	6	0	0	6	0	0
22	24034288	rs738786	A	G	10	10	20	0	0	20	0	0
22	24035970	rs2070446	C	T	15	24	39	0	0	39	0	0
22	24038847	rs1007298	T	C	186	131	317	0	0	317	0	0
22	24045244	.	C	T	4	2	6	0	1	7	0	0
22	24045962	rs9624297	A	C	4	6	10	0	0	10	0	0
22	24052031	rs9608174	C	T	41	38	79	0	2	81	0	0
22	24056537	rs2070444	G	A	6	1	7	0	0	7	0	0
22	24083873	rs9612413	C	T	3	3	6	0	0	6	0	0
22	24109550	rs131444	T	C	4	4	8	0	0	8	0	0
22	24224655	rs9608213	G	A	8	7	15	0	0	15	0	0
22	24224659	rs9612499	C	A	8	7	15	0	0	15	0	0
22	24228125	rs1129067	T	C	5	1	6	0	0	6	0	0
22	24312629	rs57389743	C	G	9	7	16	0	0	16	0	0
22	24312698	rs183093330	G	C	5	6	11	0	1	12	0	0
22	24468386	rs17854874	G	A	5	6	11	0	0	11	0	0
22	24500866	rs176156	G	C	5	1	6	0	0	6	0	0
22	24561364	rs7293224	A	G	22	18	40	0	1	41	0	0
22	24564477	rs17854875	C	T	60	41	101	0	0	101	0	0
22	24572853	rs9620361	C	T	2	4	6	0	0	6	0	0
22	24655227	rs28625949	G	A	0	22	22	0	0	22	0	0
22	24655282	rs28368772	C	A	8	0	8	0	0	8	0	0
22	24717518	rs3747113	G	A	16	15	31	0	0	31	0	0
22	24807235	rs5751867	C	T	3	7	10	0	0	10	0	0
22	24811667	rs3747114	G	A	35	41	76	0	2	78	0	0
22	24812377	rs3747115	T	C	35	61	96	0	10	106	0	0
22	24824404	rs144968231	T	G	6	5	11	0	0	11	0	0
22	24825511	rs2298383	C	T	10	5	15	0	0	15	0	0
22	24826155	rs3761420	G	A	6	6	12	0	0	12	0	0
22	24826672	rs3761422	T	C	2	5	7	0	0	7	0	0
22	24836024	rs2236624	T	C	0	7	7	0	1	8	0	0
22	24837301	rs5751876	T	C	99	117	216	0	2	218	0	0
22	24881781	rs4822502	C	T	4	6	10	0	0	10	0	0
22	24882187	rs5760448	G	A	6	5	11	0	0	11	0	0
22	24944121	.	G	A	34	34	68	0	0	68	0	0
22	25047794	.	A	G	19	0	19	0	1	20	0	0
22	25769243	.	C	T	5	9	14	0	0	14	0	0
22	25959309	rs5761122	A	G	8	5	13	0	0	13	0	0
22	26113333	rs67214996	T	G	7	3	10	0	0	10	0	0
22	26124437	rs17696356	G	A	21	6	27	0	0	27	0	0
22	26830285	rs34902186	A	G	3	9	12	0	0	12	0	0
22	26840477	rs1046453	C	T	4	7	11	0	0	11	0	0
22	26861721	rs16982145	T	C	24	33	57	0	0	57	0	0
22	26862041	rs3747129	G	A	50	48	98	0	0	98	0	0
22	26864395	rs7289202	T	C	12	9	21	0	0	21	0	0
22	26892306	rs76030007	G	C	7	14	21	0	0	21	0	0
22	26907201	rs134141	A	G	25	10	35	0	1	36	0	0
22	26907899	rs134143	C	T	7	6	13	0	0	13	0	0
22	26909750	rs134145	A	G	9	4	13	0	0	13	0	0
22	26921725	rs4275	A	G	13	16	29	0	1	30	0	0
22	26931221	rs4149478	C	T	3	5	8	0	0	8	0	0
22	26932150	rs3752523	G	A	12	10	22	0	0	22	0	0
22	26937327	rs4822735	C	G	18	17	35	0	0	35	0	0
22	26978340	rs2267099	G	C	3	3	6	0	0	6	0	0
22	26983287	rs73163239	G	T	7	3	10	0	0	10	0	0
22	26984636	rs73163240	C	A	14	17	31	0	0	31	0	0
22	27062122	rs12166567	G	C	3	3	6	0	0	6	0	0
22	27064287	rs4274	G	A	5	2	7	0	1	8	0	0
22	27065117	rs6005121	A	G	7	2	9	0	0	9	0	0
22	27065368	rs56378339	C	T	2	5	7	0	0	7	0	0
22	27067792	rs8142049	C	T	4	4	8	0	0	8	0	0
22	27068702	rs9625066	C	A	3	5	8	0	0	8	0	0
22	27068998	rs55969394	C	T	4	4	8	0	0	8	0	0
22	27069557	rs6005127	C	T	5	10	15	0	0	15	0	0
22	27069907	rs1018834	A	T	3	3	6	0	0	6	0	0
22	27070304	rs55857368	C	T	11	10	21	0	0	21	0	0
22	27070749	rs4822768	C	T	5	9	14	0	0	14	0	0
22	27072140	rs1045362	G	A	18	6	24	0	0	24	0	0
22	28145605	rs17476776	C	T	95	66	161	0	3	164	0	0
22	28195386	rs45589338	C	A	5	3	8	0	0	8	0	0
22	28306070	rs1807581	C	T	5	2	7	0	0	7	0	0
22	28319278	rs5762405	G	A	10	2	12	0	0	12	0	0
22	28374972	rs738474	C	T	3	4	7	0	0	7	0	0
22	28396867	rs138652	A	C	5	3	8	0	0	8	0	0
22	28559120	rs17486417	G	C	5	2	7	0	0	7	0	0
22	29130458	rs1805129	T	C	7	7	14	0	0	14	0	0
22	29179739	rs2347447	C	A	2	4	6	0	0	6	0	0
22	29182389	.	T	C	69	76	145	0	1	146	0	0
22	29182500	rs5762795	C	A	84	82	166	0	4	170	0	0
22	29183133	rs6005881	A	G	37	38	75	0	4	79	0	0
22	29191879	rs2097461	T	C	6	1	7	0	0	7	0	0
22	29192670	rs2239815	T	C	20	19	39	0	0	39	0	0
22	29193638	rs5762803	G	C	7	9	16	0	0	16	0	0
22	29196534	rs138290856	C	A	7	10	17	0	0	17	0	0
22	29196757	rs2269577	G	C	5	12	17	0	0	17	0	0
22	29695929	rs2518683	T	G	6	5	11	0	0	11	0	0
22	29927243	rs56066153	G	T	3	4	7	0	0	7	0	0
22	29927704	rs5763300	T	C	8	0	8	0	0	8	0	0
22	29933837	rs112883011	A	G	7	3	10	0	0	10	0	0
22	29951650	rs7609	A	T	40	41	81	0	0	81	0	0
22	29999784	rs1800539	C	A	5	5	10	0	0	10	0	0
22	30093259	rs1034880	C	G	26	26	52	0	1	53	0	0
22	30093667	rs5763431	T	C	30	23	53	0	0	53	0	0
22	30094366	rs41278851	G	A	75	51	126	0	0	126	0	0
22	30163835	rs140135	C	G	3	9	12	0	0	12	0	0
22	30165412	rs140139	A	G	9	4	13	0	0	13	0	0
22	30184950	rs7954	A	G	206	239	445	0	2	447	0	0
22	30186139	rs140151	C	T	4	4	8	0	0	8	0	0
22	30198490	rs9608815	A	T	4	4	8	0	0	8	0	0
22	30203599	rs5997530	C	G	5	21	26	0	0	26	0	0
22	30228717	rs4823055	A	G	2	6	8	0	0	8	0	0
22	30229399	rs3958025	C	G	4	8	12	0	0	12	0	0
22	30368384	rs4239932	T	G	36	18	54	0	1	55	0	0
22	30374281	rs9306468	T	C	1	5	6	0	0	6	0	0
22	30395834	rs1807508	C	T	4	6	10	0	0	10	0	0
22	30395873	rs1807509	T	C	4	6	10	0	0	10	0	0
22	30396342	rs5763691	G	T	5	5	10	0	0	10	0	0
22	30398498	rs148527720	G	A	3	3	6	0	0	6	0	0
22	30413339	rs41165	C	T	7	10	17	0	0	17	0	0
22	30413671	rs41166	A	T	6	9	15	0	0	15	0	0
22	30418161	rs41168	A	C	7	9	16	0	0	16	0	0
22	30422107	rs41171	C	G	89	108	197	0	2	199	0	0
22	30422865	rs41172	T	C	202	207	409	0	0	409	0	0
22	30423460	rs12537	C	T	291	321	612	0	4	617	1	0
22	30424863	rs41173	C	G	19	14	33	0	0	33	0	0
22	30432137	rs41175	T	C	5	3	8	0	0	8	0	0
22	30432403	rs41176	C	A	7	3	10	0	0	10	0	0
22	30659566	rs2070889	G	A	157	151	308	0	1	309	0	0
22	30660517	rs1476576	A	C	7	5	12	0	0	12	0	0
22	30661184	rs5763918	T	C	9	6	15	0	0	15	0	0
22	30691919	rs148680552	G	A	2	4	6	0	0	6	0	0
22	30819673	.	C	A	8	10	18	0	0	18	0	0
22	30981508	rs4820017	A	G	6	6	12	0	0	12	0	0
22	30981547	rs118085763	G	A	5	6	11	0	0	11	0	0
22	31006860	rs9606756	A	G	6	6	12	0	0	12	0	0
22	31011610	rs1801198	G	C	12	6	18	0	1	19	0	0
22	31013419	rs9621049	C	T	15	11	26	0	0	26	0	0
22	31022590	rs12169610	C	T	34	21	55	0	1	56	0	0
22	31043766	rs3179442	G	A	6	0	6	0	0	6	0	0
22	31283979	rs8140448	C	T	3	3	6	0	0	6	0	0
22	31302233	rs3804085	T	C	4	2	6	0	0	6	0	0
22	31303708	rs8004	G	A	8	9	17	0	0	17	0	0
22	31321847	rs2240175	C	A	78	52	130	0	0	131	1	0
22	31321948	rs2240176	G	A	64	61	125	0	1	126	0	0
22	31333631	rs3747151	T	C	39	39	78	0	0	78	0	0
22	31335724	rs1005252	T	A	2	4	6	0	0	6	0	0
22	31342376	rs2072132	G	C	30	32	62	0	0	62	0	0
22	31354653	rs737924	G	A	27	23	50	0	0	50	0	0
22	31355354	rs2285918	G	A	9	4	13	0	0	13	0	0
22	31360592	rs2240182	G	A	3	6	9	0	0	9	0	0
22	31362139	rs2240183	C	T	3	4	7	0	0	7	0	0
22	31368096	rs5749201	A	T	19	18	37	0	0	37	0	0
22	31369324	rs7284767	G	A	75	81	156	0	0	156	0	0
22	31369789	rs8139350	C	G	6	6	12	0	0	12	0	0
22	31370079	rs8139971	G	A	5	4	9	0	0	9	0	0
22	32034986	.	T	G	7	3	10	0	0	11	1	0
22	32341092	rs13055495	A	G	21	27	48	0	3	51	0	0
22	32341141	rs13057194	T	C	45	49	94	0	0	94	0	0
22	32341669	rs2301415	A	G	23	6	29	0	0	29	0	0
22	32341684	rs7290696	C	T	25	6	31	0	0	31	0	0
22	32341790	rs8141011	C	T	27	10	37	0	1	38	0	0
22	32341957	rs7291050	A	G	30	18	48	0	0	48	0	0
22	32342976	rs3747158	G	A	26	9	35	0	1	36	0	0
22	32349612	rs2858752	C	T	3	9	12	0	0	12	0	0
22	32351105	rs2858753	C	G	5	5	10	0	0	10	0	0
22	32352791	rs1049583	G	A	271	402	673	0	1	674	0	0
22	32792192	.	T	C	87	87	174	0	2	176	0	0
22	32870806	rs11538371	C	T	65	59	124	0	0	124	0	0
22	32881581	rs17771806	C	T	6	6	12	0	0	12	0	0
22	32881746	rs5754111	G	A	2	6	8	0	0	8	0	0
22	32883103	rs3788449	G	A	8	9	17	0	0	17	0	0
22	32883282	rs3827335	A	G	12	3	15	0	0	15	0	0
22	32883344	rs4821066	A	G	12	4	16	0	0	16	0	0
22	32884036	rs5998513	T	A	6	3	9	0	0	9	0	0
22	32884878	rs111913268	A	G	21	19	40	0	0	40	0	0
22	32886380	rs191803875	A	G	22	28	50	0	0	50	0	0
22	32886477	rs5749450	G	T	27	31	58	0	1	59	0	0
22	32887732	rs17698823	C	T	3	3	6	0	1	7	0	0
22	32888010	rs62241256	C	T	30	34	64	0	0	64	0	0
22	32888622	rs1029302	A	G	26	46	72	0	0	72	0	0
22	32890988	rs62241257	C	T	3	4	7	0	0	7	0	0
22	32893905	rs5754115	C	T	3	5	8	0	0	8	0	0
22	33211188	rs9606996	C	T	5	8	13	0	0	13	0	0
22	33253280	rs9862	T	C	22	17	39	0	0	39	0	0
22	35729721	rs138788	G	A	3	15	18	0	0	18	0	0
22	35733654	rs138794	G	A	5	6	11	0	0	11	0	0
22	35733708	rs138795	C	T	4	4	8	0	0	8	0	0
22	35737461	rs2267335	G	A	12	8	20	0	0	20	0	0
22	35738488	rs2283961	C	T	11	11	22	0	0	22	0	0
22	35739800	rs28491160	C	A	42	35	77	0	1	78	0	0
22	35739927	rs133395	A	C	43	33	76	0	2	78	0	0
22	35740128	rs2267336	G	A	25	35	60	0	0	60	0	0
22	35740442	rs133397	C	A	43	28	71	0	0	71	0	0
22	35742925	rs743810	T	G	304	282	586	0	6	592	0	0
22	35743124	rs2071745	G	C	290	370	660	0	42	702	0	0
22	35817553	rs2071744	C	T	15	15	30	0	3	33	0	0
22	35820589	rs4645827	A	C	4	8	12	0	0	12	0	0
22	35923105	rs1883299	G	A	5	4	9	0	0	9	0	0
22	36056400	rs116841049	G	C	30	46	76	0	0	76	0	0
22	36063884	rs117706555	C	T	73	67	140	0	1	141	0	0
22	36537500	rs132618	A	T	19	22	41	0	0	41	0	0
22	36537893	rs3827346	A	G	6	16	22	0	0	22	0	0
22	36538085	.	G	A	22	11	33	0	0	33	0	0
22	36541725	rs1807672	G	T	9	4	13	0	0	13	0	0
22	36635430	rs113056287	T	C	1	6	7	0	0	7	0	0
22	36662689	rs62233843	T	C	7	4	11	0	0	11	0	0
22	36662718	rs140768119	A	G	2	5	7	0	0	7	0	0
22	36684092	rs5756129	T	C	22	25	47	0	0	47	0	0
22	36684331	rs5756130	C	T	528	460	988	0	2	990	0	0
22	36693980	rs5756133	T	A	12	17	29	0	0	29	0	0
22	36696777	rs117734021	T	C	7	1	8	0	0	8	0	0
22	36720041	rs73167632	T	C	12	5	17	0	0	17	0	0
22	36732992	rs8135022	T	G	2	5	7	0	0	7	0	0
22	36906943	rs41283213	G	A	183	140	323	0	1	324	0	0
22	37257855	rs2413426	G	A	26	28	54	0	3	57	0	0
22	37266322	rs2075938	A	G	4	5	9	0	0	9	0	0
22	37271882	rs2075939	T	C	119	114	233	0	0	233	0	0
22	37316125	rs5750338	G	A	3	3	6	0	0	6	0	0
22	37321080	rs2284031	T	C	3	4	7	0	0	7	0	0
22	37323988	rs909486	C	T	14	16	30	0	0	30	0	0
22	37325306	.	C	T	14	17	31	0	1	32	0	0
22	37328751	rs2075936	A	G	10	15	25	0	0	25	0	0
22	37329448	rs1534881	G	A	3	5	8	0	0	8	0	0
22	37330082	rs2075937	T	C	13	17	30	0	0	30	0	0
22	37330249	rs738149	A	G	26	17	43	0	0	43	0	0
22	37330721	rs2179051	C	T	30	29	59	0	1	60	0	0
22	37330779	rs5756414	G	C	27	27	54	0	0	54	0	0
22	37330811	rs5756415	C	G	25	26	51	0	0	51	0	0
22	37331305	rs2239749	A	G	17	26	43	0	0	43	0	0
22	37333058	rs140529	G	T	20	22	42	0	0	42	0	0
22	37334832	rs131841	T	A	372	340	712	0	6	718	0	0
22	37335582	.	C	T	360	279	639	0	9	648	0	0
22	37335773	rs131842	A	G	455	416	871	0	7	878	0	0
22	37581422	rs229526	G	C	1	7	8	0	0	8	0	0
22	37621445	rs6572	C	G	459	490	949	0	8	957	0	0
22	37695256	rs2301435	T	C	11	9	20	0	0	20	0	0
22	37696555	rs2071855	A	G	19	20	39	0	1	40	0	0
22	37699377	rs2239822	T	C	70	96	166	0	2	168	0	0
22	37704671	rs6000659	C	A	2	4	6	0	0	6	0	0
22	37707962	rs2269591	C	T	33	43	76	0	1	77	0	0
22	37708004	rs2269593	T	C	29	41	70	0	0	70	0	0
22	37710013	rs3203726	C	T	148	148	296	0	3	299	0	0
22	37710131	rs3203727	C	T	198	235	433	0	2	435	0	0
22	37710177	rs3203728	G	A	174	207	381	0	2	383	0	0
22	37710295	rs5750409	G	A	157	172	329	0	3	332	0	0
22	37710514	rs5756606	T	C	206	203	409	0	0	409	0	0
22	37710569	rs2284051	G	T	197	161	358	0	3	361	0	0
22	37710839	rs9610708	C	T	331	332	663	0	0	663	0	0
22	37711078	rs15996	C	G	340	310	650	0	1	651	0	0
22	37866063	rs8192548	G	A	248	138	386	0	2	388	0	0
22	37879472	rs2284052	C	A	5	6	11	0	1	12	0	0
22	37879558	rs2284053	G	A	2	4	6	0	0	6	0	0
22	37880668	rs5756691	G	C	2	4	6	0	0	6	0	0
22	38032709	rs9306321	A	G	3	3	6	0	0	6	0	0
22	38032762	rs7284165	G	A	3	4	7	0	0	7	0	0
22	38127126	rs5756799	G	T	1	6	7	0	0	7	0	0
22	38164106	rs4821708	C	T	26	15	41	0	1	42	0	0
22	38170026	rs1129448	G	A	19	21	40	0	1	41	0	0
22	38172213	rs3171656	G	A	27	35	62	0	0	62	0	0
22	38172380	rs15691	C	A	32	27	59	0	2	61	0	0
22	38202399	rs6000898	T	C	739	507	1246	0	62	1308	0	0
22	38204089	rs710187	C	T	2	6	8	0	0	8	0	0
22	38212762	rs13911	A	G	27	17	44	0	0	44	0	0
22	38267446	rs1009045	G	C	6	10	16	0	0	16	0	0
22	38267619	rs4820310	T	A	6	1	7	0	0	7	0	0
22	38268922	rs139838	G	A	7	5	12	0	0	12	0	0
22	38273749	rs9466	T	C	961	961	1922	0	12	1934	0	0
22	38285300	rs6000926	T	C	34	37	71	0	0	71	0	0
22	38343938	rs148686951	C	T	4	2	6	0	0	6	0	0
22	38363408	.	C	G	2	5	7	0	0	7	0	0
22	38463141	rs3026688	C	A	3	4	7	0	0	7	0	0
22	38486738	rs132928	T	C	2	5	7	0	0	7	0	0
22	38490036	rs9610903	G	A	3	3	6	0	0	6	0	0
22	38512402	rs11089863	G	A	3	3	6	0	0	6	0	0
22	38517405	rs2076116	T	C	6	3	9	0	0	9	0	0
22	38517880	rs9619724	T	G	10	1	11	0	0	11	0	0
22	38518083	rs2235344	G	A	7	1	8	0	0	8	0	0
22	38518177	rs2235345	C	T	7	4	11	0	0	11	0	0
22	38518731	rs4820315	C	T	5	1	6	0	0	6	0	0
22	38519335	rs2072867	A	G	5	13	18	0	0	18	0	0
22	38522887	rs2235347	A	G	19	23	42	0	0	42	0	0
22	38523211	rs3788532	G	A	16	9	25	0	0	25	0	0
22	38523246	rs3788533	C	G	15	11	26	0	0	26	0	0
22	38524149	rs9622732	G	C	5	2	7	0	0	7	0	0
22	38598041	rs11703601	C	T	29	35	64	0	0	64	0	0
22	38599364	rs4821764	G	A	4	2	6	0	0	6	0	0
22	38600595	rs2267374	A	T	3	3	6	0	0	6	0	0
22	38609950	rs2235264	G	A	6	7	13	0	0	13	0	0
22	38611080	rs9610915	C	G	256	142	398	0	2	400	0	0
22	38612372	rs5995550	A	C	252	374	626	0	7	633	0	0
22	38617333	rs2235265	T	C	20	16	36	0	0	36	0	0
22	38620057	rs5750562	G	A	3	3	6	0	0	6	0	0
22	38659835	rs84308	C	G	5	6	11	0	0	11	0	0
22	38659842	rs2017369	G	A	5	6	11	0	0	11	0	0
22	38659896	rs2003649	T	C	3	7	10	0	0	10	0	0
22	38660871	rs135715	C	T	6	2	8	0	0	8	0	0
22	38877461	rs12004	T	G	10	5	15	0	1	16	0	0
22	38879688	rs1043402	G	A	331	457	788	0	5	793	0	0
22	38879940	rs763121	A	G	202	316	518	0	7	525	0	0
22	38881454	rs86796	A	C	51	44	95	0	0	95	0	0
22	38884775	rs5750609	C	T	50	67	117	0	3	120	0	0
22	38889657	rs2267390	C	T	1	7	8	0	0	8	0	0
22	38898051	rs138457	T	C	16	5	21	0	0	21	0	0
22	38901094	rs1837988	A	G	6	5	11	0	0	11	0	0
22	39066820	rs3761454	C	T	9	3	12	0	0	12	0	0
22	39069181	rs3747174	T	C	10	10	20	0	0	20	0	0
22	39069510	rs1065201	T	C	14	12	26	0	0	26	0	0
22	39079964	rs5750668	T	C	194	182	376	0	7	383	0	0
22	39080078	rs1056610	T	C	282	276	558	0	2	560	0	0
22	39080245	rs1056661	A	G	222	219	441	0	9	450	0	0
22	39082174	rs10135	A	G	279	307	586	0	15	601	0	0
22	39096602	rs6519133	T	C	10	1	11	0	0	11	0	0
22	39105707	rs4821815	G	A	4	3	7	0	0	7	0	0
22	39107001	rs2413546	G	A	3	5	8	0	0	8	0	0
22	39110437	rs5757257	T	C	4	2	6	0	1	7	0	0
22	39113903	rs2267395	C	T	4	2	6	0	0	6	0	0
22	39121252	rs6001209	A	G	6	3	9	0	0	9	0	0
22	39124467	rs2235230	C	T	8	9	17	0	0	17	0	0
22	39129708	rs138699	G	A	5	5	10	0	1	11	0	0
22	39129999	rs138700	A	G	14	10	24	0	1	25	0	0
22	39130843	rs17032	C	G	350	386	736	0	5	742	1	0
22	39130964	rs1043441	C	T	309	343	652	0	4	656	0	0
22	39130971	rs9835	A	G	312	348	660	0	2	662	0	0
22	39131727	rs1043312	T	G	302	273	575	0	3	578	0	0
22	39132601	rs138702	A	T	9	8	17	0	0	17	0	0
22	39132748	rs138703	G	A	12	10	22	0	0	22	0	0
22	39133410	rs138704	A	G	12	9	21	0	1	22	0	0
22	39133659	rs9611015	G	A	10	6	16	0	0	16	0	0
22	39133803	rs138705	C	T	11	11	22	0	0	22	0	0
22	39134207	rs2072797	C	T	289	275	564	0	4	568	0	0
22	39134715	rs1062687	T	C	265	290	555	0	2	557	0	0
22	39137834	rs138706	C	G	51	25	76	0	0	76	0	0
22	39139216	rs138709	C	G	7	8	15	0	0	15	0	0
22	39139343	rs138710	A	G	5	4	9	0	0	9	0	0
22	39142615	rs138713	T	C	7	8	15	0	0	15	0	0
22	39146527	rs138716	C	T	4	7	11	0	0	11	0	0
22	39147235	rs35496634	A	C	159	129	288	0	5	293	0	0
22	39150450	rs2076028	G	A	2	4	6	0	0	6	0	0
22	39178701	rs760482	A	G	4	2	6	0	3	9	0	0
22	39349617	rs5995640	G	A	4	3	7	0	0	7	0	0
22	39351466	rs17298479	G	A	2	4	6	0	0	6	0	0
22	39357581	rs35994173	C	T	30	14	44	0	0	44	0	0
22	39357634	.	A	G	25	9	34	0	2	36	0	0
22	39381826	rs2076109	A	G	24	13	37	0	0	37	0	0
22	39381935	rs2076110	C	T	25	10	35	0	0	35	0	0
22	39381999	.	T	C	31	12	43	0	0	43	0	0
22	39387558	.	C	T	18	27	45	0	1	46	0	0
22	39414766	rs1139721	C	T	26	19	45	0	1	46	0	0
22	39440149	rs5750728	C	T	2	4	6	0	0	6	0	0
22	39445554	rs2076101	G	A	2	5	7	0	0	7	0	0
22	39448711	rs6001402	C	A	4	7	11	0	0	11	0	0
22	39448750	rs5757451	T	C	6	7	13	0	0	13	0	0
22	39448875	rs5757452	C	T	6	9	15	0	1	16	0	0
22	39448993	.	A	T	5	4	9	0	1	10	0	0
22	39449655	rs5750735	T	C	3	5	8	0	0	8	0	0
22	39450528	rs1985760	C	G	4	2	6	0	0	6	0	0
22	39450678	rs2016407	G	A	6	5	11	0	0	11	0	0
22	39477123	rs5757465	T	C	29	16	45	0	2	47	0	0
22	39487595	rs139271	T	C	9	11	20	0	0	20	0	0
22	39487665	rs139272	A	G	15	13	28	0	0	28	0	0
22	39487719	rs139273	T	C	16	15	31	0	0	31	0	0
22	39487722	rs139274	C	T	16	15	31	0	0	31	0	0
22	39527583	rs79502	C	T	3	4	7	0	0	7	0	0
22	39527790	rs710190	T	C	3	4	7	0	0	7	0	0
22	39527814	rs710191	G	T	3	4	7	0	0	7	0	0
22	39528440	rs79503	A	G	6	4	10	0	0	10	0	0
22	40552119	rs9611280	G	A	6	6	12	0	0	12	0	0
22	40559156	rs1474667	G	A	0	7	7	0	0	7	0	0
22	40753730	rs62239072	C	A	5	2	7	0	0	7	0	0
22	40757228	rs8135371	A	C	19	15	34	0	0	34	0	0
22	40813931	rs78875171	G	A	19	30	49	0	0	49	0	0
22	40814500	rs878756	T	C	125	125	250	0	18	268	0	0
22	40935293	rs5750957	C	T	3	6	9	0	0	9	0	0
22	40946307	rs5758001	A	C	7	3	10	0	0	10	0	0
22	40947458	rs9623184	C	T	11	13	24	0	0	24	0	0
22	41223190	rs710193	C	T	512	554	1066	0	3	1069	0	0
22	41354887	rs56080538	G	C	6	3	9	0	0	9	0	0
22	41541024	rs1569858	A	G	1	5	6	0	0	6	0	0
22	41549009	rs6002268	T	C	4	9	13	0	0	13	0	0
22	41549297	rs7510675	A	G	2	7	9	0	0	9	0	0
22	41551039	rs20552	T	A	125	111	236	0	1	237	0	0
22	41563918	rs58268766	C	T	4	2	6	0	0	6	0	0
22	41565285	rs5751058	A	G	5	2	7	0	0	7	0	0
22	41567535	rs136393	G	T	3	7	10	0	0	10	0	0
22	41567722	rs5751060	G	T	6	5	11	0	0	11	0	0
22	41568480	rs2076577	T	C	2	4	6	0	0	6	0	0
22	41569887	rs2076580	G	A	73	64	137	0	1	138	0	0
22	41570071	rs2076581	T	C	95	106	201	0	0	201	0	0
22	41570745	rs5758251	T	C	50	61	111	0	3	114	0	0
22	41609859	rs139450	T	C	3	5	8	0	0	8	0	0
22	41610024	rs139451	G	A	12	17	29	0	0	29	0	0
22	41614020	rs139464	C	G	5	2	7	0	0	7	0	0
22	41614113	rs139465	C	T	7	5	12	0	0	12	0	0
22	41626663	rs139480	C	T	41	31	72	0	0	72	0	0
22	41627073	rs3721	C	T	53	61	114	0	1	115	0	0
22	41641984	rs1953	C	T	193	184	377	0	5	382	0	0
22	41645757	rs71948	C	G	103	110	213	0	2	215	0	0
22	41646738	rs11703267	A	G	5	9	14	0	0	14	0	0
22	41651704	rs139508	G	A	2	5	7	0	0	7	0	0
22	41652733	rs139509	G	A	80	49	129	0	1	130	0	0
22	41914434	rs41276321	A	C	15	17	32	0	0	32	0	0
22	42455248	rs62238588	C	T	6	2	8	0	0	8	0	0
22	42484712	rs62238594	C	T	3	5	8	0	0	8	0	0
22	42523528	.	C	T	1	27	28	0	0	28	0	0
22	42538870	rs2982057	A	C	5	1	6	0	1	7	0	0
22	42546852	rs59390354	G	A	7	11	18	0	0	18	0	0
22	42776588	rs2294361	T	C	17	28	45	0	0	45	0	0
22	42776609	rs2294362	A	G	17	24	41	0	0	41	0	0
22	42777414	rs12484310	G	A	5	8	13	0	2	15	0	0
22	42777621	rs11090090	A	G	8	12	20	0	0	20	0	0
22	42777662	rs11090091	C	T	4	7	11	0	1	12	0	0
22	42777694	rs11090092	A	G	3	6	9	0	0	9	0	0
22	42777866	rs10854752	T	C	10	8	18	0	0	18	0	0
22	42777935	rs11090094	A	C	14	3	17	0	0	17	0	0
22	42777966	rs11090095	C	T	13	5	18	0	0	18	0	0
22	42778078	rs6002712	A	G	13	11	24	0	0	24	0	0
22	42778116	rs6002713	C	T	12	11	23	0	1	24	0	0
22	42778210	rs6002714	T	C	15	8	23	0	0	23	0	0
22	42778325	rs6002715	A	G	7	5	12	0	0	12	0	0
22	42779018	rs1057157	T	C	11	11	22	0	0	22	0	0
22	42779551	rs9611785	T	C	8	2	10	0	0	10	0	0
22	42779699	rs2413687	T	C	6	5	11	0	0	11	0	0
22	42779752	rs2092175	T	A	10	8	18	0	2	20	0	0
22	43023939	rs2071846	G	T	6	4	10	0	0	10	0	0
22	43026690	rs2285139	G	A	7	2	9	0	0	9	0	0
22	43026792	rs5758820	A	G	11	3	14	0	0	14	0	0
22	43193323	rs5751372	T	C	64	67	131	0	1	132	0	0
22	43193641	rs4393836	G	A	3	6	9	0	0	9	0	0
22	43194273	rs1807591	G	A	4	4	8	0	0	8	0	0
22	43195147	rs1128013	A	G	41	37	78	0	1	79	0	0
22	43195671	rs5758949	A	T	7	4	11	0	1	12	0	0
22	43197034	rs5758951	A	G	4	2	6	0	0	6	0	0
22	43203137	rs738535	C	T	38	26	64	0	0	64	0	0
22	43225174	rs5758962	A	C	6	10	16	0	0	16	0	0
22	43265827	rs7074	G	T	14	19	33	0	0	33	0	0
22	43266247	rs753086	G	A	87	69	156	0	0	156	0	0
22	43266363	rs7073	C	T	73	61	134	0	3	137	0	0
22	43266774	rs8569	C	T	37	37	74	0	3	77	0	0
22	43268009	rs13433641	T	C	3	5	8	0	0	8	0	0
22	43272792	rs5751397	C	T	5	7	12	0	1	13	0	0
22	43274772	rs9611951	A	G	3	3	6	0	0	6	0	0
22	43275968	rs8141676	G	C	6	8	14	0	0	14	0	0
22	43276030	rs4820492	A	C	5	5	10	0	0	10	0	0
22	43278220	rs2899365	C	T	21	19	40	0	1	41	0	0
22	43289473	rs5759013	G	A	19	17	36	0	0	36	0	0
22	43290583	rs4822220	T	C	4	2	6	0	0	6	0	0
22	43291529	rs5759015	C	A	1	6	7	0	0	7	0	0
22	43293684	rs2077446	G	A	2	4	6	0	0	6	0	0
22	43303017	rs5759022	C	T	19	5	24	0	0	24	0	0
22	43303172	rs2267467	G	C	21	8	29	0	0	29	0	0
22	43530700	rs872841	G	C	8	1	9	0	1	10	0	0
22	43576904	rs2071723	G	A	5	6	11	0	0	11	0	0
22	44220673	rs138056	C	A	1	17	18	0	1	19	0	0
22	44221247	rs138057	A	G	0	16	16	0	0	16	0	0
22	44368122	rs3761472	A	G	32	52	84	0	0	84	0	0
22	44379838	rs8418	A	G	71	74	145	0	5	150	0	0
22	44391588	rs2179642	T	C	3	4	7	0	0	7	0	0
22	44489896	rs738479	T	C	125	128	253	0	3	256	0	0
22	44491632	rs4561757	G	A	5	2	7	0	0	7	0	0
22	44564297	rs139095	A	C	3	4	7	0	0	7	0	0
22	44564402	rs6006687	G	A	6	0	6	0	0	6	0	0
22	44565334	rs9614356	C	T	12	22	34	0	0	34	0	0
22	44565511	rs9614357	G	A	12	14	26	0	1	27	0	0
22	44565592	rs9614358	G	A	2	4	6	0	0	6	0	0
22	44566434	rs9614359	G	A	9	8	17	0	0	17	0	0
22	44566563	rs59935732	C	A	13	11	24	0	3	27	0	0
22	44566985	rs4823199	C	T	9	15	24	0	0	24	0	0
22	44567435	rs9614207	A	G	7	10	17	0	0	17	0	0
22	44567854	rs1127721	G	T	28	16	44	0	1	45	0	0
22	44568078	rs9614208	G	A	33	49	82	0	0	82	0	0
22	44577683	rs2272941	T	A	95	73	168	0	1	169	0	0
22	44582105	rs139132	G	A	35	55	90	0	0	90	0	0
22	44582136	rs3747213	G	A	52	41	93	0	0	93	0	0
22	44582820	rs139133	T	G	69	65	134	0	0	134	0	0
22	44586522	rs2272942	C	T	227	189	416	0	1	417	0	0
22	44588459	rs3747214	T	C	2	7	9	0	0	9	0	0
22	44589857	rs139142	T	G	6	6	12	0	0	12	0	0
22	44590726	rs2748871	T	C	7	5	12	0	0	12	0	0
22	44590992	rs139144	G	A	5	2	7	0	0	7	0	0
22	44593488	rs139146	C	G	9	7	16	0	0	16	0	0
22	44593624	rs139147	T	C	7	7	14	0	0	14	0	0
22	44594209	rs139150	T	G	6	4	10	0	0	10	0	0
22	44594584	rs139152	C	G	250	213	463	0	5	468	0	0
22	44594992	rs76846378	T	A	4	4	8	0	0	8	0	0
22	44595439	rs139153	C	T	5	2	7	0	0	7	0	0
22	44597504	rs139160	T	C	2	5	7	0	0	7	0	0
22	44597596	rs139161	G	A	3	3	6	0	0	6	0	0
22	44597747	rs139162	C	T	4	4	8	0	0	8	0	0
22	44597929	rs139163	G	A	6	4	10	0	0	10	0	0
22	44598301	rs139165	G	T	5	6	11	0	0	11	0	0
22	44598692	rs139167	G	A	9	2	11	0	0	11	0	0
22	44598857	.	C	T	6	10	16	0	1	17	0	0
22	44599452	rs139170	C	T	3	3	6	0	0	6	0	0
22	44599531	rs139171	G	A	5	2	7	0	0	7	0	0
22	44599736	rs73163853	G	C	3	3	6	0	0	6	0	0
22	44599781	rs139174	G	A	2	4	6	0	0	6	0	0
22	44600135	rs139176	C	A	4	7	11	0	0	11	0	0
22	44600172	rs139177	A	G	5	10	15	0	0	15	0	0
22	44600175	rs139178	C	T	5	10	15	0	0	15	0	0
22	44600500	rs139179	C	T	1	7	8	0	0	8	0	0
22	44600633	rs139180	G	C	4	5	9	0	0	9	0	0
22	44600652	rs139181	G	A	6	3	9	0	0	9	0	0
22	44600954	rs139182	T	C	6	5	11	0	0	11	0	0
22	44600995	rs139183	C	A	5	5	10	0	0	10	0	0
22	44601499	rs139184	C	G	4	9	13	0	0	13	0	0
22	44602001	rs139185	G	T	3	5	8	0	0	8	0	0
22	44602172	rs3842785	T	C	5	5	10	0	0	10	0	0
22	44602549	rs139187	A	C	52	60	112	0	7	119	0	0
22	44603527	rs9754424	A	G	13	11	24	0	0	24	0	0
22	44603582	rs139188	G	A	47	34	81	0	1	82	0	0
22	44603870	rs139190	T	C	154	131	285	0	3	288	0	0
22	44605522	rs139195	T	C	15	19	34	0	0	34	0	0
22	44605799	rs139196	A	G	7	9	16	0	0	16	0	0
22	44606259	rs1133428	A	G	30	29	59	0	1	60	0	0
22	44889342	rs3747218	G	C	21	24	45	0	1	46	0	0
22	44890312	.	T	A	22	9	31	0	0	31	0	0
22	45073281	rs184261450	C	A	8	8	16	0	1	17	0	0
22	45221423	rs3209476	A	T	17	12	29	0	1	30	0	0
22	45253079	rs4823396	G	C	10	7	17	0	2	19	0	0
22	45253473	rs13054899	G	A	9	14	23	0	0	23	0	0
22	45253773	rs71328677	G	A	13	20	33	0	1	34	0	0
22	45254340	rs11913791	T	C	7	9	16	0	0	16	0	0
22	45254717	rs2269546	C	G	18	4	22	0	0	22	0	0
22	45255460	rs4336044	G	A	27	28	55	0	2	57	0	0
22	45256418	rs59455021	T	G	2	4	6	0	0	6	0	0
22	45258324	rs2071762	C	T	58	55	113	0	1	114	0	0
22	45258539	rs2071763	G	A	31	23	54	0	1	55	0	0
22	45258614	rs2071764	G	C	3	3	6	0	0	6	0	0
22	45723854	rs9615108	C	G	13	6	19	0	0	19	0	0
22	45726345	rs7285172	A	G	8	1	9	0	0	9	0	0
22	45731539	rs738177	C	T	5	1	6	0	0	6	0	0
22	45731730	rs2205659	T	C	5	3	8	0	1	9	0	0
22	45731731	rs2205660	G	A	4	3	7	0	1	8	0	0
22	45732328	rs11704481	G	A	7	1	8	0	0	8	0	0
22	45735606	rs998706	T	C	7	7	14	0	0	14	0	0
22	45735741	rs998705	T	C	9	6	15	0	0	15	0	0
22	45736153	rs3827393	G	A	5	2	7	0	0	7	0	0
22	45736485	rs2064068	C	T	23	16	39	0	0	39	0	0
22	45736767	rs2350630	A	G	14	12	26	0	0	26	0	0
22	45736871	rs5766662	T	C	7	19	26	0	0	26	0	0
22	45737290	rs1044742	G	A	34	29	63	0	0	63	0	0
22	45737487	rs10343	G	A	58	43	101	0	0	101	0	0
22	46098587	.	G	A	61	41	102	0	1	103	0	0
22	46436973	rs7511186	T	A	2	4	6	0	0	6	0	0
22	46438873	rs7511036	C	G	6	2	8	0	0	8	0	0
22	46440273	rs8140558	A	G	5	7	12	0	0	12	0	0
22	46440359	rs10427685	C	G	8	6	14	0	0	14	0	0
22	46451537	rs7410432	G	A	6	0	6	0	0	6	0	0
22	46475465	rs9615389	T	C	14	11	25	0	1	26	0	0
22	46664412	rs117135869	C	T	25	25	50	0	0	50	0	0
22	46676203	rs1108458	C	T	6	9	15	0	0	15	0	0
22	46683138	rs55746052	C	G	7	4	11	0	0	11	0	0
22	46747300	.	T	C	5	5	10	0	1	11	0	0
22	46752911	rs55905826	G	C	54	59	113	0	0	113	0	0
22	46974717	rs9284525	G	C	1	5	6	0	0	6	0	0
22	46980536	rs7284396	G	C	6	2	8	0	0	8	0	0
22	46981329	rs9616062	C	T	3	4	7	0	0	7	0	0
22	46981340	rs5768990	A	G	3	3	6	0	0	6	0	0
22	46982721	rs9615390	T	C	4	4	8	0	0	8	0	0
22	46982722	rs9616067	G	A	4	4	8	0	0	8	0	0
22	46983605	rs5768992	A	G	4	2	6	0	0	6	0	0
22	46987047	rs5767283	T	A	7	5	12	0	0	12	0	0
22	46987087	rs5769001	G	T	6	6	12	0	0	12	0	0
22	46987989	rs9615391	G	A	3	7	10	0	0	10	0	0
22	46987995	rs9616073	T	C	3	7	10	0	0	10	0	0
22	47070747	rs34212133	G	T	7	13	20	0	0	20	0	0
22	47071531	rs2073276	T	C	4	5	9	0	0	9	0	0
22	47071860	rs2748341	A	C	10	6	16	0	0	16	0	0
22	47072070	rs17821673	C	T	9	11	20	0	1	21	0	0
22	47072477	rs2236028	G	A	16	17	33	0	0	33	0	0
22	47073721	rs5769068	C	T	48	42	90	0	2	92	0	0
22	47073801	rs41279843	G	A	38	68	106	0	1	107	0	0
22	47073861	rs17761627	C	T	33	62	95	0	4	99	0	0
22	47073875	rs2748343	T	C	68	36	104	0	2	106	0	0
22	47074258	rs3747253	G	A	34	19	53	0	2	55	0	0
22	47074281	rs3747255	G	A	27	11	38	0	0	38	0	0
22	47074937	rs2542026	T	C	141	111	252	0	2	254	0	0
22	47075462	rs3179	C	T	110	74	184	0	1	185	0	0
22	47080465	rs710124	T	C	115	119	234	0	1	235	0	0
22	47080801	rs1047123	G	C	113	89	202	0	2	204	0	0
22	47080968	rs801722	T	G	75	87	162	0	4	166	0	0
22	47081088	rs2236029	A	G	56	47	103	0	0	103	0	0
22	47081716	rs801721	A	G	44	43	87	0	0	87	0	0
22	47081855	rs2748348	A	G	53	44	97	0	1	98	0	0
22	47095235	rs13057352	C	A	32	27	59	0	0	59	0	0
22	47130782	rs1548978	A	T	7	17	24	0	0	24	0	0
22	49937236	rs28546641	C	T	2	5	7	0	0	7	0	0
22	49988815	rs2007024	C	T	16	21	37	0	2	39	0	0
22	49989106	rs1109320	G	A	13	25	38	0	0	38	0	0
22	49989272	rs75772261	T	C	17	11	28	0	1	29	0	0
22	49989649	rs73176988	G	T	7	4	11	0	0	11	0	0
22	50050468	rs739239	G	A	6	22	28	0	0	28	0	0
22	50050847	rs9616333	G	A	11	30	41	0	0	41	0	0
22	50050859	rs9616714	G	A	10	31	41	0	0	41	0	0
22	50050914	rs150881946	C	T	25	7	32	0	0	32	0	0
22	50051007	rs6009803	A	G	0	7	7	0	0	7	0	0
22	50173950	rs565076505	G	A	12	11	23	0	0	23	0	0
22	50214021	rs138877	G	A	3	5	8	0	0	8	0	0
22	50499957	rs41283496	G	A	85	73	158	0	0	158	0	0
22	50499964	rs137919	T	C	76	83	159	0	1	160	0	0
22	50501059	rs137920	A	G	14	5	19	0	0	19	0	0
22	50501685	rs137921	T	C	14	9	23	0	0	23	0	0
22	50501957	rs73183370	G	C	2	6	8	0	0	8	0	0
22	50502808	rs150770587	G	A	9	6	15	0	0	15	0	0
22	50504446	rs2294385	A	G	2	6	8	0	0	8	0	0
22	50506668	rs2076127	C	T	4	3	7	0	0	7	0	0
22	50512514	rs2272832	T	G	47	27	74	0	0	74	0	0
22	50512617	rs2038048	C	T	57	48	105	0	1	106	0	0
22	50517777	rs8137999	C	T	3	4	7	0	0	7	0	0
22	50519644	rs137927	T	C	4	2	6	0	0	6	0	0
22	50520838	rs137928	C	T	10	7	17	0	0	17	0	0
22	50610628	rs6010198	G	A	4	7	11	0	0	11	0	0
22	50611915	rs73187233	C	G	3	8	11	0	0	11	0	0
22	50613202	rs4838859	G	A	4	15	19	0	0	19	0	0
22	50613314	rs75549088	G	A	4	7	11	0	0	11	0	0
22	50613714	rs2294397	A	G	8	14	22	0	1	23	0	0
22	50614476	rs5771204	T	C	2	7	9	0	0	9	0	0
22	50616806	rs5771206	A	G	6	8	14	0	1	15	0	0
22	50625079	rs13054650	G	C	6	7	13	0	0	13	0	0
22	50625166	rs7288889	T	G	11	17	28	0	0	28	0	0
22	50625271	rs73187244	T	C	14	8	22	0	0	22	0	0
22	50625449	rs73187245	C	T	9	6	15	0	0	15	0	0
22	50626791	rs5771215	C	A	4	11	15	0	0	15	0	0
22	50627188	rs11912419	C	T	12	18	30	0	0	30	0	0
22	50627253	rs1555050	C	T	12	14	26	0	0	26	0	0
22	50627704	rs5771217	G	T	10	5	15	0	0	15	0	0
22	50628451	rs4838812	A	G	16	17	33	0	0	33	0	0
22	50628746	rs735119	T	G	9	10	19	0	0	19	0	0
22	50628996	rs56036086	G	A	13	4	17	0	1	18	0	0
22	50629292	rs732405	T	G	13	17	30	0	0	30	0	0
22	50629872	rs73187247	C	T	27	24	51	0	0	51	0	0
22	50630670	rs738339	C	T	54	36	90	0	0	90	0	0
22	50630794	rs56308603	G	A	54	53	107	0	0	107	0	0
22	50631226	rs2341367	T	C	55	51	106	0	0	106	0	0
22	50632110	.	G	A	45	49	94	0	1	95	0	0
22	50633686	rs6537639	T	C	26	16	42	0	0	42	0	0
22	50634526	rs73187249	G	A	86	26	112	0	1	114	1	0
22	50634552	rs73187250	G	A	78	24	102	0	0	102	0	0
22	50635120	rs4084289	A	G	28	8	36	0	6	42	0	0
22	50637193	rs3747941	A	G	154	213	367	0	11	378	0	0
22	50637597	rs8238	G	C	707	571	1278	0	4	1282	0	0
22	50637922	rs6712	G	C	498	529	1027	0	8	1035	0	0
22	50638172	rs563890950	G	C	40	29	69	0	1	70	0	0
22	50638502	rs5771096	T	C	28	48	76	0	0	76	0	0
22	50638953	rs1009610	A	G	13	8	21	0	0	21	0	0
22	50639473	rs5771225	T	C	3	4	7	0	0	7	0	0
22	50639528	rs5771226	T	C	3	5	8	0	0	8	0	0
22	50639965	rs2272846	C	A	5	7	12	0	0	12	0	0
22	50641351	rs4395345	G	A	22	32	54	0	0	54	0	0
22	50642359	rs73187254	C	T	23	30	53	0	1	54	0	0
22	50642777	rs4838861	C	T	26	28	54	0	0	54	0	0
22	50642793	rs4838814	C	G	21	23	44	0	0	44	0	0
22	50644480	rs56109781	T	C	26	33	59	0	1	60	0	0
22	50645219	rs11913090	G	A	37	54	91	0	2	93	0	0
22	50647448	rs55958053	T	G	17	19	36	0	0	36	0	0
22	50647966	rs4602327	A	G	47	57	104	0	2	106	0	0
22	50649545	rs4838863	A	G	1	10	11	0	0	11	0	0
22	50651785	rs73187263	C	T	4	7	11	0	0	11	0	0
22	50652653	rs148873317	C	T	5	7	12	0	0	12	0	0
22	50657112	rs11912397	C	T	5	5	10	0	0	10	0	0
22	50658053	rs6537642	A	G	29	15	44	0	2	46	0	0
22	50658501	rs9617119	A	G	19	19	38	0	0	38	0	0
22	50661869	rs5771242	T	C	15	14	29	0	0	29	0	0
22	50664612	rs4838865	A	G	34	32	66	0	1	67	0	0
22	50666223	rs56133520	G	A	5	5	10	0	0	10	0	0
22	50667565	rs73187272	G	A	6	10	16	0	0	16	0	0
22	50683792	rs7292864	A	G	28	10	38	0	1	41	2	0
22	50684296	rs13058062	T	C	19	10	29	0	0	29	0	0
22	50685508	rs4838866	A	G	4	7	11	0	0	11	0	0
22	50688235	rs738334	T	C	7	5	12	0	0	12	0	0
22	50688348	rs1555048	A	G	70	72	142	0	0	142	0	0
22	50689030	rs909688	A	G	7	3	10	0	0	10	0	0
22	50692562	rs5771276	G	A	13	1	14	0	0	14	0	0
22	50692848	rs2009816	G	A	12	1	13	0	0	13	0	0
22	50692853	rs2880034	G	A	12	1	13	0	0	13	0	0
22	50692856	rs2009815	C	T	12	1	13	0	0	13	0	0
22	50692878	rs1810456	G	A	13	1	14	0	0	14	0	0
22	50692908	rs4077315	C	T	11	1	12	0	0	12	0	0
22	50693340	rs5771280	A	T	8	6	14	0	0	14	0	0
22	50693479	rs5771281	A	G	6	3	9	0	0	9	0	0
22	50693554	rs6010220	A	G	5	1	6	0	0	6	0	0
22	50694297	rs1129880	A	G	63	52	115	0	0	115	0	0
22	50695270	rs5771284	A	C	10	11	21	0	0	21	0	0
22	50695908	rs5771285	G	T	33	2	35	0	0	35	0	0
22	50695946	rs5771111	C	G	36	2	38	0	0	38	0	0
22	50699331	rs3817818	C	G	4	3	7	0	0	7	0	0
22	50705304	rs760747	C	T	3	8	11	0	0	11	0	0
22	50722408	rs79966207	T	C	50	40	90	0	0	90	0	0
22	50751529	rs67248662	G	C	82	61	143	0	1	144	0	0
22	50752169	rs73891220	G	A	8	3	11	0	0	11	0	0
22	50753334	rs73439311	G	A	10	13	23	0	0	23	0	0
22	50754466	rs62241230	C	T	8	15	23	0	2	25	0	0
22	50754648	.	T	C	9	7	16	0	0	16	0	0
22	50881796	rs1056688	C	G	12	20	32	0	0	32	0	0
22	50881954	rs4824136	G	C	22	22	44	0	0	44	0	0
22	50883660	rs76275199	G	A	71	88	159	0	7	166	0	0
22	50885775	rs1053744	A	G	259	264	523	0	7	531	1	0
22	50886220	rs5770980	T	C	15	27	42	0	0	42	0	0
22	50886557	rs6010041	A	G	8	15	23	0	0	23	0	0
22	50895133	rs4824117	A	G	12	5	17	0	1	18	0	0
22	50896121	rs4824118	C	T	23	20	43	0	0	43	0	0
22	50896384	rs4824119	C	G	19	18	37	0	0	37	0	0
22	50896385	rs4824148	A	G	18	17	35	0	2	37	0	0
22	50896901	rs11703111	G	A	35	12	47	0	1	48	0	0
22	50911876	rs4824152	A	G	4	3	7	0	0	7	0	0
22	50942121	rs13056405	C	T	176	155	331	0	4	335	0	0
22	50943004	rs762671	C	A	54	38	92	0	0	92	0	0
22	50943010	rs762670	G	A	54	39	93	0	0	93	0	0
22	50943232	rs8136495	G	A	109	101	210	0	0	210	0	0
22	50944163	rs128941	G	A	42	53	95	0	1	96	0	0
22	50945256	rs131824	A	G	39	45	84	0	1	85	0	0
22	50955538	rs131817	A	G	5	1	6	0	0	6	0	0
22	50958392	rs10854880	C	T	31	26	57	0	0	57	0	0
22	50959608	rs131815	C	T	29	23	52	0	0	52	0	0
22	50960101	rs131814	G	A	5	6	11	0	0	11	0	0
22	50961169	rs131813	A	G	39	9	48	0	1	49	0	0
22	50961854	rs2782	T	C	101	115	216	0	0	216	0	0
22	50962208	rs12148	T	G	184	168	352	0	3	355	0	0
22	50962782	rs140523	C	G	97	94	191	0	0	192	1	0
22	50963357	rs131808	G	C	13	9	22	0	0	22	0	0
22	50963540	rs131807	G	C	5	6	11	0	0	11	0	0
22	50963965	rs131806	C	G	4	6	10	0	0	10	0	0
22	50964153	rs131805	T	C	5	5	10	0	0	10	0	0
22	50964862	rs131804	G	A	10	11	21	0	0	21	0	0
22	50966634	rs131801	G	T	18	12	30	0	0	30	0	0
22	50966914	rs470119	T	C	12	4	16	0	1	17	0	0
22	50967269	rs131800	A	G	17	9	26	0	0	26	0	0
22	50981436	rs131784	G	A	6	2	8	0	0	8	0	0
22	50985703	rs5770882	A	G	9	0	9	0	1	10	0	0
22	50988062	rs140519	G	T	40	51	91	0	1	92	0	0
22	50988193	rs131779	A	G	37	19	56	0	0	57	1	0
22	50989326	rs131778	A	G	23	25	48	0	0	48	0	0
22	51009953	rs470117	C	T	90	95	185	0	2	187	0	0
22	51011936	rs131760	T	C	6	6	12	0	0	12	0	0
22	51015210	rs140515	G	C	11	13	24	0	0	24	0	0
22	51015481	rs131759	G	A	8	9	17	0	0	17	0	0
22	51017082	rs131758	T	A	31	25	56	0	0	56	0	0
22	51018579	rs140514	A	G	4	5	9	0	0	9	0	0
22	51020668	rs86337	C	A	32	35	67	0	2	69	0	0
22	51062891	rs7288338	C	G	5	5	10	0	1	11	0	0
22	51063987	rs762674	G	C	1	6	7	0	1	8	0	0
22	51064039	rs743616	G	C	38	31	69	0	0	69	0	0
22	51065361	rs6151415	C	A	10	30	40	0	0	40	0	0
22	51121521	rs7284093	C	T	3	4	7	0	0	7	0	0
22	51121561	rs9616933	G	T	4	5	9	0	0	9	0	0
22	51123411	rs113604661	C	T	3	5	8	0	0	8	0	0
22	51144168	rs12628844	A	G	5	1	6	0	0	6	0	0
22	51147015	rs2040487	A	G	2	5	7	0	0	7	0	0
22	51161019	rs5770994	C	T	10	16	26	0	3	29	0	0
22	51162850	rs5770822	C	G	14	14	28	0	0	28	0	0
22	51163039	rs715584	G	T	13	16	29	0	0	29	0	0
22	51163138	rs715586	C	T	11	13	24	0	0	24	0	0
22	51164109	rs5770995	G	C	11	15	26	0	0	26	0	0
22	51164115	rs5770996	C	T	11	15	26	0	0	26	0	0
22	51183255	rs5771002	A	G	4	9	13	0	0	13	0	0
22	51206413	rs3888556	T	A	8	12	20	0	0	20	0	0
22	51206426	rs3888555	T	C	7	12	19	0	0	19	0	0
22	51206485	.	A	T	9	4	13	0	1	14	0	0
3	3170078	rs112763100	C	G	16	3	19	0	0	19	0	0
3	3170409	rs334774	G	C	3	5	8	0	0	8	0	0
3	3170966	rs4684375	T	C	6	4	10	0	0	10	0	0
3	3171125	rs334770	G	A	4	8	12	0	0	12	0	0
3	3171897	rs6788122	T	C	8	2	10	0	0	10	0	0
3	3174442	.	C	A	5	5	10	0	1	11	0	0
3	3189279	rs1705805	A	G	7	8	15	0	0	15	0	0
3	3190240	rs12107469	T	C	13	10	23	0	0	23	0	0
3	3191426	rs1045433	T	C	8	7	15	0	0	15	0	0
3	3192927	rs1620675	T	G	6	13	19	0	0	19	0	0
3	3193826	rs1055926	T	A	14	3	17	0	0	17	0	0
3	3195369	rs73005226	A	G	13	11	24	0	0	24	0	0
3	3195574	rs3846135	C	T	14	8	22	0	0	22	0	0
3	3197035	rs2291398	T	G	13	8	21	0	0	21	0	0
3	3198513	rs1672767	C	T	9	4	13	0	0	13	0	0
3	3199170	rs1669339	T	G	6	1	7	0	0	7	0	0
3	3199635	rs1669338	A	C	11	3	14	0	0	14	0	0
3	3200013	rs6784329	C	T	2	7	9	0	0	9	0	0
3	3201432	rs1705832	T	C	3	4	7	0	0	7	0	0
3	3201780	rs3792415	G	C	4	6	10	0	0	10	0	0
3	3205432	rs698204	G	C	7	3	10	0	0	10	0	0
3	3205515	rs60103375	A	C	2	5	7	0	0	7	0	0
3	3206281	rs1705814	C	T	3	5	8	0	0	8	0	0
3	3209242	rs4685612	G	T	17	15	32	0	0	32	0	0
3	3213689	rs1669323	G	A	4	4	8	0	0	8	0	0
3	3213775	rs3749360	G	A	6	2	8	0	0	8	0	0
3	4358210	rs7647539	A	G	52	60	112	0	0	112	0	0
3	4403153	rs14275	T	G	23	20	43	0	0	43	0	0
3	4403537	rs4685744	C	T	10	7	17	0	0	17	0	0
3	4403614	rs2819562	T	C	5	7	12	0	0	12	0	0
3	4403767	rs2819561	A	G	15	9	24	0	0	24	0	0
3	4403817	rs2633851	T	A	15	6	21	0	0	21	0	0
3	4403818	rs35083095	T	C	15	6	21	0	0	21	0	0
3	4403837	rs2633852	A	G	13	8	21	0	0	21	0	0
3	4508742	rs2819590	C	T	5	5	10	0	0	10	0	0
3	4602747	rs4685760	G	C	6	0	6	0	0	6	0	0
3	4716811	rs2306877	A	C	12	9	21	0	0	21	0	0
3	4776859	.	G	A	12	6	18	0	0	18	0	0
3	4842231	rs2291862	C	T	23	21	44	0	0	44	0	0
3	4856180	rs711631	T	C	33	13	46	0	1	47	0	0
3	4856234	rs901854	G	A	26	17	43	0	0	43	0	0
3	5019579	rs867893	G	T	4	4	8	0	0	8	0	0
3	5019936	rs1110261	G	A	16	10	26	0	0	26	0	0
3	5020148	rs1104976	A	C	4	2	6	0	0	6	0	0
3	5021403	rs2271566	C	T	301	301	602	0	3	605	0	0
3	5022961	rs13076468	A	C	10	4	14	0	1	15	0	0
3	5023574	rs6790630	G	A	11	20	31	0	0	31	0	0
3	5023996	rs6779816	A	G	18	18	36	0	0	36	0	0
3	5025645	rs34883305	G	C	639	617	1256	0	6	1265	3	0
3	5025650	rs34870629	G	T	636	605	1241	0	11	1253	1	0
3	5025654	rs74439275	G	A	657	595	1252	0	9	1261	0	0
3	5026008	rs11130215	A	G	613	598	1211	0	14	1225	0	0
3	5026261	rs3750275	A	G	741	726	1467	0	15	1482	0	0
3	5026618	rs34622661	T	A	119	93	212	0	0	212	0	0
3	5215924	rs73002998	A	G	6	4	10	0	0	10	0	0
3	6241837	rs7623846	C	G	4	4	8	0	0	8	0	0
3	9426330	rs61751573	A	G	179	180	359	0	2	361	0	0
3	9517577	rs17747739	C	T	109	91	200	0	1	201	0	0
3	9727002	rs787836	G	C	13	11	24	0	0	24	0	0
3	9728444	rs34660509	G	A	22	7	29	0	1	30	0	0
3	9733049	rs9985277	C	T	2	6	8	0	1	9	0	0
3	9733647	rs17050518	T	G	6	4	10	0	0	10	0	0
3	9735085	rs7615134	A	C	8	5	13	0	0	13	0	0
3	9737501	rs9845191	C	T	5	2	7	0	0	7	0	0
3	9737509	rs79851238	G	A	4	2	6	0	0	6	0	0
3	9738685	rs9850663	C	G	4	7	11	0	0	11	0	0
3	9739329	rs9855484	C	T	6	4	10	0	0	10	0	0
3	9739693	rs9856002	C	T	7	11	18	0	0	18	0	0
3	9740598	rs12495642	G	A	5	4	9	0	1	10	0	0
3	9743011	rs112806181	C	G	22	15	37	0	0	37	0	0
3	9743077	rs73113525	T	C	22	17	39	0	0	39	0	0
3	9829171	rs2290309	G	A	7	4	11	0	0	11	0	0
3	9829226	rs293786	A	C	6	3	9	0	0	9	0	0
3	9840983	rs6774930	C	T	6	5	11	0	0	11	0	0
3	9852148	rs9827444	G	A	5	5	10	0	0	10	0	0
3	9853437	rs4686373	A	G	6	0	6	0	0	6	0	0
3	9859198	rs11131190	G	A	7	4	11	0	0	11	0	0
3	9859456	rs3806672	C	G	21	15	36	0	0	36	0	0
3	9859777	rs3806670	G	T	19	9	28	0	0	28	0	0
3	9860880	rs3806667	G	T	18	8	26	0	0	26	0	0
3	9861053	rs3806666	T	C	13	13	26	0	0	26	0	0
3	9867625	rs3732527	C	T	60	46	106	0	0	106	0	0
3	9869150	rs11717031	G	T	4	2	6	0	0	6	0	0
3	9869375	rs9827315	C	T	5	6	11	0	0	11	0	0
3	9870065	rs9879307	C	T	6	2	8	0	0	8	0	0
3	9870857	rs2290303	G	A	66	48	114	0	1	115	0	0
3	9871030	rs2290305	T	G	82	80	162	0	1	163	0	0
3	9875212	rs11926325	G	A	6	8	14	0	0	14	0	0
3	9876301	rs13088594	G	T	9	5	14	0	0	14	0	0
3	9877481	rs9878419	G	A	69	37	106	0	0	106	0	0
3	9877783	rs9878944	G	A	64	51	115	0	1	116	0	0
3	9879034	rs12715664	A	G	5	4	9	0	0	9	0	0
3	9879756	.	G	A	41	29	70	0	0	70	0	0
3	9883021	rs2426	G	A	9	5	14	0	0	14	0	0
3	9883030	rs1133340	T	C	8	6	14	0	0	14	0	0
3	9935094	rs79555969	C	T	65	61	126	0	1	127	0	0
3	9991388	rs279601	G	C	13	6	19	0	0	19	0	0
3	10059436	rs8411	T	C	81	63	144	0	2	146	0	0
3	10064155	rs150289872	G	A	5	7	12	0	0	12	0	0
3	10065139	.	C	T	6	3	9	0	0	9	0	0
3	10085816	rs2287439	G	T	3	4	7	0	0	7	0	0
3	10142949	rs3172417	C	T	71	77	148	0	0	148	0	0
3	10187634	rs2543458	G	T	3	3	6	0	0	6	0	0
3	10190467	rs1642743	C	T	6	0	6	0	0	6	0	0
3	10191219	rs1703153	C	G	2	4	6	0	0	6	0	0
3	10191943	rs1642742	G	A	42	37	79	0	2	81	0	0
3	10192672	rs1681669	G	A	38	38	76	0	0	76	0	0
3	10192709	rs1681668	C	T	29	31	60	0	0	60	0	0
3	10192762	rs1642741	T	C	15	15	30	0	0	30	0	0
3	10193068	rs141916278	A	G	36	26	62	0	0	62	0	0
3	10193683	rs1136249	T	G	67	57	124	0	1	125	0	0
3	10318542	rs242730	A	G	3	3	6	0	0	6	0	0
3	10319262	rs242729	G	T	16	5	21	0	0	21	0	0
3	10319540	rs242728	C	T	12	6	18	0	0	18	0	0
3	10319720	rs4684675	G	T	11	17	28	0	0	28	0	0
3	10320865	rs2075355	A	G	8	3	11	0	0	11	0	0
3	10320968	rs1063429	T	A	43	52	95	0	0	95	0	0
3	10321229	rs3204477	G	T	46	52	98	0	1	99	0	0
3	10321734	rs514658	C	T	94	70	164	0	0	164	0	0
3	10325750	rs171336	T	G	4	7	11	0	0	11	0	0
3	10326169	rs171407	G	A	5	1	6	0	0	6	0	0
3	10326686	rs35684	A	G	9	10	19	0	0	19	0	0
3	10329377	rs35681	T	C	5	1	6	0	0	6	0	0
3	10332365	rs26802	T	G	4	3	7	0	0	7	0	0
3	10332468	rs27647	C	T	4	4	8	0	0	8	0	0
3	10342876	rs696221	C	T	226	171	397	0	4	401	0	0
3	10343244	rs35673	G	A	20	18	38	0	0	38	0	0
3	10345180	rs35672	G	T	6	7	13	0	0	13	0	0
3	10355475	rs140476751	A	G	7	4	11	0	0	11	0	0
3	10355584	rs154238	C	G	10	5	15	0	0	15	0	0
3	10356146	rs154237	A	C	10	11	21	0	0	21	0	0
3	10356314	rs154236	C	T	13	7	20	0	0	20	0	0
3	10356740	rs118693	T	A	9	6	15	0	0	15	0	0
3	10356760	rs118694	G	A	9	5	14	0	0	14	0	0
3	10359250	rs629067	C	T	2	4	6	0	0	6	0	0
3	10362292	rs154240	T	C	3	8	11	0	0	11	0	0
3	11320120	rs384989	C	T	6	0	6	0	0	6	0	0
3	11324794	rs921226	C	T	12	21	33	0	0	33	0	0
3	11325276	rs2594966	G	A	35	10	45	0	0	45	0	0
3	11325830	rs149310799	C	A	8	12	20	0	2	22	0	0
3	12613866	rs2648307	T	C	29	41	70	0	1	71	0	0
3	12618269	rs2442805	C	T	6	5	11	0	0	11	0	0
3	12620720	rs2454429	G	A	9	8	17	0	0	17	0	0
3	12622943	rs2596825	G	C	12	12	24	0	0	24	0	0
3	12624070	rs15997	C	T	39	45	84	0	0	84	0	0
3	12629886	rs2454436	A	G	4	9	13	0	0	13	0	0
3	12629965	rs2442807	G	C	10	10	20	0	0	20	0	0
3	12633552	rs2442808	T	C	5	2	7	0	1	8	0	0
3	12634518	rs2016492	T	C	4	5	9	0	0	9	0	0
3	12634551	rs1969044	C	T	4	7	11	0	0	11	0	0
3	12645007	rs2596828	C	T	9	5	14	0	0	14	0	0
3	12649857	rs2055311	G	C	5	2	7	0	0	7	0	0
3	12873944	rs56287208	A	G	2	4	6	0	0	6	0	0
3	13357986	rs354476	A	G	91	99	190	0	3	193	0	0
3	13358130	rs1048620	C	T	102	98	200	0	1	201	0	0
3	13358171	rs1048637	T	G	90	85	175	0	0	175	0	0
3	13358204	rs1048650	G	A	94	102	196	0	2	198	0	0
3	13360288	rs93697	T	G	4	4	8	0	0	8	0	0
3	13361238	rs2276748	C	T	1	5	6	0	0	6	0	0
3	13361287	rs354478	C	T	36	46	82	0	2	84	0	0
3	13361391	rs354479	A	G	49	68	117	0	1	118	0	0
3	13364876	rs514084	G	T	42	31	73	0	0	73	0	0
3	13367406	rs665064	C	T	42	33	75	0	0	75	0	0
3	13368892	rs2271509	G	A	36	31	67	0	0	67	0	0
3	13379400	rs3773302	C	T	24	20	44	0	1	45	0	0
3	13383540	rs2271504	A	G	30	28	58	0	0	58	0	0
3	13390629	rs6806012	A	G	3	4	7	0	0	7	0	0
3	13390740	rs6795149	T	G	2	4	6	0	0	6	0	0
3	13395579	rs2280084	C	A	17	16	33	0	1	34	0	0
3	13399786	rs6795271	G	A	29	19	48	0	0	48	0	0
3	13407556	rs3732671	T	C	24	18	42	0	0	42	0	0
3	13421150	rs7628051	C	T	24	18	42	0	0	42	0	0
3	13457610	rs6763216	A	G	4	3	7	0	0	7	0	0
3	13459961	rs7639585	G	A	4	9	13	0	0	13	0	0
3	13679335	rs1061376	C	T	2	5	7	0	0	7	0	0
3	14172827	rs17038942	C	T	3	3	6	0	0	6	0	0
3	14172974	rs3964375	C	T	4	7	11	0	0	11	0	0
3	14174427	rs4685076	A	T	38	36	74	0	1	75	0	0
3	14175262	rs2340917	T	C	40	42	82	0	0	82	0	0
3	14177251	rs3796311	G	A	19	19	38	0	1	39	0	0
3	14179422	rs2731329	A	G	12	8	20	0	0	20	0	0
3	14179453	rs2731328	C	G	10	6	16	0	0	16	0	0
3	14180633	rs2731320	C	T	10	5	15	0	2	17	0	0
3	14183758	rs1043953	A	G	58	65	123	0	1	124	0	0
3	14184074	rs13069	A	C	48	56	104	0	3	107	0	0
3	14184669	rs8516	T	C	33	42	75	0	0	75	0	0
3	14184719	rs10468	T	C	49	40	89	0	1	90	0	0
3	14184744	.	T	C	54	40	94	0	0	94	0	0
3	14186823	rs2470458	T	C	91	100	191	0	0	191	0	0
3	14186830	rs2470352	A	T	87	104	191	0	1	192	0	0
3	14187345	rs2229090	G	C	71	87	158	0	1	160	1	0
3	14187710	rs3731175	T	C	9	14	23	0	0	23	0	0
3	14193889	rs2227998	C	T	41	41	82	0	1	83	0	0
3	14194094	rs3731149	T	G	6	10	16	0	0	16	0	0
3	14194263	rs3731146	A	C	3	13	16	0	0	16	0	0
3	14195682	rs1124303	T	G	9	10	19	0	0	19	0	0
3	14197546	rs3731143	A	G	4	5	9	0	0	9	0	0
3	14199887	rs2228000	G	A	38	29	67	0	0	67	0	0
3	14199908	rs2227999	C	T	36	32	68	0	0	68	0	0
3	14201400	rs3731124	T	G	6	4	10	0	0	10	0	0
3	14203336	rs75616324	A	G	5	4	9	0	0	9	0	0
3	14240545	rs73815317	G	A	5	4	9	0	0	9	0	0
3	14241780	rs150913144	G	A	5	5	10	0	0	10	0	0
3	14242532	rs73815319	T	A	6	7	13	0	0	13	0	0
3	14447973	rs4684216	G	C	5	4	9	0	0	9	0	0
3	14448524	rs6762859	A	G	3	5	8	0	0	8	0	0
3	14509865	rs7642354	A	G	4	2	6	0	0	6	0	0
3	14511840	rs11928756	T	C	8	3	11	0	0	11	0	0
3	14513456	rs55853390	C	T	9	8	17	0	1	18	0	0
3	14513521	rs41284015	G	A	5	5	10	0	1	11	0	0
3	14517006	rs2164575	A	G	7	5	12	0	0	12	0	0
3	14526538	rs1062540	G	A	100	64	164	0	0	164	0	0
3	14709058	rs2280382	G	C	4	2	6	0	0	6	0	0
3	14712473	rs1901	G	A	74	81	155	0	0	155	0	0
3	14713058	rs11717438	G	T	31	33	64	0	1	66	1	0
3	14713121	rs11717411	C	G	29	17	46	0	0	46	0	0
3	14713306	rs11709673	A	G	28	18	46	0	0	46	0	0
3	14713526	rs13081145	G	A	27	27	54	0	6	60	0	0
3	14717160	rs6804489	A	G	4	8	12	0	0	12	0	0
3	14719946	rs7633080	C	T	15	25	40	0	0	40	0	0
3	14972980	rs13084509	G	A	3	7	10	0	0	10	0	0
3	14973320	rs12496281	A	G	7	3	10	0	0	10	0	0
3	14975150	rs115103798	G	A	73	59	132	0	0	132	0	0
3	14988585	rs67890284	A	G	15	10	25	0	0	25	0	0
3	15301363	rs2291853	G	A	24	22	46	0	0	46	0	0
3	15311325	rs1287467	A	G	22	25	47	0	0	48	1	0
3	15433690	rs188073428	C	T	5	2	7	0	0	7	0	0
3	15469001	rs2290536	A	C	3	3	6	0	0	6	0	0
3	15476011	rs1563415	C	G	53	53	106	0	1	107	0	0
3	15612213	rs17485390	T	C	4	6	10	0	0	10	0	0
3	15714390	rs193049441	C	G	5	6	11	0	0	11	0	0
3	15785334	rs151030953	C	T	21	23	44	0	0	44	0	0
3	15836502	rs114533187	G	A	4	2	6	0	0	6	0	0
3	16299968	rs842252	G	A	4	6	10	0	0	10	0	0
3	16301959	rs552	G	A	5	2	7	0	0	7	0	0
3	16327909	rs6777976	C	T	6	6	12	0	0	12	0	0
3	16349298	rs5022485	G	C	4	2	6	0	0	6	0	0
3	16349325	rs2672555	T	C	4	3	7	0	0	7	0	0
3	16351449	rs2247316	G	T	4	2	6	0	1	7	0	0
3	16354096	rs949756	A	G	8	2	10	0	0	10	0	0
3	16355148	rs62233916	A	G	4	9	13	0	0	13	0	0
3	16355689	rs62233917	T	A	6	4	10	0	0	10	0	0
3	16355715	rs62233918	C	T	5	6	11	0	1	12	0	0
3	16355778	rs6795350	A	G	5	12	17	0	0	17	0	0
3	16356466	rs860923	G	A	7	4	11	0	0	11	0	0
3	16357494	rs6900	G	A	44	26	70	0	0	70	0	0
3	16357978	rs842424	T	A	38	38	76	0	0	76	0	0
3	16358902	rs2280247	A	G	2	4	6	0	0	6	0	0
3	16359528	rs9817725	C	T	2	4	6	0	1	7	0	0
3	16360833	rs555948	A	C	3	3	6	0	0	6	0	0
3	16361063	rs11922434	C	G	3	3	6	0	1	7	0	0
3	16361108	rs11922469	C	A	5	4	9	0	1	10	0	0
3	16364954	rs11554130	C	T	26	23	49	0	0	49	0	0
3	16495542	rs4685341	A	G	12	10	22	0	1	23	0	0
3	17200091	rs7610560	T	C	13	9	22	0	0	22	0	0
3	17200512	.	C	T	9	7	16	0	0	16	0	0
3	17202334	rs13078644	A	C	4	6	10	0	0	10	0	0
3	17208267	rs1138454	T	C	5	3	8	0	0	8	0	0
3	18395010	rs9852969	T	C	24	17	41	0	0	41	0	0
3	18396325	rs7432238	T	G	9	11	20	0	0	20	0	0
3	18397849	rs6577641	C	T	6	3	9	0	0	9	0	0
3	18427924	rs2229261	G	T	152	123	275	0	0	275	0	0
3	18436677	.	A	G	3	4	7	0	0	7	0	0
3	18438158	rs9310564	A	G	12	9	21	0	0	21	0	0
3	18452539	rs7641608	T	C	15	34	49	0	0	49	0	0
3	18465822	rs114898672	T	C	10	12	22	0	4	26	0	0
3	18466059	rs73040343	A	G	31	27	58	0	1	59	0	0
3	19988662	rs62241280	A	G	4	2	6	0	0	6	0	0
3	19989504	rs11716116	T	C	6	7	13	0	0	13	0	0
3	19993083	rs59608170	T	C	13	6	19	0	0	19	0	0
3	19993544	rs111602419	G	A	17	23	40	0	1	41	0	0
3	19993703	rs4858662	A	G	15	11	26	0	0	26	0	0
3	19994271	rs9968122	G	A	9	13	22	0	1	23	0	0
3	19994475	rs4858660	G	A	26	23	49	0	1	50	0	0
3	19995611	rs13098043	G	A	32	23	55	0	1	56	0	0
3	19995799	rs13098388	G	A	23	34	57	0	0	57	0	0
3	20006346	rs35713165	G	T	2	4	6	0	0	6	0	0
3	20020154	rs1143451	A	G	4	8	12	0	1	13	0	0
3	20022050	rs11128930	G	A	5	3	8	0	0	8	0	0
3	20022495	rs12488378	G	C	3	3	6	0	0	6	0	0
3	20022595	rs34343204	G	A	6	4	10	0	0	10	0	0
3	20022826	rs4618239	C	T	3	6	9	0	0	9	0	0
3	20023990	rs13085694	A	G	9	6	15	0	0	15	0	0
3	20024269	rs77001658	A	G	8	9	17	0	2	19	0	0
3	20025925	rs45542931	G	A	74	76	150	0	4	154	0	0
3	20027708	rs11128931	A	G	7	5	12	0	0	12	0	0
3	20027769	rs12486526	A	G	3	3	6	0	0	6	0	0
3	20029081	rs34417128	A	G	12	25	37	0	0	37	0	0
3	20029447	rs13078505	C	T	14	16	30	0	0	30	0	0
3	20113830	rs3021408	G	A	11	13	24	0	1	25	0	0
3	20120653	rs62243100	A	G	6	7	13	0	0	13	0	0
3	20190727	rs1061636	G	C	5	1	6	0	0	6	0	0
3	20194255	rs41276509	A	G	4	3	7	0	0	7	0	0
3	20194423	rs4858770	C	T	11	9	20	0	0	20	0	0
3	20211332	rs62241674	A	G	3	6	9	0	0	9	0	0
3	20212189	rs1052930	A	G	10	11	21	0	0	21	0	0
3	20216519	rs61729306	T	A	9	7	16	0	0	16	0	0
3	21462754	rs451242	A	G	5	3	8	0	0	8	0	0
3	21462787	rs427233	G	A	5	4	9	0	0	9	0	0
3	22423338	rs4472062	G	C	26	0	26	0	4	30	0	0
3	23267837	rs7622784	G	A	11	8	19	0	0	19	0	0
3	23268897	rs4858062	G	A	24	18	42	0	0	42	0	0
3	23269006	rs4858063	G	A	13	10	23	0	0	23	0	0
3	23460232	rs1692619	G	A	4	4	8	0	0	8	0	0
3	23460627	rs1908773	G	T	3	4	7	0	0	7	0	0
3	23854643	rs4858090	G	A	4	2	6	0	0	6	0	0
3	23859061	rs6774787	T	C	6	3	9	0	0	9	0	0
3	23903647	rs4858550	T	C	3	3	6	0	0	6	0	0
3	23909393	rs73825124	A	G	2	4	6	0	0	6	0	0
3	23911262	rs4024642	A	C	2	6	8	0	0	8	0	0
3	23917208	rs9845287	T	C	2	4	6	0	0	6	0	0
3	23918616	rs4858094	A	T	5	1	6	0	0	6	0	0
3	23925180	rs4025822	A	G	3	3	6	0	0	6	0	0
3	23925314	rs4546101	A	G	1	5	6	0	0	6	0	0
3	23930271	rs73825178	T	C	16	23	39	0	0	39	0	0
3	23933969	rs8933	C	A	15	13	28	0	0	28	0	0
3	23934115	rs6789983	T	G	10	8	18	0	0	18	0	0
3	23934490	rs1136155	T	C	7	6	13	0	0	13	0	0
3	23935839	rs6778970	C	T	5	2	7	0	0	7	0	0
3	23940519	rs6762238	T	A	5	2	7	0	0	7	0	0
3	23942779	rs554544597	C	T	9	8	17	0	0	17	0	0
3	23942831	rs9836860	A	G	7	5	12	0	0	12	0	0
3	23943599	rs34476593	T	A	7	7	14	0	0	14	0	0
3	23961762	rs1133926	A	G	1027	1037	2064	0	3	2067	0	0
3	23964951	rs9834166	C	T	1	5	6	0	0	6	0	0
3	23987842	rs9862416	A	G	8	2	10	0	0	10	0	0
3	23988002	rs79447376	A	G	9	2	11	0	0	11	0	0
3	23988113	rs62253380	G	C	9	4	13	0	0	13	0	0
3	24218341	rs2596620	T	C	3	3	6	0	0	6	0	0
3	24535853	rs13090120	T	C	1	5	6	0	0	6	0	0
3	25777252	rs145039923	T	C	4	10	14	0	1	15	0	0
3	25787170	rs144164027	C	G	11	3	14	0	0	14	0	0
3	28363241	rs7613767	T	C	5	7	12	0	0	12	0	0
3	30722507	rs3773655	A	G	4	3	7	0	0	7	0	0
3	30733838	rs11466531	C	G	79	87	166	0	0	166	0	0
3	30740628	rs111949158	C	G	9	6	15	0	0	15	0	0
3	31575172	rs73824170	G	C	4	4	8	0	0	8	0	0
3	31644397	rs4569693	G	T	3	5	8	0	1	9	0	0
3	31648706	rs116710900	T	G	4	5	9	0	0	9	0	0
3	31660120	rs76428285	G	C	4	5	9	0	0	9	0	0
3	31661754	rs9859349	G	A	13	10	23	0	1	24	0	0
3	31662173	rs77598274	G	T	19	13	32	0	0	32	0	0
3	31663476	rs80348727	C	T	7	6	13	0	0	13	0	0
3	31672320	rs78787027	G	T	7	5	12	0	0	12	0	0
3	31676147	rs78513627	C	T	17	12	29	0	0	29	0	0
3	31676340	rs9817781	A	G	8	7	15	0	0	15	0	0
3	31678420	rs76851577	A	G	228	237	465	0	2	467	0	0
3	31700883	rs2168419	T	C	2	6	8	0	0	8	0	0
3	31701674	rs76965939	A	G	3	5	8	0	0	8	0	0
3	32523777	rs4796	T	C	229	207	436	0	1	437	0	0
3	32526153	rs367841	C	T	2	4	6	0	0	6	0	0
3	32935126	rs13433809	A	G	3	5	8	0	0	8	0	0
3	32935515	rs62253764	T	C	4	4	8	0	0	8	0	0
3	32937008	rs11927331	C	A	14	5	19	0	0	19	0	0
3	32937596	rs4909017	C	T	7	3	10	0	0	10	0	0
3	33087057	rs11927929	T	C	18	16	34	0	0	34	0	0
3	33088785	rs79337446	C	T	5	1	6	0	0	6	0	0
3	33107645	rs6550204	C	T	3	7	10	0	0	10	0	0
3	33107671	rs9835090	G	T	7	2	9	0	0	9	0	0
3	33109088	rs28488329	C	T	2	6	8	0	0	8	0	0
3	33125248	rs11707667	T	C	6	3	9	0	1	10	0	0
3	33128891	rs62250506	G	A	6	2	8	0	1	9	0	0
3	33132052	rs139306479	T	C	5	7	12	0	0	12	0	0
3	33138549	rs7637099	G	A	24	25	49	0	1	50	0	0
3	33155782	rs11558338	G	A	10	7	17	0	1	18	0	0
3	33161898	rs4076086	C	T	64	73	137	0	2	139	0	0
3	33164827	rs6774417	T	C	9	4	13	0	0	13	0	0
3	33165884	rs147610884	T	C	0	11	11	0	0	11	0	0
3	33174156	rs1135127	T	G	175	138	313	0	5	318	0	0
3	33174168	rs1135128	G	A	176	141	317	0	1	318	0	0
3	33185407	rs4678475	G	A	4	8	12	0	0	12	0	0
3	33186356	rs1127898	T	C	26	35	61	0	0	61	0	0
3	33187425	rs1132392	G	A	11	7	18	0	0	18	0	0
3	33187831	rs4678478	C	T	11	11	22	0	0	22	0	0
3	33429131	rs13060761	C	A	4	5	9	0	1	10	0	0
3	33432307	rs4678951	C	A	5	10	15	0	0	15	0	0
3	33432951	rs13084502	C	T	15	9	24	0	1	25	0	0
3	33433308	rs4678954	A	G	6	8	14	0	0	14	0	0
3	33434831	rs2293250	G	A	64	71	135	0	1	136	0	0
3	33447076	rs12492331	C	T	9	5	14	0	0	14	0	0
3	33449228	rs17030628	C	T	25	20	45	0	0	45	0	0
3	33458266	rs3736563	T	C	78	57	135	0	0	135	0	0
3	33468329	rs9311014	G	T	3	4	7	0	0	7	0	0
3	33478266	rs4678584	G	A	2	6	8	0	0	8	0	0
3	33478872	rs75560660	T	C	5	1	6	0	0	6	0	0
3	33538030	rs10764	A	G	7	6	13	0	0	13	0	0
3	33538041	rs1052812	C	T	7	5	12	0	0	12	0	0
3	33539893	rs13954	A	G	14	11	25	0	0	25	0	0
3	33589227	rs28882196	C	A	9	4	13	0	0	13	0	0
3	33608875	rs6774696	T	C	2	5	7	0	0	7	0	0
3	33652560	rs12497098	G	A	6	0	6	0	0	6	0	0
3	33852812	rs12487081	T	C	3	6	9	0	0	9	0	0
3	33868888	rs1881937	C	T	6	4	10	0	1	11	0	0
3	33868945	rs4258908	C	T	12	6	18	0	1	19	0	0
3	33887008	rs112754416	G	A	115	116	231	0	0	231	0	0
3	33893987	rs9813017	A	G	44	54	98	0	1	99	0	0
3	33905566	rs1127732	C	T	217	164	381	0	1	382	0	0
3	36869439	rs4789	T	C	28	30	58	0	0	58	0	0
3	36869482	.	G	T	27	24	51	0	0	51	0	0
3	36898973	rs17201603	G	A	5	3	8	0	0	8	0	0
3	37030175	rs9311149	C	A	15	19	34	0	0	34	0	0
3	37032296	rs1046512	A	C	28	28	56	0	1	57	0	0
3	37032370	rs3172297	T	C	13	9	22	0	2	24	0	0
3	37053568	rs1799977	A	G	30	37	67	0	1	68	0	0
3	37094679	rs4579	G	A	186	162	348	0	2	350	0	0
3	37095070	rs10849	C	T	198	192	390	0	2	392	0	0
3	37097546	rs2363499	A	G	4	2	6	0	0	6	0	0
3	37106013	rs1468712	T	C	16	8	24	0	0	24	0	0
3	37106115	rs1468713	A	G	17	14	31	0	2	33	0	0
3	37107022	rs7639375	C	A	15	10	25	0	0	25	0	0
3	37107470	rs2302503	G	A	75	78	153	0	0	153	0	0
3	37108896	rs6550448	T	A	58	49	107	0	0	107	0	0
3	37109633	rs56180213	C	A	33	31	64	0	0	64	0	0
3	37111130	rs9823428	G	A	13	29	42	0	0	42	0	0
3	37113405	rs17810211	T	C	16	8	24	0	0	24	0	0
3	37115658	rs1558527	T	C	6	11	17	0	0	17	0	0
3	37116042	rs7651033	C	T	10	9	19	0	0	19	0	0
3	37116386	rs2302504	G	T	4	8	12	0	0	12	0	0
3	37122997	rs6550449	A	G	3	3	6	0	0	6	0	0
3	37157145	rs55755638	C	T	3	4	7	0	0	7	0	0
3	37158798	rs9861967	C	T	2	4	6	0	0	6	0	0
3	37181995	rs6550456	A	G	4	4	8	0	0	8	0	0
3	37182198	rs6550457	T	C	5	4	9	0	1	10	0	0
3	37184473	rs336601	G	A	248	272	520	0	7	527	0	0
3	37185143	rs7640224	A	T	125	123	248	0	1	249	0	0
3	37185960	rs10154916	T	C	89	69	158	0	0	158	0	0
3	37187398	rs4678939	C	T	57	54	111	0	0	111	0	0
3	37187513	rs4678940	G	A	38	45	83	0	1	84	0	0
3	37188318	rs6550458	T	A	8	7	15	0	1	16	0	0
3	37190269	rs138595753	C	T	11	7	18	0	0	18	0	0
3	37210874	rs11920928	T	C	13	10	23	0	0	23	0	0
3	37211128	rs11916897	C	G	9	4	13	0	0	13	0	0
3	37211972	rs931721	T	C	3	3	6	0	0	6	0	0
3	37214204	rs17811658	T	C	12	5	17	0	0	17	0	0
3	37214685	rs4678944	C	T	86	15	101	0	2	103	0	0
3	37217622	rs9829683	C	A	60	41	101	0	1	102	0	0
3	37284427	rs4678952	T	G	5	5	10	0	0	10	0	0
3	37290210	rs17206856	G	A	3	3	6	0	0	6	0	0
3	37308532	rs1040073	C	T	3	5	8	0	0	8	0	0
3	37315873	rs6805305	G	C	5	6	11	0	1	12	0	0
3	37317043	rs3733028	T	C	7	4	11	0	0	11	0	0
3	37366459	rs11718848	C	A	18	15	33	0	0	33	0	0
3	37368755	rs62241896	T	A	30	34	64	0	0	64	0	0
3	37523079	rs17227748	G	A	24	21	45	0	0	45	0	0
3	37829174	rs2685108	A	T	5	10	15	0	0	15	0	0
3	37829791	rs9875428	T	G	7	10	17	0	0	17	0	0
3	37829959	rs7609597	A	G	4	6	10	0	2	12	0	0
3	37830119	rs2507947	T	A	9	11	20	0	0	20	0	0
3	37858410	rs6780036	G	A	8	3	11	0	1	12	0	0
3	37858496	rs13062108	A	T	7	0	7	0	0	7	0	0
3	37858771	rs6782856	G	A	5	6	11	0	0	11	0	0
3	37860688	rs35239140	G	A	50	91	141	0	0	141	0	0
3	37861860	rs57751214	A	G	3	8	11	0	0	11	0	0
3	37861996	rs35309407	C	T	3	11	14	0	0	14	0	0
3	37862450	rs78314022	C	T	5	16	21	0	0	21	0	0
3	37862718	rs6796546	C	T	6	10	16	0	0	16	0	0
3	37863134	rs2844420	G	A	10	7	17	0	0	17	0	0
3	37864504	rs3755834	A	G	7	14	21	0	0	21	0	0
3	38048559	rs141520866	T	G	22	18	40	0	1	41	0	0
3	38493212	rs3792527	T	C	1	5	6	0	0	6	0	0
3	38493303	rs3792528	T	C	2	4	6	0	0	6	0	0
3	38532511	rs1058945	G	A	3	7	10	0	0	10	0	0
3	38566235	rs1073506	G	T	12	12	24	0	0	24	0	0
3	38566480	rs1065800	G	A	18	29	47	0	0	47	0	0
3	38566519	rs1132064	T	C	11	23	34	0	0	34	0	0
3	38566722	rs1073505	T	C	6	7	13	0	0	13	0	0
3	39107993	rs10510698	T	G	5	3	8	0	0	8	0	0
3	39108503	rs7624734	G	A	8	2	10	0	0	10	0	0
3	39111140	rs2293312	C	A	85	106	191	0	2	193	0	0
3	39122997	rs192041212	T	C	9	7	16	0	1	17	0	0
3	39124132	rs12636980	A	G	12	6	18	0	0	18	0	0
3	39125293	rs2056613	G	T	19	16	35	0	1	36	0	0
3	39128458	rs115421667	G	A	18	12	30	0	0	30	0	0
3	39128610	rs77465675	G	C	21	14	35	0	0	35	0	0
3	39137883	rs1053516	G	A	219	243	462	0	8	470	0	0
3	39138082	rs1053530	C	T	281	228	509	0	3	512	0	0
3	39139339	rs114555929	G	A	63	47	110	0	0	110	0	0
3	39142624	rs41285138	G	A	6	7	13	0	0	13	0	0
3	39187597	rs784516	G	A	10	6	16	0	1	17	0	0
3	39187858	rs13084317	G	A	4	2	6	0	0	6	0	0
3	39188351	rs1105163	C	T	3	5	8	0	0	8	0	0
3	39188843	rs885067	A	G	2	7	9	0	0	9	0	0
3	39191043	rs1274962	T	C	3	4	7	0	0	7	0	0
3	39192542	rs1274960	T	C	1	6	7	0	0	7	0	0
3	39435879	.	T	C	7	9	16	0	0	16	0	0
3	40351484	rs11709089	C	T	15	7	22	0	0	22	0	0
3	40352051	rs9826419	G	A	10	8	18	0	0	18	0	0
3	40352134	rs3214006	C	T	6	6	12	0	0	12	0	0
3	40352647	rs1454491	C	G	5	6	11	0	0	11	0	0
3	40352884	rs1454492	C	T	12	0	12	0	0	12	0	0
3	40488280	rs1123019	C	T	3	6	9	0	0	9	0	0
3	40488713	rs2371186	G	C	4	2	6	0	0	6	0	0
3	40493218	rs6801859	G	T	6	0	6	0	0	6	0	0
3	40498845	rs2276868	C	T	392	232	624	0	1	625	0	0
3	40499182	rs2276870	C	T	53	21	74	0	0	74	0	0
3	40499273	rs2276871	A	G	13	10	23	0	0	23	0	0
3	40503298	rs11707190	A	G	3	3	6	0	0	6	0	0
3	40503809	rs11539046	G	A	166	115	281	0	2	283	0	0
3	40531123	rs66841330	G	A	4	11	15	0	0	15	0	0
3	40531136	rs6762251	G	A	3	10	13	0	0	13	0	0
3	40531533	rs6599105	T	C	13	22	35	0	0	35	0	0
3	40559078	rs4973907	G	C	13	6	19	0	0	19	0	0
3	40576061	rs3924444	T	C	2	7	9	0	0	9	0	0
3	40579357	rs4602359	A	G	7	9	16	0	1	17	0	0
3	41264622	rs190815111	C	T	6	6	12	0	0	12	0	0
3	41278564	rs184260900	T	C	8	6	14	0	0	14	0	0
3	41279440	rs4135385	A	G	6	6	12	0	0	12	0	0
3	41756965	rs61744388	C	T	4	14	18	0	0	18	0	0
3	41756986	rs61744385	A	T	3	13	16	0	0	16	0	0
3	41831203	rs17215589	C	T	15	9	24	0	0	24	0	0
3	41841716	rs4973986	A	C	6	14	20	0	0	20	0	0
3	41845226	rs112532924	T	C	4	4	8	0	0	8	0	0
3	41845547	rs6793567	T	A	10	8	18	0	0	18	0	0
3	41845554	rs139635297	C	T	8	8	16	0	0	16	0	0
3	41845597	rs78863838	C	G	4	2	6	0	0	6	0	0
3	41847979	rs143787364	A	G	2	6	8	0	0	8	0	0
3	41877414	rs3774372	T	C	6	19	25	0	0	25	0	0
3	41925398	rs1052501	C	T	31	22	53	0	1	54	0	0
3	41952852	rs35263917	T	C	13	22	35	0	0	35	0	0
3	41960006	rs1716975	T	C	8	13	21	0	0	21	0	0
3	41977464	rs73071203	A	C	5	16	21	0	1	22	0	0
3	41978738	rs73071208	A	T	23	72	95	0	0	95	0	0
3	41996136	rs2272007	T	C	57	30	87	0	3	90	0	0
3	42002761	rs55916855	A	G	4	4	8	0	0	8	0	0
3	42003369	rs73071261	C	A	3	4	7	0	0	7	0	0
3	42085743	rs9836286	G	C	8	4	12	0	0	12	0	0
3	42103045	rs11921457	T	G	6	1	7	0	0	7	0	0
3	42104479	rs59983764	T	C	4	4	8	0	0	8	0	0
3	42104682	rs75851484	T	C	4	2	6	0	0	6	0	0
3	42105675	rs4974016	A	G	6	7	13	0	0	13	0	0
3	42144062	rs4974009	C	G	5	1	6	0	0	6	0	0
3	42144151	rs149252134	A	C	5	2	7	0	0	7	0	0
3	42145946	rs113712414	C	T	2	4	6	0	0	6	0	0
3	42146214	rs137956813	A	G	6	5	11	0	0	11	0	0
3	42146269	rs13322778	T	C	6	6	12	0	0	12	0	0
3	42167092	.	C	T	34	20	54	0	2	56	0	0
3	42236415	rs9851455	A	G	56	36	92	0	1	93	0	0
3	42244622	rs9311310	A	G	5	3	8	0	0	8	0	0
3	42245155	rs73831718	C	T	9	4	13	0	0	13	0	0
3	42251263	rs2290134	C	T	50	37	87	0	0	87	0	0
3	42252141	rs3196165	A	G	39	33	72	0	2	74	0	0
3	42252924	rs7372751	G	C	34	21	55	0	1	56	0	0
3	42253346	rs60260632	C	T	85	71	156	0	1	157	0	0
3	42253733	rs9747	T	C	116	70	186	0	0	186	0	0
3	42257513	rs1868527	A	G	2	5	7	0	0	7	0	0
3	42258997	rs9820074	T	C	4	4	8	0	0	8	0	0
3	42259299	rs11928109	G	A	3	3	6	0	1	7	0	0
3	42259650	rs9842527	A	G	11	8	19	0	0	19	0	0
3	42260475	rs9810409	G	A	5	8	13	0	0	13	0	0
3	42260530	rs729822	T	G	5	6	11	0	0	11	0	0
3	42265166	rs12487911	T	C	22	13	35	0	0	35	0	0
3	42266346	rs1043621	A	G	77	73	150	0	2	152	0	0
3	42578579	rs14380	A	T	0	7	7	0	0	7	0	0
3	42591446	rs237064	A	G	64	61	125	0	2	127	0	0
3	42591956	rs342534	G	A	48	49	97	0	0	97	0	0
3	42592138	rs342535	G	A	71	67	138	0	0	138	0	0
3	42592319	rs342536	T	C	34	40	74	0	6	80	0	0
3	42592874	rs342537	T	C	45	39	84	0	2	86	0	0
3	42592902	rs342538	T	C	49	49	98	0	0	98	0	0
3	42594019	rs663258	C	T	21	20	41	0	1	42	0	0
3	42599091	rs2271184	G	A	81	82	163	0	2	165	0	0
3	42605402	rs9311324	A	C	46	26	72	0	0	72	0	0
3	42610374	rs2271186	A	G	46	46	92	0	1	93	0	0
3	42610515	rs2271187	G	A	45	50	95	0	0	95	0	0
3	42636141	rs4549	G	A	150	105	255	0	2	257	0	0
3	42644781	rs638904	G	T	3	3	6	0	0	6	0	0
3	42668441	rs168138	A	G	5	1	6	0	0	6	0	0
3	42670449	rs339733	A	G	28	20	48	0	0	48	0	0
3	42689777	rs8351	T	G	524	440	964	0	7	979	8	0
3	43399709	rs116652041	C	A	1	5	6	0	0	6	0	0
3	43761387	.	G	C	13	12	25	0	0	25	0	0
3	43761441	rs3733156	A	G	13	11	24	0	0	24	0	0
3	43770323	rs3733155	C	T	5	1	6	0	0	6	0	0
3	43775630	rs73089215	A	G	61	25	86	0	1	87	0	0
3	44386398	rs73090412	A	G	9	8	17	0	0	17	0	0
3	44401255	rs13575	C	T	3	5	8	0	0	8	0	0
3	44483206	rs2886	A	T	16	14	30	0	0	30	0	0
3	44485227	rs6790563	A	G	9	4	13	0	0	13	0	0
3	44485822	rs2372688	C	T	8	3	11	0	0	11	0	0
3	44485914	rs4610267	T	C	12	10	22	0	0	22	0	0
3	44510906	rs4431151	G	C	1	6	7	0	0	7	0	0
3	44612895	rs2034476	C	G	3	3	6	0	0	6	0	0
3	44637799	rs77557455	T	C	6	3	9	0	0	9	0	0
3	44639929	rs12715402	T	C	4	5	9	0	0	9	0	0
3	44640492	rs9867464	G	A	6	13	19	0	0	19	0	0
3	44665285	rs1551063	C	T	6	1	7	0	0	7	0	0
3	44666606	rs13100959	G	C	15	18	33	0	1	34	0	0
3	44667455	rs13321717	C	A	3	3	6	0	0	6	0	0
3	44686006	rs9865272	G	T	22	16	38	0	0	38	0	0
3	44686087	rs9865162	C	T	9	21	30	0	3	33	0	0
3	44701738	rs1402753	A	G	30	27	57	0	0	57	0	0
3	44762830	rs56084453	A	G	1	7	8	0	0	8	0	0
3	44763037	rs7640654	A	C	5	6	11	0	0	11	0	0
3	44775962	rs4682752	A	G	5	6	11	0	0	11	0	0
3	44791200	rs6792299	T	A	11	5	16	0	0	16	0	0
3	44796049	rs3749199	G	C	7	2	9	0	0	9	0	0
3	44796132	rs9311361	T	G	5	5	10	0	0	10	0	0
3	44884647	rs3804583	C	A	26	27	53	0	0	53	0	0
3	44902844	rs62242563	G	T	5	2	7	0	0	7	0	0
3	44902845	rs62242564	C	A	5	2	7	0	0	7	0	0
3	44906746	rs10429	A	G	19	25	44	0	0	44	0	0
3	44955530	rs1007	G	T	11	5	16	0	0	16	0	0
3	44956860	rs6622	C	T	31	31	62	0	2	64	0	0
3	44958773	rs7644978	T	C	6	15	21	0	0	21	0	0
3	44960561	rs6789458	T	C	4	4	8	0	1	9	0	0
3	44963967	rs2372849	T	C	5	2	7	0	0	7	0	0
3	44966906	rs15205	A	T	161	147	308	0	8	316	0	0
3	44973680	rs62242619	G	T	3	3	6	0	0	6	0	0
3	45016919	rs17632716	C	T	15	10	25	0	0	25	0	0
3	45043993	rs6764088	A	G	3	4	7	0	0	7	0	0
3	45044878	rs4683021	A	G	8	9	17	0	0	17	0	0
3	45051827	rs7619704	A	C	4	6	10	0	0	10	0	0
3	45052775	rs6794	G	C	152	129	281	0	3	284	0	0
3	45430151	rs28413188	G	A	3	4	7	0	0	7	0	0
3	45557707	rs11549809	G	A	6	3	9	0	0	9	0	0
3	45716209	rs2068430	G	A	5	4	9	0	0	9	0	0
3	45719209	rs2247771	T	C	23	24	47	0	0	47	0	0
3	45719561	rs3796361	G	A	14	3	17	0	0	17	0	0
3	45749183	rs73058466	G	A	23	8	31	0	0	31	0	0
3	45781655	rs116650026	G	A	3	3	6	0	0	6	0	0
3	45866357	.	G	T	16	8	24	0	1	25	0	0
3	45959515	rs7130	A	T	23	17	40	0	0	40	0	0
3	45959759	rs7129	T	C	29	12	41	0	1	42	0	0
3	45960079	rs1047444	C	A	37	22	59	0	2	61	0	0
3	45961842	rs1488374	C	T	11	17	28	0	0	28	0	0
3	45962595	rs3733103	C	G	16	17	33	0	0	34	1	0
3	45962752	rs7652331	T	C	13	13	26	0	0	26	0	0
3	45962802	rs6441934	T	C	11	8	19	0	0	19	0	0
3	45962942	rs2291470	C	T	9	10	19	0	0	19	0	0
3	45996761	rs1463680	G	A	15	19	34	0	0	34	0	0
3	46008790	rs3796375	G	A	6	8	14	0	0	14	0	0
3	46009864	rs3733100	C	G	9	5	14	0	1	15	0	0
3	46010077	rs4683158	C	T	8	7	15	0	0	15	0	0
3	46016851	rs751552	A	T	4	2	6	0	0	6	0	0
3	46021218	rs4682801	G	T	8	4	12	0	0	12	0	0
3	46449978	rs11266744	A	C	19	19	38	0	0	38	0	0
3	46450070	rs3204849	T	A	35	40	75	0	0	75	0	0
3	46480801	rs9110	A	G	527	1616	2143	0	12	2155	0	0
3	46480958	rs2073495	C	G	1266	377	1643	0	10	1653	0	0
3	46484964	rs1042073	G	A	360	1216	1576	0	13	1591	2	0
3	46487937	rs61739313	C	T	1026	283	1309	0	10	1319	0	0
3	46501213	rs1126478	T	C	151	438	589	0	7	596	0	0
3	46501268	rs1126477	C	T	137	361	498	0	3	501	0	0
3	46711300	rs3747520	C	T	10	17	27	0	0	27	0	0
3	46713120	rs115360749	G	A	5	4	9	0	0	9	0	0
3	46713351	rs79199647	C	A	6	2	8	0	0	8	0	0
3	46721988	.	C	T	3	5	8	0	0	8	0	0
3	46963502	rs4587	T	C	342	377	719	0	3	722	0	0
3	46965197	rs2290546	C	G	3	9	12	0	0	12	0	0
3	46982737	rs4682844	T	C	5	3	8	0	0	8	0	0
3	46982773	rs4682842	C	G	3	3	6	0	0	6	0	0
3	46983288	rs55786350	G	A	54	65	119	0	2	121	0	0
3	46989828	rs7640397	C	T	5	3	8	0	0	8	0	0
3	46989904	rs12491473	G	A	5	4	9	0	0	9	0	0
3	46991241	rs6774733	G	A	3	4	7	0	0	7	0	0
3	47031433	rs10433549	C	T	5	5	10	0	0	10	0	0
3	47036756	rs11720139	C	G	44	58	102	0	1	103	0	0
3	47043538	rs2305634	C	T	117	84	201	0	5	206	0	0
3	47043622	rs2305635	G	A	96	120	216	0	3	219	0	0
3	47045739	rs1079276	C	G	309	246	555	0	4	560	1	0
3	47045846	rs2305637	C	T	215	205	420	0	4	424	0	0
3	47046842	rs2305638	G	C	3	6	9	0	0	9	0	0
3	47048452	rs56217494	T	G	65	87	152	0	2	154	0	0
3	47059323	rs2385867	C	T	5	2	7	0	0	7	0	0
3	47097985	rs62246406	G	A	6	3	9	0	0	9	0	0
3	47125385	rs4082155	G	A	116	93	209	0	0	209	0	0
3	47162661	rs6767907	A	G	60	60	120	0	2	122	0	0
3	47234419	rs6773521	A	G	5	1	6	0	0	6	0	0
3	47282303	rs2276853	G	A	7	3	10	0	0	10	0	0
3	47385585	rs295458	C	A	13	14	27	0	0	27	0	0
3	47452118	rs6780013	G	A	26	23	49	0	0	49	0	0
3	47452786	rs1531875	G	A	25	25	50	0	3	53	0	0
3	47459679	rs12487736	C	T	24	23	47	0	0	47	0	0
3	47464122	rs1038394	A	G	4	3	7	0	0	7	0	0
3	47555142	rs2291298	C	A	7	10	17	0	0	17	0	0
3	47628490	.	C	T	165	154	319	0	5	324	0	0
3	47712202	rs1141601	T	C	77	71	148	0	2	150	0	0
3	48299439	rs6787500	T	C	4	6	10	0	0	10	0	0
3	48309828	rs11718329	C	G	4	2	6	0	0	6	0	0
3	48312060	rs6442111	G	C	12	15	27	0	0	27	0	0
3	48312229	rs1045482	A	G	14	17	31	0	0	31	0	0
3	48312402	rs3937	T	C	6	16	22	0	0	22	0	0
3	48335808	rs1134867	T	C	16	5	21	0	1	22	0	0
3	48335857	rs3197223	C	T	13	5	18	0	0	18	0	0
3	48482506	rs7639743	G	A	8	8	16	0	0	16	0	0
3	48483432	rs9849509	A	G	8	4	12	0	2	14	0	0
3	48483445	rs60512868	T	G	6	10	16	0	0	16	0	0
3	48483682	rs2362441	G	A	7	10	17	0	2	19	0	0
3	48484016	rs4858820	A	T	5	5	10	0	0	10	0	0
3	48484021	rs35215722	G	C	5	6	11	0	0	11	0	0
3	48484560	rs7636044	A	G	2	12	14	0	0	14	0	0
3	48484683	rs4490383	T	C	14	4	18	0	1	19	0	0
3	48484890	rs13324374	C	T	11	5	16	0	1	17	0	0
3	48485493	rs7126	A	G	243	167	410	0	1	411	0	0
3	48489398	rs922075	A	G	4	8	12	0	0	12	0	0
3	48490608	rs1824363	C	G	4	3	7	0	0	7	0	0
3	48490841	.	A	G	4	2	6	0	2	8	0	0
3	48508585	rs11797	C	T	87	80	167	0	1	168	0	0
3	48556339	rs2267846	G	A	25	23	48	0	0	48	0	0
3	48659009	rs9834639	G	T	2	4	6	0	0	6	0	0
3	48666923	rs2276852	A	G	3	4	7	0	0	7	0	0
3	48668394	rs3821876	G	T	5	5	10	0	0	10	0	0
3	48669447	rs13324142	C	T	10	13	23	0	0	23	0	0
3	48669648	rs2276850	G	A	6	11	17	0	0	17	0	0
3	48675064	rs6773261	A	G	25	6	31	0	0	31	0	0
3	48677895	rs1264195	A	T	1	10	11	0	0	11	0	0
3	48681053	rs9868809	C	T	12	2	14	0	0	14	0	0
3	48690110	rs2302295	T	C	5	2	7	0	0	7	0	0
3	48691316	rs12107252	T	C	6	3	9	0	0	9	0	0
3	48725707	rs1048940	C	T	288	285	573	0	21	594	0	0
3	48727112	rs4858798	G	A	289	249	538	0	2	540	0	0
3	48729460	rs111881466	T	C	3	6	9	0	0	9	0	0
3	48730116	rs12493578	T	C	10	7	17	0	0	17	0	0
3	48732223	rs11557629	G	A	13	14	27	0	0	27	0	0
3	48732480	rs17080319	T	C	5	6	11	0	0	11	0	0
3	48733507	rs9854034	C	T	13	12	25	0	0	25	0	0
3	48735558	rs4858831	C	T	10	16	26	0	0	26	0	0
3	48735706	rs11719291	A	G	8	8	16	0	0	16	0	0
3	48736216	rs28657585	A	T	5	14	19	0	1	20	0	0
3	48787219	rs6791542	A	G	25	31	56	0	0	56	0	0
3	48888121	rs9830636	A	C	2	5	7	0	0	7	0	0
3	48964108	rs34509487	C	T	18	12	30	0	0	30	0	0
3	48969036	rs11717978	T	A	2	4	6	0	0	6	0	0
3	48972892	rs1134591	G	A	91	49	140	0	1	141	0	0
3	48974385	rs11719457	C	T	13	20	33	0	0	33	0	0
3	49009386	rs4974078	C	T	4	2	6	0	0	6	0	0
3	49017208	rs11716614	C	G	4	2	6	0	0	6	0	0
3	49030828	rs4974080	A	C	3	3	6	0	0	6	0	0
3	49044767	rs6781790	C	T	2	6	8	0	0	8	0	0
3	49046753	.	C	A	2	4	6	0	3	9	0	0
3	49052785	rs8926	T	A	318	252	570	0	20	590	0	0
3	49064110	rs11706052	A	G	22	15	37	0	1	38	0	0
3	49067904	rs61729488	T	C	416	311	727	0	3	730	0	0
3	49134429	rs34326553	A	G	9	4	13	0	2	15	0	0
3	49134914	rs62262517	T	G	4	2	6	0	0	6	0	0
3	49135961	rs13064784	C	G	41	88	129	0	0	129	0	0
3	49141116	rs5030795	G	A	231	202	433	0	3	436	0	0
3	49145741	rs3212	T	C	70	72	142	0	0	142	0	0
3	49149850	.	C	T	35	16	51	0	2	53	0	0
3	49156473	rs11552724	C	G	24	26	50	0	0	50	0	0
3	49156676	rs4279134	A	G	28	24	52	0	0	52	0	0
3	49158763	rs74951356	C	T	68	87	155	0	2	157	0	0
3	49196132	rs12490393	C	T	4	3	7	0	0	7	0	0
3	49198091	.	T	C	7	0	7	0	0	7	0	0
3	49200137	rs1134043	G	T	28	34	62	0	1	63	0	0
3	49200627	rs4955418	A	G	35	34	69	0	0	69	0	0
3	49200692	rs4955419	T	A	22	27	49	0	1	50	0	0
3	49209057	rs34571182	T	A	5	8	13	0	0	13	0	0
3	49209058	rs13096406	C	A	5	8	13	0	1	14	0	0
3	49211989	rs10865954	T	C	7	11	18	0	0	18	0	0
3	49213030	rs11713297	T	C	17	32	49	0	0	49	0	0
3	49275964	rs11920267	G	A	4	3	7	0	0	7	0	0
3	49313978	rs13077498	C	T	33	26	59	0	0	59	0	0
3	49314452	rs181392167	C	T	6	7	13	0	0	13	0	0
3	49314960	rs56306491	G	A	24	14	38	0	0	38	0	0
3	49318265	rs17595410	G	A	122	96	218	0	1	219	0	0
3	49331060	rs9883409	T	C	16	39	55	0	0	55	0	0
3	49336232	rs11720964	T	C	8	0	8	0	0	8	0	0
3	49343175	rs2230929	G	A	62	53	115	0	0	115	0	0
3	49356577	rs73086105	A	G	8	2	10	0	1	11	0	0
3	49356671	rs11920251	C	T	7	1	8	0	1	9	0	0
3	49358646	rs34915642	G	A	8	5	13	0	0	13	0	0
3	49359102	rs35869135	A	G	4	3	7	0	0	7	0	0
3	49359943	rs9873994	T	C	7	6	13	0	0	13	0	0
3	49361791	rs13078949	A	G	3	8	11	0	0	11	0	0
3	49362369	rs56038006	C	T	41	36	77	0	2	79	0	0
3	49394834	rs1050450	G	A	999	1611	2610	0	17	2627	0	0
3	49395757	rs1800668	G	A	6	3	9	0	0	9	0	0
3	49398515	rs562262396	A	C	35	19	54	0	3	57	0	0
3	49399259	rs1987628	G	A	25	25	50	0	0	50	0	0
3	49405164	rs67485053	A	G	1	5	6	0	0	6	0	0
3	49406080	rs2878298	T	C	13	2	15	0	0	15	0	0
3	49406095	rs11716445	G	A	1	11	12	0	1	13	0	0
3	49407229	rs7373849	G	A	2	5	7	0	0	7	0	0
3	49407660	rs34588335	G	C	6	7	13	0	0	13	0	0
3	49409704	rs17595772	G	A	5	6	11	0	0	11	0	0
3	49453834	rs6997	C	T	46	34	80	0	0	80	0	0
3	49454277	rs10640	G	A	13	10	23	0	0	23	0	0
3	49455330	rs11715915	C	T	13	26	39	0	0	39	0	0
3	49459114	rs4855873	A	C	8	6	14	0	0	14	0	0
3	49459252	rs1464567	C	G	4	7	11	0	0	11	0	0
3	49459376	rs1464566	T	C	5	9	14	0	0	14	0	0
3	49507847	rs4855839	G	A	4	6	10	0	0	10	0	0
3	49570200	rs1801143	C	T	28	21	49	0	1	50	0	0
3	49570882	rs1050088	T	C	25	21	46	0	2	48	0	0
3	49572140	rs4625	A	G	41	39	80	0	0	80	0	0
3	49714225	rs1131095	T	C	34	32	66	0	1	67	0	0
3	49719729	rs9822268	G	A	3	3	6	0	0	6	0	0
3	49721532	rs3197999	G	A	17	26	43	0	0	43	0	0
3	49721798	rs13085791	C	A	23	36	59	0	2	61	0	0
3	49722356	.	G	A	7	5	12	0	0	12	0	0
3	49723784	.	C	A	4	4	8	0	0	8	0	0
3	49738945	rs6804655	C	T	10	8	18	0	1	19	0	0
3	49743010	rs76989089	C	G	19	13	32	0	0	32	0	0
3	49749976	rs34823813	G	A	25	20	45	0	0	45	0	0
3	49750188	rs3749240	T	A	5	11	16	0	0	16	0	0
3	49751585	rs2291542	C	T	29	16	45	0	1	46	0	0
3	49758764	rs4768	A	G	58	70	128	0	3	131	0	0
3	49762662	rs7634902	G	T	151	155	306	0	0	306	0	0
3	49763338	rs1049256	T	C	171	152	323	0	2	325	0	0
3	49765483	rs2307021	C	G	8	14	22	0	0	22	0	0
3	49767027	rs140342176	C	T	5	2	7	0	0	7	0	0
3	49770032	rs3749237	G	A	5	2	7	0	0	7	0	0
3	49784777	rs7374277	T	C	9	6	15	0	0	15	0	0
3	49785133	rs7374183	G	A	6	7	13	0	0	13	0	0
3	49792158	rs9855505	T	G	4	4	8	0	0	8	0	0
3	49840843	rs115355405	T	C	51	42	93	0	0	93	0	0
3	49843723	rs3819325	T	C	10	7	17	0	1	19	1	0
3	49847623	rs1799845	A	G	26	32	58	0	1	59	0	0
3	49849723	rs1799843	G	A	16	12	28	0	0	28	0	0
3	49866392	rs1128535	C	T	17	25	42	0	1	43	0	0
3	50005017	rs17598830	T	C	30	33	63	0	1	64	0	0
3	50078221	rs7430334	T	C	4	5	9	0	0	9	0	0
3	50097319	rs2245365	C	A	25	27	52	0	1	53	0	0
3	50098112	rs2624815	A	G	13	16	29	0	0	29	0	0
3	50103917	rs2023953	G	A	243	261	504	0	3	507	0	0
3	50105938	.	C	A	0	6	6	0	0	6	0	0
3	50109073	rs9856572	A	T	3	7	10	0	0	10	0	0
3	50114515	rs7061	C	T	233	174	407	0	2	409	0	0
3	50136165	rs6808044	A	G	6	4	10	0	1	11	0	0
3	50136463	rs13095697	G	A	6	4	10	0	0	10	0	0
3	50139142	rs2856234	A	G	18	21	39	0	0	39	0	0
3	50144951	rs1061474	T	C	116	97	213	0	0	213	0	0
3	50148305	rs2301166	C	G	10	16	26	0	0	26	0	0
3	50153356	rs1138536	T	C	330	340	670	0	0	670	0	0
3	50154989	rs2624825	G	A	72	54	126	0	2	128	0	0
3	50155468	rs2624826	T	G	135	139	274	0	4	278	0	0
3	50187790	rs2526397	G	T	4	2	6	0	0	6	0	0
3	50197097	rs1046953	C	T	7	2	9	0	0	9	0	0
3	50222926	rs1046956	T	A	8	8	16	0	1	17	0	0
3	50226151	rs14321	T	C	28	39	67	0	1	68	0	0
3	50286953	rs2298952	G	A	9	6	15	0	0	15	0	0
3	50288541	.	C	T	6	5	11	0	0	11	0	0
3	50326883	rs78165652	A	G	19	15	34	0	1	35	0	0
3	50362371	rs11549673	G	A	7	4	11	0	0	11	0	0
3	50378802	rs78166579	C	T	17	23	40	0	0	40	0	0
3	50387873	rs73082914	C	T	30	18	48	0	0	48	0	0
3	50388087	rs41291730	A	C	36	42	78	0	1	79	0	0
3	51738101	rs2518461	G	A	51	79	130	0	3	133	0	0
3	52237970	rs352168	C	T	150	169	319	0	0	319	0	0
3	52238656	rs352167	T	C	3	4	7	0	0	7	0	0
3	52238677	rs352166	C	T	3	5	8	0	0	8	0	0
3	52241164	rs11716756	C	T	2	7	9	0	0	9	0	0
3	52242902	rs352165	A	G	8	8	16	0	1	17	0	0
3	52244051	rs11712164	A	T	8	5	13	0	1	14	0	0
3	52247110	rs352163	G	A	6	7	13	0	0	13	0	0
3	52247314	rs164640	C	T	6	3	9	0	0	9	0	0
3	52264907	rs352143	T	C	114	109	223	0	1	224	0	0
3	52291078	rs57823393	G	A	147	164	311	0	4	315	0	0
3	52394055	rs61734638	G	A	7	7	14	0	0	14	0	0
3	52407630	.	A	G	19	14	33	0	1	34	0	0
3	52430526	rs12163565	G	A	18	39	57	0	1	58	0	0
3	52507782	rs56114678	G	A	29	39	68	0	1	69	0	0
3	52540773	rs1010553	T	C	3	3	6	0	0	6	0	0
3	52555957	rs9853056	T	C	16	9	25	0	0	25	0	0
3	52556890	rs4434138	A	G	18	19	37	0	0	37	0	0
3	52558008	rs13303	T	C	20	29	49	0	1	50	0	0
3	52558133	rs13621	T	C	34	32	66	0	0	66	0	0
3	52566422	.	G	A	3	17	20	0	1	21	0	0
3	52566682	rs7636227	G	A	11	1	12	0	0	12	0	0
3	52566820	rs12489732	C	A	12	3	15	0	0	15	0	0
3	52566914	rs7614981	C	A	9	4	13	0	0	13	0	0
3	52567014	rs12489828	G	T	5	5	10	0	0	10	0	0
3	52581435	rs3199918	T	C	18	21	39	0	1	40	0	0
3	52584787	rs2251219	T	C	16	14	30	0	0	30	0	0
3	52610651	rs17264436	T	A	17	15	32	0	0	32	0	0
3	52619792	rs12629699	T	C	10	10	20	0	0	20	0	0
3	52619836	rs12629701	T	C	10	5	15	0	0	15	0	0
3	52619962	rs12637627	G	T	12	12	24	0	0	24	0	0
3	52626646	rs2336146	A	G	4	4	8	0	0	8	0	0
3	52632357	rs62253703	T	C	10	7	17	0	0	17	0	0
3	52632911	rs6790330	G	A	7	2	9	0	0	9	0	0
3	52641255	rs3774366	T	C	3	3	6	0	0	6	0	0
3	52643307	rs3733045	A	G	19	11	30	0	1	31	0	0
3	52643685	rs3755806	T	C	47	30	77	0	1	78	0	0
3	52719816	rs10933	C	T	2	4	6	0	0	6	0	0
3	52720080	rs1108842	A	C	22	23	45	0	0	45	0	0
3	52721305	rs11177	G	A	47	47	94	0	1	95	0	0
3	52726695	rs6762813	C	T	6	3	9	0	0	9	0	0
3	52727257	rs2289247	G	A	99	87	186	0	1	187	0	0
3	52728804	rs6976	C	T	42	23	65	0	0	65	0	0
3	52739520	rs8906	T	C	8	3	11	0	0	11	0	0
3	52740182	rs6617	C	G	86	81	167	0	5	172	0	0
3	52741160	rs3755798	G	A	3	3	6	0	0	6	0	0
3	52759169	rs34610878	G	C	7	1	8	0	0	8	0	0
3	52762420	.	A	C	1	5	6	0	0	6	0	0
3	52765882	rs11714030	C	T	3	4	7	0	0	7	0	0
3	52797634	rs1029871	G	C	7	11	18	0	0	18	0	0
3	52800284	rs2230535	T	C	11	11	22	0	0	22	0	0
3	52802402	rs2230534	A	C	2	8	10	0	0	10	0	0
3	52870324	rs4687662	T	C	12	11	23	0	1	24	0	0
3	53119534	rs2253675	T	C	2	4	6	0	0	6	0	0
3	53122969	rs2082093	G	A	6	7	13	0	0	13	0	0
3	53123032	rs2099162	C	T	11	9	20	0	0	20	0	0
3	53123273	rs891368	A	G	11	8	19	0	0	19	0	0
3	53123486	rs1078968	G	A	4	7	11	0	0	11	0	0
3	53125429	rs62255926	A	T	8	4	12	0	0	12	0	0
3	53125469	rs2564922	G	A	6	6	12	0	0	12	0	0
3	53125585	rs2564921	T	C	3	4	7	0	0	7	0	0
3	53125922	rs11242	T	C	25	25	50	0	1	51	0	0
3	53226061	rs62254318	C	T	7	11	18	0	0	18	0	0
3	53897168	rs1134091	A	C	4	2	6	0	0	6	0	0
3	53901611	rs2241806	A	G	11	5	16	0	0	16	0	0
3	53904911	rs4687756	T	C	4	9	13	0	0	13	0	0
3	53905308	rs1046677	T	C	54	46	100	0	0	100	0	0
3	53906513	rs4687757	G	A	70	59	129	0	1	130	0	0
3	53916130	rs2276845	A	G	7	1	8	0	0	8	0	0
3	53918861	rs9878207	C	T	122	105	227	0	0	227	0	0
3	53922620	rs3816144	A	G	6	2	8	0	0	8	0	0
3	56655187	.	C	A	13	9	22	0	0	22	0	0
3	56829892	rs4681699	C	T	14	3	17	0	0	17	0	0
3	56835761	rs3732508	G	A	12	6	18	0	0	18	0	0
3	57269608	rs11544592	A	G	31	31	62	0	0	62	0	0
3	58081888	rs1522384	T	C	2	4	6	0	0	6	0	0
3	58109162	rs1131356	G	A	8	1	9	0	0	9	0	0
3	58112440	rs2362903	A	G	5	6	11	0	0	11	0	0
3	58112488	rs2362904	C	T	2	4	6	0	0	6	0	0
3	58154327	rs8640	C	T	25	14	39	0	0	39	0	0
3	58157519	rs1131264	G	C	29	26	55	0	2	57	0	0
3	69036991	rs7374624	A	G	3	5	8	0	0	8	0	0
3	69038088	rs13085120	A	G	25	22	47	0	0	47	0	0
3	69040409	rs7644494	T	C	3	5	8	0	0	8	0	0
3	69041006	rs6549166	G	A	9	7	16	0	0	16	0	0
3	69041033	rs6549167	T	C	5	7	12	0	0	12	0	0
3	69041322	rs6549168	A	G	7	11	18	0	0	18	0	0
3	69041434	rs7430692	C	A	6	13	19	0	1	20	0	0
3	69041622	rs7432824	A	G	4	8	12	0	0	12	0	0
3	69041932	rs9853259	A	G	4	8	12	0	0	12	0	0
3	69042266	rs7614090	G	T	5	8	13	0	0	13	0	0
3	69042624	rs6804833	A	G	8	6	14	0	0	14	0	0
3	69043012	rs7433849	T	C	3	6	9	0	0	9	0	0
3	69043027	rs35132360	T	C	6	3	9	0	0	9	0	0
3	69045948	rs4411889	C	T	7	6	13	0	0	13	0	0
3	69070563	rs1053555	A	C	36	40	76	0	2	78	0	0
3	69072761	rs9862298	T	C	3	5	8	0	0	8	0	0
3	69074930	rs2279936	G	A	5	1	6	0	0	6	0	0
3	69076210	rs113699639	G	A	3	3	6	0	0	6	0	0
3	69082708	rs1532918	C	G	74	59	133	0	0	133	0	0
3	69095112	rs13084180	T	A	5	8	13	0	0	13	0	0
3	69096614	rs2292199	G	A	70	68	138	0	1	139	0	0
3	69100890	rs34175383	G	A	6	7	13	0	0	13	0	0
3	69101369	rs41291197	C	T	28	25	53	0	1	54	0	0
3	69107293	rs11705981	C	G	11	5	16	0	0	16	0	0
3	69107306	rs6804531	A	C	12	6	18	0	0	18	0	0
3	69107316	rs6807035	T	C	12	8	20	0	0	20	0	0
3	69108316	rs2055684	A	T	3	9	12	0	0	12	0	0
3	69110201	rs62254242	A	G	6	8	14	0	0	14	0	0
3	69111488	rs6800465	A	T	4	4	8	0	0	8	0	0
3	69112049	rs2289245	C	T	5	1	6	0	0	6	0	0
3	69128743	rs3755719	A	G	5	13	18	0	0	18	0	0
3	69271032	rs62254461	G	A	15	4	19	0	0	19	0	0
3	69381944	rs11714469	G	A	4	4	8	0	0	8	0	0
3	69382324	rs11707811	C	T	2	5	7	0	0	7	0	0
3	69382349	rs34756290	T	A	1	5	6	0	0	6	0	0
3	71131950	.	T	A	2	5	7	0	0	7	0	0
3	71147574	rs72628624	T	C	11	9	20	0	0	20	0	0
3	71147590	rs17008204	C	G	10	9	19	0	0	20	1	0
3	71150983	rs831435	T	C	10	3	13	0	0	13	0	0
3	71151219	rs831436	C	T	12	5	17	0	0	17	0	0
3	71151260	rs77387049	G	A	5	10	15	0	0	15	0	0
3	71153110	rs6549377	C	A	0	6	6	0	1	7	0	0
3	71453531	rs112945520	G	C	4	5	9	0	0	9	0	0
3	71629657	rs13073703	C	A	9	6	15	0	0	15	0	0
3	71726259	rs704292	T	C	3	3	6	0	0	6	0	0
3	71731077	rs697253	C	T	36	14	50	0	0	50	0	0
3	71731348	rs704298	T	C	57	41	98	0	0	98	0	0
3	71733420	rs704299	C	T	65	36	101	0	1	102	0	0
3	71739564	rs9864677	A	C	5	2	7	0	0	7	0	0
3	71750143	rs12630449	A	G	1	11	12	0	0	12	0	0
3	71803776	.	G	A	6	5	11	0	0	11	0	0
3	71820969	rs2322141	T	C	19	135	154	0	0	154	0	0
3	71824151	rs2322142	C	T	41	3	44	0	2	46	0	0
3	71825656	.	G	A	55	6	61	0	0	61	0	0
3	71828420	rs1320015	C	T	14	2	16	0	0	16	0	0
3	71829242	rs7644362	G	A	19	0	19	0	0	19	0	0
3	71829467	rs7634474	A	G	19	2	21	0	0	21	0	0
3	71829786	rs35971163	T	G	3	23	26	0	0	26	0	0
3	72146520	rs6549436	G	A	4	3	7	0	0	7	0	0
3	72424633	rs113582970	G	A	207	169	376	0	3	379	0	0
3	72432888	rs7628338	G	A	3	3	6	0	0	6	0	0
3	72487582	rs113579694	A	T	7	6	13	0	0	13	0	0
3	72492348	rs34205354	G	T	11	11	22	0	0	22	0	0
3	72493066	rs62246789	A	T	5	4	9	0	0	9	0	0
3	72863504	rs3821561	T	C	6	6	12	0	0	12	0	0
3	73053488	rs9871570	G	A	4	3	7	0	0	7	0	0
3	73053887	rs62251769	A	G	4	3	7	0	0	7	0	0
3	73053944	rs62251770	A	C	7	5	12	0	0	12	0	0
3	73054062	rs28490409	A	G	7	5	12	0	1	13	0	0
3	73064367	rs13078603	G	A	4	4	8	0	0	8	0	0
3	73064377	rs749295	G	C	3	4	7	0	0	7	0	0
3	73064410	rs749294	C	A	2	6	8	0	0	8	0	0
3	73064745	rs9827068	G	C	0	7	7	0	0	7	0	0
3	73065170	rs36010877	G	A	8	15	23	0	0	23	0	0
3	73065232	rs7653764	C	A	7	14	21	0	0	21	0	0
3	73065276	rs28656102	T	C	3	6	9	0	0	9	0	0
3	73091008	rs4676899	A	C	2	4	6	0	0	6	0	0
3	73099608	rs12714791	A	T	2	4	6	0	1	7	0	0
3	73099610	rs13100385	A	G	2	4	6	0	1	7	0	0
3	73100154	rs11128306	C	T	12	8	20	0	0	20	0	0
3	73100200	rs11128307	C	G	8	10	18	0	0	18	0	0
3	73101145	rs9818210	T	C	11	10	21	0	0	21	0	0
3	73101397	.	C	T	6	2	8	0	1	9	0	0
3	73102141	rs9875383	C	T	23	22	45	0	0	45	0	0
3	73102242	rs2130902	T	C	25	29	54	0	0	54	0	0
3	73102475	rs9310260	C	T	11	8	19	0	0	19	0	0
3	73103169	rs7629074	A	G	6	5	11	0	0	11	0	0
3	73103189	rs7629084	A	G	6	3	9	0	1	10	0	0
3	73104286	rs6549503	C	G	5	4	9	0	0	9	0	0
3	73104377	rs6549504	G	A	5	2	7	0	0	7	0	0
3	73105167	rs1531965	T	C	7	2	9	0	0	9	0	0
3	73111053	rs2231923	A	G	10	11	21	0	0	21	0	0
3	73111368	rs2231924	T	C	14	14	28	0	1	29	0	0
3	73111809	rs2231926	A	G	17	35	52	0	0	52	0	0
3	73111973	rs2231928	A	G	20	18	38	0	0	38	0	0
3	73111998	rs1060584	C	T	20	22	42	0	0	42	0	0
3	73112378	rs7640805	A	G	19	17	36	0	0	36	0	0
3	73112974	rs11708712	A	T	11	17	28	0	1	29	0	0
3	73113528	rs4676901	C	G	2	4	6	0	0	6	0	0
3	73115175	rs1965964	A	G	95	69	164	0	9	173	0	0
3	73115786	rs3172278	T	C	348	358	706	0	3	709	0	0
3	73116437	rs1122474	C	G	42	51	93	0	2	95	0	0
3	73116716	rs7653851	A	T	8	15	23	0	2	25	0	0
3	73116878	.	T	G	6	12	18	0	0	18	0	0
3	73117835	rs1045960	C	T	56	37	93	0	0	93	0	0
3	81810516	rs9820490	C	A	2	5	7	0	0	7	0	0
3	81810770	rs78982329	G	A	9	7	16	0	0	16	0	0
3	88141638	.	A	G	4	3	7	0	0	7	0	0
3	93781615	rs73156375	G	T	7	11	18	0	0	18	0	0
3	97664725	rs2172257	C	T	5	3	8	0	0	8	0	0
3	98225352	rs13038	C	T	4	3	7	0	0	7	0	0
3	98225441	rs1132750	A	C	16	13	29	0	0	29	0	0
3	98241340	rs2306065	T	C	4	2	6	0	0	6	0	0
3	98296782	rs12496562	G	A	4	2	6	0	0	6	0	0
3	98304467	rs1729995	T	C	6	12	18	0	0	18	0	0
3	98307630	rs2228056	C	T	11	5	16	0	0	16	0	0
3	98501837	rs73136038	C	T	6	0	6	0	0	6	0	0
3	98501845	rs72932700	T	C	0	6	6	0	0	6	0	0
3	98502484	.	C	T	17	16	33	0	0	33	0	0
3	98503792	rs112115496	A	G	15	19	34	0	0	34	0	0
3	98509705	rs72934623	G	A	11	10	21	0	0	21	0	0
3	98512188	rs2278599	T	G	7	0	7	0	0	7	0	0
3	98512540	rs28489284	G	A	51	56	107	0	1	108	0	0
3	98514041	rs12203	G	C	3	5	8	0	0	8	0	0
3	98600385	rs9838238	T	C	6	5	11	0	0	11	0	0
3	99582242	rs809415	G	T	8	1	9	0	0	9	0	0
3	99583484	rs1718235	C	T	7	5	12	0	0	12	0	0
3	99584429	rs1626074	G	A	7	7	14	0	0	14	0	0
3	100064741	rs1045206	C	T	22	15	37	0	0	37	0	0
3	100064829	rs2289505	C	G	22	12	34	0	0	34	0	0
3	100064902	rs2289506	C	T	19	11	30	0	0	30	0	0
3	100084203	rs1561743	C	G	42	50	92	0	0	92	0	0
3	100086477	rs2316701	G	A	7	7	14	0	0	14	0	0
3	100086861	rs277640	T	C	6	16	22	0	1	23	0	0
3	100428460	rs1059363	G	C	4	13	17	0	0	17	0	0
3	100430675	rs6777763	G	A	4	3	7	0	0	7	0	0
3	100449501	rs3773922	C	T	5	7	12	0	0	12	0	0
3	100451780	rs10936343	T	C	11	5	16	0	0	16	0	0
3	100452644	rs10936345	C	G	7	13	20	0	0	20	0	0
3	100452668	rs10936346	G	C	7	11	18	0	0	18	0	0
3	100452911	rs1012364	T	A	11	6	17	0	3	20	0	0
3	100453859	rs10936349	T	C	7	6	13	0	0	13	0	0
3	100455433	.	T	G	183	171	354	0	0	354	0	0
3	100458260	rs7617184	G	A	5	4	9	0	1	10	0	0
3	100458996	rs41373752	A	G	3	3	6	0	0	6	0	0
3	100459966	rs1718279	T	G	5	2	7	0	0	7	0	0
3	100461442	rs3087787	T	A	15	8	23	0	0	23	0	0
3	100462527	rs2126540	A	C	10	12	22	0	0	22	0	0
3	100465276	rs1055213	C	T	9	4	13	0	0	13	0	0
3	100465609	rs3796276	A	G	11	6	17	0	0	17	0	0
3	100466421	rs115462724	A	C	4	8	12	0	0	12	0	0
3	100467018	rs11353	T	C	208	180	388	0	0	388	0	0
3	100467673	rs1059503	G	A	357	336	693	0	4	697	0	0
3	100467676	rs7297	A	T	351	329	680	0	3	683	0	0
3	101400988	rs41273607	G	A	26	16	42	0	0	42	0	0
3	101504217	rs115721253	T	C	2	5	7	0	0	7	0	0
3	101569726	rs616597	A	C	27	51	78	0	0	78	0	0
3	101570375	rs600718	A	T	12	14	26	0	0	26	0	0
3	101572822	rs2925334	C	G	1	5	6	0	0	6	0	0
3	101573052	rs678354	C	G	9	7	16	0	0	16	0	0
3	101574503	rs677011	G	A	12	13	25	0	0	25	0	0
3	101575882	.	T	C	57	25	82	0	2	84	0	0
3	101576175	rs14134	T	C	303	339	642	0	7	649	0	0
3	101576404	rs622122	A	T	24	26	50	0	1	51	0	0
3	101576762	rs599849	G	A	20	7	27	0	0	27	0	0
3	101579158	rs680508	A	G	498	415	913	0	6	919	0	0
3	105260518	rs579565	G	A	3	3	6	0	0	6	0	0
3	105501431	.	T	C	3	3	6	0	0	6	0	0
3	107526033	rs1053471	T	A	43	37	80	0	1	81	0	0
3	107527596	rs9831296	A	C	65	50	115	0	1	116	0	0
3	107529058	.	A	T	51	34	85	0	3	88	0	0
3	107529255	rs10804464	G	A	104	111	215	0	4	219	0	0
3	107769319	rs36115125	A	C	9	7	16	0	0	16	0	0
3	107808621	rs141733861	T	A	35	25	60	0	0	60	0	0
3	107856796	rs13072473	A	C	15	34	49	0	0	49	0	0
3	107856822	rs9858939	C	G	9	33	42	0	1	43	0	0
3	107856953	rs13077007	A	C	48	72	120	0	1	121	0	0
3	107879730	rs62264146	G	C	11	23	34	0	0	34	0	0
3	107880473	rs17828926	T	G	13	15	28	0	1	29	0	0
3	107880919	rs2035	T	C	5	16	21	0	0	21	0	0
3	107880977	rs57535746	G	A	2	18	20	0	0	20	0	0
3	107881138	rs1135937	T	A	5	9	14	0	0	14	0	0
3	107881152	rs58273586	T	C	4	8	12	0	0	12	0	0
3	107881701	rs9860418	G	A	20	13	33	0	0	33	0	0
3	107881711	rs62264147	T	C	17	14	31	0	0	31	0	0
3	107881796	rs9860587	G	A	16	12	28	0	0	28	0	0
3	107882291	rs28494587	G	T	4	2	6	0	0	6	0	0
3	107882952	rs79163761	T	C	7	6	13	0	0	13	0	0
3	107883232	rs9814678	T	C	8	5	13	0	0	13	0	0
3	107883530	rs13325340	C	G	11	9	20	0	0	20	0	0
3	107883768	rs13318436	A	G	19	13	32	0	1	33	0	0
3	107884132	rs62264149	T	C	7	12	19	0	0	19	0	0
3	107884269	rs62264150	A	G	10	16	26	0	0	26	0	0
3	107885483	rs17232794	G	C	4	2	6	0	0	6	0	0
3	107885875	rs2305551	A	G	2	7	9	0	0	9	0	0
3	107932180	rs62267894	A	T	3	3	6	0	0	6	0	0
3	107937360	rs56273515	C	T	6	10	16	0	0	16	0	0
3	107937408	rs1135897	C	T	107	75	182	0	3	185	0	0
3	108373022	rs2969901	G	A	9	2	11	0	0	11	0	0
3	108541761	rs9879812	T	C	4	4	8	0	0	8	0	0
3	111442959	rs17423838	A	G	5	2	7	0	0	7	0	0
3	112052103	rs2276772	G	T	6	14	20	0	0	20	0	0
3	112052927	rs9868582	G	T	5	3	8	0	0	8	0	0
3	112053246	rs1317243	T	C	6	4	10	0	0	10	0	0
3	112053565	rs1317244	G	A	6	2	8	0	0	8	0	0
3	112059768	rs1131199	C	G	17	18	35	0	0	35	0	0
3	112063850	rs2272022	C	A	34	45	79	0	1	80	0	0
3	112066141	rs13098589	C	T	1	7	8	0	0	8	0	0
3	112069392	rs9842650	T	C	9	4	13	0	0	13	0	0
3	112069755	rs12491166	T	C	4	6	10	0	0	10	0	0
3	112070576	rs7637088	T	A	12	7	19	0	0	19	0	0
3	112071282	rs62264128	A	G	13	17	30	0	0	30	0	0
3	112071413	rs62264129	A	T	17	15	32	0	1	33	0	0
3	112071934	rs2399422	G	A	14	9	23	0	0	23	0	0
3	112270857	rs13082005	G	A	7	2	9	0	0	9	0	0
3	113010303	rs17321330	G	A	3	3	6	0	0	6	0	0
3	113370010	rs1026364	G	T	10	8	18	0	0	18	0	0
3	113370967	.	T	A	53	9	62	0	1	63	0	0
3	113370969	.	T	A	51	11	62	0	0	63	1	0
3	113371590	rs2012309	A	G	15	13	28	0	0	28	0	0
3	113371631	rs2012312	C	T	16	12	28	0	0	28	0	0
3	113372047	rs13065268	C	T	19	8	27	0	0	27	0	0
3	113372243	rs9852924	G	A	24	15	39	0	0	39	0	0
3	113373019	rs12493635	C	T	19	21	40	0	0	40	0	0
3	113377361	rs9813630	A	G	7	11	18	0	0	18	0	0
3	113390883	rs12630833	G	T	5	1	6	0	0	6	0	0
3	113441152	rs35989573	A	G	3	3	6	0	0	6	0	0
3	113444051	rs921741	A	C	4	3	7	0	0	7	0	0
3	113464859	rs1048892	A	G	39	43	82	0	0	82	0	0
3	113479740	rs13097719	T	C	2	4	6	0	0	6	0	0
3	113494524	rs11719303	A	T	2	4	6	0	0	6	0	0
3	113502651	rs9851731	G	A	6	4	10	0	0	10	0	0
3	113528689	rs1043132	T	G	30	25	55	0	0	55	0	0
3	113530211	rs12736	T	C	78	95	173	0	0	173	0	0
3	113563881	rs13079071	G	A	15	24	39	0	0	39	0	0
3	113564011	rs13079300	G	T	10	28	38	0	1	39	0	0
3	113737568	rs17603649	G	A	3	3	6	0	0	6	0	0
3	113795834	rs7631864	G	A	6	1	7	0	0	7	0	0
3	113804979	rs1872575	G	A	13	40	53	0	0	53	0	0
3	113806592	rs1129632	A	G	65	46	111	0	0	111	0	0
3	114862856	.	C	A	12	12	24	0	0	24	0	0
3	118948618	rs4422293	G	C	9	8	17	0	0	17	0	0
3	118948716	rs4422294	G	A	27	28	55	0	0	55	0	0
3	118955888	rs3806698	G	A	17	9	26	0	0	26	0	0
3	119013558	rs4687994	G	A	3	3	6	0	0	6	0	0
3	119013928	rs3732412	A	T	1	7	8	0	0	8	0	0
3	119026889	rs6762580	A	G	6	2	8	0	0	8	0	0
3	119041408	rs13314464	C	G	6	1	7	0	0	7	0	0
3	119148476	rs17281647	C	T	20	14	34	0	0	34	0	0
3	119150089	rs3732421	A	G	22	25	47	0	0	47	0	0
3	119150491	rs1132202	G	C	10	7	17	0	0	17	0	0
3	119150836	rs1132200	C	T	94	109	203	0	2	205	0	0
3	119170218	rs2178318	A	G	3	3	6	0	0	6	0	0
3	119182259	rs2282175	G	A	29	29	58	0	1	59	0	0
3	119182442	rs2282173	G	C	13	15	28	0	0	28	0	0
3	119203577	rs187647864	A	G	2	4	6	0	0	6	0	0
3	119211384	rs11556604	T	G	11	12	23	0	0	23	0	0
3	119222456	rs1131265	G	C	8	10	18	0	0	18	0	0
3	119305379	rs25676	T	A	9	2	11	0	0	11	0	0
3	120045097	.	C	T	15	10	25	0	0	25	0	0
3	120045966	rs11554681	T	C	23	27	50	0	0	50	0	0
3	120049117	rs6438575	T	C	10	13	23	0	0	23	0	0
3	120316415	rs61797654	G	T	18	14	32	0	0	32	0	0
3	120317324	rs61797656	G	A	17	12	29	0	0	29	0	0
3	120318802	rs6438586	A	C	36	16	52	0	0	52	0	0
3	120389316	rs2255543	T	A	3	4	7	0	0	7	0	0
3	121350573	rs1128163	A	G	315	296	611	0	11	622	0	0
3	121350583	rs1128159	C	T	313	331	644	0	11	655	0	0
3	121350593	rs1128158	C	A	338	296	634	0	6	640	0	0
3	121350616	rs1128154	G	T	365	289	654	0	9	663	0	0
3	121354583	rs3772126	G	A	222	135	357	0	0	357	0	0
3	121356719	rs74746356	G	A	7	5	12	0	0	12	0	0
3	121356732	rs112102372	A	G	7	5	12	0	0	12	0	0
3	121361787	rs2070178	G	A	198	170	368	0	5	373	0	0
3	121362639	rs9846174	T	C	31	40	71	0	0	71	0	0
3	121363307	rs562534577	C	T	16	11	27	0	0	27	0	0
3	121374361	rs4048703	G	A	3	3	6	0	1	7	0	0
3	121374547	.	G	T	6	2	8	0	0	8	0	0
3	121382204	rs1169	C	T	128	113	241	0	6	247	0	0
3	121383297	rs7153	G	A	331	318	649	0	2	651	0	0
3	121400725	rs1463736	G	A	5	8	13	0	0	13	0	0
3	121401928	.	T	C	7	3	10	0	0	10	0	0
3	121406327	rs9817555	G	A	7	1	8	0	0	8	0	0
3	121414061	rs1127412	C	T	38	40	78	0	1	79	0	0
3	121415720	rs3732410	T	C	19	32	51	0	0	51	0	0
3	121416623	rs3732407	G	C	31	26	57	0	0	57	0	0
3	121563355	rs9884018	T	C	108	123	231	0	1	232	0	0
3	121564005	rs9868875	G	A	1	5	6	0	0	6	0	0
3	121641693	rs2293616	G	A	1	5	6	0	0	6	0	0
3	121646641	rs1143670	A	G	2	4	6	0	0	6	0	0
3	121647286	rs1143671	C	T	5	7	12	0	0	12	0	0
3	121648168	rs1143672	G	A	9	5	14	0	0	14	0	0
3	121660664	rs4285028	A	C	10	2	12	0	0	12	0	0
3	121661597	rs1136995	G	A	8	5	13	0	0	13	0	0
3	122056432	rs17589	C	T	188	170	358	0	5	363	0	0
3	122127592	rs4678192	A	G	4	3	7	0	0	7	0	0
3	122127789	rs10511409	C	T	5	5	10	0	0	10	0	0
3	122127822	rs13320117	T	C	6	6	12	0	0	12	0	0
3	122169820	.	A	G	3	3	6	0	0	6	0	0
3	122289921	rs9289200	T	C	3	6	9	0	0	9	0	0
3	122290579	rs2036342	C	T	25	26	51	0	0	51	0	0
3	122290801	rs12490075	G	A	9	18	27	0	0	27	0	0
3	122292965	rs74937187	G	A	43	36	79	0	1	80	0	0
3	122293209	rs1045089	C	T	26	20	46	0	1	47	0	0
3	122293773	rs7071	A	T	32	30	62	0	1	63	0	0
3	122354037	rs1106346	A	G	8	14	22	0	0	22	0	0
3	122354792	rs12489170	G	A	6	13	19	0	0	19	0	0
3	122355736	rs2650954	C	G	6	2	8	0	0	8	0	0
3	122356026	rs35782160	T	G	5	6	11	0	0	11	0	0
3	122357126	rs376631471	C	T	8	2	10	0	0	10	0	0
3	122357205	rs547084864	C	G	8	3	11	0	0	11	0	0
3	122357207	rs566885148	C	T	9	3	12	0	0	12	0	0
3	122357208	rs539001507	C	T	9	3	12	0	0	12	0	0
3	122357223	rs372741666	C	T	9	5	14	0	0	14	0	0
3	122357343	rs111581299	C	T	6	9	15	0	0	15	0	0
3	122357632	rs1143339	A	G	1	6	7	0	0	7	0	0
3	122419123	rs539543597	T	C	22	40	62	0	0	62	0	0
3	122606747	rs28706418	T	A	3	3	6	0	0	6	0	0
3	122864436	rs8739	G	A	10	33	43	0	1	44	0	0
3	122864627	rs1976715	C	G	0	8	8	0	0	8	0	0
3	122880191	rs8935	T	C	16	53	69	0	0	69	0	0
3	122947572	rs7642344	A	G	3	4	7	0	0	7	0	0
3	122992255	rs6438786	A	G	3	3	6	0	0	6	0	0
3	123211064	rs10668	G	T	30	27	57	0	0	57	0	0
3	123211295	rs56067434	G	A	24	25	49	0	0	49	0	0
3	123212043	rs7613130	T	C	3	10	13	0	0	13	0	0
3	123633612	rs11551801	G	A	39	54	93	0	1	94	0	0
3	123634046	rs2700373	G	A	41	28	69	0	0	69	0	0
3	123665902	rs17310144	T	G	16	22	38	0	0	38	0	0
3	123672378	rs2700357	C	T	3	3	6	0	0	6	0	0
3	123672874	rs2700351	G	A	1	5	6	0	0	6	0	0
3	123677383	rs2700399	A	C	4	2	6	0	0	6	0	0
3	123678162	rs35050482	T	G	7	1	8	0	0	8	0	0
3	124456742	rs1801019	G	C	9	5	14	0	0	14	0	0
3	124457272	rs13061561	C	T	27	17	44	0	1	45	0	0
3	124457483	rs17843826	T	G	14	6	20	0	0	20	0	0
3	124462808	rs13146	C	T	58	54	112	0	1	113	0	0
3	124463656	rs2242247	A	T	11	9	20	0	1	21	0	0
3	124463982	rs2242248	G	T	10	10	20	0	0	20	0	0
3	124482113	rs2675	T	G	8	4	12	0	0	12	0	0
3	124482222	rs2674	C	T	5	15	20	0	0	20	0	0
3	124515308	rs1803825	A	G	2	5	7	0	0	7	0	0
3	124515509	rs2291088	G	A	5	6	11	0	0	11	0	0
3	125166035	rs2333223	G	C	79	86	165	0	2	167	0	0
3	125173291	rs4679396	G	A	7	4	11	0	0	11	0	0
3	125223707	rs62270174	T	C	19	6	25	0	0	25	0	0
3	125229554	rs12498022	G	A	3	3	6	0	0	6	0	0
3	125312004	rs6773077	C	A	9	16	25	0	0	25	0	0
3	125312130	rs2979306	C	A	4	3	7	0	0	7	0	0
3	125313904	rs7625936	G	A	11	7	18	0	0	18	0	0
3	125725455	rs11543284	G	C	32	31	63	0	1	64	0	0
3	126156660	rs7131	C	G	138	120	258	0	1	260	1	0
3	126156689	rs115066783	G	C	116	123	239	0	2	241	0	0
3	126158622	rs1799404	A	C	29	27	56	0	0	56	0	0
3	126159370	rs1799403	G	A	14	24	38	0	0	38	0	0
3	126160529	rs4679244	A	G	10	9	19	0	0	19	0	0
3	126161625	rs6783961	T	C	21	8	29	0	0	29	0	0
3	126162151	rs777515	T	C	17	16	33	0	1	34	0	0
3	126163098	rs11714084	G	A	7	3	10	0	0	10	0	0
3	126165359	rs6782107	C	T	5	8	13	0	0	13	0	0
3	126167565	rs777492	G	C	3	8	11	0	0	11	0	0
3	126170695	rs12957	T	G	11	15	26	0	0	26	0	0
3	126170965	rs1844689	G	A	13	7	20	0	0	20	0	0
3	126171739	rs36059925	G	A	2	6	8	0	0	8	0	0
3	126173470	rs777503	C	T	23	17	40	0	0	40	0	0
3	126174271	rs813556	G	A	14	15	29	0	0	29	0	0
3	126174781	rs74904184	T	G	7	7	14	0	0	14	0	0
3	126175401	rs812368	G	A	8	14	22	0	0	22	0	0
3	126175410	rs58538708	G	C	13	8	21	0	0	21	0	0
3	126176112	rs777505	G	A	13	9	22	0	0	22	0	0
3	126176885	rs11717788	G	A	4	5	9	0	1	10	0	0
3	126178390	rs1043803	A	C	99	73	172	0	2	175	1	0
3	126179492	rs777507	G	A	53	47	100	0	1	102	1	0
3	126180088	rs3230	A	G	53	53	106	0	3	109	0	0
3	126180121	rs3231	C	T	57	50	107	0	1	108	0	0
3	126181582	rs883356	C	T	6	0	6	0	1	7	0	0
3	126182920	rs1687462	C	T	5	4	9	0	0	9	0	0
3	126183244	rs77947202	A	G	3	5	8	0	0	8	0	0
3	126183546	rs6810140	G	A	9	6	15	0	0	15	0	0
3	126184029	rs10934778	C	T	4	4	8	0	0	8	0	0
3	126184450	rs4679245	T	C	6	8	14	0	0	14	0	0
3	126192459	rs777502	A	G	6	2	8	0	0	8	0	0
3	126194076	rs812367	T	C	21	20	41	0	0	41	0	0
3	127292788	rs4974445	T	C	4	6	10	0	0	10	0	0
3	127295759	rs2289185	G	A	4	13	17	0	0	17	0	0
3	127379270	rs920232	C	T	7	7	14	0	0	14	0	0
3	127396573	rs35976576	C	T	134	70	204	0	1	206	1	0
3	127463188	rs1046821	G	A	17	13	30	0	0	30	0	0
3	127465870	rs512726	G	A	3	3	6	0	0	6	0	0
3	127784118	rs13070488	T	C	35	28	63	0	1	64	0	0
3	127784262	rs2075402	C	T	20	14	34	0	0	34	0	0
3	127784513	rs9819960	T	C	15	24	39	0	0	39	0	0
3	127786551	rs9858267	G	A	10	9	19	0	0	19	0	0
3	127786675	rs2276867	T	G	12	10	22	0	0	22	0	0
3	127787157	rs3733158	A	G	11	9	20	0	0	20	0	0
3	127787969	rs9829877	A	T	6	0	6	0	0	6	0	0
3	127788955	rs10934847	G	A	275	225	500	0	2	502	0	0
3	127789172	rs1042907	G	C	305	243	548	0	3	551	0	0
3	127789594	rs1042911	T	G	308	283	591	0	3	594	0	0
3	127789695	rs1042912	C	T	266	285	551	0	3	555	1	0
3	127799983	rs1057220	A	C	21	18	39	0	0	39	0	0
3	127800071	rs1057156	A	G	17	17	34	0	0	34	0	0
3	127872602	rs11719546	A	G	3	3	6	0	0	6	0	0
3	127983148	rs2811545	C	G	1	5	6	0	0	6	0	0
3	127983495	rs2811544	T	C	11	9	20	0	1	21	0	0
3	128198980	rs45463895	A	T	252	324	576	0	3	579	0	0
3	128199380	rs3803	G	A	451	384	835	0	10	845	0	0
3	128199662	rs10934857	G	A	416	338	754	0	9	763	0	0
3	128200534	rs2713603	G	A	5	7	12	0	0	12	0	0
3	128200806	rs11708606	G	A	7	2	9	0	0	9	0	0
3	128201013	rs11717152	A	C	10	9	19	0	0	19	0	0
3	128201376	rs55686439	C	A	5	7	12	0	0	12	0	0
3	128210550	rs11712335	T	C	10	6	16	0	0	16	0	0
3	128338953	rs1127030	T	C	78	121	199	0	4	203	0	0
3	128339057	.	A	T	188	99	287	0	4	291	0	0
3	128340110	rs55987729	T	C	11	5	16	0	0	16	0	0
3	128340896	rs2712419	T	C	12	13	25	0	0	25	0	0
3	128356852	rs1697	C	T	207	127	334	0	3	337	0	0
3	128364027	rs539101259	G	A	9	16	25	0	0	25	0	0
3	128364269	rs6801509	C	T	25	8	33	0	0	33	0	0
3	128364609	rs2002849	G	A	4	2	6	0	0	6	0	0
3	128366726	rs4557179	A	C	1	5	6	0	0	6	0	0
3	128369055	rs4467479	C	G	11	15	26	0	0	26	0	0
3	128369104	rs9813197	G	A	3	6	9	0	0	9	0	0
3	128464726	rs34150465	G	C	5	1	6	0	0	6	0	0
3	128469642	rs11706409	C	T	4	5	9	0	0	9	0	0
3	128486193	rs4642149	G	A	4	2	6	0	0	6	0	0
3	128531870	rs67145862	A	G	7	5	12	0	0	12	0	0
3	128614185	rs1680778	A	C	22	16	38	0	0	38	0	0
3	128625318	rs1680788	C	T	5	3	8	0	0	8	0	0
3	128625790	rs1680789	G	T	10	4	14	0	0	14	0	0
3	128625853	rs1680790	G	T	8	2	10	0	0	10	0	0
3	128626952	rs1683786	T	C	5	6	11	0	0	11	0	0
3	128627021	rs1683787	A	G	6	3	9	0	0	9	0	0
3	128627623	rs876756	G	A	4	4	8	0	0	8	0	0
3	128627753	rs876754	T	C	10	4	14	0	0	14	0	0
3	128627933	rs876755	C	T	13	23	36	0	0	36	0	0
3	128633808	rs789239	T	C	6	0	6	0	0	6	0	0
3	128640239	rs1683780	C	T	3	3	6	0	0	6	0	0
3	128642048	rs1683779	A	G	5	12	17	0	0	17	0	0
3	128643144	rs6785869	G	A	10	8	18	0	0	18	0	0
3	128643374	rs1825639	A	G	5	1	6	0	1	7	0	0
3	128643375	rs1825638	T	C	6	1	7	0	0	7	0	0
3	128643736	rs2340467	C	G	11	3	14	0	0	14	0	0
3	128648117	rs6767104	T	G	3	5	8	0	1	9	0	0
3	128648424	rs6767396	T	C	9	5	14	0	0	14	0	0
3	128754787	rs6771450	T	G	8	10	18	0	0	18	0	0
3	128755814	rs3732429	T	C	17	11	28	0	2	30	0	0
3	128755953	rs3732430	G	A	38	33	71	0	0	71	0	0
3	128759503	rs183872101	G	A	8	4	12	0	0	12	0	0
3	128848234	.	T	G	277	144	421	0	17	438	0	0
3	128848496	rs6803422	C	T	173	164	337	0	3	340	0	0
3	128992047	rs6762578	G	A	5	1	6	0	0	6	0	0
3	129020778	rs6765930	A	G	28	35	63	0	1	64	0	0
3	129042716	rs9816623	A	G	2	5	7	0	0	7	0	0
3	129043025	rs9858960	G	C	4	7	11	0	0	11	0	0
3	129109335	rs530767245	G	A	5	8	13	0	0	13	0	0
3	129111438	rs13059487	C	T	8	1	9	0	0	9	0	0
3	129111461	.	G	T	7	0	7	0	0	7	0	0
3	129281458	rs2811469	G	A	10	17	27	0	0	27	0	0
3	129809899	rs6767964	T	A	2	4	6	0	0	6	0	0
3	129816961	rs12638292	C	T	9	11	20	0	2	22	0	0
3	129817290	rs59443817	A	G	6	5	11	0	0	11	0	0
3	129817316	rs61073628	C	T	6	4	10	0	0	10	0	0
3	129817379	rs74203764	C	T	3	5	8	0	0	8	0	0
3	129817708	rs6788479	A	G	4	3	7	0	0	7	0	0
3	129821650	rs56088005	G	A	3	3	6	0	0	6	0	0
3	129822616	rs78806708	G	C	2	5	7	0	0	7	0	0
3	129824844	rs112405295	G	A	4	5	9	0	0	9	0	0
3	129829463	rs4072146	C	A	9	3	12	0	0	12	0	0
3	129829611	rs9856004	T	C	3	8	11	0	0	11	0	0
3	129838184	rs9289355	T	G	4	5	9	0	0	9	0	0
3	130400990	rs12494439	G	A	4	2	6	0	0	6	0	0
3	130427703	rs11707059	C	T	5	4	9	0	0	9	0	0
3	130428146	rs10934954	C	T	10	16	26	0	0	26	0	0
3	130431425	rs74464627	T	C	6	7	13	0	0	13	0	0
3	130431481	rs75219664	T	C	2	12	14	0	0	14	0	0
3	130432965	rs75998334	A	G	2	9	11	0	0	11	0	0
3	130433587	rs78696057	C	A	1	15	16	0	0	16	0	0
3	130433921	rs113759543	A	G	2	5	7	0	0	7	0	0
3	130449222	rs2170990	A	G	15	16	31	0	1	32	0	0
3	130462017	rs6793931	A	G	6	4	10	0	0	10	0	0
3	130462986	rs11713445	G	A	6	1	7	0	0	7	0	0
3	130465474	rs2293179	A	C	14	22	36	0	0	36	0	0
3	130716707	rs116087687	T	C	6	7	13	0	0	13	0	0
3	131102053	rs11549806	A	G	24	23	47	0	0	47	0	0
3	131104016	rs12631539	C	A	14	14	28	0	1	29	0	0
3	131182349	rs9860545	T	C	3	5	8	0	0	8	0	0
3	132068831	rs2228402	C	T	29	24	53	0	1	54	0	0
3	132075554	rs3181784	T	C	31	22	53	0	0	53	0	0
3	132075707	rs2071505	A	G	19	15	34	0	0	34	0	0
3	132075746	rs1042330	G	A	21	15	36	0	0	36	0	0
3	132076551	rs14192	T	C	38	14	52	0	1	53	0	0
3	132076706	rs1804136	G	T	46	20	66	0	0	66	0	0
3	132076955	rs1126661	C	T	21	11	32	0	1	33	0	0
3	132086825	rs2198765	G	A	2	8	10	0	0	10	0	0
3	132218623	rs3762672	G	T	19	6	25	0	0	25	0	0
3	132379065	rs2168435	C	T	11	9	20	0	1	21	0	0
3	132385190	rs1378807	C	G	4	2	6	0	0	6	0	0
3	132395811	rs1058331	G	T	46	38	84	0	1	85	0	0
3	132401056	.	T	C	4	15	19	0	1	20	0	0
3	132401421	rs6792074	G	A	1	6	7	0	0	7	0	0
3	132401600	rs6794496	C	T	38	29	67	0	0	67	0	0
3	132414454	rs12636390	T	C	4	2	6	0	0	6	0	0
3	132424172	rs10935029	C	G	2	15	17	0	0	17	0	0
3	133144383	rs9827245	A	G	7	0	7	0	0	7	0	0
3	133524717	rs1107413	G	C	17	16	33	0	0	33	0	0
3	133876415	rs1131274	A	T	64	50	114	0	0	114	0	0
3	133883410	rs4854619	T	C	4	3	7	0	0	7	0	0
3	133914636	rs9881896	C	T	10	11	21	0	0	21	0	0
3	133914748	rs9882168	C	T	9	3	12	0	0	12	0	0
3	133914765	rs13099506	G	A	9	3	12	0	1	13	0	0
3	133914938	rs62271183	G	T	6	1	7	0	0	7	0	0
3	133917421	rs56205980	A	T	9	8	17	0	0	17	0	0
3	133919953	rs4682665	T	C	2	5	7	0	0	7	0	0
3	134278270	rs1127826	C	T	13	6	19	0	0	19	0	0
3	136056861	rs696520	T	C	24	34	58	0	0	58	0	0
3	136088038	rs9860801	G	A	13	11	24	0	0	24	0	0
3	136305476	rs6806123	C	G	6	0	6	0	0	6	0	0
3	136306139	rs6806795	C	T	3	5	8	0	0	8	0	0
3	136322667	rs55907946	T	C	3	8	11	0	0	11	0	0
3	136574521	rs1052620	C	T	27	17	44	0	0	44	0	0
3	137955588	.	A	C	4	4	8	0	0	8	0	0
3	137965584	.	G	A	30	21	51	0	0	51	0	0
3	137966646	rs4678405	T	C	14	13	27	0	0	27	0	0
3	137982369	.	G	A	12	10	22	0	0	22	0	0
3	137982409	.	T	C	22	31	53	0	2	55	0	0
3	137982718	rs939453	T	G	12	8	20	0	0	20	0	0
3	141209101	rs34342794	C	T	3	5	8	0	0	8	0	0
3	141210420	rs2312194	T	G	3	4	7	0	0	7	0	0
3	141212518	rs9813177	A	G	4	2	6	0	0	6	0	0
3	141215116	rs9837959	C	T	98	44	142	0	2	144	0	0
3	141215273	rs9838230	C	T	92	66	158	0	10	168	0	0
3	141215409	rs9838419	C	G	114	97	211	0	2	213	0	0
3	141215498	rs77468424	C	A	91	86	177	0	0	177	0	0
3	141216134	rs71619392	G	A	8	13	21	0	0	21	0	0
3	141327474	rs295323	G	A	14	12	26	0	0	26	0	0
3	141331222	rs2172471	G	A	11	10	21	0	0	21	0	0
3	141331565	rs1709	T	C	21	32	53	0	0	53	0	0
3	141333835	rs11557453	C	T	45	30	75	0	0	75	0	0
3	141632797	rs2288636	G	T	4	4	8	0	0	8	0	0
3	141632816	rs2288635	A	G	3	4	7	0	0	7	0	0
3	141633222	rs79007829	G	A	3	8	11	0	0	11	0	0
3	141634056	rs3804772	G	A	8	2	10	0	0	10	0	0
3	141636530	rs9810697	A	G	4	4	8	0	0	8	0	0
3	141637526	rs6762767	T	C	2	5	7	0	0	7	0	0
3	141639377	rs4683411	G	A	4	2	6	0	1	7	0	0
3	141639697	rs77634787	C	G	4	3	7	0	0	7	0	0
3	141639886	rs74392109	A	G	2	5	7	0	0	7	0	0
3	141641216	rs111629838	C	T	20	19	39	0	1	40	0	0
3	141641368	rs141851402	G	T	17	26	43	0	0	43	0	0
3	141641538	rs6769618	A	G	10	21	31	0	1	32	0	0
3	141641682	rs76808107	C	T	25	22	47	0	0	47	0	0
3	141641970	rs12490893	A	T	27	41	68	0	1	69	0	0
3	141642176	rs12497443	G	A	28	49	77	0	0	77	0	0
3	141642312	rs12487977	T	C	35	60	95	0	0	95	0	0
3	141642345	rs12487983	T	A	29	62	91	0	2	93	0	0
3	141642563	rs78765711	C	T	16	16	32	0	0	32	0	0
3	141643694	rs4683648	T	C	20	17	37	0	1	38	0	0
3	141644097	rs4683649	C	T	25	29	54	0	1	55	0	0
3	141644774	rs11844	G	C	261	233	494	0	6	500	0	0
3	141663683	rs1045279	C	T	70	65	135	0	1	136	0	0
3	141663752	rs9942	A	G	71	72	143	0	1	144	0	0
3	141664223	rs3762726	G	A	36	22	58	0	1	59	0	0
3	141664344	rs12494971	C	G	72	67	139	0	2	141	0	0
3	141665145	rs56174413	G	A	33	37	70	0	1	71	0	0
3	141666260	rs10935447	C	T	9	7	16	0	1	17	0	0
3	141667348	rs11707100	A	G	7	3	10	0	0	10	0	0
3	141667632	rs74733987	T	G	18	20	38	0	0	38	0	0
3	141667725	rs113405221	T	C	19	18	37	0	0	37	0	0
3	141669685	rs11569291	A	G	62	55	117	0	1	118	0	0
3	141712780	rs3817176	C	T	5	2	7	0	0	7	0	0
3	141714256	rs11706728	C	T	7	0	7	0	0	7	0	0
3	141720387	rs77690894	T	C	3	3	6	0	0	6	0	0
3	141720853	rs35597264	C	T	4	3	7	0	0	7	0	0
3	141721056	rs111822220	C	T	7	3	10	0	0	10	0	0
3	141721460	rs11712803	T	C	4	4	8	0	0	8	0	0
3	141721713	rs78272662	G	C	4	9	13	0	0	13	0	0
3	141721762	rs34464850	G	C	5	3	8	0	0	8	0	0
3	141721904	rs113342937	C	G	5	3	8	0	0	8	0	0
3	141722754	rs11569190	T	C	4	3	7	0	0	7	0	0
3	141760831	rs9880805	A	G	6	3	9	0	0	9	0	0
3	141761072	rs11713690	C	T	10	8	18	0	0	18	0	0
3	141762049	rs181938072	C	T	1	5	6	0	0	6	0	0
3	141877084	rs11707853	T	C	17	8	25	0	1	26	0	0
3	141878153	rs35624474	G	A	6	8	14	0	0	14	0	0
3	141880333	rs73236065	A	G	10	7	17	0	1	18	0	0
3	141882655	rs6440063	C	T	4	6	10	0	0	10	0	0
3	141883031	rs11714396	T	C	2	4	6	0	0	6	0	0
3	142036520	rs9289648	T	C	3	3	6	0	0	6	0	0
3	142038959	rs73238136	T	C	4	4	8	0	0	8	0	0
3	142039406	rs2086933	G	A	3	4	7	0	0	7	0	0
3	142041137	rs73238138	T	C	5	3	8	0	0	8	0	0
3	142078759	rs73238159	C	T	23	22	45	0	1	46	0	0
3	142097777	rs6769786	A	G	2	5	7	0	0	7	0	0
3	142123841	rs2306700	C	T	14	11	25	0	0	25	0	0
3	142139275	rs28708455	T	C	5	2	7	0	0	7	0	0
3	142178144	rs2229032	C	T	31	24	55	0	0	55	0	0
3	142277575	rs2227930	A	T	3	8	11	0	0	11	0	0
3	142730774	rs2124541	T	G	3	3	6	0	0	6	0	0
3	142743124	rs73157687	T	C	4	2	6	0	0	6	0	0
3	142744777	rs4683721	G	A	4	2	6	0	1	7	0	0
3	142745293	rs6440129	A	G	10	10	20	0	0	20	0	0
3	142752293	rs1449869	G	A	7	3	10	0	0	10	0	0
3	142754236	rs4683723	A	T	2	4	6	0	0	6	0	0
3	142754296	rs4683444	C	T	2	8	10	0	0	10	0	0
3	142755741	rs1827159	G	A	7	9	16	0	0	16	0	0
3	142776151	rs1043898	C	T	78	75	153	0	0	153	0	0
3	142777508	rs7623532	C	A	25	25	50	0	3	53	0	0
3	142778355	rs17633378	C	T	40	25	65	0	0	65	0	0
3	142778666	rs10790	C	T	42	28	70	0	0	70	0	0
3	142779032	rs13715	A	G	11	10	21	0	0	21	0	0
3	142841740	rs6664	C	T	6	10	16	0	0	16	0	0
3	143567207	rs11714060	A	G	4	7	11	0	0	11	0	0
3	145788467	rs6710	T	C	18	16	34	0	0	34	0	0
3	145911733	rs9985294	A	G	9	3	12	0	0	12	0	0
3	146234269	rs343321	A	G	8	6	14	0	0	14	0	0
3	146235394	rs343319	T	C	18	11	29	0	0	29	0	0
3	146237323	rs72986629	C	T	4	7	11	0	0	11	0	0
3	146237370	rs414657	T	C	4	3	7	0	0	7	0	0
3	146237371	rs431840	G	A	5	3	8	0	0	8	0	0
3	146246050	rs2587026	A	T	11	3	14	0	0	14	0	0
3	146255463	rs2609867	T	C	4	2	6	0	0	6	0	0
3	146256604	rs2165948	C	A	13	12	25	0	0	26	1	0
3	146256774	rs66639703	G	A	20	25	45	0	1	46	0	0
3	146257130	rs2587018	A	G	31	35	66	0	0	66	0	0
3	146257165	rs2738918	T	C	31	31	62	0	0	62	0	0
3	146257197	rs2609865	G	A	27	25	52	0	0	52	0	0
3	146257307	rs1882974	G	C	29	26	55	0	1	56	0	0
3	146257359	rs3773521	G	A	30	27	57	0	1	58	0	0
3	146257393	rs1882973	G	A	22	14	36	0	1	37	0	0
3	146257602	rs1882972	G	A	11	13	24	0	1	25	0	0
3	146257661	rs1882971	C	T	16	28	44	0	0	44	0	0
3	146257787	rs2587017	C	T	11	12	23	0	1	24	0	0
3	146257795	rs2587016	A	G	10	10	20	0	0	20	0	0
3	146258000	rs2587015	A	G	4	4	8	0	0	8	0	0
3	146258185	rs2738916	C	T	8	7	15	0	0	15	0	0
3	146258463	rs2587014	A	G	12	11	23	0	0	23	0	0
3	146258595	rs2738915	T	C	6	13	19	0	0	19	0	0
3	146258609	rs2587013	A	G	6	13	19	0	0	19	0	0
3	146258670	rs2587012	C	A	6	13	19	0	0	19	0	0
3	146258699	rs2587011	A	G	6	9	15	0	0	15	0	0
3	146258853	rs9289722	A	G	15	10	25	0	1	26	0	0
3	146258935	rs3773510	C	T	24	15	39	0	0	39	0	0
3	146258982	rs2609864	C	T	4	6	10	0	0	10	0	0
3	146259192	rs2587010	C	T	6	7	13	0	0	13	0	0
3	146259563	rs2609862	G	A	9	7	16	0	0	16	0	0
3	146260326	rs2587009	A	G	9	7	16	0	0	16	0	0
3	146260466	rs2587008	C	G	2	4	6	0	0	6	0	0
3	146260608	rs2738912	A	T	4	3	7	0	0	7	0	0
3	146260728	rs2738911	G	C	3	3	6	0	0	6	0	0
3	146260811	rs2738910	A	G	8	6	14	0	0	14	0	0
3	146260845	rs2609861	G	A	7	5	12	0	0	12	0	0
3	146260900	rs2609860	C	T	6	11	17	0	0	17	0	0
3	146260985	rs4434119	A	T	7	10	17	0	0	17	0	0
3	146260986	rs2738907	T	G	7	10	17	0	0	17	0	0
3	146261035	rs2738906	C	T	7	12	19	0	0	19	0	0
3	146261282	rs1997601	T	C	8	7	15	0	0	15	0	0
3	146261504	rs1997604	T	C	8	2	10	0	0	10	0	0
3	146261580	rs2587007	G	A	3	3	6	0	0	6	0	0
3	146261756	.	T	C	13	1	14	0	0	14	0	0
3	146262021	rs2609858	G	A	8	6	14	0	0	14	0	0
3	146262344	rs1061307	C	T	105	73	178	0	0	178	0	0
3	148726671	rs62274643	G	A	3	6	9	0	0	9	0	0
3	148749621	rs2119342	T	C	5	8	13	0	0	13	0	0
3	148762351	rs6440581	C	G	5	1	6	0	0	6	0	0
3	148766666	rs34474865	T	C	15	16	31	0	0	31	0	0
3	148786108	rs812249	C	T	15	14	29	0	0	29	0	0
3	148801072	rs772817	A	G	3	7	10	0	0	10	0	0
3	149456926	rs10935774	A	G	25	36	61	0	1	62	0	0
3	149456995	rs10935775	C	G	13	35	48	0	0	48	0	0
3	149459466	.	C	T	72	83	155	0	2	157	0	0
3	149468141	rs74697246	G	A	2	12	14	0	0	14	0	0
3	149468530	rs9843784	T	G	51	63	114	0	0	114	0	0
3	149531177	rs6764359	T	G	3	9	12	0	0	12	0	0
3	149678534	rs6768054	C	T	52	51	103	0	0	103	0	0
3	150128392	rs879634	G	A	6	3	9	0	0	9	0	0
3	150134451	rs28517277	G	A	4	5	9	0	0	9	0	0
3	150134948	rs75150613	A	G	4	6	10	0	0	10	0	0
3	150139693	rs75902063	A	G	8	9	17	0	0	17	0	0
3	150155120	rs16862648	T	C	5	2	7	0	0	7	0	0
3	150174240	rs6795124	G	A	6	4	10	0	0	10	0	0
3	150174304	rs6770424	A	G	9	5	14	0	0	14	0	0
3	150174350	rs6807568	T	A	6	4	10	0	0	10	0	0
3	150174510	rs6810143	T	A	3	3	6	0	0	6	0	0
3	150174658	rs41267883	A	G	5	4	9	0	0	9	0	0
3	150175996	rs4423794	G	A	4	3	7	0	0	7	0	0
3	150260151	.	C	G	64	72	136	0	0	136	0	0
3	150260853	rs10272	C	T	238	221	459	0	5	464	0	0
3	150262318	rs1533816	C	T	8	3	11	0	1	12	0	0
3	150262513	rs1533817	G	A	14	9	23	0	2	25	0	0
3	150264003	rs1130834	G	C	79	74	153	0	1	154	0	0
3	150264136	rs1049947	G	A	26	40	66	0	0	66	0	0
3	150280445	rs1132979	C	G	121	94	215	0	3	219	1	0
3	150283562	rs3209262	T	C	8	2	10	0	0	10	0	0
3	150283812	rs9823447	C	A	5	3	8	0	0	8	0	0
3	150288309	rs9840992	T	C	4	2	6	0	0	6	0	0
3	150332856	rs112635778	T	A	2	4	6	0	0	6	0	0
3	150345690	rs2272084	T	G	115	94	209	0	3	212	0	0
3	150346654	rs6777911	A	G	8	7	15	0	0	15	0	0
3	150347833	rs7979	G	A	8	12	20	0	0	20	0	0
3	150399103	rs76779869	C	T	4	4	8	0	0	8	0	0
3	150399194	rs73152546	G	A	4	3	7	0	0	7	0	0
3	150881774	rs17290219	A	C	67	92	159	0	1	160	0	0
3	150964641	rs4269062	C	A	7	10	17	0	0	17	0	0
3	150964993	rs554522737	C	T	10	3	13	0	0	13	0	0
3	150965331	rs28537149	A	G	7	7	14	0	0	14	0	0
3	151044903	rs12497019	C	T	46	43	89	0	0	89	0	0
3	151056616	rs6785930	G	A	4	5	9	0	0	9	0	0
3	151061490	rs7641645	T	C	6	3	9	0	0	9	0	0
3	151061702	rs17282947	A	G	6	3	9	0	0	9	0	0
3	151062830	rs6801273	T	C	1	5	6	0	0	6	0	0
3	151062847	rs6440738	G	A	1	5	6	0	0	6	0	0
3	151063660	rs6767192	A	G	3	3	6	0	0	6	0	0
3	151063869	rs9875152	C	T	3	6	9	0	0	9	0	0
3	151064376	rs9876268	G	A	6	8	14	0	0	14	0	0
3	151065004	rs12637988	T	A	3	3	6	0	0	6	0	0
3	151067007	rs17204437	G	A	8	8	16	0	0	16	0	0
3	151090424	rs3732765	G	A	28	27	55	0	1	56	0	0
3	151103370	rs4680400	G	A	3	3	6	0	0	6	0	0
3	152016969	rs1426383	C	T	9	2	11	0	0	11	0	0
3	152022890	rs6784925	C	T	1	5	6	0	0	6	0	0
3	152025796	rs6807753	T	C	4	9	13	0	0	13	0	0
3	152029167	rs13063739	T	C	2	6	8	0	0	8	0	0
3	152033705	rs12486405	C	T	5	5	10	0	0	10	0	0
3	152035367	rs13068236	T	C	3	13	16	0	0	16	0	0
3	152036486	rs111423993	A	T	5	5	10	0	0	10	0	0
3	152042244	rs3913371	T	C	2	5	7	0	0	7	0	0
3	152043824	.	T	C	3	3	6	0	0	6	0	0
3	152181040	rs1801769	T	C	23	33	56	0	1	57	0	0
3	152183512	rs7221	T	C	20	21	41	0	1	42	0	0
3	152882810	rs61252895	A	G	14	5	19	0	0	19	0	0
3	153990749	rs355786	G	A	9	12	21	0	1	22	0	0
3	153991875	rs165275	T	C	16	13	29	0	0	29	0	0
3	153991974	rs403132	A	G	10	10	20	0	0	20	0	0
3	153992586	rs2596630	A	G	9	7	16	0	0	16	0	0
3	153992952	rs442480	T	A	7	4	11	0	0	11	0	0
3	154017691	.	C	A	41	42	83	0	0	83	0	0
3	154018887	rs9438	G	C	42	50	92	0	0	92	0	0
3	156248426	rs9830714	C	T	1	6	7	0	0	7	0	0
3	156258005	rs1046666	C	T	18	4	22	0	0	22	0	0
3	156258387	rs9856073	G	T	9	9	18	0	0	18	0	0
3	156258817	rs3773713	T	C	20	19	39	0	0	39	0	0
3	156259279	rs1129109	C	T	37	38	75	0	0	75	0	0
3	156259348	rs1129094	G	A	25	24	49	0	1	50	0	0
3	156259485	rs8665	G	A	39	33	72	0	0	72	0	0
3	156259966	rs3773714	A	T	29	24	53	0	1	54	0	0
3	156260245	rs1510277	G	A	29	24	53	0	1	54	0	0
3	156266774	rs9296	C	T	61	55	116	0	3	119	0	0
3	156397389	rs184695	T	C	2	9	11	0	0	11	0	0
3	156398360	rs185231704	A	G	1	9	10	0	0	10	0	0
3	156423072	rs346003	A	T	29	16	45	0	0	45	0	0
3	156872973	rs34046890	G	A	123	144	267	0	3	270	0	0
3	156873220	rs4680342	G	C	32	38	70	0	0	70	0	0
3	156874500	rs9863805	C	A	84	101	185	0	2	187	0	0
3	156876502	rs6441114	G	A	98	72	170	0	3	173	0	0
3	156877707	rs9814142	A	T	473	456	929	0	5	934	0	0
3	156878226	rs9856475	C	T	5	5	10	0	0	10	0	0
3	158177271	rs73877211	G	A	4	7	11	0	1	12	0	0
3	158178245	rs6806967	C	T	6	12	18	0	0	18	0	0
3	158263035	.	T	G	5	2	7	0	0	7	0	0
3	158263154	rs12491598	C	A	5	4	9	0	0	9	0	0
3	158320597	rs4875	T	C	4	5	9	0	0	9	0	0
3	158320703	rs15967	C	A	5	3	8	0	0	8	0	0
3	158362391	rs28372852	C	T	6	6	12	0	0	12	0	0
3	158362441	rs1864507	T	C	10	8	18	0	3	21	0	0
3	158367837	rs56167308	C	T	1	5	6	0	0	6	0	0
3	158387487	rs6441215	T	C	6	5	11	0	0	11	0	0
3	158388780	rs8455	T	C	7	9	16	0	0	16	0	0
3	158389772	rs7624934	C	T	8	6	14	0	0	14	0	0
3	158389860	rs17630607	C	T	4	6	10	0	0	10	0	0
3	158390395	rs9841	A	T	6	12	18	0	0	18	0	0
3	158407231	rs62288345	G	T	1	5	6	0	0	6	0	0
3	158407333	rs62288346	C	T	3	4	7	0	0	7	0	0
3	158407430	rs13325932	A	G	2	4	6	0	0	6	0	0
3	158409262	rs1047355	C	T	46	59	105	0	1	106	0	0
3	158409482	rs1047366	C	T	11	10	21	0	0	21	0	0
3	158409947	rs8650	T	A	10	8	18	0	0	18	0	0
3	158520011	rs28364680	C	T	7	15	22	0	0	22	0	0
3	158535951	rs10936160	T	C	4	3	7	0	0	7	0	0
3	158537443	rs3765083	A	G	48	54	102	0	1	103	0	0
3	158545632	rs12634337	A	G	3	4	7	0	0	7	0	0
3	158546984	rs12490494	T	G	80	119	199	0	1	200	0	0
3	160101645	rs142328090	T	G	3	6	9	0	0	9	0	0
3	160130110	rs2305407	G	A	13	5	18	0	0	18	0	0
3	160130514	rs17826173	T	C	39	17	56	0	0	56	0	0
3	160130554	rs4680581	G	A	32	24	56	0	0	56	0	0
3	160131576	rs1451762	G	C	23	24	47	0	0	47	0	0
3	160131667	rs1451761	T	G	22	18	40	0	0	40	0	0
3	160135428	rs1451760	C	T	7	6	13	0	0	13	0	0
3	160137748	rs73154592	A	T	8	11	19	0	1	20	0	0
3	160138171	rs3773369	C	G	7	10	17	0	0	17	0	0
3	160146592	.	G	A	160	177	337	0	2	339	0	0
3	160148756	rs7631792	C	T	20	9	29	0	0	29	0	0
3	160152299	rs13403	C	A	247	180	427	0	6	433	0	0
3	160152696	rs10923	A	G	55	47	102	0	4	106	0	0
3	160153989	rs6785881	C	T	12	12	24	0	0	24	0	0
3	160154258	rs1047210	A	C	14	14	28	0	0	28	0	0
3	160154747	rs4679885	A	G	6	9	15	0	0	15	0	0
3	160155047	rs4679886	C	T	7	8	15	0	1	16	0	0
3	160213102	rs1056669	G	A	52	55	107	0	0	107	0	0
3	160213286	rs73875285	C	T	32	8	40	0	0	40	0	0
3	160214469	rs3732706	G	A	6	9	15	0	0	15	0	0
3	160215548	rs58322641	T	C	3	5	8	0	0	8	0	0
3	160283126	rs4621370	A	C	18	17	35	0	0	35	0	0
3	160286646	rs3732707	C	T	6	3	9	0	0	9	0	0
3	167279650	rs6774632	A	G	2	7	9	0	0	9	0	0
3	167728054	rs73174971	C	T	55	40	95	0	2	97	0	0
3	167728254	rs73174972	G	A	7	4	11	0	0	11	0	0
3	167728808	rs9827289	A	T	4	9	13	0	0	13	0	0
3	167728973	rs76195137	C	T	8	4	12	0	1	13	0	0
3	167729034	rs9869340	G	A	7	5	12	0	0	12	0	0
3	167729139	rs9869242	C	T	6	11	17	0	0	17	0	0
3	167729244	rs9831756	A	G	6	5	11	0	1	12	0	0
3	167729312	rs182060617	A	C	8	5	13	0	0	13	0	0
3	167729319	rs149425198	C	T	8	5	13	0	0	13	0	0
3	167729340	rs9869823	G	A	5	8	13	0	0	13	0	0
3	167729527	rs13314994	T	G	5	1	6	0	0	6	0	0
3	167729586	rs183378882	A	C	10	0	10	0	0	10	0	0
3	167729750	rs143178646	T	C	5	1	6	0	0	6	0	0
3	167730046	rs147840306	C	T	5	5	10	0	0	10	0	0
3	167730114	rs187794860	A	G	7	3	10	0	0	10	0	0
3	167730606	.	C	A	9	5	14	0	0	14	0	0
3	167731576	.	T	A	3	7	10	0	0	10	0	0
3	167732379	rs145624375	A	G	4	2	6	0	0	6	0	0
3	167732837	.	G	T	3	4	7	0	0	7	0	0
3	167736700	rs55691202	C	T	3	3	6	0	0	6	0	0
3	167742248	rs56283429	G	A	7	3	10	0	0	10	0	0
3	167747022	rs61743591	C	T	30	19	49	0	1	50	0	0
3	167750349	.	G	T	20	14	34	0	0	34	0	0
3	169802930	rs1861935	G	T	6	9	15	0	0	15	0	0
3	169806816	rs6808369	A	G	44	39	83	0	0	83	0	0
3	169807624	rs6444896	C	G	33	27	60	0	0	60	0	0
3	169807839	rs6804888	G	T	47	45	92	0	0	92	0	0
3	169808114	rs10936611	A	C	32	29	61	0	1	62	0	0
3	169809559	rs62293457	A	C	7	4	11	0	0	11	0	0
3	169809560	rs62293458	C	A	7	4	11	0	0	11	0	0
3	169809923	rs7644857	A	G	11	17	28	0	0	28	0	0
3	169813340	rs7643249	C	T	38	19	57	0	0	57	0	0
3	169817867	rs4140757	C	T	8	7	15	0	0	15	0	0
3	169818669	rs2111821	G	A	6	11	17	0	0	17	0	0
3	169890409	.	T	C	36	33	69	0	0	69	0	0
3	170076571	rs17550584	C	T	5	2	7	0	0	7	0	0
3	170114078	rs1045210	A	C	24	21	45	0	0	45	0	0
3	170825920	rs2291900	G	A	9	12	21	0	0	21	0	0
3	170893070	rs12637875	G	A	7	9	16	0	0	16	0	0
3	171087469	rs3796295	G	A	13	17	30	0	0	30	0	0
3	171320227	rs9822322	C	T	9	5	14	0	0	14	0	0
3	171338237	rs9881788	T	G	4	7	11	0	0	11	0	0
3	171506572	rs79337528	A	G	37	35	72	0	1	73	0	0
3	171506698	rs10936700	C	T	29	46	75	0	0	75	0	0
3	171507563	rs4586847	C	T	1	5	6	0	0	6	0	0
3	171507730	rs9815321	G	T	9	18	27	0	1	28	0	0
3	171519793	rs13321742	G	A	5	35	40	0	0	40	0	0
3	171520169	rs72622541	A	G	2	5	7	0	0	7	0	0
3	171800654	rs6766889	T	C	3	5	8	0	0	8	0	0
3	171873423	rs35233403	C	T	3	3	6	0	0	6	0	0
3	171880905	rs185757415	A	T	6	3	9	0	0	9	0	0
3	171887511	rs34099906	G	A	4	3	7	0	0	7	0	0
3	171894947	rs62283844	A	T	3	3	6	0	0	6	0	0
3	171895648	rs35796867	T	C	2	4	6	0	0	6	0	0
3	171898074	rs9290446	A	G	10	1	11	0	0	11	0	0
3	171898688	rs4894526	A	G	4	8	12	0	0	12	0	0
3	171900281	rs4243422	T	G	6	5	11	0	0	11	0	0
3	171900737	rs9825851	G	A	2	4	6	0	0	6	0	0
3	171903778	rs9841862	G	C	21	18	39	0	0	40	1	0
3	171904125	rs7620293	A	G	15	16	31	0	0	31	0	0
3	171904227	rs7620401	A	G	19	12	31	0	2	33	0	0
3	171969077	rs7652177	C	G	6	9	15	0	0	15	0	0
3	172046861	rs2270568	T	C	7	6	13	0	1	14	0	0
3	172225140	.	A	C	6	1	7	0	0	7	0	0
3	172226074	rs3136605	A	G	3	3	6	0	0	6	0	0
3	172226620	rs3136599	A	C	5	1	6	0	0	6	0	0
3	172227402	rs6775921	G	T	3	3	6	0	0	6	0	0
3	172227905	rs3181139	C	A	13	1	14	0	0	14	0	0
3	172228544	rs3136597	G	T	5	5	10	0	0	10	0	0
3	172228872	rs3136596	G	A	8	11	19	0	0	19	0	0
3	172229871	rs2241063	G	T	5	2	7	0	0	7	0	0
3	176745349	rs17560814	G	C	6	7	13	0	0	13	0	0
3	176750426	rs9290610	C	T	3	3	6	0	0	6	0	0
3	176806198	rs1201285	G	A	7	5	12	0	0	12	0	0
3	176807314	rs1201284	G	A	14	12	26	0	0	26	0	0
3	178735842	rs4955811	G	A	1	15	16	0	0	16	0	0
3	178738432	rs6790867	T	C	3	16	19	0	0	19	0	0
3	178739594	rs1542	C	G	1	5	6	0	0	6	0	0
3	178741584	.	C	T	0	6	6	0	0	6	0	0
3	178785549	rs6772028	G	A	5	34	39	0	0	39	0	0
3	178917005	rs3729674	A	G	2	5	7	0	0	7	0	0
3	178927410	rs2230461	A	G	37	62	99	0	1	100	0	0
3	178936484	rs950486	G	A	3	3	6	0	0	6	0	0
3	178943121	rs7636471	A	G	3	3	6	0	0	6	0	0
3	178952507	rs9838117	G	T	44	34	78	0	1	79	0	0
3	178955783	rs6443626	T	C	16	17	33	0	0	33	0	0
3	178957783	rs3976507	C	T	43	38	81	0	0	81	0	0
3	178960607	rs1059691	A	G	8	2	10	0	0	10	0	0
3	178969542	rs1180368	A	G	3	4	7	0	0	7	0	0
3	178977111	rs2160756	G	T	6	12	18	0	0	18	0	0
3	178977844	rs7613411	G	C	6	7	13	0	0	13	0	0
3	178978103	rs113518362	A	G	5	13	18	0	0	18	0	0
3	178978372	rs9853868	A	G	3	7	10	0	0	10	0	0
3	179041396	rs3806687	G	A	5	4	9	0	0	9	0	0
3	179041975	rs7610174	C	T	2	4	6	0	0	6	0	0
3	179044310	rs62410444	A	G	2	4	6	0	0	6	0	0
3	179045759	rs7644501	A	G	5	13	18	0	0	18	0	0
3	179047817	rs62410445	T	C	0	6	6	0	0	6	0	0
3	179056135	rs10460887	A	G	5	5	10	0	0	10	0	0
3	179056139	rs1061751	A	G	6	5	11	0	0	11	0	0
3	179106718	rs73045131	G	T	1	5	6	0	0	6	0	0
3	179111144	rs11720405	G	A	10	5	15	0	0	15	0	0
3	179112234	rs62408878	C	T	9	0	9	0	0	9	0	0
3	179112296	rs62408879	C	T	11	6	17	0	0	17	0	0
3	179112425	rs147997842	G	C	20	15	35	0	1	36	0	0
3	179112665	rs73172210	A	T	3	3	6	0	0	6	0	0
3	179115229	rs11539412	T	C	91	113	204	0	0	204	0	0
3	179115380	rs10937003	C	T	143	131	274	0	3	277	0	0
3	179115649	rs11539416	G	A	59	48	107	0	1	108	0	0
3	179117152	rs144262708	G	A	16	38	54	0	1	55	0	0
3	179118397	rs11714353	A	C	53	70	123	0	0	123	0	0
3	179118998	rs3774225	C	T	48	29	77	0	0	77	0	0
3	179120983	rs79422823	G	A	3	3	6	0	0	6	0	0
3	179122707	rs2287311	C	G	6	4	10	0	0	10	0	0
3	179137273	rs1362650	A	G	52	37	89	0	0	89	0	0
3	179289429	rs6790272	A	C	8	5	13	0	0	13	0	0
3	179298999	rs1132429	C	T	50	47	97	0	1	98	0	0
3	179302880	rs6795642	G	T	11	6	17	0	1	18	0	0
3	179344745	rs9817167	C	T	6	5	11	0	0	11	0	0
3	179408054	rs61760203	C	T	13	7	20	0	0	20	0	0
3	179502736	rs17195990	T	A	3	6	9	0	0	9	0	0
3	179504309	rs9814513	C	T	7	3	10	0	0	10	0	0
3	179505864	rs7624986	A	G	5	5	10	0	0	10	0	0
3	179506482	rs10937010	A	G	2	7	9	0	0	9	0	0
3	179521638	rs3774230	T	C	4	2	6	0	0	6	0	0
3	180328027	rs34873940	C	G	15	17	32	0	0	32	0	0
3	180650466	.	T	C	6	0	6	0	0	6	0	0
3	182604826	rs675071	T	C	12	21	33	0	1	34	0	0
3	182606979	rs643625	G	A	3	6	9	0	0	9	0	0
3	182615459	rs55657715	A	G	11	4	15	0	0	15	0	0
3	182615560	rs59108404	G	A	7	1	8	0	0	8	0	0
3	182615740	rs7650888	G	A	13	1	14	0	0	14	0	0
3	182624759	rs4859144	C	T	4	2	6	0	0	6	0	0
3	182624904	rs6771588	G	T	5	1	6	0	1	7	0	0
3	182629855	rs7617221	C	G	5	2	7	0	0	7	0	0
3	182629859	rs7617377	G	A	5	2	7	0	0	7	0	0
3	182631792	rs11925959	C	A	20	28	48	0	1	49	0	0
3	182633307	rs7627158	G	A	9	13	22	0	0	22	0	0
3	182633469	rs1027875	A	G	3	11	14	0	0	14	0	0
3	182633727	rs1027874	G	T	5	3	8	0	0	8	0	0
3	182634373	rs72625003	C	T	4	6	10	0	0	10	0	0
3	182635345	rs1876755	G	T	17	9	26	0	0	26	0	0
3	182657666	rs6763257	C	G	20	23	43	0	0	43	0	0
3	182657981	rs9848209	C	G	66	43	109	0	3	112	0	0
3	182659953	rs9878775	T	C	10	17	27	0	1	28	0	0
3	182681740	rs4859146	C	T	46	48	94	0	0	94	0	0
3	182733713	rs13326155	G	T	4	5	9	0	0	9	0	0
3	182734481	rs9879377	C	A	1	8	9	0	0	9	0	0
3	182735311	rs10804888	C	T	5	3	8	0	0	8	0	0
3	182735412	rs10937105	A	T	4	3	7	0	1	8	0	0
3	182736611	rs11917464	A	G	3	3	6	0	0	6	0	0
3	182745131	rs4859151	A	G	6	2	8	0	0	8	0	0
3	182745757	rs2134427	A	T	4	4	8	0	0	8	0	0
3	182747552	rs1056565	A	G	5	1	6	0	0	6	0	0
3	182748495	rs10937108	A	T	2	4	6	0	0	6	0	0
3	182748812	rs4859264	T	C	3	3	6	0	0	6	0	0
3	182790249	rs7622479	G	A	22	17	39	0	0	39	0	0
3	182805804	rs7611168	C	T	4	6	10	0	0	10	0	0
3	182805943	rs11716229	G	C	5	3	8	0	0	8	0	0
3	182976865	rs149054442	C	T	9	5	14	0	0	14	0	0
3	182987515	rs3811732	G	A	256	231	487	0	0	487	0	0
3	183169943	rs10937131	G	T	9	11	20	0	0	20	0	0
3	183169944	rs10937132	A	G	7	11	18	0	0	18	0	0
3	183170136	rs10804889	A	C	10	11	21	0	1	22	0	0
3	183170142	rs10804890	C	T	5	8	13	0	0	13	0	0
3	183173326	rs10845	G	C	18	21	39	0	0	39	0	0
3	183173424	rs4859194	A	G	13	13	26	0	3	29	0	0
3	183208737	rs7644322	G	A	5	1	6	0	0	6	0	0
3	183208915	rs7622061	A	G	31	24	55	0	2	57	0	0
3	183210854	rs2255932	A	G	12	8	20	0	0	20	0	0
3	183211127	rs2662768	G	A	13	8	21	0	0	21	0	0
3	183211128	rs2686426	C	T	13	8	21	0	0	21	0	0
3	183211327	rs2686427	G	A	11	8	19	0	0	19	0	0
3	183211906	rs1520101	A	G	22	19	41	0	0	41	0	0
3	183212026	rs2256061	C	T	17	12	29	0	0	29	0	0
3	183212393	rs2662767	A	G	2	4	6	0	0	6	0	0
3	183234142	rs7623174	A	G	8	11	19	0	0	19	0	0
3	183234383	rs10804891	T	G	8	7	15	0	0	15	0	0
3	183234676	rs56296700	A	G	5	4	9	0	0	9	0	0
3	183238165	rs6809608	T	C	10	3	13	0	0	13	0	0
3	183238273	rs6797186	C	T	6	4	10	0	0	10	0	0
3	183238784	rs12494823	C	G	18	4	22	0	0	22	0	0
3	183238992	rs12495530	G	A	16	6	22	0	1	23	0	0
3	183239404	rs6800858	G	A	6	4	10	0	0	10	0	0
3	183240243	rs12487008	T	G	9	9	18	0	0	18	0	0
3	183240667	rs62287219	G	A	7	1	8	0	0	8	0	0
3	183240707	rs62287220	G	A	2	4	6	0	0	6	0	0
3	183240827	rs12108025	G	A	7	3	10	0	0	10	0	0
3	183390462	rs139710544	G	A	73	45	118	0	1	119	0	0
3	183395135	rs16857992	C	T	4	5	9	0	0	9	0	0
3	183432983	rs3736535	C	T	11	14	25	0	1	26	0	0
3	183460102	rs830182	G	A	8	7	15	0	0	15	0	0
3	183460343	rs830181	C	T	6	13	19	0	0	19	0	0
3	183476685	rs262993	G	A	33	27	60	0	2	62	0	0
3	183477126	rs262992	A	G	2	4	6	0	0	6	0	0
3	183477480	rs12639043	C	T	3	4	7	0	0	7	0	0
3	183477665	rs262991	A	G	2	4	6	0	0	6	0	0
3	183523657	rs263035	A	G	0	6	6	0	0	6	0	0
3	183524193	rs263034	T	C	4	2	6	0	0	6	0	0
3	183524948	rs263031	T	C	5	5	10	0	0	10	0	0
3	183525121	rs263030	A	G	3	4	7	0	0	7	0	0
3	183525519	rs263028	G	A	6	0	6	0	0	6	0	0
3	183528442	rs263024	C	T	51	52	103	0	3	106	0	0
3	183529521	.	T	A	63	82	145	0	2	147	0	0
3	183534069	rs3732582	G	C	5	3	8	0	0	8	0	0
3	183637845	rs562	T	C	3	9	12	0	0	12	0	0
3	183638506	rs3749445	C	T	3	10	13	0	0	13	0	0
3	183702089	rs3749440	A	G	24	12	36	0	1	37	0	0
3	183702275	rs4148575	A	G	26	13	39	0	0	39	0	0
3	183704068	rs939338	G	A	9	1	10	0	0	10	0	0
3	183705184	rs3749438	G	A	5	1	6	0	0	6	0	0
3	183858939	rs865808	A	C	3	8	11	0	0	11	0	0
3	183861064	rs843359	A	G	35	29	64	0	0	64	0	0
3	183861750	rs843357	A	C	52	49	101	0	0	101	0	0
3	183889337	rs3749231	A	T	53	56	109	0	1	110	0	0
3	183890097	rs73185726	G	A	90	89	179	0	0	179	0	0
3	183890868	rs11919795	A	G	262	204	466	0	4	471	1	0
3	183899832	rs8478	C	T	302	287	589	0	7	596	0	0
3	183900338	rs843367	T	C	9	4	13	0	0	13	0	0
3	183900729	rs843365	T	C	12	23	35	0	0	35	0	0
3	183900836	rs843364	G	A	20	16	36	0	0	36	0	0
3	183901281	rs2231224	G	A	328	307	635	0	5	641	1	0
3	183902801	rs6443954	T	C	4	2	6	0	0	6	0	0
3	183904226	rs56351888	C	T	6	8	14	0	0	14	0	0
3	183904232	rs1709624	T	A	6	8	14	0	0	14	0	0
3	183904520	rs55940723	T	C	17	13	30	0	1	31	0	0
3	183904868	rs2942057	A	G	12	14	26	0	0	26	0	0
3	183904977	rs3792305	T	C	15	25	40	0	0	40	0	0
3	183906515	rs843345	T	C	2	4	6	0	0	6	0	0
3	183907032	rs843344	G	C	27	27	54	0	0	54	0	0
3	183907902	rs843343	A	G	12	6	18	0	0	18	0	0
3	183908002	rs843342	T	C	16	4	20	0	0	20	0	0
3	183908761	rs7614381	C	T	13	10	23	0	0	23	0	0
3	183912194	rs73185743	C	T	8	4	12	0	0	12	0	0
3	183912339	rs843336	A	G	5	5	10	0	0	10	0	0
3	183916311	rs2376912	T	C	12	6	18	0	0	18	0	0
3	183916566	rs62287471	G	T	16	12	28	0	0	28	0	0
3	183960252	rs706584	A	C	27	24	51	0	0	51	0	0
3	183961180	rs843331	C	A	5	2	7	0	1	8	0	0
3	184046470	rs2230571	C	T	142	118	260	0	4	264	0	0
3	184047354	rs55829914	A	G	4	2	6	0	0	6	0	0
3	184062776	rs9839000	A	G	7	14	21	0	0	21	0	0
3	184428903	rs9872799	T	G	22	8	30	0	0	30	0	0
3	184429718	rs12011	A	G	3	3	6	0	0	6	0	0
3	184529990	rs7640976	C	G	13	8	21	0	0	21	0	0
3	184533583	rs3179379	G	A	20	14	34	0	1	35	0	0
3	184550501	rs9830734	A	G	11	8	19	0	0	19	0	0
3	184573555	rs6443999	C	T	15	12	27	0	1	28	0	0
3	184587274	rs61741194	A	G	10	19	29	0	1	30	0	0
3	184633247	rs4686879	A	C	22	23	45	0	0	45	0	0
3	184766301	rs3821750	T	C	52	87	139	0	1	140	0	0
3	184769911	rs2271257	C	T	61	68	129	0	1	130	0	0
3	184769941	rs2271258	T	C	68	75	143	0	1	144	0	0
3	184770380	rs3332	C	T	17	4	21	0	0	21	0	0
3	185135198	rs145569753	C	T	0	25	25	0	0	25	0	0
3	185313278	rs62291882	T	C	5	2	7	0	0	7	0	0
3	185331165	rs6762208	C	A	27	35	62	0	3	65	0	0
3	185331678	rs34619288	G	C	0	6	6	0	0	6	0	0
3	185346420	rs35598169	A	G	16	7	23	0	0	23	0	0
3	185346714	rs35853080	C	A	8	11	19	0	0	19	0	0
3	185347230	rs6799206	C	G	5	8	13	0	0	13	0	0
3	185347459	rs6774871	A	G	9	12	21	0	0	21	0	0
3	185348351	rs4687477	T	C	67	67	134	0	1	135	0	0
3	185348402	rs3087964	C	T	64	77	141	0	1	142	0	0
3	185350016	.	T	G	29	2	31	0	8	39	0	0
3	185350032	.	T	G	29	5	34	0	9	43	0	0
3	185350706	rs7638853	G	A	24	21	45	0	0	45	0	0
3	185351208	rs13413	G	C	34	35	69	0	0	70	1	0
3	185392802	.	T	C	6	3	9	0	3	12	0	0
3	185635685	rs16860328	A	G	5	1	6	0	0	6	0	0
3	185646406	rs2284909	A	T	21	34	55	0	0	55	0	0
3	185649960	.	G	C	5	3	8	0	0	8	0	0
3	185651001	rs2300921	T	C	7	9	16	0	0	16	0	0
3	185652947	rs16860342	C	T	9	12	21	0	0	21	0	0
3	185655454	rs1862904	A	G	4	2	6	0	0	6	0	0
3	186264587	rs4686430	T	G	8	12	20	0	1	21	0	0
3	186501502	rs266720	C	A	33	29	62	0	1	63	0	0
3	186501648	rs266719	T	C	37	29	66	0	0	66	0	0
3	186501854	rs71322413	C	T	30	24	54	0	0	54	0	0
3	186501900	rs3900626	C	T	23	19	42	0	1	43	0	0
3	186502693	rs192246586	T	C	38	39	77	0	0	77	0	0
3	186503435	rs1426810	G	A	30	21	51	0	0	51	0	0
3	186505900	rs1354091	T	G	82	80	162	0	1	163	0	0
3	186505930	rs17299991	C	T	83	83	166	0	1	167	0	0
3	186507922	rs2066500	C	T	12	12	24	0	0	24	0	0
3	186508312	rs266759	C	T	10	7	17	0	0	17	0	0
3	186508357	rs266758	T	C	10	6	16	0	0	16	0	0
3	186508574	rs266756	G	C	7	5	12	0	0	12	0	0
3	186509517	rs187868	G	A	184	159	343	0	3	346	0	0
3	186512835	rs266750	T	C	3	4	7	0	0	7	0	0
3	186545055	rs62292779	G	A	5	1	6	0	0	6	0	0
3	186793729	rs1042642	A	G	8	4	12	0	0	12	0	0
3	186794103	rs2284749	G	A	4	8	12	0	0	12	0	0
3	186794732	rs9875078	C	A	9	8	17	0	0	17	0	0
3	186794733	rs9875079	C	A	9	7	16	0	1	17	0	0
3	186795248	rs4686848	G	A	12	9	21	0	0	21	0	0
3	186795470	.	C	T	12	8	20	0	0	20	0	0
3	186795640	rs1801380	G	A	9	7	16	0	0	16	0	0
3	186795762	rs11554720	T	C	4	11	15	0	0	15	0	0
3	186796053	rs7559	T	C	5	10	15	0	0	15	0	0
3	186796130	rs1042757	G	C	8	14	22	0	0	22	0	0
3	187439555	.	A	G	87	85	172	0	2	174	0	0
3	187440506	rs1005099	C	A	6	6	12	0	0	12	0	0
3	187446211	rs2229362	C	T	92	88	180	0	0	180	0	0
3	187447032	rs1056932	G	A	107	100	207	0	1	208	0	0
3	187454731	rs3774304	C	G	11	11	22	0	1	23	0	0
3	187455958	rs11924264	A	G	7	5	12	0	0	12	0	0
3	187456238	rs189362631	G	C	7	4	11	0	2	13	0	0
3	187456594	rs3733018	A	C	3	6	9	0	0	9	0	0
3	187458152	rs146217395	C	T	5	4	9	0	0	9	0	0
3	187459907	rs3774299	G	A	6	3	9	0	0	9	0	0
3	187460099	rs3774298	G	A	3	9	12	0	0	12	0	0
3	187462296	rs4686467	A	G	6	3	9	0	0	9	0	0
3	187462722	rs80031434	C	G	18	13	31	0	0	31	0	0
3	188599369	rs4686496	G	A	3	5	8	0	0	8	0	0
3	190236758	rs9990231	T	C	7	1	8	0	0	8	0	0
3	190237797	rs7628333	C	T	5	5	10	0	0	10	0	0
3	190238043	rs3821744	C	T	8	3	11	0	0	11	0	0
3	190247500	rs141169645	G	A	7	1	8	0	0	8	0	0
3	190346218	rs6444443	G	A	2	4	6	0	0	6	0	0
3	190347391	rs7611887	C	T	20	15	35	0	0	35	0	0
3	190347523	rs1024946	G	A	21	13	34	0	0	34	0	0
3	190347678	rs1024947	C	G	20	6	26	0	0	26	0	0
3	190347681	rs1024948	C	T	19	6	25	0	1	26	0	0
3	190349888	rs4686558	A	G	9	4	13	0	0	13	0	0
3	190357721	rs58230362	C	A	4	2	6	0	0	6	0	0
3	190358352	rs9815685	G	A	2	5	7	0	0	7	0	0
3	190359456	rs9821122	G	A	4	7	11	0	0	11	0	0
3	190359804	rs62286262	A	G	4	2	6	0	0	6	0	0
3	190360571	rs3935774	C	T	2	4	6	0	0	6	0	0
3	190360642	rs3935775	A	T	3	3	6	0	0	6	0	0
3	190361497	rs9831803	G	T	3	5	8	0	0	8	0	0
3	191075902	rs11542549	C	T	3	6	9	0	0	9	0	0
3	191097966	rs293813	T	C	3	7	10	0	0	10	0	0
3	191114266	rs2293377	T	C	0	12	12	0	0	12	0	0
3	191114309	rs2293378	A	T	1	13	14	0	0	14	0	0
3	191115082	rs4677732	G	C	1	5	6	0	0	6	0	0
3	191116133	rs6953	C	T	10	0	10	0	0	10	0	0
3	193334991	rs7624750	G	A	38	38	76	0	0	76	0	0
3	193337021	rs9817704	G	A	7	9	16	0	0	16	0	0
3	193340310	rs34520293	A	C	6	3	9	0	0	9	0	0
3	193341016	rs12490391	C	T	4	5	9	0	0	9	0	0
3	193343761	rs6791301	C	G	5	9	14	0	0	14	0	0
3	193344955	rs9291059	T	C	2	9	11	0	0	11	0	0
3	193346648	rs6444733	A	C	5	2	7	0	0	7	0	0
3	193346921	rs6444734	C	T	3	5	8	0	0	8	0	0
3	193350837	rs13096511	T	G	5	8	13	0	0	13	0	0
3	193350876	rs13078398	G	T	6	6	12	0	0	12	0	0
3	193374964	rs9851685	T	C	126	123	249	0	9	258	0	0
3	193386239	rs12494482	C	T	10	16	26	0	1	27	0	0
3	193386462	rs2276722	C	T	5	12	17	0	0	17	0	0
3	193389324	rs10937597	T	A	2	4	6	0	0	6	0	0
3	193393612	rs3851984	A	G	3	4	7	0	0	7	0	0
3	193394495	rs2935303	T	C	5	1	6	0	0	6	0	0
3	193400776	rs2088335	G	A	3	3	6	0	0	6	0	0
3	193401021	rs4443116	A	G	9	1	10	0	0	10	0	0
3	193412672	rs1061648	A	G	64	72	136	0	1	137	0	0
3	193413502	rs12630	C	T	7	8	15	0	0	15	0	0
3	193413732	rs1056366	A	G	40	45	85	0	0	85	0	0
3	193414481	rs1056390	C	T	69	52	121	0	1	122	0	0
3	193414733	rs1056392	A	G	101	116	217	0	1	218	0	0
3	193414780	rs11719309	T	C	98	105	203	0	1	204	0	0
3	194308618	.	C	T	25	26	51	0	0	51	0	0
3	194309012	rs9814348	G	A	14	10	24	0	0	24	0	0
3	194310529	rs9846532	A	G	9	3	12	0	0	12	0	0
3	194310731	rs1055161	C	A	6	3	9	0	0	9	0	0
3	194334109	rs35595542	G	A	8	3	11	0	0	11	0	0
3	194338423	rs12695036	C	T	6	1	7	0	0	7	0	0
3	194338538	rs12632700	A	T	2	4	6	0	0	6	0	0
3	194338562	rs10933664	A	C	2	5	7	0	0	7	0	0
3	194338734	rs7621122	C	T	1	5	6	0	0	6	0	0
3	194355325	rs11708714	T	C	4	9	13	0	0	13	0	0
3	194355976	rs6766608	C	T	4	6	10	0	0	10	0	0
3	194356026	rs7649259	G	A	4	4	8	0	0	8	0	0
3	194357822	rs4677646	G	C	1	7	8	0	0	8	0	0
3	194358524	rs6437396	C	T	6	5	11	0	0	11	0	0
3	194358623	rs6437397	G	A	6	4	10	0	0	10	0	0
3	194359210	rs6790804	C	A	5	3	8	0	1	9	0	0
3	194360927	rs711995	C	T	4	2	6	0	0	6	0	0
3	194361714	rs1491	T	G	80	78	158	0	0	158	0	0
3	194361768	rs1493	C	T	88	93	181	0	0	181	0	0
3	194362157	rs13322267	G	T	52	54	106	0	1	108	1	0
3	194362542	rs789989	T	A	38	34	72	0	0	72	0	0
3	194362620	rs711994	T	G	36	33	69	0	0	69	0	0
3	194362721	rs1060827	G	A	37	28	65	0	1	66	0	0
3	194364703	rs9809010	C	A	2	4	6	0	0	6	0	0
3	194366007	rs2275682	T	C	3	3	6	0	0	6	0	0
3	194371437	rs1773205	T	A	14	15	29	0	0	29	0	0
3	194371496	rs1773206	G	A	13	12	25	0	1	26	0	0
3	194372349	rs1705990	C	T	4	7	11	0	0	11	0	0
3	194372382	rs9831146	T	C	8	3	11	0	0	11	0	0
3	194372719	rs1623913	G	T	8	6	14	0	0	14	0	0
3	194387300	rs1675943	C	T	16	8	24	0	0	24	0	0
3	194406997	rs9877161	G	A	25	23	48	0	0	48	0	0
3	194407405	rs3752798	C	A	21	23	44	0	2	46	0	0
3	194789553	rs57202169	A	C	21	106	127	0	1	128	0	0
3	194789558	rs60093934	C	G	24	124	148	0	1	149	0	0
3	194790422	rs3796158	G	A	12	34	46	0	0	46	0	0
3	194869285	rs2279632	G	A	5	1	6	0	0	6	0	0
3	194869328	rs2279631	T	C	6	0	6	0	0	6	0	0
3	194869342	rs2279630	C	T	6	0	6	0	0	6	0	0
3	194870295	rs7639698	G	T	2	4	6	0	0	6	0	0
3	194895842	.	A	T	5	2	7	0	0	7	0	0
3	194900764	rs9879463	C	A	6	1	7	0	0	7	0	0
3	194901139	rs59190596	G	C	13	0	13	0	0	13	0	0
3	194998813	.	A	G	10	7	17	0	1	18	0	0
3	195242593	rs1136	T	G	109	106	215	0	0	215	0	0
3	195254869	rs2641358	G	A	5	4	9	0	0	9	0	0
3	195255816	rs34658674	C	T	8	5	13	0	0	13	0	0
3	195255965	rs2641361	C	T	5	4	9	0	0	9	0	0
3	195270012	rs11475	A	G	62	47	109	0	0	109	0	0
3	195277104	rs77963694	A	G	4	2	6	0	0	6	0	0
3	195366893	rs368923021	T	C	9	1	10	0	0	10	0	0
3	195384959	.	A	T	7	1	8	0	0	8	0	0
3	195384977	rs564703796	G	T	11	3	14	0	0	14	0	0
3	195398250	.	C	A	3	4	7	0	0	7	0	0
3	195398505	.	G	A	6	1	7	0	0	7	0	0
3	195401737	.	T	C	5	1	6	0	0	6	0	0
3	195401755	.	G	T	5	1	6	0	0	6	0	0
3	195401800	rs139339724	C	T	4	4	8	0	0	8	0	0
3	195401807	.	C	T	7	1	8	0	0	8	0	0
3	195402062	.	C	T	7	0	7	0	0	7	0	0
3	195402143	.	G	C	6	1	7	0	0	7	0	0
3	195402185	.	A	G	5	1	6	0	0	6	0	0
3	195402448	rs4927765	G	C	5	8	13	0	0	13	0	0
3	195408130	.	A	T	4	5	9	0	0	9	0	0
3	195415423	rs150892404	A	G	24	3	27	0	0	27	0	0
3	195423249	.	C	G	3	8	11	0	0	11	0	0
3	195423377	.	C	T	5	9	14	0	0	14	0	0
3	195423390	.	G	A	4	8	12	0	0	12	0	0
3	195424780	.	C	G	1	6	7	0	0	7	0	0
3	195425765	rs2688468	G	C	5	5	10	0	0	10	0	0
3	195426849	rs3107774	C	A	3	4	7	0	0	7	0	0
3	195426855	rs3107773	G	A	4	3	7	0	0	7	0	0
3	195426860	.	T	C	3	4	7	0	0	7	0	0
3	195427345	rs60205953	T	C	10	0	10	0	0	10	0	0
3	195427346	rs368506998	G	A	10	0	10	0	0	10	0	0
3	195427776	rs1874020	T	C	10	1	11	0	0	11	0	0
3	195435053	.	G	A	19	10	29	0	0	29	0	0
3	195435220	.	T	G	3	3	6	0	0	6	0	0
3	195435434	.	A	G	5	2	7	0	0	7	0	0
3	195453434	.	G	A	8	7	15	0	0	15	0	0
3	195460236	rs712011	G	A	8	4	12	0	0	12	0	0
3	195460287	rs712010	G	A	5	1	6	0	0	6	0	0
3	195591527	rs3890033	T	C	6	0	6	0	0	6	0	0
3	195594950	rs56260729	G	A	82	82	164	0	1	165	0	0
3	195606770	rs881753	A	G	6	3	9	0	0	9	0	0
3	195612034	rs3747672	T	C	5	5	10	0	1	11	0	0
3	195615376	rs3747669	A	G	83	50	133	0	1	134	0	0
3	195620037	rs73205796	C	T	10	7	17	0	0	17	0	0
3	195620038	rs9846297	G	A	7	10	17	0	0	17	0	0
3	195622616	rs77828245	G	A	5	4	9	0	0	9	0	0
3	195623440	rs12490307	G	C	5	3	8	0	0	8	0	0
3	195624484	rs62283334	T	C	6	1	7	0	0	7	0	0
3	195625326	rs9871110	A	G	9	10	19	0	0	19	0	0
3	195628001	rs4927790	G	T	3	3	6	0	1	7	0	0
3	195628004	rs4927791	C	T	3	3	6	0	0	6	0	0
3	195628272	rs6421308	G	A	5	6	11	0	0	11	0	0
3	195628815	rs11185498	T	C	4	4	8	0	0	8	0	0
3	195633435	rs75417972	C	T	3	7	10	0	1	11	0	0
3	195635257	rs3747671	A	G	16	11	27	0	0	27	0	0
3	195637237	rs56261799	G	T	9	6	15	0	0	15	0	0
3	195639385	rs9834833	C	G	7	4	11	0	0	11	0	0
3	195664871	.	C	T	7	0	7	0	0	7	0	0
3	195686832	.	G	A	18	17	35	0	0	35	0	0
3	195686899	.	C	T	68	5	73	0	0	73	0	0
3	195692069	rs6776037	A	G	5	3	8	0	0	8	0	0
3	195707707	rs62282846	T	C	8	1	9	0	0	9	0	0
3	195707711	rs62282847	G	A	8	1	9	0	0	9	0	0
3	195707857	.	G	C	3	4	7	0	0	7	0	0
3	195708205	.	T	G	12	0	12	0	0	12	0	0
3	195708256	.	C	T	1	11	12	0	0	12	0	0
3	195708880	rs2620600	C	T	1	5	6	0	0	6	0	0
3	195710989	rs2620604	G	A	23	6	29	0	0	29	0	0
3	195710993	rs4927692	A	G	23	6	29	0	0	29	0	0
3	195711042	.	C	G	14	7	21	0	0	21	0	0
3	195776976	rs406271	T	C	537	353	890	0	10	900	0	0
3	195777211	rs17788379	C	T	184	178	362	0	4	366	0	0
3	195778972	rs1805051	C	T	218	264	482	0	4	486	0	0
3	195779155	rs41298097	C	T	11	3	14	0	1	15	0	0
3	195779661	rs41298089	C	T	8	0	8	0	0	8	0	0
3	195782176	rs419068	C	T	7	3	10	0	1	11	0	0
3	195782177	rs366268	A	G	7	3	10	0	1	11	0	0
3	195782184	rs419059	C	T	6	4	10	0	1	11	0	0
3	195783181	rs41297529	T	A	6	3	9	0	0	9	0	0
3	195784192	rs492349	G	A	4	4	8	0	0	8	0	0
3	195784210	rs492288	C	T	4	4	8	0	0	8	0	0
3	195787308	rs9846149	C	G	11	6	17	0	0	17	0	0
3	195788147	rs2284890	T	C	8	9	17	0	0	17	0	0
3	195788247	rs2284889	G	A	14	14	28	0	0	28	0	0
3	195789169	rs528682	G	A	5	1	6	0	0	6	0	0
3	195789414	rs2239641	T	C	1	5	6	0	0	6	0	0
3	195789708	rs2239640	G	T	18	25	43	0	1	44	0	0
3	195795618	rs112856048	G	A	4	3	7	0	0	7	0	0
3	195796049	rs4927866	G	T	6	4	10	0	0	10	0	0
3	195797553	rs11718657	C	A	8	3	11	0	0	11	0	0
3	195797576	rs11185506	G	C	7	2	9	0	0	9	0	0
3	195797947	rs3761717	G	C	9	14	23	0	0	23	0	0
3	195800811	rs3817672	C	T	74	96	170	0	1	171	0	0
3	195924378	rs112579116	G	A	13	10	23	0	0	23	0	0
3	195925355	rs1106479	C	T	9	17	26	0	0	26	0	0
3	195925419	rs56699931	T	C	9	4	13	0	0	13	0	0
3	195925458	rs1106480	A	C	5	8	13	0	0	13	0	0
3	195955762	rs939885	G	A	1	5	6	0	0	6	0	0
3	195960225	rs9343	A	G	14	8	22	0	0	22	0	0
3	195961254	rs60631199	C	T	19	15	34	0	1	35	0	0
3	195961685	rs1044988	A	G	111	82	193	0	3	196	0	0
3	195962244	rs870339	G	T	24	7	31	0	0	31	0	0
3	195964672	rs77591549	G	A	96	63	159	0	3	163	1	0
3	195964673	rs75470234	A	T	100	63	163	0	0	163	0	0
3	195964687	rs712012	C	T	88	59	147	0	3	150	0	0
3	195965115	rs939883	A	T	66	43	109	0	2	111	0	0
3	195965509	rs3184886	T	C	128	60	188	0	2	190	0	0
3	195965760	rs116712058	A	G	47	130	177	0	2	179	0	0
3	195971438	rs186755436	C	T	2	7	9	0	0	9	0	0
3	196014073	rs6766480	T	C	14	8	22	0	0	22	0	0
3	196054086	rs12054137	C	T	5	1	6	0	0	6	0	0
3	196082411	rs62409216	C	G	71	66	137	0	1	138	0	0
3	196195998	rs73891247	G	A	178	165	343	0	0	343	0	0
3	196196046	rs73213995	C	T	182	142	324	0	1	325	0	0
3	196197804	rs11719920	T	G	54	61	115	0	1	116	0	0
3	196198022	rs111444359	G	A	13	11	24	0	0	24	0	0
3	196199204	rs3796129	G	T	73	67	140	0	2	142	0	0
3	196200190	rs73213996	G	A	3	3	6	0	0	6	0	0
3	196201467	rs113713328	C	T	3	9	12	0	0	12	0	0
3	196201914	rs13098146	G	A	8	4	12	0	0	12	0	0
3	196201942	rs60280349	G	A	9	8	17	0	0	17	0	0
3	196203668	rs34196595	G	A	5	2	7	0	0	7	0	0
3	196212071	rs73214001	T	G	1	6	7	0	0	7	0	0
3	196212282	rs11718980	G	A	4	6	10	0	0	10	0	0
3	196226885	rs73219647	C	T	9	3	12	0	0	12	0	0
3	196227630	rs112647520	T	G	4	2	6	0	0	6	0	0
3	196227727	rs376309509	C	T	5	1	6	0	0	6	0	0
3	196227730	rs566974534	G	C	5	1	6	0	0	6	0	0
3	196227731	rs534420798	T	C	5	1	6	0	0	6	0	0
3	196228360	rs9869437	C	A	7	4	11	0	0	11	0	0
3	196228512	rs73219648	G	A	3	3	6	0	0	6	0	0
3	196230444	rs113586283	G	C	69	60	129	0	0	129	0	0
3	196230564	rs9837291	G	C	19	12	31	0	0	31	0	0
3	196281208	rs9311	T	C	65	69	134	0	1	135	0	0
3	196291470	rs141412257	G	A	3	3	6	0	0	6	0	0
3	196292385	rs9843607	A	G	1	6	7	0	0	7	0	0
3	196313678	.	G	C	83	78	161	0	0	161	0	0
3	196368638	rs6804254	C	T	6	1	7	0	0	7	0	0
3	196370840	rs73221623	C	T	2	5	7	0	0	7	0	0
3	196373207	rs73221625	C	G	2	5	7	0	0	7	0	0
3	196373621	rs11918382	T	C	1	5	6	0	0	6	0	0
3	196377750	rs1798629	C	T	3	4	7	0	0	7	0	0
3	196378705	rs843517	G	A	7	4	11	0	1	12	0	0
3	196379906	rs9848767	C	T	3	3	6	0	0	6	0	0
3	196380607	rs9850631	T	C	7	6	13	0	1	14	0	0
3	196380748	rs35311981	C	G	13	8	21	0	1	22	0	0
3	196381139	rs73221637	G	A	2	7	9	0	0	9	0	0
3	196382011	rs7625234	T	C	19	18	37	0	0	37	0	0
3	196383215	rs9875286	G	T	29	30	59	0	0	59	0	0
3	196384013	rs11717794	T	G	8	9	17	0	0	17	0	0
3	196384359	rs9325375	A	G	15	20	35	0	1	36	0	0
3	196384469	rs71323739	G	C	20	11	31	0	1	32	0	0
3	196384501	rs4912585	C	T	13	20	33	0	0	33	0	0
3	196384519	rs9985448	A	G	19	12	31	0	0	31	0	0
3	196384865	rs4912589	T	C	25	28	53	0	2	55	0	0
3	196385511	rs73221643	C	T	26	18	44	0	0	44	0	0
3	196385700	rs113351305	G	T	36	45	81	0	0	81	0	0
3	196385702	rs7645195	G	A	48	32	80	0	1	81	0	0
3	196460680	rs34830136	C	T	14	15	29	0	0	29	0	0
3	196461390	rs4916542	C	T	11	8	19	0	0	19	0	0
3	196468143	rs1684471	A	G	2	5	7	0	0	7	0	0
3	196468182	rs1627506	G	A	2	4	6	0	0	6	0	0
3	196475274	rs844546	T	G	5	4	9	0	0	9	0	0
3	196475313	rs843540	C	A	7	5	12	0	0	12	0	0
3	196476043	rs1104375	G	C	2	4	6	0	0	6	0	0
3	196476604	rs1798636	G	A	8	4	12	0	0	12	0	0
3	196476639	rs1798637	C	T	6	3	9	0	0	9	0	0
3	196476676	rs2931210	G	C	6	4	10	0	0	10	0	0
3	196476836	rs7638090	A	G	7	4	11	0	1	12	0	0
3	196476880	rs7638157	A	G	3	3	6	0	0	6	0	0
3	196476896	rs7626794	C	T	3	3	6	0	1	7	0	0
3	196476943	rs7626805	C	T	3	6	9	0	0	9	0	0
3	196477006	rs7640538	T	C	9	4	13	0	0	13	0	0
3	196477073	rs7640613	T	C	5	4	9	0	1	10	0	0
3	196477213	rs7648479	G	C	4	10	14	0	0	14	0	0
3	196477369	rs2669637	G	A	3	5	8	0	0	8	0	0
3	196540243	rs7430831	T	C	6	9	15	0	0	15	0	0
3	196540389	rs72611193	C	T	12	5	17	0	0	17	0	0
3	196555422	rs3659	C	G	43	45	88	0	0	88	0	0
3	196555700	rs115360023	C	T	13	15	28	0	0	28	0	0
3	196556121	rs114305365	G	C	33	29	62	0	1	63	0	0
3	196556483	rs9222	G	A	17	6	23	0	1	24	0	0
3	196556809	rs1129168	T	C	9	19	28	0	0	28	0	0
3	196613075	rs34533379	C	T	29	31	60	0	1	61	0	0
3	196621447	rs4916448	A	G	5	1	6	0	0	6	0	0
3	196631138	rs7613138	G	A	1	5	6	0	0	6	0	0
3	196634120	rs74751825	G	A	5	2	7	0	0	7	0	0
3	196636554	rs4916581	C	G	1	5	6	0	0	6	0	0
3	196641105	rs6583189	G	A	4	15	19	0	0	19	0	0
3	196651590	rs9873265	A	G	3	4	7	0	0	7	0	0
3	196654429	rs2054199	C	T	4	9	13	0	0	13	0	0
3	196654536	rs2054200	G	A	6	6	12	0	1	13	0	0
3	196655864	rs111544824	C	T	12	9	21	0	0	21	0	0
3	196656080	rs73080424	T	C	10	10	20	0	0	20	0	0
3	196659891	.	G	T	28	12	40	0	3	43	0	0
3	196660820	rs4916586	C	T	32	45	77	0	1	78	0	0
3	196662275	rs6796963	C	T	3	6	9	0	0	9	0	0
3	196662521	rs6734	G	A	94	126	220	0	0	220	0	0
3	196663122	rs11550120	T	A	67	66	133	0	1	134	0	0
3	196664890	rs516461	T	A	24	33	57	0	0	57	0	0
3	196665654	rs2593977	C	G	13	7	20	0	0	20	0	0
3	196665854	rs555582	A	G	6	11	17	0	0	17	0	0
3	196669912	rs335824	C	T	148	128	276	0	0	276	0	0
3	196669950	rs3732874	G	A	191	181	372	0	7	379	0	0
3	196735808	rs41284045	G	A	6	4	10	0	0	10	0	0
3	196736547	.	G	A	7	10	17	0	1	18	0	0
3	196736575	rs41284047	A	G	8	9	17	0	0	17	0	0
3	196743130	rs6779362	T	C	9	4	13	0	1	14	0	0
3	196769963	rs45469898	T	C	26	20	46	0	0	46	0	0
3	196769982	rs7641	C	G	24	27	51	0	0	51	0	0
3	196796746	rs62409325	T	C	6	2	8	0	0	8	0	0
3	196857790	rs62281755	G	A	15	2	17	0	0	17	0	0
3	196865242	rs1134986	C	T	13	10	23	0	0	23	0	0
3	196896765	rs6766745	G	C	4	4	8	0	0	8	0	0
3	197015386	rs338182	A	G	6	5	11	0	0	11	0	0
3	197015418	rs34305944	C	A	3	5	8	0	0	8	0	0
3	197022240	rs3915512	A	T	0	8	8	0	0	8	0	0
3	197024570	rs338215	C	A	12	12	24	0	0	24	0	0
3	197236843	rs7433302	C	G	8	1	9	0	0	9	0	0
3	197237019	rs9820761	C	T	3	4	7	0	0	7	0	0
3	197238487	rs1050119	C	T	1	5	6	0	0	6	0	0
3	197339908	rs9834939	C	G	3	16	19	0	1	20	0	0
3	197341438	rs76556472	A	G	2	21	23	0	1	24	0	0
3	197341545	rs80243400	T	C	1	6	7	0	0	7	0	0
3	197341546	rs78700248	G	A	1	6	7	0	0	7	0	0
3	197341560	rs111524677	G	T	1	8	9	0	1	10	0	0
3	197341573	rs34080757	C	T	4	13	17	0	0	17	0	0
3	197341591	rs11919940	A	G	4	14	18	0	0	18	0	0
3	197342023	rs4857533	A	G	2	6	8	0	0	8	0	0
3	197342309	rs4857534	C	A	0	9	9	0	0	9	0	0
3	197342353	rs78471347	A	G	1	8	9	0	0	9	0	0
3	197348638	rs11558292	G	A	10	33	43	0	0	43	0	0
3	197349091	rs200375137	G	A	4	5	9	0	0	9	0	0
3	197350172	.	T	C	15	0	15	0	0	15	0	0
3	197361322	rs138704337	G	C	7	2	9	0	0	9	0	0
3	197361353	.	A	G	6	1	7	0	0	7	0	0
3	197400292	rs11543358	A	G	14	22	36	0	0	36	0	0
3	197400511	rs3749250	C	G	23	22	45	0	0	45	0	0
3	197401615	rs76594274	C	T	10	14	24	0	1	25	0	0
3	197401952	rs28562770	T	C	12	12	24	0	0	24	0	0
3	197427557	rs28394098	A	G	11	13	24	0	0	24	0	0
3	197432029	rs60457064	C	A	7	4	11	0	0	11	0	0
3	197432036	rs61743568	C	T	7	4	11	0	0	11	0	0
3	197457489	rs112622269	G	C	12	9	21	0	0	21	0	0
3	197458193	rs9870714	G	A	10	7	17	0	0	17	0	0
3	197514250	rs115740702	C	T	14	15	29	0	0	29	0	0
3	197584236	.	C	T	3	3	6	0	0	6	0	0
3	197610609	rs114390216	G	A	9	8	17	0	0	17	0	0
3	197907711	.	C	T	5	4	9	0	0	9	0	0
4	54546	.	C	T	61	0	61	0	0	61	0	0
4	55372	.	G	C	21	0	21	0	0	21	0	0
4	55440	.	A	T	23	1	24	0	0	24	0	0
4	57088	.	T	G	34	0	34	0	1	35	0	0
4	60210	.	G	A	7	0	7	0	0	7	0	0
4	60400	.	G	A	6	0	6	0	0	6	0	0
4	60570	.	G	A	6	0	6	0	0	6	0	0
4	61046	.	T	C	9	0	9	0	0	9	0	0
4	61834	.	G	A	6	0	6	0	0	6	0	0
4	63024	.	G	A	20	0	20	0	0	20	0	0
4	63483	.	A	G	6	0	6	0	0	6	0	0
4	63535	.	C	T	6	0	6	0	0	6	0	0
4	67846	.	C	A	15	0	15	0	0	15	0	0
4	68443	.	A	T	38	0	38	0	0	38	0	0
4	68507	rs9985518;rs878895106	A	T	22	0	22	0	0	22	0	0
4	68603	.	T	G	18	0	18	0	0	18	0	0
4	77885	.	C	T	3	3	6	0	0	6	0	0
4	86276	rs148652224	A	G	101	61	162	0	3	165	0	0
4	126959	rs111372941	C	T	14	8	22	0	0	22	0	0
4	127452	rs7699689	A	G	5	1	6	0	0	6	0	0
4	127978	rs7660115	T	C	10	1	11	0	0	11	0	0
4	127991	rs113792592	G	A	7	0	7	0	0	7	0	0
4	128484	rs111738223	T	G	5	2	7	0	0	7	0	0
4	493032	.	G	A	3	3	6	0	0	6	0	0
4	514201	rs11730564	G	T	10	10	20	0	0	20	0	0
4	666514	rs189694890	G	A	8	8	16	0	0	16	0	0
4	731603	rs77221077	G	T	6	5	11	0	0	11	0	0
4	731895	rs78528162	G	C	3	5	8	0	0	8	0	0
4	733045	rs11723111	G	A	4	2	6	0	1	7	0	0
4	733334	rs13133410	C	T	10	5	15	0	0	15	0	0
4	733498	rs78036858	C	T	5	22	27	0	0	27	0	0
4	733733	rs78900947	G	A	9	18	27	0	0	27	0	0
4	734351	rs11729193	A	G	21	26	47	0	1	48	0	0
4	734603	rs11248037	C	T	34	20	54	0	0	54	0	0
4	734677	rs747504	G	A	23	32	55	0	0	55	0	0
4	735486	rs111652071	C	T	16	30	46	0	0	46	0	0
4	748817	.	G	A	2	5	7	0	0	7	0	0
4	752166	rs55955900	C	T	2	4	6	0	0	6	0	0
4	753807	rs6823876	T	C	2	6	8	0	0	8	0	0
4	754401	rs73222807	C	T	7	3	10	0	0	10	0	0
4	755129	rs2242234	C	T	80	97	177	0	2	179	0	0
4	756377	rs4690309	T	C	3	3	6	0	0	6	0	0
4	762285	rs17164985	A	G	49	43	92	0	1	93	0	0
4	762963	rs1026740	A	G	66	44	110	0	0	110	0	0
4	763077	rs1044147	G	A	75	57	132	0	3	135	0	0
4	763630	rs1044180	C	T	143	117	260	0	2	262	0	0
4	765656	rs56199932	A	C	2	4	6	0	0	6	0	0
4	771642	rs55715360	T	G	3	4	7	0	0	7	0	0
4	843184	rs6964	G	A	121	138	259	0	1	260	0	0
4	843695	rs8093	A	G	110	98	208	0	1	209	0	0
4	843720	rs2306242	T	C	131	98	229	0	3	232	0	0
4	847098	rs79006606	C	G	6	8	14	0	1	15	0	0
4	847462	rs9993159	T	C	5	3	8	0	0	8	0	0
4	849012	rs79964683	G	A	10	6	16	0	0	16	0	0
4	850380	.	G	C	7	0	7	0	0	7	0	0
4	850389	.	G	C	6	0	6	0	0	6	0	0
4	850491	rs2878358	T	C	6	3	9	0	1	10	0	0
4	850551	rs74358512	C	T	3	3	6	0	0	6	0	0
4	851258	rs76370559	G	A	2	5	7	0	0	7	0	0
4	852407	rs75374083	A	T	3	7	10	0	1	11	0	0
4	856734	rs74282745	C	T	4	3	7	0	0	7	0	0
4	859016	rs142955360	C	T	62	58	120	0	3	123	0	0
4	860192	rs1064207	A	G	79	70	149	0	1	150	0	0
4	867516	rs75295122	G	A	3	9	12	0	0	12	0	0
4	877412	rs11736181	C	T	2	5	7	0	0	7	0	0
4	877709	rs3736083	T	C	3	4	7	0	0	7	0	0
4	878917	rs6837528	G	A	2	5	7	0	1	8	0	0
4	879977	rs62297079	G	A	1	5	6	0	0	6	0	0
4	880094	rs17781378	T	C	3	3	6	0	0	6	0	0
4	888170	rs12499663	G	A	12	9	21	0	2	23	0	0
4	888361	rs34509509	C	A	11	7	18	0	0	18	0	0
4	891503	rs3775124	C	G	2	8	10	0	0	10	0	0
4	893687	rs3775120	G	A	4	2	6	0	0	6	0	0
4	896163	rs73209865	C	T	5	1	6	0	0	6	0	0
4	897403	rs3822022	A	G	1	5	6	0	0	6	0	0
4	900786	rs3775114	C	T	3	3	6	0	1	7	0	0
4	901323	rs3775113	C	T	5	2	7	0	0	7	0	0
4	961397	rs2305487	C	T	8	4	12	0	0	12	0	0
4	1004416	.	C	G	5	5	10	0	0	10	0	0
4	1161190	rs17164382	C	T	10	14	24	0	0	24	0	0
4	1161480	rs17164384	C	T	4	2	6	0	0	6	0	0
4	1165748	rs6836335	T	C	3	8	11	0	2	13	0	0
4	1166171	rs6812059	C	T	5	4	9	0	0	9	0	0
4	1167865	rs77180393	G	A	3	6	9	0	0	9	0	0
4	1212330	rs6840180	A	G	2	9	11	0	0	11	0	0
4	1214709	rs77965665	C	A	2	4	6	0	0	6	0	0
4	1236083	rs3755934	C	T	8	13	21	0	0	21	0	0
4	1236312	rs3822017	C	T	16	8	24	0	1	25	0	0
4	1236502	rs73069940	C	G	8	19	27	0	1	28	0	0
4	1236562	rs1564509	C	G	17	9	26	0	0	26	0	0
4	1237968	rs2335855	T	C	10	5	15	0	1	16	0	0
4	1238230	rs112869746	C	T	8	5	13	0	0	13	0	0
4	1238246	rs3755927	G	A	5	5	10	0	1	11	0	0
4	1238859	rs3775094	G	A	6	5	11	0	0	11	0	0
4	1239370	rs11733130	C	T	7	3	10	0	1	11	0	0
4	1240962	rs3775092	C	G	8	2	10	0	0	10	0	0
4	1243877	rs2878539	C	T	8	2	10	0	0	10	0	0
4	1244037	rs4974541	A	G	14	19	33	0	0	33	0	0
4	1244218	rs79407053	G	A	18	10	28	0	0	28	0	0
4	1244267	rs2291199	A	G	6	12	18	0	0	18	0	0
4	1244682	rs11554784	A	C	9	7	16	0	0	16	0	0
4	1244879	rs1564508	A	G	17	30	47	0	0	47	0	0
4	1245277	rs2279281	T	G	12	24	36	0	1	37	0	0
4	1245990	rs12642797	G	A	30	30	60	0	0	60	0	0
4	1246038	rs72501962	A	T	30	31	61	0	0	61	0	0
4	1314353	rs4974548	T	C	1	5	6	0	0	6	0	0
4	1328297	rs10024996	G	A	7	1	8	0	0	8	0	0
4	1329116	rs7664474	T	A	8	4	12	0	0	12	0	0
4	1329243	rs35705197	A	G	7	5	12	0	0	12	0	0
4	1329348	rs34180507	A	G	8	3	11	0	0	11	0	0
4	1329350	rs35520540	T	C	8	3	11	0	0	11	0	0
4	1329360	rs36105735	T	C	8	3	11	0	0	11	0	0
4	1330759	rs1128427	T	C	56	50	106	0	0	106	0	0
4	1330983	rs13135102	A	C	13	12	25	0	1	26	0	0
4	1332175	rs13147602	A	G	18	16	34	0	0	34	0	0
4	1342521	rs2293630	G	A	5	1	6	0	0	6	0	0
4	1343168	rs4974603	C	T	5	2	7	0	0	7	0	0
4	1343405	rs2276903	T	C	8	6	14	0	0	14	0	0
4	1343720	rs11247994	G	A	5	2	7	0	0	7	0	0
4	1369885	rs11724369	G	A	5	2	7	0	1	8	0	0
4	1379494	rs78013320	G	A	4	2	6	0	0	6	0	0
4	1385882	rs35852462	T	A	3	3	6	0	0	6	0	0
4	1386459	rs13114537	G	C	3	9	12	0	0	12	0	0
4	1386570	rs13142985	A	G	4	6	10	0	0	10	0	0
4	1387275	rs34299899	A	G	2	7	9	0	0	9	0	0
4	1388413	rs78309237	T	C	11	15	26	0	3	29	0	0
4	1388429	rs79298048	G	A	14	11	25	0	5	30	0	0
4	1389101	rs71614971	A	G	6	2	8	0	0	8	0	0
4	1389161	rs71614973	A	G	5	1	6	0	1	7	0	0
4	1694809	rs8051	T	C	209	180	389	0	3	392	0	0
4	1697337	rs34049648	G	A	31	15	46	0	0	46	0	0
4	1701317	rs2247341	G	A	242	184	426	0	4	430	0	0
4	1715003	rs79974263	A	G	16	16	32	0	0	32	0	0
4	1715250	rs2854921	C	T	14	13	27	0	0	27	0	0
4	1718883	rs2236787	A	T	15	16	31	0	0	31	0	0
4	1719620	rs743569	T	G	8	3	11	0	0	11	0	0
4	1719633	rs712982	A	C	4	7	11	0	0	11	0	0
4	1719758	rs17802841	A	G	7	7	14	0	0	14	0	0
4	1719817	rs712983	A	G	3	9	12	0	0	12	0	0
4	1720550	rs2854917	T	C	11	2	13	0	0	13	0	0
4	1720794	rs61675353	T	G	14	6	20	0	0	20	0	0
4	1721002	rs115285310	C	T	4	8	12	0	1	13	0	0
4	1721348	rs2854916	G	A	3	3	6	0	0	6	0	0
4	1722187	rs1793990	G	A	4	2	6	0	0	6	0	0
4	1723292	rs115455600	C	T	6	6	12	0	0	12	0	0
4	1725685	rs41286673	C	A	0	7	7	0	0	7	0	0
4	1727603	rs1794002	A	G	1	6	7	0	0	7	0	0
4	1729154	rs1665368	G	A	3	9	12	0	0	12	0	0
4	1729347	rs1793997	A	G	4	8	12	0	0	12	0	0
4	1729348	rs2854908	T	A	4	8	12	0	0	12	0	0
4	1729425	rs2592828	C	G	5	9	14	0	0	14	0	0
4	1729556	rs34205238	G	A	57	43	100	0	0	100	0	0
4	1730215	rs798757	C	G	90	56	146	0	1	147	0	0
4	1730299	rs798759	A	G	100	57	157	0	3	160	0	0
4	1731126	rs798761	G	A	17	6	23	0	0	23	0	0
4	1731345	rs3819382	A	G	16	8	24	0	0	24	0	0
4	1731621	rs798763	T	C	14	14	28	0	0	28	0	0
4	1732230	rs3819376	T	C	9	10	19	0	0	19	0	0
4	1733731	rs57456249	C	T	18	17	35	0	0	35	0	0
4	1733888	rs112558308	G	A	7	16	23	0	0	23	0	0
4	1734446	rs9985880	A	G	8	3	11	0	0	11	0	0
4	1735236	rs28553325	T	A	7	9	16	0	0	16	0	0
4	1735387	rs55888408	A	T	7	9	16	0	1	17	0	0
4	1735446	rs111653571	C	T	10	1	11	0	0	11	0	0
4	1736544	rs28425493	C	T	8	5	13	0	0	13	0	0
4	1736737	rs28499138	T	C	7	9	16	0	0	16	0	0
4	1737071	rs17681032	C	A	6	8	14	0	0	14	0	0
4	1737108	rs3752747	C	T	8	2	10	0	0	10	0	0
4	1737502	rs11248073	C	T	128	134	262	0	2	264	0	0
4	1738129	rs7676700	A	G	4	6	10	0	0	10	0	0
4	1738313	rs11730727	T	C	11	7	18	0	0	18	0	0
4	1738580	rs28558469	G	T	17	13	30	0	1	31	0	0
4	1739976	rs28716870	C	T	25	42	67	0	0	67	0	0
4	1740675	rs13138643	G	A	61	45	106	0	0	106	0	0
4	1740985	rs10022431	A	C	25	47	72	0	1	73	0	0
4	1741325	rs2077363	A	G	47	72	119	0	4	123	0	0
4	1741663	rs111894970	G	A	4	6	10	0	0	10	0	0
4	1741740	rs2249143	G	A	15	11	26	0	0	26	0	0
4	1742150	rs113368208	T	C	17	11	28	0	0	28	0	0
4	1742342	rs78738426	G	A	17	9	26	0	0	26	0	0
4	1742779	rs1530588	G	A	14	12	26	0	0	26	0	0
4	1743336	rs7654245	C	T	18	12	30	0	0	30	0	0
4	1743366	rs76927797	A	G	17	15	32	0	0	32	0	0
4	1743754	rs11248074	C	T	7	14	21	0	0	21	0	0
4	1744252	rs2403293	A	G	23	14	37	0	0	37	0	0
4	1744939	rs11736125	C	T	6	21	27	0	2	29	0	0
4	1744943	rs55670131	A	G	20	6	26	0	1	27	0	0
4	1745345	rs9990541	A	G	33	24	57	0	0	57	0	0
4	1745486	rs4865465	G	A	45	42	87	0	0	87	0	0
4	1745492	rs4865466	C	T	44	44	88	0	0	88	0	0
4	1745770	rs28420470	A	G	47	29	76	0	1	77	0	0
4	1746229	rs2290011	G	T	58	63	121	0	2	123	0	0
4	1980251	.	C	G	8	8	16	0	0	16	0	0
4	1981229	rs73202837	G	T	78	76	154	0	0	154	0	0
4	1981256	rs1132849	T	G	77	80	157	0	0	157	0	0
4	2470956	rs71606399	G	A	73	88	161	0	1	162	0	0
4	2492191	rs34742072	T	C	73	57	130	0	3	133	0	0
4	2512016	rs1203849	G	C	5	3	8	0	0	8	0	0
4	2512054	rs2282765	A	G	5	7	12	0	1	13	0	0
4	2515277	rs2354513	G	C	6	8	14	0	0	14	0	0
4	2516903	rs71608205	C	T	213	140	353	0	1	354	0	0
4	2592655	.	G	A	2	4	6	0	0	6	0	0
4	2652053	rs141926929	G	A	4	2	6	0	0	6	0	0
4	2658327	rs2282766	G	A	3	4	7	0	0	7	0	0
4	2658755	rs2282767	G	C	3	3	6	0	0	6	0	0
4	2702115	rs17681870	A	G	62	56	118	0	1	119	0	0
4	2728804	rs13113593	G	A	6	4	10	0	0	10	0	0
4	2732690	rs232725	G	A	5	4	9	0	0	9	0	0
4	2743433	rs7461	G	A	33	50	83	0	0	83	0	0
4	2744087	rs2269495	G	A	105	72	177	0	1	178	0	0
4	2744937	rs3733226	G	A	23	19	42	0	2	44	0	0
4	2745734	rs3733222	G	A	20	14	34	0	0	34	0	0
4	2746286	rs13135456	C	A	20	21	41	0	0	41	0	0
4	2746898	rs762856	C	T	27	34	61	0	1	62	0	0
4	2747008	rs75040025	C	T	37	30	67	0	0	67	0	0
4	2748663	rs4690055	G	A	3	4	7	0	0	7	0	0
4	2750118	rs57796386	C	T	2	4	6	0	0	6	0	0
4	2750119	rs13138665	G	T	4	2	6	0	0	6	0	0
4	2751346	rs56128852	C	T	5	3	8	0	0	8	0	0
4	2757800	rs74548850	G	C	14	7	21	0	0	21	0	0
4	2801373	rs231340	T	G	4	2	6	0	0	6	0	0
4	2822467	rs231402	G	T	35	41	76	0	1	77	0	0
4	2836195	rs73189445	C	A	61	70	131	0	2	133	0	0
4	2836628	rs231394	C	T	51	41	92	0	0	92	0	0
4	2837763	rs1263416	G	C	87	67	154	0	0	154	0	0
4	2839438	rs735794	G	C	30	28	58	0	0	58	0	0
4	2839659	rs9715869	G	A	24	28	52	0	0	52	0	0
4	2840395	rs147679025	G	A	27	27	54	0	1	55	0	0
4	2841240	rs4690002	T	C	24	21	45	0	1	46	0	0
4	2860520	rs10031688	C	A	5	6	11	0	0	11	0	0
4	2906285	rs2285084	A	G	5	2	7	0	0	7	0	0
4	2906707	rs4961	G	T	94	105	199	0	5	204	0	0
4	2909194	rs12642795	G	A	8	4	12	0	0	12	0	0
4	2915369	rs2237005	G	T	4	6	10	0	0	10	0	0
4	2916762	rs4963	C	G	121	100	221	0	2	223	0	0
4	2928223	rs34209081	C	T	3	3	6	0	0	6	0	0
4	2929023	rs1263347	T	C	5	3	8	0	0	8	0	0
4	2929729	.	C	A	4	9	13	0	0	13	0	0
4	2931243	rs35640772	T	C	263	235	498	0	4	502	0	0
4	2934308	rs1263349	G	A	50	58	108	0	0	108	0	0
4	2935251	rs2301374	T	A	27	61	88	0	5	93	0	0
4	2937133	rs76568071	C	T	7	7	14	0	0	14	0	0
4	2937485	rs1419045	T	G	14	10	24	0	0	24	0	0
4	2937603	rs78405901	C	G	9	16	25	0	0	25	0	0
4	2938687	rs10030687	G	A	6	1	7	0	0	7	0	0
4	2939018	rs1263338	C	T	6	8	14	0	1	15	0	0
4	2941988	rs2032463	T	C	9	7	16	0	0	16	0	0
4	2942073	rs1475974	T	C	10	7	17	0	0	17	0	0
4	2942539	rs1263336	T	C	5	3	8	0	0	8	0	0
4	2943361	rs1054090	T	C	68	69	137	0	1	138	0	0
4	2943672	rs2960296	G	C	3	4	7	0	0	7	0	0
4	2944620	rs12502773	T	C	8	5	13	0	0	13	0	0
4	2944746	rs57191180	T	C	5	3	8	0	1	9	0	0
4	2944850	.	C	T	4	6	10	0	0	10	0	0
4	2945109	rs148444335	C	T	3	7	10	0	0	10	0	0
4	2946802	rs28474697	C	T	8	5	13	0	0	13	0	0
4	2951804	rs2515960	A	G	42	57	99	0	2	101	0	0
4	2955145	rs1475977	T	C	3	13	16	0	0	16	0	0
4	2955192	rs1475976	C	G	6	11	17	0	0	17	0	0
4	2960430	rs2515963	C	T	4	3	7	0	0	7	0	0
4	2963907	rs77705027	G	C	1	5	6	0	0	6	0	0
4	2964388	rs2488813	T	A	4	4	8	0	0	8	0	0
4	2971497	rs2185886	T	C	4	2	6	0	0	6	0	0
4	3117579	rs17780797	T	C	2	4	6	0	0	6	0	0
4	3162056	rs363099	C	T	40	40	80	0	1	81	0	0
4	3182849	rs66684864	T	G	10	11	21	0	0	21	0	0
4	3184464	rs2269477	G	T	5	4	9	0	0	9	0	0
4	3185747	rs2298967	T	C	13	15	28	0	0	28	0	0
4	3186244	rs2298969	A	G	10	12	22	0	0	22	0	0
4	3188616	rs188072823	C	T	9	4	13	0	0	13	0	0
4	3190486	rs6844859	T	C	29	32	61	0	1	62	0	0
4	3213832	rs362336	G	A	60	60	120	0	1	121	0	0
4	3215835	rs362331	T	C	71	91	162	0	0	162	0	0
4	3216815	rs916171	C	G	3	8	11	0	0	11	0	0
4	3218739	rs10011326	A	G	4	4	8	0	1	9	0	0
4	3227419	rs362273	A	G	93	103	196	0	3	199	0	0
4	3228492	rs2237006	A	G	24	32	56	0	0	56	0	0
4	3228966	.	T	G	38	25	63	0	1	64	0	0
4	3230804	rs2530598	A	C	7	6	13	0	0	13	0	0
4	3231148	rs111065364	G	C	9	3	12	0	0	12	0	0
4	3232257	rs3121419	C	T	17	17	34	0	0	34	0	0
4	3234828	rs2269478	G	T	9	14	23	0	0	23	0	0
4	3234980	rs362272	G	A	157	152	309	0	2	311	0	0
4	3235241	rs362314	A	G	7	5	12	0	0	12	0	0
4	3235450	rs2237007	T	C	10	5	15	0	0	15	0	0
4	3235518	rs362271	G	A	11	4	15	0	0	15	0	0
4	3236135	rs362270	G	T	9	15	24	0	0	24	0	0
4	3236632	rs2530596	T	C	14	9	23	0	0	23	0	0
4	3237644	rs362312	T	C	5	2	7	0	0	7	0	0
4	3238754	rs3775061	A	G	4	2	6	0	0	6	0	0
4	3238981	rs3135175	A	G	5	4	9	0	0	9	0	0
4	3239702	rs2269499	C	T	2	4	6	0	0	6	0	0
4	3240159	rs2071704	C	T	5	5	10	0	1	11	0	0
4	3240915	rs362309	G	C	28	28	56	0	1	57	0	0
4	3241413	rs2071703	A	C	16	34	50	0	0	50	0	0
4	3241845	rs362307	C	T	339	351	690	0	2	692	0	0
4	3242100	rs362306	G	A	282	288	570	0	6	576	0	0
4	3242148	rs362268	C	G	311	356	667	0	5	672	0	0
4	3242240	rs371097921	C	T	292	272	564	0	3	567	0	0
4	3243218	rs362267	C	T	38	39	77	0	0	77	0	0
4	3318413	rs2236052	A	G	3	3	6	0	0	6	0	0
4	3417845	rs3213507	G	C	1	5	6	0	0	6	0	0
4	3433782	rs1055711	T	A	2	12	14	0	0	14	0	0
4	3509259	rs2858029	C	T	4	5	9	0	0	9	0	0
4	3509260	rs71608285	G	A	5	4	9	0	0	9	0	0
4	3510598	rs3182	G	A	2	8	10	0	0	10	0	0
4	3510769	rs10001975	G	A	4	3	7	0	0	7	0	0
4	3512137	rs10014466	C	T	9	2	11	0	0	11	0	0
4	3512563	rs1794423	C	T	2	10	12	0	0	12	0	0
4	3513205	rs1741555	C	G	1	5	6	0	0	6	0	0
4	3514229	rs2077130	T	C	6	5	11	0	0	11	0	0
4	3514695	rs6789	A	G	377	283	660	0	9	670	1	0
4	3517049	rs1741550	T	C	2	6	8	0	0	8	0	0
4	3517389	rs13129212	A	G	2	4	6	0	0	6	0	0
4	3517732	rs1794444	G	C	5	6	11	0	0	11	0	0
4	3517746	rs138493591	A	C	4	4	8	0	0	8	0	0
4	3518274	rs1800491	A	C	35	26	61	0	1	62	0	0
4	3518447	rs1730778	T	C	26	16	42	0	1	43	0	0
4	3518507	rs34327156	G	C	13	18	31	0	0	31	0	0
4	3518577	rs1730776	C	T	18	10	28	0	0	28	0	0
4	3518680	rs1622883	G	A	22	8	30	0	1	31	0	0
4	3519054	rs1613915	G	A	25	13	38	0	0	38	0	0
4	3519762	rs13325	A	G	289	304	593	0	5	598	0	0
4	3521939	rs1741547	T	A	7	4	11	0	0	11	0	0
4	3525057	rs1730775	G	A	3	3	6	0	0	6	0	0
4	3525257	rs13117941	G	T	3	4	7	0	0	7	0	0
4	3527046	rs17202256	C	T	11	9	20	0	0	20	0	0
4	3528846	rs13125213	A	G	2	7	9	0	0	9	0	0
4	3530294	rs1076898	C	T	7	2	9	0	0	9	0	0
4	3530529	.	T	C	7	3	10	0	0	10	0	0
4	3530770	rs62272716	G	A	4	7	11	0	0	11	0	0
4	3533219	rs1741543	C	G	3	3	6	0	0	6	0	0
4	4239402	.	T	C	10	0	10	0	0	10	0	0
4	4239516	rs62286913	C	T	9	0	9	0	0	9	0	0
4	4239539	.	C	T	9	0	9	0	1	10	0	0
4	4242527	rs13146382	G	A	6	1	7	0	0	7	0	0
4	4249483	rs2916466	C	T	6	6	12	0	0	12	0	0
4	4249884	rs6854167	G	T	8	6	14	0	0	14	0	0
4	4276198	rs41264703	C	T	13	18	31	0	0	31	0	0
4	4276475	rs2272739	C	T	22	21	43	0	0	43	0	0
4	4421055	rs2044	T	C	28	14	42	0	2	44	0	0
4	4421619	rs35705307	G	A	61	63	124	0	1	125	0	0
4	4423597	rs34465931	G	A	6	0	6	0	0	6	0	0
4	4425640	rs11931787	G	A	6	3	9	0	0	9	0	0
4	4428728	rs28564055	A	C	6	4	10	0	0	10	0	0
4	4428761	rs28733402	T	C	6	6	12	0	0	12	0	0
4	4428852	rs58612183	A	C	4	3	7	0	0	7	0	0
4	4428883	rs4348043	A	G	3	3	6	0	0	6	0	0
4	4436517	rs33952588	A	T	41	46	87	0	1	88	0	0
4	4440183	rs61740788	T	G	49	27	76	0	1	77	0	0
4	4510413	rs4689777	C	T	3	3	6	0	0	6	0	0
4	6594947	rs2301796	A	C	9	6	15	0	0	15	0	0
4	6619204	rs4689490	G	A	9	6	15	0	0	15	0	0
4	6620602	rs3733603	C	G	5	3	8	0	0	8	0	0
4	6622140	rs7654130	C	A	4	2	6	0	0	6	0	0
4	6623332	rs3088248	G	A	10	12	22	0	0	22	0	0
4	6644327	rs7660424	A	G	409	448	857	0	5	862	0	0
4	6675421	rs1133576	C	T	8	4	12	0	0	12	0	0
4	6676485	rs7662433	G	A	23	6	29	0	0	29	0	0
4	6676524	rs7662452	G	A	29	7	36	0	0	36	0	0
4	6677063	rs2301787	G	A	133	58	191	0	5	197	1	0
4	6677430	rs11553058	A	G	76	165	241	0	1	242	0	0
4	6696460	rs58654929	G	A	10	6	16	0	0	16	0	0
4	6696524	rs58986571	T	C	11	3	14	0	0	14	0	0
4	6697166	rs4689034	T	C	6	7	13	0	0	13	0	0
4	6697176	rs4689521	A	G	6	3	9	0	1	10	0	0
4	6697356	rs3822266	C	T	11	5	16	0	0	16	0	0
4	6697554	rs3822265	C	G	5	6	11	0	0	11	0	0
4	6697673	rs3822263	T	C	7	4	11	0	0	11	0	0
4	6697766	rs3822262	T	G	7	6	13	0	0	13	0	0
4	6697795	rs3822261	A	C	5	6	11	0	0	11	0	0
4	6697822	rs3822260	C	T	3	6	9	0	0	9	0	0
4	6698567	rs74666034	G	A	21	22	43	0	0	43	0	0
4	6718811	rs11550047	A	G	137	132	269	0	0	269	0	0
4	6883514	rs3822268	A	G	107	71	178	0	2	180	0	0
4	6988238	rs3857168	C	T	4	11	15	0	0	15	0	0
4	7018195	rs11732301	G	A	4	2	6	0	0	6	0	0
4	7032924	rs3756255	A	T	52	43	95	0	0	95	0	0
4	7033671	rs12119	C	T	49	60	109	0	0	109	0	0
4	7058882	rs10937783	A	T	5	11	16	0	0	16	0	0
4	7743283	rs13442	T	G	5	5	10	0	0	10	0	0
4	7744046	rs12642285	G	A	6	12	18	0	0	18	0	0
4	8207083	rs2677605	A	G	4	3	7	0	0	7	0	0
4	8228948	rs55642964	T	C	4	8	12	0	0	12	0	0
4	8234381	rs3775905	T	C	6	9	15	0	0	15	0	0
4	8234904	rs1281093	G	A	16	12	28	0	1	29	0	0
4	8234929	rs2291072	A	C	12	13	25	0	2	27	0	0
4	8238151	rs11603	C	T	15	27	42	0	0	42	0	0
4	8297770	rs13130469	A	G	5	3	8	0	0	8	0	0
4	8368433	rs7809	G	A	1	6	7	0	0	7	0	0
4	8368604	rs708244	C	T	7	7	14	0	0	14	0	0
4	8512712	rs3103097	A	G	2	5	7	0	0	7	0	0
4	8514233	rs4696836	T	C	2	4	6	0	0	6	0	0
4	10092310	.	C	T	29	26	55	0	0	55	0	0
4	10099420	.	C	T	221	209	430	0	1	431	0	0
4	10443384	rs4422413	T	G	11	5	16	0	2	18	0	0
4	10443425	rs10938799	G	A	11	14	25	0	0	25	0	0
4	10444650	rs3217	C	T	19	16	35	0	0	35	0	0
4	10446906	rs10016022	A	G	5	3	8	0	0	8	0	0
4	10447168	rs66538112	C	G	8	10	18	0	0	18	0	0
4	10452763	rs7674156	G	C	8	4	12	0	0	12	0	0
4	10454994	rs12019277	C	A	8	2	10	0	0	10	0	0
4	13595670	rs191513717	C	T	4	7	11	0	0	11	0	0
4	13604034	rs61995956	T	C	18	26	44	0	0	44	0	0
4	15004655	rs7435318	G	A	11	9	20	0	1	21	0	0
4	15005604	rs112476821	G	A	5	2	7	0	0	7	0	0
4	15009232	rs1874207	C	T	4	4	8	0	0	8	0	0
4	15010590	rs2047205	A	G	7	4	11	0	0	11	0	0
4	15012764	rs2643089	A	G	6	12	18	0	1	19	0	0
4	15607857	rs6823775	C	A	3	3	6	0	0	6	0	0
4	15608175	rs6824422	C	T	6	16	22	0	0	22	0	0
4	15608551	rs10433813	A	G	1	7	8	0	0	8	0	0
4	15611017	rs35120298	T	C	3	3	6	0	0	6	0	0
4	15619568	rs13134177	A	G	12	8	20	0	0	20	0	0
4	15620327	rs10939627	T	C	5	8	13	0	0	13	0	0
4	15620332	rs10939628	G	A	5	9	14	0	0	14	0	0
4	15620408	rs34910084	T	C	12	10	22	0	0	22	0	0
4	15623418	rs10017222	A	T	26	19	45	0	1	46	0	0
4	15624519	rs10008889	C	G	15	25	40	0	0	40	0	0
4	15625449	rs6833704	G	A	122	115	237	0	28	297	32	0
4	15625682	rs10026851	C	T	154	111	265	0	2	267	0	0
4	15625743	rs28447067	G	A	110	115	225	0	1	226	0	0
4	15626243	rs7682586	G	A	68	55	123	0	2	125	0	0
4	15626280	rs73239201	A	C	55	45	100	0	3	103	0	0
4	15626447	rs6449152	A	G	71	94	165	0	2	167	0	0
4	15626475	rs6414764	C	T	71	92	163	0	0	163	0	0
4	15628809	rs62290586	G	C	3	7	10	0	1	11	0	0
4	15629080	rs12645849	G	A	7	4	11	0	1	12	0	0
4	15629409	rs62290588	T	C	8	9	17	0	0	17	0	0
4	15629827	rs4698403	T	G	1	5	6	0	0	6	0	0
4	15630737	rs6826058	C	T	2	5	7	0	0	7	0	0
4	15630849	rs35013326	G	A	3	5	8	0	0	8	0	0
4	15631068	rs4346644	C	T	3	9	12	0	0	12	0	0
4	15632021	rs62290591	G	A	2	4	6	0	1	7	0	0
4	15632732	rs10015827	A	G	7	7	14	0	0	14	0	0
4	15633111	rs77743450	G	A	32	27	59	0	0	59	0	0
4	15633160	rs6839438	G	A	28	23	51	0	0	51	0	0
4	15634145	rs11945626	G	A	14	9	23	0	0	23	0	0
4	15636911	rs11732953	G	A	3	3	6	0	0	6	0	0
4	15637198	rs12509029	G	A	5	3	8	0	0	8	0	0
4	15637258	rs62290592	C	T	5	5	10	0	0	10	0	0
4	15655698	rs872678	T	C	2	4	6	0	0	6	0	0
4	15669484	rs7687010	G	T	22	30	52	0	0	52	0	0
4	15674814	rs10030313	G	C	2	5	7	0	0	7	0	0
4	15679371	rs7434484	T	C	14	19	33	0	0	33	0	0
4	15679852	rs4301111	A	T	8	10	18	0	0	18	0	0
4	15681414	rs34473224	A	C	12	14	26	0	0	26	0	0
4	15681536	rs62290605	T	C	16	11	27	0	1	28	0	0
4	15682239	rs12650632	C	G	7	13	20	0	0	20	0	0
4	15683318	rs13150957	C	T	27	46	73	0	1	74	0	0
4	15689632	rs11729955	G	A	5	3	8	0	0	8	0	0
4	15689928	rs4235380	G	A	2	7	9	0	0	9	0	0
4	15706790	rs3756246	T	A	4	6	10	0	0	10	0	0
4	15739498	rs997250	A	G	4	3	7	0	0	7	0	0
4	15782155	.	A	G	5	2	7	0	0	7	0	0
4	15785201	rs4580644	C	T	8	8	16	0	0	16	0	0
4	15785659	rs3796878	C	T	19	25	44	0	0	44	0	0
4	15794060	rs7669673	T	A	6	4	10	0	0	10	0	0
4	15794069	rs7685848	G	A	4	4	8	0	1	9	0	0
4	15852104	rs17476066	T	C	13	4	17	0	0	17	0	0
4	15853013	rs4396987	C	A	13	19	32	0	0	32	0	0
4	15853684	rs13133313	T	C	15	24	39	0	0	39	0	0
4	15854420	rs6858536	G	A	27	21	48	0	5	53	0	0
4	15854725	rs3733593	G	A	51	47	98	0	0	98	0	0
4	15964485	rs758329	G	A	4	2	6	0	0	6	0	0
4	15964501	rs2286459	G	A	2	4	6	0	0	6	0	0
4	15969938	rs3130	T	C	72	44	116	0	0	116	0	0
4	15970349	rs2240688	T	G	97	63	160	0	0	160	0	0
4	15971082	rs35366218	A	G	6	0	6	0	0	6	0	0
4	15972905	rs11735976	T	C	5	2	7	0	0	7	0	0
4	15977828	rs3796859	C	G	2	5	7	0	0	7	0	0
4	15977980	rs3796858	C	A	6	9	15	0	0	15	0	0
4	15978245	rs11944619	A	G	6	2	8	0	0	8	0	0
4	16039097	rs6818582	T	A	6	2	8	0	0	8	0	0
4	16040617	rs76963591	C	T	12	9	21	0	0	21	0	0
4	16076892	rs11733197	A	G	5	9	14	0	0	14	0	0
4	16163709	rs11934569	C	A	137	110	247	0	0	247	0	0
4	16163966	rs151045647	C	G	139	72	211	0	1	212	0	0
4	16164230	rs10516298	T	C	42	68	110	0	1	111	0	0
4	16167954	rs2271749	C	T	17	9	26	0	0	26	0	0
4	16168246	rs2271748	C	T	11	5	16	0	0	16	0	0
4	16168512	rs11724423	C	A	34	32	66	0	1	67	0	0
4	16168707	rs111676522	T	A	9	7	16	0	1	17	0	0
4	16168862	rs6834015	C	A	14	12	26	0	0	26	0	0
4	16169219	rs74527416	G	C	50	33	83	0	0	83	0	0
4	16170164	rs12643544	C	T	25	12	37	0	0	37	0	0
4	16170492	rs1662652	C	A	23	21	44	0	0	44	0	0
4	16173524	rs6814370	C	T	9	12	21	0	0	21	0	0
4	16173552	rs6813085	G	C	4	13	17	0	0	17	0	0
4	16177517	rs16893143	A	G	28	28	56	0	0	56	0	0
4	16179741	rs16893144	C	A	8	9	17	0	0	17	0	0
4	16184860	rs73128457	T	C	2	5	7	0	0	7	0	0
4	16187016	rs113195683	C	T	5	2	7	0	0	7	0	0
4	16189780	.	C	T	1	8	9	0	0	9	0	0
4	16199230	rs76347794	C	G	0	39	39	0	1	40	0	0
4	16215537	rs12651110	T	G	4	9	13	0	0	13	0	0
4	16216616	rs35851218	T	C	20	17	37	0	0	37	0	0
4	16217627	rs56023844	T	C	9	14	23	0	0	23	0	0
4	16219162	rs77499790	T	A	10	8	18	0	0	18	0	0
4	16221791	rs144101482	T	A	17	6	23	0	0	23	0	0
4	16226298	rs894639	A	G	1	6	7	0	0	7	0	0
4	16229881	rs114549620	A	C	6	2	8	0	0	8	0	0
4	16230002	rs12645055	G	A	5	1	6	0	0	6	0	0
4	16230212	rs149169344	C	T	6	3	9	0	0	9	0	0
4	17485081	rs2597756	C	T	7	6	13	0	0	13	0	0
4	17485097	rs2597757	C	T	12	6	18	0	1	19	0	0
4	17485749	rs2597760	T	A	3	3	6	0	0	6	0	0
4	17485932	rs2518626	G	A	14	10	24	0	1	25	0	0
4	17486029	rs2518625	A	G	20	17	37	0	0	37	0	0
4	17486065	rs2518624	T	C	20	17	37	0	0	37	0	0
4	17486468	rs2315246	A	T	7	7	14	0	0	14	0	0
4	17486506	rs2315247	G	A	6	4	10	0	0	10	0	0
4	17486575	rs2518623	A	G	7	8	15	0	2	17	0	0
4	17487028	rs2597765	A	C	13	3	16	0	0	16	0	0
4	17487183	rs2597766	G	A	11	4	15	0	0	15	0	0
4	17487597	rs12512495	G	A	11	7	18	0	0	18	0	0
4	17487713	rs6449303	A	T	5	3	8	0	0	8	0	0
4	17488064	rs1031326	T	C	11	6	17	0	1	18	0	0
4	17488072	rs699459	T	C	10	6	16	0	1	17	0	0
4	17488244	rs1031327	G	A	9	6	15	0	0	15	0	0
4	17488286	rs699460	T	G	10	7	17	0	0	17	0	0
4	17488533	rs1049582	C	T	14	15	29	0	1	30	0	0
4	17488534	rs1049581	A	G	14	16	30	0	0	30	0	0
4	17587338	rs75282622	C	T	6	6	12	0	0	12	0	0
4	17597549	rs6812675	A	G	3	3	6	0	0	6	0	0
4	17598840	rs41268395	G	A	11	12	23	0	0	23	0	0
4	17599500	rs4698625	G	T	5	5	10	0	1	11	0	0
4	17609071	.	T	C	271	236	507	0	1	508	0	0
4	17816929	.	G	A	21	13	34	0	0	34	0	0
4	17852961	rs71603383	A	G	4	8	12	0	0	12	0	0
4	17913879	rs35921582	A	G	2	4	6	0	0	6	0	0
4	17932319	rs73802707	C	T	4	3	7	0	0	7	0	0
4	17932555	rs6854757	A	G	3	4	7	0	0	7	0	0
4	17933639	rs35654348	C	T	6	4	10	0	0	10	0	0
4	17933810	rs6841793	C	G	6	3	9	0	0	9	0	0
4	17934394	rs6449345	A	T	3	3	6	0	0	6	0	0
4	17934461	rs6449346	T	C	4	5	9	0	0	9	0	0
4	20728966	rs17552929	G	C	5	5	10	0	0	10	0	0
4	20733963	rs6811505	C	G	5	2	7	0	0	7	0	0
4	22439914	rs6823735	A	C	4	10	14	0	0	14	0	0
4	24521943	rs116013582	C	G	5	2	7	0	0	7	0	0
4	24807991	rs2324580	T	C	10	4	14	0	0	14	0	0
4	24808318	rs2270224	G	A	7	5	12	0	1	13	0	0
4	24809380	rs2361079	T	C	5	3	8	0	0	8	0	0
4	24809884	rs1019229	T	C	7	8	15	0	0	15	0	0
4	25125098	rs73252520	G	A	25	25	50	0	0	50	0	0
4	25152014	rs73252527	G	A	4	2	6	0	0	6	0	0
4	25158750	rs73252528	T	C	9	4	13	0	0	13	0	0
4	25159180	rs200560359	G	T	4	3	7	0	0	7	0	0
4	25161539	rs60527077	G	A	8	10	18	0	1	19	0	0
4	25749303	rs7701	C	A	28	29	57	0	0	57	0	0
4	25915858	rs2305670	C	A	3	7	10	0	0	10	0	0
4	25930928	rs14553	A	G	17	21	38	0	0	38	0	0
4	26289961	rs13142370	C	T	5	4	9	0	0	9	0	0
4	26861656	rs9790789	A	C	5	9	14	0	0	14	0	0
4	36245543	rs6531424	C	T	6	3	9	0	0	9	0	0
4	37592674	rs937941	T	C	7	4	11	0	0	11	0	0
4	37604982	rs10050295	G	A	4	3	7	0	0	7	0	0
4	37612519	rs116408552	G	A	230	191	421	0	2	423	0	0
4	37675388	rs13150568	G	A	9	8	17	0	0	17	0	0
4	37676970	rs77854093	T	C	2	4	6	0	0	6	0	0
4	37904082	rs2279026	T	C	5	9	14	0	0	14	0	0
4	37907980	rs13108308	G	C	4	3	7	0	0	7	0	0
4	37908066	rs59208148	G	T	8	3	11	0	0	11	0	0
4	37908067	rs58798777	C	A	8	3	11	0	0	11	0	0
4	37908103	rs34871767	G	A	7	2	9	0	1	10	0	0
4	38626130	rs28418927	A	C	0	8	8	0	0	8	0	0
4	38664499	rs2078179	A	G	11	4	15	0	0	15	0	0
4	38665818	rs113071828	G	A	21	8	29	0	0	29	0	0
4	38666746	rs28656945	G	A	74	71	145	0	1	146	0	0
4	38686405	rs10019144	G	A	5	5	10	0	0	10	0	0
4	38686852	rs17500787	G	A	8	2	10	0	0	10	0	0
4	38687928	rs28681431	G	A	2	4	6	0	0	6	0	0
4	38689042	rs17428931	A	G	11	5	16	0	0	16	0	0
4	38689228	rs4535339	A	G	7	8	15	0	0	15	0	0
4	38689745	rs17428945	T	C	44	49	93	0	1	94	0	0
4	38692925	rs3796535	T	A	55	39	94	0	2	96	0	0
4	38692940	rs3796536	G	A	58	44	102	0	0	102	0	0
4	38693924	rs73232901	C	A	6	3	9	0	0	9	0	0
4	38702437	rs7147	A	G	40	47	87	0	0	87	0	0
4	38849325	rs531901860	C	A	2	4	6	0	0	6	0	0
4	38968444	rs7655962	A	T	5	8	13	0	1	14	0	0
4	39116911	rs3733276	T	C	23	33	56	0	0	56	0	0
4	39121668	rs7675782	G	A	5	4	9	0	0	9	0	0
4	39121774	rs7676008	G	C	2	4	6	0	0	6	0	0
4	39121990	rs7677729	C	T	3	4	7	0	0	7	0	0
4	39122016	rs7655122	A	G	4	2	6	0	0	6	0	0
4	39122697	rs3733275	C	T	6	3	9	0	0	9	0	0
4	39122913	rs13182	T	A	13	21	34	0	0	34	0	0
4	39124750	rs1061377	C	A	6	6	12	0	0	12	0	0
4	39124873	rs1982009	C	T	6	6	12	0	0	12	0	0
4	39124935	rs1138494	C	T	6	7	13	0	0	13	0	0
4	39126016	rs13109200	A	G	5	8	13	0	1	14	0	0
4	39127021	rs2890659	T	C	23	14	37	0	0	37	0	0
4	39127747	rs1046655	G	A	2	7	9	0	0	9	0	0
4	39135564	rs10018622	G	A	1	7	8	0	0	8	0	0
4	39216221	rs2167494	C	T	4	3	7	0	0	7	0	0
4	39275394	rs6531702	T	C	17	4	21	0	0	21	0	0
4	39277296	rs17431358	T	C	4	2	6	0	0	6	0	0
4	39287322	rs7564	C	T	28	5	33	0	0	33	0	0
4	39703872	.	T	C	13	0	13	0	10	23	0	0
4	39838468	rs305128	A	G	3	4	7	0	0	7	0	0
4	39854212	rs7671295	T	C	9	3	12	0	0	12	0	0
4	39854403	rs6531743	G	A	13	4	17	0	0	17	0	0
4	39854639	rs6531744	C	T	8	5	13	0	0	13	0	0
4	39855140	rs62307934	C	T	8	3	11	0	0	11	0	0
4	39856519	rs1994076	C	T	6	2	8	0	0	8	0	0
4	39902840	rs7696520	C	T	5	1	6	0	0	6	0	0
4	39921942	rs28449663	A	G	46	55	101	0	0	101	0	0
4	40100676	rs1706028	C	G	3	9	12	0	1	13	0	0
4	40151656	rs807787	A	G	1	5	6	0	0	6	0	0
4	40156577	rs61474507	G	T	3	3	6	0	0	6	0	0
4	40158167	rs78152193	A	G	17	15	32	0	0	32	0	0
4	40158464	rs9998717	A	G	15	20	35	0	0	35	0	0
4	40198846	rs2245466	G	C	193	170	363	0	11	374	0	0
4	40237039	rs7669035	G	A	6	4	10	0	1	11	0	0
4	40237692	rs13103342	C	T	4	10	14	0	1	15	0	0
4	40245990	rs1053509	A	C	155	199	354	0	6	360	0	0
4	40246416	rs4600925	A	G	12	9	21	0	0	21	0	0
4	40246835	rs58297725	T	A	13	11	24	0	0	24	0	0
4	40247611	rs4616763	C	G	13	17	30	0	0	30	0	0
4	40428010	rs278981	T	C	9	6	15	0	0	15	0	0
4	40428056	rs149047307	T	G	6	6	12	0	0	12	0	0
4	41015742	rs11942640	T	C	10	0	10	0	0	10	0	0
4	41015899	rs4861358	C	T	0	12	12	0	0	12	0	0
4	41015942	.	A	G	0	8	8	0	0	8	0	0
4	41956413	rs1507086	C	T	6	10	16	0	0	16	0	0
4	41957994	rs56187334	G	T	12	8	20	0	0	20	0	0
4	41958539	rs78574837	T	C	5	3	8	0	0	8	0	0
4	41959924	rs75626463	C	T	16	18	34	0	0	34	0	0
4	41960341	rs16853815	T	C	18	11	29	0	0	29	0	0
4	41962491	rs1043343	C	A	15	14	29	0	0	29	0	0
4	41987892	rs2581438	G	A	4	5	9	0	0	9	0	0
4	41992677	rs2581434	C	G	12	12	24	0	0	24	0	0
4	41993744	rs2581433	T	G	8	6	14	0	0	14	0	0
4	41994449	rs75709518	A	G	7	9	16	0	0	16	0	0
4	41994645	rs2660346	C	T	4	4	8	0	0	8	0	0
4	42003671	rs1047626	A	G	14	9	23	0	0	23	0	0
4	42020142	rs2581423	A	G	25	14	39	0	0	39	0	0
4	42022464	rs15857	C	A	25	19	44	0	0	44	0	0
4	42033414	rs28712316	C	T	2	4	6	0	0	6	0	0
4	42089177	rs11051	G	A	43	44	87	0	2	89	0	0
4	42113241	rs13756	C	T	15	4	19	0	0	19	0	0
4	42113249	rs10018324	A	T	15	4	19	0	0	19	0	0
4	42114944	rs56050241	G	A	13	14	27	0	0	27	0	0
4	42115810	rs17446061	C	T	19	16	35	0	0	35	0	0
4	42116821	rs60267384	G	A	10	10	20	0	1	21	0	0
4	42117070	rs58352691	G	T	12	16	28	0	0	28	0	0
4	42117173	rs4861163	C	T	10	9	19	0	0	19	0	0
4	42117559	rs16854020	G	A	4	4	8	0	0	8	0	0
4	42120509	rs2880666	A	G	3	7	10	0	0	10	0	0
4	42121412	rs2343617	G	C	2	4	6	0	0	6	0	0
4	42411192	.	C	A	50	45	95	0	1	96	0	0
4	42411553	rs7665824	G	T	56	38	94	0	0	94	0	0
4	42412687	rs12639920	T	G	42	34	76	0	0	76	0	0
4	42414273	rs28577194	A	G	27	25	52	0	0	52	0	0
4	42415736	rs79916262	T	C	3	5	8	0	0	8	0	0
4	42415737	rs77117942	T	C	2	6	8	0	0	8	0	0
4	42576655	.	T	C	13	15	28	0	1	29	0	0
4	44682465	rs6447368	T	C	6	10	16	0	0	16	0	0
4	44695848	rs192443880	C	G	15	12	27	0	0	27	0	0
4	44701256	rs13125773	G	T	22	12	34	0	0	34	0	0
4	44701446	rs6811584	A	G	19	49	68	0	0	68	0	0
4	44701750	rs6812211	A	C	7	24	31	0	0	31	0	0
4	44701764	rs6817397	T	G	10	25	35	0	0	35	0	0
4	44702720	rs1565532	T	C	4	8	12	0	0	12	0	0
4	44704206	rs1128553	A	G	4	2	6	0	0	6	0	0
4	44705595	rs1133648	G	A	15	13	28	0	0	28	0	0
4	44705601	rs1133650	T	C	16	14	30	0	0	30	0	0
4	44706453	rs16857402	T	C	3	8	11	0	1	12	0	0
4	44706919	rs2709	C	T	3	21	24	0	0	24	0	0
4	44707815	rs10020551	G	T	8	4	12	0	1	13	0	0
4	44707939	rs10213309	G	T	4	5	9	0	0	9	0	0
4	44707941	rs10212824	C	A	4	5	9	0	0	9	0	0
4	44708086	rs62305383	G	C	4	6	10	0	0	10	0	0
4	44708093	rs10213518	C	G	6	4	10	0	0	10	0	0
4	44715341	rs7670601	T	C	7	5	12	0	0	12	0	0
4	47514685	rs33995001	C	T	2	5	7	0	0	7	0	0
4	47560163	rs11729411	C	A	7	2	9	0	0	9	0	0
4	47584046	rs1058793	G	A	4	3	7	0	0	7	0	0
4	48069696	rs2230594	G	C	12	7	19	0	0	19	0	0
4	48132393	rs55683170	C	G	5	1	6	0	0	6	0	0
4	48138535	rs1008277	T	C	26	16	42	0	0	42	0	0
4	48142320	rs4446283	C	T	12	12	24	0	2	26	0	0
4	48142678	rs28521484	C	T	6	4	10	0	0	10	0	0
4	48143201	rs17470892	T	C	5	6	11	0	0	11	0	0
4	48144525	rs17470919	T	C	5	4	9	0	0	9	0	0
4	48144710	rs73244489	T	A	6	6	12	0	0	12	0	0
4	48145121	rs6844543	T	C	4	23	27	0	0	27	0	0
4	48145695	rs7682890	A	T	16	8	24	0	2	26	0	0
4	48146864	rs996223	G	A	13	6	19	0	0	19	0	0
4	48147309	rs17574371	T	C	78	69	147	0	0	147	0	0
4	48152256	rs10938522	C	T	8	3	11	0	3	14	0	0
4	48153706	rs7654182	A	G	5	2	7	0	0	7	0	0
4	48172266	rs2271173	G	A	52	34	86	0	2	88	0	0
4	48201821	rs2457414	C	A	6	1	7	0	0	7	0	0
4	48227642	rs2704424	G	C	7	5	12	0	1	13	0	0
4	48227694	rs11947838	G	A	5	3	8	0	0	8	0	0
4	48227700	rs6835999	A	G	8	4	12	0	0	12	0	0
4	48227782	rs2704423	A	G	8	1	9	0	0	9	0	0
4	48582909	rs4695391	G	A	5	4	9	0	0	9	0	0
4	48588742	rs34558821	C	T	4	10	14	0	0	14	0	0
4	48765175	rs7657698	G	A	9	3	12	0	2	14	0	0
4	48765787	rs7660206	C	T	4	2	6	0	0	6	0	0
4	48851540	rs11733534	T	C	13	3	16	0	0	16	0	0
4	48851937	rs3761729	C	T	50	34	84	0	0	84	0	0
4	48854139	rs2572345	T	C	45	33	78	0	0	78	0	0
4	48855217	rs2712159	A	C	27	15	42	0	0	42	0	0
4	48857387	rs2712158	A	G	7	11	18	0	0	18	0	0
4	48857743	rs9637562	C	T	35	20	55	0	0	55	0	0
4	48859825	rs116736272	C	T	10	9	19	0	0	19	0	0
4	48859940	rs2883562	C	G	7	4	11	0	0	11	0	0
4	48860817	rs12512637	A	G	5	14	19	0	0	19	0	0
4	48890460	rs6447670	T	A	8	8	16	0	0	16	0	0
4	48898352	.	A	T	6	8	14	0	0	14	0	0
4	53465250	.	C	T	8	2	10	0	0	10	0	0
4	54263353	rs17082681	G	T	12	5	17	0	0	17	0	0
4	54263919	rs10019914	A	G	7	7	14	0	0	14	0	0
4	54264105	rs10022429	T	C	6	11	17	0	0	17	0	0
4	54264543	rs10025091	T	C	3	5	8	0	0	8	0	0
4	54274257	rs10025794	C	T	3	3	6	0	0	6	0	0
4	54283574	rs28506190	C	T	3	3	6	0	0	6	0	0
4	54324991	rs2137895	A	T	3	3	6	0	0	6	0	0
4	54326395	rs2048709	C	T	16	12	28	0	1	29	0	0
4	54326550	rs17657105	A	T	10	6	16	0	0	16	0	0
4	54327526	rs17082837	T	A	14	18	32	0	0	32	0	0
4	54328671	rs15834	C	A	35	20	55	0	0	55	0	0
4	54862653	rs116326015	C	A	6	3	9	0	0	9	0	0
4	54875021	rs13117076	C	G	4	2	6	0	0	6	0	0
4	54902570	rs13133387	T	G	10	14	24	0	0	24	0	0
4	54903376	rs11935636	A	C	20	11	31	0	0	31	0	0
4	54903664	rs13140725	T	C	9	9	18	0	0	18	0	0
4	54906967	rs13131335	C	A	8	13	21	0	0	21	0	0
4	54926469	rs13147006	C	T	9	6	15	0	1	16	0	0
4	54926673	rs13145833	G	C	9	3	12	0	0	12	0	0
4	55593919	rs72549291	C	G	13	10	23	0	0	23	0	0
4	56236328	rs2538	C	T	21	16	37	0	0	37	0	0
4	56262741	rs3087606	C	G	2	6	8	0	0	8	0	0
4	56264753	rs4549456	C	G	16	14	30	0	0	30	0	0
4	56266724	rs13113860	C	T	12	11	23	0	0	23	0	0
4	56267473	rs12641881	C	T	17	21	38	0	1	39	0	0
4	56281484	rs550144	G	A	2	4	6	0	0	6	0	0
4	56290558	rs11732723	C	T	2	4	6	0	0	6	0	0
4	56292101	rs6802	A	T	28	26	54	0	0	54	0	0
4	56294628	rs3749473	T	C	3	4	7	0	0	7	0	0
4	56295583	rs1047354	A	G	4	2	6	0	0	6	0	0
4	56413803	rs4864548	G	A	7	10	17	0	0	17	0	0
4	56475338	rs3805383	G	A	3	3	6	0	0	6	0	0
4	56754099	rs12646999	T	G	2	4	6	0	0	6	0	0
4	56761741	rs73238391	T	A	10	3	13	0	0	13	0	0
4	56761931	rs73238392	C	T	13	7	20	0	0	20	0	0
4	56762101	rs17086129	C	T	38	30	68	0	0	68	0	0
4	56762208	rs73238393	A	C	26	28	54	0	1	55	0	0
4	56771089	rs11658	G	A	84	78	162	0	2	164	0	0
4	56829482	rs2593068	G	A	3	5	8	0	0	8	0	0
4	57180473	rs6823339	C	A	2	7	9	0	0	9	0	0
4	57190356	rs7695701	G	A	11	11	22	0	0	22	0	0
4	57194329	rs11733474	G	T	12	9	21	0	0	21	0	0
4	57194460	rs6811153	A	G	7	9	16	0	0	16	0	0
4	57194525	rs6834736	C	G	7	6	13	0	0	13	0	0
4	57194712	rs6811616	A	C	6	14	20	0	0	20	0	0
4	57215677	rs3796544	G	A	23	14	37	0	0	37	0	0
4	57215969	rs61978622	C	T	12	22	34	0	1	35	0	0
4	57219592	rs6554348	G	A	11	5	16	0	0	16	0	0
4	57237683	rs6554354	G	A	10	4	14	0	0	14	0	0
4	57253826	rs116228399	G	A	9	0	9	0	0	9	0	0
4	57260298	rs1042040	C	G	7	14	21	0	0	21	0	0
4	57273840	rs11538098	C	G	5	11	16	0	0	16	0	0
4	57275129	rs13114481	C	A	1	6	7	0	0	7	0	0
4	57301681	rs6843073	G	A	9	8	17	0	0	17	0	0
4	57310924	rs7694047	T	C	9	2	11	0	1	12	0	0
4	57310971	rs7689163	A	G	9	4	13	0	0	13	0	0
4	57318490	rs111521045	G	A	5	3	8	0	0	8	0	0
4	57326406	rs17051687	G	A	44	40	84	0	1	85	0	0
4	57327405	rs6584	T	C	53	35	88	0	0	88	0	0
4	57333822	rs12513091	G	T	34	45	79	0	2	81	0	0
4	57340592	rs11610	C	T	4	4	8	0	0	8	0	0
4	57356972	rs17086883	C	T	12	15	27	0	0	27	0	0
4	57357139	rs17086887	A	G	7	7	14	0	0	14	0	0
4	57357244	rs12509542	T	C	9	14	23	0	0	23	0	0
4	57366176	rs68101565	G	C	3	5	8	0	0	8	0	0
4	57368200	rs10051	T	C	145	137	282	0	0	282	0	0
4	57368413	rs4260596	G	A	179	176	355	0	3	358	0	0
4	57368759	rs14211	A	G	145	127	272	0	1	273	0	0
4	57368807	rs10518	C	T	188	192	380	0	2	382	0	0
4	57522220	rs4626270	A	G	6	1	7	0	0	7	0	0
4	57522646	rs4429779	A	G	46	32	78	0	1	79	0	0
4	57522689	rs4558922	C	T	13	3	16	0	0	16	0	0
4	57774176	rs781654	C	G	6	1	7	0	0	7	0	0
4	57797230	.	C	T	47	46	93	0	0	93	0	0
4	57798469	rs781667	A	G	35	33	68	0	1	69	0	0
4	57800489	rs79178673	G	A	89	61	150	0	1	151	0	0
4	57835056	rs13146782	C	T	4	5	9	0	0	9	0	0
4	57861117	rs1713951	G	A	11	8	19	0	3	22	0	0
4	57872421	rs7661194	T	C	3	5	8	0	1	9	0	0
4	57873296	rs67541678	C	T	23	11	34	0	0	34	0	0
4	57874348	rs62310298	T	C	56	45	101	0	2	103	0	0
4	57874454	rs10000395	T	C	22	17	39	0	0	39	0	0
4	57874827	rs34948796	A	G	44	50	94	0	0	94	0	0
4	57887252	rs13146153	G	A	11	9	20	0	0	20	0	0
4	57889332	rs1718862	G	A	14	15	29	0	0	29	0	0
4	57889677	rs1056364	C	T	281	294	575	0	1	576	0	0
4	57896699	rs1277307	G	T	2	4	6	0	0	6	0	0
4	57898230	rs11573128	G	T	1	6	7	0	0	7	0	0
4	57956728	rs62308284	C	A	2	5	7	0	0	7	0	0
4	57966325	rs75522131	G	A	0	6	6	0	0	6	0	0
4	57975328	rs11133484	A	G	11	9	20	0	0	20	0	0
4	68284172	rs10009461	A	C	3	5	8	0	0	8	0	0
4	68286626	rs2291807	A	G	5	2	7	0	0	7	0	0
4	68297697	rs28410544	A	G	4	2	6	0	0	6	0	0
4	68297913	rs142199623	C	A	3	6	9	0	0	9	0	0
4	68330933	rs1497426	T	C	16	12	28	0	0	28	0	0
4	68331605	rs2319231	A	G	5	6	11	0	0	11	0	0
4	68331699	rs2319232	G	C	7	3	10	0	0	10	0	0
4	68331703	rs2319233	C	T	7	3	10	0	0	10	0	0
4	68331909	rs6840283	A	G	4	8	12	0	0	12	0	0
4	68331984	rs2319234	C	T	4	7	11	0	0	11	0	0
4	68332222	rs872422	G	C	6	4	10	0	0	10	0	0
4	68333123	rs6552096	T	A	3	6	9	0	0	9	0	0
4	68333125	rs6552097	C	A	3	6	9	0	0	9	0	0
4	68339425	rs7669626	G	A	14	8	22	0	0	22	0	0
4	68339466	rs10025283	T	C	8	9	17	0	0	17	0	0
4	68340246	rs62303192	C	T	12	11	23	0	0	23	0	0
4	68341063	rs10866195	A	G	9	12	21	0	0	21	0	0
4	68341138	rs10866196	G	A	5	10	15	0	0	15	0	0
4	68341404	rs6841742	C	G	10	8	18	0	0	18	0	0
4	68341599	rs117838702	G	A	6	4	10	0	0	10	0	0
4	68343353	rs9992946	T	C	8	1	9	0	0	9	0	0
4	68343391	rs7697098	C	A	7	4	11	0	0	11	0	0
4	68344384	rs11931016	A	C	4	9	13	0	1	14	0	0
4	68345897	rs11724698	A	C	2	4	6	0	0	6	0	0
4	68347972	rs4266337	C	A	2	4	6	0	0	6	0	0
4	68350308	rs9312182	T	C	2	5	7	0	0	7	0	0
4	68350759	rs1846062	T	C	1	5	6	0	0	6	0	0
4	68352790	rs355469	C	G	5	14	19	0	0	19	0	0
4	68356827	rs191650	C	T	6	2	8	0	0	8	0	0
4	68357814	rs1497430	A	G	2	4	6	0	0	6	0	0
4	68358981	.	T	A	3	3	6	0	0	6	0	0
4	68374597	rs1056789	C	T	85	95	180	0	2	182	0	0
4	68376067	rs2646290	G	A	6	5	11	0	0	11	0	0
4	68377711	rs355465	T	A	5	1	6	0	0	6	0	0
4	68380215	rs11250	G	A	54	65	119	0	1	120	0	0
4	68382837	rs4860851	C	A	4	3	7	0	0	7	0	0
4	68383293	rs28756365	A	T	9	4	13	0	0	13	0	0
4	68384008	rs355510	C	T	29	36	65	0	2	67	0	0
4	68384602	rs355508	C	G	6	31	37	0	1	38	0	0
4	68391949	rs355493	A	T	4	4	8	0	0	8	0	0
4	68478554	rs1047961	G	A	19	8	27	0	0	27	0	0
4	68478574	rs1047960	T	G	19	9	28	0	1	29	0	0
4	68478852	rs11943533	C	A	20	19	39	0	0	39	0	0
4	68479388	rs67960624	G	A	8	4	12	0	0	12	0	0
4	68480218	rs1548119	T	C	6	5	11	0	0	11	0	0
4	68480525	rs4860262	C	T	3	7	10	0	0	10	0	0
4	68480724	rs56288325	T	C	7	10	17	0	0	17	0	0
4	68480740	rs67538316	T	C	9	11	20	0	0	20	0	0
4	68480922	rs12504029	G	T	10	5	15	0	0	15	0	0
4	68483491	rs13348	T	G	50	69	119	0	0	119	0	0
4	68484094	rs35366816	G	A	103	56	159	0	2	161	0	0
4	68484199	rs35769737	A	G	66	49	115	0	1	116	0	0
4	68484396	rs66709509	G	A	45	27	72	0	1	73	0	0
4	68485352	rs11131714	G	A	6	6	12	0	0	12	0	0
4	68485590	rs10866199	C	A	8	3	11	0	1	12	0	0
4	68485823	rs12502000	C	T	11	1	12	0	0	12	0	0
4	68486467	rs3860688	A	G	3	6	9	0	0	9	0	0
4	68488305	rs13104385	C	G	5	6	11	0	0	11	0	0
4	68489649	rs7684656	C	T	9	4	13	0	0	13	0	0
4	68490019	rs10454253	C	T	3	3	6	0	0	6	0	0
4	68490650	rs12508337	G	A	7	3	10	0	0	10	0	0
4	68491773	rs2306809	T	A	4	3	7	0	0	7	0	0
4	68501455	rs13151494	A	C	5	2	7	0	0	7	0	0
4	68518288	rs13119953	C	T	8	3	11	0	0	11	0	0
4	68518546	rs35446506	T	C	7	4	11	0	0	11	0	0
4	68518668	rs35129113	C	T	8	5	13	0	0	13	0	0
4	68518680	rs34004194	C	T	8	5	13	0	0	13	0	0
4	68519087	.	C	T	3	5	8	0	0	8	0	0
4	68524242	rs57101483	G	T	7	2	9	0	0	9	0	0
4	68524285	rs35719494	C	T	6	1	7	0	0	7	0	0
4	68525682	rs6849445	C	T	3	3	6	0	0	6	0	0
4	68562365	rs17572160	A	G	15	4	19	0	0	19	0	0
4	68586315	rs13124793	G	A	6	12	18	0	0	18	0	0
4	68586335	rs72643632	T	C	7	13	20	0	0	20	0	0
4	68586336	rs17635292	A	G	7	13	20	0	0	20	0	0
4	68586450	rs7697056	C	A	8	8	16	0	0	16	0	0
4	68586509	rs6552111	C	T	7	5	12	0	0	12	0	0
4	69178954	rs2293594	T	C	26	26	52	0	0	52	0	0
4	69181332	rs57643586	T	C	46	40	86	0	5	91	0	0
4	69181942	rs12649108	G	A	55	50	105	0	1	106	0	0
4	69182335	rs58108365	C	T	29	35	64	0	0	64	0	0
4	69185154	rs3927373	A	G	39	30	69	0	1	70	0	0
4	69189048	rs1730872	A	G	6	7	13	0	0	13	0	0
4	69190493	rs1880183	A	G	6	12	18	0	0	18	0	0
4	69191360	rs2140519	G	C	17	7	24	0	0	24	0	0
4	69193754	rs62316045	C	T	9	7	16	0	0	16	0	0
4	69195065	rs4860927	A	G	8	8	16	0	0	16	0	0
4	69215551	rs36215897	A	T	10	14	24	0	0	24	0	0
4	70056432	rs68147210	A	G	7	0	7	0	0	7	0	0
4	70056507	rs72607815	G	A	6	0	6	0	0	6	0	0
4	70056516	rs72607816	A	C	6	0	6	0	0	6	0	0
4	70056815	rs7676175	G	A	12	0	12	0	0	12	0	0
4	70056952	rs4404618	T	C	8	0	8	0	0	8	0	0
4	70056983	.	A	C	10	0	10	0	0	10	0	0
4	70063169	rs60149852	G	A	3	3	6	0	0	6	0	0
4	70070431	.	T	C	5	1	6	0	0	6	0	0
4	70071817	rs4485863	T	C	2	4	6	0	0	6	0	0
4	70081510	rs6833028	T	C	11	4	15	0	0	15	0	0
4	70081827	rs6847476	G	T	20	14	34	0	0	34	0	0
4	71570134	rs1891451	G	A	5	7	12	0	0	12	0	0
4	71672653	rs1043903	A	G	17	9	26	0	0	26	0	0
4	71686578	.	C	T	167	149	316	0	4	320	0	0
4	71848084	rs114571766	G	A	30	22	52	0	0	52	0	0
4	71850271	rs3733399	A	G	12	16	28	0	1	29	0	0
4	71859966	rs149746268	A	T	3	18	21	0	0	21	0	0
4	73930552	rs3762883	G	A	11	7	18	0	0	18	0	0
4	73956736	rs6855349	G	A	33	21	54	0	0	54	0	0
4	74094500	rs9291182	G	A	9	5	14	0	0	14	0	0
4	74606669	rs2227307	T	G	13	6	19	0	0	19	0	0
4	74607055	rs2227306	C	T	56	43	99	0	0	99	0	0
4	74607910	rs2227543	C	T	107	107	214	0	2	216	0	0
4	74609045	rs1126647	A	T	1076	1078	2154	0	11	2166	1	0
4	74735150	rs11547681	G	T	29	34	63	0	0	63	0	0
4	74735244	rs2071425	A	G	48	29	77	0	1	78	0	0
4	74736180	rs56078309	G	A	5	8	13	0	0	13	0	0
4	75141357	rs2169129	C	A	11	5	16	0	1	17	0	0
4	75247090	rs9291193	C	A	5	12	17	0	1	18	0	0
4	75247174	rs10446508	T	A	3	7	10	0	0	10	0	0
4	75247955	rs4694188	T	A	2	10	12	0	0	12	0	0
4	75248434	rs2367707	A	G	196	354	550	0	3	553	0	0
4	75252179	rs1017732	A	C	144	204	348	0	5	353	0	0
4	75252350	rs1017733	C	T	235	300	535	0	4	539	0	0
4	75252785	rs1962685	T	C	357	536	893	0	0	893	0	0
4	75253120	rs1017734	A	C	86	174	260	0	1	261	0	0
4	75253136	rs1017735	G	T	90	188	278	0	0	278	0	0
4	75253143	rs1017736	T	G	98	192	290	0	0	290	0	0
4	75254258	rs1460007	G	A	158	159	317	0	2	319	0	0
4	75254282	rs1460008	G	A	166	176	342	0	2	344	0	0
4	76407419	rs9189	C	T	68	44	112	0	0	112	0	0
4	76648290	rs7691385	C	T	7	2	9	0	0	9	0	0
4	76648449	rs7696241	C	G	6	3	9	0	0	9	0	0
4	76649924	rs2280095	C	G	14	5	19	0	0	19	0	0
4	76650176	rs7657871	C	G	9	3	12	0	0	12	0	0
4	76650443	rs7662940	C	T	4	3	7	0	0	7	0	0
4	76720885	rs13119659	T	C	15	11	26	0	0	26	0	0
4	76721414	rs13145290	C	G	6	4	10	0	0	10	0	0
4	76721459	rs4859409	G	A	8	3	11	0	0	11	0	0
4	76730195	rs324689	A	G	57	55	112	0	1	113	0	0
4	76857309	rs4859571	C	T	36	22	58	0	0	58	0	0
4	76857388	rs4859572	C	T	20	6	26	0	0	26	0	0
4	76878688	rs2242470	G	A	33	31	64	0	1	65	0	0
4	76878716	rs2242471	G	C	21	33	54	0	1	55	0	0
4	76883281	rs13132564	T	A	4	2	6	0	0	6	0	0
4	76955406	rs10017431	T	C	5	2	7	0	0	7	0	0
4	76955617	rs13130221	G	A	3	3	6	0	0	6	0	0
4	77038749	.	T	C	4	6	10	0	0	10	0	0
4	77227676	rs56049812	A	C	4	5	9	0	0	9	0	0
4	77871016	rs873090	T	G	1	9	10	0	0	10	0	0
4	77882153	rs1553029	A	T	4	3	7	0	0	7	0	0
4	77909557	rs62302300	C	T	2	11	13	0	0	13	0	0
4	77958765	rs1127595	A	G	14	7	21	0	0	21	0	0
4	77974545	rs4241599	C	T	11	7	18	0	0	18	0	0
4	79530732	rs7675646	C	T	5	1	6	0	0	6	0	0
4	79531308	rs4612	C	T	141	130	271	0	3	274	0	0
4	79791119	rs10025599	T	C	5	3	8	0	0	8	0	0
4	79841359	rs10028067	C	G	12	10	22	0	0	22	0	0
4	79849042	rs6854347	A	T	5	1	6	0	0	6	0	0
4	80872086	rs4511947	A	G	2	4	6	0	0	6	0	0
4	80887556	rs10033596	G	T	6	13	19	0	0	19	0	0
4	80887969	rs11098964	A	G	7	6	13	0	0	13	0	0
4	80894706	rs10003491	T	C	4	5	9	0	0	9	0	0
4	80896945	rs73828828	A	G	3	3	6	0	0	6	0	0
4	80897785	rs73828830	G	A	4	2	6	0	0	6	0	0
4	80905851	rs28688624	A	C	2	4	6	0	0	6	0	0
4	80989904	rs150727065	C	G	12	11	23	0	0	23	0	0
4	80989905	rs7661959	A	G	13	11	24	0	0	24	0	0
4	82362055	.	T	C	43	55	98	0	0	98	0	0
4	82370993	rs1822816	T	A	3	3	6	0	0	6	0	0
4	82372610	rs1562138	T	C	19	9	28	0	0	28	0	0
4	82374121	rs1348600	T	C	7	4	11	0	0	11	0	0
4	82374847	rs9307783	A	G	3	6	9	0	0	9	0	0
4	82376529	rs6829780	A	C	4	7	11	0	0	11	0	0
4	82390927	rs12649837	C	T	5	7	12	0	0	12	0	0
4	83274634	rs2288338	C	T	13	16	29	0	0	29	0	0
4	83278915	rs2575885	T	A	13	7	20	0	0	20	0	0
4	83279071	rs2556538	G	A	6	9	15	0	0	15	0	0
4	83282421	rs2258407	G	C	32	34	66	0	3	69	0	0
4	83283819	rs2556544	A	G	27	36	63	0	1	64	0	0
4	83295916	rs2288337	T	A	7	13	20	0	0	20	0	0
4	83344774	rs114515824	G	A	89	77	166	0	0	166	0	0
4	83740718	rs12331100	T	C	6	4	10	0	0	10	0	0
4	83740867	rs11099554	A	C	5	3	8	0	0	8	0	0
4	83742336	rs4634209	C	T	7	5	12	0	0	12	0	0
4	83752830	rs114245448	G	A	7	10	17	0	0	17	0	0
4	83754091	rs57994979	C	T	5	10	15	0	0	15	0	0
4	83754204	rs80275378	C	T	3	8	11	0	0	11	0	0
4	83754887	rs28611098	T	C	2	8	10	0	1	11	0	0
4	83754894	rs28661080	T	C	3	8	11	0	0	11	0	0
4	83756926	rs66932306	T	C	5	1	6	0	0	6	0	0
4	83758827	rs1136882	T	C	7	1	8	0	0	8	0	0
4	83765050	rs9690	C	A	5	4	9	0	0	9	0	0
4	83795806	rs10025654	T	C	37	32	69	0	0	69	0	0
4	83814823	rs7082	T	C	60	75	135	0	1	136	0	0
4	83817816	rs6855151	T	C	36	21	57	0	0	57	0	0
4	83838262	rs897945	G	T	3	6	9	0	0	9	0	0
4	83840906	rs1047564	G	A	13	16	29	0	0	29	0	0
4	83848388	rs13132580	T	C	15	13	28	0	1	29	0	0
4	83849057	rs13151638	G	A	4	4	8	0	0	8	0	0
4	83977244	rs10028177	C	T	5	7	12	0	1	13	0	0
4	83980563	rs1962413	C	G	5	2	7	0	0	7	0	0
4	83980618	.	A	G	3	3	6	0	0	6	0	0
4	83983700	rs4591594	T	C	4	13	17	0	0	17	0	0
4	84026430	.	T	A	4	5	9	0	0	9	0	0
4	84028524	rs11934937	C	T	6	5	11	0	0	11	0	0
4	84028838	rs4693563	G	A	13	7	20	0	0	20	0	0
4	84029557	rs6817600	C	T	8	7	15	0	0	15	0	0
4	84188850	rs1129617	G	A	25	25	50	0	0	50	0	0
4	84364751	rs7665103	A	G	8	8	16	0	0	16	0	0
4	84370091	rs13141136	A	G	3	4	7	0	0	7	0	0
4	84374480	rs1494961	C	T	25	34	59	0	0	59	0	0
4	84380955	rs12505955	G	T	7	1	8	0	0	8	0	0
4	84382552	rs1126971	A	T	24	9	33	0	1	34	0	0
4	84382763	rs11099601	C	T	36	17	53	0	0	53	0	0
4	84383810	rs12642536	C	T	15	22	37	0	0	37	0	0
4	84400330	rs1565909	C	T	7	4	11	0	0	11	0	0
4	84402043	rs6834006	A	G	3	11	14	0	1	15	0	0
4	84526275	rs1521531	T	C	74	61	135	0	0	135	0	0
4	84526573	rs1052473	A	G	68	58	126	0	1	127	0	0
4	84526767	rs3822008	C	T	103	78	181	0	1	182	0	0
4	88057353	rs1408	G	A	60	60	120	0	2	122	0	0
4	88058743	rs76280539	C	T	77	84	161	0	0	161	0	0
4	88061055	rs141343010	T	C	189	203	392	0	4	396	0	0
4	88224998	rs11945520	C	T	3	3	6	0	0	6	0	0
4	88225233	rs11727374	A	G	32	30	62	0	0	62	0	0
4	88225269	rs150031335	G	C	31	26	57	0	1	58	0	0
4	88225318	rs13106540	G	T	41	32	73	0	0	73	0	0
4	88225321	rs7663544	T	C	41	39	80	0	0	80	0	0
4	88225442	rs7685519	A	C	37	42	79	0	1	80	0	0
4	88225446	rs7686034	G	C	38	41	79	0	2	81	0	0
4	88238013	rs7662471	T	C	4	8	12	0	0	12	0	0
4	88238448	rs6531975	A	G	4	6	10	0	0	10	0	0
4	88242629	rs112592619	C	T	3	5	8	0	0	8	0	0
4	88244209	rs115597995	A	G	3	9	12	0	0	12	0	0
4	88246162	rs6531977	G	T	3	5	8	0	0	8	0	0
4	88248660	rs10009871	C	T	5	4	9	0	0	9	0	0
4	88248743	rs113305148	C	A	2	4	6	0	1	7	0	0
4	88256990	rs113186475	G	A	10	5	15	0	0	15	0	0
4	88257233	rs111649922	C	A	3	5	8	0	0	8	0	0
4	88259008	rs12649023	G	A	6	6	12	0	1	13	0	0
4	88260263	rs12643799	A	G	7	5	12	0	0	12	0	0
4	88260342	rs80263421	A	T	7	2	9	0	0	9	0	0
4	88293887	rs6531985	G	A	293	284	577	0	2	579	0	0
4	88295539	rs62319100	G	A	17	0	17	0	1	18	0	0
4	88943887	rs2725228	A	T	4	2	6	0	0	6	0	0
4	88944511	rs2725227	C	T	4	2	6	0	0	6	0	0
4	88946391	rs7690969	A	G	11	4	15	0	0	15	0	0
4	88954247	rs6850829	G	C	5	3	8	0	0	8	0	0
4	88956521	rs6532045	A	G	5	4	9	0	0	9	0	0
4	88959922	rs2725220	G	C	9	7	16	0	1	17	0	0
4	88959968	rs2725218	G	C	7	8	15	0	0	15	0	0
4	88959998	rs7696304	A	G	9	6	15	0	0	15	0	0
4	88960329	rs79219814	C	G	8	7	15	0	0	15	0	0
4	88960579	rs2725216	A	G	13	10	23	0	0	23	0	0
4	88961184	rs80301989	G	A	14	12	26	0	0	26	0	0
4	89393906	rs7667551	A	G	15	21	36	0	0	36	0	0
4	89397091	rs7699006	A	G	110	95	205	0	0	205	0	0
4	89398165	rs78443383	G	A	8	6	14	0	2	16	0	0
4	89400947	rs111780472	G	A	7	3	10	0	0	11	1	0
4	89403198	rs28410134	T	G	1	5	6	0	0	6	0	0
4	89403725	.	C	T	8	7	15	0	0	15	0	0
4	89405202	rs113251292	C	T	10	4	14	0	0	14	0	0
4	89420539	rs74658427	T	C	9	2	11	0	0	11	0	0
4	89421086	rs10516809	A	G	120	138	258	0	0	258	0	0
4	89577214	rs2972040	A	T	13	15	28	0	0	28	0	0
4	89578140	rs2860513	A	T	19	11	30	0	0	30	0	0
4	89605997	rs3017912	C	A	6	1	7	0	0	8	1	0
4	89607932	rs7698491	G	A	25	25	50	0	0	50	0	0
4	89617387	rs8605	A	G	0	68	68	0	0	68	0	0
4	89617931	rs28435799	G	A	0	59	59	0	3	62	0	0
4	89618837	rs710834	T	C	0	23	23	0	0	23	0	0
4	89628242	rs2924934	G	T	13	18	31	0	0	31	0	0
4	89629000	rs1063143	A	G	17	23	40	0	0	40	0	0
4	89629066	rs2602117	T	C	18	21	39	0	2	41	0	0
4	89631029	rs2972030	A	G	3	6	9	0	0	9	0	0
4	89640567	rs2924935	C	T	6	6	12	0	0	12	0	0
4	89643379	rs2860419	T	C	12	12	24	0	1	25	0	0
4	89643699	rs62308725	C	T	4	9	13	0	0	13	0	0
4	89643997	rs3017899	C	G	6	2	8	0	0	8	0	0
4	89644197	rs2924941	C	T	10	7	17	0	0	17	0	0
4	89646706	rs3017897	C	G	2	5	7	0	0	7	0	0
4	89647070	rs2860500	C	T	2	4	6	0	0	6	0	0
4	89648845	rs13130	A	G	14	20	34	0	0	34	0	0
4	89649491	rs3017895	A	G	42	48	90	0	1	91	0	0
4	89649659	rs9224	A	G	48	43	91	0	0	91	0	0
4	89650437	rs78517451	C	A	3	8	11	0	0	11	0	0
4	89654165	rs3017914	T	C	10	6	16	0	0	16	0	0
4	89658352	rs2602112	G	A	5	1	6	0	0	6	0	0
4	89670155	rs3756050	C	T	8	4	12	0	0	12	0	0
4	89671721	rs61737091	C	T	5	12	17	0	0	17	0	0
4	89906598	rs78681184	C	T	2	4	6	0	0	6	0	0
4	90034686	rs17015027	A	G	9	9	18	0	0	18	0	0
4	90707901	.	C	T	9	5	14	0	0	14	0	0
4	90707947	rs2737033	T	C	2	6	8	0	0	8	0	0
4	90711770	rs2737029	T	C	1	10	11	0	0	11	0	0
4	90743331	rs10005233	C	T	7	5	12	0	0	12	0	0
4	95496882	rs2452600	C	T	4	3	7	0	0	7	0	0
4	95506827	rs11722955	G	A	4	4	8	0	0	8	0	0
4	99793998	rs187793690	C	G	4	3	7	0	0	7	0	0
4	99813495	rs11097639	A	C	4	5	9	0	0	9	0	0
4	99988713	rs17595186	G	A	20	15	35	0	1	36	0	0
4	100787233	rs77036069	C	A	32	23	55	0	0	55	0	0
4	101107168	rs1053227	G	A	88	84	172	0	0	172	0	0
4	101107191	.	C	G	92	87	179	0	2	181	0	0
4	101107276	rs1063821	C	A	142	127	269	0	1	270	0	0
4	101107292	rs2903209	A	T	137	132	269	0	3	272	0	0
4	101107664	rs3819182	C	A	72	52	124	0	0	124	0	0
4	101945139	rs6826912	T	G	4	5	9	0	0	9	0	0
4	101946948	rs1042094	T	C	7	3	10	0	0	10	0	0
4	102218715	rs920559	C	G	2	4	6	0	0	6	0	0
4	102254445	.	T	G	7	0	7	0	2	9	0	0
4	102261253	rs10516469	C	T	6	7	13	0	0	13	0	0
4	103172826	rs62327889	C	T	4	2	6	0	0	6	0	0
4	103173749	rs13126885	C	T	3	3	6	0	0	6	0	0
4	103174015	rs190178	G	A	5	1	6	0	0	6	0	0
4	103184590	rs7672806	T	C	3	3	6	0	0	6	0	0
4	103187146	rs62327916	T	G	1	10	11	0	0	11	0	0
4	103225255	rs985989	A	C	4	5	9	0	0	9	0	0
4	103227073	rs6829701	G	A	19	10	29	0	0	29	0	0
4	103480450	rs230506	A	G	4	3	7	0	0	7	0	0
4	103514658	rs1609993	T	C	67	63	130	0	0	130	0	0
4	103536261	rs230547	C	T	7	4	11	0	0	11	0	0
4	103726568	rs13128934	C	T	8	1	9	0	0	9	0	0
4	103749747	rs13117052	G	C	4	5	9	0	0	9	0	0
4	106105299	rs10461139	A	G	4	4	8	0	0	8	0	0
4	106123582	rs2047408	G	C	15	11	26	0	0	26	0	0
4	106123638	rs78632895	A	T	5	2	7	0	0	7	0	0
4	106156187	rs17253672	C	T	25	26	51	0	1	52	0	0
4	106160133	rs56185013	G	A	63	46	109	0	0	109	0	0
4	106160365	rs7670522	A	C	18	10	28	0	0	28	0	0
4	106196829	rs34402524	T	G	6	10	16	0	0	16	0	0
4	106196951	rs2454206	A	G	8	6	14	0	0	14	0	0
4	106199505	rs2647257	A	T	17	16	33	0	0	33	0	0
4	106317429	rs13787	C	G	53	33	86	0	0	86	0	0
4	106319684	rs2713869	T	C	5	7	12	0	0	12	0	0
4	106319836	rs2726453	T	G	3	19	22	0	0	22	0	0
4	106320532	rs2713870	T	C	4	4	8	0	0	8	0	0
4	106325798	rs2636746	A	T	7	1	8	0	0	8	0	0
4	106325900	rs9992793	C	T	6	1	7	0	0	7	0	0
4	106325965	rs10015293	A	G	7	2	9	0	0	9	0	0
4	106338742	rs2726463	G	A	3	3	6	0	0	6	0	0
4	106340353	rs2713823	A	G	2	4	6	0	0	6	0	0
4	106340372	rs2713824	G	C	2	5	7	0	0	7	0	0
4	106341530	rs2713825	T	C	5	2	7	0	0	7	0	0
4	106343119	rs2713842	A	G	4	6	10	0	0	10	0	0
4	106350501	rs1344330	C	T	14	5	19	0	0	19	0	0
4	106358553	rs73836209	T	C	8	0	8	0	0	8	0	0
4	106358577	rs2636741	A	G	0	8	8	0	0	8	0	0
4	106359393	rs2713863	A	G	4	3	7	0	0	7	0	0
4	106366209	rs2636751	T	C	2	4	6	0	0	6	0	0
4	106389297	rs13104830	T	C	4	5	9	0	0	9	0	0
4	106389337	rs13129703	G	C	3	7	10	0	0	10	0	0
4	106392086	rs4699177	C	A	9	8	17	0	1	18	0	0
4	106392707	rs1048518	C	G	71	54	125	0	0	127	2	0
4	106393547	rs12498981	A	G	52	45	97	0	0	97	0	0
4	106394380	rs2074396	C	A	41	49	90	0	2	92	0	0
4	106395181	rs4699179	G	A	9	6	15	0	0	15	0	0
4	106407156	rs148715591	T	C	7	0	7	0	0	7	0	0
4	106604190	rs35370743	A	G	120	111	231	0	0	231	0	0
4	106604364	rs34072732	A	G	112	101	213	0	0	214	1	0
4	106629246	rs28391170	A	C	8	4	12	0	0	12	0	0
4	106643445	rs6820200	G	A	2	5	7	0	0	7	0	0
4	106645771	rs4699198	G	A	4	3	7	0	0	7	0	0
4	106768086	rs150384021	A	G	1	9	10	0	0	10	0	0
4	107253217	rs180895145	T	C	11	10	21	0	0	21	0	0
4	107258228	rs3737495	G	A	3	3	6	0	0	6	0	0
4	108542623	rs76517405	T	C	12	2	14	0	1	15	0	0
4	108641317	rs1127006	G	A	52	31	83	0	1	84	0	0
4	108835028	.	C	T	11	3	14	0	0	14	0	0
4	108853384	rs6849089	C	G	2	4	6	0	0	6	0	0
4	108853592	rs62311379	A	G	10	5	15	0	0	15	0	0
4	108873285	rs8727	T	C	4	4	8	0	0	8	0	0
4	108873308	rs7791	A	C	5	4	9	0	0	9	0	0
4	108916556	rs76916282	A	G	2	5	7	0	0	7	0	0
4	108946067	rs75702913	A	C	5	5	10	0	0	10	0	0
4	110432078	rs7680211	G	T	9	2	11	0	0	11	0	0
4	110524474	rs197210	G	A	12	9	21	0	0	21	0	0
4	110524784	rs197209	G	A	24	19	43	0	1	44	0	0
4	110524900	.	C	G	15	20	35	0	1	36	0	0
4	110524940	rs197207	C	T	12	21	33	0	1	34	0	0
4	110525022	rs538533624	G	A	18	14	32	0	1	33	0	0
4	110570095	rs9996730	G	T	2	5	7	0	0	7	0	0
4	110581363	rs4698744	T	A	50	60	110	0	1	111	0	0
4	110585645	rs767598	G	A	6	4	10	0	0	10	0	0
4	110602430	rs4698780	T	G	6	2	8	0	0	8	0	0
4	110603784	rs3733611	T	C	112	89	201	0	2	203	0	0
4	110605744	rs13846	A	T	114	84	198	0	0	198	0	0
4	110610086	rs1042891	A	G	19	27	46	0	1	47	0	0
4	110638810	rs2285714	C	T	6	4	10	0	0	10	0	0
4	113151732	rs7699435	T	C	2	4	6	0	0	6	0	0
4	113196906	rs3202899	T	C	3	8	11	0	0	11	0	0
4	113197769	rs28555653	T	C	5	11	16	0	1	17	0	0
4	113198087	rs6852042	T	A	3	6	9	0	0	9	0	0
4	113198130	rs3203648	T	C	3	5	8	0	0	8	0	0
4	113198805	rs701758	G	C	17	25	42	0	1	43	0	0
4	113199075	rs701759	A	G	74	69	143	0	0	143	0	0
4	113336478	rs13149115	T	A	6	2	8	0	0	8	0	0
4	113347496	rs9994944	A	G	4	2	6	0	0	6	0	0
4	113352075	rs73841022	A	G	9	10	19	0	0	19	0	0
4	113352397	rs2074388	G	A	14	18	32	0	0	32	0	0
4	113352832	rs35633116	C	T	14	20	34	0	0	34	0	0
4	113352899	rs2074379	G	A	14	16	30	0	0	30	0	0
4	113354291	rs6847956	G	C	5	5	10	0	0	10	0	0
4	113362301	rs61574683	T	G	10	13	23	0	0	23	0	0
4	113362316	rs1486868	A	G	9	10	19	0	0	19	0	0
4	113363048	rs960583	G	A	17	13	30	0	0	30	0	0
4	113363349	rs231254	G	A	18	21	39	0	1	40	0	0
4	113363361	rs231255	G	T	16	23	39	0	0	39	0	0
4	113363417	rs75370802	G	C	21	17	38	0	0	38	0	0
4	113529020	rs4834294	A	G	6	5	11	0	0	11	0	0
4	113568328	rs75987826	G	T	29	19	48	0	0	48	0	0
4	113578266	rs6533631	G	A	2	4	6	0	0	6	0	0
4	113578609	rs1129065	C	T	48	33	81	0	0	81	0	0
4	114372504	rs12511604	C	T	12	12	24	0	0	24	0	0
4	114373068	rs17676882	G	A	7	3	10	0	0	10	0	0
4	119526740	rs78175353	C	G	17	20	37	0	1	38	0	0
4	119526915	rs79026339	T	C	21	7	28	0	0	28	0	0
4	119534679	rs199563204	C	T	3	4	7	0	0	7	0	0
4	119551780	.	A	C	39	56	95	0	1	96	0	0
4	119552436	rs9760578	A	C	39	45	84	0	1	85	0	0
4	119552849	rs67276048	C	T	58	63	121	0	0	121	0	0
4	119553410	rs71610221	C	A	64	58	122	0	0	122	0	0
4	119553741	rs538624505	T	G	38	41	79	0	0	79	0	0
4	119553799	rs71247728	A	G	60	20	80	0	2	82	0	0
4	119553997	rs67655207	T	A	69	68	137	0	0	137	0	0
4	119554298	rs35102067	A	G	86	54	140	0	1	141	0	0
4	119554364	rs34838106	G	C	67	99	166	0	2	168	0	0
4	119554736	rs12651650	C	T	55	89	144	0	3	147	0	0
4	119555093	rs6855978	C	G	185	85	270	0	5	275	0	0
4	119555287	rs6833597	T	C	278	103	381	0	4	385	0	0
4	119616916	rs36023173	G	T	2	4	6	0	0	6	0	0
4	119619263	rs11945703	T	G	3	3	6	0	0	6	0	0
4	119622348	rs10213474	G	T	4	2	6	0	1	7	0	0
4	119623467	rs298998	C	T	8	7	15	0	0	15	0	0
4	119624581	rs6836005	C	T	6	2	8	0	0	8	0	0
4	119624641	rs6813357	T	G	5	1	6	0	0	6	0	0
4	119624745	rs298996	G	A	9	5	14	0	0	14	0	0
4	119625000	rs3733517	A	G	6	5	11	0	0	11	0	0
4	119631992	rs1064034	A	T	37	39	76	0	2	78	0	0
4	119632379	rs3087958	A	G	105	112	217	0	1	218	0	0
4	119634130	rs419292	T	C	1	8	9	0	0	9	0	0
4	119634275	rs368669	A	G	2	6	8	0	0	8	0	0
4	119636034	rs298974	A	G	9	5	14	0	0	14	0	0
4	119636395	rs298975	G	T	8	9	17	0	1	18	0	0
4	119648150	rs67989872	G	C	5	2	7	0	0	7	0	0
4	119736796	rs2389688	A	C	15	13	28	0	0	28	0	0
4	120169906	rs113583516	A	T	12	7	19	0	0	19	0	0
4	120215314	rs1052633	A	G	14	34	48	0	0	48	0	0
4	120215836	rs2175383	C	A	3	11	14	0	0	14	0	0
4	120220196	rs6843509	G	A	1	5	6	0	0	6	0	0
4	120422738	rs35264119	G	A	8	7	15	0	0	15	0	0
4	120423094	rs80223330	G	A	15	3	18	0	0	18	0	0
4	120424580	rs13107334	T	G	4	5	9	0	0	9	0	0
4	120425215	rs2127826	A	G	12	6	18	0	0	18	0	0
4	120434015	rs61747388	G	A	14	26	40	0	0	40	0	0
4	122590435	rs12510548	C	G	8	5	13	0	0	13	0	0
4	122590457	rs41279317	G	A	5	6	11	0	0	11	0	0
4	122592663	rs2306419	C	T	1	5	6	0	0	6	0	0
4	122599249	rs3756281	G	A	20	9	29	0	0	29	0	0
4	122599755	rs3733649	T	C	7	5	12	0	0	12	0	0
4	122599984	rs3733650	T	A	6	3	9	0	1	10	0	0
4	122600471	rs11098637	G	T	8	4	12	0	0	12	0	0
4	122600522	rs11098638	G	A	5	2	7	0	0	7	0	0
4	122600664	rs4833229	G	A	6	7	13	0	0	13	0	0
4	122601781	rs1480287	C	T	3	4	7	0	0	7	0	0
4	122617745	rs1131239	G	A	19	32	51	0	1	52	0	0
4	122618046	rs1050606	A	C	33	55	88	0	1	89	0	0
4	122618117	rs113588187	C	T	10	16	26	0	0	26	0	0
4	122726987	rs13105974	A	G	1	10	11	0	0	11	0	0
4	122728965	rs9998785	A	T	4	2	6	0	0	6	0	0
4	122729505	rs9999362	A	G	4	5	9	0	0	9	0	0
4	122735868	rs6815050	C	T	13	10	23	0	0	23	0	0
4	122736053	rs6845901	T	C	14	9	23	0	1	24	0	0
4	123081460	rs6832214	C	G	7	7	14	0	0	14	0	0
4	123145751	rs7658836	T	A	25	21	46	0	0	46	0	0
4	123178574	rs45534531	T	C	23	28	51	0	1	52	0	0
4	123188449	rs13104615	C	G	5	3	8	0	0	8	0	0
4	123192383	rs45574236	T	C	13	9	22	0	0	22	0	0
4	123229132	rs7688384	C	T	31	30	61	0	0	61	0	0
4	123245699	.	A	G	1	5	6	0	0	6	0	0
4	123249429	rs74414351	G	A	50	22	72	0	0	72	0	0
4	123838758	rs12648093	A	G	3	4	7	0	0	7	0	0
4	124319055	rs13150612	C	T	8	10	18	0	0	18	0	0
4	124319144	rs300569	C	T	31	22	53	0	0	53	0	0
4	124320322	rs9992811	A	G	4	6	10	0	0	10	0	0
4	124320340	rs28514996	C	T	6	6	12	0	0	12	0	0
4	124320359	rs28477228	C	T	3	5	8	0	0	8	0	0
4	124322594	rs159762	G	A	7	7	14	0	0	14	0	0
4	124323783	rs300575	G	C	135	135	270	0	11	283	2	0
4	125626745	rs12501208	G	A	6	7	13	0	0	13	0	0
4	128807219	rs3811740	T	A	30	29	59	0	0	59	0	0
4	128814964	rs17012739	G	T	71	62	133	0	2	135	0	0
4	128884610	rs2087446	A	C	5	1	6	0	0	6	0	0
4	128960569	rs11098945	C	T	12	7	19	0	0	19	0	0
4	128995640	rs7696130	G	A	22	17	39	0	0	39	0	0
4	129012181	rs2306054	G	A	42	44	86	0	0	86	0	0
4	129012638	rs1064205	A	G	32	45	77	0	0	77	0	0
4	129043204	rs12508837	C	G	8	3	11	0	1	12	0	0
4	129043286	rs3733320	C	T	6	6	12	0	0	12	0	0
4	129100643	rs12645577	G	A	3	6	9	0	0	9	0	0
4	129785512	rs13114904	G	A	10	14	24	0	0	24	0	0
4	129793559	rs11933240	A	G	34	22	56	0	0	56	0	0
4	129844449	rs1674962	G	A	7	4	11	0	1	12	0	0
4	129845927	rs4052	G	A	6	4	10	0	0	10	0	0
4	129846109	rs318564	T	G	2	4	6	0	0	6	0	0
4	129846249	rs318563	T	C	2	4	6	0	0	6	0	0
4	129847352	rs318562	T	G	5	1	6	0	0	6	0	0
4	129867280	rs10028124	T	A	5	9	14	0	0	14	0	0
4	129913345	rs13151322	G	A	6	4	10	0	0	10	0	0
4	129924977	rs3113487	C	A	4	2	6	0	0	6	0	0
4	129955932	rs34145504	C	T	5	1	6	0	0	6	0	0
4	129992058	rs62316978	T	G	5	2	7	0	0	7	0	0
4	130028426	rs337279	G	T	8	0	8	0	0	8	0	0
4	130030644	rs2271570	C	T	33	38	71	0	0	71	0	0
4	130031650	rs1709416	G	A	6	5	11	0	0	11	0	0
4	130031847	rs1709417	G	A	2	4	6	0	0	6	0	0
4	130032031	rs498435	A	G	3	3	6	0	0	6	0	0
4	130032119	rs1867951	A	C	6	7	13	0	0	13	0	0
4	130032843	rs17351999	A	G	27	25	52	0	0	52	0	0
4	139967824	rs62320528	C	T	70	44	114	0	1	115	0	0
4	139968368	rs13125484	C	G	258	243	501	0	5	506	0	0
4	140053960	rs10857271	A	C	5	6	11	0	0	11	0	0
4	140056431	rs58302711	G	A	65	41	106	0	1	107	0	0
4	140056433	.	G	A	62	44	106	0	2	108	0	0
4	140216530	rs6815500	G	A	20	20	40	0	0	40	0	0
4	140217010	rs71606834	G	C	15	22	37	0	0	37	0	0
4	140222034	rs3806767	C	G	7	4	11	0	0	11	0	0
4	140332563	rs34038966	A	G	5	2	7	0	0	7	0	0
4	140336007	rs12374240	T	A	4	2	6	0	0	6	0	0
4	140373081	rs1142627	A	C	4	4	8	0	0	8	0	0
4	140375296	rs13128486	C	G	6	6	12	0	0	12	0	0
4	140394875	rs13137997	G	A	33	32	65	0	0	65	0	0
4	140395583	rs4074940	C	T	107	59	166	0	1	167	0	0
4	140396931	rs3088313	C	A	30	20	50	0	1	51	0	0
4	140617280	rs2646073	C	G	0	9	9	0	0	9	0	0
4	140640283	rs10519504	G	T	4	7	11	0	1	12	0	0
4	140640703	rs61747885	G	T	3	6	9	0	0	9	0	0
4	141294814	rs2271430	G	C	9	6	15	0	0	15	0	0
4	141317068	rs12513290	G	A	4	2	6	0	0	6	0	0
4	141458038	rs2321271	T	A	4	2	6	0	0	6	0	0
4	141466478	rs3104104	A	G	3	3	6	0	0	6	0	0
4	141471014	rs3104101	G	A	2	4	6	0	0	6	0	0
4	141473357	rs6846451	T	G	3	3	6	0	0	6	0	0
4	141543997	rs1560440	G	A	5	1	6	0	0	6	0	0
4	142155214	rs3822128	T	C	202	179	381	0	0	381	0	0
4	142654432	rs1057972	A	T	3	4	7	0	0	7	0	0
4	142945131	rs1039937	T	A	10	3	13	0	0	13	0	0
4	142945451	rs336361	T	C	10	2	12	0	0	12	0	0
4	142947546	rs11100741	C	G	3	3	6	0	0	6	0	0
4	143565480	rs13114452	G	A	5	8	13	0	0	13	0	0
4	143568783	rs78401193	A	G	3	3	6	0	0	6	0	0
4	143575740	rs13125853	A	G	5	6	11	0	0	11	0	0
4	143713970	.	G	A	6	8	14	0	0	14	0	0
4	143714094	rs28633136	T	C	13	4	17	0	0	17	0	0
4	143714120	rs17016776	T	C	10	2	12	0	0	12	0	0
4	143714533	rs80227024	G	C	14	2	16	0	1	17	0	0
4	144127778	rs112090426	G	A	2	4	6	0	0	6	0	0
4	144135718	rs4285045	G	A	58	50	108	0	0	108	0	0
4	144136405	rs10001113	T	C	10	4	14	0	0	14	0	0
4	144143340	rs7673827	T	G	14	18	32	0	0	32	0	0
4	144143578	rs4131029	C	T	14	11	25	0	0	25	0	0
4	144144667	rs6856785	C	A	21	26	47	0	1	48	0	0
4	144833153	rs74590858	C	G	8	10	18	0	0	18	0	0
4	144833154	rs78713560	T	G	8	10	18	0	0	18	0	0
4	144918712	rs1132783	C	G	8	3	11	0	0	11	0	0
4	144920596	rs7683365	G	A	4	7	11	0	0	11	0	0
4	145031841	rs13125760	C	T	3	6	9	0	0	9	0	0
4	145984839	rs17781702	C	A	10	8	18	0	0	18	0	0
4	146042445	rs10519725	G	C	9	5	14	0	0	14	0	0
4	146056320	rs1804528	G	A	78	69	147	0	2	149	0	0
4	146402470	rs6854034	C	G	7	2	9	0	0	9	0	0
4	146402592	rs6537355	A	G	5	2	7	0	1	8	0	0
4	146572227	rs11721553	G	A	16	6	22	0	0	22	0	0
4	146682333	rs62345780	G	A	18	20	38	0	0	38	0	0
4	146735071	rs1876476	G	T	4	2	6	0	0	6	0	0
4	147100475	rs2115794	T	C	3	4	7	0	0	7	0	0
4	147110790	rs41280529	A	T	82	77	159	0	1	160	0	0
4	147176097	rs7435720	A	G	10	8	18	0	0	18	0	0
4	147176571	rs2291379	C	A	6	2	8	0	0	8	0	0
4	147177341	rs1057560	G	A	8	11	19	0	0	19	0	0
4	147388554	rs56105621	C	T	2	4	6	0	0	6	0	0
4	148538941	rs11541450	G	A	10	8	18	0	0	18	0	0
4	148593179	.	G	T	8	4	12	0	0	12	0	0
4	148944467	rs35975487	A	G	13	28	41	0	0	41	0	0
4	148993857	rs9724	C	G	16	21	37	0	0	37	0	0
4	152046645	.	A	C	8	3	11	0	0	11	0	0
4	152062184	rs77577197	G	A	36	32	68	0	0	68	0	0
4	152065684	rs6818900	A	G	23	22	45	0	2	47	0	0
4	152592191	rs4571	T	C	52	53	105	0	0	105	0	0
4	152594407	rs6813516	C	G	9	1	10	0	0	10	0	0
4	152594814	rs7439465	T	C	5	3	8	0	0	8	0	0
4	152643184	rs6817586	G	A	3	4	7	0	0	7	0	0
4	153565838	rs3935569	C	T	5	6	11	0	0	11	0	0
4	153565969	rs4443258	C	T	6	8	14	0	1	15	0	0
4	153832040	rs7689343	G	A	7	1	8	0	0	8	0	0
4	153897770	rs3811832	G	A	4	2	6	0	0	6	0	0
4	154197234	rs2289409	T	G	3	5	8	0	0	8	0	0
4	154387597	rs71620317	G	C	5	5	10	0	1	11	0	0
4	154542609	rs6535931	T	C	5	1	6	0	0	6	0	0
4	154543557	rs2241839	A	G	2	4	6	0	0	6	0	0
4	154543571	rs2241840	T	C	2	5	7	0	0	7	0	0
4	154543771	rs4696469	T	G	2	8	10	0	0	10	0	0
4	154547617	rs4696470	A	G	4	3	7	0	0	7	0	0
4	154549663	rs6535932	T	C	8	5	13	0	0	13	0	0
4	154622950	rs13105517	G	A	9	7	16	0	0	16	0	0
4	154624656	rs3804099	T	C	44	48	92	0	0	92	0	0
4	155456390	rs1110	C	G	13	13	26	0	1	27	0	0
4	155456608	rs7654425	A	G	13	15	28	0	0	28	0	0
4	155457073	rs62330399	T	C	13	10	23	0	0	23	0	0
4	155457150	rs62330406	T	C	17	9	26	0	0	26	0	0
4	155457183	rs11553452	T	C	15	8	23	0	0	23	0	0
4	155457225	rs11553453	T	A	12	4	16	0	1	17	0	0
4	155457530	rs7685666	T	A	0	6	6	0	0	6	0	0
4	155457601	rs60732160	T	C	7	4	11	0	0	11	0	0
4	155458728	rs7668014	C	T	6	3	9	0	0	9	0	0
4	155458844	rs7668341	C	T	0	6	6	0	0	6	0	0
4	155459194	rs7668818	A	T	58	54	112	0	0	112	0	0
4	155461113	rs7671792	T	C	76	47	123	0	0	123	0	0
4	155470302	rs55710159	G	A	3	8	11	0	0	11	0	0
4	155470398	rs72679193	A	G	1	7	8	0	0	8	0	0
4	155471164	rs60198817	C	G	5	3	8	0	0	8	0	0
4	156263871	rs10326	G	A	3	5	8	0	0	8	0	0
4	156617994	rs2306557	G	A	57	55	112	0	1	113	0	0
4	156628921	rs72687508	A	G	0	6	6	0	0	6	0	0
4	156631345	rs3796592	T	C	4	2	6	0	0	6	0	0
4	156644015	rs55673113	C	A	3	5	8	0	0	8	0	0
4	156695587	rs9998822	C	T	4	3	7	0	0	7	0	0
4	156700444	rs113999871	A	C	5	3	8	0	0	8	0	0
4	156728367	rs7638	A	C	12	8	20	0	0	20	0	0
4	159045966	rs8370	A	G	20	19	39	0	1	40	0	0
4	159046278	rs14202	C	T	7	8	15	0	0	15	0	0
4	159047173	rs181588593	G	A	1	6	7	0	0	7	0	0
4	159047602	rs10028490	A	T	6	1	7	0	0	7	0	0
4	159048217	rs4691455	G	A	6	7	13	0	0	13	0	0
4	159049771	rs4501266	C	T	5	5	10	0	0	10	0	0
4	159076826	rs6830702	C	T	9	4	13	0	0	13	0	0
4	159161933	rs183293900	G	C	2	4	6	0	0	6	0	0
4	159801291	rs13129071	C	G	19	13	32	0	0	32	0	0
4	159826379	rs2279153	T	C	9	7	16	0	0	16	0	0
4	159827313	rs10589	T	C	10	5	15	0	0	15	0	0
4	159828328	rs2291007	T	C	7	12	19	0	0	19	0	0
4	160090125	rs7669604	A	G	3	10	13	0	0	13	0	0
4	160090172	rs7669745	A	T	6	8	14	0	0	14	0	0
4	160277276	rs1135004	C	T	77	64	141	0	6	147	0	0
4	164045822	rs1055263	A	G	4	3	7	0	0	7	0	0
4	164049916	rs1061075	A	C	5	7	12	0	0	12	0	0
4	164050186	.	C	T	4	3	7	0	0	7	0	0
4	164054971	rs6829366	G	T	6	6	12	0	0	12	0	0
4	164059657	rs6839886	T	C	6	2	8	0	0	8	0	0
4	164078541	.	G	A	46	25	71	0	1	72	0	0
4	164085425	rs4691896	T	C	21	28	49	0	0	49	0	0
4	164087954	rs936562	A	T	18	21	39	0	2	41	0	0
4	165997375	rs57550388	T	G	9	3	12	0	0	12	0	0
4	165998104	rs35654372	C	G	5	9	14	0	0	14	0	0
4	165999980	.	C	T	6	1	7	0	0	7	0	0
4	166000263	rs59386121	C	T	12	12	24	0	0	24	0	0
4	166006830	.	C	A	17	11	28	0	0	28	0	0
4	166021811	rs6536890	G	C	7	5	12	0	0	12	0	0
4	166139198	rs112925802	A	G	5	2	7	0	0	7	0	0
4	166145191	rs138811447	C	T	5	4	9	0	0	9	0	0
4	166189666	.	C	T	2	5	7	0	0	7	0	0
4	166192043	rs9994064	G	T	2	4	6	0	0	6	0	0
4	166193434	rs184493507	C	T	4	3	7	0	0	7	0	0
4	166193693	rs116215522	G	A	4	2	6	0	0	6	0	0
4	166193694	rs115146063	C	T	4	2	6	0	0	6	0	0
4	166231868	rs28678193	A	G	43	32	75	0	0	75	0	0
4	166233873	rs9685465	T	G	3	3	6	0	0	6	0	0
4	166241056	rs13353543	G	C	3	8	11	0	0	11	0	0
4	166241366	rs10015240	A	G	4	8	12	0	0	12	0	0
4	166241618	rs76311079	C	T	5	4	9	0	0	9	0	0
4	166243082	rs60759634	A	G	5	6	11	0	0	11	0	0
4	166243491	rs75575884	T	C	46	55	101	0	0	101	0	0
4	169299528	rs13110927	T	C	14	12	26	0	2	28	0	0
4	169343044	rs61740705	A	G	45	33	78	0	1	79	0	0
4	169369820	rs2712113	T	A	25	11	36	0	0	36	0	0
4	169369853	rs2712114	A	T	20	10	30	0	0	30	0	0
4	169379626	rs2712136	G	A	5	1	6	0	0	6	0	0
4	169381860	rs4345134	T	C	5	6	11	0	0	11	0	0
4	169382991	rs17612630	C	A	19	10	29	0	0	29	0	0
4	169389776	rs9312329	A	G	4	2	6	0	0	6	0	0
4	169397160	rs4692942	C	G	3	9	12	0	0	12	0	0
4	169849389	rs1071738	C	G	5	1	6	0	0	6	0	0
4	169909593	rs17054604	G	A	1	5	6	0	0	6	0	0
4	169931274	rs2279038	G	A	7	4	11	0	0	11	0	0
4	170015936	rs552255941	T	A	7	8	15	0	0	15	0	0
4	170015937	rs2245118	A	T	9	6	15	0	0	15	0	0
4	170051272	.	C	T	27	36	63	0	0	63	0	0
4	170075130	rs2009329	A	T	4	2	6	0	0	6	0	0
4	170077789	rs10518039	A	G	36	26	62	0	0	62	0	0
4	170133366	rs2660417	C	A	3	10	13	0	0	13	0	0
4	170133829	rs56324525	C	A	6	3	9	0	0	9	0	0
4	170133836	rs55857181	T	G	6	3	9	0	0	9	0	0
4	170133956	rs2706751	C	T	5	3	8	0	0	8	0	0
4	170907795	rs12509103	A	T	4	6	10	0	0	10	0	0
4	174089048	rs1054497	T	A	9	15	24	0	0	24	0	0
4	174089080	rs1054496	T	C	7	16	23	0	0	23	0	0
4	174089238	rs6835098	T	C	8	10	18	0	0	18	0	0
4	174089426	rs4695826	T	A	5	7	12	0	1	13	0	0
4	174089635	rs6835517	A	C	4	2	6	0	0	6	0	0
4	174090004	rs3733477	G	A	22	24	46	0	2	48	0	0
4	174155518	rs11721513	T	C	4	4	8	0	0	8	0	0
4	174156383	rs4696054	C	A	3	3	6	0	0	6	0	0
4	174156538	rs12639929	A	G	2	8	10	0	0	10	0	0
4	174157689	rs17059235	C	G	10	5	15	0	1	16	0	0
4	174159469	rs79973999	G	C	4	3	7	0	0	7	0	0
4	174159788	rs13111572	G	A	8	9	17	0	0	17	0	0
4	174225875	rs78561916	C	T	11	3	14	0	0	14	0	0
4	174229762	rs7665469	T	C	25	28	53	0	1	54	0	0
4	174239704	rs34885736	C	T	13	17	30	0	0	30	0	0
4	174243631	rs3775590	T	C	31	19	50	0	0	50	0	0
4	174253178	rs73005353	T	C	1503	1522	3025	0	15	3040	0	0
4	174253422	rs73005356	T	A	21	13	34	0	0	34	0	0
4	174253647	rs73005357	C	G	21	10	31	0	0	31	0	0
4	174291484	rs146330572	G	A	0	7	7	0	0	7	0	0
4	175240339	rs184424931	A	T	25	15	40	0	0	40	0	0
4	175420413	rs6828850	G	A	4	4	8	0	0	8	0	0
4	175442198	rs3797010	A	G	2	4	6	0	0	6	0	0
4	175442305	rs3797009	T	C	3	4	7	0	0	7	0	0
4	175443156	rs1050145	C	T	36	22	58	0	0	58	0	0
4	175443823	rs116796476	C	G	7	1	8	0	0	8	0	0
4	175444006	rs1346271	C	G	6	2	8	0	0	8	0	0
4	178352679	rs1061814	T	G	5	1	6	0	0	6	0	0
4	184426333	.	G	A	9	10	19	0	0	19	0	0
4	184561196	rs4862230	G	T	33	31	64	0	1	65	0	0
4	184562162	rs1046111	G	T	42	47	89	0	1	90	0	0
4	184566639	rs6552692	A	G	3	4	7	0	1	8	0	0
4	184568703	rs9997619	G	C	6	0	6	0	0	6	0	0
4	184568817	rs60703411	T	G	7	0	7	0	0	7	0	0
4	184570238	rs28643521	A	G	4	6	10	0	0	10	0	0
4	184570485	rs7686593	T	C	6	2	8	0	0	8	0	0
4	184590750	rs4422454	T	C	1	5	6	0	0	6	0	0
4	184600601	rs4241779	A	G	20	16	36	0	1	37	0	0
4	184614874	rs4862234	C	T	28	33	61	0	0	61	0	0
4	184618936	rs62617790	G	C	42	29	71	0	1	72	0	0
4	184621325	rs7440957	C	T	4	2	6	0	1	7	0	0
4	184625201	rs72693616	G	A	6	6	12	0	0	12	0	0
4	184627810	rs11931311	A	G	4	5	9	0	0	9	0	0
4	184628710	rs4583804	A	C	5	3	8	0	0	8	0	0
4	184633558	rs62358042	A	G	3	3	6	0	0	6	0	0
4	185549130	rs6948	G	T	173	200	373	0	2	375	0	0
4	185550089	rs1049216	A	G	65	66	131	0	0	131	0	0
4	185550764	rs4647693	T	C	11	12	23	0	1	24	0	0
4	185551966	rs2705891	T	C	13	15	28	0	0	28	0	0
4	185554300	rs2720376	C	T	1	7	8	0	0	8	0	0
4	185677421	rs8086	C	T	269	226	495	0	1	496	0	0
4	185679623	rs34416324	C	T	2	5	7	0	0	7	0	0
4	185680566	rs13137387	G	A	7	9	16	0	0	16	0	0
4	185686032	rs2292898	C	T	130	113	243	0	1	244	0	0
4	185686652	rs3792315	G	A	11	29	40	0	0	40	0	0
4	185686667	rs114033753	G	A	31	13	44	0	0	44	0	0
4	185686856	rs3792314	C	G	10	11	21	0	0	21	0	0
4	185687233	rs3749233	C	T	18	23	41	0	2	43	0	0
4	185687687	rs12374289	A	C	11	7	18	0	2	20	0	0
4	185687863	rs11727009	A	G	101	91	192	0	0	192	0	0
4	185691888	rs4861632	C	T	3	7	10	0	0	10	0	0
4	185694697	rs7691972	G	A	1	6	7	0	0	7	0	0
4	185695324	rs3792311	G	A	5	5	10	0	0	10	0	0
4	185701549	rs1803898	G	T	60	52	112	0	2	114	0	0
4	185702170	rs62338202	A	T	9	9	18	0	0	18	0	0
4	185704176	rs2046814	G	T	5	7	12	0	0	12	0	0
4	185704700	rs1873227	C	T	6	0	6	0	0	6	0	0
4	185705006	rs2102862	G	A	4	9	13	0	0	13	0	0
4	185707459	rs77308816	G	T	4	2	6	0	0	6	0	0
4	185723711	rs13105565	C	T	12	19	31	0	0	31	0	0
4	185726548	rs4862423	C	T	3	4	7	0	0	7	0	0
4	185728839	rs902177	T	C	2	7	9	0	0	9	0	0
4	185731442	rs13120078	G	A	6	8	14	0	0	14	0	0
4	185731583	rs35340636	C	T	7	6	13	0	0	13	0	0
4	185731940	rs13126272	G	T	7	6	13	0	0	13	0	0
4	185732658	rs11726327	A	G	4	2	6	0	0	6	0	0
4	185733609	rs34202162	G	A	7	7	14	0	0	14	0	0
4	185735054	rs7676928	G	A	3	3	6	0	0	6	0	0
4	185736113	rs2280297	G	C	5	4	9	0	0	9	0	0
4	185743348	rs6853210	C	G	3	7	10	0	0	10	0	0
4	185743738	rs6858762	C	T	12	9	21	0	0	21	0	0
4	185744820	rs1554336	C	T	9	10	19	0	1	20	0	0
4	185745029	rs2139178	C	T	8	12	20	0	0	20	0	0
4	185745640	rs11940804	T	C	8	5	13	0	0	13	0	0
4	185746088	rs12503643	G	T	4	7	11	0	0	11	0	0
4	185746257	rs67824824	T	C	3	3	6	0	0	6	0	0
4	185746565	rs12504478	C	G	4	2	6	0	0	6	0	0
4	185776649	rs6856034	T	C	5	2	7	0	0	7	0	0
4	185776650	rs6830690	G	A	5	2	7	0	0	7	0	0
4	187114073	rs5004484	C	G	6	6	12	0	0	12	0	0
4	190862083	rs1138726	T	C	92	73	165	0	1	166	0	0
4	190862155	rs4145515	T	G	163	175	338	0	1	339	0	0
4	190862182	rs2411530	C	T	180	200	380	0	5	385	0	0
4	190864015	rs6553396	C	A	3	3	6	0	0	6	0	0
4	190876195	rs7684300	C	T	295	308	603	0	1	604	0	0
4	190880853	rs1882895	G	A	3	4	7	0	0	7	0	0
4	190881438	rs2411550	T	C	5	6	11	0	0	11	0	0
4	190881536	rs3959346	C	T	3	4	7	0	0	7	0	0
4	190881691	rs13108772	A	G	8	5	13	0	0	13	0	0
5	197576	rs141188845	G	A	4	2	6	0	0	6	0	0
5	201550	rs3810862	A	G	2	4	6	0	0	6	0	0
5	201824	rs56179436	C	T	1	5	6	0	0	6	0	0
5	202282	rs3932940	C	T	4	5	9	0	0	9	0	0
5	202733	rs72720493	C	T	1	10	11	0	0	11	0	0
5	203042	rs11744204	T	G	2	5	7	0	0	7	0	0
5	214127	rs2099084	T	C	7	14	21	0	0	21	0	0
5	214450	rs2115275	C	T	4	21	25	0	0	25	0	0
5	214454	rs2115274	A	G	4	20	24	0	0	24	0	0
5	214603	rs2162871	A	G	10	23	33	0	0	33	0	0
5	225941	rs59452511	C	T	2	4	6	0	0	6	0	0
5	231111	rs1126417	T	C	138	111	249	0	3	252	0	0
5	234983	rs140519744	A	G	5	5	10	0	0	10	0	0
5	235548	rs10060259	T	C	1	6	7	0	0	7	0	0
5	235593	.	C	G	2	8	10	0	0	10	0	0
5	240820	rs150390853	T	G	14	11	25	0	0	25	0	0
5	242003	rs72711326	A	C	18	20	38	0	0	38	0	0
5	242040	rs10060206	A	G	21	25	46	0	0	46	0	0
5	242308	rs72711328	T	G	37	28	65	0	3	68	0	0
5	242453	rs148416613	C	G	40	22	62	0	1	63	0	0
5	250646	rs7706416	A	G	6	4	10	0	0	10	0	0
5	250769	rs7706696	A	G	6	3	9	0	0	9	0	0
5	254861	rs2241600	C	G	9	8	17	0	0	17	0	0
5	296050	rs4957016	G	A	8	3	11	0	0	11	0	0
5	296219	rs6881576	A	T	4	6	10	0	0	10	0	0
5	296552	rs150255025	C	T	8	7	15	0	0	15	0	0
5	297066	rs2943345	C	T	12	9	21	0	1	22	0	0
5	304462	rs7448453	C	T	3	3	6	0	1	7	0	0
5	305595	rs16900804	T	C	7	5	12	0	0	12	0	0
5	309096	rs3756712	A	C	4	3	7	0	0	7	0	0
5	311478	rs2244029	T	C	83	89	172	0	0	172	0	0
5	313762	rs2672767	G	A	10	5	15	0	0	15	0	0
5	314329	rs76740326	C	T	11	5	16	0	0	16	0	0
5	442790	rs10035653	G	A	7	1	8	0	0	8	0	0
5	457176	rs59568259	T	A	5	1	6	0	0	6	0	0
5	458999	rs2434698	T	C	11	16	27	0	1	28	0	0
5	459003	rs2434699	G	A	11	13	24	0	1	25	0	0
5	459681	.	G	T	18	16	34	0	0	34	0	0
5	460079	rs7716075	C	T	25	27	52	0	1	53	0	0
5	462556	rs2081942	G	A	11	15	26	0	0	26	0	0
5	467652	.	G	T	17	0	17	0	1	18	0	0
5	469379	rs79060451	A	G	4	4	8	0	0	8	0	0
5	469644	rs2278249	C	T	6	5	11	0	0	11	0	0
5	469765	rs2278250	C	T	1	6	7	0	0	7	0	0
5	470087	rs2278251	G	A	104	89	193	0	2	195	0	0
5	473797	rs6868891	G	C	5	2	7	0	0	7	0	0
5	473957	rs3777225	C	A	9	5	14	0	0	14	0	0
5	473979	rs13354935	G	A	5	8	13	0	1	14	0	0
5	475895	rs45521339	C	T	4	8	12	0	0	12	0	0
5	476848	rs890976	C	T	9	2	11	0	0	11	0	0
5	476969	rs890978	C	T	6	5	11	0	0	11	0	0
5	477019	rs2244223	T	C	5	7	12	0	0	12	0	0
5	477175	rs2278252	G	T	11	9	20	0	0	20	0	0
5	477253	rs890979	A	G	18	8	26	0	0	26	0	0
5	477303	rs890980	A	G	13	5	18	0	0	18	0	0
5	477968	rs2278254	G	A	11	0	11	0	0	11	0	0
5	478059	rs78031941	C	G	2	16	18	0	0	18	0	0
5	478440	rs3734137	G	A	11	4	15	0	0	15	0	0
5	478447	rs10062053	A	G	5	11	16	0	0	16	0	0
5	478458	rs3734138	T	C	9	5	14	0	0	14	0	0
5	478466	rs3734139	T	C	9	6	15	0	1	16	0	0
5	478655	rs3734141	G	A	9	4	13	0	0	13	0	0
5	478755	rs10053300	G	C	3	8	11	0	0	11	0	0
5	479454	rs890982	C	T	6	3	9	0	0	9	0	0
5	479473	rs890983	C	T	6	3	9	0	0	9	0	0
5	479746	rs890985	C	G	7	7	14	0	0	14	0	0
5	481194	rs6879351	G	A	6	1	7	0	0	7	0	0
5	881077	.	C	T	5	5	10	0	0	10	0	0
5	881241	.	C	T	33	32	65	0	0	65	0	0
5	882057	rs116588393	C	T	15	21	36	0	0	36	0	0
5	1051687	rs1058508	T	C	27	23	50	0	0	50	0	0
5	1052360	rs3810854	C	T	14	18	32	0	0	32	0	0
5	1054197	rs4975572	C	T	6	6	12	0	0	12	0	0
5	1057615	rs2241606	A	G	10	11	21	0	0	21	0	0
5	1063998	rs7722287	G	A	16	15	31	0	0	31	0	0
5	1065399	rs737154	C	T	11	5	16	0	0	16	0	0
5	1319680	rs451360	C	A	29	14	43	0	0	43	0	0
5	1320136	rs421629	G	A	27	10	37	0	1	38	0	0
5	1320247	rs380286	G	A	25	7	32	0	0	32	0	0
5	1320722	rs402710	C	T	19	4	23	0	0	23	0	0
5	1323212	rs13178866	C	T	2	4	6	0	0	6	0	0
5	1324121	rs414965	G	A	10	10	20	0	1	21	0	0
5	1325590	rs421284	T	C	4	2	6	0	0	6	0	0
5	1325684	.	G	A	5	3	8	0	0	8	0	0
5	1325767	.	A	G	4	8	12	0	0	12	0	0
5	1325803	rs465498	A	G	3	7	10	0	0	10	0	0
5	1327101	rs11133729	C	G	6	6	12	0	1	14	1	0
5	1327851	rs383009	C	T	11	6	17	0	1	18	0	0
5	1328897	rs380145	C	T	6	6	12	0	0	12	0	0
5	1330253	rs452932	T	C	4	2	6	0	0	6	0	0
5	1330840	rs452384	T	C	8	7	15	0	0	15	0	0
5	1490124	rs10475025	A	C	5	3	8	0	0	8	0	0
5	1490352	rs58146373	T	G	2	5	7	0	0	7	0	0
5	1490594	rs1010626	T	C	5	6	11	0	0	11	0	0
5	1491009	rs10058172	A	G	4	2	6	0	0	6	0	0
5	1610287	.	T	C	0	7	7	0	1	8	0	0
5	1610302	.	C	T	0	6	6	0	0	6	0	0
5	1610316	.	A	T	0	7	7	0	0	7	0	0
5	1801936	rs974722	A	G	6	3	9	0	0	9	0	0
5	1802229	rs1845288	C	T	6	6	12	0	0	12	0	0
5	1803326	rs1873926	C	T	9	7	16	0	0	16	0	0
5	1803564	rs4147769	G	A	14	12	26	0	0	26	0	0
5	1803748	rs4147770	T	C	10	9	19	0	0	19	0	0
5	1803901	rs3776150	C	T	20	14	34	0	0	34	0	0
5	1804056	rs3776149	T	C	16	11	27	0	2	29	0	0
5	1804180	rs3776148	C	T	13	11	24	0	0	24	0	0
5	1804530	rs3776147	G	A	8	4	12	0	1	13	0	0
5	1805554	rs4975731	T	C	15	10	25	0	1	26	0	0
5	1806627	rs1018120	C	T	11	8	19	0	0	19	0	0
5	1807093	rs35380881	C	T	18	7	25	0	0	25	0	0
5	1807407	rs4975849	T	G	15	14	29	0	4	33	0	0
5	1807475	rs11959171	G	A	13	13	26	0	0	26	0	0
5	1807682	rs3822364	G	A	22	8	30	0	0	30	0	0
5	1807912	rs3776146	A	G	20	11	31	0	0	31	0	0
5	1808626	rs3776145	C	T	10	15	25	0	0	25	0	0
5	1808861	rs3776144	A	G	16	10	26	0	0	26	0	0
5	1808976	rs3776143	A	G	7	4	11	0	0	11	0	0
5	1809228	rs3756346	C	T	15	22	37	0	2	39	0	0
5	1809320	rs3756345	A	T	17	23	40	0	2	42	0	0
5	1809674	rs3776142	T	C	16	11	27	0	0	27	0	0
5	1809713	rs3776141	G	A	14	15	29	0	0	29	0	0
5	1811479	rs904760	A	C	38	15	53	0	1	54	0	0
5	1812332	rs12515616	G	A	149	50	199	0	0	199	0	0
5	1812906	rs6863367	T	C	6	1	7	0	0	7	0	0
5	1812965	rs13170104	G	A	7	0	7	0	0	7	0	0
5	1812995	rs6555012	T	C	12	0	12	0	0	12	0	0
5	1813568	rs3756343	C	T	25	34	59	0	0	59	0	0
5	1814146	rs4147772	G	A	56	84	140	0	0	140	0	0
5	1815415	rs11133910	A	C	4	4	8	0	0	8	0	0
5	1815449	rs11133911	C	G	5	6	11	0	0	11	0	0
5	5467989	.	C	G	5	5	10	0	0	10	0	0
5	6372248	rs4592	G	A	101	85	186	0	1	187	0	0
5	6372585	rs9451	A	G	265	305	570	0	10	581	1	0
5	6373732	rs7726893	C	T	27	11	38	0	0	38	0	0
5	6374004	rs2455146	A	G	7	14	21	0	0	21	0	0
5	6374079	rs2455147	A	C	7	12	19	0	1	20	0	0
5	6374985	rs2562616	T	C	13	20	33	0	0	33	0	0
5	6375337	rs905140	A	G	10	15	25	0	0	25	0	0
5	6375480	rs16877235	C	T	6	7	13	0	0	13	0	0
5	6377832	rs9313147	A	G	3	4	7	0	0	7	0	0
5	6378192	rs9313148	G	C	2	4	6	0	0	6	0	0
5	6600793	rs3776446	T	C	24	15	39	0	0	39	0	0
5	6600864	rs3822433	T	C	7	16	23	0	0	23	0	0
5	6601055	rs3776444	A	T	9	19	28	0	1	29	0	0
5	6601257	rs564457	T	C	10	15	25	0	0	25	0	0
5	6601309	rs4701741	C	T	14	10	24	0	0	24	0	0
5	6602544	rs2303711	T	C	12	7	19	0	0	19	0	0
5	6602668	rs2303710	G	C	12	9	21	0	0	21	0	0
5	6603711	rs3776441	G	A	3	4	7	0	0	7	0	0
5	6603942	rs11748532	C	T	7	4	11	0	0	11	0	0
5	6604931	rs6889694	C	T	50	40	90	0	2	92	0	0
5	6604970	rs6888601	G	A	52	35	87	0	0	87	0	0
5	6605271	rs506416	G	A	51	34	85	0	2	87	0	0
5	6605532	rs2303707	C	A	47	45	92	0	0	92	0	0
5	6605540	rs13171975	T	C	42	40	82	0	1	83	0	0
5	6605829	rs11743548	G	T	25	18	43	0	2	45	0	0
5	6606019	rs6876067	A	G	33	12	45	0	1	46	0	0
5	6606303	rs6555402	C	T	29	18	47	0	0	47	0	0
5	6606323	rs6555403	T	C	23	19	42	0	0	42	0	0
5	6606445	rs6555404	G	A	16	7	23	0	0	23	0	0
5	6606807	rs7700639	G	A	5	3	8	0	2	10	0	0
5	6607916	rs720846	T	C	25	22	47	0	0	47	0	0
5	6608150	rs1366297	T	C	15	15	30	0	0	30	0	0
5	6608534	rs502272	A	T	16	8	24	0	1	25	0	0
5	6608877	rs484418	A	G	9	12	21	0	0	21	0	0
5	6608957	rs3776439	T	C	7	8	15	0	0	15	0	0
5	6609024	rs6882580	C	T	5	13	18	0	0	18	0	0
5	6609088	rs3776437	C	A	11	13	24	0	1	25	0	0
5	6609112	.	G	A	15	9	24	0	1	25	0	0
5	6609139	rs12374467	G	A	18	10	28	0	0	28	0	0
5	6610911	rs11741091	T	C	6	5	11	0	0	11	0	0
5	6611757	rs10454287	A	T	4	8	12	0	0	12	0	0
5	6620459	rs2288446	A	G	4	2	6	0	0	6	0	0
5	6633042	rs10062086	C	T	13	13	26	0	1	27	0	0
5	6633222	rs4702373	C	T	4	2	6	0	0	6	0	0
5	6651970	rs3822430	A	G	4	2	6	0	0	6	0	0
5	6652009	rs8192186	G	A	4	6	10	0	0	10	0	0
5	6656210	rs3736316	G	A	6	6	12	0	0	12	0	0
5	6668842	rs3297	C	T	5	7	12	0	0	12	0	0
5	6669000	rs13974	A	G	12	9	21	0	0	21	0	0
5	6719164	rs274721	C	T	4	3	7	0	0	7	0	0
5	6727188	rs6865483	A	G	6	2	8	0	0	8	0	0
5	6732114	rs1006148	T	C	5	5	10	0	0	10	0	0
5	6732120	rs880993	C	G	5	4	9	0	0	9	0	0
5	6733506	rs11134177	A	T	4	3	7	0	0	7	0	0
5	6735245	rs1003098	C	T	3	3	6	0	0	6	0	0
5	6736215	rs274689	G	C	3	5	8	0	0	8	0	0
5	6737134	rs200841	T	C	5	4	9	0	0	9	0	0
5	6740468	rs377137	T	G	2	8	10	0	0	10	0	0
5	6740855	rs416689	C	T	6	3	9	0	0	9	0	0
5	6744176	rs274672	G	A	22	32	54	0	0	54	0	0
5	6745875	rs427394	A	G	15	20	35	0	0	35	0	0
5	6746648	rs2291704	T	C	3	9	12	0	0	12	0	0
5	6747238	rs2290617	T	C	7	8	15	0	1	16	0	0
5	6747453	rs182135	G	A	5	5	10	0	0	10	0	0
5	6747950	rs274683	T	A	6	9	15	0	0	15	0	0
5	6748810	rs2279653	G	A	11	7	18	0	0	18	0	0
5	6750830	.	G	A	4	2	6	0	0	6	0	0
5	6751071	rs191109862	G	A	5	3	8	0	0	8	0	0
5	6752109	rs3797185	G	A	3	7	10	0	0	10	0	0
5	6752385	rs274678	G	A	3	10	13	0	0	13	0	0
5	6753806	rs7356738	T	C	8	0	8	0	0	8	0	0
5	6755319	rs274675	C	T	61	74	135	0	2	137	0	0
5	6755460	rs274674	C	T	48	62	110	0	3	113	0	0
5	7305293	rs3890111	G	A	17	0	17	0	0	17	0	0
5	7859523	rs1046012	A	G	25	29	54	0	0	54	0	0
5	7870083	rs326119	C	A	2	6	8	0	0	8	0	0
5	7870095	rs12653464	G	A	2	6	8	0	0	8	0	0
5	7878179	rs1532268	C	T	38	43	81	0	1	82	0	0
5	7880835	rs162033	C	T	10	1	11	0	0	11	0	0
5	7887284	rs13189728	A	C	8	12	20	0	0	20	0	0
5	7887488	rs13190084	A	G	4	4	8	0	1	9	0	0
5	7888198	rs62342530	A	G	2	4	6	0	0	6	0	0
5	7890266	rs190193283	A	T	6	9	15	0	1	16	0	0
5	7891097	rs4001964	A	C	7	6	13	0	0	13	0	0
5	7897319	rs1802059	G	A	83	121	204	0	0	204	0	0
5	7897946	rs17267793	A	G	14	6	20	0	0	20	0	0
5	7898640	rs13163363	C	T	19	19	38	0	0	38	0	0
5	7899231	rs35400615	C	T	25	20	45	0	0	45	0	0
5	7899419	rs716537	C	T	24	30	54	0	0	54	0	0
5	7899850	rs62342557	T	C	5	3	8	0	0	8	0	0
5	7900338	rs115253331	A	G	54	49	103	0	0	103	0	0
5	7900598	rs9282787	T	C	17	16	33	0	0	33	0	0
5	8460415	rs34805629	C	G	10	8	18	0	0	18	0	0
5	8460453	rs79804225	C	T	6	3	9	0	1	10	0	0
5	10250430	rs2548546	G	A	27	27	54	0	0	54	0	0
5	10250443	rs2578618	T	C	46	40	86	0	2	88	0	0
5	10254817	rs2578617	A	G	111	82	193	0	1	194	0	0
5	10255821	rs3846599	T	C	6	1	7	0	0	7	0	0
5	10256161	rs1042392	T	C	98	105	203	0	0	203	0	0
5	10259873	rs3105815	T	G	5	2	7	0	0	7	0	0
5	10259990	rs6876282	A	C	3	4	7	0	0	7	0	0
5	10261065	rs12516390	C	T	7	5	12	0	0	12	0	0
5	10261250	rs2607314	C	G	1	5	6	0	0	6	0	0
5	10261408	rs2607316	T	G	4	5	9	0	0	9	0	0
5	10261434	rs2607319	G	C	3	4	7	0	0	7	0	0
5	10261764	rs141675330	C	G	160	132	292	0	1	293	0	0
5	10261966	rs2244717	G	A	13	16	29	0	0	29	0	0
5	10262158	rs2244722	A	G	20	18	38	0	0	38	0	0
5	10262347	rs2244729	G	A	29	28	57	0	0	57	0	0
5	10262366	rs2244730	C	T	35	28	63	0	0	63	0	0
5	10262405	rs2244733	G	A	27	29	56	0	0	56	0	0
5	10262740	rs2578642	C	A	35	42	77	0	1	78	0	0
5	10263041	rs6893533	A	C	20	40	60	0	1	61	0	0
5	10264962	rs544	A	G	153	168	321	0	0	321	0	0
5	10265076	rs699113	C	T	31	52	83	0	0	83	0	0
5	10265719	rs2578639	C	G	2	4	6	0	0	6	0	0
5	10266067	rs2578638	G	T	3	4	7	0	0	7	0	0
5	10280376	rs113659583	G	A	6	3	9	0	0	9	0	0
5	10285689	rs114538813	C	T	6	1	7	0	0	7	0	0
5	10285808	.	T	C	9	0	9	0	1	10	0	0
5	10376875	.	G	T	6	4	10	0	0	10	0	0
5	10382248	rs2640712	G	A	4	5	9	0	0	9	0	0
5	10383537	rs2567584	G	A	4	3	7	0	0	7	0	0
5	10385680	rs2567583	A	G	8	7	15	0	0	15	0	0
5	10396015	rs2567565	A	G	8	6	14	0	0	14	0	0
5	10397021	rs2640711	G	A	9	3	12	0	1	13	0	0
5	10397621	rs3852167	G	C	4	3	7	0	0	7	0	0
5	10397623	rs2567566	C	G	3	4	7	0	0	7	0	0
5	10399578	rs2567567	C	G	6	6	12	0	1	13	0	0
5	10400113	rs2640707	T	C	14	16	30	0	0	30	0	0
5	10413501	rs2567588	T	C	7	7	14	0	0	14	0	0
5	10417575	rs2934222	C	G	18	13	31	0	0	31	0	0
5	10419328	rs2567578	T	C	32	30	62	0	0	62	0	0
5	10422076	rs2589667	A	G	6	11	17	0	0	17	0	0
5	10422579	rs2380095	A	G	13	12	25	0	0	25	0	0
5	10428221	rs2934221	G	A	8	5	13	0	0	13	0	0
5	10428540	rs1295192	A	G	4	4	8	0	0	8	0	0
5	10433294	rs3852168	G	A	3	4	7	0	0	7	0	0
5	10434643	rs2589668	A	G	7	27	34	0	0	34	0	0
5	10437435	rs1287599	C	A	38	49	87	0	1	88	0	0
5	10437834	rs1287600	C	T	69	79	148	0	2	150	0	0
5	10438757	rs1287601	T	G	8	0	8	0	0	8	0	0
5	10679746	rs7973	T	C	145	124	269	0	4	273	0	0
5	10680063	rs5745300	G	A	116	103	219	0	0	219	0	0
5	10680749	rs10271	G	A	120	139	259	0	1	260	0	0
5	10681110	rs5745296	A	G	61	73	134	0	2	136	0	0
5	10752139	rs77155899	G	A	4	2	6	0	0	6	0	0
5	10752181	rs3797143	T	C	0	6	6	0	0	6	0	0
5	10758378	rs267931	C	G	6	6	12	0	0	12	0	0
5	10758562	rs267930	G	A	5	6	11	0	0	11	0	0
5	10758861	rs58891571	C	A	3	5	8	0	0	8	0	0
5	10758867	rs58583280	G	A	3	5	8	0	0	8	0	0
5	14368975	rs13189406	C	T	15	19	34	0	0	34	0	0
5	14397238	rs30774	T	C	12	14	26	0	0	26	0	0
5	14465355	rs17500759	C	T	5	5	10	0	0	10	0	0
5	14479938	rs26173	G	A	4	2	6	0	0	6	0	0
5	14482166	rs32526	G	C	3	4	7	0	0	7	0	0
5	14498727	rs26107	G	A	46	33	79	0	0	79	0	0
5	14503119	rs152433	G	A	6	2	8	0	0	8	0	0
5	14507905	rs26086	A	G	4	4	8	0	0	8	0	0
5	14599926	rs250184	T	G	6	4	10	0	0	10	0	0
5	14697914	rs39609	C	T	77	74	151	0	1	152	0	0
5	14698233	rs31995	T	C	43	39	82	0	1	83	0	0
5	14699582	rs31994	C	T	108	114	222	0	0	222	0	0
5	14705665	rs26307	T	C	3	3	6	0	0	6	0	0
5	17212748	rs143695303	G	A	4	2	6	0	0	6	0	0
5	17212752	rs151255543	A	G	4	3	7	0	0	7	0	0
5	17217899	rs147621681	C	T	73	69	142	0	1	143	0	0
5	17219093	rs1540599	G	T	2	4	6	0	0	6	0	0
5	21480111	.	G	A	3	4	7	0	0	7	0	0
5	21480137	.	A	G	3	4	7	0	0	7	0	0
5	21495276	.	C	T	17	2	19	0	1	20	0	0
5	21497180	.	G	A	10	2	12	0	0	12	0	0
5	21497187	.	C	T	10	2	12	0	0	12	0	0
5	31401003	rs642321	T	C	5	6	11	0	0	11	0	0
5	31401447	rs10719	A	G	40	46	86	0	0	86	0	0
5	31408484	rs3805524	G	A	3	3	6	0	0	6	0	0
5	31408671	rs3805523	A	G	7	1	8	0	0	8	0	0
5	31409252	rs2241337	A	G	108	77	185	0	1	186	0	0
5	31410923	rs61748189	G	A	84	47	131	0	0	131	0	0
5	31411879	rs10940952	A	G	3	8	11	0	0	11	0	0
5	31423007	rs2287584	T	C	57	35	92	0	1	93	0	0
5	31515657	rs55656741	G	A	12	11	23	0	0	23	0	0
5	31531619	rs17409803	A	G	6	22	28	0	0	28	0	0
5	31532789	rs17409893	A	G	5	3	8	0	0	8	0	0
5	32227486	.	C	A	26	16	42	0	0	42	0	0
5	32229677	rs1873921	G	A	17	6	23	0	0	23	0	0
5	32255813	.	C	T	58	40	98	0	4	102	0	0
5	32274259	rs76849027	A	C	1	8	9	0	0	9	0	0
5	32400266	rs1051489	A	G	90	77	167	0	2	169	0	0
5	32712831	rs4867473	C	T	4	2	6	0	0	6	0	0
5	32713365	rs62369523	T	G	4	2	6	0	0	6	0	0
5	32716535	rs11750438	C	T	35	3	38	0	0	38	0	0
5	32716589	rs10057069	T	C	6	30	36	0	0	36	0	0
5	32786389	rs2270915	A	G	82	78	160	0	1	161	0	0
5	32788184	.	C	T	23	21	44	0	0	44	0	0
5	32788369	rs1158715	G	A	33	31	64	0	0	64	0	0
5	32789392	rs2287661	G	A	25	39	64	0	1	65	0	0
5	32789852	rs1173756	T	C	54	55	109	0	0	109	0	0
5	32790616	rs1345597	T	C	57	74	131	0	0	131	0	0
5	33989518	rs2278008	C	T	14	22	36	0	0	36	0	0
5	33998768	rs34677	C	A	17	15	32	0	1	33	0	0
5	33998883	rs2287939	A	G	18	22	40	0	0	40	0	0
5	34930387	rs35176895	T	C	11	11	22	0	1	23	0	0
5	34937960	rs112209905	G	A	11	24	35	0	0	35	0	0
5	34951150	rs37439	C	A	16	10	26	0	1	27	0	0
5	34952823	rs72732854	A	G	10	11	21	0	0	21	0	0
5	35861068	rs1494558	T	C	7	9	16	0	0	16	0	0
5	35871190	rs1494555	G	A	7	11	18	0	0	18	0	0
5	35876274	rs3194051	A	G	4	4	8	0	0	8	0	0
5	35877505	rs10063294	G	A	2	6	8	0	0	8	0	0
5	35877826	rs9292617	A	T	4	2	6	0	1	7	0	0
5	35877841	rs10491435	G	A	5	2	7	0	0	7	0	0
5	35877914	rs10491434	A	G	5	4	9	0	0	9	0	0
5	35878249	rs7716064	G	A	4	6	10	0	0	10	0	0
5	35878927	rs6451231	T	C	19	12	31	0	0	31	0	0
5	35879429	rs1053496	T	C	10	9	19	0	0	19	0	0
5	35879595	rs700179	A	G	10	9	19	0	0	19	0	0
5	36098822	rs3799	A	G	2	4	6	0	1	7	0	0
5	36164421	rs4434406	A	G	3	3	6	0	0	6	0	0
5	36179097	rs33662	G	A	8	14	22	0	0	22	0	0
5	36194007	rs3088073	T	A	30	25	55	0	0	55	0	0
5	36687856	rs2269272	C	T	3	3	6	0	0	6	0	0
5	36985303	rs3822471	A	G	94	105	199	0	1	200	0	0
5	36992990	rs188488	A	G	6	11	17	0	0	17	0	0
5	36995205	rs159755	T	A	10	9	19	0	1	20	0	0
5	37051246	rs12188075	C	A	7	1	8	0	0	8	0	0
5	37288535	rs10473043	A	G	51	52	103	0	0	103	0	0
5	37288935	rs140491224	G	C	7	12	19	0	0	19	0	0
5	37289049	rs11750291	T	A	16	21	37	0	0	37	0	0
5	37333727	rs150594	A	G	18	18	36	0	0	36	0	0
5	37393417	rs12659660	C	G	7	4	11	0	0	11	0	0
5	37393433	rs12189377	C	T	4	7	11	0	0	11	0	0
5	37528147	rs62359011	G	T	5	6	11	0	0	11	0	0
5	37528509	rs36190855	C	G	3	12	15	0	0	15	0	0
5	37688094	rs6451337	C	T	20	0	20	0	0	20	0	0
5	37696178	rs6451339	T	C	9	0	9	0	0	9	0	0
5	38940245	.	C	A	71	51	122	0	10	132	0	0
5	38940246	.	A	C	89	30	119	0	9	128	0	0
5	38955796	rs2043112	G	A	64	57	121	0	0	121	0	0
5	39008680	rs75513875	A	G	4	2	6	0	0	6	0	0
5	39010209	rs1239274	C	G	4	2	6	0	0	6	0	0
5	39060643	rs13171123	C	T	10	6	16	0	0	16	0	0
5	39105594	rs358501	C	T	15	12	27	0	0	27	0	0
5	39269845	rs35249	C	T	22	11	33	0	0	33	0	0
5	39372150	rs1046033	A	G	22	19	41	0	0	41	0	0
5	39373253	rs4578	C	T	4	5	9	0	0	9	0	0
5	39376988	rs3733801	C	T	7	7	14	0	0	14	0	0
5	39394493	rs1050903	G	C	2	8	10	0	0	10	0	0
5	42800808	rs7579	C	T	23	19	42	0	1	43	0	0
5	43015122	rs66521413	T	A	4	12	16	0	1	17	0	0
5	43015214	rs160709	A	C	10	5	15	0	0	15	0	0
5	43016195	rs10522	G	C	6	4	10	0	1	11	0	0
5	43016650	rs222060	C	T	5	8	13	0	0	13	0	0
5	43018123	rs71627568	G	T	4	5	9	0	0	9	0	0
5	43018348	rs4637560	T	C	6	8	14	0	0	14	0	0
5	43018575	rs4092294	A	G	7	5	12	0	0	12	0	0
5	43018651	rs4092293	G	A	5	6	11	0	0	11	0	0
5	43018839	rs35484387	T	C	9	19	28	0	0	28	0	0
5	43024494	rs36048737	G	T	6	3	9	0	0	9	0	0
5	43039793	rs1054428	T	C	105	116	221	0	0	221	0	0
5	43066712	rs13167991	G	A	13	14	27	0	0	27	0	0
5	43066774	rs316408	T	C	18	22	40	0	0	40	0	0
5	43072724	rs316403	A	G	2	6	8	0	0	8	0	0
5	43073433	rs316402	G	T	13	15	28	0	0	28	0	0
5	43074291	.	T	C	4	4	8	0	0	8	0	0
5	43078218	rs178415	T	G	39	45	84	0	0	84	0	0
5	43084813	rs503965	G	A	5	2	7	0	0	7	0	0
5	43098707	rs34517361	G	T	5	5	10	0	0	10	0	0
5	43120098	rs511340	A	G	0	6	6	0	0	6	0	0
5	43123623	rs567884	T	C	2	4	6	0	0	6	0	0
5	43124688	rs782971	A	G	4	4	8	0	0	8	0	0
5	43127925	rs3797306	A	G	3	8	11	0	0	11	0	0
5	43129946	rs13159390	G	A	2	4	6	0	0	6	0	0
5	43130263	rs147769962	G	A	8	3	11	0	0	11	0	0
5	43130436	rs72748897	T	A	6	5	11	0	0	11	0	0
5	43132040	rs72750704	T	C	2	4	6	0	0	6	0	0
5	43132756	rs72750764	G	A	4	4	8	0	0	8	0	0
5	43133765	rs35754881	C	G	7	5	12	0	1	13	0	0
5	43134467	rs35199583	G	A	5	4	9	0	0	9	0	0
5	43134510	rs512921	A	G	5	4	9	0	0	9	0	0
5	43134610	rs512040	A	G	6	7	13	0	0	13	0	0
5	43135801	rs28548198	C	T	3	6	9	0	1	10	0	0
5	43135957	rs521649	C	T	6	2	8	0	0	8	0	0
5	43136704	rs77422760	G	A	3	3	6	0	0	6	0	0
5	43136705	rs79875910	T	C	2	4	6	0	0	6	0	0
5	43137865	rs35949944	G	A	14	19	33	0	1	34	0	0
5	43147181	rs77324927	A	G	3	5	8	0	0	8	0	0
5	43161337	rs903391	A	G	4	4	8	0	0	8	0	0
5	43172896	rs782984	A	G	2	4	6	0	0	6	0	0
5	43175103	rs35397154	C	T	132	104	236	0	0	236	0	0
5	43175369	rs35855029	G	T	115	173	288	0	0	288	0	0
5	43289708	rs6814	G	C	55	64	119	0	0	119	0	0
5	43290700	rs13659	T	A	41	33	74	0	2	76	0	0
5	43294192	rs56257144	C	T	30	19	49	0	2	51	0	0
5	43297144	rs3733769	A	G	17	12	29	0	0	29	0	0
5	43297819	rs6898398	C	T	4	2	6	0	0	6	0	0
5	43298515	rs6863360	C	T	4	2	6	0	0	6	0	0
5	43313531	rs12514393	C	T	6	3	9	0	0	9	0	0
5	43378817	rs7710570	T	C	3	3	6	0	0	6	0	0
5	43379792	rs11741797	A	G	2	4	6	0	0	6	0	0
5	43381580	rs7706402	G	A	5	3	8	0	0	8	0	0
5	43445855	rs11547957	A	C	5	1	6	0	0	6	0	0
5	43484257	rs79904209	C	T	3	5	8	0	0	8	0	0
5	43495599	rs56333629	C	T	40	1	41	0	1	42	0	0
5	43495684	rs10066408	C	T	19	1	20	0	1	21	0	0
5	43527033	rs4866747	A	T	21	18	39	0	0	39	0	0
5	43527381	rs71629179	T	C	16	9	25	0	1	26	0	0
5	43530035	rs6866325	G	C	3	7	10	0	1	11	0	0
5	43531116	rs60297702	A	G	4	7	11	0	0	11	0	0
5	43535754	rs6869933	G	C	5	3	8	0	0	8	0	0
5	43543557	rs6884661	C	T	8	13	21	0	0	21	0	0
5	43543651	rs10059912	T	C	9	8	17	0	1	18	0	0
5	43545310	rs10462051	G	A	3	7	10	0	0	10	0	0
5	43545534	rs13359906	A	G	7	10	17	0	0	17	0	0
5	43545628	rs12332560	A	G	6	6	12	0	0	12	0	0
5	43545734	rs191057893	C	G	7	8	15	0	0	15	0	0
5	43605098	rs79231838	G	A	4	5	9	0	0	9	0	0
5	43609343	rs10057103	C	T	10	10	20	0	1	21	0	0
5	49693458	rs2883164	C	T	19	28	47	0	1	48	0	0
5	49694583	rs3933097	T	G	25	22	47	0	1	48	0	0
5	49694713	rs1052977	T	A	11	17	28	0	0	28	0	0
5	49709068	rs1010676	T	C	8	5	13	0	0	13	0	0
5	49709450	rs13357429	C	A	4	2	6	0	0	6	0	0
5	49709774	rs13184466	C	A	3	8	11	0	0	11	0	0
5	49710710	rs16879113	T	G	5	13	18	0	0	18	0	0
5	49710895	rs13159506	A	G	8	10	18	0	0	18	0	0
5	49711287	rs4495185	C	T	5	2	7	0	0	7	0	0
5	49715382	.	T	C	5	1	6	0	0	6	0	0
5	49738788	rs13159894	A	C	8	14	22	0	0	22	0	0
5	49962179	rs62366936	T	C	1	6	7	0	0	7	0	0
5	50043855	rs71615982	A	G	3	8	11	0	1	12	0	0
5	50045967	rs2442107	G	T	16	4	20	0	1	21	0	0
5	50057729	rs282547	G	A	100	40	140	0	2	142	0	0
5	50139286	rs285529	A	G	18	8	26	0	0	26	0	0
5	50139358	rs27243	A	T	21	6	27	0	0	27	0	0
5	52979097	rs567	G	A	42	27	69	0	0	69	0	0
5	54603307	.	A	G	25	35	60	0	2	62	0	0
5	54960609	rs4865614	A	G	5	7	12	0	0	12	0	0
5	54960673	rs4865615	C	G	3	7	10	0	0	10	0	0
5	54960687	rs4865616	C	T	3	8	11	0	0	11	0	0
5	55800724	rs25789	C	T	61	0	61	0	7	68	0	0
5	56116085	rs252902	A	G	2	6	8	0	0	8	0	0
5	56118482	rs563296879	A	G	9	4	13	0	0	13	0	0
5	56118733	rs252904	A	T	2	4	6	0	0	6	0	0
5	56118875	rs252905	G	A	1	6	7	0	0	7	0	0
5	56119190	rs252906	C	A	2	5	7	0	1	8	0	0
5	56120413	rs2432195	C	T	9	12	21	0	1	22	0	0
5	56149429	rs860580	T	G	2	4	6	0	0	6	0	0
5	56150537	rs860581	A	G	4	7	11	0	0	11	0	0
5	56150622	.	G	C	4	5	9	0	0	9	0	0
5	56161787	rs832575	G	A	20	25	45	0	0	45	0	0
5	56177443	rs702689	G	A	22	27	49	0	0	49	0	0
5	56177743	rs832582	G	A	30	33	63	0	0	63	0	0
5	56177843	rs45556841	C	G	41	34	75	0	1	76	0	0
5	56178217	rs832583	A	C	32	39	71	0	0	71	0	0
5	56190986	rs702688	A	G	16	16	32	0	0	32	0	0
5	56191200	rs832546	T	A	56	33	89	0	0	89	0	0
5	56207123	rs2257505	T	A	4	4	8	0	0	8	0	0
5	56207792	rs43183	C	T	5	4	9	0	0	9	0	0
5	56209735	rs40497	A	G	16	43	59	0	0	59	0	0
5	56215152	rs832533	T	C	5	4	9	0	0	9	0	0
5	56218029	rs702681	C	T	52	67	119	0	1	120	0	0
5	56220382	rs702680	T	C	4	2	6	0	0	6	0	0
5	56224124	rs252895	A	G	5	4	9	0	0	9	0	0
5	56233541	rs2591968	G	A	3	4	7	0	0	7	0	0
5	56233551	rs2591967	C	G	3	3	6	0	0	6	0	0
5	56235548	rs1445996	C	T	5	1	6	0	0	6	0	0
5	56236176	rs2591965	T	C	4	2	6	0	0	6	0	0
5	56236900	rs2591964	T	G	4	2	6	0	0	6	0	0
5	56237135	rs2591963	T	A	4	3	7	0	0	7	0	0
5	56237155	rs2591962	G	A	4	2	6	0	0	6	0	0
5	56242774	rs2034244	T	C	41	28	69	0	0	69	0	0
5	57750350	rs15009	C	G	47	52	99	0	0	99	0	0
5	57754851	rs702722	A	G	20	11	31	0	0	31	0	0
5	57755703	rs3211270	C	T	12	6	18	0	0	18	0	0
5	58265605	.	T	G	19	26	45	0	1	46	0	0
5	58267976	rs829259	T	A	97	112	209	0	1	210	0	0
5	58269240	rs17719258	T	C	38	33	71	0	1	72	0	0
5	58335025	.	C	T	30	29	59	0	0	59	0	0
5	58571617	rs16889518	A	G	6	5	11	0	0	11	0	0
5	60140061	rs35453042	T	C	1	5	6	0	0	6	0	0
5	60200665	rs4647100	A	G	9	6	15	0	0	15	0	0
5	60235240	rs158938	G	A	4	5	9	0	0	9	0	0
5	60235314	rs182352	A	T	6	3	9	0	0	9	0	0
5	60235483	rs4647052	C	T	5	3	8	0	0	8	0	0
5	60241142	rs158921	G	A	23	29	52	0	0	52	0	0
5	60633113	rs56256680	A	C	16	7	23	0	1	24	0	0
5	60642347	rs6449528	G	A	4	4	8	0	0	8	0	0
5	60642595	rs4604142	C	T	4	5	9	0	0	9	0	0
5	60643513	rs6449529	T	C	3	13	16	0	0	16	0	0
5	60655782	rs10061522	A	G	15	9	24	0	1	25	0	0
5	64859592	rs261252	T	A	19	16	35	0	2	37	0	0
5	64860547	rs261250	C	T	24	29	53	0	0	53	0	0
5	64861271	rs12516229	G	C	19	9	28	0	0	28	0	0
5	64865346	rs149512	A	T	5	4	9	0	0	9	0	0
5	64875004	rs13177756	A	G	17	29	46	0	0	46	0	0
5	64875105	rs37334	G	T	23	15	38	0	0	38	0	0
5	64876389	rs37335	A	G	5	31	36	0	1	37	0	0
5	64876490	rs37336	G	A	24	23	47	0	0	47	0	0
5	64877614	rs11740053	A	G	7	5	12	0	0	12	0	0
5	64886546	rs10699	A	G	17	26	43	0	0	43	0	0
5	64949594	rs17241135	G	A	3	4	7	0	1	8	0	0
5	64953081	rs11737962	C	T	3	3	6	0	0	6	0	0
5	64954159	rs28084	A	G	4	4	8	0	0	8	0	0
5	64956216	rs37351	C	T	3	4	7	0	0	7	0	0
5	64956249	rs74873074	A	G	2	4	6	0	0	6	0	0
5	64957299	rs72764480	G	T	5	7	12	0	0	12	0	0
5	64962816	rs72764483	A	G	39	45	84	0	0	84	0	0
5	64964250	.	G	C	12	8	20	0	0	20	0	0
5	64964978	rs72764486	G	A	9	5	14	0	0	14	0	0
5	64965137	rs27138	C	G	9	6	15	0	0	15	0	0
5	64965900	rs1549192	T	C	16	16	32	0	1	33	0	0
5	65105886	.	T	G	3	6	9	0	0	9	0	0
5	65108215	rs2254485	A	G	6	4	10	0	0	10	0	0
5	65120027	rs9291848	G	A	6	2	8	0	0	8	0	0
5	65120054	rs1550818	C	T	6	3	9	0	0	9	0	0
5	65120144	rs10096	T	C	2	5	7	0	0	7	0	0
5	67528286	rs138111407	G	A	1	6	7	0	0	7	0	0
5	67587434	rs831125	A	G	6	3	9	0	0	9	0	0
5	67588148	rs3730089	G	A	140	124	264	0	2	266	0	0
5	67592281	rs895304	G	A	6	3	9	0	0	9	0	0
5	67595861	rs12755	C	A	45	44	89	0	1	90	0	0
5	67596088	rs3756668	G	A	206	185	391	0	7	398	0	0
5	67596933	rs66666989	C	T	306	268	574	0	0	574	0	0
5	67597270	.	A	G	12	6	18	0	0	18	0	0
5	67597321	rs9623	T	C	23	18	41	0	1	42	0	0
5	68409094	rs164393	A	C	4	6	10	0	1	11	0	0
5	68414334	rs61749603	G	A	7	5	12	0	0	12	0	0
5	68425699	rs6886492	A	G	2	5	7	0	0	7	0	0
5	68506040	rs111243827	G	C	69	65	134	0	0	134	0	0
5	68616132	.	T	G	7	10	17	0	0	17	0	0
5	68682024	.	G	C	25	25	50	0	1	51	0	0
5	69367063	.	G	T	2	4	6	0	0	6	0	0
5	69515779	.	G	T	34	33	67	0	1	68	0	0
5	69515863	.	G	A	17	12	29	0	1	30	0	0
5	69515870	.	C	T	20	9	29	0	0	29	0	0
5	70406701	.	C	T	0	8	8	0	1	9	0	0
5	70798541	rs36009281	A	G	12	19	31	0	0	31	0	0
5	70800475	rs3761966	C	T	18	11	29	0	0	29	0	0
5	70800538	rs3761967	G	A	15	17	32	0	0	32	0	0
5	70806457	rs715748	G	A	14	14	28	0	0	28	0	0
5	70806649	rs1961760	T	A	11	8	19	0	0	19	0	0
5	70809169	rs1698063	A	G	11	27	38	0	0	38	0	0
5	70811909	.	C	A	21	19	40	0	0	40	0	0
5	70818150	rs12187098	C	G	26	21	47	0	1	48	0	0
5	70840233	rs182190	C	T	21	18	39	0	0	39	0	0
5	70849021	rs469039	G	T	15	16	31	0	0	31	0	0
5	70858194	rs277941	C	T	10	14	24	0	1	25	0	0
5	70862059	rs185733	C	T	25	13	38	0	1	39	0	0
5	70862874	rs277945	C	T	27	40	67	0	0	67	0	0
5	70862879	rs12659208	C	T	36	23	59	0	2	61	0	0
5	70934311	rs12188784	G	A	4	4	8	0	0	8	0	0
5	70934704	rs544779	G	A	4	3	7	0	0	7	0	0
5	70934904	rs277935	T	G	6	1	7	0	0	7	0	0
5	70936643	rs277936	C	G	4	5	9	0	0	9	0	0
5	70953885	rs277975	C	T	9	8	17	0	0	17	0	0
5	71515616	rs6831	A	G	85	97	182	0	0	182	0	0
5	71519664	rs3209157	C	T	20	22	42	0	0	42	0	0
5	71524163	rs10942927	A	T	24	29	53	0	0	53	0	0
5	71654855	rs7714219	G	C	9	5	14	0	0	14	0	0
5	71657414	rs62364788	G	A	7	2	9	0	0	9	0	0
5	71664031	rs17377355	G	A	7	2	9	0	0	9	0	0
5	72209989	.	A	G	302	327	629	0	4	633	0	0
5	72795369	rs819564	T	G	2	8	10	0	0	10	0	0
5	72798724	rs347233	T	G	20	17	37	0	1	38	0	0
5	72800408	rs703882	G	C	5	3	8	0	0	8	0	0
5	72849591	rs343102	T	C	7	6	13	0	0	13	0	0
5	72849775	rs343103	C	T	7	4	11	0	0	11	0	0
5	72850282	rs343104	A	G	4	5	9	0	0	9	0	0
5	72857986	rs819582	T	C	5	2	7	0	0	7	0	0
5	72857999	rs189341	A	G	5	2	7	0	0	7	0	0
5	72861309	rs343108	G	A	14	6	20	0	0	20	0	0
5	72861366	rs343109	G	A	9	5	14	0	0	14	0	0
5	72862289	.	G	A	5	1	6	0	0	6	0	0
5	72863824	rs74978501	T	C	7	9	16	0	0	16	0	0
5	72863894	rs168223	G	A	12	3	15	0	0	15	0	0
5	72874907	rs343122	A	C	57	42	99	0	2	101	0	0
5	72876035	rs343120	G	A	8	16	24	0	0	24	0	0
5	72876119	rs343119	T	C	7	14	21	0	0	21	0	0
5	72876776	rs343118	C	A	5	6	11	0	0	11	0	0
5	73929841	rs6453068	T	C	2	5	7	0	0	7	0	0
5	73930751	rs300239	C	T	21	8	29	0	0	29	0	0
5	73932315	rs9176	T	C	16	6	22	0	0	22	0	0
5	73981270	rs820878	T	C	31	31	62	0	1	63	0	0
5	73984460	rs6453073	A	G	3	3	6	0	0	6	0	0
5	73984610	rs7710892	C	T	3	3	6	0	0	6	0	0
5	73985215	rs11556045	A	G	80	102	182	0	1	183	0	0
5	73985910	rs13154639	A	G	7	0	7	0	0	7	0	0
5	73986189	rs12519436	T	C	14	1	15	0	0	15	0	0
5	73986200	rs10942718	C	T	11	0	11	0	0	11	0	0
5	73986206	rs12521189	G	A	9	0	9	0	0	9	0	0
5	73986648	rs820875	A	G	10	2	12	0	0	12	0	0
5	73986826	rs3776484	T	C	17	1	18	0	0	18	0	0
5	73999205	rs820834	T	C	2	4	6	0	0	6	0	0
5	74001977	rs820827	G	A	13	10	23	0	0	23	0	0
5	74002394	rs820825	G	A	2	4	6	0	0	6	0	0
5	74002438	rs6870622	G	A	3	3	6	0	0	6	0	0
5	74002931	rs141512892	C	T	2	4	6	0	0	6	0	0
5	74007489	.	A	C	7	2	9	0	0	9	0	0
5	74008944	rs17670605	G	A	5	5	10	0	0	10	0	0
5	74015025	rs17738111	T	C	37	35	72	0	0	72	0	0
5	74015234	rs62366371	A	T	35	46	81	0	1	82	0	0
5	74017499	rs1048167	C	T	51	56	107	0	0	107	0	0
5	74020029	rs10515189	C	T	4	2	6	0	0	6	0	0
5	74032116	rs16872231	G	A	4	3	7	0	0	7	0	0
5	74032897	rs7713812	T	C	2	5	7	0	0	7	0	0
5	74037386	rs16872235	T	A	26	20	46	0	0	46	0	0
5	74038805	rs56127814	C	A	5	3	8	0	0	8	0	0
5	74039150	rs11743415	C	A	6	4	10	0	0	10	0	0
5	74039263	.	C	T	3	4	7	0	0	7	0	0
5	74046464	rs17852781	C	T	11	16	27	0	0	27	0	0
5	74046656	rs6873998	A	G	2	4	6	0	0	6	0	0
5	74055209	rs957680	T	C	11	17	28	0	0	28	0	0
5	74062881	rs11556477	C	T	6	4	10	0	0	10	0	0
5	74070134	rs6883420	T	G	6	9	15	0	0	15	0	0
5	74070492	rs3968877	A	G	7	2	9	0	0	9	0	0
5	74130664	rs1993371	T	A	2	4	6	0	0	6	0	0
5	74130665	rs1993372	C	A	2	4	6	0	0	6	0	0
5	74749969	rs116070404	T	C	11	10	21	0	0	21	0	0
5	75699194	rs1122654	C	T	8	4	12	0	0	12	0	0
5	75699599	rs62363210	T	C	4	3	7	0	0	7	0	0
5	75699680	rs62363211	G	A	4	2	6	0	0	6	0	0
5	75700310	rs9293683	C	T	5	2	7	0	0	7	0	0
5	75911399	rs1047530	T	C	5	2	7	0	0	7	0	0
5	75911464	rs1047529	A	C	4	3	7	0	0	7	0	0
5	75911715	rs2069693	G	T	4	3	7	0	0	7	0	0
5	76003258	rs464494	C	T	57	47	104	0	2	106	0	0
5	76004328	rs153316	T	C	3	3	6	0	0	6	0	0
5	76030796	rs1801719	T	C	13	5	18	0	0	18	0	0
5	76114963	rs1529505	C	T	6	3	9	0	0	9	0	0
5	76250972	rs32897	T	C	8	7	15	0	0	15	0	0
5	76252375	rs32898	A	G	6	5	11	0	0	11	0	0
5	76252686	rs75342827	C	T	7	6	13	0	0	13	0	0
5	76253764	rs7701813	C	A	7	8	15	0	0	15	0	0
5	76253810	rs10066068	C	T	9	7	16	0	0	16	0	0
5	76258048	rs7718461	A	G	27	23	50	0	0	50	0	0
5	76258461	rs1018160	A	G	13	11	24	0	0	24	0	0
5	76264982	rs1875999	T	C	160	138	298	0	0	298	0	0
5	76265035	rs1053989	C	A	163	134	297	0	1	298	0	0
5	76326885	rs2278241	G	A	2	5	7	0	0	7	0	0
5	76359024	rs34400049	C	A	26	29	55	0	0	55	0	0
5	76360122	rs113215682	G	A	52	58	110	0	0	110	0	0
5	76369337	rs1048834	T	G	12	10	22	0	0	22	0	0
5	76370827	rs1529460	T	C	71	72	143	0	1	144	0	0
5	76372192	rs75180394	C	T	35	44	79	0	3	82	0	0
5	76372709	rs1056587	G	A	34	43	77	0	1	78	0	0
5	76374956	rs35558152	A	C	2	4	6	0	0	6	0	0
5	76375077	rs56045003	G	A	14	10	24	0	0	24	0	0
5	76375672	rs34432214	T	C	6	1	7	0	0	7	0	0
5	77066189	rs73765206	A	G	4	3	7	0	0	7	0	0
5	77068775	rs71632943	G	A	15	12	27	0	0	27	0	0
5	77069502	rs254421	G	A	22	22	44	0	0	44	0	0
5	77069705	rs254420	T	C	24	25	49	0	0	49	0	0
5	77070033	rs71632944	T	C	17	12	29	0	0	29	0	0
5	77070699	.	T	C	13	8	21	0	0	21	0	0
5	77070762	rs254419	C	A	6	10	16	0	1	17	0	0
5	77071284	rs254416	C	T	9	15	24	0	2	26	0	0
5	77071703	rs254415	G	T	2	4	6	0	0	6	0	0
5	77072121	rs4024280	G	C	19	12	31	0	1	32	0	0
5	77783029	rs11743650	T	C	21	25	46	0	2	48	0	0
5	78074963	rs754567	T	G	2	4	6	0	0	6	0	0
5	78076160	rs2173012	C	T	8	6	14	0	0	14	0	0
5	78181423	rs1071598	C	T	6	5	11	0	0	11	0	0
5	78181477	rs1065757	C	T	5	7	12	0	0	12	0	0
5	78234830	rs12658000	T	G	11	4	15	0	0	15	0	0
5	78236503	rs337839	C	T	7	3	10	0	0	10	0	0
5	78236589	rs9763091	G	A	5	1	6	0	0	6	0	0
5	78237846	rs10474571	A	G	3	4	7	0	0	7	0	0
5	78253122	rs234687	A	G	4	6	10	0	0	10	0	0
5	78532076	.	C	G	7	1	8	0	1	9	0	0
5	78909958	rs6863792	A	C	6	2	8	0	0	8	0	0
5	78910132	rs62364124	G	A	5	2	7	0	0	7	0	0
5	78910248	rs6883691	C	T	4	4	8	0	0	8	0	0
5	78912380	rs60818258	A	G	8	2	10	0	0	10	0	0
5	78913441	rs35805677	G	C	5	1	6	0	0	6	0	0
5	78915992	rs3828602	A	C	3	4	7	0	0	7	0	0
5	78920250	rs1875530	T	G	39	47	86	0	1	87	0	0
5	78939341	rs1948764	C	T	3	6	9	0	0	9	0	0
5	78940139	rs58314186	G	A	4	2	6	0	0	6	0	0
5	78940414	rs34059910	C	G	4	2	6	0	0	6	0	0
5	78940783	rs16876991	C	T	7	7	14	0	0	14	0	0
5	78945711	rs7711830	G	A	6	4	10	0	0	10	0	0
5	78948971	rs6884654	A	T	4	2	6	0	0	6	0	0
5	78949413	rs6453469	A	G	2	4	6	0	0	6	0	0
5	78949877	rs62365189	A	G	7	5	12	0	0	12	0	0
5	78949908	rs62365190	C	G	7	3	10	0	0	10	0	0
5	78949951	rs62365191	T	C	5	3	8	0	0	8	0	0
5	78950371	rs3891351	T	C	6	8	14	0	1	15	0	0
5	78950407	rs764311	C	T	6	6	12	0	0	12	0	0
5	78951474	rs6875026	G	A	7	2	9	0	0	9	0	0
5	78951490	rs6875039	G	A	7	2	9	0	0	9	0	0
5	78952691	rs67039976	G	A	14	13	27	0	0	27	0	0
5	78954326	rs6877796	T	A	1	5	6	0	0	6	0	0
5	78957543	rs61196068	G	A	7	6	13	0	0	13	0	0
5	78958366	rs7724000	G	A	5	3	8	0	0	8	0	0
5	78958490	.	G	A	4	3	7	0	0	7	0	0
5	78958549	rs62365229	G	A	5	4	9	0	0	9	0	0
5	78959105	rs4704572	C	A	4	5	9	0	0	9	0	0
5	78959130	rs4703781	A	G	3	7	10	0	0	10	0	0
5	78959643	rs58919140	C	T	5	13	18	0	0	18	0	0
5	78959746	rs57959985	G	C	4	13	17	0	0	17	0	0
5	78960215	rs62365232	C	T	2	14	16	0	0	16	0	0
5	78961764	rs10942899	T	G	2	4	6	0	1	7	0	0
5	78963780	rs6895525	A	C	4	4	8	0	2	10	0	0
5	78981550	rs3087813	G	T	163	162	325	0	1	326	0	0
5	79276149	rs6870377	G	C	5	12	17	0	0	17	0	0
5	79276281	rs6892826	A	G	9	9	18	0	3	21	0	0
5	79276953	rs10071601	G	C	1	6	7	0	0	7	0	0
5	79277215	rs10064975	A	G	6	6	12	0	0	12	0	0
5	79277335	rs17196706	A	C	4	7	11	0	0	11	0	0
5	79277817	rs6453495	A	C	5	9	14	0	0	14	0	0
5	79278596	rs11741143	T	C	2	10	12	0	0	12	0	0
5	79370247	rs13167730	G	T	0	7	7	0	0	7	0	0
5	79372407	rs384941	C	T	56	37	93	0	1	94	0	0
5	79435803	rs55740328	G	A	8	8	16	0	1	17	0	0
5	79436186	rs55777108	A	G	4	2	6	0	0	6	0	0
5	80149981	rs184967	A	G	14	9	23	0	1	24	0	0
5	80169035	.	T	C	28	23	51	0	0	51	0	0
5	80608545	rs2270825	G	A	26	26	52	0	0	52	0	0
5	80736444	rs9596	A	G	18	16	34	0	0	34	0	0
5	80767655	rs6866727	T	C	6	0	6	0	0	6	0	0
5	80769369	rs2396170	G	C	23	9	32	0	0	32	0	0
5	80835793	rs56005129	T	C	5	3	8	0	0	8	0	0
5	80864718	rs35438373	A	G	3	3	6	0	0	6	0	0
5	80865272	rs66969660	A	T	17	81	98	0	0	98	0	0
5	80865481	rs62368675	A	G	19	65	84	0	4	88	0	0
5	80866198	rs12515751	A	C	5	12	17	0	0	17	0	0
5	80866422	rs35586490	C	G	16	47	63	0	0	63	0	0
5	80867413	rs4426897	G	A	5	7	12	0	0	12	0	0
5	80869873	rs2972244	C	T	3	5	8	0	0	8	0	0
5	80870584	rs4529168	G	A	1	6	7	0	0	7	0	0
5	81009972	rs62366307	C	T	9	8	17	0	0	17	0	0
5	81549240	rs1864182	C	A	6	3	9	0	0	9	0	0
5	81550207	rs1135335	C	T	5	9	14	0	0	14	0	0
5	81550381	.	G	A	1	5	6	0	2	8	0	0
5	81569293	rs3738	A	C	320	89	409	0	3	413	1	0
5	81569311	rs3739	A	G	336	95	431	0	0	431	0	0
5	81570394	rs226203	G	A	12	35	47	0	0	47	0	0
5	81571669	rs226202	C	T	37	105	142	0	0	142	0	0
5	81571846	rs226201	G	A	81	149	230	0	0	230	0	0
5	81572464	rs226199	G	C	4	5	9	0	1	10	0	0
5	81574182	rs6880209	C	T	4	4	8	0	0	8	0	0
5	82349377	rs7891	A	G	59	38	97	0	1	98	0	0
5	82350191	rs27493	G	A	53	29	82	0	1	83	0	0
5	82350810	rs255561	C	A	34	21	55	0	0	55	0	0
5	86661010	rs3804233	C	G	19	93	112	0	1	114	1	0
5	86661054	rs3804232	T	A	13	31	44	0	0	44	0	0
5	86663270	rs2923742	T	C	33	6	39	0	0	39	0	0
5	86665098	.	G	T	2	4	6	0	0	6	0	0
5	86677220	rs3827607	G	A	4	6	10	0	0	10	0	0
5	86677755	rs11750894	T	A	5	3	8	0	0	8	0	0
5	86683105	rs1062035	C	G	3	5	8	0	0	8	0	0
5	88015545	rs34316	A	C	4	2	6	0	0	6	0	0
5	88099951	rs4521516	G	C	2	5	7	0	0	7	0	0
5	88148638	.	A	C	3	4	7	0	0	7	0	0
5	88153874	rs55740951	C	T	18	8	26	0	0	26	0	0
5	88154616	rs77654793	A	T	15	15	30	0	0	30	0	0
5	88157552	rs4518438	T	C	4	3	7	0	0	7	0	0
5	88158146	rs7730255	G	C	7	5	12	0	0	12	0	0
5	88159966	rs76768696	T	G	10	3	13	0	0	13	0	0
5	88160354	rs56947091	C	T	3	3	6	0	0	6	0	0
5	88161417	rs12054920	T	C	3	5	8	0	0	8	0	0
5	88166061	rs10064180	G	A	3	3	6	0	0	6	0	0
5	88168955	rs797419	C	A	12	5	17	0	0	17	0	0
5	88170066	rs304136	T	C	10	3	13	0	0	13	0	0
5	88170331	rs216057	T	C	6	3	9	0	0	9	0	0
5	88177599	rs77381797	T	C	8	8	16	0	1	17	0	0
5	89810077	rs1047787	G	A	5	4	9	0	0	9	0	0
5	89812676	rs3087840	T	A	7	13	20	0	0	20	0	0
5	89816299	rs171790	C	A	6	3	9	0	0	9	0	0
5	89816383	rs13182165	G	A	2	4	6	0	0	6	0	0
5	89819560	rs7716979	A	C	4	2	6	0	0	6	0	0
5	89819800	rs7717423	A	G	5	2	7	0	0	7	0	0
5	89820186	rs1553545	A	G	7	3	10	0	0	10	0	0
5	89820984	rs10069050	T	C	43	44	87	0	0	87	0	0
5	89824976	rs37238	C	T	18	7	25	0	0	25	0	0
5	89825035	rs603015	G	A	21	6	27	0	0	27	0	0
5	90665025	rs17638113	G	A	96	84	180	0	2	182	0	0
5	90665473	rs17638138	T	C	138	113	251	0	3	254	0	0
5	92954477	rs58143801	C	A	9	9	18	0	2	20	0	0
5	92954574	rs7712388	C	G	5	8	13	0	0	13	0	0
5	92954716	rs1046217	T	A	6	6	12	0	0	12	0	0
5	92955057	rs7736624	T	C	4	7	11	0	0	11	0	0
5	93138654	rs1470150	T	C	2	4	6	0	0	6	0	0
5	93366135	rs6870688	G	A	3	3	6	0	0	6	0	0
5	93994405	rs28787271	A	G	4	2	6	0	0	6	0	0
5	94032989	rs10044768	C	T	5	3	8	0	0	8	0	0
5	94032995	rs10039102	G	T	5	4	9	0	1	10	0	0
5	94043352	.	C	T	3	3	6	0	0	6	0	0
5	94043353	rs7735924	G	T	3	3	6	0	0	6	0	0
5	94050447	rs2638	C	T	54	32	86	0	0	86	0	0
5	94050487	rs2636	T	A	51	37	88	0	0	88	0	0
5	94225877	rs293055	A	C	3	3	6	0	0	6	0	0
5	94237398	rs26998	C	T	17	22	39	0	0	39	0	0
5	94239189	rs26997	T	C	8	6	14	0	0	14	0	0
5	94250056	rs186095	A	C	7	7	14	0	0	14	0	0
5	94252979	rs469968	G	A	2	15	17	0	0	17	0	0
5	94254379	rs62365751	T	G	6	1	7	0	0	7	0	0
5	94254691	rs469061	A	C	7	5	12	0	0	12	0	0
5	94255599	rs293047	G	C	4	2	6	0	0	6	0	0
5	94262642	rs293052	T	G	5	2	7	0	0	7	0	0
5	94267120	rs13170906	C	A	6	5	11	0	0	11	0	0
5	94268504	rs189265195	G	C	7	4	11	0	0	11	0	0
5	94268566	rs13166515	T	G	4	5	9	0	0	9	0	0
5	94269133	rs17084316	C	T	3	4	7	0	0	7	0	0
5	94278129	rs293035	T	C	19	25	44	0	2	46	0	0
5	94747274	rs3906363	A	G	4	5	9	0	0	9	0	0
5	94747652	rs7717264	C	T	4	4	8	0	0	8	0	0
5	94747733	rs7716264	G	T	10	9	19	0	0	19	0	0
5	94747866	rs7716456	G	A	10	4	14	0	0	14	0	0
5	94747964	rs7737309	A	T	14	2	16	0	0	16	0	0
5	94748056	rs7737471	A	C	12	7	19	0	0	19	0	0
5	94748180	rs7707641	T	C	14	5	19	0	1	20	0	0
5	94748352	rs7703849	A	T	8	3	11	0	0	11	0	0
5	94748360	rs7703853	A	T	8	4	12	0	0	12	0	0
5	94748607	rs7704204	A	G	7	3	10	0	0	10	0	0
5	94748662	rs7704343	A	T	6	5	11	0	0	11	0	0
5	94748878	rs7722912	C	T	9	5	14	0	0	14	0	0
5	94748911	rs7722932	C	G	11	4	15	0	0	15	0	0
5	94748944	rs7708941	T	A	9	5	14	0	0	14	0	0
5	94749422	rs7726429	G	C	1	6	7	0	0	7	0	0
5	94749723	rs7726891	G	A	10	10	20	0	0	20	0	0
5	94750232	rs6878485	T	A	3	6	9	0	0	9	0	0
5	94750293	rs6874124	A	G	7	6	13	0	0	13	0	0
5	94750299	rs6892564	G	A	7	7	14	0	0	14	0	0
5	94750445	rs6892914	G	T	6	7	13	0	0	13	0	0
5	94751133	rs34999134	A	G	1	5	6	0	0	6	0	0
5	94751489	rs55994669	T	C	3	3	6	0	0	6	0	0
5	94831757	rs1981952	T	C	2	4	6	0	0	6	0	0
5	95084131	rs34896	G	A	13	12	25	0	0	25	0	0
5	95091194	rs34898	C	T	15	12	27	0	0	27	0	0
5	95091201	rs34899	A	G	16	10	26	0	0	26	0	0
5	95092113	rs138115734	C	A	9	5	14	0	0	14	0	0
5	95129251	rs12351	T	G	8	6	14	0	0	14	0	0
5	95131292	rs6815	G	A	30	28	58	0	0	58	0	0
5	95131401	rs7622	A	G	46	35	81	0	0	81	0	0
5	95150245	rs1047420	G	A	16	13	29	0	2	31	0	0
5	95152085	rs6556883	A	G	5	1	6	0	0	6	0	0
5	95152313	rs4561	A	G	184	226	410	0	3	413	0	0
5	95152493	rs955688	T	A	10	7	17	0	1	18	0	0
5	95155812	rs6875489	C	T	3	4	7	0	0	7	0	0
5	95239222	rs13166162	G	A	3	4	7	0	0	7	0	0
5	96086334	rs754615	G	C	37	27	64	0	0	64	0	0
5	96100764	rs26501	G	C	3	4	7	0	0	7	0	0
5	96105926	rs25863	G	A	7	9	16	0	0	16	0	0
5	96107202	rs27689	G	T	7	5	12	0	1	13	0	0
5	96107774	rs27581	C	T	5	4	9	0	0	9	0	0
5	96109244	rs28096	G	A	1	7	8	0	0	8	0	0
5	96109610	rs1057569	G	A	15	12	27	0	0	27	0	0
5	96109935	rs27433	T	G	9	13	22	0	0	22	0	0
5	96110211	rs7063	A	T	13	11	24	0	1	25	0	0
5	96111228	rs3198304	A	G	44	4	48	0	1	49	0	0
5	96111371	rs13160562	G	A	30	6	36	0	1	37	0	0
5	96112083	rs1065407	T	G	21	11	32	0	0	32	0	0
5	96118852	rs27044	G	C	27	24	51	0	1	52	0	0
5	96118866	rs17482078	C	T	27	34	61	0	0	61	0	0
5	96120054	rs39840	G	C	1	9	10	0	0	10	0	0
5	96120170	rs39841	G	A	2	8	10	0	0	10	0	0
5	96120259	rs30376	C	T	2	6	8	0	0	8	0	0
5	96120455	rs42398	C	T	5	13	18	0	0	18	0	0
5	96120933	.	T	A	3	10	13	0	0	13	0	0
5	96121152	rs2032890	A	C	1	15	16	0	0	16	0	0
5	96121184	rs13185488	G	A	1	13	14	0	0	14	0	0
5	96121243	rs13186739	C	T	1	8	9	0	0	9	0	0
5	96121524	rs469783	C	T	23	8	31	0	0	31	0	0
5	96122210	rs10050860	C	T	26	28	54	0	1	55	0	0
5	96124330	rs30187	T	C	16	15	31	0	1	32	0	0
5	96126308	rs27529	A	G	21	17	38	0	0	38	0	0
5	96129512	rs27434	A	G	14	15	29	0	0	29	0	0
5	96129535	rs2287987	T	C	15	15	30	0	0	30	0	0
5	96139250	rs26653	C	G	8	10	18	0	0	18	0	0
5	96228072	rs75263594	C	T	16	8	24	0	0	24	0	0
5	96231000	rs2549782	G	T	14	10	24	0	1	25	0	0
5	96231372	rs2549783	T	C	4	2	6	0	0	6	0	0
5	96232142	rs2548538	T	A	19	11	30	0	0	30	0	0
5	96235896	rs2248374	A	G	1	9	10	0	0	10	0	0
5	96237326	rs2287988	G	A	22	10	32	0	0	32	0	0
5	96244549	rs2549794	C	T	4	2	6	0	0	6	0	0
5	96244638	rs2549795	A	G	3	4	7	0	0	7	0	0
5	96245343	rs2549796	C	T	35	20	55	0	1	56	0	0
5	96245439	rs1056893	C	T	44	23	67	0	3	70	0	0
5	96247434	rs2910793	G	A	2	7	9	0	0	9	0	0
5	96247750	rs10463196	C	T	6	4	10	0	0	10	0	0
5	96247810	rs6873866	T	C	5	3	8	0	0	8	0	0
5	96247827	rs13163165	G	A	5	3	8	0	0	8	0	0
5	96249115	rs2255546	C	T	68	28	96	0	0	96	0	0
5	96250457	rs2548522	G	A	4	4	8	0	0	8	0	0
5	96254209	rs1230381	A	G	31	42	73	0	1	74	0	0
5	96254354	rs1230382	T	A	31	43	74	0	0	74	0	0
5	96254817	rs1019503	G	A	35	57	92	0	0	92	0	0
5	96271804	rs185601392	C	T	5	11	16	0	0	16	0	0
5	96273033	rs2548225	A	T	4	11	15	0	0	15	0	0
5	96273034	rs2617435	T	C	4	11	15	0	0	15	0	0
5	96273180	rs1046395	G	A	3	3	6	0	0	6	0	0
5	96273187	rs1046396	G	A	5	2	7	0	0	7	0	0
5	96273298	rs2762	C	T	7	3	10	0	0	10	0	0
5	96274223	rs2910787	C	T	5	3	8	0	0	8	0	0
5	96275154	rs2617439	G	A	1	5	6	0	0	6	0	0
5	96275186	rs2548226	C	T	3	3	6	0	0	6	0	0
5	96275201	rs2432142	G	A	4	2	6	0	0	6	0	0
5	96275413	rs2548516	C	T	2	4	6	0	0	6	0	0
5	96316758	rs3797796	C	T	5	4	9	0	0	9	0	0
5	96364454	rs39602	C	G	16	23	39	0	0	39	0	0
5	96366328	.	G	C	12	4	16	0	0	16	0	0
5	96367408	rs27998	G	A	7	4	11	0	0	11	0	0
5	96369146	rs76290380	C	G	10	9	19	0	0	19	0	0
5	96370879	rs248215	G	A	1	13	14	0	1	15	0	0
5	96372165	rs9127	G	A	42	29	71	0	1	72	0	0
5	96497866	rs56410653	C	T	9	13	22	0	0	22	0	0
5	98191530	rs139918850	T	G	121	151	272	0	8	280	0	0
5	98192545	rs692759	T	C	3	3	6	0	0	6	0	0
5	98199077	rs10069735	T	C	4	4	8	0	0	8	0	0
5	98201668	rs466442	G	A	12	5	17	0	0	17	0	0
5	98232554	rs60421587	T	C	3	7	10	0	0	10	0	0
5	99897866	rs6874840	G	A	23	16	39	0	0	39	0	0
5	99922081	rs13876	G	A	6	7	13	0	0	13	0	0
5	100143084	rs13857	G	C	1	5	6	0	0	6	0	0
5	100145777	rs2725124	C	A	11	3	14	0	1	15	0	0
5	100147398	rs3076	C	T	6	2	8	0	0	8	0	0
5	100185360	rs9327327	C	T	7	5	12	0	0	12	0	0
5	100189728	rs72778620	A	G	3	3	6	0	1	7	0	0
5	100191561	rs11742480	G	T	3	4	7	0	0	7	0	0
5	100236848	rs3756352	G	A	3	3	6	0	0	6	0	0
5	100238801	rs1428439	A	G	43	51	94	0	0	94	0	0
5	102203032	rs2230458	G	C	4	4	8	0	0	8	0	0
5	107714778	.	A	G	13	18	31	0	0	31	0	0
5	107715746	rs1397580	A	G	19	26	45	0	0	45	0	0
5	108660528	rs17161729	G	C	2	5	7	0	0	7	0	0
5	108671838	rs33729	C	T	200	179	379	0	2	381	0	0
5	108672755	rs33730	T	A	41	37	78	0	2	80	0	0
5	108672946	rs246105	C	T	134	133	267	0	1	268	0	0
5	108673453	rs2416207	T	C	8	5	13	0	0	13	0	0
5	108675737	rs400277	C	T	2	5	7	0	0	7	0	0
5	108713970	rs10042721	C	T	99	90	189	0	1	190	0	0
5	108713982	rs12523186	T	C	105	94	199	0	2	201	0	0
5	108714298	rs1045706	T	C	124	120	244	0	1	245	0	0
5	108719151	rs1045704	G	A	80	80	160	0	1	161	0	0
5	109034924	rs150895295	A	G	4	5	9	0	0	9	0	0
5	109201475	rs72814838	T	C	2	4	6	0	0	6	0	0
5	110439509	rs11241095	A	G	13	17	30	0	2	32	0	0
5	110456704	rs13186912	A	T	40	30	70	0	0	70	0	0
5	110462230	rs4530809	A	G	4	3	7	0	0	7	0	0
5	110464008	rs1043828	T	C	13	13	26	0	0	26	0	0
5	112182679	.	C	G	2	4	6	0	1	7	0	0
5	112320191	.	A	T	85	58	143	0	0	143	0	0
5	112849478	rs929774	A	G	5	6	11	0	0	11	0	0
5	112868693	rs6594732	C	A	34	32	66	0	0	66	0	0
5	112899573	rs6867579	T	C	30	15	45	0	1	46	0	0
5	112903383	rs76945231	T	G	47	22	69	0	2	71	0	0
5	112904402	rs13182972	A	G	4	3	7	0	0	7	0	0
5	112908171	rs2162841	A	C	5	4	9	0	0	9	0	0
5	112909860	rs111675777	T	G	2	5	7	0	1	8	0	0
5	112910083	.	G	C	4	4	8	0	0	8	0	0
5	112911165	rs10065790	C	T	6	5	11	0	0	11	0	0
5	112911738	rs111778031	G	C	5	1	6	0	0	6	0	0
5	112913284	rs13359625	C	G	4	4	8	0	0	8	0	0
5	112913318	rs13359648	C	T	4	2	6	0	0	6	0	0
5	112913356	rs13359652	C	T	6	3	9	0	0	9	0	0
5	112913934	rs10440762	G	A	5	4	9	0	0	9	0	0
5	112914284	rs4705555	T	C	3	5	8	0	0	8	0	0
5	112916239	rs10478129	A	G	4	2	6	0	0	6	0	0
5	112924159	rs11241215	G	T	3	3	6	0	0	6	0	0
5	112925555	rs35093510	A	G	3	4	7	0	0	7	0	0
5	112926181	rs7729306	T	C	11	7	18	0	0	18	0	0
5	112926755	rs2303718	G	A	66	83	149	0	1	150	0	0
5	112927900	rs73242858	A	T	7	5	12	0	0	12	0	0
5	112928865	rs3763138	G	T	3	4	7	0	0	7	0	0
5	112930203	rs7730949	G	A	51	52	103	0	1	104	0	0
5	112930565	rs7713451	T	C	119	143	262	0	1	263	0	0
5	114540463	rs62383165	T	C	7	4	11	0	0	11	0	0
5	114541887	rs265417	T	G	7	2	9	0	0	9	0	0
5	114541908	rs265418	C	T	9	2	11	0	0	11	0	0
5	114546906	rs265421	C	T	53	47	100	0	1	101	0	0
5	114858437	rs12187973	G	T	98	55	153	0	1	154	0	0
5	114859606	rs3776802	G	C	87	76	163	0	3	166	0	0
5	114859653	rs3776801	T	C	81	65	146	0	3	149	0	0
5	114860161	rs73253005	G	A	91	99	190	0	1	191	0	0
5	114914429	rs2597	T	G	4	2	6	0	0	6	0	0
5	114949680	rs17474216	A	G	24	20	44	0	0	44	0	0
5	114961656	rs2546473	T	C	18	26	44	0	0	44	0	0
5	115177262	rs7724740	C	G	8	3	11	0	0	11	0	0
5	115181188	rs150583525	T	C	5	3	8	0	0	8	0	0
5	115228342	rs10039749	G	A	2	6	8	0	0	8	0	0
5	115241758	rs6880372	C	G	4	2	6	0	0	6	0	0
5	115242142	rs3733902	G	A	4	2	6	0	0	6	0	0
5	115244272	rs139593458	C	G	3	4	7	0	0	7	0	0
5	115244374	rs10055640	G	A	2	4	6	0	0	6	0	0
5	115245631	rs115712182	A	C	3	4	7	0	0	7	0	0
5	115249078	.	C	T	699	1	700	0	4	704	0	0
5	115249271	rs3879477	G	A	606	5	611	0	5	616	0	0
5	115419968	rs10054121	G	A	5	3	8	0	0	8	0	0
5	115428334	rs1129494	G	T	17	11	28	0	1	29	0	0
5	115469773	rs1129496	C	T	16	12	28	0	0	28	0	0
5	115506638	rs144150600	C	G	1	5	6	0	0	6	0	0
5	115521667	rs62384212	A	G	8	0	8	0	0	8	0	0
5	115521811	rs4484468	G	A	6	1	7	0	0	7	0	0
5	115525826	rs6594957	A	G	7	0	7	0	0	7	0	0
5	115526238	rs4921075	T	A	0	6	6	0	0	6	0	0
5	115548348	rs1820053	A	T	5	2	7	0	0	7	0	0
5	115548365	rs7723358	A	G	1	6	7	0	0	7	0	0
5	115901872	rs17140139	T	A	5	3	8	0	0	8	0	0
5	118101904	.	A	C	6	0	6	0	2	8	0	0
5	118323121	rs299205	T	C	4	4	8	0	0	8	0	0
5	118323544	rs299206	C	G	4	3	7	0	0	7	0	0
5	118470659	rs4583917	G	A	19	9	28	0	0	28	0	0
5	118731067	rs1105769	A	C	1	5	6	0	0	6	0	0
5	118811533	rs25640	G	A	35	22	57	0	0	57	0	0
5	118845139	rs32664	G	A	6	44	50	0	0	50	0	0
5	118849174	rs39971	A	G	3	3	6	0	0	6	0	0
5	118861713	rs11205	A	G	85	69	154	0	1	155	0	0
5	118870033	rs3822527	G	C	0	7	7	0	0	7	0	0
5	120656658	rs12659036	G	A	11	13	24	0	0	24	0	0
5	120661145	rs9885432	A	G	36	10	46	0	0	46	0	0
5	120688997	rs10463739	T	A	6	2	8	0	0	8	0	0
5	122139685	rs6595412	G	T	4	2	6	0	0	6	0	0
5	122141459	rs6899195	G	A	5	1	6	0	0	6	0	0
5	122143150	rs10060420	A	G	3	4	7	0	0	7	0	0
5	122145636	rs6872932	T	C	3	5	8	0	0	8	0	0
5	122146094	.	T	A	2	4	6	0	0	6	0	0
5	122146272	rs3822367	C	T	3	3	6	0	0	6	0	0
5	122146831	rs12109791	C	T	6	0	6	0	0	6	0	0
5	122146978	rs10071135	C	G	6	3	9	0	0	9	0	0
5	122147896	rs11241659	G	C	5	2	7	0	0	7	0	0
5	122149934	rs6896344	T	G	6	4	10	0	0	10	0	0
5	122150528	rs565101991	T	G	3	9	12	0	0	12	0	0
5	122154023	rs12515910	G	A	2	4	6	0	0	6	0	0
5	122164612	rs7728489	A	G	4	2	6	0	0	6	0	0
5	122165022	rs10478568	C	T	7	7	14	0	1	15	0	0
5	122165209	rs6885464	T	G	8	3	11	0	0	11	0	0
5	122685727	rs1047437	C	G	28	25	53	0	2	55	0	0
5	122738061	rs62376439	C	A	5	2	7	0	0	7	0	0
5	122950330	rs3797534	G	C	40	24	64	0	2	66	0	0
5	125764421	rs34401600	G	T	7	1	8	0	0	8	0	0
5	125764502	rs4288110	G	A	7	2	9	0	0	9	0	0
5	125764507	rs34585744	G	A	6	2	8	0	0	8	0	0
5	125764628	rs4323230	C	G	4	6	10	0	0	10	0	0
5	125880589	rs2775	T	C	0	7	7	0	0	7	0	0
5	126167776	rs10064033	G	A	3	3	6	0	0	6	0	0
5	126168150	rs2973594	G	C	10	1	11	0	0	11	0	0
5	126171999	rs1051643	T	C	101	106	207	0	2	209	0	0
5	126172195	rs1051644	C	T	126	130	256	0	2	258	0	0
5	158613193	.	C	T	4	2	6	0	0	6	0	0
5	158709982	.	A	T	6	3	9	0	0	9	0	0
5	158712254	rs145815046	A	C	53	5	58	0	6	64	0	0
5	159436161	rs2271945	C	T	6	6	12	0	0	12	0	0
5	159443806	rs4921248	G	T	5	1	6	0	0	6	0	0
5	159444944	.	T	C	8	5	13	0	0	13	0	0
5	159685517	rs143474536	G	A	17	0	17	0	1	18	0	0
5	159829058	rs1128026	A	T	165	118	283	0	2	285	0	0
5	159829947	rs2961936	G	A	49	49	98	0	0	98	0	0
5	159830008	rs2961937	C	T	42	43	85	0	2	87	0	0
5	159840700	rs12522744	A	C	5	6	11	0	0	11	0	0
5	162823770	.	T	G	5	2	7	0	0	7	0	0
5	162823912	rs13187699	G	C	10	11	21	0	1	22	0	0
5	162887650	rs2303076	G	A	1	5	6	0	0	6	0	0
5	162911075	rs2230363	C	A	20	15	35	0	0	35	0	0
5	162940047	rs12515448	G	A	6	5	11	0	0	11	0	0
5	162940108	rs10214203	C	T	9	5	14	0	0	14	0	0
5	162940999	rs11546512	A	G	59	38	97	0	0	97	0	0
5	167919726	rs2305727	A	G	35	26	61	0	0	61	0	0
5	167919825	rs2305728	G	A	38	39	77	0	0	77	0	0
5	167920069	rs3756602	A	G	12	14	26	0	0	26	0	0
5	167920354	rs3756601	G	A	14	10	24	0	0	24	0	0
5	167920597	rs9647571	C	G	9	11	20	0	0	20	0	0
5	167920626	rs9647572	G	A	9	8	17	0	0	17	0	0
5	167920725	rs9647573	G	T	15	8	23	0	0	23	0	0
5	167921389	rs13182927	A	G	29	20	49	0	1	50	0	0
5	167921801	rs78602242	G	A	18	15	33	0	0	33	0	0
5	167922095	rs72830962	A	G	18	16	34	0	0	34	0	0
5	167922578	rs67012869	C	T	29	30	59	0	0	59	0	0
5	167923080	rs9647574	G	A	14	17	31	0	0	31	0	0
5	167923157	rs9647575	A	G	14	5	19	0	0	19	0	0
5	167924123	rs17664493	T	C	31	36	67	0	0	67	0	0
5	167924174	rs72830965	T	G	26	19	45	0	0	45	0	0
5	167924260	rs11557637	C	A	65	68	133	0	3	137	1	0
5	167933060	rs2305733	A	G	98	104	202	0	3	205	0	0
5	167933156	rs61744940	A	G	97	118	215	0	1	216	0	0
5	167933158	rs2305734	T	A	98	117	215	0	2	217	0	0
5	167936000	rs11748918	T	G	6	5	11	0	0	11	0	0
5	167936019	rs10516047	G	A	5	7	12	0	0	12	0	0
5	167937139	rs2290627	A	G	4	3	7	0	0	7	0	0
5	167937253	rs72830973	C	G	14	2	16	0	0	16	0	0
5	167937415	rs2290628	G	A	15	9	24	0	0	24	0	0
5	167978722	rs17664707	C	G	19	29	48	0	0	48	0	0
5	167980525	rs158898	A	G	24	15	39	0	1	40	0	0
5	167982528	rs139659598	G	A	6	5	11	0	0	11	0	0
5	168003959	rs158893	C	A	13	2	15	0	0	15	0	0
5	168004126	rs158892	T	C	9	6	15	0	0	15	0	0
5	168005621	rs158891	A	G	5	2	7	0	0	7	0	0
5	168043619	rs61612167	G	T	18	0	18	0	2	20	0	0
5	169015479	rs116483731	G	A	6	9	15	0	0	15	0	0
5	169138029	rs373808	A	G	6	0	6	0	0	6	0	0
5	169280659	.	C	T	5	2	7	0	0	7	0	0
5	169362082	rs6895199	G	A	5	2	7	0	0	7	0	0
5	169362824	rs13153416	C	A	9	1	10	0	0	10	0	0
5	169363051	rs6859903	A	T	2	4	6	0	0	6	0	0
5	169401557	rs13184164	C	T	5	2	7	0	0	7	0	0
5	169478318	rs7714269	G	C	3	3	6	0	0	6	0	0
5	169507986	rs6885366	G	A	3	17	20	0	0	20	0	0
5	169508011	rs35672222	G	T	5	5	10	0	0	10	0	0
5	169508172	.	A	G	11	8	19	0	0	19	0	0
5	169508461	rs13181782	A	G	11	15	26	0	0	26	0	0
5	169510023	rs9307	A	G	242	222	464	0	5	469	0	0
5	169689519	rs2338871	G	A	9	4	13	0	0	13	0	0
5	169695446	rs2292254	C	T	134	100	234	0	10	244	0	0
5	169695611	rs366122	C	A	7	8	15	0	1	16	0	0
5	169696181	rs315751	C	T	13	10	23	0	1	24	0	0
5	169696233	rs315750	C	G	14	11	25	0	0	25	0	0
5	169696373	rs315749	C	T	15	11	26	0	0	26	0	0
5	169696743	rs315748	C	A	22	17	39	0	0	39	0	0
5	169697122	rs315747	T	G	13	1	14	0	0	14	0	0
5	169697707	rs315745	G	A	28	15	43	0	1	44	0	0
5	169698028	rs315744	A	G	43	50	93	0	1	94	0	0
5	169700022	rs315742	A	C	29	18	47	0	0	47	0	0
5	169700352	rs315741	G	A	23	19	42	0	1	43	0	0
5	169700426	rs315740	C	A	25	16	41	0	0	41	0	0
5	169701017	rs36094591	C	T	24	33	57	0	0	57	0	0
5	169701546	rs4867953	G	C	13	5	18	0	0	18	0	0
5	169702390	rs2271146	C	A	3	4	7	0	0	7	0	0
5	169704002	rs3789179	C	T	2	9	11	0	0	11	0	0
5	169716515	rs13155130	C	T	10	16	26	0	0	26	0	0
5	169723779	rs13164693	C	G	7	6	13	0	0	13	0	0
5	169723931	rs13164877	C	T	3	4	7	0	0	7	0	0
5	169724324	rs315730	A	T	5	6	11	0	0	11	0	0
5	171472575	rs4868136	G	A	3	4	7	0	0	7	0	0
5	171477346	rs4392641	A	G	11	9	20	0	0	20	0	0
5	171481606	rs10155597	A	G	139	158	297	0	3	300	0	0
5	171483129	rs11134727	T	C	10	3	13	0	0	13	0	0
5	171483730	rs13152863	T	C	2	8	10	0	0	10	0	0
5	171523436	rs4868141	G	A	35	24	59	0	0	59	0	0
5	171600555	rs6884456	G	A	1	5	6	0	0	6	0	0
5	171605471	rs2130728	T	C	4	6	10	0	0	10	0	0
5	171605562	rs2172048	A	G	6	2	8	0	0	8	0	0
5	171636926	rs9043	C	T	9	4	13	0	0	13	0	0
5	171655921	rs7726020	G	T	5	4	9	0	0	9	0	0
5	171658243	rs12659910	A	G	4	5	9	0	0	9	0	0
5	171658287	.	T	C	2	6	8	0	0	8	0	0
5	171658346	rs12659926	A	G	5	8	13	0	0	13	0	0
5	171658543	rs11134737	G	A	4	6	10	0	0	10	0	0
5	171658559	rs11134738	G	A	4	5	9	0	0	9	0	0
5	171658781	rs12658484	T	C	2	5	7	0	0	7	0	0
5	171659146	rs12652112	A	G	3	4	7	0	0	7	0	0
5	172189304	rs322356	G	C	2	5	7	0	0	7	0	0
5	172194116	rs72809987	T	C	20	11	31	0	0	31	0	0
5	172196997	rs7702178	T	C	10	16	26	0	0	26	0	0
5	172199366	rs13184134	G	A	3	6	9	0	0	9	0	0
5	173316729	rs359467	G	A	21	15	36	0	0	36	0	0
5	173380346	rs969518	C	T	1	5	6	0	0	6	0	0
5	173380595	rs969519	T	A	3	3	6	0	0	6	0	0
5	173380934	rs17763772	A	G	10	8	18	0	0	18	0	0
5	173383194	rs1564823	C	A	33	31	64	0	0	64	0	0
5	173384663	rs1976074	T	A	41	35	76	0	0	76	0	0
5	174955115	.	G	A	57	39	96	0	4	100	0	0
5	175087111	rs7443900	G	A	14	11	25	0	0	25	0	0
5	175088278	rs2913218	A	C	17	9	26	0	0	26	0	0
5	175110064	.	C	A	7	3	10	0	1	11	0	0
5	175112323	rs7730099	G	T	5	8	13	0	0	13	0	0
5	175112328	rs76827388	A	G	5	9	14	0	0	14	0	0
5	175112330	rs7729715	A	G	5	9	14	0	0	14	0	0
5	175113038	rs678591	G	T	11	18	29	0	0	29	0	0
5	175353627	.	A	G	2	4	6	0	0	6	0	0
5	175354289	.	G	A	3	3	6	0	0	6	0	0
5	175360339	.	A	G	2	6	8	0	0	8	0	0
5	175815215	rs17832192	G	A	2	4	6	0	0	6	0	0
5	175817309	rs143999130	A	G	5	6	11	0	0	11	0	0
5	175819478	rs115470776	G	A	6	2	8	0	0	8	0	0
5	175820588	rs112365133	C	T	1	5	6	0	0	6	0	0
5	175825311	rs11956701	A	G	10	13	23	0	0	23	0	0
5	175826154	rs55827151	C	T	11	7	18	0	0	18	0	0
5	175827476	rs62402498	G	A	7	4	11	0	0	11	0	0
5	175829571	rs11958063	T	G	2	5	7	0	0	7	0	0
5	175830897	rs13169400	G	A	2	5	7	0	0	7	0	0
5	175831645	rs7703742	T	C	4	11	15	0	0	15	0	0
5	175912755	rs7713154	G	A	16	10	26	0	0	26	0	0
5	175917999	rs4868640	A	G	5	6	11	0	0	11	0	0
5	175920441	rs754350	T	G	5	4	9	0	0	9	0	0
5	175921783	rs2913897	A	G	3	3	6	0	0	6	0	0
5	175923431	.	G	A	6	1	7	0	0	7	0	0
5	175930488	rs2913902	G	A	4	3	7	0	0	7	0	0
5	175935735	rs12341	A	G	106	113	219	0	1	220	0	0
5	175936516	rs11027	T	C	285	290	575	0	3	578	0	0
5	175956177	rs2241584	G	A	34	19	53	0	0	53	0	0
5	175956516	rs2241585	G	A	21	21	42	0	0	42	0	0
5	175959919	.	A	C	8	4	12	0	0	12	0	0
5	175960676	rs1366240	C	T	8	7	15	0	2	17	0	0
5	176309082	rs34127573	C	T	27	22	49	0	1	50	0	0
5	176314459	rs2278492	G	A	18	18	36	0	1	37	0	0
5	176314639	rs6875296	G	A	15	20	35	0	0	35	0	0
5	176333126	rs2292256	C	T	7	15	22	0	0	22	0	0
5	176333748	rs2962844	G	T	4	9	13	0	0	13	0	0
5	176378574	rs365132	G	T	130	131	261	0	1	262	0	0
5	176390550	rs72813113	A	C	6	1	7	0	0	7	0	0
5	176396684	rs72813116	G	A	93	144	237	0	2	239	0	0
5	176396888	rs353465	T	C	4	4	8	0	0	8	0	0
5	176402401	rs1700490	G	A	242	177	419	0	1	420	0	0
5	176474348	rs251842	T	G	3	6	9	0	0	9	0	0
5	176476605	rs251844	T	A	4	3	7	0	0	7	0	0
5	176482985	rs374485	A	G	8	2	10	0	0	10	0	0
5	176483687	rs428985	A	G	6	5	11	0	0	11	0	0
5	176492557	rs251848	G	A	29	22	51	0	3	54	0	0
5	176498882	rs353482	C	T	8	5	13	0	0	13	0	0
5	176499541	rs74389812	T	A	8	10	18	0	0	18	0	0
5	176501583	rs6867614	C	A	3	6	9	0	0	9	0	0
5	176502619	rs244717	A	G	1	5	6	0	0	6	0	0
5	176502869	.	A	G	4	3	7	0	0	7	0	0
5	176503563	rs244715	A	G	20	16	36	0	0	36	0	0
5	176506520	rs72813141	G	A	4	2	6	0	0	6	0	0
5	176525071	rs1076890	G	A	6	6	12	0	1	13	0	0
5	176729417	.	G	A	153	151	304	0	4	308	0	0
5	176732257	rs79989845	G	A	3	11	14	0	1	15	0	0
5	176788570	rs4976646	T	C	2	4	6	0	0	6	0	0
5	176796765	rs59131256	C	T	2	4	6	0	0	6	0	0
5	176799029	.	C	T	90	67	157	0	1	159	1	0
5	176854541	rs77846318	G	C	3	4	7	0	0	7	0	0
5	176855012	rs77998600	C	A	8	14	22	0	0	22	0	0
5	176855627	rs2545798	T	A	5	6	11	0	1	12	0	0
5	176857270	rs2731665	T	C	9	6	15	0	0	15	0	0
5	176857512	.	C	T	10	5	15	0	0	15	0	0
5	176858049	rs867755	C	T	9	7	16	0	0	16	0	0
5	176860293	rs2287694	T	C	9	6	15	0	0	15	0	0
5	176912073	.	C	T	29	27	56	0	0	56	0	0
5	176913822	rs181038806	T	C	17	14	31	0	2	33	0	0
5	176915416	rs96656	G	A	2	4	6	0	0	6	0	0
5	176916516	rs335462	C	T	125	117	242	0	3	245	0	0
5	176918902	.	G	A	89	62	151	0	1	152	0	0
5	176929185	rs337368	G	C	389	314	703	0	5	708	0	0
5	176929974	rs2544814	G	A	152	171	323	0	0	323	0	0
5	176930651	rs337366	G	A	107	81	188	0	1	189	0	0
5	176931706	rs179810	G	C	24	27	51	0	1	52	0	0
5	176936300	rs337400	C	A	18	22	40	0	0	40	0	0
5	176940190	rs114021969	G	A	12	15	27	0	0	27	0	0
5	176940274	rs335437	C	T	8	16	24	0	0	24	0	0
5	176940384	rs335438	G	A	198	245	443	0	3	446	0	0
5	176948717	rs337386	T	C	5	6	11	0	0	11	0	0
5	176949322	rs337385	T	C	14	11	25	0	0	25	0	0
5	176949352	.	G	A	10	13	23	0	0	23	0	0
5	176949611	rs1990909	G	T	6	6	12	0	0	12	0	0
5	176955598	rs335443	T	A	4	2	6	0	0	6	0	0
5	176959296	rs2246566	T	G	7	6	13	0	0	13	0	0
5	176969625	rs335458	G	A	4	5	9	0	0	9	0	0
5	176970803	rs335457	G	A	5	7	12	0	0	12	0	0
5	176975140	rs335424	C	G	2	7	9	0	0	9	0	0
5	177046538	rs116120158	C	T	22	18	40	0	0	40	0	0
5	177482694	rs11953084	T	C	6	0	6	0	1	7	0	0
5	177550476	rs3812079	A	C	3	4	7	0	0	7	0	0
5	177551169	rs3812075	T	C	5	6	11	0	0	11	0	0
5	177551176	rs3812074	T	C	5	5	10	0	0	10	0	0
5	177551604	.	A	T	5	4	9	0	0	9	0	0
5	177551985	rs3812073	C	T	3	3	6	0	0	6	0	0
5	177574421	rs6601221	C	T	6	0	6	0	0	6	0	0
5	177577303	rs62392211	C	T	7	11	18	0	0	18	0	0
5	177635084	rs11743721	A	C	10	13	23	0	0	23	0	0
5	177635181	rs12514956	G	T	14	4	18	0	1	19	0	0
5	177636199	rs1059367	C	T	5	4	9	0	0	9	0	0
5	177637447	rs2913751	G	A	11	16	27	0	0	27	0	0
5	177637882	rs17759	G	A	217	237	454	0	2	456	0	0
5	177639453	rs17639190	T	C	5	1	6	0	0	6	0	0
5	177640394	rs17577590	G	A	2	4	6	0	0	6	0	0
5	177642085	rs72817294	A	G	4	2	6	0	0	6	0	0
5	177642177	rs2913748	C	T	3	3	6	0	0	6	0	0
5	177642518	rs17639362	G	A	8	4	12	0	0	12	0	0
5	177642673	rs76750715	C	T	5	6	11	0	0	11	0	0
5	177643137	rs57358849	T	C	4	2	6	0	0	6	0	0
5	177644329	rs75647366	C	A	3	3	6	0	0	6	0	0
5	177644691	rs113910776	G	C	8	2	10	0	0	10	0	0
5	177644711	rs113488901	T	A	8	2	10	0	1	12	1	0
5	177645574	rs58591737	G	A	7	4	11	0	0	11	0	0
5	177648188	rs10080049	A	G	6	3	9	0	1	10	0	0
5	177650208	rs78718890	T	C	4	4	8	0	0	8	0	0
5	177650986	rs111778865	T	C	6	1	7	0	0	7	0	0
5	177651040	rs6887384	C	T	8	2	10	0	0	10	0	0
5	177651050	rs41285583	A	T	8	2	10	0	0	10	0	0
5	177651837	rs55812151	T	C	5	1	6	0	1	7	0	0
5	177652231	rs2913869	A	G	6	4	10	0	0	10	0	0
5	177652684	.	T	G	5	2	7	0	0	7	0	0
5	177652787	rs10055967	C	G	8	7	15	0	0	15	0	0
5	177653249	rs1134369	C	T	2	5	7	0	0	7	0	0
5	177653262	rs62388738	A	G	6	2	8	0	0	8	0	0
5	177653961	rs2913866	C	T	11	12	23	0	0	23	0	0
5	177654158	rs75616150	T	G	13	14	27	0	0	27	0	0
5	178040327	.	C	T	5	3	8	0	0	8	0	0
5	178294059	rs11952817	T	C	21	19	40	0	0	40	0	0
5	178294060	rs11955074	G	A	21	19	40	0	0	40	0	0
5	178311993	rs6894878	G	A	8	4	12	0	0	12	0	0
5	178312265	rs12657785	G	C	2	4	6	0	0	6	0	0
5	178312935	rs78428003	T	C	4	5	9	0	0	9	0	0
5	178313078	rs2411991	A	C	5	4	9	0	0	9	0	0
5	178313209	rs72816603	G	A	6	9	15	0	0	15	0	0
5	178313217	rs78967197	G	A	9	5	14	0	1	15	0	0
5	178313485	rs75774943	G	A	6	6	12	0	0	12	0	0
5	178313643	rs10074505	G	A	5	10	15	0	0	15	0	0
5	178313825	rs7731067	T	C	4	12	16	0	0	16	0	0
5	178313942	rs7706558	G	A	8	7	15	0	0	15	0	0
5	178314112	.	T	C	7	5	12	0	1	13	0	0
5	178314583	rs80159698	A	G	7	4	11	0	0	11	0	0
5	179027233	rs115390848	G	A	0	6	6	0	0	6	0	0
5	179042400	rs61408162	C	T	66	48	114	0	1	115	0	0
5	179043465	rs78518762	G	A	134	111	245	0	2	247	0	0
5	179126090	rs1134924	C	T	84	70	154	0	0	154	0	0
5	179126632	rs13182141	C	T	16	5	21	0	0	21	0	0
5	179136137	rs72809766	C	T	3	3	6	0	0	6	0	0
5	179137436	rs13174472	C	T	32	17	49	0	2	51	0	0
5	179157025	.	T	C	219	197	416	0	10	426	0	0
5	179160402	rs61751563	G	C	4	8	12	0	0	12	0	0
5	179162122	rs11743232	G	A	61	22	83	0	0	83	0	0
5	179162840	rs6860716	T	C	4	6	10	0	0	10	0	0
5	179164143	rs62406176	T	G	6	9	15	0	0	15	0	0
5	179176627	rs56335144	C	T	3	8	11	0	0	11	0	0
5	179176692	rs12522263	T	A	5	10	15	0	0	15	0	0
5	179177116	rs55827522	C	T	8	9	17	0	0	17	0	0
5	179193598	rs3797776	C	T	22	33	55	0	0	55	0	0
5	179193970	rs3797774	C	T	22	20	42	0	0	42	0	0
5	179201847	rs6895902	G	A	8	5	13	0	0	13	0	0
5	179202688	rs3797762	A	G	6	11	17	0	0	17	0	0
5	179214818	rs12522926	G	A	6	2	8	0	0	8	0	0
5	179220450	rs183808429	C	A	5	2	7	0	0	7	0	0
5	179223238	rs2306795	T	C	4	3	7	0	0	7	0	0
5	179227154	rs72807339	G	A	34	42	76	0	1	77	0	0
5	179227286	rs166624	G	T	98	73	171	0	1	172	0	0
5	179231248	rs12652934	T	G	66	70	136	0	0	136	0	0
5	179234122	rs59066892	A	T	5	4	9	0	0	9	0	0
5	179238228	rs62406227	G	A	2	5	7	0	0	7	0	0
5	179238251	rs62406228	A	G	3	4	7	0	0	7	0	0
5	179240712	rs58926938	G	A	3	5	8	0	0	8	0	0
5	179245093	rs60291142	G	A	4	6	10	0	0	10	0	0
5	179248257	rs4700700	G	A	3	3	6	0	0	6	0	0
5	179249073	rs513165	A	C	66	78	144	0	0	144	0	0
5	179249099	rs513235	T	A	80	68	148	0	1	149	0	0
5	179249179	rs67929139	A	G	74	73	147	0	0	147	0	0
5	179249433	rs475716	T	C	85	87	172	0	1	173	0	0
5	179250392	rs10464093	G	A	53	45	98	0	1	99	0	0
5	179250416	rs1137043	A	G	35	23	58	0	0	58	0	0
5	179250500	rs10464095	C	T	35	41	76	0	0	76	0	0
5	179251475	rs55993594	T	G	11	13	24	0	0	24	0	0
5	179252537	rs3734007	A	G	11	11	22	0	0	22	0	0
5	179253875	rs10071544	C	T	4	7	11	0	0	11	0	0
5	179253926	rs565280	A	G	3	11	14	0	0	14	0	0
5	179254247	rs10056257	G	A	6	14	20	0	0	20	0	0
5	179254340	rs546161	T	C	5	2	7	0	0	7	0	0
5	179254846	rs10051350	A	G	8	12	20	0	0	20	0	0
5	179255970	rs2161101	G	C	8	7	15	0	0	15	0	0
5	179256923	rs1345579	C	A	9	4	13	0	0	13	0	0
5	179257171	rs695191	C	A	10	10	20	0	0	20	0	0
5	179258901	rs693549	G	A	13	10	23	0	0	23	0	0
5	179259448	rs111478607	G	C	14	12	26	0	0	26	0	0
5	179259842	rs2450484	G	C	17	23	40	0	0	40	0	0
5	179260213	rs4797	G	A	940	907	1847	0	14	1861	0	0
5	179260494	rs155787	G	A	269	305	574	0	1	575	0	0
5	179261001	rs248237	G	A	100	97	197	0	1	198	0	0
5	179261027	rs35968447	A	G	91	88	179	0	0	179	0	0
5	179261411	.	G	A	38	27	65	0	4	69	0	0
5	179261592	rs269449	G	A	51	32	83	0	0	83	0	0
5	179262108	rs173561	C	T	80	73	153	0	4	157	0	0
5	179262132	rs10061964	G	A	76	68	144	0	4	148	0	0
5	179262233	rs248241	T	C	87	56	143	0	1	144	0	0
5	179262335	rs166033	A	G	114	43	157	0	1	158	0	0
5	179262733	rs248242	A	G	87	99	186	0	1	188	1	0
5	179264731	rs10277	T	C	17	53	70	0	0	70	0	0
5	179264915	rs1065154	G	T	9	21	30	0	1	31	0	0
5	179265261	rs248245	G	A	5	7	12	0	1	13	0	0
5	179267395	rs6896817	G	A	4	4	8	0	0	8	0	0
5	179267783	rs248247	G	A	9	6	15	0	0	15	0	0
5	179280379	.	T	C	6	5	11	0	0	11	0	0
5	179285752	rs10060182	G	A	4	4	8	0	0	8	0	0
5	179290154	rs9957	G	C	49	72	121	0	0	121	0	0
5	179290845	rs30386	T	G	32	45	77	0	1	78	0	0
5	179333233	rs155795	G	C	3	3	6	0	0	6	0	0
5	179404114	rs62404970	C	T	12	11	23	0	0	23	0	0
5	179405144	rs27018	A	G	3	4	7	0	0	7	0	0
5	179409613	rs863231	C	T	30	15	45	0	0	45	0	0
5	179411289	.	G	A	14	9	23	0	0	23	0	0
5	179413168	rs1103811	G	A	8	6	14	0	0	14	0	0
5	179414050	rs57117216	A	C	7	5	12	0	0	12	0	0
5	179414645	rs438050	T	C	4	5	9	0	0	9	0	0
5	179415985	rs61356660	G	A	7	3	10	0	0	10	0	0
5	179416210	rs1102191	C	T	6	3	9	0	0	9	0	0
5	179417170	rs57008562	C	A	4	2	6	0	0	6	0	0
5	179417335	rs594202	C	T	5	12	17	0	0	17	0	0
5	179417797	.	C	T	7	12	19	0	0	19	0	0
5	179418116	.	T	A	6	11	17	0	0	17	0	0
5	179418134	rs394616	T	G	6	12	18	0	0	18	0	0
5	179419332	rs11748441	G	A	5	2	7	0	0	7	0	0
5	179420013	rs857187	T	C	2	9	11	0	0	11	0	0
5	179420113	rs857188	C	A	6	12	18	0	0	18	0	0
5	179420991	rs62404974	C	T	10	6	16	0	0	16	0	0
5	179427089	rs62404976	A	G	3	4	7	0	0	7	0	0
5	179427873	rs864482	A	G	6	1	7	0	0	7	0	0
5	179428887	rs62404977	G	A	6	1	7	0	0	7	0	0
5	179434232	rs12152713	C	T	4	4	8	0	0	8	0	0
5	179438433	rs62405015	C	T	11	9	20	0	0	20	0	0
5	179438626	rs12519642	T	G	14	7	21	0	0	21	0	0
5	179438920	rs12654148	T	A	7	4	11	0	0	11	0	0
5	179439345	rs3797764	A	G	7	7	14	0	0	14	0	0
5	179439516	rs3797763	C	T	6	10	16	0	0	16	0	0
5	179473900	rs34674199	G	A	18	6	24	0	0	24	0	0
5	179661692	rs13435	C	T	2	7	9	0	0	9	0	0
5	179662384	rs1127575	A	G	9	9	18	0	0	18	0	0
5	179670528	rs7445806	C	T	8	12	20	0	0	20	0	0
5	179672108	rs7726664	G	A	5	2	7	0	1	8	0	0
5	179672583	rs11739985	C	T	5	9	14	0	1	15	0	0
5	179672825	rs4362908	T	C	7	1	8	0	0	8	0	0
5	179673708	rs4481314	T	C	7	7	14	0	1	15	0	0
5	179704627	rs12519649	T	C	7	8	15	0	0	15	0	0
5	179721590	rs3749792	A	G	6	2	8	0	0	8	0	0
5	179722015	rs918483	G	A	3	4	7	0	0	7	0	0
5	179722109	rs918482	C	G	5	6	11	0	1	12	0	0
5	179991841	rs6874985	A	G	6	5	11	0	0	11	0	0
5	179991959	rs6894846	C	T	7	3	10	0	0	10	0	0
5	179992566	rs11249729	C	T	10	9	19	0	0	19	0	0
5	179992582	rs12054820	C	T	8	8	16	0	1	17	0	0
5	179996875	rs11249731	G	A	3	6	9	0	0	9	0	0
5	180004154	rs11738060	T	A	33	29	62	0	2	64	0	0
5	180039606	rs1130379	C	T	6	3	9	0	0	9	0	0
5	180043388	rs1130378	G	A	4	2	6	0	0	6	0	0
5	180218668	rs634501	A	G	172	179	351	0	3	354	0	0
5	180235582	rs80073440	G	A	10	0	10	0	0	10	0	0
5	180237305	rs114287048	C	T	4	2	6	0	0	6	0	0
5	180287567	rs2127379	G	A	7	8	15	0	0	15	0	0
5	180650685	rs147321649	A	G	3	5	8	0	1	9	0	0
5	180670904	rs61735487	G	A	13	12	25	0	0	25	0	0
5	180685900	rs13177248	T	G	3	4	7	0	1	8	0	0
6	291744	.	G	C	10	0	10	0	0	10	0	0
6	349016	.	C	T	6	0	6	0	0	6	0	0
6	349317	rs6927235	T	C	10	1	11	0	0	11	0	0
6	350496	.	G	A	13	15	28	0	2	30	0	0
6	351156	.	C	T	101	0	101	0	2	103	0	0
6	410417	rs1050979	A	G	7	4	11	0	0	11	0	0
6	411064	rs872071	A	G	7	6	13	0	0	13	0	0
6	485586	rs11242914	C	T	3	4	7	0	0	7	0	0
6	486193	rs12952	G	A	6	2	8	0	0	8	0	0
6	679344	rs9405909	C	G	7	10	17	0	1	18	0	0
6	1613686	rs2745599	A	G	4	3	7	0	0	7	0	0
6	1742794	rs3734739	A	G	36	33	69	0	1	70	0	0
6	2766613	.	C	T	73	70	143	0	0	143	0	0
6	2766727	rs3757094	A	G	14	4	18	0	1	19	0	0
6	2766779	rs3757093	G	A	22	9	31	0	0	31	0	0
6	2783071	rs315007	G	A	40	38	78	0	0	78	0	0
6	2783304	rs4083550	A	G	51	26	77	0	1	78	0	0
6	2784353	rs160704	C	G	42	51	93	0	0	93	0	0
6	2784797	rs3734499	T	C	16	15	31	0	1	32	0	0
6	2785636	rs1059630	G	T	196	230	426	0	2	428	0	0
6	2832778	rs147662517	T	C	97	128	225	0	0	226	1	0
6	2833739	rs15286	A	G	297	391	688	0	5	693	0	0
6	2834265	rs386915	C	T	17	18	35	0	0	35	0	0
6	2834416	rs1262184	G	A	23	15	38	0	0	38	0	0
6	2835831	rs2293772	A	G	14	9	23	0	0	23	0	0
6	2836266	rs385955	T	A	45	6	51	0	0	51	0	0
6	2837612	rs316337	G	A	25	15	40	0	0	40	0	0
6	2837846	rs316338	A	G	18	18	36	0	0	36	0	0
6	2838046	rs316339	A	G	24	17	41	0	0	41	0	0
6	2838102	rs316340	G	A	20	12	32	0	0	32	0	0
6	2838248	rs316341	G	A	12	17	29	0	0	29	0	0
6	2839789	rs316342	T	C	45	22	67	0	1	68	0	0
6	2840059	rs316343	C	T	33	36	69	0	0	69	0	0
6	2840316	rs316344	A	C	55	28	83	0	0	83	0	0
6	2841040	rs316345	T	C	99	35	134	0	7	141	0	0
6	2841556	rs316346	C	T	378	118	496	0	5	501	0	0
6	2842139	rs386713	C	T	40	26	66	0	2	68	0	0
6	2890190	rs1052886	A	G	10	3	13	0	0	13	0	0
6	2890283	rs318486	A	G	13	8	21	0	1	22	0	0
6	2949387	rs9378746	G	A	8	8	16	0	0	16	0	0
6	2962459	rs146240139	C	A	3	4	7	0	0	7	0	0
6	2970127	.	T	G	11	11	22	0	0	22	0	0
6	3003970	rs4149358	A	G	5	12	17	0	0	17	0	0
6	3018928	.	G	A	5	1	6	0	0	6	0	0
6	3025300	rs141722700	G	A	6	1	7	0	1	8	0	0
6	3073792	rs6920024	G	A	12	7	19	0	1	20	0	0
6	3073912	rs6920337	G	A	2	12	14	0	1	15	0	0
6	3074021	rs9501918	G	A	10	6	16	0	0	16	0	0
6	3074940	rs9405607	C	T	3	5	8	0	0	8	0	0
6	3075553	rs2326173	A	G	10	11	21	0	0	21	0	0
6	3075698	rs3757082	T	C	3	3	6	0	0	6	0	0
6	3075959	rs140210585	G	A	11	5	16	0	0	16	0	0
6	3081579	rs11242823	G	A	27	28	55	0	4	59	0	0
6	3723764	rs1045778	G	T	21	12	33	0	0	33	0	0
6	3727811	rs226959	C	G	19	15	34	0	0	34	0	0
6	3739193	rs4959871	T	C	4	4	8	0	0	8	0	0
6	4118813	rs76844247	T	C	13	8	21	0	0	21	0	0
6	4892081	rs61749071	C	T	20	27	47	0	0	47	0	0
6	4915135	.	C	T	10	2	12	0	0	12	0	0
6	4932152	rs7755871	G	A	5	1	6	0	0	6	0	0
6	4933034	rs7743681	A	G	3	3	6	0	0	6	0	0
6	4945568	rs11756225	G	A	2	5	7	0	0	7	0	0
6	4953879	rs7776245	C	A	5	8	13	0	0	13	0	0
6	4954412	rs11754078	C	T	71	66	137	0	0	137	0	0
6	4954710	rs1045074	A	G	13	20	33	0	0	33	0	0
6	5108734	rs8980	G	C	31	28	59	0	1	60	0	0
6	5108965	rs467373	A	G	38	34	72	0	1	73	0	0
6	5109592	rs9606	T	G	100	92	192	0	0	192	0	0
6	5186900	rs1055415	G	T	21	4	25	0	0	25	0	0
6	5263255	rs187241978	C	G	6	1	7	0	0	7	0	0
6	6144807	rs3024487	G	C	19	30	49	0	0	49	0	0
6	6152137	rs5988	C	G	8	9	17	0	0	17	0	0
6	6152140	rs5987	C	T	7	8	15	0	1	16	0	0
6	6251120	rs3024477	T	A	4	6	10	0	0	10	0	0
6	7181735	rs9406002	A	G	32	30	62	0	0	62	0	0
6	7181993	rs9392862	T	C	54	46	100	0	1	101	0	0
6	7211818	rs1334576	G	A	88	68	156	0	2	158	0	0
6	7238069	rs2714335	T	C	5	6	11	0	0	11	0	0
6	7247248	rs2256596	T	C	26	32	58	0	0	58	0	0
6	7248212	rs3799504	G	A	4	2	6	0	0	6	0	0
6	7250625	.	C	T	40	46	86	0	0	86	0	0
6	7268623	rs2038829	C	T	65	54	119	0	1	120	0	0
6	7280780	rs2764086	A	G	7	3	10	0	0	10	0	0
6	7282451	rs2714356	C	A	17	14	31	0	1	32	0	0
6	7282523	rs2764087	A	G	23	16	39	0	0	39	0	0
6	7282979	rs2068946	C	G	14	12	26	0	0	26	0	0
6	7286019	rs2714358	T	C	5	6	11	0	0	11	0	0
6	7881311	rs1044104	A	G	3	3	6	0	0	6	0	0
6	7889088	rs1225944	A	G	9	4	13	0	0	13	0	0
6	7889310	rs1225945	C	T	6	5	11	0	0	11	0	0
6	7889465	rs1225946	A	G	6	5	11	0	0	11	0	0
6	7890121	rs1225947	T	G	3	3	6	0	1	7	0	0
6	7891160	rs13873	G	T	11	9	20	0	0	20	0	0
6	8014704	rs2748375	A	C	7	14	21	0	0	21	0	0
6	8080783	rs80351316	A	G	4	12	16	0	0	16	0	0
6	8081021	rs2815164	G	A	5	7	12	0	0	12	0	0
6	8081495	rs9392959	A	G	4	5	9	0	0	9	0	0
6	8090270	rs1136044	T	G	5	2	7	0	0	7	0	0
6	10529119	rs79945859	A	C	3	4	7	0	0	7	0	0
6	10731218	rs7113	C	T	215	177	392	0	1	393	0	0
6	11136257	rs12205389	G	T	9	13	22	0	0	22	0	0
6	11184801	rs12211539	C	T	14	23	37	0	0	37	0	0
6	11185161	rs1908	C	T	51	27	78	0	0	78	0	0
6	11185184	rs1911	A	G	31	54	85	0	0	85	0	0
6	11193860	rs16871074	G	A	11	17	28	0	1	29	0	0
6	11200856	rs2034	A	C	6	3	9	0	0	9	0	0
6	11201135	rs3798733	C	G	6	1	7	0	0	7	0	0
6	11201527	rs3798736	A	G	2	6	8	0	0	8	0	0
6	11224713	rs7769369	T	C	2	4	6	0	0	6	0	0
6	11224748	rs7769173	A	C	4	2	6	0	0	6	0	0
6	11229590	.	G	A	4	4	8	0	0	8	0	0
6	11352094	rs6905278	C	G	10	4	14	0	0	14	0	0
6	11548502	rs13213717	A	G	4	2	6	0	0	6	0	0
6	11559036	rs601543	A	G	7	1	8	0	1	9	0	0
6	12008915	rs41273100	C	G	2	4	6	0	0	6	0	0
6	12017065	rs1409286	G	C	5	13	18	0	0	18	0	0
6	12038976	rs1570987	C	A	23	18	41	0	0	41	0	0
6	12039056	rs55797398	A	G	12	21	33	0	0	33	0	0
6	12123249	rs2228220	A	G	19	14	33	0	3	36	0	0
6	12124587	rs2228212	C	G	15	9	24	0	0	24	0	0
6	12125772	rs1126472	A	G	28	30	58	0	0	58	0	0
6	12138261	rs3822926	C	T	2	6	8	0	0	8	0	0
6	12138597	rs219940	C	A	4	3	7	0	0	7	0	0
6	12140718	rs9369106	G	A	2	4	6	0	0	6	0	0
6	12141145	rs9380837	C	T	3	4	7	0	0	7	0	0
6	12143778	rs219945	G	T	3	5	8	0	0	8	0	0
6	12144060	rs13217115	A	G	4	4	8	0	0	8	0	0
6	12144171	rs219946	C	T	9	0	9	0	0	9	0	0
6	12144367	rs36147437	G	T	1	5	6	0	0	6	0	0
6	12149138	rs220018	G	A	4	2	6	0	0	6	0	0
6	12158870	rs7751398	T	C	4	3	7	0	0	7	0	0
6	12160547	rs3777754	T	C	8	4	12	0	0	12	0	0
6	12514644	rs9296405	T	G	53	0	53	0	1	54	0	0
6	13206282	rs73725623	C	T	4	3	7	0	0	7	0	0
6	13264113	rs202065	A	G	9	13	22	0	1	23	0	0
6	13267242	.	G	A	2	6	8	0	0	8	0	0
6	13267622	rs68050381	T	G	4	5	9	0	0	9	0	0
6	13267938	rs202070	T	C	4	11	15	0	0	15	0	0
6	13273318	rs202054	A	G	7	4	11	0	0	11	0	0
6	13273554	rs6458744	C	T	8	3	11	0	0	11	0	0
6	13273643	rs202053	T	C	5	4	9	0	0	9	0	0
6	13273836	rs202052	A	G	7	2	9	0	1	10	0	0
6	13274324	rs202049	G	A	3	4	7	0	0	7	0	0
6	13275570	rs202046	T	C	7	5	12	0	0	12	0	0
6	13275914	rs202045	G	C	8	3	11	0	0	11	0	0
6	13275950	rs202044	C	T	7	5	12	0	0	12	0	0
6	13277017	rs202043	A	G	4	5	9	0	0	9	0	0
6	13277714	rs202042	G	C	2	6	8	0	0	8	0	0
6	13277915	rs495895	T	C	11	7	18	0	0	18	0	0
6	13277919	rs116078317	C	T	11	7	18	0	0	18	0	0
6	13278219	rs77222298	C	T	6	6	12	0	1	13	0	0
6	13279464	rs417048	G	A	3	4	7	0	0	7	0	0
6	13279867	rs405078	T	A	5	3	8	0	0	8	0	0
6	13279906	rs441213	G	T	4	2	6	0	0	6	0	0
6	13280437	rs384730	T	A	6	7	13	0	0	13	0	0
6	13280454	rs442614	G	A	5	6	11	0	0	11	0	0
6	13280489	rs412787	T	C	6	4	10	0	0	10	0	0
6	13280641	rs413120	T	C	5	3	8	0	0	8	0	0
6	13282775	rs75447267	T	C	3	3	6	0	0	6	0	0
6	13283930	rs434923	C	T	5	2	7	0	0	7	0	0
6	13283964	rs369946	G	A	4	6	10	0	0	10	0	0
6	13283977	rs417024	A	C	4	5	9	0	0	9	0	0
6	13284155	rs9367406	A	G	6	7	13	0	1	14	0	0
6	13284922	rs79243579	G	A	6	4	10	0	0	10	0	0
6	13284976	rs74941053	C	T	4	7	11	0	0	11	0	0
6	13287400	rs693758	G	A	60	40	100	0	1	101	0	0
6	13288669	rs202037	C	T	76	57	133	0	3	136	0	0
6	13289240	rs17667989	G	A	88	93	181	0	1	182	0	0
6	13454367	rs2841562	C	T	3	3	6	0	0	6	0	0
6	13463159	rs9382117	G	A	4	2	6	0	0	6	0	0
6	13464030	rs9382119	T	C	6	6	12	0	0	12	0	0
6	13464627	rs6901974	G	A	13	9	22	0	0	22	0	0
6	13464827	rs13196546	C	T	13	13	26	0	0	26	0	0
6	13466830	rs2841555	T	C	4	7	11	0	0	11	0	0
6	13579828	rs2804911	A	C	2	4	6	0	0	6	0	0
6	13613783	rs2841523	A	G	7	2	9	0	0	9	0	0
6	13616710	.	C	T	209	195	404	0	4	408	0	0
6	13619424	rs3823453	G	C	4	4	8	0	0	8	0	0
6	13619629	rs3800503	A	G	5	7	12	0	0	12	0	0
6	13626154	.	T	C	27	23	50	0	1	51	0	0
6	13628059	rs7760411	C	T	4	3	7	0	1	8	0	0
6	13628357	rs7742342	A	G	5	2	7	0	1	8	0	0
6	13630864	rs10807467	T	G	6	7	13	0	0	13	0	0
6	13630961	rs6899402	C	T	4	7	11	0	0	11	0	0
6	13633522	rs7745101	T	A	3	11	14	0	0	14	0	0
6	13634038	rs10948804	A	T	7	3	10	0	0	10	0	0
6	13638243	rs2071836	T	C	7	6	13	0	0	13	0	0
6	13638984	rs4715451	A	G	7	6	13	0	0	13	0	0
6	13639700	rs6915775	G	A	1	5	6	0	0	6	0	0
6	13644160	rs6911121	T	C	5	3	8	0	0	8	0	0
6	13649724	rs11755634	T	C	5	1	6	0	0	6	0	0
6	13649762	rs11753232	C	G	5	3	8	0	0	8	0	0
6	13649858	.	T	C	6	3	9	0	1	10	0	0
6	13652006	rs4715455	C	T	1	5	6	0	0	6	0	0
6	13711279	rs6905991	A	G	60	73	133	0	0	133	0	0
6	14121828	rs7757201	C	T	5	3	8	0	0	8	0	0
6	14130325	rs35360116	G	A	10	10	20	0	0	20	0	0
6	14131244	rs853358	A	T	14	24	38	0	0	38	0	0
6	14131804	rs7743206	G	A	113	157	270	0	3	273	0	0
6	14131854	rs35118414	A	G	182	125	307	0	9	316	0	0
6	14132241	rs9296923	G	A	23	20	43	0	0	43	0	0
6	14132551	rs9296924	A	G	26	29	55	0	0	55	0	0
6	14132611	rs9476511	A	G	32	31	63	0	1	64	0	0
6	14132887	rs9396472	G	T	29	22	51	0	1	52	0	0
6	14133647	rs7774927	T	C	32	38	70	0	0	70	0	0
6	14136428	rs1050650	A	C	324	327	651	0	3	654	0	0
6	14137014	rs9230	T	C	32	36	68	0	1	69	0	0
6	15508315	rs2076057	C	T	70	69	139	0	2	141	0	0
6	15511785	rs2235259	C	G	30	29	59	0	0	59	0	0
6	15513744	rs9396589	G	T	11	3	14	0	0	14	0	0
6	15514499	rs9396590	A	G	11	11	22	0	1	23	0	0
6	15516285	rs9396591	G	A	19	9	28	0	1	29	0	0
6	15517659	rs2072822	C	A	8	9	17	0	0	17	0	0
6	15518036	rs2072821	G	C	11	6	17	0	0	17	0	0
6	15518814	rs1967663	G	A	8	8	16	0	0	16	0	0
6	15519885	rs13198512	C	T	11	16	27	0	1	28	0	0
6	15523101	rs1047631	T	C	25	35	60	0	0	60	0	0
6	15524679	rs16876571	G	A	14	2	16	0	1	17	0	0
6	15527197	rs9476835	A	C	3	3	6	0	0	6	0	0
6	15528367	rs9296978	C	T	3	4	7	0	0	7	0	0
6	15530164	rs9464795	G	A	12	4	16	0	0	16	0	0
6	15530784	rs9296979	A	C	15	12	27	0	0	27	0	0
6	15530877	rs62396142	G	A	19	16	35	0	0	35	0	0
6	15533064	rs9367878	G	A	4	4	8	0	0	8	0	0
6	15533733	rs11753919	C	T	5	1	6	0	0	6	0	0
6	15533840	rs116647843	G	A	3	5	8	0	0	8	0	0
6	15533951	rs4236167	C	T	5	1	6	0	0	6	0	0
6	16129498	rs3765234	G	T	39	29	68	0	0	68	0	0
6	16138363	rs2142675	C	G	4	2	6	0	0	6	0	0
6	16140827	rs4716048	C	G	9	1	10	0	0	10	0	0
6	16145325	rs9370867	A	G	68	52	120	0	1	121	0	0
6	16146740	rs1060913	G	A	32	16	48	0	1	49	0	0
6	16147977	rs185701087	G	C	205	212	417	0	9	426	0	0
6	16148058	rs2205795	G	T	226	212	438	0	7	445	0	0
6	16148176	rs2205794	G	A	308	276	584	0	5	589	0	0
6	16522874	rs75873938	G	A	36	29	65	0	0	65	0	0
6	16694501	rs2146753	A	G	4	2	6	0	2	8	0	0
6	16719358	rs17670444	G	A	3	5	8	0	0	8	0	0
6	16731200	rs6459484	A	G	14	2	16	0	0	16	0	0
6	16731618	rs143370405	G	A	4	28	32	0	0	32	0	0
6	16735572	rs581812	C	T	4	2	6	0	0	6	0	0
6	16741886	rs3812227	A	C	4	4	8	0	0	8	0	0
6	16742033	rs697739	C	T	4	8	12	0	0	12	0	0
6	16742118	rs3806144	T	C	4	3	7	0	0	7	0	0
6	16742765	rs1144695	C	T	4	3	7	0	0	7	0	0
6	16753352	rs10456791	A	C	2	6	8	0	0	8	0	0
6	16762814	.	T	A	4	2	6	0	7	13	0	0
6	17600619	rs6919110	A	G	4	10	14	0	0	14	0	0
6	17601213	rs61736671	C	T	4	8	12	0	0	12	0	0
6	17603200	rs4142551	C	A	1	7	8	0	0	8	0	0
6	17607840	rs17330323	A	C	6	11	17	0	0	17	0	0
6	17610090	rs1055111	T	G	24	25	49	0	0	49	0	0
6	17611089	rs3777710	G	A	165	138	303	0	3	306	0	0
6	17616556	rs3777712	C	T	4	3	7	0	0	7	0	0
6	17624033	rs4716166	G	A	18	8	26	0	0	26	0	0
6	17624060	rs1830818	C	A	17	10	27	0	0	27	0	0
6	17633061	rs2274136	C	T	59	58	117	0	3	120	0	0
6	17650320	rs3777713	C	G	2	4	6	0	0	6	0	0
6	17657033	rs9383307	C	G	2	6	8	0	0	8	0	0
6	17658333	rs7773218	G	T	6	2	8	0	0	8	0	0
6	17665479	rs6906499	G	C	48	50	98	0	3	101	0	0
6	17675246	rs2228375	T	C	38	41	79	0	0	79	0	0
6	17675553	rs61748704	T	C	59	62	121	0	1	122	0	0
6	17759737	rs1084	C	G	46	45	91	0	0	91	0	0
6	17760132	rs9371016	G	A	19	18	37	0	0	37	0	0
6	17760540	rs78307568	A	G	21	24	45	0	1	46	0	0
6	17762801	rs77465094	C	G	1	6	7	0	0	7	0	0
6	17764211	rs80258593	A	G	45	35	80	0	1	81	0	0
6	17764530	rs9371018	C	T	51	40	91	0	0	91	0	0
6	17794494	rs3734234	G	A	23	31	54	0	0	54	0	0
6	17815179	.	C	G	5	7	12	0	0	12	0	0
6	17815452	rs116265524	G	T	34	28	62	0	0	62	0	0
6	17815517	rs149262793	A	T	32	29	61	0	0	61	0	0
6	17815716	rs6920106	C	T	27	26	53	0	0	53	0	0
6	17815777	rs115424887	A	C	23	22	45	0	0	45	0	0
6	17834213	rs4716190	T	C	33	46	79	0	1	80	0	0
6	17837586	rs76101669	A	G	6	2	8	0	0	8	0	0
6	17950944	rs114490978	C	T	25	4	29	0	2	31	0	0
6	17959298	rs184886943	A	C	2	4	6	0	1	7	0	0
6	18223409	rs214505	C	T	35	44	79	0	0	79	0	0
6	18223566	rs214504	C	T	5	14	19	0	2	21	0	0
6	18225173	rs3476	C	T	354	320	674	0	2	676	0	0
6	18226340	rs214503	G	A	8	6	14	0	1	15	0	0
6	18237661	rs1013062	C	T	256	253	509	0	2	511	0	0
6	18246501	rs7750525	T	C	2	6	8	0	0	8	0	0
6	18257078	rs214520	A	G	15	10	25	0	0	25	0	0
6	18257132	rs9350064	C	T	12	14	26	0	0	26	0	0
6	18257985	rs214519	G	T	9	10	19	0	0	19	0	0
6	18264210	rs11544757	G	A	78	89	167	0	2	169	0	0
6	18264658	rs9383352	G	A	30	20	50	0	7	57	0	0
6	18387752	rs41267736	G	A	104	71	175	0	3	178	0	0
6	18468114	rs10949517	C	T	9	10	19	0	0	19	0	0
6	20124860	rs949550	G	A	13	7	20	0	1	21	0	0
6	20431741	rs12192975	G	A	6	10	16	0	0	16	0	0
6	20490464	.	G	T	47	63	110	0	0	110	0	0
6	21164077	rs6935079	A	G	4	15	19	0	0	19	0	0
6	21164131	rs6935117	A	G	3	8	11	0	0	11	0	0
6	21164145	rs6935124	A	G	2	4	6	0	0	6	0	0
6	21201493	rs9465994	G	A	8	13	21	0	0	21	0	0
6	21232239	.	T	G	14	6	20	0	3	23	0	0
6	24415380	rs3761788	G	A	4	4	8	0	0	8	0	0
6	24418348	rs2793422	G	A	5	9	14	0	0	14	0	0
6	24422543	rs7738943	G	C	4	2	6	0	0	6	0	0
6	24532392	rs58747567	T	C	6	8	14	0	0	14	0	0
6	24650626	rs16889567	C	T	55	40	95	0	0	95	0	0
6	24653283	rs11559067	T	C	65	54	119	0	0	119	0	0
6	24653376	rs1129644	G	A	48	58	106	0	0	106	0	0
6	24658948	.	T	C	39	53	92	0	2	94	0	0
6	24664930	rs17249561	C	G	13	10	23	0	0	23	0	0
6	24667074	rs61760186	C	A	11	4	15	0	0	15	0	0
6	24669472	rs2223589	C	G	7	3	10	0	0	10	0	0
6	24669786	rs2206524	T	A	8	8	16	0	0	16	0	0
6	24669945	rs2223588	T	C	10	8	18	0	0	18	0	0
6	24698215	rs7765904	G	A	20	14	34	0	1	35	0	0
6	24704017	rs62400787	C	T	6	0	6	0	0	6	0	0
6	24705835	rs3756814	T	C	262	251	513	0	0	513	0	0
6	24706770	rs6931809	T	C	5	6	11	0	1	12	0	0
6	24706852	rs6909099	A	C	9	14	23	0	0	23	0	0
6	24708786	rs7757919	G	T	7	1	8	0	0	8	0	0
6	24709830	rs9356943	T	C	25	21	46	0	0	46	0	0
6	24711019	rs9366580	G	A	30	33	63	0	0	63	0	0
6	24712044	rs9379685	A	G	10	14	24	0	0	24	0	0
6	24714433	rs11753290	G	A	19	12	31	0	0	31	0	0
6	24780944	rs2307300	A	C	108	107	215	0	0	215	0	0
6	24782217	rs62400832	G	A	6	4	10	0	0	10	0	0
6	24805574	rs4712850	G	T	6	3	9	0	1	10	0	0
6	24805627	rs12195807	T	G	10	5	15	0	1	16	0	0
6	24806048	rs3730	T	C	7	4	11	0	0	11	0	0
6	24806070	rs1132352	A	C	8	4	12	0	0	12	0	0
6	24806338	rs9393586	T	C	7	3	10	0	0	10	0	0
6	24806594	rs9358799	C	T	9	4	13	0	0	13	0	0
6	24818785	rs9358802	A	G	9	13	22	0	0	22	0	0
6	24841320	rs9366585	A	G	7	7	14	0	0	14	0	0
6	24841722	rs35114991	G	A	4	2	6	0	0	6	0	0
6	24973197	rs9358810	T	A	2	5	7	0	0	7	0	0
6	25016224	rs9461090	T	C	5	2	7	0	0	7	0	0
6	25017127	rs7767457	A	G	4	2	6	0	0	6	0	0
6	25023829	rs9379706	T	C	4	3	7	0	0	7	0	0
6	25023966	rs9358823	A	T	4	6	10	0	1	11	0	0
6	25024004	rs9356953	G	C	5	6	11	0	0	11	0	0
6	25024934	rs9358824	C	G	4	3	7	0	0	7	0	0
6	25992978	.	G	C	4	7	11	0	0	11	0	0
6	26124634	rs4645	C	T	94	75	169	0	2	171	0	0
6	26159649	.	C	G	6	1	7	0	0	7	0	0
6	26171250	rs1059490	T	C	5	2	7	0	1	8	0	0
6	26200083	rs1059486	A	G	1	7	8	0	0	8	0	0
6	26200677	rs806794	A	G	6	4	10	0	0	10	0	0
6	26285560	rs2393592	A	G	5	7	12	0	0	12	0	0
6	26285683	rs2393593	T	C	5	7	12	0	0	12	0	0
6	26370605	rs9379860	T	C	3	3	6	0	0	6	0	0
6	26377991	rs34637389	C	G	3	3	6	0	0	6	0	0
6	26404958	rs10456045	G	A	1	10	11	0	0	11	0	0
6	26414425	rs3208733	C	T	6	9	15	0	0	15	0	0
6	26414678	rs10946822	G	C	14	14	28	0	0	28	0	0
6	26522675	rs4343916	A	T	17	0	17	0	0	17	0	0
6	26524061	rs6910930	G	A	6	0	6	0	0	6	0	0
6	26524339	rs6910899	A	G	7	1	8	0	1	9	0	0
6	26545632	rs4871	G	A	26	22	48	0	1	49	0	0
6	26597333	rs3800302	A	G	98	103	201	0	2	204	1	0
6	26597893	rs7767847	A	T	21	20	41	0	1	42	0	0
6	26597924	rs4591839	C	T	24	24	48	0	0	48	0	0
6	26598188	rs3800303	A	G	141	131	272	0	2	274	0	0
6	26598798	rs3800304	G	A	151	118	269	0	3	272	0	0
6	26600156	rs12204145	G	A	15	22	37	0	0	37	0	0
6	27093715	rs12214930	C	T	4	2	6	0	1	7	0	0
6	27093821	rs6456768	G	C	6	3	9	0	0	9	0	0
6	27115069	rs7756481	G	C	5	5	10	0	0	10	0	0
6	27326863	rs2235232	G	A	5	2	7	0	0	7	0	0
6	27418847	rs7509	T	G	25	33	58	0	1	59	0	0
6	27813813	rs200994	G	T	6	0	6	0	0	6	0	0
6	27833315	rs41269275	C	G	3	4	7	0	0	7	0	0
6	28046673	rs203876	T	C	4	2	6	0	0	6	0	0
6	28048535	rs9380049	A	G	10	9	19	0	0	19	0	0
6	28048538	rs9380050	A	G	10	11	21	0	0	21	0	0
6	28048624	rs203877	T	C	10	13	23	0	0	23	0	0
6	28090931	rs6934769	A	G	25	31	56	0	1	57	0	0
6	28113730	rs9468296	A	G	5	2	7	0	0	7	0	0
6	28113746	rs1225716	A	C	6	3	9	0	0	9	0	0
6	28117443	rs2622322	C	G	3	3	6	0	0	6	0	0
6	28118874	rs9468297	G	T	4	3	7	0	0	7	0	0
6	28120663	rs9295758	C	G	2	4	6	0	0	6	0	0
6	28120898	rs17774663	G	A	21	16	37	0	0	37	0	0
6	28121278	rs62620226	A	G	18	18	36	0	1	37	0	0
6	28122345	rs9468298	A	G	8	1	9	0	0	9	0	0
6	28123928	rs1150666	T	C	18	13	31	0	0	31	0	0
6	28124469	rs9295759	C	T	22	15	37	0	1	38	0	0
6	28126202	rs9348796	A	G	81	80	161	0	1	162	0	0
6	28126834	rs11552219	C	T	165	126	291	0	2	293	0	0
6	28132603	rs9380060	G	A	3	3	6	0	0	6	0	0
6	28136212	rs4713150	G	A	1	5	6	0	0	6	0	0
6	28136797	rs9393901	A	G	3	3	6	0	0	6	0	0
6	28193786	rs1150705	T	G	4	5	9	0	0	9	0	0
6	28194629	rs9461443	A	T	3	3	6	0	0	6	0	0
6	28194799	rs41269285	T	C	20	14	34	0	0	34	0	0
6	28201138	rs7206	A	G	9	7	16	0	0	16	0	0
6	28212748	rs13408	G	A	11	5	16	0	0	16	0	0
6	28219826	rs1736895	G	A	4	3	7	0	0	7	0	0
6	28225053	rs140272569	C	T	3	6	9	0	0	9	0	0
6	28239681	rs2394049	A	G	8	7	15	0	0	15	0	0
6	28241398	rs72850302	A	G	3	3	6	0	0	6	0	0
6	28294550	rs853684	T	C	6	3	9	0	0	9	0	0
6	28348109	rs41270579	C	G	18	20	38	0	0	38	0	0
6	28348158	rs1052215	T	G	12	17	29	0	0	29	0	0
6	28349264	rs2531825	C	T	6	1	7	0	0	7	0	0
6	28350969	rs72854546	A	G	20	20	40	0	1	41	0	0
6	28359170	rs2859348	A	G	6	5	11	0	0	11	0	0
6	28359186	rs2232430	C	T	7	5	12	0	0	12	0	0
6	29691772	rs2076179	T	C	4	2	6	0	0	6	0	0
6	29691774	rs2076178	A	C	4	2	6	0	0	6	0	0
6	29693011	rs1736924	C	T	9	16	25	0	0	25	0	0
6	29855120	rs3115608	G	T	11	3	14	0	0	14	0	0
6	29855320	rs3128882	T	G	12	1	13	0	0	13	0	0
6	29855331	rs3132696	A	G	12	1	13	0	0	13	0	0
6	29855386	rs3128881	C	T	11	3	14	0	0	14	0	0
6	29855392	rs3128880	T	G	8	3	11	0	1	12	0	0
6	29855401	rs2734949	C	G	7	4	11	0	1	12	0	0
6	29855409	rs3132695	A	G	8	4	12	0	0	12	0	0
6	29855677	rs3132693	G	A	5	3	8	0	0	8	0	0
6	29855682	rs3128879	T	G	4	3	7	0	0	7	0	0
6	29855706	rs3128878	C	G	2	4	6	0	0	6	0	0
6	29855849	rs2734948	A	C	6	2	8	0	0	8	0	0
6	29855856	rs2734947	T	C	6	2	8	0	0	8	0	0
6	29855858	rs9259225	C	A	8	2	10	0	0	10	0	0
6	29855901	rs1059453	A	G	9	8	17	0	0	17	0	0
6	29856022	rs1611611	G	A	21	7	28	0	1	29	0	0
6	29856092	rs3128877	A	T	5	5	10	0	0	10	0	0
6	29856330	rs2428512	G	A	27	13	40	0	0	40	0	0
6	29856347	rs3128875	C	T	60	16	76	0	2	78	0	0
6	29856427	.	G	A	14	12	26	0	0	26	0	0
6	29856550	rs1611617	C	G	14	18	32	0	0	32	0	0
6	29856633	rs7769342	T	C	12	19	31	0	0	31	0	0
6	29856686	rs7769640	C	G	11	24	35	0	0	35	0	0
6	29856693	rs2517819	C	T	11	24	35	0	0	35	0	0
6	29856718	rs7769501	G	C	13	20	33	0	0	33	0	0
6	29856843	rs2523800	G	C	24	23	47	0	1	48	0	0
6	29856917	.	T	C	73	25	98	0	0	98	0	0
6	29857013	rs7774113	A	G	13	28	41	0	1	42	0	0
6	29857050	rs7755851	A	T	42	15	57	0	0	57	0	0
6	29857099	rs2517818	C	T	19	10	29	0	0	29	0	0
6	29857237	rs59581768	G	C	68	7	75	0	1	76	0	0
6	29857249	rs2844818	G	A	71	11	82	0	1	83	0	0
6	29857359	rs28668506	C	A	69	31	100	0	0	101	1	0
6	29857410	rs3115606	T	C	4	6	10	0	0	10	0	0
6	29857502	rs3115605	A	C	13	29	42	0	0	42	0	0
6	29857504	rs28628412	G	A	15	29	44	0	0	44	0	0
6	29857730	rs3115604	G	C	7	6	13	0	0	13	0	0
6	29857852	rs9259265	A	G	9	26	35	0	0	36	1	0
6	29857890	rs9259266	T	C	9	4	13	0	0	13	0	0
6	29857901	rs9259267	T	C	9	3	12	0	0	12	0	0
6	29857919	rs9259268	A	G	9	4	13	0	0	13	0	0
6	29857965	rs9259269	G	A	5	8	13	0	1	14	0	0
6	29858213	rs3115603	G	C	14	0	14	0	0	14	0	0
6	29858218	rs3115602	A	G	19	22	41	0	0	41	0	0
6	29858256	rs3128874	T	G	18	27	45	0	0	45	0	0
6	29894205	rs2517772	T	C	9	9	18	0	0	18	0	0
6	29894226	rs2074487	G	T	8	12	20	0	0	20	0	0
6	29894243	rs2074486	C	T	7	15	22	0	0	22	0	0
6	29894410	rs2904763	C	T	2	9	11	0	0	11	0	0
6	29894439	rs2517771	A	T	8	12	20	0	0	20	0	0
6	29894456	rs2734913	T	G	9	12	21	0	1	22	0	0
6	29894580	rs2571425	T	G	8	15	23	0	0	23	0	0
6	29894794	rs1632907	A	G	8	16	24	0	0	24	0	0
6	29894798	rs2517767	T	C	8	14	22	0	0	22	0	0
6	29894874	rs439058	C	A	3	5	8	0	0	8	0	0
6	29894991	rs2517765	T	C	4	16	20	0	0	20	0	0
6	29895002	rs2517764	G	C	5	17	22	0	0	22	0	0
6	29895215	rs1655938	C	T	17	32	49	0	1	50	0	0
6	29895250	rs1655937	C	T	15	24	39	0	0	39	0	0
6	29895529	rs2517761	C	T	16	24	40	0	1	41	0	0
6	29895604	rs2471867	C	G	19	20	39	0	0	39	0	0
6	29895649	rs1655936	G	A	20	16	36	0	0	36	0	0
6	29895667	rs9259835	C	A	22	3	25	0	0	25	0	0
6	29895682	rs1632904	A	G	19	8	27	0	0	27	0	0
6	29895697	rs2471866	T	C	15	9	24	0	1	25	0	0
6	29895816	rs2517760	A	T	10	8	18	0	0	18	0	0
6	29895830	.	C	A	9	5	14	0	1	15	0	0
6	29895831	rs3957006	T	C	9	5	14	0	0	14	0	0
6	29895833	rs3863208	T	C	9	5	14	0	0	14	0	0
6	29895862	rs413009	G	A	16	12	28	0	0	28	0	0
6	29895913	rs13201148	G	A	17	19	36	0	0	36	0	0
6	29895928	rs3863209	G	A	17	19	36	0	0	36	0	0
6	29895929	rs9259839	C	G	16	19	35	0	1	36	0	0
6	29895944	rs13204255	G	A	17	37	54	0	0	54	0	0
6	29895973	rs9259842	C	G	18	50	68	0	1	69	0	0
6	29896054	rs9259844	C	A	16	26	42	0	2	44	0	0
6	29896055	rs9259845	C	T	17	27	44	0	0	44	0	0
6	29896084	rs9259846	A	G	209	36	245	0	1	246	0	0
6	29896120	rs2975011	G	T	1	5	6	0	0	6	0	0
6	29896268	rs2517759	T	C	25	50	75	0	0	75	0	0
6	29896275	rs2517758	G	A	23	50	73	0	0	73	0	0
6	29896484	rs2571424	G	C	8	0	8	0	0	8	0	0
6	29909745	rs9260107	A	G	4	3	7	0	0	7	0	0
6	29909751	rs2905764	T	C	3	3	6	0	1	7	0	0
6	29909756	rs9260109	G	C	3	3	6	0	1	7	0	0
6	29910189	rs9260119	A	T	5	1	6	0	0	6	0	0
6	29910276	rs41560714	T	G	10	6	16	0	0	16	0	0
6	29910286	rs2916801	C	T	10	8	18	0	0	18	0	0
6	29910358	rs1143146	C	G	181	337	518	0	3	521	0	0
6	29910378	rs41546314	C	T	201	398	599	0	5	604	0	0
6	29910429	.	C	G	6	11	17	0	0	17	0	0
6	29910437	.	C	T	7	7	14	0	0	14	0	0
6	29910450	rs17885299	G	C	7	2	9	0	1	10	0	0
6	29910457	rs9260125	T	G	6	1	7	0	0	7	0	0
6	29910478	rs9260127	G	C	7	2	9	0	0	9	0	0
6	29910482	rs9256980	G	A	7	2	9	0	0	9	0	0
6	29910496	rs2904759	C	G	6	2	8	0	0	8	0	0
6	29910508	rs9260129	A	G	4	2	6	0	0	6	0	0
6	29910522	rs9260130	G	C	5	12	17	0	0	17	0	0
6	29910527	.	C	T	6	14	20	0	0	20	0	0
6	29910538	.	C	T	236	442	678	0	3	681	0	0
6	29910604	rs12721675	C	A	238	475	713	0	11	724	0	0
6	29910700	.	G	T	391	466	857	0	4	861	0	0
6	29910716	rs1059455	C	G	433	277	710	0	2	714	2	0
6	29910717	rs1064588	A	G	432	278	710	0	2	714	2	0
6	29910730	rs199474436	T	A	448	309	757	0	11	768	0	0
6	29910742	rs78306866	G	C	432	243	675	0	6	681	0	0
6	29910752	rs1136683	G	C	448	443	891	0	5	896	0	0
6	29910820	rs9260142	G	C	99	66	165	0	2	167	0	0
6	29910834	rs63225861	G	C	94	76	170	0	1	171	0	0
6	29910839	.	C	T	94	77	171	0	0	171	0	0
6	29910892	.	A	G	88	97	185	0	2	187	0	0
6	29910986	rs17882350	G	A	21	32	53	0	15	68	0	0
6	29911000	rs9256982	T	G	9	39	48	0	0	48	0	0
6	29911019	rs9260149	T	C	9	18	27	0	0	27	0	0
6	29911037	rs9260152	G	C	11	17	28	0	1	29	0	0
6	29911056	rs1071743	A	G	391	521	912	0	6	918	0	0
6	29911063	rs199474485	T	G	403	437	840	0	4	844	0	0
6	29911064	rs1136695	A	G	410	437	847	0	7	854	0	0
6	29911092	rs1136702	G	T	498	491	989	0	2	991	0	0
6	29911114	rs3173420	G	A	527	201	728	0	2	730	0	0
6	29911115	rs1059498;rs12721717	G	C	528	201	729	0	3	732	0	0
6	29911119	rs3173419	G	T	546	238	784	0	5	790	1	0
6	29911154	rs1059509	C	A	703	430	1133	0	8	1141	0	0
6	29911190	rs1059514	G	A	757	266	1023	0	4	1027	0	0
6	29911198	.	T	C	723	255	978	0	4	982	0	0
6	29911207	.	G	A	717	265	982	0	5	987	0	0
6	29911228	rs9256983	A	T	701	441	1142	0	11	1153	0	0
6	29911256	rs1059542	T	G	709	520	1229	0	7	1237	1	0
6	29911419	.	A	G	116	32	148	0	2	150	0	0
6	29911538	rs2735111	G	A	115	33	148	0	7	155	0	0
6	29911790	rs9260166	T	C	183	26	209	0	0	209	0	0
6	29911803	.	G	A	180	28	208	0	2	210	0	0
6	29911827	.	G	A	208	26	234	0	1	235	0	0
6	29911836	.	C	T	210	24	234	0	0	234	0	0
6	29911844	.	T	A	196	19	215	0	0	215	0	0
6	29911879	rs9260171	T	G	240	10	250	0	0	250	0	0
6	29911880	rs17885212	T	A	242	10	252	0	0	252	0	0
6	29911893	rs9260172	C	T	237	28	265	0	1	266	0	0
6	29911895	.	T	A	263	5	268	0	1	269	0	0
6	29911901	.	C	G	985	349	1334	0	5	1341	2	0
6	29911909	rs1136746	G	A	946	297	1243	0	5	1249	1	0
6	29911912	rs1136749	A	G	909	262	1171	0	11	1183	1	0
6	29911921	.	C	T	873	206	1079	0	8	1087	0	0
6	29911928	.	C	G	830	0	830	0	4	834	0	0
6	29911930	.	C	T	825	0	825	0	6	831	0	0
6	29911931	.	A	G	815	0	815	0	4	819	0	0
6	29911945	.	G	A	794	207	1001	0	8	1009	0	0
6	29911970	.	G	A	676	435	1111	0	8	1119	0	0
6	29912108	rs2231095	G	C	774	818	1592	0	4	1596	0	0
6	29912147	.	C	T	977	909	1886	0	11	1897	0	0
6	29912188	.	T	C	163	70	233	0	7	240	0	0
6	29912204	rs2276447	C	T	168	64	232	0	3	235	0	0
6	29912280	rs1136903	T	C	950	1135	2085	0	6	2091	0	0
6	29912333	rs3179982	C	T	1108	1373	2481	0	39	2520	0	0
6	29912368	rs1141891	C	T	1086	665	1751	0	50	1802	1	0
6	29912398	rs9260191	A	G	182	53	235	0	3	238	0	0
6	29912451	rs9260193	C	A	120	26	146	0	1	147	0	0
6	29912457	rs9260194	C	G	130	23	153	0	0	153	0	0
6	29912463	.	A	G	139	14	153	0	1	154	0	0
6	29912473	rs9260196	T	C	140	10	150	0	1	151	0	0
6	29912477	rs9260197	A	G	146	5	151	0	0	151	0	0
6	29912493	rs1655894	G	A	152	1	153	0	1	154	0	0
6	29912494	rs2975059	T	C	149	1	150	0	1	151	0	0
6	29912502	rs9260198	C	T	160	16	176	0	0	176	0	0
6	29912517	rs1655895	T	C	145	18	163	0	3	166	0	0
6	29912595	.	G	A	116	89	205	0	0	205	0	0
6	29912657	rs9260200	C	T	182	91	273	0	7	280	0	0
6	29912668	rs9260201	T	G	181	104	285	0	8	293	0	0
6	29912669	rs9260202	A	G	183	104	287	0	9	296	0	0
6	29912754	.	G	A	215	141	356	0	4	360	0	0
6	29912766	rs3823324	A	T	216	148	364	0	1	365	0	0
6	29912796	.	G	A	221	139	360	0	0	360	0	0
6	29912830	rs2571381	T	C	232	82	314	0	0	314	0	0
6	29912852	rs1137296	T	C	1162	315	1477	0	45	1522	0	0
6	29912856	rs2231119	A	T	1209	310	1519	0	7	1526	0	0
6	29912935	rs2916802	C	T	67	21	88	0	0	88	0	0
6	29912944	rs2916803	T	C	67	15	82	0	0	82	0	0
6	29913042	rs14288	C	T	1278	1429	2707	0	13	2721	1	0
6	29913067	rs3823342	T	C	43	21	64	0	1	65	0	0
6	29913074	rs9260205	A	G	40	21	61	0	0	61	0	0
6	29913078	rs41546815	A	G	42	22	64	0	1	65	0	0
6	29913135	.	G	C	41	23	64	0	2	66	0	0
6	29913171	rs2975057	G	A	41	34	75	0	0	75	0	0
6	29913191	rs2975055	T	C	38	37	75	0	3	78	0	0
6	29913192	rs9260210	G	A	40	36	76	0	2	78	0	0
6	29913197	.	T	C	37	38	75	0	0	75	0	0
6	29913542	rs2499	T	G	391	450	841	0	11	852	0	0
6	29913638	rs13488	G	C	65	58	123	0	2	125	0	0
6	30037990	rs6539	C	T	79	58	137	0	0	137	0	0
6	30152367	rs7843	A	G	155	110	265	0	1	266	0	0
6	30152789	rs1042338	C	T	167	93	260	0	1	261	0	0
6	30154199	rs2074473	T	C	59	49	108	0	1	109	0	0
6	30154928	rs9261547	G	A	5	2	7	0	0	7	0	0
6	30155045	rs4959045	A	C	2	6	8	0	0	8	0	0
6	30155313	rs6457167	C	T	3	5	8	0	0	8	0	0
6	30157654	rs765977	G	A	4	6	10	0	0	10	0	0
6	30159039	rs718254	C	G	4	3	7	0	0	7	0	0
6	30159854	rs2284164	A	C	5	1	6	0	0	6	0	0
6	30160055	rs2284165	G	C	6	3	9	0	0	9	0	0
6	30161205	rs7382110	T	C	3	3	6	0	0	6	0	0
6	30162458	rs2517616	C	G	3	4	7	0	0	7	0	0
6	30167294	rs9261558	C	T	15	7	22	0	0	22	0	0
6	30179026	rs3130383	A	C	4	2	6	0	0	6	0	0
6	30179422	rs2844775	G	A	4	5	9	0	0	9	0	0
6	30181117	rs3094615	A	G	14	25	39	0	0	39	0	0
6	30272459	rs261944	G	A	4	4	8	0	0	8	0	0
6	30306553	rs3129838	G	A	12	4	16	0	0	16	0	0
6	30313268	rs11967	G	A	58	44	102	0	1	103	0	0
6	30314116	rs2844749	G	A	2	9	11	0	0	11	0	0
6	30530245	rs2074504	T	C	11	18	29	0	1	30	0	0
6	30530496	rs2074503	T	C	28	31	59	0	0	59	0	0
6	30564343	rs3130245	C	T	3	3	6	0	0	6	0	0
6	30574194	rs12174151	C	T	17	7	24	0	1	25	0	0
6	30608893	rs3130038	T	C	5	4	9	0	0	9	0	0
6	30685066	rs3132587	A	G	7	6	13	0	0	13	0	0
6	30711805	rs3094124	C	G	321	326	647	0	10	657	0	0
6	30876017	rs3218808	C	T	3	3	6	0	0	6	0	0
6	30882634	rs1264302	C	T	5	8	13	0	0	13	0	0
6	30882781	rs1264301	G	T	6	13	19	0	0	19	0	0
6	30884436	rs1264298	A	G	3	7	10	0	0	10	0	0
6	30884806	rs1264297	A	C	6	10	16	0	0	16	0	0
6	30885639	rs9262288	A	G	2	19	21	0	0	21	0	0
6	30885686	rs9262289	T	A	6	15	21	0	0	21	0	0
6	30885821	rs9262290	G	A	11	11	22	0	1	23	0	0
6	30886079	rs9262292	G	A	3	4	7	0	0	7	0	0
6	30887344	rs7738138	T	C	1	6	7	0	0	7	0	0
6	30887988	rs2249459	C	T	15	27	42	0	0	42	0	0
6	30888161	rs2249464	T	C	19	36	55	0	0	55	0	0
6	30888169	rs2517468	G	A	22	36	58	0	0	58	0	0
6	30889120	rs2532943	A	G	2	5	7	0	0	7	0	0
6	30889260	rs2517467	G	A	2	6	8	0	0	8	0	0
6	30890206	rs887381	T	C	4	18	22	0	0	22	0	0
6	30890483	rs2074506	G	T	29	47	76	0	2	78	0	0
6	30892322	rs2532942	C	T	28	30	58	0	2	60	0	0
6	30893428	rs2252863	G	A	19	52	71	0	0	71	0	0
6	30893728	rs1043483	C	T	45	74	119	0	0	119	0	0
6	31110671	rs1265085	G	C	14	12	26	0	0	26	0	0
6	31111180	rs130073	T	C	24	17	41	0	0	41	0	0
6	31113030	rs3132539	A	G	18	16	34	0	1	35	0	0
6	31113052	rs3094225	G	A	23	12	35	0	1	36	0	0
6	31118511	rs130067	T	G	11	6	17	0	0	17	0	0
6	31118565	rs130078	C	G	9	9	18	0	0	18	0	0
6	31122315	rs130066	G	C	11	7	18	0	1	19	0	0
6	31124849	rs3130453	C	T	14	7	21	0	0	21	0	0
6	31126944	rs3094187	C	T	6	4	10	0	0	10	0	0
6	31129616	rs2073721	A	G	9	11	20	0	0	20	0	0
6	31129642	rs2073722	A	C	8	13	21	0	0	21	0	0
6	31130502	rs1065461	T	C	4	8	12	0	0	12	0	0
6	31130593	rs1419881	G	A	3	4	7	0	1	8	0	0
6	31131569	rs3132528	C	T	4	4	8	0	0	8	0	0
6	31131609	rs3173358	A	T	7	4	11	0	0	11	0	0
6	31131611	rs9257058	A	C	7	4	11	0	0	11	0	0
6	31163106	rs7743722	C	G	9	6	15	0	0	15	0	0
6	31163566	rs9295960	A	G	9	8	17	0	0	17	0	0
6	31163569	rs9391819	A	G	10	7	17	0	0	17	0	0
6	31163582	rs9378227	C	G	10	10	20	0	0	20	0	0
6	31163791	rs6922077	G	C	17	20	37	0	0	37	0	0
6	31163796	rs6901685	T	C	17	19	36	0	0	36	0	0
6	31163972	rs28749551	G	C	14	8	22	0	0	22	0	0
6	31164199	rs28749555	C	T	12	2	14	0	0	14	0	0
6	31164204	rs200784272	T	C	12	4	16	0	0	16	0	0
6	31164207	rs28749557	C	T	12	2	14	0	0	14	0	0
6	31164235	rs3094611	T	C	10	3	13	0	0	13	0	0
6	31164236	rs6922842	G	A	10	3	13	0	0	13	0	0
6	31164242	rs6922553	C	T	10	3	13	0	0	13	0	0
6	31164271	rs6922994	G	A	12	6	18	0	1	19	0	0
6	31164352	rs6922744	C	T	13	4	17	0	0	17	0	0
6	31164365	rs6922729	A	G	13	6	19	0	0	19	0	0
6	31164410	rs6922756	A	G	14	9	23	0	1	24	0	0
6	31164472	rs6927253	C	A	17	12	29	0	0	29	0	0
6	31164507	rs28360065	G	A	13	6	19	0	0	19	0	0
6	31164511	rs9501073	C	T	13	6	19	0	0	19	0	0
6	31164517	rs28360066	C	T	14	2	16	0	0	16	0	0
6	31164549	rs9500882	A	G	14	6	20	0	0	20	0	0
6	31164580	rs28360067	G	A	13	6	19	0	0	19	0	0
6	31164590	rs28397268	A	C	12	10	22	0	0	22	0	0
6	31164595	rs28397269	G	A	10	12	22	0	0	22	0	0
6	31164635	rs28397270	T	C	5	14	19	0	0	19	0	0
6	31164643	rs28397271	C	T	5	16	21	0	0	21	0	0
6	31164700	rs3130461	G	A	6	21	27	0	0	27	0	0
6	31164739	rs28397272	C	A	4	12	16	0	0	16	0	0
6	31164750	rs28397273	T	G	4	10	14	0	0	14	0	0
6	31164770	rs28397275	C	T	5	6	11	0	0	11	0	0
6	31164779	rs28362333	T	C	6	13	19	0	0	19	0	0
6	31164794	rs28397276	T	C	10	22	32	0	0	32	0	0
6	31164849	rs28362335	G	A	19	30	49	0	2	51	0	0
6	31164901	rs28362336	T	G	16	25	41	0	1	42	0	0
6	31164943	rs28397277	G	A	12	16	28	0	0	28	0	0
6	31165100	rs9500883	A	C	9	16	25	0	0	25	0	0
6	31165150	rs3094610	G	C	6	17	23	0	0	23	0	0
6	31165177	rs9501075	C	T	9	17	26	0	0	26	0	0
6	31165277	rs3130462	A	G	5	18	23	0	0	23	0	0
6	31165438	rs28362342	T	G	16	27	43	0	1	44	0	0
6	31165566	rs3094609	T	C	12	25	37	0	0	37	0	0
6	31167512	rs9501077	A	G	5	2	7	0	0	7	0	0
6	31167927	rs4122189	C	T	5	1	6	0	0	6	0	0
6	31171257	rs6921948	A	C	2	5	7	0	0	7	0	0
6	31171598	rs1135811	T	C	2	4	6	0	0	6	0	0
6	31236534	rs35075694	G	A	115	14	129	0	3	132	0	0
6	31236567	rs1049281	T	C	524	250	774	0	6	780	0	0
6	31236599	rs3189472	G	C	1083	350	1433	0	6	1439	0	0
6	31236622	rs1130538	C	A	1283	571	1854	0	18	1873	1	0
6	31236643	rs1130552	T	C	1408	677	2085	0	7	2092	0	0
6	31236679	rs1130580	T	C	1670	1044	2714	0	11	2725	0	0
6	31236690	rs1130592	T	G	2019	1076	3095	0	19	3114	0	0
6	31236722	rs1094	C	T	2022	1185	3207	0	29	3238	2	0
6	31236853	rs1065711	G	A	2526	1355	3881	0	22	3903	0	0
6	31236998	rs2001181	C	T	24	16	40	0	0	40	0	0
6	31237002	rs17885436	G	C	24	15	39	0	1	40	0	0
6	31237014	rs3998381	G	A	23	11	34	0	0	34	0	0
6	31237017	rs2394960	C	T	25	12	37	0	0	37	0	0
6	31237027	rs2394961	C	T	25	10	35	0	0	35	0	0
6	31237048	rs9264594	A	G	21	5	26	0	0	26	0	0
6	31237061	rs2894204	C	T	17	7	24	0	0	24	0	0
6	31237124	rs1130838	T	C	2463	1636	4099	0	29	4128	0	0
6	31237162	rs35708511	C	G	2176	1162	3338	0	14	3352	0	0
6	31237230	rs9264596	A	G	47	23	70	0	0	70	0	0
6	31237233	rs9264597	A	G	50	23	73	0	0	73	0	0
6	31237255	rs2523609	G	A	54	21	75	0	0	75	0	0
6	31237323	rs68094471	A	G	44	66	110	0	1	111	0	0
6	31237333	rs66772001	T	A	47	67	114	0	3	117	0	0
6	31237342	rs72558163	G	T	48	62	110	0	0	110	0	0
6	31237353	rs67827555	T	C	48	59	107	0	1	108	0	0
6	31237405	rs56010430	C	T	69	54	123	0	1	124	0	0
6	31237437	rs66459704	T	C	86	70	156	0	1	157	0	0
6	31237449	rs68037221	T	C	84	69	153	0	0	153	0	0
6	31237463	rs66620546	C	G	86	85	171	0	1	172	0	0
6	31237563	rs3819287	C	T	63	36	99	0	2	101	0	0
6	31237592	rs9264606	A	C	72	73	145	0	2	147	0	0
6	31237660	rs9264608	A	G	70	76	146	0	0	146	0	0
6	31237664	rs9264609	C	T	68	68	136	0	0	136	0	0
6	31237703	rs17886880	G	A	46	33	79	0	0	79	0	0
6	31237723	rs9264610	G	A	47	25	72	0	0	72	0	0
6	31237727	rs2074497	T	C	43	23	66	0	0	66	0	0
6	31237767	rs1130935	T	C	2237	22	2259	0	74	2333	0	0
6	31237769	rs1050105	G	A	2318	22	2340	0	21	2361	0	0
6	31237771	rs1050106	G	A	2318	22	2340	0	15	2355	0	0
6	31237773	rs1130947	T	C	2275	21	2296	0	13	2309	0	0
6	31237774	rs41540512	G	C	2282	22	2304	0	20	2324	0	0
6	31237786	.	A	T	2339	191	2530	0	37	2567	0	0
6	31237802	.	A	G	2271	311	2582	0	35	2617	0	0
6	31237833	rs1050180	T	C	2383	308	2691	0	65	2756	0	0
6	31237858	rs34794906	T	C	2288	196	2484	0	22	2506	0	0
6	31237876	rs9264622	A	G	44	38	82	0	0	82	0	0
6	31237917	rs17884362	C	T	33	24	57	0	1	58	0	0
6	31237950	rs9264623	T	C	31	0	31	0	0	31	0	0
6	31237955	rs9264624	T	G	30	0	30	0	1	31	0	0
6	31237960	rs9264625	G	C	29	0	29	0	0	29	0	0
6	31237962	rs9264626	T	C	28	0	28	0	0	28	0	0
6	31237963	rs9264627	G	A	27	0	27	0	0	27	0	0
6	31237965	rs17886232	G	C	25	0	25	0	0	25	0	0
6	31237971	.	C	T	28	0	28	0	0	28	0	0
6	31237975	.	T	C	24	0	24	0	0	24	0	0
6	31237991	rs2308628	G	T	2277	62	2339	0	13	2353	1	0
6	31238009	rs1131014	T	C	2230	129	2359	0	33	2392	0	0
6	31238010	rs1131015	T	G	2261	128	2389	0	10	2399	0	0
6	31238029	rs2308622	T	C	2167	327	2494	0	22	2516	0	0
6	31238053	.	G	C	2431	437	2868	0	6	2876	2	0
6	31238126	.	G	A	2090	281	2371	0	10	2383	2	0
6	31238135	rs1050317	G	A	1973	234	2207	0	14	2221	0	0
6	31238138	rs1050320	C	T	1931	243	2174	0	22	2198	2	0
6	31238155	rs1050328	G	A	1708	269	1977	0	10	1987	0	0
6	31238230	rs1050716	G	C	1925	266	2191	0	12	2204	1	0
6	31238234	rs1050344	G	A	1914	214	2128	0	10	2138	0	0
6	31238259	rs1131096	G	T	1785	316	2101	0	10	2112	1	0
6	31238297	rs9264636	C	T	28	6	34	0	1	35	0	0
6	31238308	rs9264637	G	C	31	6	37	0	0	37	0	0
6	31238318	rs9264638	G	A	29	7	36	0	0	36	0	0
6	31238345	rs17883395	T	C	24	5	29	0	0	29	0	0
6	31238372	rs9264640	C	G	27	14	41	0	0	41	0	0
6	31238377	rs9264641	G	C	27	17	44	0	0	44	0	0
6	31238490	rs9264642	T	C	12	24	36	0	0	36	0	0
6	31238492	rs9264643	C	A	12	24	36	0	0	36	0	0
6	31238524	rs9264645	G	A	13	21	34	0	0	34	0	0
6	31238535	rs9264646	T	C	13	19	32	0	2	34	0	0
6	31238613	rs9264647	A	G	17	21	38	0	1	39	0	0
6	31238632	.	C	T	15	21	36	0	0	36	0	0
6	31238661	rs9264648	G	A	16	14	30	0	0	30	0	0
6	31238662	rs9264649	A	G	16	14	30	0	0	30	0	0
6	31238728	.	G	C	16	13	29	0	0	29	0	0
6	31238759	rs17884428	C	T	17	8	25	0	1	26	0	0
6	31238762	rs9264652	T	C	18	9	27	0	0	27	0	0
6	31238814	rs9264653	T	C	11	7	18	0	0	18	0	0
6	31238851	.	T	C	1716	200	1916	0	11	1928	1	0
6	31238875	.	G	A	1615	333	1948	0	13	1961	0	0
6	31238880	.	C	T	1581	337	1918	0	20	1938	0	0
6	31238909	rs1050686	G	A	1480	166	1646	0	7	1666	13	0
6	31238910	rs1050685	T	G	1416	161	1577	0	29	1620	14	0
6	31238942	rs2308590	G	T	1400	55	1455	0	11	1565	99	0
6	31238957	.	A	C	1543	60	1603	0	9	1613	1	0
6	31238983	rs2308585	G	C	1347	145	1492	0	9	1501	0	0
6	31239010	.	G	A	1339	94	1433	0	4	1437	0	0
6	31239050	rs713032	G	T	1145	205	1350	0	6	1356	0	0
6	31239090	rs34592426	G	C	1096	284	1380	0	9	1390	1	0
6	31239101	rs1131115	G	T	1075	298	1373	0	12	1385	0	0
6	31239114	rs1071649	G	T	1058	321	1379	0	7	1386	0	0
6	31239116	.	G	A	1062	324	1386	0	3	1389	0	0
6	31239151	rs67420880	A	C	6	0	6	0	0	6	0	0
6	31239205	rs9264663	C	T	85	51	136	0	3	139	0	0
6	31239227	rs9264664	C	T	109	77	186	0	1	187	0	0
6	31239279	rs9264665	T	C	218	38	256	0	15	271	0	0
6	31239296	rs9264666	G	C	235	76	311	0	3	314	0	0
6	31239305	rs17879195	C	T	251	92	343	0	3	346	0	0
6	31239306	rs7383157	T	G	248	93	341	0	4	345	0	0
6	31239335	rs17880655	G	A	247	135	382	0	3	386	1	0
6	31239378	rs1131123	T	G	1227	335	1562	0	7	1569	0	0
6	31239430	rs41543814	C	T	1154	626	1780	0	6	1786	0	0
6	31239577	rs707911	A	C	850	224	1074	0	13	1090	3	0
6	31239585	rs1050437	C	T	887	190	1077	0	16	1093	0	0
6	31239593	rs41542719	T	C	845	160	1005	0	5	1010	0	0
6	31239614	rs1050444	G	A	839	65	904	0	6	910	0	0
6	31239622	rs9264668	C	A	797	45	842	0	4	948	102	0
6	31239681	rs9264669	A	T	89	35	124	0	1	125	0	0
6	31239722	rs9264670	A	C	111	46	157	0	1	158	0	0
6	31239752	rs9264671	C	A	116	35	151	0	1	152	0	0
6	31239776	rs2074493	A	C	704	75	779	0	6	785	0	0
6	31239802	rs1050451	C	G	602	83	685	0	2	687	0	0
6	31239821	rs2308527	G	T	553	45	598	0	2	600	0	0
6	31239827	rs2308525	C	T	508	42	550	0	10	560	0	0
6	31239855	rs7767581	C	G	125	11	136	0	2	138	0	0
6	31239868	rs9264674	G	C	13	7	20	0	0	20	0	0
6	31239896	rs2074491	T	C	4	4	8	0	0	8	0	0
6	31248204	rs2524062	G	A	0	8	8	0	0	8	0	0
6	31248432	rs2844606	A	G	0	6	6	0	0	6	0	0
6	31248434	rs9264758	A	G	0	6	6	0	0	6	0	0
6	31321681	rs1058067	C	T	486	162	648	0	2	650	0	0
6	31324024	rs697742	C	A	1827	1322	3149	0	31	3184	4	0
6	31324036	rs151341293	T	A	2542	622	3164	0	18	3182	0	0
6	31324051	rs41551018	C	A	2662	603	3265	0	24	3290	1	0
6	31324064	rs41541519	T	A	2576	586	3162	0	19	3181	0	0
6	31324151	rs709055	C	T	1473	449	1922	0	9	1932	1	0
6	31324200	rs1140412	G	C	1174	580	1754	0	8	1762	0	0
6	31324373	rs4999718	A	G	110	50	160	0	0	160	0	0
6	31324375	rs41563615	G	T	118	50	168	0	1	169	0	0
6	31324516	rs1131215	C	A	1735	251	1986	0	9	1995	0	0
6	31324531	rs1131204	C	T	1576	77	1653	0	7	1661	1	0
6	31324536	rs1071816	T	G	1612	91	1703	0	5	1709	1	0
6	31324547	rs1065386	G	C	1599	96	1695	0	7	1702	0	0
6	31324549	rs1050570	T	C	1599	97	1696	0	2	1698	0	0
6	31324586	rs1050556	C	T	1587	73	1660	0	12	1672	0	0
6	31324603	rs9266178	C	T	1493	58	1551	0	4	1555	0	0
6	31324604	.	T	C	1485	57	1542	0	7	1549	0	0
6	31324615	rs1050529	C	T	1391	65	1456	0	15	1472	1	0
6	31324641	rs1050518	T	A	1416	28	1444	0	23	1467	0	0
6	31324643	rs1050517	G	C	1433	32	1465	0	6	1471	0	0
6	31324664	rs9266184	T	G	1383	25	1408	0	23	1431	0	0
6	31324666	rs713031	A	T	1262	25	1287	0	22	1379	70	0
6	31324702	rs1050486	C	T	1155	42	1197	0	11	1208	0	0
6	31324705	rs1131170	A	C	1048	164	1212	0	13	1226	1	0
6	31324711	rs2596492	A	G	1307	82	1389	0	7	1397	1	0
6	31324742	rs147324178	T	C	176	3	179	0	1	180	0	0
6	31324750	rs41558815	G	A	179	0	179	0	0	179	0	0
6	31324788	rs9266193	T	C	131	0	131	0	4	135	0	0
6	31324790	rs9266194	A	G	130	0	130	0	2	133	1	0
6	31324829	rs9266196	G	C	96	0	96	0	0	96	0	0
6	31324830	rs9266197	G	A	96	0	96	0	1	97	0	0
6	31324847	rs9266198	C	G	86	0	86	0	1	87	0	0
6	31324921	rs1050459	C	T	509	110	619	0	5	624	0	0
6	31324925	rs1050458	A	G	451	74	525	0	3	528	0	0
6	31324931	rs9266206	A	C	382	39	421	0	7	428	0	0
6	31324953	rs9266207	C	T	31	0	31	0	1	32	0	0
6	31462672	rs2534684	A	C	7	6	13	0	0	13	0	0
6	31473546	rs3131639	A	G	24	21	45	0	0	45	0	0
6	31473561	rs1065075	A	G	23	20	43	0	0	43	0	0
6	31474000	rs1051788	G	A	31	27	58	0	2	60	0	0
6	31475486	rs3132468	C	T	1	8	9	0	0	9	0	0
6	31475764	rs3093952	A	G	3	3	6	0	0	6	0	0
6	31475913	rs2844499	A	T	4	3	7	0	0	7	0	0
6	31476094	rs3131636	A	G	5	6	11	0	0	11	0	0
6	31476134	rs3131635	A	G	4	3	7	0	0	7	0	0
6	31476265	rs3134891	G	A	8	2	10	0	0	10	0	0
6	31476339	rs3132466	C	T	4	3	7	0	0	7	0	0
6	31476340	rs3134892	A	G	4	3	7	0	0	7	0	0
6	31476514	rs3134893	C	A	5	1	6	0	0	6	0	0
6	31477681	rs1065076	A	G	21	15	36	0	1	37	0	0
6	31498384	rs9267480	C	A	39	16	55	0	0	55	0	0
6	31498497	rs3093978	C	A	30	34	64	0	1	65	0	0
6	31498737	rs2516478	G	A	105	74	179	0	1	180	0	0
6	31499354	rs3130056	C	T	262	252	514	0	4	518	0	0
6	31500226	rs3093977	C	A	184	157	341	0	1	342	0	0
6	31501413	rs3093948	A	G	486	450	936	0	6	942	0	0
6	31501737	rs1055388	C	T	395	389	784	0	8	792	0	0
6	31501817	rs3131629	T	A	337	333	670	0	2	672	0	0
6	31502767	rs3131628	C	T	373	329	702	0	0	704	2	0
6	31502861	rs3093976	A	G	293	276	569	0	0	569	0	0
6	31503975	rs2075580	G	C	12	5	17	0	0	17	0	0
6	31506624	rs1129640	T	C	535	475	1010	0	3	1013	0	0
6	31506648	rs933208	G	T	14	7	21	0	0	21	0	0
6	31506744	rs2516393	A	C	4	6	10	0	0	10	0	0
6	31506801	rs2523512	G	A	5	7	12	0	0	12	0	0
6	31506854	rs2523511	C	T	6	6	12	0	0	12	0	0
6	31508761	rs2523508	C	T	22	13	35	0	0	35	0	0
6	31509355	rs2523507	G	A	19	23	42	0	1	43	0	0
6	31509372	rs2239525	G	A	17	24	41	0	0	41	0	0
6	31509432	rs2239526	G	A	26	23	49	0	1	50	0	0
6	31509967	rs2523506	G	T	5	5	10	0	0	10	0	0
6	31510105	rs2239528	A	G	2	4	6	0	0	6	0	0
6	31525448	rs2230365	C	T	30	28	58	0	1	59	0	0
6	31525912	rs3130062	C	T	32	50	82	0	0	82	0	0
6	31540556	rs2229094	T	C	4	5	9	0	0	9	0	0
6	31540757	rs2229092	A	C	6	5	11	0	0	11	0	0
6	31555130	rs2256965	A	G	9	5	14	0	0	14	0	0
6	31555657	rs3135041	A	G	9	13	22	0	0	22	0	0
6	31556581	rs1052248	T	A	76	124	200	0	1	201	0	0
6	31583827	rs2259571	T	G	237	231	468	0	3	471	0	0
6	31594628	rs3130071	T	A	115	86	201	0	1	202	0	0
6	31595487	rs2736171	A	G	7	4	11	0	0	11	0	0
6	31595882	rs1046080	C	A	136	140	276	0	1	277	0	0
6	31601344	rs2272593	T	C	116	144	260	0	5	265	0	0
6	31603591	rs2261033	A	G	19	11	30	0	0	30	0	0
6	31604010	rs13716	C	G	340	404	744	0	5	749	0	0
6	31604044	rs3132453	T	G	274	370	644	0	28	672	0	0
6	31605199	rs2736155	G	C	261	226	487	0	1	488	0	0
6	31605448	rs7889	C	G	5	36	41	0	2	43	0	0
6	31607050	rs750332	C	T	9	9	18	0	0	18	0	0
6	31610529	rs1077393	A	G	3	4	7	0	0	7	0	0
6	31610686	rs1052486	A	G	78	80	158	0	2	160	0	0
6	31611158	rs2395047	T	C	3	4	7	0	0	7	0	0
6	31619652	rs805299	T	A	18	9	27	0	0	27	0	0
6	31627523	rs3130617	C	T	37	31	68	0	0	68	0	0
6	31636031	rs3117578	A	G	4	4	8	0	0	8	0	0
6	31637734	rs5872	A	T	346	309	655	0	3	658	0	0
6	31639420	rs3131377	A	G	4	5	9	0	0	9	0	0
6	31641139	rs707919	A	G	357	345	702	0	1	703	0	0
6	31657413	rs1475865	T	C	113	120	233	0	1	234	0	0
6	31688518	rs805293	T	A	8	5	13	0	0	13	0	0
6	31695368	rs11540321	G	A	1217	999	2216	0	15	2231	0	0
6	31697957	rs9267551	C	G	321	286	607	0	10	617	0	0
6	31698352	rs2272592	T	C	70	34	104	0	6	110	0	0
6	31703688	.	C	A	8	19	27	0	0	27	0	0
6	31717692	rs3117572	A	G	4	2	6	0	0	6	0	0
6	31723389	rs3130487	C	T	9	4	13	0	0	13	0	0
6	31762843	rs2607015	G	C	19	14	33	0	2	35	0	0
6	31762844	rs2753960	G	T	19	15	34	0	1	35	0	0
6	31777946	rs2075800	C	T	4	4	8	0	0	8	0	0
6	31785228	rs506770	G	C	85	108	193	0	2	195	0	0
6	31797587	.	C	G	184	2	186	0	4	190	0	0
6	31839331	rs2242664	C	T	6	0	6	0	0	6	0	0
6	31860337	rs535586	T	C	48	51	99	0	1	100	0	0
6	31861141	rs2844457	A	T	48	42	90	0	0	90	0	0
6	31864547	rs7887	G	T	42	30	72	0	1	73	0	0
6	31928799	rs419788	T	C	2	5	7	0	0	7	0	0
6	31929014	rs437179	A	C	8	11	19	0	0	19	0	0
6	31936668	rs410851	T	C	40	50	90	0	0	90	0	0
6	31947460	rs389883	G	T	20	28	48	0	1	49	0	0
6	32010272	rs17421133	T	A	14	5	19	0	0	19	0	0
6	32050067	rs185819	T	C	4	2	6	0	0	6	0	0
6	32075563	rs429150	T	C	5	5	10	0	0	10	0	0
6	32076499	rs2269426	G	A	5	2	7	0	0	7	0	0
6	32080146	rs3130342	A	C	4	3	7	0	0	7	0	0
6	32083175	rs8111	C	T	66	66	132	0	1	133	0	0
6	32088854	rs2228628	G	C	87	70	157	0	1	158	0	0
6	32407709	rs14004	C	A	48	62	110	0	0	110	0	0
6	32411035	rs8084	A	C	84	132	216	0	1	217	0	0
6	32411646	rs7192	T	G	83	127	210	0	3	213	0	0
6	32412480	rs7194	G	A	93	135	228	0	0	228	0	0
6	32412539	rs7195	A	G	118	172	290	0	2	292	0	0
6	32412571	rs7196	A	T	115	172	287	0	0	287	0	0
6	32412580	rs7197	T	C	121	185	306	0	2	308	0	0
6	32489744	.	G	A	6	0	6	0	0	6	0	0
6	32489745	rs41548618	C	G	6	0	6	0	0	6	0	0
6	32489792	rs41562816	G	T	0	7	7	0	0	7	0	0
6	32489794	rs1059350	G	A	0	7	7	0	0	7	0	0
6	32489795	.	T	C	7	0	7	0	0	7	0	0
6	32489796	rs145586726	C	T	7	0	7	0	0	7	0	0
6	32546677	.	T	A	9	7	16	0	0	16	0	0
6	32546684	.	A	G	9	6	15	0	0	15	0	0
6	32546697	.	G	A	8	9	17	0	0	17	0	0
6	32546698	.	G	A	8	9	17	0	0	17	0	0
6	32546704	.	G	A	11	8	19	0	0	19	0	0
6	32546758	.	C	T	9	5	14	0	0	14	0	0
6	32546781	.	T	C	9	1	10	0	0	10	0	0
6	32548632	.	T	A	13	7	20	0	0	20	0	0
6	32549452	.	C	G	0	13	13	0	0	13	0	0
6	32549464	.	T	C	12	0	12	0	0	12	0	0
6	32549481	.	C	T	0	10	10	0	0	10	0	0
6	32549497	.	G	A	0	6	6	0	0	6	0	0
6	32549548	.	G	A	1	18	19	0	1	20	0	0
6	32549607	.	T	G	12	0	12	0	0	12	0	0
6	32552056	.	A	G	11	0	11	0	0	11	0	0
6	32780724	rs11244	G	A	17	14	31	0	0	31	0	0
6	32780914	rs2070120	G	A	18	14	32	0	0	32	0	0
6	32781076	rs17220087	C	A	9	5	14	0	0	14	0	0
6	32781121	rs17213693	G	C	9	4	13	0	0	13	0	0
6	32781554	rs2070121	G	A	19	11	30	0	0	30	0	0
6	32781776	rs2856997	C	A	4	6	10	0	0	10	0	0
6	32782018	rs16870880	C	T	3	5	8	0	0	8	0	0
6	32782149	rs17501267	G	A	11	5	16	0	0	16	0	0
6	32783086	rs7383287	A	G	4	9	13	0	0	13	0	0
6	32783337	rs2856995	T	A	6	4	10	0	0	10	0	0
6	32783365	rs2857111	T	C	8	4	12	0	0	12	0	0
6	32783406	rs76440421	G	A	6	6	12	0	0	12	0	0
6	32783450	rs17501287	C	G	4	4	8	0	0	8	0	0
6	32784783	rs2071469	C	T	6	1	7	0	0	7	0	0
6	32785029	rs2071547	T	C	1	6	7	0	0	7	0	0
6	32785035	rs2071468	A	G	1	6	7	0	0	7	0	0
6	32785904	rs2157077	G	T	5	8	13	0	0	13	0	0
6	32795032	rs10484565	G	A	8	16	24	0	0	24	0	0
6	32795462	rs187562510	C	T	24	19	43	0	0	43	0	0
6	32800412	rs1800454	C	T	14	12	26	0	0	26	0	0
6	32802009	rs62397687	C	T	6	2	8	0	0	8	0	0
6	32802203	rs241432	G	T	3	4	7	0	0	7	0	0
6	32813768	rs116827595	G	A	12	12	24	0	0	24	0	0
6	32917544	rs1063478	C	T	29	19	48	0	0	48	0	0
6	32942302	rs516535	G	A	181	209	390	0	6	396	0	0
6	32945466	rs73409631	A	G	5	10	15	0	0	15	0	0
6	32946322	rs76088152	G	A	51	54	105	0	1	106	0	0
6	32946328	rs206780	G	C	45	49	94	0	2	96	0	0
6	32946511	rs73409636	G	A	20	39	59	0	0	59	0	0
6	32946837	rs2395380	A	T	21	13	34	0	0	34	0	0
6	32946854	rs2082260	G	T	21	19	40	0	2	42	0	0
6	32948462	rs3918140	G	A	853	892	1745	0	9	1754	0	0
6	32948607	rs1049414	C	T	503	701	1204	0	116	1336	16	0
6	32948721	rs78300601	C	G	657	661	1318	0	11	1329	0	0
6	33033022	rs3077	A	G	2	4	6	0	0	6	0	0
6	33033055	rs1042688	A	T	3	4	7	0	0	7	0	0
6	33033058	rs3211475	T	C	3	6	9	0	0	9	0	0
6	33036435	rs1126769	T	G	5	6	11	0	0	11	0	0
6	33036999	rs1042190	T	C	2	4	6	0	0	6	0	0
6	33048466	rs1126511	G	T	8	6	14	0	0	14	0	0
6	33048467	rs1126513	G	T	8	6	14	0	0	14	0	0
6	33048539	rs1042117	T	A	9	8	17	0	0	17	0	0
6	33048542	rs1042121	C	T	9	8	17	0	0	17	0	0
6	33048599	rs707958	C	A	9	9	18	0	0	18	0	0
6	33048602	rs1042131	C	A	9	9	18	0	0	18	0	0
6	33048606	rs1042133	G	C	9	7	16	0	0	16	0	0
6	33048628	rs1042136	A	C	9	6	15	0	0	15	0	0
6	33048661	rs1042151	A	G	10	3	13	0	0	13	0	0
6	33048663	rs1042153	G	A	10	3	13	0	0	13	0	0
6	33053577	rs9276	G	A	26	19	45	0	0	45	0	0
6	33162082	rs2072915	T	A	64	74	138	0	1	139	0	0
6	33168716	rs113790335	G	A	47	24	71	0	0	71	0	0
6	33176958	rs213209	C	T	13	6	19	0	0	19	0	0
6	33178010	rs213208	G	T	28	27	55	0	2	57	0	0
6	33180045	rs2854027	T	C	17	16	33	0	0	33	0	0
6	33229010	rs457105	C	A	7	7	14	0	0	14	0	0
6	33232055	rs213202	G	A	35	29	64	0	0	64	0	0
6	33232521	rs213201	C	T	58	30	88	0	0	88	0	0
6	33235755	rs213199	G	A	50	46	96	0	1	97	0	0
6	33238404	rs213203	A	C	6	3	9	0	0	9	0	0
6	33241076	rs213204	C	A	8	12	20	0	0	20	0	0
6	33241135	rs213205	T	C	7	10	17	0	0	17	0	0
6	33241143	rs213206	C	G	8	8	16	0	0	16	0	0
6	33241169	rs213207	C	T	8	5	13	0	0	13	0	0
6	33247875	rs120626	A	T	5	5	10	0	1	11	0	0
6	33248174	rs213215	G	A	3	5	8	0	0	8	0	0
6	33252115	rs455567	G	A	4	4	8	0	0	8	0	0
6	33255103	rs446735	A	C	9	4	13	0	0	13	0	0
6	33256096	rs462093	A	T	5	8	13	0	0	13	0	0
6	33256984	rs463260	C	T	39	35	74	0	0	74	0	0
6	33257186	rs464865	A	G	23	33	56	0	0	56	0	0
6	33258443	rs456261	G	A	14	16	30	0	0	30	0	0
6	33261871	rs2239842	A	G	13	16	29	0	0	29	0	0
6	33267672	rs1059288	A	G	782	804	1586	0	10	1596	0	0
6	33268737	rs3130259	C	A	90	49	139	0	9	148	0	0
6	33269881	rs35404844	T	G	21	19	40	0	2	42	0	0
6	33270680	rs9277968	A	G	15	22	37	0	0	37	0	0
6	33272541	rs1800838	A	T	16	13	29	0	0	29	0	0
6	33272712	rs2071889	C	A	3	4	7	0	0	7	0	0
6	33272855	rs2071888	G	C	116	101	217	0	1	218	0	0
6	33274520	rs3135409	A	C	5	2	7	0	0	7	0	0
6	33275013	rs3135408	T	C	3	3	6	0	0	6	0	0
6	33278816	rs3130260	G	A	2	5	7	0	0	7	0	0
6	33280629	rs3106190	C	G	3	3	6	0	0	6	0	0
6	33281842	rs2239841	G	T	24	14	38	0	0	38	0	0
6	33281843	rs2239840	A	T	24	14	38	0	0	38	0	0
6	33282002	rs3106189	C	T	13	7	20	0	0	20	0	0
6	33282628	rs1061783	C	T	37	21	58	0	1	59	0	0
6	33283766	rs3130100	T	C	17	24	41	0	1	42	0	0
6	33288075	rs2239839	C	A	41	33	74	0	0	74	0	0
6	33288271	rs1059231	A	G	85	72	157	0	1	158	0	0
6	33367133	rs391500	C	A	8	8	16	0	0	16	0	0
6	33376436	rs114485144	T	C	6	9	15	0	0	15	0	0
6	33377506	.	G	C	90	6	96	0	2	98	0	0
6	33541719	rs513349	A	G	13	13	26	0	0	26	0	0
6	33542523	rs9296095	T	C	14	7	21	0	1	22	0	0
6	33542661	rs11757379	G	T	9	13	22	0	0	22	0	0
6	33545125	rs5745587	A	G	3	3	6	0	0	6	0	0
6	33545340	rs2227925	G	A	61	60	121	0	1	122	0	0
6	33599207	rs11755257	C	A	3	7	10	0	0	10	0	0
6	33599979	rs13192436	C	T	5	2	7	0	0	7	0	0
6	33599993	rs11758330	T	A	7	2	9	0	0	9	0	0
6	33753171	.	C	T	21	12	33	0	0	33	0	0
6	34207317	rs186750821	C	G	5	1	6	0	0	6	0	0
6	34207727	rs183778437	T	A	2	5	7	0	0	7	0	0
6	34215135	rs181266984	G	C	8	11	19	0	0	19	0	0
6	34248685	rs375811453	T	C	51	25	76	0	1	77	0	0
6	34249341	rs62399870	T	C	32	19	51	0	1	52	0	0
6	34252352	rs6691	C	T	3	11	14	0	4	18	0	0
6	34253877	rs6907486	A	G	6	3	9	0	2	11	0	0
6	34254178	rs6908522	G	T	10	6	16	0	0	16	0	0
6	34255476	rs206942	T	C	26	15	41	0	0	41	0	0
6	34290533	rs6924682	T	G	2	4	6	0	0	6	0	0
6	34386600	rs529786272	C	T	5	3	8	0	0	8	0	0
6	34393845	rs9469779	G	A	17	95	112	0	1	113	0	0
6	34393866	rs78454682	G	A	53	5	58	0	0	58	0	0
6	34512195	rs2233637	G	C	8	2	10	0	0	10	0	0
6	34557246	rs2744937	C	T	57	39	96	0	2	98	0	0
6	34573213	rs2814975	C	T	4	4	8	0	0	8	0	0
6	34577751	rs2744975	C	T	13	6	19	0	0	19	0	0
6	34577776	rs2814978	T	A	13	5	18	0	0	18	0	0
6	34655000	rs2744961	C	T	37	33	70	0	2	72	0	0
6	34656722	rs2814949	A	G	7	18	25	0	0	25	0	0
6	34725658	.	G	T	38	9	47	0	0	48	1	0
6	34729848	rs9469862	A	G	4	4	8	0	0	8	0	0
6	34759954	rs6457791	A	G	4	5	9	0	0	9	0	0
6	34761809	rs6942040	A	C	2	17	19	0	1	20	0	0
6	34803947	rs4259246	C	T	28	25	53	0	0	53	0	0
6	34824636	rs11755393	A	G	18	22	40	0	0	40	0	0
6	34825662	rs16894959	T	C	14	24	38	0	0	38	0	0
6	34827085	rs9469913	A	T	26	39	65	0	0	65	0	0
6	34831866	rs3734264	G	A	16	23	39	0	0	39	0	0
6	34842192	rs11969436	C	T	33	29	62	0	1	63	0	0
6	34845449	rs4646949	T	G	5	4	9	0	0	9	0	0
6	34845648	rs2985	T	C	213	173	386	0	3	389	0	0
6	34846832	rs4646944	G	A	22	17	39	0	0	39	0	0
6	34847229	rs4646940	T	C	11	4	15	0	1	16	0	0
6	34850143	rs9462032	G	A	11	7	18	0	0	18	0	0
6	34850411	rs9469923	A	G	5	3	8	0	0	8	0	0
6	34851134	rs2273006	T	C	5	2	7	0	1	8	0	0
6	34852150	rs4646930	A	G	6	5	11	0	0	11	0	0
6	34852253	rs4646926	G	T	11	4	15	0	0	15	0	0
6	34852546	rs4646925	A	G	3	5	8	0	0	8	0	0
6	34852891	rs57951780	C	T	7	1	8	0	0	8	0	0
6	34949607	rs2293242	C	T	5	2	7	0	1	8	0	0
6	34966047	rs9784889	A	G	3	3	6	0	0	6	0	0
6	34966288	rs9784818	G	A	5	3	8	0	0	8	0	0
6	35050506	rs2177382	G	A	7	6	13	0	0	13	0	0
6	35056560	rs11552397	G	A	11	7	18	0	0	18	0	0
6	35056862	rs57111149	T	C	11	7	18	0	0	18	0	0
6	35057479	rs17610836	C	T	12	11	23	0	0	23	0	0
6	35058117	rs707968	A	G	10	20	30	0	0	30	0	0
6	35058531	rs11552398	C	T	22	16	38	0	1	39	0	0
6	35088381	rs2234045	C	G	3	5	8	0	0	8	0	0
6	35090097	rs2234044	T	C	1	5	6	0	0	6	0	0
6	35256934	rs729925	C	A	5	1	6	0	0	6	0	0
6	35259646	rs9366883	G	C	10	9	19	0	0	19	0	0
6	35260503	rs1557567	C	T	27	28	55	0	1	56	0	0
6	35260530	.	C	T	32	32	64	0	0	64	0	0
6	35261990	rs965272	C	T	4	2	6	0	1	7	0	0
6	35263555	rs1194	A	G	46	38	84	0	0	84	0	0
6	35263677	rs8205	T	A	28	22	50	0	0	50	0	0
6	35378778	rs2016520	C	T	6	7	13	0	0	13	0	0
6	35384168	.	A	C	22	1	23	0	1	24	0	0
6	35384173	.	A	C	18	2	20	0	5	25	0	0
6	35391787	rs2076167	C	T	15	10	25	0	0	25	0	0
6	35395010	rs3734254	C	T	18	17	35	0	0	35	0	0
6	35395578	rs1053046	G	A	29	28	57	0	0	57	0	0
6	35395618	rs1053049	C	T	26	28	54	0	0	54	0	0
6	35436925	rs2076172	C	T	162	181	343	0	4	347	0	0
6	35437374	rs114188429	A	G	44	46	90	0	2	92	0	0
6	35437453	rs139064372	T	G	47	75	122	0	1	123	0	0
6	35437738	rs115419624	C	A	72	77	149	0	0	149	0	0
6	35542045	rs41270080	C	A	87	78	165	0	3	168	0	0
6	35542526	rs11545925	T	A	46	51	97	0	1	98	0	0
6	35544942	rs34866878	G	A	97	86	183	0	3	186	0	0
6	35549670	rs755658	C	T	5	4	9	0	0	9	0	0
6	35610340	rs12110366	C	T	2	4	6	0	0	6	0	0
6	35610751	rs12527329	A	T	1	6	7	0	0	7	0	0
6	35613998	rs7771722	G	A	14	2	16	0	0	16	0	0
6	35614127	rs73748211	C	G	12	1	13	0	0	13	0	0
6	35995633	rs56156688	A	G	6	12	18	0	0	18	0	0
6	35996413	rs61763101	C	T	0	6	6	0	0	6	0	0
6	36046226	rs61195139	A	C	55	67	122	0	0	122	0	0
6	36048010	rs7748078	G	A	27	39	66	0	2	68	0	0
6	36048417	rs6910685	A	G	42	24	66	0	4	70	0	0
6	36049716	rs80032177	G	A	3	6	9	0	0	9	0	0
6	36054932	rs60909394	C	T	2	7	9	0	0	9	0	0
6	36055675	rs58690654	A	G	3	3	6	0	0	6	0	0
6	36055941	rs7762483	G	T	6	6	12	0	1	13	0	0
6	36056855	rs56327416	C	A	1	6	7	0	0	7	0	0
6	36060211	rs16884660	G	A	17	15	32	0	1	33	0	0
6	36061263	rs6914570	G	A	15	13	28	0	0	28	0	0
6	36061461	rs60342497	A	G	12	3	15	0	0	15	0	0
6	36062991	rs7771484	A	T	20	15	35	0	1	36	0	0
6	36063162	rs16884694	G	A	34	18	52	0	0	52	0	0
6	36064036	rs851007	G	A	8	12	20	0	0	20	0	0
6	36065622	rs7745082	A	C	10	4	14	0	0	14	0	0
6	36065664	rs12529470	T	C	7	2	9	0	1	10	0	0
6	36067466	.	C	T	20	18	38	0	1	39	0	0
6	36068303	rs7761118	G	A	19	15	34	0	0	34	0	0
6	36068989	rs7766032	G	A	23	18	41	0	0	41	0	0
6	36069489	rs851005	A	G	18	21	39	0	1	40	0	0
6	36069875	rs6936327	C	T	25	15	40	0	1	41	0	0
6	36070227	rs16884857	G	T	41	27	68	0	0	68	0	0
6	36070671	rs3752525	G	T	13	10	23	0	0	23	0	0
6	36070699	rs16884906	A	G	9	12	21	0	0	21	0	0
6	36071517	rs16884919	G	A	29	24	53	0	0	53	0	0
6	36072172	rs1967966	C	T	6	0	6	0	0	6	0	0
6	36075219	rs9470219	A	C	8	3	11	0	0	11	0	0
6	36076280	rs6457878	C	T	309	208	517	0	1	518	0	0
6	36077961	rs3804451	G	A	526	463	989	0	2	991	0	0
6	36126650	rs2213661	A	G	4	2	6	0	0	6	0	0
6	36163941	rs9470228	C	T	9	1	10	0	0	10	0	0
6	36198577	rs3748045	G	C	14	10	24	0	0	24	0	0
6	36274148	rs45621032	T	A	8	0	8	0	0	8	0	0
6	36274153	rs12197079	C	T	8	0	8	0	0	8	0	0
6	36275458	rs4713956	T	C	8	1	9	0	0	9	0	0
6	36430560	rs9348997	A	G	6	1	7	0	0	7	0	0
6	36452407	.	C	G	6	3	9	0	0	9	0	0
6	36455838	rs41272166	C	T	93	76	169	0	0	169	0	0
6	36456243	rs584196	G	C	91	109	200	0	0	200	0	0
6	36458038	rs146829680	G	A	122	113	235	0	2	237	0	0
6	36466366	.	C	T	7	18	25	0	0	25	0	0
6	36466787	rs4713978	C	A	26	24	50	0	2	52	0	0
6	36467791	rs659726	C	G	10	6	16	0	0	16	0	0
6	36469121	rs632943	A	G	13	4	17	0	1	18	0	0
6	36472259	rs621796	A	T	5	2	7	0	1	8	0	0
6	36472492	rs77171963	A	G	4	2	6	0	0	6	0	0
6	36473320	rs77808456	C	T	3	8	11	0	0	11	0	0
6	36484252	rs614028	G	A	3	4	7	0	0	7	0	0
6	36515040	rs45524837	G	C	17	22	39	0	0	39	0	0
6	36645696	rs2395655	A	G	7	1	8	0	0	8	0	0
6	36651971	rs1801270	C	A	81	69	150	0	3	153	0	0
6	36653597	rs1059234	C	T	71	64	135	0	1	136	0	0
6	36686272	rs236487	C	T	39	29	68	0	0	68	0	0
6	36686407	rs236486	C	T	3	3	6	0	0	6	0	0
6	36687301	rs236484	A	T	49	33	82	0	1	83	0	0
6	36687518	rs236483	T	C	54	51	105	0	1	107	1	0
6	36687592	rs236482	A	G	38	50	88	0	0	88	0	0
6	36687809	rs236481	A	G	37	33	70	0	3	73	0	0
6	36688006	rs236480	A	C	35	29	64	0	1	65	0	0
6	36688729	rs129546	T	C	15	8	23	0	0	23	0	0
6	36689030	rs236478	A	C	52	49	101	0	6	108	1	0
6	36689630	rs236477	C	T	75	70	145	0	1	146	0	0
6	36708989	rs10947627	A	G	4	2	6	0	0	6	0	0
6	36824399	rs2071823	C	T	8	7	15	0	0	15	0	0
6	36894677	rs1632649	T	C	5	5	10	0	0	10	0	0
6	36896437	rs8472	T	G	30	39	69	0	1	70	0	0
6	36936483	rs11548580	C	T	608	601	1209	0	3	1212	0	0
6	36936697	rs11548576	T	C	715	734	1449	0	7	1456	0	0
6	36936771	rs7772210	A	G	237	220	457	0	5	462	0	0
6	36937086	rs114538865	T	G	430	424	854	0	6	860	0	0
6	36937640	rs62622382	C	T	206	162	368	0	2	370	0	0
6	36937682	rs41272204	C	G	172	152	324	0	5	330	1	0
6	36938968	rs115183512	C	G	14	16	30	0	0	30	0	0
6	36939363	rs3778025	C	T	22	14	36	0	0	36	0	0
6	36939528	rs9462250	C	G	16	12	28	0	0	28	0	0
6	36940259	rs34385946	C	T	15	10	25	0	1	26	0	0
6	36940273	rs6918432	G	A	17	12	29	0	0	29	0	0
6	36940343	rs2293383	G	C	12	13	25	0	0	25	0	0
6	36940805	rs831506	T	C	9	8	17	0	0	17	0	0
6	36943531	rs17554163	G	A	4	3	7	0	0	7	0	0
6	36943575	rs115240884	C	T	4	2	6	0	0	6	0	0
6	36945537	rs41272206	T	C	76	96	172	0	1	173	0	0
6	36948805	rs3778021	A	G	5	17	22	0	0	22	0	0
6	37013127	rs2692879	G	A	0	12	12	0	0	12	0	0
6	37299648	rs45606431	G	A	66	46	112	0	1	113	0	0
6	37338969	rs963835	G	C	11	11	22	0	0	22	0	0
6	37339017	rs761737	A	G	10	10	20	0	0	20	0	0
6	37349033	rs2284922	G	A	14	41	55	0	0	55	0	0
6	37358022	rs195432	A	C	9	10	19	0	0	19	0	0
6	37444399	rs77513786	A	C	11	17	28	0	0	28	0	0
6	37445079	rs10947673	C	T	15	7	22	0	0	22	0	0
6	37446163	rs71569377	C	T	3	3	6	0	0	6	0	0
6	37447075	rs2797790	G	A	4	3	7	0	0	7	0	0
6	37450803	rs13216875	C	G	4	5	9	0	0	9	0	0
6	37450914	rs10692	T	C	9	7	16	0	0	16	0	0
6	38121762	rs78437801	C	T	159	131	290	0	3	293	0	0
6	38136784	rs877527	T	C	7	3	10	0	0	10	0	0
6	38138333	rs2092426	G	A	13	15	28	0	0	28	0	0
6	38138378	rs742539	G	A	9	14	23	0	0	23	0	0
6	38139482	rs13198420	T	C	13	14	27	0	0	27	0	0
6	38139500	rs13212638	A	G	13	12	25	0	0	25	0	0
6	38139748	rs12206712	T	C	5	2	7	0	0	7	0	0
6	38139938	rs9470806	G	A	12	10	22	0	0	22	0	0
6	38139945	rs9470807	A	G	12	8	20	0	0	20	0	0
6	38140503	rs737170	C	T	3	8	11	0	0	11	0	0
6	38140505	rs737171	A	G	2	8	10	0	0	10	0	0
6	38140658	rs909998	C	T	5	4	9	0	0	9	0	0
6	38140755	rs761153	C	G	8	9	17	0	0	17	0	0
6	38141022	rs735117	G	A	2	4	6	0	0	6	0	0
6	38142004	rs3800358	G	T	5	4	9	0	0	9	0	0
6	39072334	rs41273118	T	A	12	6	18	0	0	18	0	0
6	39072681	rs7696	A	G	6	1	7	0	0	7	0	0
6	39078235	rs61737200	G	A	2	5	7	0	0	7	0	0
6	39157781	rs6912288	A	C	25	21	46	0	0	46	0	0
6	39158045	rs114864747	C	T	19	8	27	0	1	28	0	0
6	39158301	rs3734615	A	G	13	4	17	0	0	17	0	0
6	39158339	rs4714222	A	G	10	4	14	0	0	14	0	0
6	39158514	rs3734616	A	G	12	8	20	0	0	20	0	0
6	39267753	rs1535496	T	A	6	2	8	0	0	8	0	0
6	39267754	rs1535497	C	T	6	2	8	0	0	8	0	0
6	39267791	rs147634594	G	A	3	4	7	0	0	7	0	0
6	39272866	rs12195376	C	T	4	2	6	0	0	6	0	0
6	39278794	rs72855550	G	C	4	6	10	0	0	11	1	0
6	39279136	rs151078165	G	A	8	5	13	0	0	13	0	0
6	41034000	rs114812713	G	C	19	16	35	0	2	37	0	0
6	41197857	rs7769759	C	T	5	1	6	0	0	6	0	0
6	41204329	rs9349186	A	T	5	1	6	0	0	6	0	0
6	41204805	rs13200807	G	A	6	3	9	0	0	9	0	0
6	41205157	rs13204001	C	G	7	0	7	0	0	7	0	0
6	41205179	rs12195623	C	A	0	7	7	0	0	7	0	0
6	41205235	rs13204353	G	A	6	0	6	0	0	6	0	0
6	41205690	rs9296359	G	A	8	0	8	0	0	8	0	0
6	41235879	rs1471743	A	G	6	9	15	0	0	15	0	0
6	41235919	rs1471742	G	C	9	8	17	0	0	17	0	0
6	41236513	rs9369269	A	C	4	9	13	0	0	13	0	0
6	41236774	rs12197877	G	T	3	7	10	0	0	10	0	0
6	41242972	rs6914090	T	C	28	11	39	0	1	40	0	0
6	41243516	rs12200981	G	A	31	30	61	0	0	61	0	0
6	41243581	rs12201045	G	A	29	28	57	0	0	57	0	0
6	41243740	rs2234246	C	T	31	21	52	0	0	52	0	0
6	41244404	rs1817538	G	A	7	1	8	0	0	8	0	0
6	41244567	rs1817537	C	G	4	4	8	0	0	8	0	0
6	41245172	rs3804277	C	T	4	2	6	0	0	6	0	0
6	41246473	rs4711668	T	C	4	2	6	0	0	6	0	0
6	41247764	rs6940092	T	C	3	4	7	0	1	8	0	0
6	41652136	rs14063	G	A	12	20	32	0	1	33	0	0
6	41652514	rs2073158	C	T	13	11	24	0	0	24	0	0
6	41873466	.	T	C	17	22	39	0	0	39	0	0
6	41994015	rs181284761	C	T	3	3	6	0	0	6	0	0
6	42016319	rs11552783	G	A	34	54	88	0	1	89	0	0
6	42018883	rs11967378	G	T	9	2	11	0	0	11	0	0
6	42032181	rs62415894	C	A	3	6	9	0	0	9	0	0
6	42032652	rs9471747	G	A	4	2	6	0	1	7	0	0
6	42039551	rs66489927	C	T	4	2	6	0	0	6	0	0
6	42045364	rs73735020	G	A	18	28	46	0	0	46	0	0
6	42047994	rs6906808	G	T	52	47	99	0	1	100	0	0
6	42048690	rs7745547	A	G	5	13	18	0	0	18	0	0
6	42049183	rs4711705	C	T	8	6	14	0	0	14	0	0
6	42049535	rs4711706	C	T	9	5	14	0	0	14	0	0
6	42049598	rs6936467	T	G	5	6	11	0	0	11	0	0
6	42049900	rs6918636	G	C	14	11	25	0	0	25	0	0
6	42050170	rs6919008	G	A	10	10	20	0	0	20	0	0
6	42050359	rs9381134	G	C	13	15	28	0	3	31	0	0
6	42050823	rs9381135	C	T	11	20	31	0	0	31	0	0
6	42050997	rs6904481	T	C	2	8	10	0	0	10	0	0
6	42051093	rs6925028	G	T	5	4	9	0	0	9	0	0
6	42052691	rs9471754	C	G	3	4	7	0	0	7	0	0
6	42052751	rs16895221	G	A	7	7	14	0	0	14	0	0
6	42052817	rs73735023	G	T	6	7	13	0	0	13	0	0
6	42053778	rs2492935	G	A	5	5	10	0	0	10	0	0
6	42053804	rs56340838	A	C	8	6	14	0	0	14	0	0
6	42054346	rs2492937	G	A	5	8	13	0	0	13	0	0
6	42054380	rs2492938	G	T	6	11	17	0	0	17	0	0
6	42054832	rs12524651	A	G	8	8	16	0	0	16	0	0
6	42082595	rs143864504	T	C	2	4	6	0	0	6	0	0
6	42152333	rs3749920	T	C	15	13	28	0	0	28	0	0
6	42156659	rs111771592	C	A	6	0	6	0	0	6	0	0
6	42156675	rs56183417	G	A	6	0	6	0	1	7	0	0
6	42156676	rs59908960	A	T	7	0	7	0	0	7	0	0
6	42156924	rs56402927	C	A	5	10	15	0	0	15	0	0
6	42157693	rs7746021	T	C	1	5	6	0	0	6	0	0
6	42157817	rs7764278	G	T	3	5	8	0	0	8	0	0
6	42159497	rs13219565	G	A	3	9	12	0	0	12	0	0
6	42161292	rs9381153	T	C	1	7	8	0	0	8	0	0
6	42162575	rs1474867	A	G	0	6	6	0	0	6	0	0
6	42174558	rs4714580	A	G	26	21	47	0	0	47	0	0
6	42175405	rs34526507	A	C	27	51	78	0	0	78	0	0
6	42184003	rs56198496	G	C	1	5	6	0	0	6	0	0
6	42185564	rs9471809	A	C	13	14	27	0	0	27	0	0
6	42194286	rs60843126	C	T	21	18	39	0	0	39	0	0
6	42194636	rs146368985	C	T	23	13	36	0	0	36	0	0
6	42194666	rs35801097	T	A	17	11	28	0	0	28	0	0
6	42219591	rs9349227	A	T	3	3	6	0	0	6	0	0
6	42532102	rs3749897	C	T	109	129	238	0	3	241	0	0
6	42541802	rs16895843	G	C	36	19	55	0	1	56	0	0
6	42571346	rs16895863	A	T	13	9	22	0	1	23	0	0
6	42630579	rs761538	A	G	4	8	12	0	1	13	0	0
6	42660822	rs373413	G	C	19	33	52	0	0	52	0	0
6	42751374	rs3800290	G	T	3	5	8	0	0	8	0	0
6	42751457	rs3800291	C	T	7	4	11	0	0	11	0	0
6	42751778	rs13198778	C	T	8	7	15	0	0	15	0	0
6	42752624	rs4714626	C	T	5	4	9	0	0	9	0	0
6	42753205	rs2395924	G	A	4	2	6	0	0	6	0	0
6	42754029	rs4711727	G	A	4	2	6	0	0	6	0	0
6	42754525	rs9394925	T	C	6	6	12	0	0	12	0	0
6	42756170	rs6908434	G	A	5	4	9	0	0	9	0	0
6	42756442	rs4236083	G	A	5	6	11	0	0	11	0	0
6	42756472	rs3997653	A	G	5	9	14	0	0	14	0	0
6	42756974	rs9471917	A	G	4	3	7	0	0	7	0	0
6	42758850	rs3737097	T	C	22	29	51	0	0	51	0	0
6	42823638	.	G	A	2	4	6	0	0	6	0	0
6	42855945	rs552431809	C	T	46	30	76	0	1	77	0	0
6	42897074	rs2234185	T	C	5	2	7	0	0	7	0	0
6	42897712	rs4711731	C	T	6	2	8	0	0	8	0	0
6	42901120	rs4714634	G	A	10	4	14	0	0	14	0	0
6	42902508	rs3763236	T	C	5	8	13	0	0	13	0	0
6	42903763	rs1053538	C	G	72	93	165	0	0	165	0	0
6	42903766	rs1053539	T	G	72	88	160	0	1	161	0	0
6	42904274	rs6458312	G	T	4	3	7	0	0	7	0	0
6	42905235	rs9471968	A	G	5	9	14	0	0	14	0	0
6	42906384	rs9471969	G	T	261	282	543	0	1	545	1	0
6	42910666	rs9462853	T	C	34	23	57	0	1	58	0	0
6	42912589	rs6927188	A	G	3	4	7	0	0	7	0	0
6	42914041	rs7744454	C	G	4	2	6	0	1	7	0	0
6	42915403	rs7770760	T	C	9	14	23	0	0	23	0	0
6	42924193	rs13215983	C	T	14	0	14	0	1	15	0	0
6	42924247	rs13216214	G	A	50	0	50	0	1	51	0	0
6	42924424	rs4714640	G	T	59	3	62	0	3	65	0	0
6	42924427	rs145400085	A	C	58	3	61	0	2	63	0	0
6	42929533	rs9471978	T	C	3	4	7	0	0	7	0	0
6	42932200	rs1129187	G	T	11	25	36	0	0	36	0	0
6	42932202	rs1129186	C	T	10	24	34	0	2	36	0	0
6	42932715	rs2274517	C	T	7	5	12	0	0	12	0	0
6	42934500	rs2274514	C	T	3	11	14	0	0	14	0	0
6	42934620	rs3818554	C	T	5	13	18	0	0	18	0	0
6	42934818	rs4714644	T	C	3	3	6	0	0	6	0	0
6	42935998	rs9471982	G	A	5	4	9	0	0	9	0	0
6	42936900	rs3805953	C	T	8	19	27	0	0	27	0	0
6	42937126	rs3805952	C	T	10	12	22	0	0	22	0	0
6	42937176	rs3805951	C	A	17	16	33	0	1	34	0	0
6	42938377	rs3293	G	T	6	10	16	0	0	16	0	0
6	42944773	rs9471988	T	C	33	23	56	0	2	58	0	0
6	42944850	rs6907751	C	T	18	19	37	0	0	37	0	0
6	43109751	rs6905948	G	A	37	36	73	0	1	74	0	0
6	43111445	rs3737185	T	C	1	11	12	0	0	12	0	0
6	43129333	rs56739823	G	A	7	5	12	0	1	13	0	0
6	43307861	rs10948072	G	A	11	9	20	0	0	20	0	0
6	43322231	rs12190755	A	G	7	12	19	0	0	19	0	0
6	43473025	rs147994267	G	A	74	98	172	0	2	174	0	0
6	43488362	.	G	A	11	7	18	0	0	18	0	0
6	44081718	rs6883	G	A	87	70	157	0	2	159	0	0
6	44093742	rs1935611	C	T	23	10	33	0	0	33	0	0
6	44094305	rs4714750	A	T	3	7	10	0	0	10	0	0
6	44104395	rs7756198	T	C	3	3	6	0	0	6	0	0
6	44115169	rs4714759	G	A	11	11	22	0	0	22	0	0
6	44117664	rs4714762	C	T	24	18	42	0	1	43	0	0
6	44118612	rs3734694	T	C	5	3	8	0	0	8	0	0
6	44118911	rs6911630	A	G	3	4	7	0	0	7	0	0
6	44119145	rs6934989	T	C	5	6	11	0	0	11	0	0
6	44119338	rs3734695	C	T	5	5	10	0	0	10	0	0
6	44119676	rs3734697	A	G	7	7	14	0	0	14	0	0
6	44121214	rs3813503	A	T	11	12	23	0	0	23	0	0
6	44121216	rs3813502	T	C	11	12	23	0	0	23	0	0
6	44121270	rs1041523	C	T	13	13	26	0	0	26	0	0
6	44151490	rs7761137	G	A	12	4	16	0	0	16	0	0
6	44151765	rs13209117	G	A	6	6	12	0	0	12	0	0
6	44200325	rs1128930	A	C	2	7	9	0	0	9	0	0
6	44215784	rs34124063	A	T	7	6	13	0	0	13	0	0
6	44215785	rs34789835	G	C	8	6	14	0	0	14	0	0
6	44215786	rs34451930	A	G	8	6	14	0	0	14	0	0
6	44218120	rs13296	A	G	1007	1064	2071	0	31	2102	0	0
6	44220295	rs35318214	C	T	7	4	11	0	0	11	0	0
6	44220514	rs36093082	G	C	7	11	18	0	0	18	0	0
6	44246766	rs12943	C	T	6	8	14	0	0	14	0	0
6	44250165	rs516582	A	G	5	5	10	0	0	10	0	0
6	44251045	rs4714774	C	A	5	5	10	0	0	10	0	0
6	44252253	rs12664825	C	T	5	6	11	0	0	11	0	0
6	44255459	rs324146	G	A	2	4	6	0	0	6	0	0
6	44266984	rs1123523	G	A	19	21	40	0	0	40	0	0
6	44269193	rs498512	C	T	15	7	22	0	0	22	0	0
6	44777204	rs7765371	G	A	11	4	15	0	0	15	0	0
6	45481266	rs58268689	G	A	21	12	33	0	0	33	0	0
6	45511945	rs13201287	G	A	6	5	11	0	0	11	0	0
6	45529643	rs13199389	G	A	5	3	8	0	0	8	0	0
6	46620252	rs12192544	C	G	4	12	16	0	0	16	0	0
6	46625635	rs10807344	C	T	2	13	15	0	0	15	0	0
6	46625886	rs6907892	C	T	3	6	9	0	0	9	0	0
6	46626353	rs953062	A	G	3	15	18	0	1	19	0	0
6	46644875	rs2270450	C	T	3	11	14	0	0	14	0	0
6	47277569	rs6458555	G	A	5	5	10	0	0	10	0	0
6	49398115	rs9381784	C	T	9	1	10	0	0	10	0	0
6	49403282	rs8589	T	C	57	67	124	0	1	125	0	0
6	49412433	rs1141321	C	T	23	44	67	0	2	69	0	0
6	49419864	rs6923124	A	G	3	5	8	0	0	8	0	0
6	49420206	rs6908203	T	C	4	4	8	0	0	8	0	0
6	49420248	rs62411930	A	G	5	4	9	0	0	9	0	0
6	49425521	rs2229384	C	T	13	17	30	0	1	31	0	0
6	49439805	rs4267943	G	A	7	4	11	0	0	11	0	0
6	49442694	rs62411932	C	T	2	4	6	0	0	6	0	0
6	49443027	rs12212022	A	G	6	4	10	0	0	10	0	0
6	49518599	rs45551532	T	C	0	6	6	0	0	6	0	0
6	49519169	rs41273692	T	C	4	9	13	0	0	13	0	0
6	49519279	rs41273694	G	C	5	7	12	0	0	12	0	0
6	49519840	rs7758141	G	A	8	16	24	0	0	24	0	0
6	49520083	rs7761928	C	A	3	11	14	0	0	14	0	0
6	49522688	rs6939457	C	T	32	14	46	0	0	46	0	0
6	49522724	rs6939453	A	G	36	10	46	0	0	46	0	0
6	49696473	rs488132	G	T	16	23	39	0	1	40	0	0
6	49701523	rs495335	A	G	14	23	37	0	0	37	0	0
6	52129484	rs2230240	C	T	146	136	282	0	0	282	0	0
6	52131254	rs10807441	C	T	8	7	15	0	0	15	0	0
6	52357071	rs17851770	A	C	13	15	28	0	0	28	0	0
6	52362637	rs3804498	G	A	39	41	80	0	0	80	0	0
6	52363615	rs62407914	G	A	20	11	31	0	0	31	0	0
6	52363759	rs62407915	A	G	12	12	24	0	0	24	0	0
6	52363849	rs2073181	C	G	18	18	36	0	0	36	0	0
6	52365317	rs9395798	T	G	5	9	14	0	0	14	0	0
6	52365331	rs557879933	T	G	11	2	13	0	0	13	0	0
6	52365336	rs73740390	T	G	10	4	14	0	0	14	0	0
6	52365499	rs145502128	C	T	11	14	25	0	0	25	0	0
6	52365873	rs2073182	A	G	18	16	34	0	0	34	0	0
6	52366653	rs41273742	C	T	7	8	15	0	0	15	0	0
6	52366762	rs2073183	G	A	9	11	20	0	0	20	0	0
6	52366796	rs9370127	G	A	13	9	22	0	1	23	0	0
6	52367235	rs1064217	G	A	13	5	18	0	0	18	0	0
6	52367897	rs41273846	G	A	6	10	16	0	1	17	0	0
6	52380641	rs941968	C	T	4	3	7	0	0	7	0	0
6	52443067	rs9474251	G	A	23	23	46	0	0	46	0	0
6	52546620	rs35319285	C	T	4	5	9	0	0	9	0	0
6	52868953	rs147397393	G	C	8	8	16	0	0	16	0	0
6	53137581	rs209533	A	G	9	6	15	0	0	15	0	0
6	53141952	rs146352718	A	C	6	5	11	0	0	11	0	0
6	53171184	.	G	A	3	4	7	0	1	8	0	0
6	53174448	rs209485	T	C	4	4	8	0	0	8	0	0
6	53175237	rs209486	T	C	5	1	6	0	0	6	0	0
6	53195627	rs209509	T	C	5	6	11	0	0	11	0	0
6	53379517	rs17884046	C	A	3	4	7	0	0	7	0	0
6	53380140	rs17885403	T	C	3	4	7	0	0	7	0	0
6	53382260	rs512827	A	T	5	1	6	0	0	6	0	0
6	53749074	rs4265034	G	C	1	5	6	0	0	6	0	0
6	53787572	.	G	A	7	4	11	0	0	11	0	0
6	54074945	.	G	T	0	6	6	0	0	6	0	0
6	54074949	.	C	T	6	0	6	0	0	6	0	0
6	56348118	rs9382635	C	G	7	5	12	0	0	12	0	0
6	56348730	rs721475	C	T	3	4	7	0	0	7	0	0
6	57020233	rs11755664	G	A	2	4	6	0	0	6	0	0
6	57204495	rs138276296	A	C	4	3	7	0	0	7	0	0
6	57393112	.	T	C	0	15	15	0	0	15	0	0
6	57393125	.	A	G	0	18	18	0	0	18	0	0
6	57430560	.	G	A	0	7	7	0	0	7	0	0
6	57430616	.	C	T	0	7	7	0	0	7	0	0
6	57453330	.	A	G	0	12	12	0	0	12	0	0
6	57467100	.	G	C	0	15	15	0	0	15	0	0
6	57467175	.	A	G	0	19	19	0	1	20	0	0
6	64292153	rs1062193	A	G	129	121	250	0	4	254	0	0
6	64293010	rs16894460	G	A	271	256	527	0	2	529	0	0
6	64398899	rs68128834	G	A	2	4	6	0	0	6	0	0
6	64416991	rs2295184	T	G	4	4	8	0	0	8	0	0
6	64424525	rs61606312	G	A	6	6	12	0	0	12	0	0
6	64425146	.	C	G	10	1	11	0	0	11	0	0
6	64426894	rs4710437	A	G	3	3	6	0	0	6	0	0
6	64427095	rs1057530	C	T	2	6	8	0	0	8	0	0
6	64427928	rs66481681	T	C	9	9	18	0	0	18	0	0
6	68597665	rs12195943	T	C	4	5	9	0	0	9	0	0
6	70385989	.	A	G	60	45	105	0	0	105	0	0
6	70452801	rs147439743	T	C	2	5	7	0	0	7	0	0
6	71236216	rs7740873	C	T	15	14	29	0	0	29	0	0
6	71247385	rs2207423	A	G	5	1	6	0	0	6	0	0
6	71269459	rs16869371	C	T	5	9	14	0	0	14	0	0
6	71269632	rs16869373	G	A	2	4	6	0	0	6	0	0
6	71280594	rs7757026	T	A	7	7	14	0	0	14	0	0
6	71289189	rs1048886	A	G	5	2	7	0	0	7	0	0
6	71570641	rs9680	A	G	45	33	78	0	0	78	0	0
6	73111910	rs73750480	T	C	1	5	6	0	0	6	0	0
6	73984720	rs10943088	T	C	4	2	6	0	0	6	0	0
6	74019338	rs16883571	G	A	11	4	15	0	0	15	0	0
6	74019376	rs16883573	T	C	13	4	17	0	0	17	0	0
6	74079024	rs496530	A	G	9	5	14	0	0	14	0	0
6	74125875	rs311686	A	G	0	20	20	0	0	20	0	0
6	74125888	rs311685	A	G	0	18	18	0	0	18	0	0
6	74126941	rs311683	G	A	3	14	17	0	0	17	0	0
6	74128119	rs311682	G	T	7	2	9	0	0	9	0	0
6	74133712	rs4032696	T	A	28	25	53	0	0	53	0	0
6	74133986	rs3959830	T	A	69	63	132	0	1	133	0	0
6	74134079	rs71573596	C	A	49	64	113	0	0	113	0	0
6	74134199	rs311680	C	T	27	41	68	0	4	72	0	0
6	74134849	rs311679	T	C	47	60	107	0	1	108	0	0
6	74135016	rs311678	C	T	57	40	97	0	0	97	0	0
6	74155346	rs610913	G	T	55	41	96	0	0	96	0	0
6	74161503	rs9446904	A	G	16	9	25	0	0	25	0	0
6	74161604	rs141133909	C	T	7	5	12	0	0	12	0	0
6	74161801	rs9352000	G	T	41	17	58	0	0	58	0	0
6	74161855	rs147035222	G	C	29	43	72	0	0	72	0	0
6	74216201	rs4257823	G	A	8	2	10	0	0	10	0	0
6	74226245	rs1128073	G	T	102	76	178	0	4	182	0	0
6	74226318	rs1390082	T	A	75	53	128	0	1	129	0	0
6	74226865	rs13193159	A	T	68	63	131	0	0	133	2	0
6	74228006	rs1874229	A	G	89	86	175	0	2	177	0	0
6	74228049	rs1874230	A	G	83	78	161	0	2	163	0	0
6	74229258	rs2073466	G	T	17	14	31	0	0	31	0	0
6	74229405	rs4708060	C	A	17	16	33	0	0	33	0	0
6	74230528	rs2291719	A	G	141	158	299	0	7	306	0	0
6	74303829	rs670248	C	T	16	32	48	0	0	48	0	0
6	74319303	rs1691341	A	G	4	2	6	0	0	6	0	0
6	74319334	rs1741894	G	A	5	1	6	0	0	6	0	0
6	74326666	rs1741889	T	A	2	5	7	0	0	7	0	0
6	74326754	rs1691350	C	A	7	6	13	0	0	13	0	0
6	74326960	rs656748	A	G	7	2	9	0	1	10	0	0
6	74326991	rs560386	A	G	6	5	11	0	0	11	0	0
6	74327075	rs657212	C	T	5	3	8	0	0	8	0	0
6	74332493	rs625512	T	C	6	5	11	0	0	11	0	0
6	74354175	rs472294	C	T	45	59	104	0	2	106	0	0
6	74424069	rs9293937	G	A	3	3	6	0	0	6	0	0
6	74432427	rs28360541	T	G	4	4	8	0	0	8	0	0
6	74432636	rs9442951	C	T	3	5	8	0	0	8	0	0
6	75994151	rs240374	A	G	40	51	91	0	1	92	0	0
6	79577796	rs9341753	C	T	5	1	6	0	1	7	0	0
6	79595097	rs6908105	A	G	6	3	9	0	0	9	0	0
6	79610356	rs2135771	T	C	6	2	8	0	0	8	0	0
6	79642581	rs9343853	T	C	4	6	10	0	0	10	0	0
6	79656562	rs2275291	A	T	51	41	92	0	0	92	0	0
6	79656570	rs2275290	G	A	52	40	92	0	0	92	0	0
6	79667170	.	T	C	5	1	6	0	0	6	0	0
6	79675701	rs9350797	A	G	40	39	79	0	1	80	0	0
6	79692751	rs11547228	G	A	41	35	76	0	1	77	0	0
6	79717326	rs67073459	T	C	5	5	10	0	0	10	0	0
6	79720120	rs72902902	T	A	4	4	8	0	0	8	0	0
6	79786639	rs74839403	A	G	9	10	19	0	0	19	0	0
6	79786645	rs3812161	A	C	10	11	21	0	0	21	0	0
6	79911935	rs79282883	T	C	68	87	155	0	2	157	0	0
6	79912189	rs2236543	A	G	15	10	25	0	0	25	0	0
6	79914733	rs10943623	G	A	8	3	11	0	2	13	0	0
6	79915334	rs12208546	A	G	9	10	19	0	0	19	0	0
6	79922278	rs9343884	C	A	3	4	7	0	0	7	0	0
6	79923868	rs9343885	A	T	4	3	7	0	0	7	0	0
6	80196848	rs1875845	C	T	7	3	10	0	0	10	0	0
6	80228535	rs34068461	T	G	3	3	6	0	0	6	0	0
6	80715838	rs240226	T	G	7	0	7	0	0	7	0	0
6	80741243	rs1801465	A	T	19	21	40	0	0	40	0	0
6	80749972	rs1801460	A	C	53	36	89	0	0	89	0	0
6	80751942	rs17254634	G	A	52	29	81	0	0	81	0	0
6	80752094	rs17176133	C	T	20	12	32	0	0	32	0	0
6	82454909	.	C	T	23	11	34	0	2	36	0	0
6	82455072	rs7745467	T	C	12	31	43	0	0	44	1	0
6	82456051	rs12207462	T	C	267	246	513	0	6	519	0	0
6	82457147	rs194607	C	G	334	403	737	0	3	740	0	0
6	82458639	rs7742628	G	T	127	132	259	0	3	262	0	0
6	82461520	rs3186631	A	G	38	39	77	0	0	77	0	0
6	82880833	rs991781	T	C	5	10	15	0	0	15	0	0
6	82887284	rs6902282	C	T	5	4	9	0	0	9	0	0
6	82887292	rs12190543	C	T	4	5	9	0	0	9	0	0
6	82887693	rs6903061	C	A	3	5	8	0	0	8	0	0
6	82888978	rs181617274	T	C	3	4	7	0	0	7	0	0
6	82890520	rs9449442	A	G	7	1	8	0	0	8	0	0
6	82890570	rs9449443	T	C	6	2	8	0	0	8	0	0
6	82900811	rs9449444	G	A	22	14	36	0	0	36	0	0
6	82933309	rs9361904	C	T	5	4	9	0	0	9	0	0
6	83075914	rs700494	G	A	3	7	10	0	0	10	0	0
6	83875292	rs1813511	T	C	9	1	10	0	0	10	0	0
6	83880167	rs473267	C	T	11	7	18	0	1	19	0	0
6	83881740	rs542948	T	C	8	3	11	0	0	11	0	0
6	84704414	rs9353162	C	A	6	5	11	0	0	11	0	0
6	86221321	rs80162125	A	G	6	6	12	0	0	12	0	0
6	86221586	rs9450288	A	T	4	3	7	0	0	7	0	0
6	86221771	rs6911143	C	T	8	6	14	0	2	16	0	0
6	86223316	rs12203963	T	C	4	4	8	0	0	8	0	0
6	86240147	rs4640862	G	A	3	7	10	0	0	10	0	0
6	86302034	rs2842611	A	G	4	4	8	0	0	8	0	0
6	86302734	rs117561058	A	T	3	3	6	0	0	6	0	0
6	86331887	rs2842602	C	T	1	5	6	0	0	6	0	0
6	86333029	rs12205013	C	T	6	1	7	0	0	7	0	0
6	86387888	rs1059307	G	T	775	1547	2322	0	6	2329	1	0
6	86388109	rs1059306	G	C	300	372	672	0	3	675	0	0
6	86388223	rs3087978	C	T	230	264	494	0	5	499	0	0
6	87932948	rs7752882	A	G	14	8	22	0	0	22	0	0
6	87933239	rs9353464	C	G	10	11	21	0	0	21	0	0
6	87937326	rs9450638	C	T	3	6	9	0	0	9	0	0
6	87939964	rs9444484	A	G	5	10	15	0	0	15	0	0
6	87941101	rs6932641	C	T	9	10	19	0	0	19	0	0
6	87941419	rs6933046	A	G	7	8	15	0	0	15	0	0
6	87942028	rs9450639	C	T	8	6	14	0	0	14	0	0
6	87948572	rs9344694	A	G	5	1	6	0	0	6	0	0
6	87948723	rs9362413	C	G	6	2	8	0	0	8	0	0
6	87949639	rs9359740	A	G	3	3	6	0	0	6	0	0
6	87951272	rs7755244	A	G	5	2	7	0	0	7	0	0
6	87951784	rs3846773	C	T	3	3	6	0	0	6	0	0
6	87951932	rs3846774	G	C	6	6	12	0	0	12	0	0
6	87965528	rs6908834	T	C	27	19	46	0	0	46	0	0
6	87968565	rs9362415	A	G	46	34	80	0	1	81	0	0
6	87969480	rs6910541	G	A	100	90	190	0	4	194	0	0
6	87969737	rs3734187	C	T	110	109	219	0	2	221	0	0
6	87970301	rs3812132	C	G	127	127	254	0	1	255	0	0
6	87973627	rs9353468	A	G	41	65	106	0	3	109	0	0
6	88000581	rs6940544	G	A	2	5	7	0	0	7	0	0
6	88000766	rs9294376	G	A	3	4	7	0	0	7	0	0
6	88051052	rs397516	T	C	2	8	10	0	0	10	0	0
6	88051262	rs398140	T	C	3	7	10	0	0	10	0	0
6	88183043	rs58785365	G	C	7	3	10	0	0	10	0	0
6	88224164	rs8802	T	C	91	44	135	0	1	136	0	0
6	88225698	rs7753275	T	C	6	9	15	0	0	15	0	0
6	88230732	rs910267	G	A	4	3	7	0	0	7	0	0
6	88241377	rs56386021	T	C	0	7	7	0	0	7	0	0
6	88287828	rs4132446	C	A	5	1	6	0	0	6	0	0
6	88287834	.	C	G	1	5	6	0	0	6	0	0
6	88406656	rs4707386	G	A	10	3	13	0	0	13	0	0
6	88411768	rs9474	A	G	119	127	246	0	1	247	0	0
6	88411890	rs1052623	A	G	136	132	268	0	1	269	0	0
6	89857120	rs9451167	G	A	3	5	8	0	0	8	0	0
6	89858851	rs6926895	G	A	1	5	6	0	0	6	0	0
6	89872499	rs9359842	G	T	23	28	51	0	0	51	0	0
6	89872976	rs2150820	C	T	35	27	62	0	2	64	0	0
6	89873055	rs6927416	T	A	24	11	35	0	0	35	0	0
6	89873182	rs6454741	T	C	27	20	47	0	0	47	0	0
6	89874656	.	A	G	53	32	85	0	7	92	0	0
6	89874857	rs1048641	T	G	21	15	36	0	4	40	0	0
6	90036511	rs13215418	C	T	89	49	138	0	0	138	0	0
6	90037968	rs6552	T	G	93	89	182	0	1	183	0	0
6	90039670	rs10502	G	C	639	591	1230	0	4	1235	1	0
6	90040348	.	A	G	4	4	8	0	0	8	0	0
6	90075359	rs1062108	A	G	31	16	47	0	0	47	0	0
6	90076993	rs2274087	G	T	8	12	20	0	0	20	0	0
6	90079214	rs1321821	C	T	9	6	15	0	0	15	0	0
6	90080167	.	C	T	3	4	7	0	0	7	0	0
6	90080928	rs13212185	C	G	5	9	14	0	0	14	0	0
6	90091447	rs74898979	G	C	3	3	6	0	0	6	0	0
6	90344869	rs6905628	C	G	12	1	13	0	0	13	0	0
6	90345536	rs11754238	T	C	6	8	14	0	0	14	0	0
6	90345698	rs67506370	C	G	5	7	12	0	0	12	0	0
6	90347511	rs34012596	T	C	60	59	119	0	1	120	0	0
6	90371202	rs9444701	G	A	49	46	95	0	0	95	0	0
6	90402840	rs9351212	C	A	30	27	57	0	0	57	0	0
6	90418262	rs2026634	C	T	22	16	38	0	0	38	0	0
6	90418331	rs55729223	A	G	13	21	34	0	0	34	0	0
6	90436507	rs2768939	C	T	6	5	11	0	0	11	0	0
6	90436943	rs2768938	A	G	10	10	20	0	0	20	0	0
6	90437164	rs2768937	A	G	12	13	25	0	0	25	0	0
6	90448092	rs4140446	C	T	3	5	8	0	0	8	0	0
6	90486325	rs41402447	T	C	4	2	6	0	0	6	0	0
6	90565242	rs369328	A	G	6	1	7	0	0	7	0	0
6	90577602	rs60966143	C	T	10	12	22	0	1	23	0	0
6	90583601	rs11752373	T	A	9	11	20	0	0	20	0	0
6	90956976	rs576454613	T	C	3	3	6	0	0	6	0	0
6	91223620	rs10894	C	T	6	7	13	0	0	13	0	0
6	91224372	rs9345020	C	T	3	6	9	0	0	9	0	0
6	91225135	rs157705	C	T	4	16	20	0	0	20	0	0
6	91225220	rs157704	G	A	8	12	20	0	0	20	0	0
6	91239123	rs205347	C	T	3	3	6	0	0	6	0	0
6	91295818	rs282068	C	G	25	11	36	0	0	36	0	0
6	91295984	rs282069	G	A	8	1	9	0	0	9	0	0
6	91296420	rs282070	C	G	15	12	27	0	0	27	0	0
6	96969917	rs77958363	C	T	10	8	18	0	0	18	0	0
6	96985311	rs55792562	T	C	41	44	85	0	0	85	0	0
6	96990194	rs9386610	T	G	7	5	12	0	0	12	0	0
6	97002661	rs9784852	C	A	33	11	44	0	0	44	0	0
6	97002776	rs9784785	G	T	46	45	91	0	2	93	0	0
6	97638436	rs2500502	T	C	6	4	10	0	0	10	0	0
6	97677118	rs9481410	G	A	7	13	20	0	0	20	0	0
6	97706849	rs9387200	C	T	11	10	21	0	0	21	0	0
6	97707122	rs9384897	A	G	10	12	22	0	0	22	0	0
6	97707317	rs9384898	T	C	9	4	13	0	1	14	0	0
6	97707917	rs184112622	A	G	7	11	18	0	0	18	0	0
6	97708455	rs9387202	T	C	2	4	6	0	0	6	0	0
6	97708999	rs1133362	C	G	8	5	13	0	0	13	0	0
6	99317443	rs13194064	T	C	7	3	10	0	0	10	0	0
6	99337248	rs2267924	T	C	8	13	21	0	0	21	0	0
6	99847260	rs4144165	G	T	13	11	24	0	0	24	0	0
6	99847586	rs12191620	A	T	24	20	44	0	0	44	0	0
6	99848256	rs1128347	A	T	87	78	165	0	1	166	0	0
6	99850730	rs9389328	C	T	59	82	141	0	0	141	0	0
6	99851977	rs3811072	T	C	18	16	34	0	0	34	0	0
6	99852267	rs11154824	T	C	9	6	15	0	1	16	0	0
6	99856341	rs1135676	A	G	12	11	23	0	1	24	0	0
6	99857773	rs9321534	T	G	13	8	21	0	0	21	0	0
6	99859675	rs9321538	T	G	83	50	133	0	4	138	1	0
6	99863847	rs7769516	G	A	3	3	6	0	0	6	0	0
6	99873534	rs4351270	C	T	6	2	8	0	0	8	0	0
6	99904096	rs35535366	T	G	4	4	8	0	0	8	0	0
6	99994764	rs330808	G	A	3	4	7	0	0	7	0	0
6	99995053	rs170710	C	T	6	9	15	0	0	15	0	0
6	99995344	rs78325533	T	C	4	3	7	0	2	9	0	0
6	100000485	rs330812	A	G	7	2	9	0	0	9	0	0
6	100000890	rs330813	T	C	6	2	8	0	0	8	0	0
6	100001973	rs330814	T	A	3	3	6	0	0	6	0	0
6	100002493	rs330816	A	C	5	1	6	0	0	6	0	0
6	100005775	rs543967	G	A	4	2	6	0	0	6	0	0
6	101094554	rs239239	A	G	3	4	7	0	0	7	0	0
6	101166095	rs41288423	G	A	2	5	7	0	0	7	0	0
6	101291262	rs846773	G	A	3	7	10	0	0	10	0	0
6	101292227	rs846774	G	A	3	3	6	0	0	6	0	0
6	101304829	rs705599	C	T	18	17	35	0	0	35	0	0
6	101305983	rs846793	A	T	4	2	6	0	0	6	0	0
6	101308421	rs11963911	T	C	5	3	8	0	0	8	0	0
6	101308423	rs9377239	T	C	6	3	9	0	0	9	0	0
6	105176528	rs45521835	G	A	15	14	29	0	0	29	0	0
6	105198267	rs7752614	A	G	7	8	15	0	0	15	0	0
6	105726036	rs1051484	C	T	63	75	138	0	1	139	0	0
6	105821449	rs9486069	A	G	27	27	54	0	0	54	0	0
6	106555991	rs3890556	C	T	11	6	17	0	0	17	0	0
6	106967778	rs3747787	T	C	9	3	12	0	0	12	0	0
6	106982263	rs1809321	G	A	3	3	6	0	0	6	0	0
6	106991361	rs61741114	T	C	12	26	38	0	0	38	0	0
6	107003333	rs9486395	G	A	9	6	15	0	0	15	0	0
6	107017338	rs72943042	T	G	24	38	62	0	0	62	0	0
6	107017711	rs41312800	T	C	28	65	93	0	0	93	0	0
6	107103510	rs118029715	G	T	27	24	51	0	0	51	0	0
6	107115832	rs35459512	A	T	3	7	10	0	0	10	0	0
6	107362576	rs113186302	A	G	9	7	16	0	0	16	0	0
6	107386793	rs1060369	C	T	12	12	24	0	0	24	0	0
6	107387317	rs3838673	A	T	12	3	15	0	1	16	0	0
6	108210437	rs9480813	G	A	3	3	6	0	0	6	0	0
6	108258930	rs6568519	T	C	3	3	6	0	0	6	0	0
6	108533609	rs150466788	C	A	2	4	6	0	0	6	0	0
6	108882570	rs11757217	C	T	10	13	23	0	0	23	0	0
6	108888593	rs2253310	C	G	3	8	11	0	0	11	0	0
6	108902139	rs7747393	C	T	4	4	8	0	0	8	0	0
6	108960840	rs9486913	C	G	17	9	26	0	0	26	0	0
6	108996553	rs3778588	T	C	2	5	7	0	0	7	0	0
6	108997435	rs9374040	G	A	4	2	6	0	0	6	0	0
6	108999287	rs1935949	A	G	1	5	6	0	0	6	0	0
6	109000742	rs4946935	A	G	5	5	10	0	0	10	0	0
6	109002042	rs4945816	C	T	103	80	183	0	3	186	0	0
6	109003321	rs4946936	T	C	113	100	213	0	1	214	0	0
6	109003989	rs9400241	C	A	167	147	314	0	3	317	0	0
6	109005588	rs1062034	A	G	239	237	476	0	5	481	0	0
6	109688114	rs7372	A	G	297	417	714	0	4	718	0	0
6	109688538	rs8465	A	C	55	83	138	0	6	144	0	0
6	109688731	rs699700	C	A	283	342	625	0	2	627	0	0
6	109689431	rs974034	A	G	167	248	415	0	1	416	0	0
6	109689907	rs11251	G	T	163	181	344	0	1	345	0	0
6	109691101	rs1322818	A	G	14	16	30	0	2	32	0	0
6	109691944	rs3818933	G	A	19	18	37	0	0	37	0	0
6	109692188	rs9372213	C	T	31	38	69	0	0	69	0	0
6	109692484	rs11153176	C	T	14	9	23	0	1	24	0	0
6	109692727	rs9487076	T	C	18	6	24	0	0	24	0	0
6	109692776	rs12193493	T	C	18	12	30	0	0	30	0	0
6	109693287	rs3799835	A	G	21	15	36	0	0	36	0	0
6	109695054	rs11753645	T	C	21	14	35	0	0	35	0	0
6	109695985	rs3778474	G	A	18	17	35	0	0	35	0	0
6	109696206	rs3778475	A	G	14	18	32	0	0	32	0	0
6	109696751	rs1853330	G	T	11	19	30	0	0	30	0	0
6	109697051	rs34131679	C	A	12	9	21	0	0	21	0	0
6	109697083	rs145666240	T	C	12	12	24	0	0	24	0	0
6	109698306	rs9480942	C	T	8	2	10	0	0	10	0	0
6	109701218	rs1358998	T	C	3	12	15	0	0	15	0	0
6	109701660	rs1358997	G	C	10	14	24	0	0	24	0	0
6	109702646	rs3799840	A	T	10	5	15	0	0	15	0	0
6	109704062	rs1322815	A	G	11	7	18	0	1	19	0	0
6	109704442	rs3757230	T	C	7	14	21	0	0	21	0	0
6	109704451	rs3757231	A	C	7	10	17	0	0	17	0	0
6	109759552	rs59906308	G	A	4	6	10	0	0	10	0	0
6	109763040	rs35969918	G	C	7	4	11	0	0	11	0	0
6	109764535	rs1476387	G	T	19	35	54	0	0	54	0	0
6	109765818	rs2236582	C	G	6	2	8	0	0	8	0	0
6	109767930	rs9320288	G	T	416	231	647	0	8	655	0	0
6	109767931	rs59056467	C	T	410	233	643	0	10	653	0	0
6	109768295	rs910730	G	A	273	162	435	0	2	437	0	0
6	109770999	rs752262	G	C	36	37	73	0	1	74	0	0
6	109771691	rs61731700	G	A	84	117	201	0	9	210	0	0
6	109772518	rs4946976	A	G	5	5	10	0	0	10	0	0
6	109773946	rs1546980	T	C	28	44	72	0	1	73	0	0
6	109775436	rs2277113	T	C	90	64	154	0	2	156	0	0
6	109776058	rs3778477	C	G	5	5	10	0	0	10	0	0
6	109783941	rs1046943	A	G	9	15	24	0	0	24	0	0
6	109786432	rs12209691	C	T	5	1	6	0	0	6	0	0
6	109786980	rs3734652	T	C	7	12	19	0	0	19	0	0
6	110057219	rs3799852	A	G	3	3	6	0	0	6	0	0
6	110059000	rs11964533	G	A	12	2	14	0	0	14	0	0
6	110059510	rs2273752	C	A	7	3	10	0	0	10	0	0
6	110107517	rs9885672	T	C	11	6	17	0	0	17	0	0
6	110541983	rs9487316	G	A	6	0	6	0	0	6	0	0
6	110746421	rs181266713	C	T	2	5	7	0	0	7	0	0
6	110932865	rs2817802	C	T	9	10	19	0	0	19	0	0
6	111326278	.	C	T	10	4	14	0	0	14	0	0
6	111346806	rs1044387	C	T	0	12	12	0	0	12	0	0
6	111346808	rs1044388	G	A	0	12	12	0	0	12	0	0
6	111346843	rs1044389	G	A	0	9	9	0	0	9	0	0
6	111620758	rs465646	G	A	12	7	19	0	1	20	0	0
6	111628597	rs3204954	C	G	25	23	48	0	0	48	0	0
6	111628626	rs3204953	C	T	22	25	47	0	0	47	0	0
6	111688927	rs3218587	G	A	3	7	10	0	1	11	0	0
6	111695073	rs455645	C	T	6	2	8	0	0	8	0	0
6	111695887	rs462779	G	A	4	5	9	0	0	9	0	0
6	111696129	rs3218591	T	A	5	3	8	0	0	8	0	0
6	111775358	rs74529244	C	T	9	4	13	0	0	13	0	0
6	111778720	rs6935759	G	A	10	9	19	0	0	19	0	0
6	111779341	rs118081854	T	C	34	18	52	0	0	52	0	0
6	111779448	rs113922733	T	C	7	14	21	0	0	21	0	0
6	111779833	rs79720667	G	T	5	13	18	0	0	18	0	0
6	111784240	rs12192837	C	G	3	3	6	0	0	6	0	0
6	111784375	rs9400476	C	T	1	6	7	0	0	7	0	0
6	111785030	rs56300817	A	T	4	3	7	0	0	7	0	0
6	111787885	rs7752418	C	T	3	4	7	0	0	7	0	0
6	111884528	rs77000205	G	T	1	5	6	0	0	6	0	0
6	111891391	rs6941924	C	T	3	4	7	0	0	7	0	0
6	111897648	rs2038013	G	T	6	8	14	0	0	14	0	0
6	111897852	rs9320367	A	G	2	7	9	0	0	9	0	0
6	111897865	rs2038014	G	A	2	7	9	0	0	9	0	0
6	111898620	rs12663048	T	C	8	3	11	0	0	11	0	0
6	111901453	rs1043730	G	T	73	56	129	0	1	130	0	0
6	112034293	rs17072844	T	C	6	0	6	0	0	6	0	0
6	112034368	rs17072845	C	T	8	0	8	0	0	8	0	0
6	112034777	rs9400494	T	C	5	1	6	0	0	6	0	0
6	112101775	rs12910	G	T	14	7	21	0	0	21	0	0
6	114265587	rs13204445	T	C	2	4	6	0	0	6	0	0
6	114271094	rs6568820	T	C	15	8	23	0	0	23	0	0
6	114272701	rs34789089	G	A	115	55	170	0	6	176	0	0
6	114273127	rs352063	C	G	121	117	238	0	0	238	0	0
6	114273361	.	G	C	144	125	269	0	3	272	0	0
6	114274848	rs13204434	A	G	7	18	25	0	0	25	0	0
6	114276024	rs13194921	T	C	13	9	22	0	0	22	0	0
6	114276069	rs13209064	A	C	15	15	30	0	0	30	0	0
6	114276810	rs12660832	T	C	11	5	16	0	0	16	0	0
6	114276867	rs12665116	G	A	12	12	24	0	0	24	0	0
6	114278805	rs13191525	C	A	2	5	7	0	0	7	0	0
6	116565504	rs2235980	G	A	3	5	8	0	0	8	0	0
6	116568773	rs1052443	A	C	0	6	6	0	0	6	0	0
6	116571255	rs6755	G	A	54	60	114	0	1	115	0	0
6	116571695	rs3749893	G	A	19	19	38	0	1	39	0	0
6	116572828	rs1204833	A	G	13	6	19	0	2	21	0	0
6	116572971	rs1931895	C	G	18	10	28	0	0	28	0	0
6	116573667	rs9387389	G	A	53	51	104	0	1	105	0	0
6	116574455	rs2232472	G	A	57	50	107	0	1	108	0	0
6	116575083	rs2232470	C	A	54	51	105	0	0	105	0	0
6	116589290	rs9374596	A	G	3	4	7	0	0	7	0	0
6	116590802	rs1569824	T	A	4	3	7	0	0	7	0	0
6	116590807	rs1569825	T	G	4	3	7	0	0	7	0	0
6	116594511	rs1931892	A	C	3	3	6	0	0	6	0	0
6	116594545	rs9374597	G	C	3	4	7	0	0	7	0	0
6	116598475	rs1045182	T	C	308	316	624	0	6	630	0	0
6	116598793	rs10456904	G	A	215	193	408	0	6	414	0	0
6	116598853	rs1128261	A	G	195	162	357	0	3	360	0	0
6	116599665	rs9400897	T	C	97	116	213	0	3	216	0	0
6	116600774	rs3749895	C	G	83	91	174	0	2	176	0	0
6	116600810	rs3828743	G	A	86	93	179	0	3	182	0	0
6	116692795	rs2640873	A	G	22	39	61	0	0	61	0	0
6	116694120	rs9387400	C	A	7	4	11	0	0	11	0	0
6	116720487	rs10485183	C	T	13	10	23	0	0	23	0	0
6	116724377	rs1029313	C	G	5	4	9	0	0	9	0	0
6	116726588	rs3798413	G	A	4	7	11	0	0	11	0	0
6	116729339	rs3798410	A	T	3	3	6	0	0	6	0	0
6	116758932	rs1048386	T	C	11	7	18	0	0	20	2	0
6	116760341	rs9488929	A	G	3	5	8	0	0	8	0	0
6	116761621	rs9488932	C	T	5	5	10	0	0	10	0	0
6	117882679	rs9374669	T	C	19	16	35	0	0	35	0	0
6	117896899	rs2301425	G	A	5	3	8	0	0	8	0	0
6	118320108	rs9387532	A	G	0	25	25	0	0	25	0	0
6	118320469	rs9401042	G	A	6	0	6	0	0	6	0	0
6	118320595	rs6928714	C	A	23	0	23	0	0	23	0	0
6	119135142	.	G	C	26	26	52	0	0	52	0	0
6	119499566	rs1046226	G	C	123	94	217	0	0	217	0	0
6	119500239	rs3798602	G	A	153	120	273	0	1	274	0	0
6	119500674	rs2558	G	A	35	36	71	0	0	71	0	0
6	119506064	rs916471	T	A	2	4	6	0	0	6	0	0
6	119506104	rs760785	C	T	3	3	6	0	0	6	0	0
6	119506995	rs2005984	A	C	5	1	6	0	0	6	0	0
6	119508207	rs1012509	C	T	4	5	9	0	1	10	0	0
6	119509003	rs11153795	A	G	2	4	6	0	0	6	0	0
6	119510941	rs2072890	C	A	95	86	181	0	0	181	0	0
6	119543808	rs1980460	G	A	6	4	10	0	0	10	0	0
6	119585566	rs12210002	A	G	5	4	9	0	0	9	0	0
6	119586804	rs12205826	T	C	4	6	10	0	0	10	0	0
6	119590869	rs11153803	T	C	2	5	7	0	0	7	0	0
6	119592236	rs6569062	A	G	2	9	11	0	0	11	0	0
6	119592825	rs7762546	T	C	2	7	9	0	0	9	0	0
6	119596914	rs6932066	T	G	13	20	33	0	0	33	0	0
6	119598353	rs150516539	C	G	15	4	19	0	0	19	0	0
6	119598550	rs9489650	T	A	3	5	8	0	0	8	0	0
6	119633014	rs6569072	C	T	6	4	10	0	0	10	0	0
6	119633625	rs10485001	T	C	3	4	7	0	0	7	0	0
6	119640850	rs195053	C	G	4	4	8	0	0	8	0	0
6	119640890	rs6918913	C	A	16	7	23	0	2	25	0	0
6	119640949	rs195054	T	A	13	28	41	0	0	41	0	0
6	119641060	rs11962938	T	G	27	8	35	0	1	36	0	0
6	119642661	rs195055	C	T	3	5	8	0	0	8	0	0
6	119642700	rs10872177	C	T	4	2	6	0	0	6	0	0
6	119649165	rs9489686	A	G	10	2	12	0	0	12	0	0
6	119649498	rs195059	C	T	4	4	8	0	0	8	0	0
6	119649678	rs195060	A	C	3	3	6	0	0	6	0	0
6	119650416	rs195063	T	C	2	4	6	0	0	6	0	0
6	119650542	rs195065	T	G	3	4	7	0	0	7	0	0
6	119669877	rs3734385	C	T	31	18	49	0	0	49	0	0
6	119670908	rs28364655	C	T	5	3	8	0	0	8	0	0
6	122735618	rs3799545	C	T	13	11	24	0	0	24	0	0
6	122736211	.	G	A	12	11	23	0	0	23	0	0
6	122765754	rs11966733	T	A	209	203	412	0	4	416	0	0
6	122765777	rs11154080	T	C	173	189	362	0	3	365	0	0
6	122766138	rs11964202	G	A	164	187	351	0	3	354	0	0
6	125289004	rs36060063	A	G	2	4	6	0	0	6	0	0
6	125332976	rs11154282	G	A	9	9	18	0	0	19	1	0
6	125596750	rs9491352	T	A	7	1	8	0	0	8	0	0
6	126102402	rs41285252	T	C	3	6	9	0	0	9	0	0
6	126109903	rs60687777	T	C	6	3	9	0	0	9	0	0
6	126109977	rs6921070	T	C	7	2	9	0	0	9	0	0
6	126177977	rs28558746	T	C	6	2	8	0	0	8	0	0
6	126190588	rs28622002	C	G	4	3	7	0	0	7	0	0
6	126210395	rs6919947	T	G	24	25	49	0	0	49	0	0
6	126218961	rs6918791	C	G	8	1	9	0	0	9	0	0
6	126228395	rs10223441	G	C	5	2	7	0	0	7	0	0
6	126229580	rs6932705	T	C	3	3	6	0	0	6	0	0
6	126244682	rs1322755	T	C	3	3	6	0	0	6	0	0
6	126248596	rs6918302	G	A	4	3	7	0	0	7	0	0
6	126250396	rs1062718	T	A	47	29	76	0	2	78	0	0
6	126250397	rs1138820	T	A	42	36	78	0	0	78	0	0
6	126250398	rs57519248	T	A	39	36	75	0	4	79	0	0
6	127590829	rs12192111	A	G	9	10	19	0	1	20	0	0
6	127601717	rs9388559	G	A	7	2	9	0	0	9	0	0
6	127610021	rs6683	G	A	5	13	18	0	0	18	0	0
6	127664661	rs11556354	G	A	5	2	7	0	0	7	0	0
6	130373397	.	G	A	2	4	6	0	0	6	0	0
6	131160876	rs6536	G	T	19	9	28	0	0	28	0	0
6	131161504	rs1043596	T	C	20	8	28	0	0	28	0	0
6	131190838	rs17059736	G	A	10	9	19	0	0	19	0	0
6	131203804	rs76557359	C	A	2	6	8	0	0	8	0	0
6	131520655	rs1190788	G	A	15	15	30	0	0	30	0	0
6	131538952	rs28360555	C	A	4	10	14	0	0	14	0	0
6	131552900	rs67021539	A	G	3	4	7	0	0	7	0	0
6	131895144	rs2781667	C	T	27	18	45	0	0	45	0	0
6	131908498	.	C	T	29	24	53	0	0	53	0	0
6	131917379	rs2608985	A	G	3	3	6	0	0	6	0	0
6	131918839	rs2608984	A	T	9	8	17	0	0	17	0	0
6	131926334	rs2608953	C	T	6	7	13	0	0	13	0	0
6	131927007	rs2749924	C	G	8	7	15	0	0	15	0	0
6	131929751	rs2608911	T	G	3	3	6	0	0	6	0	0
6	131931092	rs2245133	T	C	6	3	9	0	0	9	0	0
6	133003344	rs2745426	C	T	4	7	11	0	0	11	0	0
6	133003865	rs1044593	A	T	3	4	7	0	1	8	0	0
6	133006059	rs2745427	C	A	13	17	30	0	0	30	0	0
6	133006626	rs2251455	C	A	3	8	11	0	0	11	0	0
6	133006740	rs2251449	C	T	4	13	17	0	0	17	0	0
6	133007480	rs35011108	G	A	5	4	9	0	0	9	0	0
6	133010525	rs2745432	G	A	4	7	11	0	0	11	0	0
6	133013544	rs45562238	T	C	1	6	7	0	0	7	0	0
6	133014413	rs45530734	C	T	4	11	15	0	0	15	0	0
6	133052997	rs12525900	T	C	4	5	9	0	0	9	0	0
6	133054766	rs11965457	T	A	5	3	8	0	0	8	0	0
6	133055876	rs45548039	G	A	3	4	7	0	0	7	0	0
6	133135886	rs9483504	A	G	2422	2270	4692	0	77	4769	0	0
6	133136041	rs9493451	C	G	2	4	6	0	0	6	0	0
6	133137111	rs3778174	C	T	4	6	10	0	0	10	0	0
6	133138010	rs9389034	T	C	8	10	18	0	0	18	0	0
6	133138249	rs2236381	T	C	11	15	26	0	0	26	0	0
6	134306290	rs9493786	G	A	2	4	6	0	0	6	0	0
6	134306312	rs148421531	G	T	2	4	6	0	0	6	0	0
6	134309513	rs115813933	C	T	6	0	6	0	0	6	0	0
6	134309568	rs76305699	G	A	5	1	6	0	0	6	0	0
6	135286230	rs11549504	T	C	85	77	162	0	2	164	0	0
6	135290923	rs9376073	A	G	2	6	8	0	0	8	0	0
6	135293463	rs4895435	C	A	1	6	7	0	0	7	0	0
6	135293512	rs4896120	C	G	3	4	7	0	0	7	0	0
6	135303356	rs12526072	A	G	3	4	7	0	0	7	0	0
6	135305304	rs12525425	T	C	7	10	17	0	0	17	0	0
6	135351720	rs9376083	G	A	6	2	8	0	0	8	0	0
6	135352088	rs1590975	C	T	5	1	6	0	0	6	0	0
6	135352303	rs6569988	C	A	9	1	10	0	0	10	0	0
6	135352648	rs9321481	G	C	6	1	7	0	0	7	0	0
6	135353452	rs10872427	T	C	4	5	9	0	0	9	0	0
6	135353851	rs7766189	A	C	99	77	176	0	0	176	0	0
6	135354094	rs4134030	G	T	39	18	57	0	1	58	0	0
6	135354849	rs150492354	T	C	51	61	112	0	2	114	0	0
6	135355118	rs4896130	C	T	15	16	31	0	0	31	0	0
6	135355507	rs9402676	C	T	35	31	66	0	1	67	0	0
6	135355723	rs7748274	A	G	22	28	50	0	0	50	0	0
6	135356216	rs11754265	G	C	34	35	69	0	0	69	0	0
6	135356469	rs11756749	T	C	12	29	41	0	1	42	0	0
6	135358567	rs7742542	T	G	22	24	46	0	0	46	0	0
6	135358916	rs9373121	G	A	32	25	57	0	0	57	0	0
6	135623584	rs2223802	C	T	7	11	18	0	0	18	0	0
6	135624811	rs6931735	G	A	4	2	6	0	0	6	0	0
6	135626348	rs6928977	T	G	4	3	7	0	0	7	0	0
6	136579206	rs17641544	G	C	72	82	154	0	1	155	0	0
6	136663948	rs1681	A	C	2	5	7	0	0	7	0	0
6	136682172	rs2076190	G	A	4	3	7	0	0	7	0	0
6	136893203	rs4631311	G	A	4	2	6	0	0	6	0	0
6	136903399	rs9376209	T	C	4	5	9	0	0	9	0	0
6	136904002	rs6570083	A	T	5	1	6	0	0	6	0	0
6	136973316	rs9402838	C	A	2	4	6	0	0	6	0	0
6	136989035	rs13195420	G	A	8	11	19	0	0	19	0	0
6	136989243	rs9389421	C	A	9	14	23	0	0	23	0	0
6	136989363	rs7766726	A	T	8	6	14	0	0	14	0	0
6	136990283	rs3765259	T	C	6	4	10	0	0	10	0	0
6	137026266	rs9321567	T	G	13	23	36	0	0	36	0	0
6	137105400	rs9483947	C	T	2	6	8	0	0	8	0	0
6	137108757	rs6912539	A	G	7	4	11	0	0	11	0	0
6	137110188	rs6899530	T	C	4	4	8	0	0	8	0	0
6	137110205	rs138857274	G	A	4	4	8	0	0	8	0	0
6	137111178	rs1923120	G	C	3	4	7	0	0	7	0	0
6	137519588	rs11914	A	C	313	287	600	0	6	606	0	0
6	137540520	rs2234711	A	G	4	9	13	0	0	13	0	0
6	138413333	rs648802	G	C	3	3	6	0	0	6	0	0
6	138725520	rs148419987	G	C	9	11	20	0	1	21	0	0
6	138731460	rs56004125	G	T	3	4	7	0	1	8	0	0
6	138732238	rs9495078	G	T	3	7	10	0	0	10	0	0
6	138732756	rs9495079	G	C	7	6	13	0	0	13	0	0
6	138732905	rs6919294	G	T	6	7	13	0	0	13	0	0
6	138733415	rs45595439	G	A	18	10	28	0	0	28	0	0
6	138734422	rs1053657	C	T	24	25	49	0	1	50	0	0
6	138742172	rs12208658	G	A	7	7	14	0	0	14	0	0
6	138742249	rs7776384	C	T	9	7	16	0	0	16	0	0
6	139018126	rs3088031	A	C	1	9	10	0	0	10	0	0
6	139018132	rs1129180	A	G	2	10	12	0	0	12	0	0
6	139309168	rs143077749	G	A	6	11	17	0	0	17	0	0
6	139349921	rs2504376	G	C	46	42	88	0	0	88	0	0
6	139351193	rs62441849	A	C	6	1	7	0	0	7	0	0
6	139352800	rs6570300	T	G	5	2	7	0	0	7	0	0
6	139354032	rs9385845	A	C	2	4	6	0	0	6	0	0
6	139354482	rs6570301	G	A	3	3	6	0	0	6	0	0
6	139354692	rs6570302	C	T	5	3	8	0	0	8	0	0
6	139355158	rs3813331	A	G	6	4	10	0	0	10	0	0
6	139358862	rs56029058	C	T	3	3	6	0	0	6	0	0
6	139362711	rs6928096	T	C	1	5	6	0	0	6	0	0
6	139362833	rs56049150	A	G	3	5	8	0	0	8	0	0
6	139362975	rs7764219	T	A	6	2	8	0	0	8	0	0
6	141167474	rs650883	C	A	13	2	15	0	0	15	0	0
6	143090734	rs34530989	T	C	6	2	8	0	0	8	0	0
6	143222842	rs76147438	T	C	10	1	11	0	0	11	0	0
6	143228163	rs6570533	G	A	5	4	9	0	0	9	0	0
6	143265186	rs11155268	A	G	3	3	6	0	0	6	0	0
6	143270247	rs1413627	A	G	4	10	14	0	0	14	0	0
6	143274271	rs6902635	C	T	5	3	8	0	0	8	0	0
6	143277652	rs12660871	G	A	4	2	6	0	0	6	0	0
6	143744326	rs9390090	G	A	5	13	18	0	0	18	0	0
6	143747270	rs1061220	T	C	9	9	18	0	0	18	0	0
6	143748722	rs3088203	T	C	44	33	77	0	3	80	0	0
6	143749295	rs1065355	G	T	36	52	88	0	0	88	0	0
6	143754112	rs4896656	A	C	4	5	9	0	0	9	0	0
6	143763873	rs4895614	A	G	15	16	31	0	0	31	0	0
6	143765778	rs6929191	A	G	12	9	21	0	0	21	0	0
6	143810909	rs10809	A	G	3	3	6	0	0	6	0	0
6	143813668	rs9403496	T	A	6	2	8	0	0	8	0	0
6	143814595	rs1116	G	C	5	11	16	0	1	17	0	0
6	143815127	rs223228	T	C	18	19	37	0	0	37	0	0
6	143815303	rs72992615	G	T	53	37	90	0	0	90	0	0
6	143816123	rs9376753	A	C	5	3	8	0	0	8	0	0
6	143816859	rs8161	C	T	76	67	143	0	0	143	0	0
6	143823112	rs3762001	G	A	49	38	87	0	0	87	0	0
6	143823157	rs3762002	T	C	49	39	88	0	2	90	0	0
6	143827102	rs1038390	T	C	6	1	7	0	0	7	0	0
6	143828325	rs1569589	T	C	4	2	6	0	0	6	0	0
6	144145797	rs1082	A	C	9	5	14	0	0	14	0	0
6	144148874	rs34853285	A	G	1	7	8	0	0	8	0	0
6	144149889	rs10447447	A	G	5	7	12	0	0	12	0	0
6	144150609	rs1072385	C	T	9	10	19	0	1	20	0	0
6	144150831	rs3734226	T	C	18	15	33	0	1	34	0	0
6	144151314	rs4896674	T	A	12	8	20	0	0	20	0	0
6	144170503	rs4140442	T	A	3	4	7	0	0	7	0	0
6	144178419	rs3818089	T	C	4	3	7	0	0	7	0	0
6	144181952	rs1884089	C	T	10	4	14	0	0	14	0	0
6	144182183	rs1810524	A	G	11	9	20	0	0	20	0	0
6	144269541	rs2076684	G	C	39	25	64	0	0	64	0	0
6	144270001	rs2064495	C	T	1	8	9	0	0	9	0	0
6	144272240	rs2268443	A	G	8	1	9	0	0	9	0	0
6	144328671	rs73006277	C	T	0	22	22	0	0	22	0	0
6	144328705	rs148450783	G	A	25	0	25	0	1	26	0	0
6	144328968	rs2281476	T	C	0	9	9	0	0	9	0	0
6	144852201	rs12204734	G	A	5	6	11	0	0	11	0	0
6	144869785	rs1534443	A	G	6	12	18	0	0	18	0	0
6	146007332	rs35230590	C	T	5	4	9	0	0	9	0	0
6	147163841	rs12213086	G	C	4	4	8	0	0	8	0	0
6	147165627	rs12206612	C	G	1	7	8	0	0	8	0	0
6	149650100	rs478767	G	C	3	5	8	0	0	8	0	0
6	149685617	rs506268	C	T	6	1	7	0	0	7	0	0
6	149700491	rs3734296	G	A	141	120	261	0	4	265	0	0
6	149700805	rs2031450	G	A	4	3	7	0	0	7	0	0
6	149730846	rs652921	G	A	174	176	350	0	2	352	0	0
6	149731904	rs2744434	C	T	214	241	455	0	1	456	0	0
6	150046637	rs111309085	A	G	5	1	6	0	0	6	0	0
6	151274168	rs803463	G	A	6	3	9	0	0	9	0	0
6	151336739	rs509474	C	G	22	24	46	0	0	46	0	0
6	151422936	rs7543	G	A	15	22	37	0	0	37	0	0
6	151685594	rs3186051	A	T	63	47	110	0	0	110	0	0
6	151686905	rs11155787	C	T	36	50	86	0	0	86	0	0
6	151712598	rs79626929	T	G	4	3	7	0	0	7	0	0
6	151726175	rs3757312	G	T	25	12	37	0	0	37	0	0
6	151726300	rs1065310	G	C	30	20	50	0	0	50	0	0
6	152355156	rs9479169	G	C	5	1	6	0	0	6	0	0
6	152443744	rs2295190	G	T	38	36	74	0	1	75	0	0
6	152464839	rs2256135	A	G	14	18	32	0	1	33	0	0
6	152489913	rs2635447	A	G	2	4	6	0	0	6	0	0
6	152529260	rs3798756	G	A	7	13	20	0	0	20	0	0
6	152615200	rs12664753	G	A	7	15	22	0	0	22	0	0
6	153035121	rs4870130	C	T	6	3	9	0	0	9	0	0
6	153037298	rs1361437	C	T	4	2	6	0	0	6	0	0
6	153038605	rs9479376	C	T	5	10	15	0	0	15	0	0
6	153044050	rs9397552	T	G	10	12	22	0	0	22	0	0
6	153044425	rs116888986	G	A	18	21	39	0	0	39	0	0
6	153044949	rs4348331	T	C	26	26	52	0	0	52	0	0
6	153045477	.	A	G	45	67	112	0	0	112	0	0
6	153304588	rs2073262	C	T	7	4	11	0	1	12	0	0
6	153306749	rs3757063	T	G	37	15	52	0	1	53	0	0
6	153308198	rs6921137	T	G	13	8	21	0	0	21	0	0
6	153323594	.	C	T	144	47	191	0	0	191	0	0
6	153323709	rs3818125	T	C	62	8	70	0	1	71	0	0
6	154476528	rs9479767	T	C	6	4	10	0	0	10	0	0
6	154477913	rs17277929	T	C	2	4	6	0	1	7	0	0
6	154478440	rs2236256	C	A	4	4	8	0	0	8	0	0
6	154478704	rs2236258	C	T	2	5	7	0	0	7	0	0
6	154479003	rs6902403	T	C	5	5	10	0	0	10	0	0
6	154479396	rs9322448	C	G	4	2	6	0	0	6	0	0
6	154480520	rs139261756	C	T	9	10	19	0	1	20	0	0
6	154727825	rs12528985	C	T	13	0	13	0	0	13	0	0
6	154731898	rs6915474	G	A	11	1	12	0	0	12	0	0
6	154731904	rs2275337	C	G	11	1	12	0	0	12	0	0
6	154731970	rs2275338	G	A	8	0	8	0	0	8	0	0
6	154763401	rs6557351	G	A	4	9	13	0	0	13	0	0
6	154771277	rs9322467	A	G	4	8	12	0	0	12	0	0
6	154830816	rs57619897	A	G	1	5	6	0	0	6	0	0
6	155102802	rs9479956	T	C	7	2	9	0	0	9	0	0
6	155103250	rs74460474	A	G	4	2	6	0	0	6	0	0
6	155105997	rs9478582	C	T	7	3	10	0	0	10	0	0
6	155106052	rs9478583	A	G	6	4	10	0	0	10	0	0
6	155106151	rs9397747	C	A	6	2	8	0	0	8	0	0
6	155141313	rs17552819	C	T	122	106	228	0	1	229	0	0
6	155152311	rs911191	C	G	8	1	9	0	1	10	0	0
6	155155039	rs9375	C	T	170	177	347	0	1	348	0	0
6	155160128	rs9384245	T	C	4	9	13	0	0	13	0	0
6	155160436	rs17085709	T	C	9	8	17	0	0	17	0	0
6	155162121	rs12199781	T	G	6	4	10	0	0	10	0	0
6	155162163	rs12201149	T	C	7	2	9	0	0	9	0	0
6	155568819	rs2989457	A	G	3	3	6	0	0	6	0	0
6	155568881	rs3011906	A	G	4	9	13	0	0	13	0	0
6	155575431	rs1331212	C	T	1	5	6	0	0	6	0	0
6	155582215	rs4870366	T	G	2	4	6	0	0	6	0	0
6	157306025	.	G	T	3	3	6	0	0	6	0	0
6	157337988	rs6909426	C	A	3	4	7	0	0	7	0	0
6	157393026	rs17344487	T	A	3	3	6	0	0	6	0	0
6	157405930	rs3734441	G	A	15	17	32	0	0	32	0	0
6	157711777	rs6605502	C	T	14	12	26	0	0	26	0	0
6	157713777	rs3199374	C	T	126	99	225	0	2	227	0	0
6	157745008	rs1133482	C	T	8	8	16	0	0	16	0	0
6	157745159	rs3812104	C	G	5	7	12	0	0	12	0	0
6	158361899	rs912879	C	T	8	5	13	0	0	13	0	0
6	158418448	rs9356200	C	T	9	4	13	0	0	13	0	0
6	158448559	rs9456988	C	G	3	7	10	0	1	11	0	0
6	158450598	rs2010835	A	G	2	5	7	0	0	7	0	0
6	158450603	rs2010836	A	G	2	5	7	0	0	7	0	0
6	158451601	rs10806798	G	A	189	190	379	0	0	379	0	0
6	158497717	rs2296508	T	C	7	3	10	0	0	10	0	0
6	158507981	rs2296506	G	A	4	2	6	0	1	7	0	0
6	158517308	rs2502601	A	G	8	15	23	0	0	23	0	0
6	158517451	rs2502600	A	G	9	8	17	0	1	18	0	0
6	158518507	rs1048394	T	C	2	8	10	0	0	10	0	0
6	158518639	rs17490133	A	G	8	7	15	0	0	15	0	0
6	158519155	rs2502599	T	C	10	15	25	0	0	25	0	0
6	158519189	rs2502598	C	G	12	15	27	0	0	27	0	0
6	158531168	rs2502607	A	G	7	5	12	0	0	12	0	0
6	158532187	rs2502606	A	G	4	2	6	0	0	6	0	0
6	158571501	rs6929274	G	A	24	15	39	0	0	39	0	0
6	158924595	rs3749853	A	G	1	5	6	0	0	6	0	0
6	158927651	rs3828712	A	G	5	1	6	0	0	6	0	0
6	158928523	rs17582855	A	G	1	8	9	0	0	9	0	0
6	159031370	rs55844923	C	T	4	3	7	0	0	7	0	0
6	159034448	rs56240001	G	A	6	8	14	0	0	14	0	0
6	159040865	rs149114036	C	T	8	5	13	0	1	14	0	0
6	159054127	rs73016232	T	C	6	11	17	0	2	19	0	0
6	159178345	rs901363	C	T	66	70	136	0	1	137	0	0
6	159180191	rs10945560	C	A	2	4	6	0	0	6	0	0
6	159184462	rs2291387	A	G	115	91	206	0	3	209	0	0
6	159185563	rs3123101	T	A	99	97	196	0	2	198	0	0
6	159187348	.	A	T	254	122	376	0	27	403	0	0
6	159188128	rs2242318	A	G	9	7	16	0	1	17	0	0
6	159189508	rs3102977	G	C	31	25	56	0	0	56	0	0
6	159189572	rs901361	G	A	23	21	44	0	0	44	0	0
6	159190019	rs3102976	T	G	12	9	21	0	0	21	0	0
6	159190184	rs3102975	G	A	17	17	34	0	0	34	0	0
6	159190800	rs3127177	C	G	13	8	21	0	0	21	0	0
6	159192575	rs3127181	A	G	27	31	58	0	1	59	0	0
6	159192919	rs3102974	G	T	26	29	55	0	1	56	0	0
6	159193325	rs2129208	A	C	32	22	54	0	0	54	0	0
6	159193395	rs3127182	A	G	24	17	41	0	0	41	0	0
6	159193471	rs117994844	C	T	21	16	37	0	0	37	0	0
6	159194671	rs3102973	G	A	19	17	36	0	0	36	0	0
6	159195184	rs3123102	A	T	12	15	27	0	0	27	0	0
6	159195416	rs3123103	A	T	10	14	24	0	0	24	0	0
6	159195743	rs3123104	A	G	19	13	32	0	3	35	0	0
6	159195781	rs3102972	G	T	13	12	25	0	0	25	0	0
6	159196150	rs3123105	T	C	10	9	19	0	1	20	0	0
6	159196603	rs9456352	C	A	16	14	30	0	1	31	0	0
6	159197006	rs1564972	C	G	21	19	40	0	0	40	0	0
6	159197182	rs3127200	C	T	15	10	25	0	0	25	0	0
6	159198380	rs3123106	C	G	4	2	6	0	0	6	0	0
6	159198706	rs3127205	T	C	3	4	7	0	0	7	0	0
6	159198730	rs3102971	T	C	3	5	8	0	0	8	0	0
6	159199286	rs3123107	C	G	3	5	8	0	0	8	0	0
6	159206484	.	T	C	321	294	615	0	9	624	0	0
6	159207643	rs3123112	C	T	5	2	7	0	0	7	0	0
6	159207783	rs3127219	A	G	5	33	38	0	0	38	0	0
6	159230633	rs3123131	T	C	3	3	6	0	0	6	0	0
6	159238666	rs1872611	C	T	4	2	6	0	0	6	0	0
6	159239763	rs62431645	G	A	9	4	13	0	0	13	0	0
6	159239813	rs9457476	G	A	8	4	12	0	0	12	0	0
6	159435372	rs3117158	C	T	3	4	7	0	0	7	0	0
6	159465977	rs1738074	T	C	139	120	259	0	0	259	0	0
6	160110109	.	T	A	4	3	7	0	0	7	0	0
6	160152435	.	G	C	24	36	60	0	2	62	0	0
6	160170795	.	T	C	21	27	48	0	1	49	0	0
6	160198395	rs3465	G	A	72	87	159	0	2	161	0	0
6	160240766	rs7761227	T	C	5	1	6	0	0	6	0	0
6	160240768	rs7761229	T	C	5	1	6	0	0	6	0	0
6	160448324	rs8191754	C	G	12	7	19	0	0	19	0	0
6	160453978	rs1570070	A	G	3	8	11	0	0	11	0	0
6	160464289	rs894817	G	A	3	5	8	0	0	8	0	0
6	161489332	rs4709488	A	T	4	2	6	0	0	6	0	0
6	161521039	rs12528950	A	G	2	4	6	0	0	6	0	0
6	161538250	rs1488	G	A	80	67	147	0	2	149	0	0
6	161551876	rs55666532	G	A	15	17	32	0	0	32	0	0
6	161556411	rs56073227	T	A	2	5	7	0	0	7	0	0
6	161557662	rs3734462	G	A	26	28	54	0	1	55	0	0
6	163881133	rs183304733	G	C	6	6	12	0	2	14	0	0
6	166738902	rs9356477	T	A	6	1	7	0	0	7	0	0
6	166748342	rs9459655	C	G	13	11	24	0	0	24	0	0
6	166750247	rs4610538	G	A	2	10	12	0	0	12	0	0
6	166778679	rs3728	T	G	33	33	66	0	2	68	0	0
6	167271716	rs9347162	T	C	7	2	9	0	0	9	0	0
6	167358068	rs3734246	G	A	15	3	18	0	0	18	0	0
6	167358233	rs1212550	C	T	17	3	20	0	0	20	0	0
6	167358351	rs3778439	C	T	7	0	7	0	0	7	0	0
6	167359345	rs3777727	A	G	6	16	22	0	2	24	0	0
6	167359558	rs2769343	C	T	10	19	29	0	0	29	0	0
6	167360104	rs2236312	G	A	5	22	27	0	0	27	0	0
6	167366394	rs2769345	T	C	1	5	6	0	0	6	0	0
6	167369897	rs1044059	C	A	7	38	45	0	0	45	0	0
6	167369992	rs2247325	A	G	10	24	34	0	0	34	0	0
6	167394634	rs4710154	A	T	4	4	8	0	1	9	0	0
6	167454434	rs10484531	G	A	6	2	8	0	0	8	0	0
6	167455139	rs162297	A	G	7	16	23	0	0	23	0	0
6	167455629	rs162298	G	A	8	8	16	0	0	16	0	0
6	167465882	rs9459854	C	T	2	7	9	0	0	9	0	0
6	170106833	.	C	T	12	3	15	0	2	17	0	0
6	170106835	.	C	T	12	2	14	0	2	16	0	0
6	170113295	rs7773552	A	G	8	5	13	0	0	13	0	0
6	170122234	rs6931721	G	A	2	4	6	0	0	6	0	0
6	170150584	rs13214127	T	C	8	6	14	0	0	14	0	0
6	170152991	rs6907286	G	A	18	18	36	0	0	36	0	0
6	170172316	rs6937197	C	T	4	4	8	0	0	8	0	0
6	170173277	rs9478007	G	A	2	6	8	0	0	8	0	0
6	170674366	rs9366215	T	C	4	4	8	0	0	8	0	0
6	170678670	rs66805711	T	A	2	6	8	0	0	8	0	0
6	170678753	rs73036672	C	T	1	5	6	0	0	6	0	0
6	170679596	rs9460126	A	C	4	7	11	0	0	11	0	0
6	170681747	rs3734766	G	A	27	22	49	0	0	49	0	0
6	170703130	rs73038692	C	T	3	6	9	0	0	9	0	0
6	170703908	rs7772226	C	T	2	6	8	0	0	8	0	0
6	170713682	rs9295407	A	T	6	12	18	0	0	18	0	0
6	170713885	rs13207394	C	G	13	7	20	0	1	21	0	0
6	170714007	rs1274	T	C	8	12	20	0	0	20	0	0
6	170714797	rs16901389	C	G	3	6	9	0	0	9	0	0
6	170858332	rs17860779	G	A	38	46	84	0	0	84	0	0
6	170860395	rs9356664	T	G	21	12	33	0	0	33	0	0
6	170878886	rs2235506	A	G	5	5	10	0	0	10	0	0
7	5965334	.	C	T	4	43	47	0	1	48	0	0
7	5968053	.	A	G	2	7	9	0	0	9	0	0
7	5968349	.	A	G	1	11	12	0	0	12	0	0
7	5968352	.	T	C	1	11	12	0	0	12	0	0
7	5968355	.	T	C	1	9	10	0	0	10	0	0
7	5968359	.	T	C	1	10	11	0	0	11	0	0
7	6833894	.	C	G	7	0	7	0	0	7	0	0
7	6836486	rs62453638	T	C	19	27	46	0	0	46	0	0
7	26251843	.	C	T	147	0	147	0	4	151	0	0
7	26252166	.	G	A	664	0	664	0	8	672	0	0
7	26252382	.	A	G	301	1	302	0	1	303	0	0
7	65227913	.	T	C	23	1	24	0	0	24	0	0
7	65228128	.	C	T	10	11	21	0	0	21	0	0
7	66769132	.	G	A	17	0	17	0	0	17	0	0
7	66769133	.	A	T	17	0	17	0	0	17	0	0
7	66769189	.	A	G	12	0	12	0	0	12	0	0
7	66769194	rs370292714	C	T	10	0	10	0	0	10	0	0
7	66769198	.	A	G	9	0	9	0	0	9	0	0
7	66769241	rs377105733	T	C	9	0	9	0	0	9	0	0
7	66769242	rs370471568	G	A	9	0	9	0	0	9	0	0
7	71247168	rs118054711	G	C	15	4	19	0	1	20	0	0
7	71248966	rs10225199	C	G	6	4	10	0	0	10	0	0
7	72307542	rs28505075	C	T	203	237	440	0	6	446	0	0
7	72350361	rs62463388	G	A	12	7	19	0	0	19	0	0
7	72413443	.	G	A	72	56	128	0	2	130	0	0
7	72414219	rs62463430	G	A	10	12	22	0	0	22	0	0
7	72417638	.	C	T	15	15	30	0	0	30	0	0
7	72418992	rs9955	C	T	49	54	103	0	0	103	0	0
7	72436652	rs121966	A	G	8	0	8	0	0	8	0	0
7	72468030	.	A	T	12	8	20	0	0	20	0	0
7	72469999	.	G	T	26	15	41	0	0	41	0	0
7	72483668	rs800182	A	G	8	9	17	0	0	17	0	0
7	72640036	.	T	C	63	18	81	0	0	81	0	0
7	72717933	rs11544043	C	T	45	61	106	0	1	107	0	0
7	72722126	rs141077039	G	A	4	4	8	0	0	8	0	0
7	72855351	.	T	A	140	3	143	0	82	225	0	0
7	72855358	.	T	A	170	4	174	0	70	244	0	0
7	72891754	rs2074754	C	T	31	36	67	0	2	69	0	0
7	72951095	rs35107030	C	G	284	289	573	0	1	574	0	0
7	73096993	rs8891	T	C	49	50	99	0	0	99	0	0
7	73097654	rs1128349	C	T	28	18	46	0	0	46	0	0
7	73097720	rs28494095	G	C	12	21	33	0	0	33	0	0
7	73100487	rs11762191	G	C	2	4	6	0	1	7	0	0
7	73111504	rs4717804	A	C	28	24	52	0	1	53	0	0
7	73114481	rs1569061	C	T	37	28	65	0	0	65	0	0
7	73115201	rs41271241	G	A	63	38	101	0	3	104	0	0
7	73122923	rs2228607	A	G	46	40	86	0	1	87	0	0
7	73122977	rs2229854	G	A	38	38	76	0	1	77	0	0
7	73124408	rs28452991	C	T	1	5	6	0	0	6	0	0
7	73470714	rs2071307	G	A	8	52	60	0	0	60	0	0
7	73521113	rs13236108	A	G	10	7	17	0	0	17	0	0
7	73536368	rs3801461	C	G	61	39	100	0	0	100	0	0
7	73607937	rs62475257	C	T	14	15	29	0	0	29	0	0
7	73637310	rs75232755	G	A	9	7	16	0	0	16	0	0
7	73641115	rs147050248	C	A	9	6	15	0	0	15	0	0
7	73663362	rs1805395	T	C	51	17	68	0	0	68	0	0
7	73765251	rs11975727	G	T	5	2	7	0	0	7	0	0
7	73765932	rs565201	A	G	3	3	6	0	0	6	0	0
7	74108249	rs35275911	G	C	5	1	6	0	1	7	0	0
7	74168944	.	G	A	4	2	6	0	1	7	0	0
7	74169405	.	G	A	14	16	30	0	0	30	0	0
7	74193668	rs10614	G	A	31	134	165	0	0	165	0	0
7	74201598	.	T	C	9	11	20	0	0	20	0	0
7	74212036	rs707394	C	G	7	11	18	0	0	18	0	0
7	74212048	rs707395	C	T	7	11	18	0	0	18	0	0
7	74294925	rs2529275	C	T	19	8	27	0	0	27	0	0
7	74296369	rs587690801	T	C	5	1	6	0	0	6	0	0
7	74297306	rs2530478	C	T	13	2	15	0	0	15	0	0
7	74297551	rs2108321	T	A	8	1	9	0	1	10	0	0
7	74297827	rs1635765	G	A	7	2	9	0	0	9	0	0
7	74298377	rs1062273	T	C	30	6	36	0	0	36	0	0
7	74306596	rs71558560	G	A	29	12	41	0	2	43	0	0
7	74312339	rs201815917	C	T	10	8	18	0	0	18	0	0
7	74312340	rs200011387	G	A	10	8	18	0	0	18	0	0
7	74322249	rs587678468	C	T	1	5	6	0	0	6	0	0
7	74388457	.	G	T	6	1	7	0	0	7	0	0
7	74534644	rs113677035	C	A	6	3	9	0	0	9	0	0
7	74994593	.	C	T	14	31	45	0	0	45	0	0
7	74997640	.	C	G	14	3	17	0	0	17	0	0
7	75042154	.	C	T	8	7	15	0	0	15	0	0
7	75044463	rs71245954	G	A	44	29	73	0	1	75	1	0
7	75044830	rs236651	G	A	15	4	19	0	0	19	0	0
7	75046785	rs8726	T	C	115	115	230	0	3	233	0	0
7	75048564	rs71560447	A	G	22	28	50	0	0	50	0	0
7	75048750	rs6465926	G	A	17	11	28	0	0	28	0	0
7	75048804	rs365844	T	C	15	7	22	0	1	23	0	0
7	75049197	.	T	G	6	7	13	0	0	13	0	0
7	75049460	rs236658	A	G	11	3	14	0	0	14	0	0
7	75049648	rs71234110	C	T	15	12	27	0	0	27	0	0
7	75050086	rs236660	T	C	6	7	13	0	1	14	0	0
7	75050273	.	C	T	12	0	12	0	0	17	5	0
7	75050298	rs117224201	T	C	13	9	22	0	0	22	0	0
7	75053572	rs71560448	G	A	4	3	7	0	0	7	0	0
7	75070642	rs61091455	C	T	6	1	7	0	0	7	0	0
7	75101707	rs62477685	A	T	8	6	14	0	0	14	0	0
7	75104331	rs2923700	A	G	12	8	20	0	0	20	0	0
7	75145495	rs794377	G	A	14	19	33	0	0	33	0	0
7	75155300	.	G	A	6	3	9	0	0	9	0	0
7	75163169	rs1167827	A	G	28	23	51	0	1	52	0	0
7	75163397	rs1167828	A	G	17	26	43	0	0	43	0	0
7	75165018	rs1167829	G	A	12	10	22	0	1	23	0	0
7	75166401	rs1167830	C	T	7	4	11	0	0	11	0	0
7	75172270	rs1167794	G	A	7	9	16	0	0	16	0	0
7	75176300	rs1167801	T	C	2	5	7	0	1	8	0	0
7	75511979	.	A	T	21	23	44	0	1	45	0	0
7	75513062	rs42183	A	G	201	266	467	0	1	468	0	0
7	75513631	rs35144704	G	T	3	6	9	0	0	9	0	0
7	75875546	rs80333454	G	A	37	0	37	0	0	37	0	0
7	75985373	rs11765693	A	G	0	7	7	0	1	8	0	0
7	75985782	rs7802264	T	C	0	7	7	0	0	7	0	0
7	102167801	.	C	T	6	8	14	0	0	14	0	0
7	102173568	.	T	C	6	9	15	0	0	15	0	0
7	102182031	.	G	A	12	7	19	0	0	19	0	0
7	102185788	.	C	G	8	11	19	0	1	20	0	0
7	102220462	.	T	C	7	4	11	0	0	11	0	0
7	102246394	rs11547191	A	G	10	1	11	0	0	11	0	0
7	102272532	rs3873775	A	G	11	5	16	0	0	16	0	0
7	102274796	rs77602985	T	C	6	3	9	0	0	9	0	0
7	102739043	.	C	T	0	14	14	0	0	14	0	0
7	102739085	.	A	G	18	0	18	0	0	18	0	0
7	102739689	.	G	A	13	0	13	0	0	13	0	0
7	102739708	.	G	A	13	0	13	0	0	13	0	0
7	102961593	rs12705114	C	T	0	9	9	0	0	9	0	0
7	105741908	.	C	G	8	0	8	0	0	8	0	0
7	105741912	.	C	G	7	0	7	0	0	7	0	0
7	142498735	.	A	C	194	12	206	0	1	207	0	0
7	142498738	.	C	G	196	12	208	0	2	210	0	0
7	142498833	.	A	T	245	25	270	0	0	270	0	0
7	142498837	.	C	T	249	25	274	0	0	274	0	0
7	142498897	.	A	G	214	25	239	0	0	239	0	0
7	142499071	.	T	C	228	50	278	0	8	286	0	0
7	142999282	.	A	G	18	0	18	0	3	21	0	0
7	143549350	.	A	G	0	13	13	0	0	13	0	0
7	143911365	.	T	G	2	4	6	0	0	6	0	0
7	151074430	.	A	T	6	0	6	0	0	6	0	0
7	151927021	.	C	A	10	0	10	0	0	10	0	0
7	151927026	.	T	C	10	0	10	0	0	10	0	0
7	151932908	.	T	C	17	0	17	0	0	17	0	0
7	151932945	.	C	T	19	0	19	0	0	19	0	0
7	151932965	.	C	T	22	0	22	0	0	22	0	0
7	151941664	rs62478310	G	T	16	0	16	0	1	17	0	0
7	151941917	rs4024448	T	C	12	0	12	0	0	12	0	0
7	151941919	rs4024447	G	C	13	0	13	0	0	13	0	0
7	151941955	.	C	A	14	0	14	0	0	14	0	0
7	151942061	.	G	C	12	0	12	0	0	12	0	0
7	151942182	.	A	G	9	0	9	0	0	9	0	0
7	151942190	.	A	T	10	0	10	0	0	10	0	0
7	151942201	rs2770457	A	T	9	0	9	0	0	9	0	0
7	151945007	.	C	T	32	0	32	0	0	32	0	0
7	151945140	.	C	T	36	0	36	0	1	37	0	0
7	151945167	.	G	T	32	0	32	0	0	32	0	0
7	151945204	.	G	A	31	0	31	0	0	31	0	0
7	151945256	.	G	A	34	0	34	0	0	34	0	0
7	151945334	.	T	C	26	0	26	0	1	27	0	0
7	151970856	.	T	A	12	0	12	0	1	13	0	0
7	151970931	rs56850341	G	A	19	0	19	0	1	20	0	0
7	157162559	rs9691430	C	A	5	3	8	0	0	8	0	0
8	163226	rs3008288	T	C	2	4	6	0	0	6	0	0
8	163249	rs2906361	T	C	3	5	8	0	0	8	0	0
8	163654	rs2906362	C	T	2	4	6	0	0	6	0	0
8	169366	rs2240378	T	C	7	0	7	0	0	7	0	0
8	182949	.	C	A	6	4	10	0	0	10	0	0
8	184319	rs2906326	T	C	4	2	6	0	0	6	0	0
8	184698	rs2906327	C	A	8	4	12	0	0	12	0	0
8	196884	rs763786	C	A	5	2	7	0	0	7	0	0
8	197042	rs3750097	C	T	7	2	9	0	0	9	0	0
8	363192	rs10090550	G	A	6	1	7	0	0	7	0	0
8	381344	rs28438773	C	G	10	1	11	0	0	11	0	0
8	622869	.	C	A	8	6	14	0	0	14	0	0
8	623906	rs118014343	C	T	30	46	76	0	0	76	0	0
8	681206	rs11781283	G	C	8	5	13	0	0	13	0	0
8	1707647	rs13277835	C	G	8	4	12	0	0	12	0	0
8	1721598	rs13281053	A	C	8	4	12	0	0	12	0	0
8	1733200	rs116856439	G	C	9	16	25	0	1	26	0	0
8	1920411	rs4242547	G	A	1	22	23	0	0	23	0	0
8	1921428	rs4633105	G	A	2	8	10	0	0	10	0	0
8	2461973	.	T	C	6	5	11	0	0	11	0	0
8	2585814	rs5021865	C	T	14	7	21	0	0	21	0	0
8	2669059	rs17078479	C	G	3	6	9	0	0	9	0	0
8	2669611	rs881039	A	G	3	11	14	0	0	14	0	0
8	2669749	rs113004794	G	A	4	7	11	0	0	11	0	0
8	2669970	rs17078492	G	A	6	7	13	0	0	13	0	0
8	2670098	rs35937253	T	C	8	5	13	0	1	14	0	0
8	2670129	rs78495168	C	T	5	9	14	0	0	14	0	0
8	2670273	rs111750373	G	A	9	11	20	0	0	20	0	0
8	2670363	rs59476445	G	A	8	8	16	0	0	16	0	0
8	2671083	rs115128700	C	A	4	2	6	0	0	6	0	0
8	6263083	rs1057187	G	T	2	4	6	0	0	6	0	0
8	6263306	rs2243660	T	G	3	7	10	0	0	10	0	0
8	6263307	rs2243661	T	A	3	7	10	0	0	10	0	0
8	6263326	rs2243662	C	T	3	6	9	0	0	9	0	0
8	6263465	rs2515485	G	T	3	7	10	0	0	10	0	0
8	6263807	rs2243674	T	C	3	3	6	0	0	6	0	0
8	6263816	rs2243675	G	C	3	3	6	0	0	6	0	0
8	6263939	rs2243755	C	T	4	4	8	0	0	8	0	0
8	6263947	rs2243756	C	G	5	6	11	0	0	11	0	0
8	6263953	rs3020244	G	C	6	5	11	0	0	11	0	0
8	6266693	rs1550698	C	T	0	7	7	0	0	7	0	0
8	6272399	rs2305022	G	T	51	70	121	0	0	121	0	0
8	6290914	rs2442520	A	G	4	2	6	0	0	6	0	0
8	6302106	rs35590577	C	A	96	50	146	0	1	147	0	0
8	6302183	rs930557	G	C	78	115	193	0	1	194	0	0
8	6303409	rs2916750	T	G	69	43	112	0	0	112	0	0
8	6303434	rs2515570	T	A	32	61	93	0	0	93	0	0
8	6303511	rs1054073	T	A	17	31	48	0	0	48	0	0
8	6303614	rs1054074	A	C	8	7	15	0	0	15	0	0
8	6303846	rs79010412	A	G	34	25	59	0	1	60	0	0
8	6303859	rs2440415	C	T	36	28	64	0	1	65	0	0
8	6304259	rs2515571	G	A	15	21	36	0	1	37	0	0
8	6304348	rs2166006	C	T	25	27	52	0	1	53	0	0
8	6304814	rs1129706	A	G	98	69	167	0	0	167	0	0
8	6370183	rs73199034	T	G	2	5	7	0	0	7	0	0
8	6370186	rs73199035	C	G	2	4	6	0	0	6	0	0
8	6392269	rs2515483	G	C	1	6	7	0	0	7	0	0
8	6403006	rs2515488	A	C	8	14	22	0	1	23	0	0
8	6478986	rs2912010	C	T	23	6	29	0	0	29	0	0
8	6479042	rs1057090	C	T	31	7	38	0	1	39	0	0
8	6479178	rs2912016	C	A	28	6	34	0	1	35	0	0
8	6483482	rs2912057	C	T	17	4	21	0	1	22	0	0
8	6500544	rs1057091	C	T	11	6	17	0	0	17	0	0
8	6500751	rs2433149	C	G	5	3	8	0	0	8	0	0
8	6507723	rs74644235	C	T	1	6	7	0	0	7	0	0
8	6507839	rs2912004	T	C	4	2	6	0	0	6	0	0
8	6561901	rs2911989	T	G	7	4	11	0	0	11	0	0
8	6561928	rs141402436	T	C	8	7	15	0	0	15	0	0
8	6562092	rs10108451	C	T	5	7	12	0	0	12	0	0
8	6562144	rs2928614	C	T	11	4	15	0	0	15	0	0
8	6562574	rs2928615	C	T	6	1	7	0	0	7	0	0
8	6563612	rs1978547	A	G	6	3	9	0	0	9	0	0
8	6564391	rs1425786	T	C	2	5	7	0	0	7	0	0
8	6566186	rs2911984	G	A	10	2	12	0	0	12	0	0
8	6566815	rs2912043	T	C	24	18	42	0	4	46	0	0
8	6566920	rs28476773	T	A	16	26	42	0	2	44	0	0
8	6567046	rs1469268	G	A	37	16	53	0	1	54	0	0
8	6567422	rs6559177	A	G	17	37	54	0	0	54	0	0
8	6567647	rs2408444	C	G	22	64	86	0	2	88	0	0
8	6567707	rs2408445	A	T	64	23	87	0	0	87	0	0
8	6873603	.	T	G	453	0	453	0	8	461	0	0
8	8093240	rs2945254	G	T	19	6	25	0	0	25	0	0
8	8094540	rs117907084	A	C	3	8	11	0	0	11	0	0
8	8994512	rs9949	A	G	26	41	67	0	0	67	0	0
8	8994936	rs12785	A	T	27	57	84	0	1	85	0	0
8	8995166	rs330908	A	G	58	76	134	0	0	134	0	0
8	8995755	rs330910	T	A	45	63	108	0	0	108	0	0
8	8996273	rs330911	C	T	15	28	43	0	0	43	0	0
8	8996294	rs330912	C	T	10	24	34	0	2	36	0	0
8	8996490	rs330913	G	A	26	44	70	0	1	71	0	0
8	8996695	rs330914	A	G	15	14	29	0	0	29	0	0
8	8996936	rs330915	T	A	15	33	48	0	0	48	0	0
8	8997096	rs330916	C	T	14	28	42	0	1	43	0	0
8	8997194	rs330917	G	T	14	25	39	0	0	39	0	0
8	8997207	rs330918	C	G	12	26	38	0	0	38	0	0
8	8997415	rs330919	G	A	11	27	38	0	1	39	0	0
8	8997614	rs330920	C	T	19	33	52	0	0	52	0	0
8	8997623	rs330921	G	A	19	34	53	0	0	53	0	0
8	8997798	rs330922	C	G	19	38	57	0	0	57	0	0
8	8997877	rs330923	C	T	25	41	66	0	0	66	0	0
8	8998262	rs434238	C	T	17	52	69	0	1	70	0	0
8	8998263	rs408773	T	G	18	52	70	0	0	70	0	0
8	9492060	rs4535743	A	C	2	4	6	0	0	6	0	0
8	9493701	rs11994018	T	C	2	5	7	0	0	7	0	0
8	9496357	rs13268770	A	G	0	6	6	0	0	6	0	0
8	9496366	rs34638238	C	G	0	6	6	0	0	6	0	0
8	9512470	rs13277588	T	C	4	3	7	0	0	7	0	0
8	9516550	rs7463594	A	C	2	6	8	0	0	8	0	0
8	9517208	rs78145084	A	T	3	7	10	0	0	10	0	0
8	9517978	rs139201103	G	C	8	6	14	0	1	15	0	0
8	9518424	rs4554469	A	G	6	7	13	0	0	13	0	0
8	9518689	rs187890215	A	G	4	6	10	0	0	10	0	0
8	9518762	rs183366568	T	C	3	8	11	0	0	11	0	0
8	9519039	rs201287878	G	A	7	1	8	0	0	8	0	0
8	9519044	rs199580004	G	T	6	1	7	0	0	7	0	0
8	9519359	rs75417225	T	C	13	15	28	0	2	30	0	0
8	9519970	rs36090374	C	G	11	21	32	0	0	32	0	0
8	9535417	rs181717512	C	G	2	33	35	0	0	35	0	0
8	9539431	rs79256633	T	G	2	13	15	0	0	15	0	0
8	9540631	rs74932046	A	G	1	6	7	0	0	7	0	0
8	9542071	rs12544371	T	G	8	0	8	0	0	8	0	0
8	9542427	rs4841195	T	C	0	9	9	0	0	9	0	0
8	9542601	rs9650639	T	C	7	0	7	0	0	7	0	0
8	9542960	rs77976553	A	C	2	5	7	0	0	7	0	0
8	9543080	rs12679180	G	A	9	0	9	0	0	10	1	0
8	9543632	rs13260526	G	A	10	1	11	0	0	11	0	0
8	9543651	rs13270801	A	T	11	1	12	0	0	12	0	0
8	9545167	rs11776236	T	C	66	5	71	0	0	71	0	0
8	9545368	rs7003791	T	C	39	4	43	0	1	44	0	0
8	9545542	rs10081565	C	T	77	7	84	0	0	84	0	0
8	9545570	rs10081478	T	G	58	8	66	0	0	66	0	0
8	9545743	rs77562848	A	G	4	41	45	0	0	45	0	0
8	9548592	rs4313162	A	G	5	1	6	0	0	6	0	0
8	9555223	rs4841198	C	T	0	8	8	0	0	8	0	0
8	9555907	rs10903317	A	C	8	0	8	0	0	8	0	0
8	9564437	rs7006985	A	G	38	28	66	0	2	68	0	0
8	9630266	rs78039844	A	G	24	32	56	0	1	57	0	0
8	9635770	rs17734024	G	A	26	19	45	0	0	45	0	0
8	9913772	rs11786253	G	A	3	6	9	0	0	9	0	0
8	9913813	rs11779614	C	G	6	5	11	0	0	11	0	0
8	9913842	rs625218	T	C	5	9	14	0	0	14	0	0
8	9920901	rs2628136	A	G	3	5	8	0	0	8	0	0
8	9930790	rs59759359	C	T	3	3	6	0	0	6	0	0
8	9931941	rs6983566	A	G	4	3	7	0	0	7	0	0
8	9932664	rs1471765	G	C	6	2	8	0	0	8	0	0
8	10285810	rs3750314	T	C	58	30	88	0	0	88	0	0
8	10286050	rs3750315	G	A	80	39	119	0	0	119	0	0
8	10286273	rs14879	G	A	33	58	91	0	1	92	0	0
8	10643164	rs9657541	C	T	6	2	8	0	0	8	0	0
8	10643233	rs2409663	G	T	6	2	8	0	0	8	0	0
8	10692158	rs2271355	C	T	7	1	8	0	1	9	0	0
8	11159355	.	G	A	5	6	11	0	0	11	0	0
8	11183152	.	G	T	5	5	10	0	0	10	0	0
8	11279878	rs113139618	T	G	21	11	32	0	1	33	0	0
8	11280724	rs75235065	C	G	15	2	17	0	0	17	0	0
8	11280737	rs3021510	A	G	14	3	17	0	2	19	0	0
8	11302044	rs3021514	G	T	11	1	12	0	0	12	0	0
8	11411005	rs11250146	G	C	4	4	8	0	0	8	0	0
8	11416171	rs7011778	T	C	3	4	7	0	0	7	0	0
8	11643803	rs1534862	C	T	50	14	64	0	0	64	0	0
8	11644751	rs4639	A	G	14	25	39	0	0	39	0	0
8	11660614	rs1497042	C	T	1	8	9	0	0	9	0	0
8	11660916	rs2252567	C	T	21	41	62	0	1	63	0	0
8	11663394	rs1736091	G	T	4	3	7	0	0	7	0	0
8	11664738	rs1736060	C	T	6	9	15	0	1	16	0	0
8	11664818	rs2179010	C	G	6	3	9	0	1	10	0	0
8	11664895	rs2179011	T	C	5	7	12	0	1	13	0	0
8	11665016	rs1736062	A	G	4	4	8	0	0	8	0	0
8	11665217	rs1736057	G	A	5	7	12	0	0	12	0	0
8	11665518	rs1736067	A	G	5	12	17	0	0	17	0	0
8	11665661	rs1032575	C	T	13	24	37	0	0	37	0	0
8	11665704	rs1293301	C	T	25	11	36	0	1	37	0	0
8	11665805	rs1736070	C	T	6	11	17	0	0	17	0	0
8	11667179	rs8417	C	T	138	260	398	0	1	399	0	0
8	11689119	rs9205	G	C	280	589	869	0	5	874	0	0
8	11690422	rs1293315	G	A	3	3	6	0	0	6	0	0
8	11692638	rs1293322	C	T	4	5	9	0	0	9	0	0
8	11692841	rs3735810	C	T	3	5	8	0	1	9	0	0
8	11692922	rs13282158	C	T	2	6	8	0	1	9	0	0
8	11693378	rs6990033	G	T	8	7	15	0	0	15	0	0
8	11693577	rs1293325	G	A	1	6	7	0	0	7	0	0
8	11694604	rs6995787	G	C	2	4	6	0	0	6	0	0
8	11694650	rs1296025	C	T	3	3	6	0	0	6	0	0
8	11694986	rs1293327	G	A	7	5	12	0	0	12	0	0
8	11695060	rs1293328	G	A	11	7	18	0	0	18	0	0
8	11695872	rs10903343	T	C	6	7	13	0	0	13	0	0
8	11696492	rs8944	A	C	10	29	39	0	0	39	0	0
8	11700437	rs71518539	C	T	4	3	7	0	1	8	0	0
8	11701096	rs8005	A	C	11	22	33	0	1	34	0	0
8	11701253	rs2740592	A	G	15	7	22	0	0	22	0	0
8	11701278	rs2645425	G	A	13	8	21	0	0	21	0	0
8	11702313	rs709822	C	G	281	365	646	0	3	649	0	0
8	11702375	rs3947	G	A	239	331	570	0	3	573	0	0
8	11702594	rs709821	G	C	192	225	417	0	1	419	1	0
8	11702840	rs1736081	T	G	11	2	13	0	0	13	0	0
8	11703420	rs1736082	C	T	1	6	7	0	0	7	0	0
8	11706834	rs35581201	T	C	6	6	12	0	0	12	0	0
8	11707530	rs62495696	A	G	7	3	10	0	0	10	0	0
8	11708355	rs2272766	G	A	5	1	6	0	0	6	0	0
8	11710888	rs12338	G	C	108	62	170	0	1	171	0	0
8	11722046	rs2645415	A	G	9	13	22	0	0	22	0	0
8	11722125	rs1299525	C	T	9	17	26	0	1	27	0	0
8	11722355	rs1296022	G	A	9	7	16	0	0	16	0	0
8	11723775	rs1293309	G	A	15	30	45	0	0	45	0	0
8	12581855	rs4831768	C	T	5	3	8	0	0	8	0	0
8	12582865	rs55752837	A	G	2	6	8	0	0	8	0	0
8	12583544	rs11782145	C	T	5	5	10	0	0	10	0	0
8	12602541	rs4831784	G	C	15	8	23	0	1	24	0	0
8	12942510	rs486596	A	G	8	15	23	0	0	23	0	0
8	12943065	rs10888175	T	C	3	10	13	0	1	14	0	0
8	12990518	rs13275331	T	A	2	8	10	0	0	10	0	0
8	12990734	rs17553593	C	A	9	3	12	0	0	12	0	0
8	16890224	rs7011678	C	T	4	3	7	0	0	7	0	0
8	16941332	rs3850760	A	C	30	6	36	0	0	36	0	0
8	17155811	rs4922281	A	G	9	5	14	0	0	14	0	0
8	17156298	rs2285271	A	G	11	6	17	0	0	17	0	0
8	17157259	rs6992513	G	A	18	6	24	0	1	25	0	0
8	17158312	rs4921744	T	G	4	3	7	0	0	7	0	0
8	17159812	rs6587028	G	A	32	13	45	0	0	45	0	0
8	17799241	rs10108545	T	C	15	20	35	0	0	35	0	0
8	17815082	rs181777656	T	G	82	110	192	0	1	193	0	0
8	17817553	rs17635381	G	T	165	83	248	0	0	248	0	0
8	17819572	rs3780103	C	T	75	183	258	0	1	259	0	0
8	17820714	rs6991775	A	T	148	64	212	0	1	213	0	0
8	17826543	rs2285307	G	A	5	1	6	0	0	6	0	0
8	17843926	rs11776688	G	C	3	4	7	0	0	7	0	0
8	17844353	rs17126060	T	C	14	10	24	0	0	24	0	0
8	17844370	rs17635520	A	G	13	9	22	0	0	22	0	0
8	17844870	rs10088513	A	C	5	10	15	0	1	16	0	0
8	17846189	rs183465600	A	G	20	22	42	0	0	42	0	0
8	17852036	rs13279395	T	G	4	3	7	0	0	7	0	0
8	17854779	rs35935919	C	A	13	3	16	0	0	16	0	0
8	17857028	rs13258901	T	C	6	9	15	0	0	15	0	0
8	17857348	rs13266666	T	C	5	4	9	0	0	9	0	0
8	17857416	rs13256296	G	C	8	3	11	0	0	11	0	0
8	17857445	rs6586676	T	C	4	10	14	0	0	14	0	0
8	17857880	rs7825899	A	C	5	14	19	0	0	19	0	0
8	17858297	rs34975555	G	C	12	4	16	0	0	16	0	0
8	17860863	rs12056629	T	C	15	12	27	0	0	27	0	0
8	17860882	rs62498198	G	T	13	12	25	0	0	25	0	0
8	17860966	rs3898982	T	G	20	13	33	0	0	33	0	0
8	17864020	rs17514686	A	G	7	23	30	0	2	32	0	0
8	17871256	rs10103879	A	T	15	33	48	0	1	49	0	0
8	17872642	rs62498200	T	C	44	26	70	0	0	70	0	0
8	17874882	rs2237849	A	C	1	6	7	0	0	7	0	0
8	17880260	rs2283114	C	G	3	5	8	0	0	8	0	0
8	17880616	rs3886398	T	C	3	6	9	0	0	9	0	0
8	17880625	rs3886397	C	T	2	6	8	0	0	8	0	0
8	17880869	rs17514812	T	A	2	6	8	0	0	8	0	0
8	17882483	rs2299603	C	T	13	4	17	0	0	17	0	0
8	17884606	rs383091	T	C	4	4	8	0	0	8	0	0
8	17913970	rs7508	G	A	48	47	95	0	0	95	0	0
8	17914117	rs3810	T	G	100	206	306	0	3	309	0	0
8	17918986	rs17515291	A	G	19	11	30	0	0	30	0	0
8	17919031	rs61108931	C	T	22	14	36	0	0	36	0	0
8	17919440	rs62497596	G	C	18	12	30	0	0	30	0	0
8	17920077	rs12541567	T	A	18	27	45	0	0	45	0	0
8	17920337	rs7387912	C	T	23	8	31	0	1	32	0	0
8	17920359	rs7387916	C	A	17	7	24	0	0	24	0	0
8	17920361	rs7386629	A	G	17	6	23	0	1	24	0	0
8	17920567	rs7387930	C	T	15	9	24	0	1	25	0	0
8	17920623	rs6586683	C	T	13	11	24	0	0	24	0	0
8	17920807	rs7824644	A	G	21	71	92	0	3	95	0	0
8	17920820	rs7824650	A	T	19	68	87	0	1	88	0	0
8	17921230	rs13280	G	A	40	62	102	0	2	104	0	0
8	17921666	rs2073572	C	T	50	95	145	0	1	146	0	0
8	17921673	rs2073573	G	T	44	87	131	0	0	131	0	0
8	17921921	rs2073574	T	C	11	57	68	0	0	68	0	0
8	17922396	rs7834136	T	C	22	90	112	0	3	115	0	0
8	17922414	rs7830490	A	G	19	82	101	0	0	101	0	0
8	17923339	rs4377998	C	T	5	14	19	0	0	19	0	0
8	17923421	rs28479568	A	G	8	27	35	0	0	35	0	0
8	17923423	rs55869903	A	G	8	26	34	0	1	35	0	0
8	17923499	rs12541181	C	G	9	21	30	0	0	30	0	0
8	17924645	.	G	T	434	59	493	0	4	498	1	0
8	17927327	rs1049874	T	C	613	315	928	0	6	934	0	0
8	17928811	rs1071645	C	T	520	233	753	0	8	761	0	0
8	17928999	rs12549594	G	A	5	1	6	0	0	6	0	0
8	17930435	rs7387072	C	T	5	2	7	0	0	7	0	0
8	17930772	rs3753115	C	T	34	2	36	0	0	36	0	0
8	17933458	rs10105871	C	T	3	4	7	0	0	7	0	0
8	17935951	rs7460605	G	A	1	6	7	0	0	7	0	0
8	17937530	rs11986226	G	A	1	6	7	0	0	7	0	0
8	18385221	rs3087875	T	A	5	1	6	0	0	6	0	0
8	19316086	rs12155539	G	A	0	15	15	0	1	16	0	0
8	19363425	rs6984644	C	T	2	16	18	0	0	18	0	0
8	19679449	rs7005767	T	C	3	3	6	0	0	6	0	0
8	19682577	rs6997363	G	A	6	7	13	0	0	13	0	0
8	19818436	rs316	C	A	1	5	6	0	0	6	0	0
8	20055601	rs10093929	G	A	13	16	29	0	0	29	0	0
8	20069789	rs10156354	G	C	4	2	6	0	0	6	0	0
8	20071770	rs13253777	C	G	15	33	48	0	0	48	0	0
8	20080322	rs13252207	G	A	3	11	14	0	0	14	0	0
8	20081890	rs1390943	T	G	6	10	16	0	1	17	0	0
8	21766900	rs17853066	G	A	207	120	327	0	0	327	0	0
8	21767275	rs2242240	C	G	191	101	292	0	0	292	0	0
8	21768765	rs59181113	G	A	9	1	10	0	0	10	0	0
8	21844096	rs4871908	T	C	1	5	6	0	0	6	0	0
8	21849566	rs17296501	C	T	4	5	9	0	0	9	0	0
8	22069386	rs7001	T	C	97	57	154	0	1	155	0	0
8	22105502	rs1126677	T	C	40	26	66	0	0	66	0	0
8	22113430	rs12541504	A	G	6	3	9	0	0	9	0	0
8	22397645	rs116930787	G	A	4	5	9	0	0	9	0	0
8	22424244	rs2272716	T	C	20	23	43	0	2	45	0	0
8	22430238	rs2469766	G	C	4	4	8	0	0	8	0	0
8	22436681	rs11545016	C	T	15	35	50	0	0	50	0	0
8	22437823	rs3735891	C	G	8	11	19	0	1	20	0	0
8	22438313	rs922810	T	C	2	5	7	0	0	7	0	0
8	22440208	rs11779638	A	C	0	9	9	0	0	9	0	0
8	22444129	rs1038310	C	G	8	11	19	0	0	19	0	0
8	22449484	rs4592028	T	C	10	13	23	0	0	23	0	0
8	22451688	rs3064	G	C	104	262	366	0	3	370	1	0
8	22455155	rs75291371	C	T	6	2	8	0	0	8	0	0
8	22457804	rs746011	C	T	3	5	8	0	0	8	0	0
8	22459073	rs900273	T	C	5	6	11	0	0	11	0	0
8	22460101	rs117289616	C	T	98	46	144	0	0	144	0	0
8	22460204	rs34268501	A	G	1	6	7	0	0	7	0	0
8	22462755	rs11777808	A	C	29	55	84	0	3	87	0	0
8	22462852	rs11778693	T	C	19	52	71	0	4	75	0	0
8	22463623	rs7843828	C	T	112	232	344	0	1	345	0	0
8	22464064	rs2291232	T	C	5	4	9	0	0	9	0	0
8	22467760	rs13271626	C	G	17	35	52	0	0	52	0	0
8	22467870	rs6986550	T	A	30	26	56	0	0	57	1	0
8	22469492	rs55776566	T	C	18	26	44	0	2	46	0	0
8	22470308	rs2306518	A	G	19	43	62	0	2	64	0	0
8	22470710	rs1871902	G	A	28	57	85	0	0	85	0	0
8	22471147	rs720745	G	T	42	65	107	0	0	107	0	0
8	22471399	rs720746	T	C	41	61	102	0	0	102	0	0
8	22471824	rs3736147	G	A	173	331	504	0	2	506	0	0
8	22473158	rs11781149	C	T	4	6	10	0	0	10	0	0
8	22473850	rs6558167	T	C	2	6	8	0	1	9	0	0
8	22475627	rs751680	G	A	6	20	26	0	0	26	0	0
8	22475657	rs57594397	T	C	6	20	26	0	0	26	0	0
8	22476095	rs79080458	C	T	20	9	29	0	0	29	0	0
8	22477778	rs1059592	G	A	458	874	1332	0	7	1340	1	0
8	22477807	rs1545837	T	C	455	906	1361	0	6	1367	0	0
8	22479461	rs7846476	T	C	1	8	9	0	0	9	0	0
8	22479988	rs11136093	C	G	1	5	6	0	0	6	0	0
8	22480519	rs11780207	G	A	2	9	11	0	0	11	0	0
8	22481449	rs1871900	A	G	125	249	374	0	2	376	0	0
8	22482799	rs876714	A	G	23	78	101	0	0	101	0	0
8	22483246	rs13271506	G	A	13	37	50	0	1	51	0	0
8	22483836	rs878051	T	C	11	21	32	0	0	32	0	0
8	22483849	rs878053	T	C	10	19	29	0	1	30	0	0
8	22484268	rs10099266	G	C	6	16	22	0	0	22	0	0
8	22484296	rs10110443	C	G	5	11	16	0	0	16	0	0
8	22484949	rs2404654	T	C	5	26	31	0	0	31	0	0
8	22485258	rs900267	T	C	2	21	23	0	1	24	0	0
8	22485295	rs900266	A	T	2	22	24	0	0	24	0	0
8	22485375	rs7830206	C	T	3	13	16	0	0	16	0	0
8	22485934	rs10113779	G	C	5	11	16	0	0	16	0	0
8	22486612	rs11785031	A	G	4	13	17	0	0	17	0	0
8	22486951	rs3758042	T	C	5	6	11	0	0	11	0	0
8	22486987	rs3758041	A	G	5	3	8	0	0	8	0	0
8	22487087	rs3758040	T	C	0	14	14	0	0	14	0	0
8	22487388	rs6558170	C	G	5	10	15	0	0	15	0	0
8	22487422	rs6558171	T	C	5	12	17	0	0	17	0	0
8	22488750	rs13269603	C	T	7	7	14	0	0	14	0	0
8	22489247	rs1038311	T	C	4	9	13	0	0	13	0	0
8	22489678	rs7831119	A	G	6	9	15	0	0	15	0	0
8	22490209	rs2404655	T	C	4	5	9	0	0	9	0	0
8	22491397	rs1809452	G	A	3	8	11	0	0	11	0	0
8	22491496	rs2009212	G	A	4	17	21	0	0	21	0	0
8	22491518	rs2003908	T	C	4	14	18	0	0	18	0	0
8	22491622	rs35952885	T	G	3	12	15	0	2	17	0	0
8	22491980	rs17746902	G	T	3	7	10	0	0	10	0	0
8	22492103	rs6558173	G	T	6	6	12	0	0	12	0	0
8	22492129	rs6558174	A	G	6	5	11	0	0	11	0	0
8	22493124	rs11776549	C	T	3	8	11	0	0	11	0	0
8	22493350	rs12676084	C	T	5	6	11	0	0	11	0	0
8	22526559	rs11550509	G	A	130	64	194	0	1	195	0	0
8	22553621	rs1008949	T	C	12	8	20	0	0	20	0	0
8	22567044	rs73212838	C	A	1	7	8	0	0	8	0	0
8	22875909	rs2889	A	G	10	4	14	0	0	14	0	0
8	22875985	rs2241260	A	G	7	3	10	0	0	10	0	0
8	22876739	rs2241261	C	T	5	12	17	0	0	17	0	0
8	22880162	rs1047275	G	C	71	41	112	0	0	112	0	0
8	22880973	.	G	C	6	3	9	0	0	9	0	0
8	22882293	rs59296513	G	A	5	1	6	0	0	6	0	0
8	22885154	rs1105945	G	A	31	15	46	0	0	46	0	0
8	22886818	rs883429	C	T	5	2	7	0	0	7	0	0
8	22887608	rs4460370	G	A	3	4	7	0	0	7	0	0
8	22898404	rs7834266	C	T	5	2	7	0	0	7	0	0
8	22898435	rs7834281	C	T	5	13	18	0	0	18	0	0
8	22898960	rs10093948	G	A	2	5	7	0	0	7	0	0
8	22899384	rs55939050	G	A	7	13	20	0	1	21	0	0
8	22899633	rs6557612	C	G	4	28	32	0	0	32	0	0
8	22899762	rs56070946	T	C	2	17	19	0	0	19	0	0
8	22921931	rs13252794	C	T	25	40	65	0	0	65	0	0
8	22927696	rs4871845	T	C	9	2	11	0	1	12	0	0
8	22927824	rs4872048	G	C	6	2	8	0	0	8	0	0
8	22967290	rs9918919	G	C	3	4	7	0	1	8	0	0
8	22972696	rs114139410	C	G	1	9	10	0	0	10	0	0
8	22974915	rs117325737	G	A	3	16	19	0	0	19	0	0
8	22993798	rs6557617	T	C	70	61	131	0	0	131	0	0
8	22998297	rs35207185	C	A	5	2	7	0	1	8	0	0
8	22998770	rs13266164	C	G	6	2	8	0	0	8	0	0
8	23000183	rs4242391	T	C	6	2	8	0	0	8	0	0
8	23001125	rs6557618	A	T	2	5	7	0	0	7	0	0
8	23002893	rs7014588	T	C	3	3	6	0	0	6	0	0
8	23021346	rs11135703	G	A	11	14	25	0	1	26	0	0
8	23049292	rs2230229	C	T	18	10	28	0	0	28	0	0
8	23288346	rs61744075	C	A	54	83	137	0	0	137	0	0
8	23290253	rs144973738	C	T	34	16	50	0	0	50	0	0
8	23388377	rs139560434	C	T	37	19	56	0	0	56	0	0
8	23423669	rs2942194	A	G	132	70	202	0	0	202	0	0
8	23427281	rs34138581	G	A	10	6	16	0	0	16	0	0
8	23431045	rs1810193	T	C	25	43	68	0	0	68	0	0
8	23432332	rs8534	C	T	20	37	57	0	0	57	0	0
8	24213761	rs4404928	G	C	20	8	28	0	0	28	0	0
8	24434873	.	A	C	6	0	6	0	4	10	0	0
8	24434879	.	A	C	8	0	8	0	2	10	0	0
8	25042353	rs147197943	G	C	4	2	6	0	0	6	0	0
8	25056344	rs13258749	G	A	6	2	8	0	0	8	0	0
8	25057541	rs76115341	T	C	4	3	7	0	0	7	0	0
8	25057771	rs4872295	C	T	7	3	10	0	0	10	0	0
8	25108235	rs6989175	C	A	5	2	7	0	0	7	0	0
8	25112851	rs73558472	C	A	8	2	10	0	0	10	0	0
8	25112909	rs1606036	G	A	8	2	10	0	0	10	0	0
8	25130818	rs4872301	T	C	7	1	8	0	0	8	0	0
8	25135624	rs2666158	T	C	1	6	7	0	0	7	0	0
8	25135671	rs2709610	G	C	2	7	9	0	0	9	0	0
8	25182969	rs2666172	C	T	28	46	74	0	1	75	0	0
8	25230168	rs2271108	C	T	21	37	58	0	1	59	0	0
8	25269102	rs1506869	C	A	58	90	148	0	0	148	0	0
8	25364331	rs4872318	G	A	22	9	31	0	0	31	0	0
8	26164723	rs1564577	G	A	5	1	6	0	0	6	0	0
8	26170246	rs11784209	T	C	2	4	6	0	0	6	0	0
8	26171145	rs56147604	A	G	8	3	11	0	0	11	0	0
8	26173814	rs6994906	A	G	4	3	7	0	0	7	0	0
8	26178438	rs17174717	A	G	12	23	35	0	1	36	0	0
8	26183107	.	A	C	13	24	37	0	0	37	0	0
8	26193845	rs73217707	T	C	4	2	6	0	0	6	0	0
8	26194926	rs73217708	C	T	4	2	6	0	0	6	0	0
8	26199444	rs73217712	A	G	5	2	7	0	0	7	0	0
8	26208209	rs10866848	G	C	10	6	16	0	0	16	0	0
8	26208744	rs6557914	G	C	9	11	20	0	0	20	0	0
8	26209062	rs6557915	C	A	14	11	25	0	0	25	0	0
8	26209954	rs73217720	T	G	12	6	18	0	0	18	0	0
8	26219909	rs55705565	T	A	8	5	13	0	0	13	0	0
8	26220442	rs17309592	A	G	21	2	23	0	0	23	0	0
8	26220600	rs17309613	T	C	15	7	22	0	0	22	0	0
8	26236978	rs1064807	C	T	6	1	7	0	0	7	0	0
8	26242409	rs73217736	C	T	4	2	6	0	0	6	0	0
8	26249018	rs2304300	G	A	8	1	9	0	0	9	0	0
8	26250296	rs3808580	T	C	6	2	8	0	0	8	0	0
8	26250682	rs3808579	C	T	42	8	50	0	0	50	0	0
8	26252217	rs6557918	T	C	11	9	20	0	0	20	0	0
8	26263260	rs7813520	C	T	5	1	6	0	0	6	0	0
8	26266834	rs3808576	G	A	11	12	23	0	0	23	0	0
8	26510792	rs708621	T	C	8	4	12	0	0	12	0	0
8	26513525	rs76752934	G	A	15	5	20	0	0	20	0	0
8	26514293	rs1058332	G	A	8	14	22	0	0	22	0	0
8	26514316	rs11863	C	T	18	7	25	0	0	25	0	0
8	26515472	rs10495	G	A	78	33	111	0	1	112	0	0
8	27144942	.	C	T	5	7	12	0	0	12	0	0
8	27169130	rs6988218	A	T	1	5	6	0	0	6	0	0
8	27209248	rs80162260	A	C	7	1	8	0	0	8	0	0
8	27298409	rs56073911	G	A	14	8	22	0	1	23	0	0
8	27309830	.	G	A	11	20	31	0	2	33	0	0
8	27462481	rs7982	A	G	178	394	572	0	4	576	0	0
8	27591164	rs7109	C	T	30	34	64	0	0	64	0	0
8	27591261	rs8445	G	C	24	42	66	0	0	66	0	0
8	27591506	rs2010525	A	G	22	33	55	0	0	55	0	0
8	27591849	rs9797	G	A	28	13	41	0	1	42	0	0
8	27592828	rs7465	G	A	87	120	207	0	0	207	0	0
8	27593150	rs1048887	G	A	37	51	88	0	1	89	0	0
8	27593581	rs3735747	A	T	15	25	40	0	1	41	0	0
8	27635617	rs13261706	C	T	1	8	9	0	1	10	0	0
8	27669564	rs6997451	C	A	3	7	10	0	0	10	0	0
8	27669686	rs35386738	G	A	6	2	8	0	0	8	0	0
8	27670157	rs74913146	A	C	6	0	6	0	0	6	0	0
8	27670687	rs34461536	G	C	9	4	13	0	0	13	0	0
8	27982316	rs11136032	C	T	1	5	6	0	0	6	0	0
8	27982954	rs12548838	A	G	1	6	7	0	0	7	0	0
8	28014561	rs12541966	G	A	7	1	8	0	0	8	0	0
8	28040712	rs59148819	G	A	2	11	13	0	0	13	0	0
8	28204264	rs351779	G	A	332	511	843	0	27	870	0	0
8	28206275	rs1046511	G	C	283	141	424	0	3	427	0	0
8	28580813	rs4732650	C	G	3	4	7	0	0	7	0	0
8	28609769	rs9183	C	T	11	10	21	0	0	21	0	0
8	28626470	rs241177	G	A	6	2	8	0	0	8	0	0
8	28909523	rs10088428	C	T	19	25	44	0	1	45	0	0
8	28913888	rs2279442	T	C	48	32	80	0	0	80	0	0
8	28917082	rs73243127	A	G	24	14	38	0	0	38	0	0
8	28924858	rs2693	C	T	13	27	40	0	0	40	0	0
8	28925475	rs76644623	C	T	27	45	72	0	0	72	0	0
8	28926081	rs17454230	G	T	26	47	73	0	1	74	0	0
8	29099386	rs73224687	A	G	7	0	7	0	0	7	0	0
8	29100294	rs1378703	C	T	12	0	12	0	0	12	0	0
8	29197672	rs583034	A	G	9	7	16	0	0	16	0	0
8	29922417	rs1033090	T	C	55	120	175	0	0	175	0	0
8	29957151	.	A	C	4	4	8	0	1	9	0	0
8	30023540	rs7829853	A	G	2	4	6	0	0	6	0	0
8	30025442	rs141010388	C	T	1	7	8	0	0	8	0	0
8	30030897	rs35461544	G	A	6	3	9	0	0	9	0	0
8	30031648	rs71521374	C	T	16	10	26	0	0	26	0	0
8	30407991	rs3779639	G	A	1	5	6	0	0	6	0	0
8	30408241	rs6468391	C	T	4	3	7	0	0	7	0	0
8	30410265	rs4327824	T	C	4	2	6	0	0	6	0	0
8	30410795	rs1984838	C	T	5	2	7	0	0	7	0	0
8	30413888	rs112674727	C	T	7	3	10	0	1	11	0	0
8	30417532	rs13249960	C	G	2	4	6	0	0	6	0	0
8	30417971	rs6468395	A	G	5	10	15	0	0	15	0	0
8	30420597	rs3757915	T	C	7	11	18	0	0	18	0	0
8	30421455	rs3779641	C	T	4	3	7	0	0	7	0	0
8	30424915	rs10099372	A	G	4	6	10	0	0	10	0	0
8	30425905	rs3757916	A	G	12	27	39	0	0	39	0	0
8	30427612	rs2280912	G	A	16	37	53	0	1	54	0	0
8	30428758	rs34437419	C	T	11	36	47	0	0	47	0	0
8	30480097	rs12545384	C	A	6	2	8	0	0	8	0	0
8	30480697	rs12545979	C	A	2	6	8	0	0	8	0	0
8	30535660	rs3594	C	A	45	15	60	0	0	60	0	0
8	30601707	rs189910554	A	G	5	1	6	0	0	6	0	0
8	30644891	rs117764693	T	G	3	7	10	0	0	10	0	0
8	30659349	rs28714262	T	C	6	1	7	0	0	7	0	0
8	30661395	rs4733513	C	T	2	8	10	0	0	10	0	0
8	30661486	rs562836459	G	A	0	8	8	0	0	8	0	0
8	30665278	rs4733515	T	C	4	5	9	0	0	9	0	0
8	30665640	rs6987432	A	G	4	3	7	0	0	7	0	0
8	30916058	rs34477820	A	G	32	8	40	0	1	41	0	0
8	31016389	rs111400862	G	A	32	49	81	0	0	81	0	0
8	31031877	rs10092417	A	C	30	11	41	0	0	41	0	0
8	31032343	.	C	T	5	11	16	0	0	16	0	0
8	31032490	rs2553252	C	T	12	21	33	0	0	33	0	0
8	33310935	rs16880994	G	A	10	6	16	0	0	16	0	0
8	33318913	rs77009471	C	T	5	6	11	0	0	11	0	0
8	33356074	rs6468171	A	G	4	17	21	0	0	21	0	0
8	33358162	rs10644	A	T	14	24	38	0	0	38	0	0
8	33358270	rs8685	G	A	14	25	39	0	0	39	0	0
8	33358730	rs7848	C	T	3	4	7	0	0	7	0	0
8	33369944	rs2304748	T	C	14	47	61	0	1	62	0	0
8	33371086	rs188095262	C	T	40	2	42	0	1	43	0	0
8	33416189	rs3735950	G	A	93	140	233	0	1	234	0	0
8	33416222	rs3735951	C	T	89	139	228	0	1	229	0	0
8	33424546	rs3735952	T	G	16	37	53	0	0	53	0	0
8	37593688	.	G	C	2	4	6	0	0	6	0	0
8	37621345	rs78611671	G	A	3	8	11	0	0	11	0	0
8	37747138	rs72641990	A	C	6	4	10	0	0	10	0	0
8	37749477	rs55946986	A	G	5	2	7	0	0	7	0	0
8	37968654	rs3864689	G	A	9	10	19	0	0	19	0	0
8	38020325	rs2843727	G	A	10	1	11	0	2	13	0	0
8	38027483	rs3015656	G	C	4	3	7	0	0	7	0	0
8	38027519	rs16887236	A	G	4	3	7	0	0	7	0	0
8	38028195	rs7823144	G	A	10	6	16	0	0	16	0	0
8	38122161	rs80081744	G	C	14	5	19	0	0	19	0	0
8	38186318	rs189704308	T	C	42	95	137	0	1	138	0	0
8	38190769	rs2956731	T	G	4	2	6	0	0	6	0	0
8	38282064	.	A	G	11	4	15	0	1	16	0	0
8	38292266	rs2956724	C	A	7	3	10	0	0	10	0	0
8	38292894	rs2978076	G	A	2	6	8	0	0	8	0	0
8	38645854	rs117133908	C	G	16	39	55	0	0	55	0	0
8	38789797	rs4509281	C	T	5	4	9	0	0	9	0	0
8	38791709	rs11998701	C	T	6	8	14	0	0	14	0	0
8	38792366	rs66763267	C	T	4	2	6	0	0	6	0	0
8	38864860	rs13282047	C	T	3	9	12	0	0	12	0	0
8	38875649	rs13268394	G	A	2	4	6	0	0	6	0	0
8	38876466	rs6474518	T	C	46	17	63	0	0	63	0	0
8	38876468	rs6474519	C	T	45	17	62	0	0	62	0	0
8	38877415	rs7832578	C	T	33	86	119	0	0	119	0	0
8	38877792	rs4733901	A	G	30	59	89	0	2	91	0	0
8	38878960	rs6997721	G	A	67	5	72	0	0	72	0	0
8	38929273	rs6474523	T	C	1	5	6	0	0	6	0	0
8	38932597	rs12546318	T	C	2	7	9	0	0	9	0	0
8	38932706	rs150330549	G	T	2	14	16	0	0	16	0	0
8	38940922	rs6474529	G	A	3	4	7	0	0	7	0	0
8	38943567	rs12543921	T	C	5	4	9	0	0	9	0	0
8	38943733	rs10958534	G	C	3	3	6	0	0	6	0	0
8	38946828	rs13248324	A	G	8	8	16	0	0	16	0	0
8	41364861	.	C	T	4	3	7	0	2	9	0	0
8	41365601	rs78636725	A	T	7	2	9	0	0	9	0	0
8	41368001	.	C	G	78	119	197	0	2	199	0	0
8	41435795	rs999188	T	G	38	14	52	0	0	52	0	0
8	41457094	rs2977844	C	T	2	5	7	0	0	7	0	0
8	41458606	rs1978546	G	A	7	1	8	0	0	8	0	0
8	41460187	rs11996226	C	T	8	6	14	0	0	14	0	0
8	41460789	rs13275940	T	C	10	1	11	0	0	11	0	0
8	41468606	rs7825768	A	G	32	9	41	0	1	42	0	0
8	41468608	rs7841392	G	A	34	9	43	0	0	43	0	0
8	41468809	rs11990028	T	A	32	5	37	0	1	38	0	0
8	41471374	rs7843597	T	G	3	3	6	0	0	6	0	0
8	41471533	rs7822392	C	T	6	3	9	0	0	9	0	0
8	41472375	rs11995712	G	A	5	2	7	0	0	7	0	0
8	41473417	rs55812128	G	A	19	4	23	0	0	23	0	0
8	41474290	rs13248554	T	C	11	5	16	0	0	16	0	0
8	41474614	rs10958695	T	C	12	3	15	0	0	15	0	0
8	41475681	rs72638928	A	C	6	21	27	0	1	28	0	0
8	41475688	rs60344866	T	C	23	5	28	0	0	28	0	0
8	41480509	rs7010327	G	A	4	2	6	0	0	6	0	0
8	41481096	rs749540	G	A	11	5	16	0	0	16	0	0
8	41481224	rs749541	G	A	6	1	7	0	0	7	0	0
8	41482361	rs12675455	G	C	9	3	12	0	1	13	0	0
8	41514297	rs2883631	G	C	9	1	10	0	0	10	0	0
8	41553928	rs504574	C	G	3	10	13	0	1	14	0	0
8	41559609	rs2304880	G	A	6	23	29	0	0	29	0	0
8	41563685	rs1137177	G	A	5	7	12	0	0	12	0	0
8	41573266	rs34387324	G	A	18	6	24	0	0	24	0	0
8	41585438	rs2304871	G	A	8	4	12	0	0	12	0	0
8	41645710	rs4026	C	T	4	2	6	0	0	6	0	0
8	41646021	rs13253960	A	G	5	3	8	0	0	8	0	0
8	41791283	rs3739365	G	A	120	165	285	0	1	286	0	0
8	41798417	rs3824275	C	T	69	124	193	0	6	199	0	0
8	41799893	rs2929897	A	G	3	9	12	0	0	12	0	0
8	41803664	rs78995287	G	A	2	5	7	0	0	7	0	0
8	41811521	rs12548435	A	T	3	8	11	0	0	11	0	0
8	41818232	rs12550098	T	C	3	7	10	0	0	10	0	0
8	41827088	rs7831915	C	T	5	6	11	0	0	11	0	0
8	41827185	rs60116794	A	T	2	6	8	0	0	8	0	0
8	41906095	rs3824276	A	G	47	79	126	0	2	128	0	0
8	41906694	rs7006698	A	T	33	70	103	0	0	103	0	0
8	41997183	rs144582155	C	A	41	41	82	0	0	82	0	0
8	42013295	rs11778382	A	G	4	4	8	0	0	8	0	0
8	42021766	rs34101330	G	A	3	4	7	0	1	8	0	0
8	42023688	rs12545125	C	T	2	4	6	0	0	6	0	0
8	42026968	rs34361836	A	T	12	19	31	0	0	31	0	0
8	42028537	rs1050275	T	C	30	15	45	0	1	46	0	0
8	42222502	rs3136783	G	A	11	18	29	0	1	30	0	0
8	42385748	rs2923427	A	C	1	7	8	0	0	8	0	0
8	42388301	rs2923428	T	C	3	16	19	0	0	19	0	0
8	42389743	rs2923429	A	G	1	6	7	0	0	7	0	0
8	42391945	rs2974338	A	G	0	7	7	0	0	7	0	0
8	42394425	rs2923431	G	C	1	8	9	0	0	9	0	0
8	42397233	rs113755761	T	A	9	5	14	0	0	14	0	0
8	42397529	rs2974339	T	C	4	7	11	0	0	11	0	0
8	42397731	rs2974340	T	C	2	4	6	0	0	6	0	0
8	42399906	rs13273204	C	T	4	4	8	0	0	8	0	0
8	42400823	rs34432089	G	A	3	3	6	0	0	6	0	0
8	42401205	rs2974346	T	C	7	7	14	0	0	14	0	0
8	42408483	rs2974352	C	T	22	38	60	0	0	60	0	0
8	42911986	rs12541969	T	A	5	27	32	0	0	32	0	0
8	42919808	.	C	A	4	3	7	0	0	7	0	0
8	43025784	.	G	A	27	10	37	0	1	38	0	0
8	48235279	rs6990123	A	G	3	7	10	0	0	10	0	0
8	48316140	rs4873292	T	C	3	11	14	0	0	14	0	0
8	48316543	rs4873293	G	A	9	10	19	0	0	19	0	0
8	48317711	rs72646317	C	T	20	10	30	0	0	30	0	0
8	48359042	rs10808752	C	T	4	9	13	0	0	13	0	0
8	48398644	rs10957549	C	T	1	5	6	0	0	6	0	0
8	48400191	rs143356987	T	A	3	3	6	0	0	6	0	0
8	48401247	rs141682284	G	C	7	4	11	0	0	11	0	0
8	48403431	.	A	T	6	3	9	0	0	9	0	0
8	48539790	rs28542855	G	A	8	1	9	0	0	9	0	0
8	48648690	rs3614	A	T	16	5	21	0	0	21	0	0
8	48690558	rs8178252	C	T	2	6	8	0	0	8	0	0
8	48710955	rs7830743	A	G	66	39	105	0	2	107	0	0
8	48882899	rs9657054	C	T	6	0	6	0	0	6	0	0
8	48886470	rs10091017	G	A	9	3	12	0	0	12	0	0
8	48889409	rs17334535	C	A	157	93	250	0	4	254	0	0
8	52730864	.	T	C	8	7	15	0	0	15	0	0
8	52731018	.	C	T	36	0	36	0	1	37	0	0
8	52731092	.	T	A	21	0	21	0	0	21	0	0
8	52731250	.	A	G	32	0	32	0	0	32	0	0
8	52733050	rs12335014	T	A	43	25	68	0	0	68	0	0
8	52733355	rs77641444	C	T	4	3	7	0	0	7	0	0
8	52735334	rs10086425	G	A	7	6	13	0	0	13	0	0
8	52735572	rs13257067	G	A	7	2	9	0	0	9	0	0
8	52736786	rs11786382	A	G	4	2	6	0	0	6	0	0
8	52737238	rs10094353	G	C	6	1	7	0	0	7	0	0
8	52738872	rs13272467	C	T	4	2	6	0	0	6	0	0
8	52746153	rs9298462	C	T	11	10	21	0	0	21	0	0
8	52762882	rs12677168	T	C	19	9	28	0	0	28	0	0
8	52763312	rs4324911	C	T	6	0	6	0	0	6	0	0
8	52764155	rs4584139	G	A	4	3	7	0	0	7	0	0
8	52764368	rs7833777	G	A	7	2	9	0	0	9	0	0
8	52764596	rs80042160	T	C	3	7	10	0	0	10	0	0
8	52764605	rs10958299	T	C	6	2	8	0	0	8	0	0
8	52766522	rs4618684	A	G	95	39	134	0	1	135	0	0
8	52766985	rs4330683	A	C	56	18	74	0	0	74	0	0
8	52767174	rs4313145	T	C	29	31	60	0	0	60	0	0
8	52767538	rs145969298	G	A	18	43	61	0	0	61	0	0
8	52767675	rs11777386	A	G	33	14	47	0	0	47	0	0
8	52768305	rs7827346	G	A	12	5	17	0	0	17	0	0
8	52769075	rs9643793	C	G	30	7	37	0	0	37	0	0
8	52769763	rs7008057	C	T	28	13	41	0	1	42	0	0
8	52770449	rs2395825	A	G	28	16	44	0	0	44	0	0
8	52770799	rs4873613	T	C	24	9	33	0	0	33	0	0
8	52771058	rs10435632	G	T	55	44	99	0	1	100	0	0
8	52771560	rs4873206	T	C	80	50	130	0	0	130	0	0
8	52772515	rs9298464	T	C	103	41	144	0	4	148	0	0
8	52773230	rs9298465	C	G	59	34	93	0	1	94	0	0
8	52773295	rs9298466	T	A	36	21	57	0	1	58	0	0
8	52783262	rs10086351	T	C	5	2	7	0	0	7	0	0
8	52785007	rs10094042	T	C	4	2	6	0	0	6	0	0
8	52786066	rs12544903	G	A	1	6	7	0	0	7	0	0
8	52786158	rs13267846	G	A	11	1	12	0	0	12	0	0
8	52786410	rs2395826	G	A	8	6	14	0	0	14	0	0
8	52786690	rs116655711	C	T	9	17	26	0	0	26	0	0
8	52786700	rs2395827	C	T	15	9	24	0	0	24	0	0
8	52788393	rs7838816	G	A	1	8	9	0	0	9	0	0
8	52790996	rs4873616	G	T	1	6	7	0	0	7	0	0
8	52794907	rs10958303	G	A	12	3	15	0	0	15	0	0
8	52795614	rs13277735	G	A	5	2	7	0	0	7	0	0
8	52796807	rs12680958	G	A	10	4	14	0	0	14	0	0
8	52797072	rs28619907	T	C	7	2	9	0	0	9	0	0
8	52797159	rs13256408	C	T	7	4	11	0	0	11	0	0
8	52801361	rs1013622	A	G	5	1	6	0	0	6	0	0
8	52801391	rs1013621	C	T	6	1	7	0	0	7	0	0
8	52811914	rs13264242	C	G	23	18	41	0	0	41	0	0
8	52812343	rs3763547	A	G	29	13	42	0	1	43	0	0
8	52824085	rs11781801	G	A	7	3	10	0	0	10	0	0
8	53537316	rs1129660	A	G	210	360	570	0	5	575	0	0
8	53539804	rs60173373	A	C	6	4	10	0	0	10	0	0
8	53539869	rs62499940	C	T	5	2	7	0	0	7	0	0
8	53554145	rs16918019	C	A	2	5	7	0	0	7	0	0
8	53555069	rs2305427	A	G	191	294	485	0	3	488	0	0
8	53557226	rs2108	T	C	12	5	17	0	0	17	0	0
8	53561892	rs964785	T	C	28	53	81	0	1	82	0	0
8	53565818	rs13250856	G	A	15	9	24	0	0	24	0	0
8	53602831	rs13270654	A	G	1	9	10	0	0	10	0	0
8	53621223	rs62501683	C	G	5	5	10	0	0	10	0	0
8	54696076	rs188171252	A	C	7	10	17	0	0	17	0	0
8	54850809	rs6473898	C	T	5	15	20	0	0	20	0	0
8	54852643	rs3816772	C	G	5	8	13	0	0	13	0	0
8	54853705	rs729016	T	G	2	7	9	0	0	9	0	0
8	54971811	rs77948165	T	C	10	5	15	0	0	15	0	0
8	56843930	rs10091244	T	G	4	14	18	0	0	18	0	0
8	56866780	rs2292419	T	C	4	10	14	0	0	14	0	0
8	56866957	rs10089932	A	G	9	11	20	0	0	20	0	0
8	56868065	rs56181546	G	A	8	17	25	0	0	25	0	0
8	56868240	rs10104302	T	G	12	35	47	0	0	47	0	0
8	56868363	rs7829003	C	G	22	14	36	0	1	37	0	0
8	56869605	rs2668016	C	T	0	7	7	0	0	7	0	0
8	56869746	rs56337639	A	G	7	0	7	0	0	7	0	0
8	56870048	rs2719240	C	G	3	5	8	0	0	8	0	0
8	56872082	rs2719268	T	C	3	5	8	0	0	8	0	0
8	56872102	rs2668018	C	T	3	4	7	0	0	7	0	0
8	56872972	rs66838044	A	G	5	1	6	0	0	6	0	0
8	56875533	rs72651502	A	G	5	5	10	0	0	10	0	0
8	56877051	rs2668022	A	G	4	3	7	0	0	7	0	0
8	56884089	rs952784	G	A	1	6	7	0	0	7	0	0
8	56885601	rs7838485	A	C	3	3	6	0	0	6	0	0
8	56886156	rs2719233	A	G	6	2	8	0	2	10	0	0
8	56886410	rs2667984	C	T	5	3	8	0	0	8	0	0
8	56886657	rs10112370	C	T	4	3	7	0	1	8	0	0
8	56886687	rs10101914	T	C	7	5	12	0	0	12	0	0
8	56888078	rs2719230	G	A	3	3	6	0	0	6	0	0
8	56890564	rs17812677	T	A	6	0	6	0	0	6	0	0
8	56892230	rs16922508	T	C	7	2	9	0	0	9	0	0
8	56894167	rs2667982	T	G	4	2	6	0	0	6	0	0
8	56894303	rs2667981	T	A	6	0	6	0	0	6	0	0
8	56894359	rs2719245	G	C	57	0	57	0	1	58	0	0
8	56894421	rs2719246	G	T	63	1	64	0	0	64	0	0
8	56903610	rs9650314	G	A	5	1	6	0	0	6	0	0
8	56904026	rs16920192	T	A	4	2	6	0	0	6	0	0
8	56904244	rs2667977	A	G	6	0	6	0	0	6	0	0
8	56904723	rs2667976	C	A	9	3	12	0	0	12	0	0
8	56904852	rs2719252	T	C	4	3	7	0	0	7	0	0
8	56905130	rs2667975	T	C	4	3	7	0	0	7	0	0
8	56906068	rs10282821	G	A	3	6	9	0	0	9	0	0
8	56906088	rs72653924	C	T	7	2	9	0	0	9	0	0
8	56906590	rs2667973	A	C	9	2	11	0	0	11	0	0
8	56906661	rs2667972	C	T	11	2	13	0	0	13	0	0
8	56906976	rs2719243	T	C	5	3	8	0	0	8	0	0
8	56907160	rs2667971	T	C	6	7	13	0	0	13	0	0
8	56907232	rs2719242	T	C	6	5	11	0	0	11	0	0
8	56907735	rs72653928	A	G	7	1	8	0	0	8	0	0
8	56913220	rs2667990	C	G	10	2	12	0	0	12	0	0
8	56913527	rs2719248	T	A	9	1	10	0	0	10	0	0
8	56915902	.	G	A	1	5	6	0	0	6	0	0
8	56920443	rs2668010	C	T	6	6	12	0	0	12	0	0
8	56922067	rs1995976	A	G	15	7	22	0	0	22	0	0
8	56923290	rs115163019	A	C	634	177	811	0	9	821	1	0
8	56980542	rs2976009	G	A	5	3	8	0	0	8	0	0
8	56980569	rs2953897	C	T	5	4	9	0	0	9	0	0
8	56980803	rs2953898	C	T	8	2	10	0	0	10	0	0
8	56981194	rs6474042	G	A	8	2	10	0	0	10	0	0
8	56981824	rs2953901	C	A	8	2	10	0	0	10	0	0
8	56984392	rs2953916	T	C	5	3	8	0	0	8	0	0
8	56984963	.	T	C	2	4	6	0	0	6	0	0
8	56985814	rs1050403	T	C	6954	3957	10911	0	205	11117	1	0
8	56986417	rs17814456	A	G	32	11	43	0	0	43	0	0
8	56986531	rs2976045	C	G	21	15	36	0	0	36	0	0
8	56986737	rs2976044	A	G	42	29	71	0	0	71	0	0
8	57075473	rs35399547	A	C	7	6	13	0	1	14	0	0
8	57076241	rs1128144	C	T	9	7	16	0	2	18	0	0
8	57078933	rs35883156	G	T	11	6	17	0	0	17	0	0
8	57900233	rs185639004	T	C	0	6	6	0	0	6	0	0
8	59329438	rs13277646	A	G	60	14	74	0	0	74	0	0
8	59341863	rs75963467	C	T	1	5	6	0	0	6	0	0
8	59344064	rs74884939	T	C	2	4	6	0	0	6	0	0
8	59345945	rs12543860	G	A	5	1	6	0	0	6	0	0
8	59346928	rs201309347	A	T	1	6	7	0	2	9	0	0
8	59349053	rs6993992	T	C	39	33	72	0	2	74	0	0
8	59361873	.	G	A	7	3	10	0	0	10	0	0
8	59361875	rs118104017	T	C	7	3	10	0	0	10	0	0
8	59362624	rs1057067	T	C	36	13	49	0	0	49	0	0
8	59468464	rs7843989	T	G	10	12	22	0	0	22	0	0
8	59468651	rs7825996	A	T	16	10	26	0	0	26	0	0
8	59468842	rs6471731	A	G	36	29	65	0	0	65	0	0
8	59469136	rs72647434	G	A	2	6	8	0	0	8	0	0
8	59469275	rs72647435	G	T	3	3	6	0	0	6	0	0
8	59470992	rs9297996	T	C	4	5	9	0	1	10	0	0
8	59471332	rs10104292	T	C	3	4	7	0	0	7	0	0
8	59473938	rs12676593	A	G	4	10	14	0	0	14	0	0
8	59478423	rs10111052	T	G	5	26	31	0	0	31	0	0
8	59478980	rs10099912	G	T	2	9	11	0	0	11	0	0
8	59481292	rs10094910	T	C	1	7	8	0	0	8	0	0
8	59481663	rs62511968	C	T	6	4	10	0	0	10	0	0
8	59482041	rs4400366	C	G	4	2	6	0	0	6	0	0
8	59487176	rs10090425	T	A	7	11	18	0	0	18	0	0
8	59489542	rs4282557	C	T	0	8	8	0	0	8	0	0
8	59489549	rs4400367	A	G	0	7	7	0	0	7	0	0
8	59494089	rs28656336	G	T	34	50	84	0	0	84	0	0
8	59496416	rs1050504	C	T	127	201	328	0	2	330	0	0
8	59496490	rs1050488	A	G	95	154	249	0	1	250	0	0
8	59497371	rs72647443	G	A	11	15	26	0	0	26	0	0
8	59498190	rs12677290	G	A	10	18	28	0	1	29	0	0
8	59502535	rs3736236	G	A	4	4	8	0	0	8	0	0
8	59507125	rs77593073	G	A	4	2	6	0	0	6	0	0
8	59921413	rs826595	C	T	3	5	8	0	0	8	0	0
8	59946033	rs35002097	G	A	3	3	6	0	0	6	0	0
8	60032805	rs2290526	T	G	4	15	19	0	0	19	0	0
8	60033144	rs1456019	G	T	18	45	63	0	0	63	0	0
8	61145264	rs6986917	A	G	1	5	6	0	0	6	0	0
8	61461482	rs74872219	C	G	4	3	7	0	0	7	0	0
8	61461799	rs74648505	C	T	10	2	12	0	0	12	0	0
8	61462172	rs72648594	G	C	23	8	31	0	0	31	0	0
8	61478763	rs72648602	A	G	7	1	8	0	0	8	0	0
8	61480704	rs57550331	T	C	6	2	8	0	0	8	0	0
8	61480830	rs12681841	A	G	5	5	10	0	1	11	0	0
8	61482194	rs77065309	C	T	13	17	30	0	0	30	0	0
8	61482319	rs72650405	G	A	27	18	45	0	2	47	0	0
8	61501058	rs72650416	A	G	12	5	17	0	0	17	0	0
8	61509013	rs112957317	A	G	4	3	7	0	0	7	0	0
8	61510555	rs34234629	A	T	4	5	9	0	0	9	0	0
8	61510658	rs13267765	A	C	3	5	8	0	0	8	0	0
8	61510867	rs11786146	A	G	4	9	13	0	0	13	0	0
8	61511725	rs12680436	T	C	30	43	73	0	0	73	0	0
8	61512070	rs7462738	A	G	8	12	20	0	0	20	0	0
8	61512119	rs56332284	T	G	12	13	25	0	1	26	0	0
8	61512640	rs55878066	C	A	4	8	12	0	0	12	0	0
8	61521803	rs602724	C	T	1	5	6	0	0	6	0	0
8	61521867	rs610455	A	G	1	6	7	0	0	7	0	0
8	61535125	rs649634	C	G	28	44	72	0	0	72	0	0
8	61535417	rs9437	G	A	31	52	83	0	0	83	0	0
8	62415320	.	T	G	6	2	8	0	0	8	0	0
8	63951237	rs11545077	C	T	69	41	110	0	0	110	0	0
8	63951312	rs1800909	A	G	48	24	72	0	1	73	0	0
8	64089789	rs72659895	A	G	7	9	16	0	0	17	1	0
8	64091822	.	C	A	0	8	8	0	2	10	0	0
8	64097069	rs17196307	T	C	3	15	18	0	0	18	0	0
8	64124094	rs77594100	C	A	127	251	378	0	6	384	0	0
8	65527669	rs59035258	C	T	7	50	57	0	1	58	0	0
8	66514954	rs14213	T	C	73	35	108	0	1	109	0	0
8	66515783	rs1053088	G	A	62	30	92	0	0	92	0	0
8	66515865	rs1053087	A	G	50	32	82	0	0	82	0	0
8	66515988	rs1053085	C	T	25	7	32	0	0	32	0	0
8	66621411	rs76100380	G	A	32	18	50	0	0	50	0	0
8	66624232	rs10504390	A	G	5	1	6	0	0	6	0	0
8	66625124	rs78748261	G	A	6	2	8	0	0	8	0	0
8	66626374	rs7822627	C	A	2	4	6	0	0	6	0	0
8	66626779	rs78005584	C	T	16	7	23	0	0	23	0	0
8	66630900	rs17395656	T	C	95	59	154	0	3	157	0	0
8	66639733	rs17395920	A	G	18	4	22	0	0	22	0	0
8	66640090	rs16932315	C	A	4	2	6	0	0	6	0	0
8	66642905	rs118041909	G	A	6	2	8	0	0	8	0	0
8	66644150	rs76326392	A	G	5	2	7	0	0	7	0	0
8	66644295	rs149499131	A	G	7	7	14	0	0	14	0	0
8	66644713	rs10808746	G	A	6	1	7	0	0	7	0	0
8	66644963	rs75342066	T	G	1	5	6	0	0	6	0	0
8	66645549	rs7833031	G	A	10	1	11	0	0	11	0	0
8	66645592	rs80322153	C	T	9	1	10	0	0	10	0	0
8	66736695	rs6415604	T	C	23	8	31	0	0	31	0	0
8	66737101	rs77444023	T	G	9	1	10	0	0	10	0	0
8	66738913	rs78027859	T	C	5	3	8	0	0	8	0	0
8	66739623	rs77670797	C	T	12	18	30	0	0	30	0	0
8	66740628	rs76127068	G	A	10	9	19	0	0	19	0	0
8	66741103	rs77759672	A	G	16	11	27	0	0	27	0	0
8	66744193	rs77168736	A	G	7	3	10	0	0	10	0	0
8	66746474	rs77295491	A	G	3	5	8	0	0	8	0	0
8	66749488	rs79686994	C	T	5	6	11	0	0	11	0	0
8	66750427	rs76560471	G	A	6	6	12	0	0	12	0	0
8	66753261	rs6472225	C	T	3	4	7	0	0	7	0	0
8	67366221	rs147080598	C	T	25	8	33	0	0	33	0	0
8	67369355	rs2555588	G	C	21	49	70	0	0	70	0	0
8	67577061	rs61753691	T	C	49	115	164	0	2	166	0	0
8	67579416	rs191872173	C	A	5	4	9	0	0	9	0	0
8	67957130	rs7840028	C	T	3	3	6	0	0	6	0	0
8	68122084	rs72654952	T	G	10	16	26	0	0	26	0	0
8	68123065	rs57551749	G	A	4	9	13	0	0	13	0	0
8	68222466	rs143323509	C	A	6	1	7	0	0	7	0	0
8	68223017	rs140486610	G	A	2	4	6	0	1	7	0	0
8	71041428	rs73687604	C	T	2	5	7	0	0	7	0	0
8	71489077	rs373885	C	G	3	5	8	0	0	8	0	0
8	71489080	rs11989403	T	G	4	5	9	0	0	9	0	0
8	71490539	rs67074395	T	C	0	7	7	0	0	7	0	0
8	71491316	rs13281844	T	C	3	5	8	0	0	8	0	0
8	71550832	rs7830986	T	C	6	5	11	0	0	11	0	0
8	73957540	rs1545827	C	T	4	3	7	0	1	8	0	0
8	73958718	rs10112752	G	A	43	15	58	0	0	58	0	0
8	74867927	rs72661848	C	G	9	7	16	0	0	16	0	0
8	74868305	rs12676883	T	C	6	15	21	0	0	21	0	0
8	74868374	rs72661849	G	A	7	7	14	0	0	14	0	0
8	74868909	rs72661850	A	G	7	1	8	0	0	8	0	0
8	74869599	rs73687113	G	A	3	3	6	0	0	6	0	0
8	74869616	rs73687114	G	A	3	3	6	0	0	6	0	0
8	74870647	rs1559797	A	G	5	5	10	0	0	10	0	0
8	74871099	rs900130	T	C	2	4	6	0	0	6	0	0
8	74871324	rs900131	A	G	11	10	21	0	0	21	0	0
8	74873578	rs72661851	G	A	4	3	7	0	0	7	0	0
8	74873669	rs17317020	C	T	5	3	8	0	0	8	0	0
8	74873968	rs112748538	G	A	2	4	6	0	0	6	0	0
8	74883103	.	A	C	3	3	6	0	0	6	0	0
8	74883104	.	C	A	3	3	6	0	0	6	0	0
8	74888494	rs2306486	C	T	42	27	69	0	0	69	0	0
8	74888616	rs8075	G	C	29	32	61	0	0	61	0	0
8	74891164	rs75674446	A	G	2	4	6	0	0	6	0	0
8	74892353	rs12543465	T	C	2	5	7	0	0	7	0	0
8	74892483	rs12541279	C	T	0	7	7	0	0	7	0	0
8	74892520	rs2383922	C	T	5	2	7	0	0	7	0	0
8	74893821	rs1053079	A	G	198	211	409	0	6	415	0	0
8	74893850	rs1053077	C	G	174	174	348	0	3	351	0	0
8	74894025	rs1053054	A	G	20	26	46	0	0	46	0	0
8	74894627	rs6472811	G	A	28	41	69	0	0	69	0	0
8	74894748	rs2291217	A	G	42	24	66	0	0	66	0	0
8	75274141	rs11554166	T	G	6	2	8	0	0	8	0	0
8	75278457	rs6472842	A	G	3	3	6	0	0	6	0	0
8	77893801	rs112199677	G	A	7	2	9	0	0	9	0	0
8	77895039	rs143201132	C	T	27	10	37	0	0	37	0	0
8	77898932	rs4735749	C	A	2	4	6	0	0	6	0	0
8	77899416	rs79126340	C	T	5	2	7	0	1	8	0	0
8	77899774	rs111503584	C	T	7	1	8	0	0	8	0	0
8	77901778	rs75782992	A	T	6	0	6	0	0	6	0	0
8	81397423	rs406079	A	T	7	3	10	0	0	10	0	0
8	81435942	rs16907781	A	G	339	173	512	0	6	518	0	0
8	81454224	rs438160	G	T	8	0	8	0	0	8	0	0
8	81454587	rs3893826	G	C	6	2	8	0	0	8	0	0
8	81455041	rs57642931	A	G	15	12	27	0	0	27	0	0
8	81542089	rs73260945	C	T	5	4	9	0	0	9	0	0
8	81881962	rs1445564	C	T	14	4	18	0	0	18	0	0
8	81885077	rs1445560	A	G	34	31	65	0	0	65	0	0
8	81905397	rs2016465	A	G	28	56	84	0	1	85	0	0
8	81905533	rs895267	G	A	27	58	85	0	0	85	0	0
8	81976019	rs35710008	G	A	2	4	6	0	0	6	0	0
8	81998174	rs17570887	T	C	1	5	6	0	0	6	0	0
8	82016119	rs4404873	A	G	3	10	13	0	0	13	0	0
8	82017186	rs11994289	C	T	6	5	11	0	0	11	0	0
8	82017932	rs4500045	G	A	4	9	13	0	0	13	0	0
8	82018861	rs28683599	A	G	8	2	10	0	0	10	0	0
8	82020700	rs4377918	A	G	5	2	7	0	0	7	0	0
8	82020794	rs4269491	C	A	4	3	7	0	0	7	0	0
8	82194029	.	T	A	3	5	8	0	0	8	0	0
8	82570390	rs915	C	T	105	29	134	0	2	136	0	0
8	82570458	rs75293486	G	A	40	116	156	0	0	156	0	0
8	82570631	rs1058401	C	T	39	8	47	0	1	48	0	0
8	82573391	rs10096714	T	C	5	1	6	0	0	6	0	0
8	82588938	rs2300491	A	G	6	1	7	0	0	7	0	0
8	82590861	rs2991004	G	A	7	5	12	0	0	12	0	0
8	82592967	.	G	A	18	45	63	0	1	64	0	0
8	82614590	rs6415649	T	C	133	272	405	0	2	407	0	0
8	82616347	rs114203486	A	C	1	5	6	0	0	6	0	0
8	82616349	rs199836050	A	C	1	5	6	0	0	6	0	0
8	82713126	rs1906875	G	C	5	15	20	0	0	20	0	0
8	82713223	rs77057724	G	A	9	3	12	0	0	12	0	0
8	82715153	rs2029414	T	C	3	8	11	0	0	11	0	0
8	82727329	rs56291867	T	C	2	4	6	0	0	6	0	0
8	82727569	rs16909651	T	C	12	4	16	0	1	17	0	0
8	82733663	rs774464	G	A	3	3	6	0	0	6	0	0
8	82737786	rs12677458	C	T	0	6	6	0	0	6	0	0
8	82741020	rs61366694	C	T	4	3	7	0	0	7	0	0
8	87404324	rs55871514	G	A	1	6	7	0	0	7	0	0
8	87480097	rs3087641	G	A	6	0	6	0	0	6	0	0
8	87484640	rs72690413	T	C	33	22	55	0	1	56	0	0
8	87484919	rs72690414	G	A	31	10	41	0	3	44	0	0
8	87502546	rs72690418	T	C	8	0	8	0	0	8	0	0
8	87540872	rs10956871	G	A	43	17	60	0	2	62	0	0
8	87557541	rs72690469	C	G	4	3	7	0	0	7	0	0
8	87558138	rs2119537	A	G	8	2	10	0	0	10	0	0
8	87558142	rs1946939	T	G	2	8	10	0	0	10	0	0
8	87567193	rs2304789	C	T	32	11	43	0	1	44	0	0
8	87567848	rs10504825	A	C	3	22	25	0	0	25	0	0
8	87569710	rs62510848	A	G	2	5	7	0	0	7	0	0
8	87570665	rs1062850	A	C	35	69	104	0	3	107	0	0
8	87570728	rs1062851	C	T	34	66	100	0	1	101	0	0
8	87571049	rs1044719	A	G	20	63	83	0	1	84	0	0
8	87572663	rs1044728	C	T	79	52	131	0	0	131	0	0
8	87573644	rs8041	G	C	5	9	14	0	0	14	0	0
8	90716624	rs184302	C	T	2	5	7	0	0	7	0	0
8	90730906	rs218900	A	T	14	11	25	0	0	25	0	0
8	90731317	rs218901	G	T	8	9	17	0	0	17	0	0
8	90732214	rs218902	T	C	4	4	8	0	0	8	0	0
8	90733686	rs218903	T	A	7	5	12	0	0	12	0	0
8	90734506	rs218904	C	T	9	4	13	0	0	13	0	0
8	90770609	rs39499	A	G	2	6	8	0	0	8	0	0
8	90770669	rs43133	A	T	2	5	7	0	0	7	0	0
8	90779253	rs39762	T	C	4	10	14	0	0	14	0	0
8	90792066	rs39505	A	G	1	9	10	0	0	10	0	0
8	90792127	rs39506	A	C	2	7	9	0	0	9	0	0
8	90796967	rs389848	T	G	5	3	8	0	0	8	0	0
8	90796968	rs372981	C	T	5	3	8	0	0	8	0	0
8	90801972	rs40247	A	C	4	3	7	0	0	7	0	0
8	90802045	rs40453	A	G	3	4	7	0	0	7	0	0
8	90802099	rs400411	A	G	4	2	6	0	0	6	0	0
8	90914272	rs2250670	A	G	8	8	16	0	0	16	0	0
8	90946056	rs9995	A	G	35	37	72	0	1	73	0	0
8	90947269	rs2735383	C	G	33	14	47	0	0	47	0	0
8	90947537	rs1063053	C	T	44	17	61	0	0	61	0	0
8	90949724	rs2735385	C	A	9	1	10	0	0	10	0	0
8	90949880	rs2697679	A	C	9	2	11	0	0	11	0	0
8	90950261	rs6998169	T	A	4	2	6	0	0	7	1	0
8	90951272	rs2735387	C	G	6	2	8	0	0	8	0	0
8	90955624	rs3736639	T	A	4	4	8	0	0	8	0	0
8	90958422	rs1061302	T	C	115	72	187	0	2	189	0	0
8	90961512	rs10109454	T	C	5	1	6	0	0	6	0	0
8	90967711	rs709816	A	G	75	43	118	0	1	119	0	0
8	90990479	rs1805794	C	G	73	46	119	0	2	121	0	0
8	90993395	rs1805796	C	T	6	5	11	0	0	11	0	0
8	90993883	rs1805797	C	T	11	4	15	0	0	15	0	0
8	90996258	rs1805844	A	G	3	6	9	0	0	9	0	0
8	91017745	rs1805806	T	C	5	7	12	0	0	12	0	0
8	91650818	rs17643634	C	T	7	6	13	0	0	13	0	0
8	91651162	rs7463641	C	T	5	7	12	0	0	12	0	0
8	91651250	rs16905041	G	T	3	7	10	0	0	10	0	0
8	91652817	rs13266461	T	C	5	8	13	0	0	13	0	0
8	91656967	rs6471243	T	C	2	5	7	0	0	7	0	0
8	94746698	rs3133974	G	T	3	11	14	0	0	14	0	0
8	94808165	rs3134031	A	G	2	5	7	0	0	7	0	0
8	94935937	rs4735258	T	C	12	31	43	0	0	43	0	0
8	94936532	rs911	G	C	14	23	37	0	0	37	0	0
8	95440553	rs2930958	A	G	7	6	13	0	0	13	0	0
8	95500924	rs8117	A	G	201	319	520	0	2	522	0	0
8	95523189	rs1055798	T	A	25	42	67	0	0	67	0	0
8	95524748	rs10104301	T	C	3	4	7	0	0	7	0	0
8	95525394	rs112710004	T	C	2	5	7	0	0	7	0	0
8	95527078	rs10087221	T	G	2	5	7	0	0	7	0	0
8	95538468	rs2890827	T	C	52	88	140	0	0	140	0	0
8	95538708	rs7835534	G	A	79	109	188	0	3	191	0	0
8	95541371	rs957446	T	A	52	81	133	0	1	134	0	0
8	95560432	rs80010487	A	C	8	0	8	0	0	8	0	0
8	95805155	rs144304726	G	T	3	4	7	0	0	7	0	0
8	96167968	rs3174076	C	T	121	203	324	0	5	329	0	0
8	97239613	rs2292836	A	C	3	25	28	0	0	28	0	0
8	97240129	rs10504961	C	T	9	10	19	0	1	20	0	0
8	97240847	rs13253635	A	G	5	16	21	0	0	21	0	0
8	97242124	rs7002575	G	A	18	35	53	0	0	53	0	0
8	97242849	rs7836698	C	T	12	47	59	0	0	59	0	0
8	97243720	rs2292835	G	A	36	53	89	0	0	89	0	0
8	97273543	rs3808386	G	A	1	6	7	0	0	7	0	0
8	97316821	rs938828	T	G	3	9	12	0	0	12	0	0
8	97317409	rs3808480	G	A	4	6	10	0	0	10	0	0
8	97335067	rs13262071	C	T	4	3	7	0	0	7	0	0
8	97337656	rs17781008	A	G	7	1	8	0	0	8	0	0
8	97338400	rs76916934	C	T	5	8	13	0	0	13	0	0
8	97338931	rs17781044	A	G	5	2	7	0	1	8	0	0
8	97339091	rs114567799	G	T	6	10	16	0	0	16	0	0
8	97340004	rs6468500	C	G	6	3	9	0	0	9	0	0
8	97340116	rs9886481	C	G	5	11	16	0	0	16	0	0
8	97340925	rs6985074	A	T	22	8	30	0	3	33	0	0
8	97341390	rs11784595	A	C	2	9	11	0	1	12	0	0
8	97341406	rs11777772	G	A	6	10	16	0	0	16	0	0
8	97342090	rs2280264	A	G	10	12	22	0	0	22	0	0
8	97342536	rs2280263	A	G	7	18	25	0	0	25	0	0
8	97342582	rs7001397	C	T	19	5	24	0	0	24	0	0
8	97343176	rs2271775	G	T	10	24	34	0	0	34	0	0
8	97345590	rs3735986	A	G	7	6	13	0	0	13	0	0
8	98855616	rs2513969	T	C	4	2	6	0	0	6	0	0
8	98863876	rs1136594	G	A	175	82	257	0	2	260	1	0
8	98863930	rs1136595	T	C	216	99	315	0	2	317	0	0
8	98864794	rs3412	T	C	37	12	49	0	0	49	0	0
8	99054796	rs1599909	C	T	8	10	18	0	0	18	0	0
8	99055222	rs2877453	C	A	92	116	208	0	2	210	0	0
8	99055335	rs2444859	A	G	103	47	150	0	1	151	0	0
8	99057150	rs11777189	C	A	235	690	925	0	1	926	0	0
8	99057526	rs812	G	A	363	358	721	0	10	731	0	0
8	99114768	rs73701250	G	A	12	3	15	0	0	15	0	0
8	99467856	rs10955176	C	T	2	9	11	0	0	11	0	0
8	100216840	rs10107358	T	A	27	48	75	0	0	75	0	0
8	100216998	rs149455679	G	A	49	29	78	0	6	85	1	0
8	100844758	rs36074608	T	C	6	5	11	0	0	11	0	0
8	100865836	rs6468694	G	A	1	14	15	0	1	16	0	0
8	100884321	rs35509895	C	G	5	7	12	0	0	12	0	0
8	100884323	rs35769167	C	A	5	7	12	0	0	12	0	0
8	100885600	rs4480092	A	T	5	23	28	0	0	28	0	0
8	100889677	rs7157	C	T	17	34	51	0	0	51	0	0
8	100890542	rs4626565	T	C	7	3	10	0	0	10	0	0
8	100890893	rs7813557	C	T	4	3	7	0	0	7	0	0
8	100891210	rs4510829	G	A	6	4	10	0	0	10	0	0
8	100899793	rs1130569	G	A	515	996	1511	0	2	1513	0	0
8	100904277	rs1130474	T	C	358	683	1041	0	9	1050	0	0
8	101163127	rs2453640	C	G	2	7	9	0	0	9	0	0
8	101227024	rs2088199	A	T	2	5	7	0	0	7	0	0
8	101228483	rs2514683	C	G	2	7	9	0	0	9	0	0
8	101228530	rs2514684	C	T	1	5	6	0	0	6	0	0
8	101247320	rs1692004	T	C	5	6	11	0	0	11	0	0
8	101250907	rs1660353	C	T	5	6	11	0	0	11	0	0
8	101251366	rs181212017	C	A	10	11	21	0	0	21	0	0
8	101252680	rs6511	T	C	16	49	65	0	1	66	0	0
8	101253184	rs1788190	G	A	24	79	103	0	3	106	0	0
8	101268237	rs1660350	G	A	6	1	7	0	0	7	0	0
8	101271821	rs1616833	C	T	3	14	17	0	0	17	0	0
8	101275034	rs1660351	C	T	34	15	49	0	0	49	0	0
8	101276677	rs1788193	C	T	34	14	48	0	0	48	0	0
8	101277640	rs1660322	T	C	6	1	7	0	0	7	0	0
8	101277916	rs1788194	T	C	6	4	10	0	0	10	0	0
8	101278724	rs1660323	T	A	6	2	8	0	0	8	0	0
8	101525880	rs10104673	T	C	5	1	6	0	0	6	0	0
8	101533868	rs15989	A	G	7	24	31	0	0	31	0	0
8	101545455	rs12545394	T	C	12	15	27	0	0	27	0	0
8	101562193	rs10955231	C	T	4	6	10	0	0	10	0	0
8	101562939	rs2844048	T	C	7	0	7	0	0	7	0	0
8	101707306	rs1616359	G	C	8	3	11	0	0	11	0	0
8	101707567	rs186339830	G	T	16	6	22	0	0	22	0	0
8	101709538	rs1693543	C	T	4	4	8	0	0	8	0	0
8	101712964	rs6468732	C	A	4	2	6	0	0	6	0	0
8	101714394	rs1693547	C	T	3	3	6	0	0	6	0	0
8	101714799	rs1693548	C	T	15	6	21	0	0	21	0	0
8	101715956	rs1693550	G	A	115	49	164	0	2	166	0	0
8	101718352	rs1693553	G	C	11	5	16	0	0	16	0	0
8	101718768	rs1693555	A	G	14	4	18	0	0	18	0	0
8	101719436	rs1786321	C	G	38	13	51	0	4	55	0	0
8	101720062	rs1786320	T	C	64	34	98	0	1	99	0	0
8	101722092	rs1693557	T	C	59	27	86	0	1	87	0	0
8	101722366	rs1039153	T	C	38	10	48	0	0	48	0	0
8	101726477	rs3115894	C	T	86	38	124	0	2	126	0	0
8	101726490	rs3133526	T	A	79	38	117	0	1	118	0	0
8	101726965	rs1786319	T	C	67	30	97	0	0	97	0	0
8	101728948	rs1693558	C	T	79	36	115	0	1	116	0	0
8	101731154	rs1786317	A	G	34	16	50	0	0	50	0	0
8	101733263	rs1786316	G	A	29	18	47	0	1	48	0	0
8	101934140	rs3134376	C	T	5	15	20	0	1	21	0	0
8	101934435	rs3134377	T	C	6	19	25	0	0	25	0	0
8	101937374	rs3105460	A	G	7	8	15	0	0	15	0	0
8	101937455	rs964917	T	C	14	12	26	0	0	26	0	0
8	101938901	rs17462921	G	A	13	4	17	0	0	17	0	0
8	101939479	rs1376672	G	A	18	19	37	0	0	37	0	0
8	101947336	rs3134352	C	G	7	19	26	0	1	27	0	0
8	101947453	rs3134353	A	T	3	3	6	0	0	6	0	0
8	101956226	rs4734499	G	A	2	4	6	0	0	6	0	0
8	101958433	rs3134358	G	T	0	8	8	0	0	8	0	0
8	101959609	rs1901362	G	A	7	9	16	0	0	16	0	0
8	101961910	rs983583	T	C	3	5	8	0	0	8	0	0
8	101962897	rs71506349	A	G	4	2	6	0	0	6	0	0
8	101962901	rs71506350	A	G	4	2	6	0	0	6	0	0
8	103218873	rs1265116	C	G	30	19	49	0	1	50	0	0
8	103251997	rs2853231	G	A	11	7	18	0	1	19	0	0
8	103255945	rs2853232	G	A	2	5	7	0	0	7	0	0
8	103265132	rs2853235	A	G	37	17	54	0	0	54	0	0
8	103268066	rs1993477	A	C	9	1	10	0	0	10	0	0
8	103268301	rs2168690	A	G	6	1	7	0	0	7	0	0
8	103282518	rs2978431	A	G	9	2	11	0	0	11	0	0
8	103283313	rs3018508	C	T	8	5	13	0	0	13	0	0
8	103300771	rs2925781	T	C	9	4	13	0	0	13	0	0
8	103313114	rs76081441	A	G	6	5	11	0	0	11	0	0
8	103356239	rs117695477	G	A	3	6	9	0	0	9	0	0
8	103418351	rs10109588	A	T	5	1	6	0	0	6	0	0
8	103847399	rs2916558	A	C	3	3	6	0	0	6	0	0
8	104004679	rs677398	C	T	4	2	6	0	0	6	0	0
8	104005559	rs504467	T	C	3	6	9	0	0	9	0	0
8	104007506	rs613121	C	T	9	2	11	0	0	11	0	0
8	104007996	rs615348	A	T	5	4	9	0	0	9	0	0
8	104008681	rs628793	G	A	6	1	7	0	0	7	0	0
8	104008940	rs488420	A	T	6	7	13	0	0	13	0	0
8	104009041	rs630236	G	A	5	5	10	0	0	10	0	0
8	104009578	rs642994	C	G	6	2	8	0	0	8	0	0
8	104009880	rs644305	G	A	7	3	10	0	0	10	0	0
8	104081226	rs8079	A	G	5	5	10	0	0	10	0	0
8	104082411	rs4734684	G	A	7	7	14	0	0	14	0	0
8	104210367	rs62528474	A	G	14	0	14	0	0	14	0	0
8	104227660	rs144697208	G	C	17	2	19	0	0	19	0	0
8	104229824	rs17799604	C	T	1	9	10	0	0	10	0	0
8	104231944	rs9656787	C	A	1	18	19	0	0	19	0	0
8	104232037	rs17205332	T	C	0	17	17	0	0	17	0	0
8	104233228	rs62525464	A	G	8	0	8	0	0	8	0	0
8	104234377	rs59299635	A	G	10	0	10	0	0	10	0	0
8	104234512	rs34111666	A	G	10	0	10	0	0	10	0	0
8	104235770	rs62525466	G	A	10	1	11	0	0	11	0	0
8	104238747	rs4734693	T	C	0	13	13	0	0	13	0	0
8	104297832	rs1568641	T	G	6	22	28	0	1	29	0	0
8	104326806	rs827543	T	C	2	4	6	0	0	6	0	0
8	104331088	rs3104026	G	C	2	4	6	0	0	6	0	0
8	104332200	rs827554	T	C	3	3	6	0	0	6	0	0
8	104335970	rs827552	T	C	6	6	12	0	0	12	0	0
8	104336166	rs827551	G	T	6	3	9	0	0	9	0	0
8	104343362	rs3116469	G	A	2	4	6	0	1	7	0	0
8	104343822	rs2934725	A	G	30	51	81	0	0	81	0	0
8	104344790	rs2687355	T	C	74	120	194	0	2	196	0	0
8	104415118	rs3133810	C	T	18	4	22	0	0	22	0	0
8	104416252	rs17228841	T	C	9	12	21	0	0	21	0	0
8	104416833	rs1865855	A	C	12	5	17	0	0	17	0	0
8	104417045	rs17803441	C	T	28	55	83	0	0	83	0	0
8	104427541	rs3134296	C	T	9	6	15	0	0	15	0	0
8	104432631	rs3098238	T	C	26	67	93	0	1	94	0	0
8	104435201	rs117739694	A	C	5	8	13	0	0	13	0	0
8	104435202	rs3098235	G	C	5	7	12	0	1	13	0	0
8	104435537	rs3134257	C	A	4	11	15	0	0	15	0	0
8	104435905	rs3098234	C	A	4	3	7	0	0	7	0	0
8	106620033	rs71522749	A	G	4	2	6	0	0	6	0	0
8	106620043	rs71522750	A	G	5	3	8	0	0	8	0	0
8	107284715	rs11549658	T	C	43	22	65	0	1	66	0	0
8	107708086	rs76580505	G	A	1	8	9	0	1	10	0	0
8	107713210	.	T	A	9	7	16	0	0	16	0	0
8	107754715	rs28924691	C	A	1	7	8	0	0	8	0	0
8	109213893	rs603571	A	C	4	3	7	0	0	7	0	0
8	109215368	rs630492	T	C	23	29	52	0	0	52	0	0
8	109215910	rs617285	T	C	10	2	12	0	0	12	0	0
8	109227406	rs609102	A	G	9	4	13	0	0	13	0	0
8	109227570	rs859788	A	G	24	6	30	0	0	30	0	0
8	109227585	rs859787	C	T	23	6	29	0	0	29	0	0
8	109227822	rs651951	C	G	25	8	33	0	0	33	0	0
8	109227826	rs610873	A	G	24	9	33	0	0	33	0	0
8	109228008	rs611744	A	G	12	11	23	0	0	23	0	0
8	109229243	rs635219	C	T	16	17	33	0	0	33	0	0
8	109230383	rs653081	G	T	10	10	20	0	0	20	0	0
8	109231948	rs608115	T	A	5	5	10	0	0	10	0	0
8	109233239	rs686630	G	C	3	5	8	0	0	8	0	0
8	109233433	rs559089	A	G	5	3	8	0	0	8	0	0
8	109233591	rs142194329	G	T	5	2	7	0	0	7	0	0
8	109234035	.	G	A	4	6	10	0	0	10	0	0
8	109234825	rs639746	T	C	7	2	9	0	0	9	0	0
8	109235569	rs636399	G	A	8	0	8	0	0	8	0	0
8	109235858	rs475865	G	C	6	1	7	0	0	7	0	0
8	109242730	rs678387	G	C	6	5	11	0	1	12	0	0
8	109242803	rs674391	T	A	31	26	57	0	1	58	0	0
8	109242981	rs633901	G	T	14	14	28	0	0	28	0	0
8	109244742	rs679077	G	T	8	7	15	0	0	15	0	0
8	109245497	rs585077	C	T	19	9	28	0	0	28	0	0
8	109252554	rs702808	T	C	7	4	11	0	0	11	0	0
8	109254003	rs667742	T	C	7	2	9	0	0	9	0	0
8	109254677	rs627392	C	T	50	22	72	0	3	75	0	0
8	109254842	rs579162	A	G	55	43	98	0	1	99	0	0
8	109255032	rs681963	C	A	49	24	73	0	2	75	0	0
8	109255206	rs629996	C	T	63	38	101	0	0	101	0	0
8	109255727	rs678820	G	A	33	15	48	0	0	48	0	0
8	109255732	rs639609	C	T	31	15	46	0	0	46	0	0
8	109255989	rs2594357	A	G	24	17	41	0	0	41	0	0
8	109256014	rs2597658	C	T	22	10	32	0	0	32	0	0
8	109256018	rs2594358	A	G	24	10	34	0	0	34	0	0
8	109258333	rs13251024	T	C	33	15	48	0	0	49	1	0
8	109260776	rs4735053	A	G	14	10	24	0	0	24	0	0
8	109488937	rs1871685	A	G	4	2	6	0	0	6	0	0
8	110283256	rs11550169	T	C	38	10	48	0	0	48	0	0
8	110283353	rs34660136	T	G	36	9	45	0	0	45	0	0
8	110301998	rs2980618	T	C	29	11	40	0	0	40	0	0
8	110302047	rs2980619	T	G	25	7	32	0	0	32	0	0
8	110350921	rs34824085	A	G	3	7	10	0	0	10	0	0
8	110353218	rs2980575	A	G	5	19	24	0	0	24	0	0
8	110354394	.	T	C	4	12	16	0	3	19	0	0
8	110357309	rs9297424	C	G	122	232	354	0	1	355	0	0
8	110552577	rs1044230	T	C	10	13	23	0	0	23	0	0
8	110556883	rs2703389	G	C	9	1	10	0	0	10	0	0
8	116535911	rs76796524	C	T	2	5	7	0	0	7	0	0
8	117858389	rs4570	G	A	326	143	469	0	2	472	1	0
8	117860152	rs16888887	T	C	25	17	42	0	0	42	0	0
8	117861516	rs2289938	T	C	30	29	59	0	0	59	0	0
8	117864217	rs1050838	A	G	373	208	581	0	3	584	0	0
8	117869549	.	A	G	142	287	429	0	7	437	1	0
8	117877476	rs12550234	T	C	4	2	6	0	0	6	0	0
8	118532964	rs6469696	A	G	5	7	12	0	0	12	0	0
8	118544068	rs10505294	A	T	3	4	7	0	0	7	0	0
8	118551305	rs6987041	A	G	2	4	6	0	0	6	0	0
8	118551613	rs7007867	T	C	1	8	9	0	0	9	0	0
8	119111527	rs10505327	T	C	8	23	31	0	0	31	0	0
8	119112250	rs2451133	T	C	7	2	9	0	0	9	0	0
8	120429024	rs2279112	G	A	0	7	7	0	0	7	0	0
8	120435705	rs11785549	T	C	5	14	19	0	0	19	0	0
8	120435733	rs11775043	A	G	5	16	21	0	0	21	0	0
8	120435812	rs2071518	C	T	18	31	49	0	0	49	0	0
8	120435908	rs2071519	A	G	16	26	42	0	0	42	0	0
8	120436403	rs10575	C	T	26	29	55	0	0	55	0	0
8	120436418	rs1057732	T	C	25	31	56	0	1	57	0	0
8	120436486	rs14324	C	T	12	13	25	0	0	25	0	0
8	120436541	rs11526	T	C	7	13	20	0	0	20	0	0
8	120575184	rs1058913	G	A	21	40	61	0	1	62	0	0
8	120602788	rs149223629	T	C	9	22	31	0	0	31	0	0
8	120745357	rs13261032	C	A	4	11	15	0	0	15	0	0
8	120745663	rs13262434	G	T	4	10	14	0	1	15	0	0
8	120747498	rs192911200	T	C	9	0	9	0	1	10	0	0
8	120748454	rs2043431	A	G	4	4	8	0	0	8	0	0
8	120751012	rs9297604	T	C	1	6	7	0	0	7	0	0
8	120759910	rs10086913	C	G	4	3	7	0	0	7	0	0
8	120790304	rs1509348	T	C	24	32	56	0	1	57	0	0
8	120803637	rs9297605	C	G	19	33	52	0	1	53	0	0
8	120813879	rs28715681	A	T	8	9	17	0	0	17	0	0
8	120814020	rs7813438	A	G	7	11	18	0	0	18	0	0
8	120815404	rs28756749	T	C	7	12	19	0	0	19	0	0
8	120817599	rs7829198	C	T	4	9	13	0	0	13	0	0
8	120818026	rs7833490	G	A	13	8	21	0	0	21	0	0
8	120818483	rs4871634	G	A	10	10	20	0	0	20	0	0
8	120824357	rs6989791	T	G	2	6	8	0	0	8	0	0
8	120846589	rs14027	G	A	11	41	52	0	1	53	0	0
8	120847078	rs1055133	C	G	6	9	15	0	1	16	0	0
8	120847123	rs1055131	C	T	12	15	27	0	1	28	0	0
8	120847188	rs1055130	T	C	16	36	52	0	0	52	0	0
8	120851405	rs7813680	C	T	0	6	6	0	0	6	0	0
8	120852100	rs3812463	C	T	4	7	11	0	0	11	0	0
8	120857083	rs71532474	A	G	3	3	6	0	0	6	0	0
8	120940652	rs16893299	C	T	15	30	45	0	1	46	0	0
8	121062976	rs6985424	C	T	25	46	71	0	1	72	0	0
8	121067240	rs4871828	A	G	5	2	7	0	0	7	0	0
8	121488835	rs138990349	A	T	4	3	7	0	0	7	0	0
8	121583488	rs72680558	T	C	5	3	8	0	0	8	0	0
8	121583533	rs72680559	G	A	7	5	12	0	0	12	0	0
8	121583562	rs72680560	C	T	6	4	10	0	0	10	0	0
8	121583603	rs72680561	G	A	7	4	11	0	0	11	0	0
8	121583635	rs73707305	G	T	4	3	7	0	0	7	0	0
8	121642050	rs4364672	T	G	4	2	6	0	0	6	0	0
8	121642058	rs10108624	C	A	5	2	7	0	0	7	0	0
8	121651042	rs62526712	C	T	10	1	11	0	0	11	0	0
8	121651106	rs28863871	C	T	7	2	9	0	0	9	0	0
8	121651676	rs112126092	T	G	6	3	9	0	0	9	0	0
8	121948558	rs4871140	A	G	14	16	30	0	0	30	0	0
8	123796334	rs13282466	T	C	0	10	10	0	0	10	0	0
8	123801257	rs4871304	T	C	2	7	9	0	0	9	0	0
8	124025682	rs7160	C	A	39	53	92	0	0	92	0	0
8	124027628	rs7159	T	C	259	451	710	0	2	712	0	0
8	124028479	rs11781842	G	A	6	10	16	0	0	16	0	0
8	124028631	rs10090419	A	G	11	8	19	0	0	19	0	0
8	124032259	rs4871338	G	A	22	13	35	0	1	36	0	0
8	124033036	.	C	A	8	2	10	0	0	10	0	0
8	124034342	rs11782469	C	T	13	18	31	0	0	31	0	0
8	124036277	rs2385078	T	C	17	6	23	0	0	23	0	0
8	124036956	rs13259131	C	T	14	25	39	0	0	39	0	0
8	124037435	rs3765210	A	T	6	8	14	0	0	14	0	0
8	124038045	rs12677755	A	G	2	8	10	0	0	10	0	0
8	124038055	rs13271447	T	A	2	8	10	0	0	10	0	0
8	124039487	rs28588315	C	T	5	1	6	0	0	6	0	0
8	124039750	rs13280996	A	G	5	8	13	0	0	13	0	0
8	124040062	rs12674841	G	A	2	4	6	0	0	6	0	0
8	124049057	rs13255713	C	T	3	3	6	0	0	6	0	0
8	124142489	rs2272724	T	C	9	20	29	0	0	29	0	0
8	124346818	rs75546871	A	G	6	6	12	0	0	12	0	0
8	124353068	.	G	C	18	31	49	0	0	49	0	0
8	124513882	rs73330046	A	C	12	19	31	0	0	31	0	0
8	124514183	rs3739286	T	C	16	7	23	0	0	23	0	0
8	124514400	rs3739284	C	T	25	24	49	0	0	49	0	0
8	124514716	rs4871383	T	C	25	17	42	0	0	42	0	0
8	124514769	rs1048515	A	G	16	19	35	0	0	35	0	0
8	124516813	rs73330050	G	A	1	6	7	0	0	7	0	0
8	124780824	rs12334564	C	A	9	23	32	0	0	32	0	0
8	124782340	rs10956148	G	A	1	5	6	0	0	6	0	0
8	124798276	rs12549683	G	C	40	17	57	0	1	58	0	0
8	124803697	rs9297675	A	T	3	3	6	0	0	6	0	0
8	124803962	rs7827025	A	G	3	3	6	0	0	6	0	0
8	124804190	rs7827665	G	A	7	1	8	0	0	8	0	0
8	124807809	rs66515434	C	T	5	8	13	0	1	14	0	0
8	124807908	rs73337418	G	A	5	4	9	0	0	9	0	0
8	124807975	rs67139073	G	C	2	6	8	0	0	8	0	0
8	124812933	rs6470186	T	C	6	4	10	0	0	10	0	0
8	124814481	rs4871415	C	T	5	5	10	0	0	10	0	0
8	124816862	rs9918907	A	G	4	3	7	0	0	7	0	0
8	124821713	rs6985019	G	A	9	5	14	0	0	14	0	0
8	124821884	rs6998271	A	G	15	5	20	0	0	20	0	0
8	124822144	rs13278088	T	A	4	2	6	0	0	6	0	0
8	124822969	rs7833650	C	T	46	25	71	0	0	71	0	0
8	124823777	rs13252451	A	G	38	20	58	0	0	58	0	0
8	124824581	rs2060112	C	T	58	16	74	0	0	74	0	0
8	124826804	rs9656947	G	T	472	230	702	0	9	711	0	0
8	125319458	rs72721434	T	C	24	43	67	0	0	67	0	0
8	125319976	rs4592012	G	A	8	3	11	0	0	11	0	0
8	125463098	rs3812474	A	T	5	6	11	0	1	12	0	0
8	125463250	rs3812475	T	C	4	26	30	0	0	30	0	0
8	125463544	rs11556913	T	C	6	23	29	0	0	29	0	0
8	125485480	rs117257413	G	A	15	23	38	0	0	38	0	0
8	125486767	rs3812472	A	G	1	5	6	0	0	6	0	0
8	125498547	rs3812471	C	T	165	258	423	0	2	425	0	0
8	125551364	rs34681068	A	G	20	65	85	0	0	85	0	0
8	125563769	rs1131024	A	G	20	41	61	0	0	61	0	0
8	125565328	rs3829037	T	C	75	247	322	0	0	322	0	0
8	125565978	rs13269215	C	T	1	8	9	0	0	9	0	0
8	125569380	rs16899688	C	A	6	5	11	0	0	11	0	0
8	125569683	rs7841224	A	G	13	4	17	0	0	17	0	0
8	125570554	rs6470248	A	C	8	17	25	0	2	27	0	0
8	125570729	rs7830235	T	A	2	13	15	0	0	15	0	0
8	125571412	rs17298759	A	C	6	11	17	0	0	17	0	0
8	125571478	rs3793397	G	T	13	4	17	0	0	17	0	0
8	125571483	rs3793398	C	T	12	3	15	0	0	15	0	0
8	125571747	rs6470250	T	C	15	8	23	0	0	23	0	0
8	125571856	rs4489311	C	T	11	6	17	0	0	17	0	0
8	125571968	rs76933982	C	A	9	11	20	0	0	20	0	0
8	125571973	rs77422927	T	C	8	9	17	0	1	18	0	0
8	125572179	rs78402756	T	C	4	17	21	0	0	21	0	0
8	125572233	rs17298884	G	A	3	13	16	0	0	16	0	0
8	125573374	rs17298912	A	G	7	4	11	0	0	11	0	0
8	125573401	rs112385015	G	A	5	4	9	0	0	9	0	0
8	125573770	rs3763542	C	T	5	2	7	0	0	7	0	0
8	125574613	rs17299030	G	A	1	5	6	0	0	6	0	0
8	125574913	rs7015228	G	C	8	2	10	0	0	10	0	0
8	125575323	rs2303955	T	C	9	3	12	0	0	12	0	0
8	125575803	rs11783209	A	G	6	0	6	0	0	6	0	0
8	125576963	rs13255599	C	T	6	4	10	0	0	10	0	0
8	125577050	rs13256399	G	T	3	3	6	0	0	6	0	0
8	125578501	rs4870904	A	G	2	5	7	0	0	7	0	0
8	125580928	rs2288664	A	G	5	12	17	0	0	17	0	0
8	125581166	rs2288663	G	A	2	5	7	0	0	7	0	0
8	125588934	rs17372350	T	C	1	6	7	0	0	7	0	0
8	125592443	rs1134893	C	T	3	5	8	0	0	8	0	0
8	125606782	rs4007927	C	A	4	3	7	0	0	7	0	0
8	125703560	rs7014786	A	C	16	49	65	0	0	65	0	0
8	125703708	.	T	C	23	10	33	0	0	33	0	0
8	125707536	rs6998715	G	A	28	44	72	0	5	78	1	0
8	125707569	rs10956195	A	C	33	47	80	0	2	82	0	0
8	125707738	rs11776802	T	C	23	49	72	0	3	75	0	0
8	125708200	rs61510689	G	A	7	16	23	0	0	23	0	0
8	125708475	rs62530739	T	C	4	13	17	0	1	18	0	0
8	125708601	rs62530740	A	G	12	20	32	0	0	32	0	0
8	125709925	rs186557988	G	A	17	10	27	0	0	27	0	0
8	125990136	.	T	C	3	5	8	0	0	8	0	0
8	126032110	rs10113457	C	A	6	5	11	0	0	11	0	0
8	126032500	rs60909322	A	T	1	5	6	0	0	6	0	0
8	126032682	rs2033130	G	A	6	2	8	0	0	8	0	0
8	126034410	rs9940	A	G	32	9	41	0	0	41	0	0
8	126037033	rs17398450	A	G	12	24	36	0	0	36	0	0
8	126040573	rs7007960	C	T	3	3	6	0	0	6	0	0
8	126040625	rs57886679	G	A	3	3	6	0	0	6	0	0
8	126041821	rs4007685	C	G	7	10	17	0	0	17	0	0
8	126042041	rs6989560	G	A	13	9	22	0	0	22	0	0
8	126044264	rs3750237	A	C	11	7	18	0	0	18	0	0
8	126044437	rs17398660	G	A	8	16	24	0	0	24	0	0
8	126047161	.	T	C	12	13	25	0	0	25	0	0
8	126047856	rs2288311	G	T	21	8	29	0	0	29	0	0
8	126049191	rs13257850	A	G	10	5	15	0	0	15	0	0
8	126051500	rs6470329	A	C	8	0	8	0	0	8	0	0
8	126052350	rs2303530	T	C	5	3	8	0	0	8	0	0
8	126082491	.	T	G	2	11	13	0	0	13	0	0
8	126085363	rs10102230	T	C	2	5	7	0	0	7	0	0
8	126325828	rs17403341	G	C	3	4	7	0	0	7	0	0
8	126360798	rs11776254	G	A	5	1	6	0	0	6	0	0
8	126442726	rs3201475	C	T	50	112	162	0	9	171	0	0
8	126442934	rs2280826	T	C	22	45	67	0	0	67	0	0
8	126444463	rs4421363	C	T	4	6	10	0	0	10	0	0
8	126444788	rs2980874	G	A	4	4	8	0	0	8	0	0
8	126445505	rs13277396	G	C	2	12	14	0	1	15	0	0
8	126447308	rs2385114	C	T	24	36	60	0	0	60	0	0
8	126447844	rs55709232	C	G	15	35	50	0	0	50	0	0
8	126448789	rs2235108	G	A	205	408	613	0	3	616	0	0
8	126960818	rs6470397	A	G	5	3	8	0	0	8	0	0
8	126960819	rs6470398	T	A	5	3	8	0	0	8	0	0
8	127567870	.	A	G	17	56	73	0	1	74	0	0
8	127570511	rs2290840	T	G	20	45	65	0	0	65	0	0
8	128748385	rs4645946	G	A	5	11	16	0	0	16	0	0
8	128751563	rs4645963	C	T	4	8	12	0	0	12	0	0
8	128904964	.	G	A	5	5	10	0	2	12	0	0
8	128906787	rs6999585	T	C	6	12	18	0	0	18	0	0
8	128906788	rs7017386	C	T	6	12	18	0	0	18	0	0
8	128909273	rs61029984	C	G	10	15	25	0	1	26	0	0
8	129009814	rs34575579	C	T	1	6	7	0	0	7	0	0
8	129009922	rs13328406	A	C	5	2	7	0	0	7	0	0
8	129010590	rs10283090	C	A	11	2	13	0	0	13	0	0
8	129014660	rs4733587	T	C	6	0	6	0	0	6	0	0
8	129108823	rs11604	C	T	45	61	106	0	3	109	0	0
8	129113373	rs10453	C	T	76	54	130	0	0	130	0	0
8	130860941	rs189990990	C	A	28	13	41	0	0	41	0	0
8	131012487	rs7016345	C	T	1	5	6	0	0	6	0	0
8	131019647	rs7016267	C	T	4	4	8	0	0	8	0	0
8	131022475	rs7003672	C	G	6	4	10	0	0	10	0	0
8	131024198	rs6995968	T	C	4	5	9	0	1	10	0	0
8	131065153	rs4236749	C	T	74	45	119	0	0	119	0	0
8	131320963	rs12679283	A	G	4	3	7	0	0	7	0	0
8	131332667	rs9643252	G	A	17	3	20	0	1	21	0	0
8	131332932	rs2791346	A	T	11	6	17	0	0	17	0	0
8	131335663	rs16904249	A	G	6	1	7	0	0	7	0	0
8	131339373	rs7460225	C	T	3	5	8	0	0	8	0	0
8	131339554	rs2670881	A	C	3	5	8	0	0	8	0	0
8	131344745	rs7008182	T	A	3	6	9	0	0	9	0	0
8	131345906	rs2791349	A	C	31	50	81	0	2	84	1	0
8	131346066	rs6470814	A	G	214	326	540	0	4	544	0	0
8	131347799	rs6470815	T	C	9	33	42	0	0	42	0	0
8	131348360	rs1538728	A	G	8	31	39	0	1	40	0	0
8	131349110	rs1123205	C	G	12	24	36	0	0	36	0	0
8	131349318	rs1340021	C	G	14	22	36	0	0	36	0	0
8	131349715	rs6470816	C	T	12	11	23	0	0	23	0	0
8	131352586	rs1417007	C	G	6	13	19	0	0	19	0	0
8	131353139	rs13265869	T	C	8	16	24	0	0	24	0	0
8	131353734	rs11779014	A	G	6	8	14	0	0	14	0	0
8	131354091	rs11786705	G	A	6	9	15	0	0	15	0	0
8	131356001	rs1340020	T	G	6	7	13	0	0	13	0	0
8	131356047	rs1340019	A	G	7	5	12	0	0	12	0	0
8	131356392	rs13258946	A	C	4	11	15	0	0	15	0	0
8	131357391	rs10109236	T	C	5	11	16	0	0	16	0	0
8	131358612	rs9297806	C	T	5	12	17	0	0	17	0	0
8	131359869	rs6415512	C	G	5	5	10	0	0	10	0	0
8	131361477	rs7018225	C	T	1	11	12	0	0	12	0	0
8	131363241	rs2791354	G	A	3	5	8	0	0	8	0	0
8	131366887	rs11784041	T	G	1	10	11	0	0	11	0	0
8	131367481	rs4574884	A	G	2	4	6	0	0	6	0	0
8	131368011	rs6999216	T	A	2	7	9	0	1	10	0	0
8	132935380	rs79685424	T	A	2	11	13	0	0	13	0	0
8	133012216	rs1062064	G	T	6	6	12	0	0	12	0	0
8	133012442	rs57043549	T	C	8	2	10	0	0	10	0	0
8	133012761	rs16904571	T	A	3	4	7	0	0	7	0	0
8	133020382	rs6993606	A	C	6	2	8	0	0	8	0	0
8	133021149	rs28562159	G	A	2	4	6	0	0	6	0	0
8	133025671	rs8859	C	G	3	13	16	0	0	16	0	0
8	133637659	rs2293979	G	A	6	3	9	0	0	9	0	0
8	133722281	rs1048490	T	C	8	8	16	0	0	16	0	0
8	133723166	rs1895807	A	G	19	10	29	0	0	29	0	0
8	133753856	rs2911949	C	G	5	1	6	0	1	7	0	0
8	133753884	rs2467965	T	C	7	0	7	0	0	7	0	0
8	133753967	rs2467964	A	G	8	0	8	0	0	8	0	0
8	133770287	rs2467961	G	A	4	2	6	0	0	6	0	0
8	133770740	rs2553606	T	C	6	0	6	0	0	6	0	0
8	133788557	rs7827212	A	G	2	7	9	0	0	9	0	0
8	133805463	rs1469263	T	G	3	4	7	0	0	7	0	0
8	133808415	rs2553587	A	G	8	12	20	0	0	20	0	0
8	133809975	rs2245068	T	G	5	11	16	0	1	17	0	0
8	133811435	rs2244885	T	A	14	16	30	0	0	30	0	0
8	133815576	rs235427	A	G	4	12	16	0	0	16	0	0
8	133815671	rs7830984	T	C	5	5	10	0	0	10	0	0
8	133815726	rs235428	G	A	7	7	14	0	0	14	0	0
8	133819075	rs235429	A	T	8	8	16	0	0	16	0	0
8	133822535	rs235431	C	G	3	4	7	0	0	7	0	0
8	133824377	rs235432	C	A	14	21	35	0	0	35	0	0
8	133837802	rs235442	A	G	4	15	19	0	0	19	0	0
8	133844508	rs16904746	C	T	56	82	138	0	2	140	0	0
8	133845690	rs193066250	T	G	11	4	15	0	0	15	0	0
8	133845827	rs10092556	A	G	4	9	13	0	0	13	0	0
8	133846090	rs941396	C	T	10	5	15	0	0	15	0	0
8	133846645	rs2223130	C	T	5	2	7	0	0	7	0	0
8	133847545	rs4736610	A	G	3	7	10	0	0	10	0	0
8	133847947	rs28500471	C	T	2	5	7	0	0	7	0	0
8	133848396	rs10101478	G	A	1	6	7	0	0	7	0	0
8	133853813	rs17609732	A	G	1	5	6	0	0	6	0	0
8	133859086	rs574540178	A	T	52	28	80	0	2	82	0	0
8	134055031	rs2741191	T	C	11	6	17	0	0	17	0	0
8	134055485	rs2702996	T	C	3	9	12	0	0	12	0	0
8	134056899	rs2687837	T	C	4	2	6	0	0	6	0	0
8	134060718	rs3779962	G	A	4	7	11	0	0	11	0	0
8	134061060	rs2253035	G	C	8	3	11	0	0	11	0	0
8	134064152	rs1533910	C	T	12	6	18	0	0	18	0	0
8	134064773	rs2252553	G	T	3	4	7	0	0	7	0	0
8	134065794	rs4736619	G	A	13	3	16	0	0	16	0	0
8	134065873	rs10099615	G	A	3	5	8	0	0	8	0	0
8	134068748	rs2702967	G	A	5	7	12	0	0	12	0	0
8	134069420	rs17695552	T	C	6	1	7	0	0	7	0	0
8	134070061	rs10087449	C	A	3	4	7	0	0	7	0	0
8	134073280	rs3758112	G	A	4	9	13	0	0	13	0	0
8	134073815	rs72729520	G	A	6	0	6	0	0	6	0	0
8	134075411	rs4736621	T	C	9	1	10	0	0	10	0	0
8	134083593	rs28445135	T	C	3	4	7	0	0	7	0	0
8	134083730	rs17623738	T	C	4	7	11	0	0	11	0	0
8	134083802	rs2739149	C	G	6	2	8	0	0	8	0	0
8	134083839	rs12545138	C	A	5	1	6	0	0	6	0	0
8	134084369	rs2739150	C	T	4	5	9	0	0	9	0	0
8	134084432	rs2739151	C	T	3	5	8	0	0	8	0	0
8	134084800	rs2703004	G	A	2	6	8	0	0	8	0	0
8	134085103	rs2739152	G	T	1	5	6	0	0	6	0	0
8	134085353	rs2244716	C	T	32	43	75	0	0	75	0	0
8	134144113	rs2294024	C	T	5	6	11	0	0	11	0	0
8	134250430	rs1049694	C	T	455	237	692	0	3	695	0	0
8	134252732	rs3779945	C	G	5	3	8	0	0	8	0	0
8	134254797	rs2929978	C	G	7	3	10	0	0	10	0	0
8	134262915	rs36076004	C	T	7	0	7	0	0	7	0	0
8	134264646	rs62514042	C	T	1	7	8	0	0	8	0	0
8	134264993	rs7816917	G	A	5	1	6	0	1	7	0	0
8	134264996	rs7835058	T	C	5	1	6	0	0	6	0	0
8	134267721	rs16904874	C	T	14	27	41	0	0	41	0	0
8	134267762	rs3824240	T	C	20	28	48	0	0	48	0	0
8	134267870	rs35927571	C	T	26	16	42	0	0	42	0	0
8	134268306	rs3779935	G	C	16	40	56	0	0	56	0	0
8	134270126	rs62514047	T	A	2	8	10	0	0	10	0	0
8	134270303	rs1060401	C	T	9	15	24	0	0	24	0	0
8	134488007	rs2230542	G	A	35	36	71	0	1	72	0	0
8	134488549	rs1048471	T	C	26	28	54	0	0	54	0	0
8	134572959	rs72720289	G	C	16	11	27	0	0	27	0	0
8	135490539	rs11538239	A	G	7	11	18	0	0	18	0	0
8	135614972	rs3739422	A	G	3	4	7	0	0	7	0	0
8	140743200	rs199226	G	A	29	29	58	0	7	65	0	0
8	140915017	rs10107700	C	G	6	1	7	0	0	7	0	0
8	140917457	rs1075493	T	C	6	2	8	0	0	8	0	0
8	140917576	rs7825905	C	T	5	3	8	0	0	8	0	0
8	140921688	rs62526977	A	G	5	1	6	0	0	6	0	0
8	141105532	rs80162190	A	G	0	9	9	0	0	9	0	0
8	141106204	rs4289794	T	C	0	12	12	0	0	12	0	0
8	141262869	rs11166964	C	T	6	2	8	0	1	9	0	0
8	141263015	rs11166965	G	A	25	14	39	0	0	39	0	0
8	141460395	rs11166981	C	G	12	18	30	0	0	30	0	0
8	141461062	rs3735803	G	A	18	36	54	0	1	55	0	0
8	141462153	rs10106245	A	G	5	1	6	0	0	6	0	0
8	141462169	rs10106253	A	G	5	1	6	0	0	6	0	0
8	141467018	rs2977493	C	T	14	31	45	0	0	45	0	0
8	141467019	rs2948173	T	C	14	30	44	0	1	45	0	0
8	141516724	rs11774952	A	G	1	5	6	0	0	6	0	0
8	141516993	rs11775712	A	G	4	5	9	0	0	9	0	0
8	141517388	rs13264648	G	A	1	8	9	0	0	9	0	0
8	141518037	rs1057083	A	C	3	3	6	0	0	6	0	0
8	141525465	rs2231527	T	C	93	161	254	0	7	261	0	0
8	141526038	rs4246131	T	C	11	46	57	0	2	59	0	0
8	141526231	rs4961323	C	T	50	90	140	0	6	146	0	0
8	141526311	rs182567405	G	A	104	230	334	0	9	343	0	0
8	141526985	rs10216653	G	C	12	32	44	0	0	44	0	0
8	141532648	rs201091986	T	C	11	1	12	0	3	16	1	0
8	141533818	rs11595	A	G	7	20	27	0	0	27	0	0
8	141537406	rs2235117	T	C	9	5	14	0	1	15	0	0
8	141538846	rs2977453	T	C	4	2	6	0	0	6	0	0
8	141545193	rs2977464	C	T	3	3	6	0	0	6	0	0
8	141545954	rs2280833	T	C	2	4	6	0	0	6	0	0
8	141546602	rs2977466	T	C	4	2	6	0	0	6	0	0
8	141548419	rs2944772	C	G	7	2	9	0	0	9	0	0
8	141606989	rs4961271	C	T	2	6	8	0	0	8	0	0
8	141607011	rs4961272	C	G	2	7	9	0	0	9	0	0
8	142139751	rs76072125	G	A	6	8	14	0	0	14	0	0
8	142146708	rs307772	T	C	61	43	104	0	0	104	0	0
8	142151713	rs307766	C	T	4	2	6	0	0	6	0	0
8	142152442	rs307765	A	G	11	7	18	0	0	18	0	0
8	142160172	rs2117148	T	C	4	4	8	0	0	8	0	0
8	142160829	rs35212078	T	G	2	12	14	0	0	14	0	0
8	142169759	rs28537120	A	G	3	3	6	0	0	6	0	0
8	142176507	rs412706	T	C	8	4	12	0	0	12	0	0
8	142178718	rs57171090	C	T	5	4	9	0	0	9	0	0
8	142179371	rs6993862	G	A	8	4	12	0	0	12	0	0
8	142182644	rs4961333	C	T	10	7	17	0	0	17	0	0
8	142182667	rs57258815	G	A	12	7	19	0	1	20	0	0
8	142185718	rs307733	T	C	6	3	9	0	0	9	0	0
8	142186573	rs307732	A	G	6	5	11	0	0	11	0	0
8	142186963	rs2241734	G	A	49	35	84	0	1	85	0	0
8	142188707	rs12674965	A	T	42	31	73	0	0	73	0	0
8	142191032	rs2278448	T	G	6	2	8	0	0	8	0	0
8	142192542	rs307740	G	A	151	10	161	0	0	161	0	0
8	142192569	rs307739	G	A	137	8	145	0	1	146	0	0
8	142194627	rs138814988	C	T	2	18	20	0	0	20	0	0
8	142202856	rs6990186	C	T	53	54	107	0	1	108	0	0
8	142202884	rs7014062	T	C	38	54	92	0	3	95	0	0
8	142203452	rs11784862	T	C	103	184	287	0	0	287	0	0
8	142204326	rs1045248	C	G	88	110	198	0	0	198	0	0
8	142205132	rs11579	G	A	257	390	647	0	3	650	0	0
8	142205237	rs9792	A	G	251	396	647	0	11	658	0	0
8	142218119	rs2288999	G	A	6	7	13	0	0	13	0	0
8	142221032	rs13724	C	T	53	114	167	0	6	173	0	0
8	142221361	rs3739241	C	G	37	94	131	0	0	131	0	0
8	142221414	rs3739240	G	A	49	85	134	0	2	136	0	0
8	142221874	rs3739239	A	G	4	27	31	0	0	31	0	0
8	142222374	rs7017848	A	G	22	33	55	0	0	55	0	0
8	142222445	rs3739238	T	C	20	34	54	0	0	54	0	0
8	142227592	rs10107024	T	C	2	12	14	0	0	14	0	0
8	142227854	rs9324542	T	A	4	7	11	0	0	11	0	0
8	142228809	rs753779	T	C	5	17	22	0	0	22	0	0
8	142228909	rs753778	G	A	6	11	17	0	0	17	0	0
8	142229891	rs2304279	A	G	3	8	11	0	0	11	0	0
8	142248454	rs55846720	G	A	19	4	23	0	0	23	0	0
8	142248526	rs28645241	C	T	5	11	16	0	0	16	0	0
8	142248944	rs28368589	C	T	2	10	12	0	1	13	0	0
8	142250794	rs10110009	G	A	5	3	8	0	0	8	0	0
8	142250950	rs10103294	T	C	2	7	9	0	0	9	0	0
8	142260162	rs12543661	C	T	5	3	8	0	0	8	0	0
8	142260232	rs4273887	G	T	5	2	7	0	0	7	0	0
8	142260880	rs12375300	C	T	7	3	10	0	0	10	0	0
8	142262413	rs10108156	G	A	8	3	11	0	0	11	0	0
8	142263393	rs7014583	T	C	3	4	7	0	0	7	0	0
8	142263891	rs7812916	T	C	6	2	8	0	0	8	0	0
8	142266108	rs111748779	C	T	2	5	7	0	0	7	0	0
8	142428554	rs76808808	G	A	3	5	8	0	0	8	0	0
8	142429028	rs77459385	A	G	4	9	13	0	0	13	0	0
8	142430457	rs78425073	T	G	8	13	21	0	0	21	0	0
8	142433871	rs7463766	A	G	5	2	7	0	0	7	0	0
8	142434862	rs79850270	T	C	5	1	6	0	0	6	0	0
8	143413136	rs10435683	C	T	6	7	13	0	0	13	0	0
8	143425720	rs10100935	T	C	6	20	26	0	0	26	0	0
8	143427178	rs33970858	C	G	2	4	6	0	0	6	0	0
8	143436034	rs7814359	A	G	5	10	15	0	0	15	0	0
8	143623459	rs34364916	G	T	4	20	24	0	0	24	0	0
8	143626033	rs9650581	G	C	4	5	9	0	0	9	0	0
8	143692781	rs77080405	C	T	6	12	18	0	1	19	0	0
8	143739020	rs1137522	A	C	10	8	18	0	1	19	0	0
8	143739162	rs1137521	C	T	6	4	10	0	0	10	0	0
8	143739343	rs13248524	T	C	14	3	17	0	0	17	0	0
8	143739435	rs11543967	C	T	19	6	25	0	0	25	0	0
8	143739647	rs4336593	G	T	8	8	16	0	0	16	0	0
8	143739731	rs4401833	A	T	6	9	15	0	1	16	0	0
8	143740167	rs1056012	A	G	9	5	14	0	0	14	0	0
8	143741381	rs4736362	G	A	5	1	6	0	0	6	0	0
8	143742112	rs4736363	C	A	5	4	9	0	1	10	0	0
8	143742113	rs4736364	C	T	5	5	10	0	0	10	0	0
8	143746701	rs3802232	A	G	5	3	8	0	0	8	0	0
8	143809193	rs2257840	C	T	2	5	7	0	0	7	0	0
8	143810819	rs6991446	T	C	4	3	7	0	0	7	0	0
8	143817806	rs2717598	C	T	22	13	35	0	1	36	0	0
8	144357205	rs34723570	G	C	6	1	7	0	0	7	0	0
8	144399833	rs138052800	C	T	13	9	22	0	0	22	0	0
8	144465918	rs11785598	C	T	24	39	63	0	0	63	0	0
8	144499131	rs11778587	C	T	2	6	8	0	0	8	0	0
8	144553138	rs374534	C	G	2	10	12	0	0	12	0	0
8	144553465	rs11136296	C	T	2	6	8	0	0	8	0	0
8	144553478	rs2956378	T	C	6	2	8	0	0	8	0	0
8	144554731	rs2004100	C	T	4	2	6	0	1	7	0	0
8	144554746	rs2004099	G	T	3	4	7	0	0	7	0	0
8	144639363	rs72691465	C	T	11	30	41	0	1	42	0	0
8	144639954	rs4266665	T	G	6	14	20	0	0	20	0	0
8	144641161	rs4292703	A	G	5	3	8	0	0	8	0	0
8	144641370	rs2305492	A	G	2	7	9	0	0	9	0	0
8	144643169	rs1545536	C	T	70	32	102	0	5	107	0	0
8	144649265	rs11785441	G	C	19	25	44	0	1	45	0	0
8	144650503	rs13271361	G	A	33	8	41	0	0	41	0	0
8	144650510	rs11136301	G	A	10	32	42	0	0	42	0	0
8	144650547	rs11136302	G	A	11	28	39	0	0	39	0	0
8	144723538	rs62522224	A	G	2	7	9	0	1	10	0	0
8	144732450	rs3750204	G	A	11	13	24	0	0	24	0	0
8	144733805	rs12679735	C	T	17	34	51	0	2	53	0	0
8	144901507	rs116975352	C	A	8	15	23	0	2	25	0	0
8	144901509	rs117297129	C	A	9	15	24	0	0	24	0	0
8	144993069	rs28455570	G	A	74	112	186	0	0	186	0	0
8	144995964	rs35139934	G	A	59	22	81	0	0	81	0	0
8	145531837	rs4256628	A	G	7	0	7	0	0	7	0	0
8	145536056	rs62530366	A	G	3	3	6	0	0	6	0	0
8	145544720	rs3890400	G	A	1	5	6	0	0	6	0	0
8	145545546	rs3757974	A	G	19	15	34	0	0	34	0	0
8	145545662	rs62530370	A	G	18	6	24	0	0	24	0	0
8	145545749	rs3757973	G	A	21	10	31	0	0	31	0	0
8	145545920	rs3757972	C	T	18	3	21	0	0	21	0	0
8	145545949	rs3757971	T	C	16	8	24	0	0	24	0	0
8	145546036	rs3757970	A	G	17	10	27	0	0	27	0	0
8	145547716	rs6988119	A	G	8	3	11	0	0	11	0	0
8	145584694	rs34383175	C	T	41	16	57	0	0	57	0	0
8	145620764	rs11556134	G	A	133	197	330	0	1	331	0	0
8	145622455	rs113296524	C	G	56	96	152	0	1	153	0	0
8	145651262	rs2272658	T	C	93	159	252	0	1	253	0	0
8	145651888	rs7842602	G	A	26	25	51	0	1	52	0	0
8	145652412	rs3929255	C	G	81	38	119	0	0	119	0	0
8	145653006	rs3735840	G	A	16	37	53	0	2	55	0	0
8	145653550	rs2291130	G	A	5	17	22	0	0	22	0	0
8	145654230	rs7341562	T	G	12	4	16	0	0	16	0	0
8	145654233	rs13253451	T	C	12	5	17	0	0	17	0	0
8	145654298	rs13273684	G	A	43	52	95	0	1	96	0	0
8	145656658	rs13258903	C	T	2	4	6	0	0	6	0	0
8	145657958	rs12542502	C	T	3	4	7	0	0	7	0	0
8	145658115	rs2620631	A	G	0	7	7	0	0	7	0	0
8	145658253	rs13270605	C	T	0	7	7	0	0	7	0	0
8	145658526	rs12542638	C	T	4	7	11	0	0	11	0	0
8	145661320	rs2721140	G	A	19	5	24	0	0	24	0	0
8	145661675	rs7830832	G	A	24	12	36	0	0	36	0	0
8	145662377	rs2242270	A	C	10	7	17	0	0	17	0	0
8	145662766	rs2242269	G	A	1	8	9	0	0	9	0	0
8	145663584	rs1011212	T	C	1	5	6	0	0	6	0	0
8	145663689	rs1011211	A	C	0	9	9	0	0	9	0	0
8	145665407	rs2229315	C	T	5	25	30	0	0	30	0	0
8	145665761	rs2229313	G	A	11	25	36	0	0	36	0	0
8	145666578	rs2242266	T	C	6	8	14	0	0	14	0	0
8	145666664	rs4925822	T	C	6	5	11	0	0	11	0	0
8	145668443	rs760477	G	A	6	0	6	0	0	6	0	0
8	145668481	rs2242263	C	T	7	0	7	0	0	7	0	0
8	145679125	rs531570927	A	C	42	17	59	0	0	59	0	0
8	145683531	.	G	A	14	11	25	0	0	25	0	0
8	145722497	rs141236578	C	A	8	26	34	0	1	35	0	0
8	145749480	.	C	A	25	12	37	0	0	37	0	0
8	145979138	rs35571769	C	T	40	19	59	0	2	61	0	0
8	146017032	rs2954657	C	T	68	31	99	0	0	99	0	0
8	146017534	rs200177451	G	A	5	7	12	0	0	12	0	0
8	146017782	rs2954658	C	T	37	18	55	0	1	56	0	0
8	146034379	rs2954668	T	C	12	3	15	0	0	15	0	0
8	146035358	rs2979082	A	G	6	6	12	0	0	12	0	0
8	146053628	rs1735425	G	C	3	3	6	0	0	6	0	0
8	146054703	rs1735157	C	T	5	9	14	0	1	15	0	0
8	146063418	rs148798608	G	A	78	94	172	0	0	172	0	0
8	146064103	rs2727230	G	A	69	79	148	0	2	150	0	0
8	146064154	rs2722490	T	C	54	57	111	0	0	111	0	0
8	146064157	rs1810387	G	C	54	55	109	0	1	110	0	0
8	146065173	rs1735166	A	G	38	39	77	0	1	78	0	0
8	146065452	rs1735167	C	T	27	40	67	0	0	67	0	0
8	146066031	rs1618523	C	T	26	59	85	0	0	85	0	0
8	146066053	rs1625919	T	C	24	64	88	0	1	89	0	0
8	146066418	rs2242650	T	C	36	40	76	0	1	77	0	0
8	146066508	rs2242651	T	C	27	46	73	0	0	73	0	0
8	146067054	rs1735169	G	A	50	45	95	0	1	96	0	0
8	146068322	rs9004	C	T	40	65	105	0	0	105	0	0
8	146070496	rs2727229	G	A	1	5	6	0	0	6	0	0
8	146072760	rs909245	G	A	1	6	7	0	0	7	0	0
8	146075832	rs1209881	T	G	17	38	55	0	0	55	0	0
8	146076708	rs1209879	C	T	53	141	194	0	0	194	0	0
8	146078864	rs1209874	C	T	21	38	59	0	0	59	0	0
8	146156247	rs3735789	C	A	25	19	44	0	0	44	0	0
8	146157339	rs3735787	T	C	15	4	19	0	0	19	0	0
8	146171437	rs3735785	A	G	10	4	14	0	0	14	0	0
8	146280802	rs6986329	C	T	171	211	382	0	2	384	0	0
9	14690	rs62530146	C	G	697	291	988	0	2	990	0	0
9	16295	.	T	C	7	1	8	0	0	8	0	0
9	17808	.	G	C	73	29	102	0	2	105	1	0
9	17829	.	G	A	57	14	71	0	0	71	0	0
9	17835	.	A	G	57	10	67	0	1	68	0	0
9	135808	rs372662961	G	C	4	3	7	0	0	7	0	0
9	303266	rs36066376	C	T	4	2	6	0	0	6	0	0
9	303396	rs10969094	C	T	6	2	8	0	0	8	0	0
9	303479	rs10757842	G	T	5	3	8	0	0	8	0	0
9	312124	rs2039045	T	C	21	44	65	0	0	65	0	0
9	313666	rs10813241	T	C	5	5	10	0	0	10	0	0
9	318153	rs1980876	A	G	3	3	6	0	0	6	0	0
9	334337	rs10970979	A	G	25	33	58	0	0	58	0	0
9	370244	rs913703	A	G	28	42	70	0	0	70	0	0
9	377111	rs10814431	G	C	17	31	48	0	0	48	0	0
9	380035	rs11790531	G	T	2	4	6	0	0	6	0	0
9	390512	rs2297075	C	T	25	32	57	0	1	58	0	0
9	392840	rs10973732	T	C	6	8	14	0	0	14	0	0
9	396881	.	A	G	30	49	79	0	0	79	0	0
9	433816	rs79332955	C	G	1	5	6	0	0	6	0	0
9	446352	rs10814952	G	C	3	3	6	0	0	6	0	0
9	457290	rs4740776	C	T	2	5	7	0	0	7	0	0
9	457366	rs868761	A	T	2	5	7	0	0	7	0	0
9	459024	rs7853027	T	C	4	6	10	0	0	10	0	0
9	459566	rs10814996	T	G	3	5	8	0	0	8	0	0
9	460036	rs4740781	C	T	2	5	7	0	0	7	0	0
9	460072	rs10758625	T	C	0	6	6	0	0	6	0	0
9	460325	rs10758627	C	T	4	7	11	0	0	11	0	0
9	460877	rs10814999	G	A	5	10	15	0	0	15	0	0
9	461133	rs10815000	G	C	3	5	8	0	0	8	0	0
9	461140	rs10815001	C	T	2	4	6	0	1	7	0	0
9	462759	rs7869992	A	G	10	9	19	0	0	19	0	0
9	463095	rs1329379	C	A	9	11	20	0	0	20	0	0
9	2146501	rs12349346	A	G	8	1	9	0	0	9	0	0
9	2153066	rs11792420	C	A	3	3	6	0	0	6	0	0
9	2153386	rs1590410	C	A	3	3	6	0	0	6	0	0
9	2172011	rs16937826	A	G	7	0	7	0	0	7	0	0
9	2172103	rs10965085	C	T	1	6	7	0	0	7	0	0
9	2180510	rs10965112	A	G	6	0	6	0	0	6	0	0
9	2193437	rs45616134	T	C	208	131	339	0	1	340	0	0
9	2644954	rs11789583	C	T	6	10	16	0	0	16	0	0
9	2651962	rs6145	G	T	5	4	9	0	0	9	0	0
9	2652301	rs17712698	T	C	5	8	13	0	0	13	0	0
9	2652589	rs35075133	C	T	3	8	11	0	0	11	0	0
9	2654419	rs8210	T	C	13	49	62	0	0	62	0	0
9	2654617	rs34318472	C	T	8	30	38	0	0	38	0	0
9	2655520	rs7040916	G	A	41	93	134	0	2	136	0	0
9	2655702	rs35456336	T	C	30	93	123	0	2	125	0	0
9	3220602	rs17658489	G	C	4	3	7	0	0	7	0	0
9	3257122	rs35483263	C	T	7	18	25	0	0	25	0	0
9	3670015	rs17729056	A	G	8	1	9	0	0	9	0	0
9	4711367	rs12256	T	C	59	31	90	0	0	90	0	0
9	4711440	rs6915	T	A	70	35	105	0	0	105	0	0
9	4726759	rs62544266	G	A	5	5	10	0	0	10	0	0
9	4727113	rs7862134	A	C	8	6	14	0	0	14	0	0
9	4738221	rs12380629	A	C	4	8	12	0	1	13	0	0
9	4738451	rs55800129	A	C	7	13	20	0	0	20	0	0
9	4739005	rs10974760	C	T	11	1	12	0	0	12	0	0
9	4739898	rs371053	A	G	5	1	6	0	0	6	0	0
9	4852599	rs10758656	A	G	5	1	6	0	0	6	0	0
9	4860300	rs15583	A	G	74	121	195	0	1	196	0	0
9	4860569	rs1260073	G	A	46	29	75	0	0	75	0	0
9	4860643	rs1053872	G	C	45	28	73	0	2	75	0	0
9	4860943	rs295918	A	G	21	31	52	0	0	52	0	0
9	4860980	rs1053889	G	A	27	18	45	0	0	45	0	0
9	5068178	rs547378966	A	C	8	0	8	0	0	8	0	0
9	5081780	rs2230724	G	A	29	57	86	0	0	86	0	0
9	5100628	rs7870694	T	C	5	5	10	0	0	10	0	0
9	5100862	rs7852755	C	T	6	1	7	0	0	7	0	0
9	5102190	rs2094392	C	G	4	7	11	0	0	11	0	0
9	5102560	rs12335663	C	T	11	2	13	0	1	14	0	0
9	5102910	rs7032780	G	C	11	23	34	0	0	34	0	0
9	5103067	rs111751030	G	A	28	4	32	0	1	33	0	0
9	5103450	rs7022333	A	G	15	4	19	0	0	19	0	0
9	5103942	rs11531774	C	T	6	14	20	0	0	20	0	0
9	5104574	rs7867965	G	T	5	7	12	0	0	12	0	0
9	5104640	rs6476940	G	A	7	10	17	0	0	17	0	0
9	5105140	rs7871704	G	A	3	12	15	0	1	16	0	0
9	5105645	rs2094620	C	T	9	12	21	0	1	22	0	0
9	5105651	rs2094621	G	C	8	13	21	0	0	21	0	0
9	5106023	rs2104685	A	T	8	26	34	0	0	34	0	0
9	5106648	rs10974964	C	T	32	14	46	0	0	46	0	0
9	5106775	rs12340894	C	A	30	22	52	0	0	52	0	0
9	5106904	rs73399345	A	T	13	25	38	0	0	38	0	0
9	5115588	rs145932125	T	G	4	3	7	0	0	7	0	0
9	5115591	rs140197847	A	G	4	3	7	0	0	7	0	0
9	5115684	rs55668727	G	A	8	6	14	0	0	14	0	0
9	5115860	rs7470337	C	G	6	4	10	0	1	11	0	0
9	5136434	rs2094393	G	A	3	5	8	0	0	8	0	0
9	5136969	rs62541871	C	T	8	2	10	0	0	10	0	0
9	5137893	rs10283582	A	G	11	4	15	0	0	15	0	0
9	5138404	rs12336875	C	A	14	8	22	0	0	22	0	0
9	5468257	rs4143815	G	C	3	6	9	0	0	9	0	0
9	5630344	rs10815254	C	T	19	25	44	0	0	44	0	0
9	5712223	rs7466553	C	T	14	20	34	0	1	35	0	0
9	5712626	rs10975255	C	A	17	13	30	0	0	30	0	0
9	5732483	rs7850299	T	C	6	0	6	0	0	6	0	0
9	5773799	rs3824443	G	C	4	10	14	0	0	14	0	0
9	5774225	rs3739648	T	G	64	92	156	0	1	157	0	0
9	5774661	rs10975277	G	A	45	85	130	0	0	130	0	0
9	5774810	rs1885928	C	T	89	124	213	0	2	215	0	0
9	5776236	rs702274	C	A	81	123	204	0	0	204	0	0
9	5777553	rs16923507	T	C	4	9	13	0	0	13	0	0
9	5778116	rs2181518	A	C	4	4	8	0	0	8	0	0
9	5778395	rs2146710	G	C	5	11	16	0	0	16	0	0
9	5778456	rs2146711	C	G	5	7	12	0	0	12	0	0
9	5778823	rs2146712	C	T	7	5	12	0	0	12	0	0
9	5779165	rs2181519	A	C	7	3	10	0	0	10	0	0
9	5780074	rs2093652	G	A	3	5	8	0	0	8	0	0
9	5780083	rs2093653	C	T	3	5	8	0	0	8	0	0
9	5780121	rs2093654	A	G	3	3	6	0	0	6	0	0
9	5780803	rs2093656	C	T	2	5	7	0	0	7	0	0
9	5781664	rs10815280	T	G	5	2	7	0	0	7	0	0
9	5783107	rs2381382	A	G	8	2	10	0	0	10	0	0
9	5786850	rs1028702	G	A	31	37	68	0	0	68	0	0
9	5808800	rs144816125	C	T	4	3	7	0	0	7	0	0
9	5832728	rs1131727	G	C	2	5	7	0	0	7	0	0
9	5968303	.	T	C	17	34	51	0	1	52	0	0
9	5969249	rs10739080	A	G	11	21	32	0	0	32	0	0
9	5996316	rs10975392	T	G	5	1	6	0	0	6	0	0
9	6011335	rs7425	T	C	179	114	293	0	8	301	0	0
9	6011757	rs10758736	G	A	208	114	322	0	3	325	0	0
9	6012734	rs106033	A	C	158	96	254	0	2	256	0	0
9	6490248	rs10739105	A	G	3	4	7	0	0	7	0	0
9	6852878	rs17509780	G	A	7	4	11	0	0	11	0	0
9	6987984	rs6477135	C	T	5	3	8	0	0	8	0	0
9	7050341	rs1057200	C	A	0	6	6	0	0	6	0	0
9	7076463	rs1570512	G	A	12	9	21	0	0	21	0	0
9	7135540	rs10758836	C	T	5	10	15	0	0	15	0	0
9	7135716	rs12005620	G	T	6	4	10	0	0	10	0	0
9	7174430	rs7029684	T	C	2	5	7	0	0	7	0	0
9	7174433	rs3753003	G	T	2	5	7	0	0	7	0	0
9	7174773	rs913589	G	A	27	46	73	0	1	74	0	0
9	7174898	rs913590	C	A	29	44	73	0	1	74	0	0
9	7799007	rs13284912	C	T	15	6	21	0	0	21	0	0
9	7799606	rs14059	C	A	86	40	126	0	5	131	0	0
9	7799653	rs1127430	G	T	98	56	154	0	2	156	0	0
9	8320978	rs10976946	G	A	2	6	8	0	0	8	0	0
9	8848256	rs10759001	A	G	6	0	6	0	0	6	0	0
9	8853406	rs767209	A	G	8	6	14	0	0	14	0	0
9	10000548	rs10978155	A	G	0	8	8	0	0	8	0	0
9	13106335	rs722651	G	A	3	3	6	0	0	6	0	0
9	14588910	rs1047720	G	A	12	6	18	0	0	18	0	0
9	14588915	rs117840217	G	C	6	12	18	0	0	18	0	0
9	14588923	rs1047718	A	G	12	7	19	0	0	19	0	0
9	14589173	rs1047717	G	A	18	8	26	0	0	26	0	0
9	14611366	rs7849849	A	T	14	4	18	0	0	18	0	0
9	14612922	rs2890991	C	T	5	3	8	0	0	8	0	0
9	14618856	rs3802482	C	T	8	5	13	0	0	13	0	0
9	14646691	rs12346636	A	T	3	3	6	0	0	6	0	0
9	15170552	rs1746331	C	T	7	5	12	0	0	12	0	0
9	15170740	rs2489543	A	G	7	12	19	0	0	19	0	0
9	15188106	rs1407977	T	C	22	48	70	0	0	70	0	0
9	15298387	rs4740607	A	C	20	18	38	0	0	38	0	0
9	15299590	rs11792305	T	C	12	10	22	0	0	22	0	0
9	15299715	rs583204	G	T	11	13	24	0	0	24	0	0
9	15301428	rs2849049	C	A	4	2	6	0	0	6	0	0
9	15424888	rs10962032	T	C	4	3	7	0	1	8	0	0
9	15459821	rs3087653	A	C	4	7	11	0	1	12	0	0
9	15461853	rs2665504	G	C	9	4	13	0	0	13	0	0
9	15464834	rs41306098	C	T	178	292	470	0	1	471	0	0
9	15465743	rs41268961	C	A	4	2	6	0	0	6	0	0
9	15466033	rs1046388	G	C	6	10	16	0	0	16	0	0
9	15468268	rs78054686	C	T	5	4	9	0	0	9	0	0
9	15468480	rs4741507	T	C	7	10	17	0	0	17	0	0
9	15472139	rs2777950	C	T	25	25	50	0	0	50	0	0
9	15472409	rs62571001	A	G	16	30	46	0	4	50	0	0
9	15472411	rs1058252	A	G	33	16	49	0	0	49	0	0
9	15473236	rs16933296	G	A	1	5	6	0	0	6	0	0
9	15482976	rs7862428	C	T	1	5	6	0	0	6	0	0
9	15498495	rs12339417	C	T	2	5	7	0	0	7	0	0
9	15501422	rs2175257	G	A	3	3	6	0	0	6	0	0
9	15501753	rs12336509	C	T	13	6	19	0	0	19	0	0
9	15553591	rs10810397	G	C	6	30	36	0	0	36	0	0
9	15581302	rs276447	C	T	2	10	12	0	0	12	0	0
9	15582252	rs276444	G	C	5	21	26	0	0	26	0	0
9	15583444	rs2663300	G	C	4	17	21	0	0	21	0	0
9	15591372	rs4741510	T	A	14	41	55	0	0	55	0	0
9	15650009	rs7022384	C	A	7	0	7	0	0	7	0	0
9	15650011	rs7038778	T	G	7	0	7	0	0	7	0	0
9	15784560	rs55780067	A	G	5	21	26	0	0	26	0	0
9	15784631	rs1539172	A	G	9	6	15	0	1	16	0	0
9	15786817	rs10962157	A	T	0	8	8	0	0	8	0	0
9	15786902	rs10962158	T	A	4	5	9	0	0	9	0	0
9	15822447	rs79590312	A	C	6	0	6	0	0	6	0	0
9	15822518	rs76680143	C	T	8	0	8	0	0	8	0	0
9	15865546	rs1773046	A	G	3	6	9	0	0	9	0	0
9	15887778	.	T	A	2	9	11	0	0	11	0	0
9	15887931	rs770210	G	C	8	14	22	0	0	22	0	0
9	15888024	rs10756715	A	C	9	25	34	0	1	35	0	0
9	15888049	rs770212	G	A	10	26	36	0	0	36	0	0
9	15894354	rs2769716	C	T	2	5	7	0	0	7	0	0
9	16061329	rs10114770	C	T	3	3	6	0	0	6	0	0
9	17300057	rs60520802	A	C	5	1	6	0	0	6	0	0
9	17300060	rs2779778	G	A	5	1	6	0	0	6	0	0
9	19200511	rs10811136	C	T	27	0	27	0	1	28	0	0
9	19234313	rs7864873	G	C	7	1	8	0	1	9	0	0
9	19235023	rs1854553	G	A	11	5	16	0	0	16	0	0
9	19235047	rs1854552	C	T	10	4	14	0	0	14	0	0
9	19235270	rs1854551	G	A	9	4	13	0	0	13	0	0
9	19241543	rs10757038	C	T	5	1	6	0	0	6	0	0
9	19305959	rs7048291	T	G	4	3	7	0	0	7	0	0
9	19309311	rs7048603	C	T	4	6	10	0	0	10	0	0
9	19321950	rs7019592	T	C	12	2	14	0	0	14	0	0
9	19323097	rs2803124	A	G	7	3	10	0	0	10	0	0
9	19323159	rs7041985	G	A	4	5	9	0	0	9	0	0
9	19331233	rs2490471	G	A	4	2	6	0	0	6	0	0
9	19341045	rs928128	A	G	35	39	74	0	0	74	0	0
9	19343346	rs6475321	T	C	30	16	46	0	1	47	0	0
9	19346710	rs17818730	A	G	51	23	74	0	0	74	0	0
9	19372275	rs41270105	A	G	42	78	120	0	1	121	0	0
9	19378074	rs62562711	C	T	14	19	33	0	1	34	0	0
9	20659270	rs113127190	G	A	4	3	7	0	0	7	0	0
9	20929441	.	A	G	13	7	20	0	0	20	0	0
9	20948311	rs35470485	A	G	21	10	31	0	0	31	0	0
9	20988426	rs4977881	A	G	34	19	53	0	0	53	0	0
9	21003783	rs34590084	C	T	3	3	6	0	0	6	0	0
9	21004768	rs62558318	C	G	15	31	46	0	0	46	0	0
9	21005305	rs4129713	G	C	16	12	28	0	0	28	0	0
9	21005397	rs4129715	A	C	14	18	32	0	1	33	0	0
9	21005744	rs4129714	C	T	5	13	18	0	0	18	0	0
9	21006021	rs7863405	C	T	9	22	31	0	0	31	0	0
9	21006600	rs35893324	C	A	7	14	21	0	0	21	0	0
9	21006934	rs1134090	A	G	7	22	29	0	0	29	0	0
9	21029330	rs2298260	T	C	13	14	27	0	0	27	0	0
9	21077716	rs1051922	G	A	37	29	66	0	0	66	0	0
9	21331119	rs8729	C	T	20	33	53	0	0	53	0	0
9	21816758	rs7023954	G	A	15	5	20	0	0	20	0	0
9	21865106	rs4977735	T	C	8	5	13	0	1	14	0	0
9	25677215	rs12348	T	C	103	55	158	0	1	159	0	0
9	25677257	rs1128957	C	G	94	48	142	0	4	146	0	0
9	25677349	rs1128953	A	C	122	54	176	0	9	185	0	0
9	25677698	rs72631815	A	C	10	15	25	0	0	25	0	0
9	25677933	rs35110225	T	C	10	18	28	0	0	28	0	0
9	26892137	rs7860830	G	C	7	0	7	0	0	7	0	0
9	26907342	rs12376190	G	A	9	6	15	0	0	15	0	0
9	27329622	rs1984007	T	C	9	3	12	0	0	12	0	0
9	27329792	rs1984008	T	C	8	3	11	0	0	11	0	0
9	27546828	rs9103	A	G	66	97	163	0	1	164	0	0
9	27546890	rs13691	G	A	64	58	122	0	1	123	0	0
9	27555817	rs10967983	T	A	3	7	10	0	0	10	0	0
9	27555836	rs10967984	C	T	8	3	11	0	0	11	0	0
9	27559674	rs7860526	A	G	4	6	10	0	0	10	0	0
9	27559733	rs1565948	G	A	3	3	6	0	0	6	0	0
9	27560594	rs3849944	T	C	13	7	20	0	0	20	0	0
9	27567145	rs10757668	C	T	18	42	60	0	0	60	0	0
9	27571458	rs3849946	C	A	4	3	7	0	0	7	0	0
9	27572634	rs2282240	C	T	16	7	23	0	0	23	0	0
9	32455542	rs10363	G	A	13	23	36	0	1	37	0	0
9	32455876	rs41272907	G	C	4	6	10	0	0	10	0	0
9	32456017	rs12006123	G	A	3	14	17	0	0	17	0	0
9	32456656	rs12555727	G	A	6	6	12	0	0	12	0	0
9	32457189	rs10970987	T	C	60	28	88	0	0	88	0	0
9	32483718	rs7848849	C	A	3	6	9	0	0	9	0	0
9	32483730	rs4487862	A	G	3	7	10	0	0	10	0	0
9	32484577	rs17289627	A	G	4	6	10	0	0	10	0	0
9	32507972	rs7048401	A	T	0	7	7	0	0	7	0	0
9	32507981	rs7034138	T	C	2	9	11	0	0	11	0	0
9	32508586	rs582509	C	G	1	34	35	0	0	35	0	0
9	32508928	.	A	G	0	21	21	0	0	21	0	0
9	32509167	rs583488	A	G	2	8	10	0	0	10	0	0
9	32542204	rs10971019	A	G	115	169	284	0	0	284	0	0
9	32547185	rs10971021	G	A	2	4	6	0	0	6	0	0
9	32553171	rs17218354	A	G	4	4	8	0	0	8	0	0
9	32555049	rs6476369	C	A	3	4	7	0	0	7	0	0
9	32564514	rs200040913	T	A	2	4	6	0	0	6	0	0
9	32564749	rs671018	T	C	13	19	32	0	0	32	0	0
9	32565776	rs688556	G	C	6	17	23	0	0	23	0	0
9	32566400	rs593700	A	T	10	19	29	0	0	29	0	0
9	32568024	rs598349	A	G	5	10	15	0	1	16	0	0
9	32568168	rs611653	A	T	9	15	24	0	0	24	0	0
9	32947078	rs10511911	C	T	2	4	6	0	0	6	0	0
9	32988185	rs17226291	C	T	9	3	12	0	0	12	0	0
9	32988455	rs10971271	G	A	14	3	17	0	0	17	0	0
9	32989004	rs17324043	T	C	8	4	12	0	0	12	0	0
9	33001067	rs139023574	A	C	3	3	6	0	0	6	0	0
9	33001448	rs190368009	G	C	6	0	6	0	0	6	0	0
9	33024641	rs17325001	C	G	5	2	7	0	0	7	0	0
9	33025251	rs2297218	G	C	6	4	10	0	0	10	0	0
9	33026572	rs20583	T	C	439	267	706	0	3	709	0	0
9	33026638	rs2274769	G	A	7	6	13	0	0	13	0	0
9	33027142	rs368301188	T	C	10	3	13	0	1	14	0	0
9	33027775	rs141404572	G	A	13	7	20	0	2	22	0	0
9	33027855	rs118065940	C	A	11	6	17	0	0	17	0	0
9	33028537	rs12380574	A	G	7	6	13	0	0	13	0	0
9	33028977	rs12377889	C	T	19	10	29	0	0	29	0	0
9	33029015	rs4879658	C	T	20	16	36	0	0	36	0	0
9	33030087	rs10971343	T	C	10	9	19	0	0	19	0	0
9	33030166	rs10971344	A	G	7	8	15	0	1	16	0	0
9	33036711	rs10813925	A	G	12	5	17	0	0	17	0	0
9	33036717	rs10813926	C	G	13	5	18	0	0	18	0	0
9	33037349	rs7861851	T	A	21	6	27	0	0	27	0	0
9	33037350	rs7875733	C	A	21	6	27	0	0	27	0	0
9	33037446	rs10971357	A	G	19	8	27	0	1	28	0	0
9	33038049	rs10971358	G	C	15	15	30	0	0	30	0	0
9	33039024	rs7296	T	A	346	201	547	0	5	552	0	0
9	33042562	rs10971361	C	A	26	5	31	0	0	31	0	0
9	33045147	rs10758180	A	G	181	82	263	0	1	264	0	0
9	33045161	rs10758181	C	T	174	75	249	0	0	249	0	0
9	33045276	rs1537042	G	C	207	83	290	0	1	291	0	0
9	33045664	rs1970027	A	G	62	18	80	0	0	80	0	0
9	33045810	.	T	C	79	20	99	0	1	100	0	0
9	33047398	rs2274767	T	C	6	6	12	0	0	12	0	0
9	33047910	rs10813927	C	T	3	3	6	0	0	6	0	0
9	33048280	rs10971364	A	C	50	56	106	0	1	107	0	0
9	33050342	rs10971367	A	G	14	7	21	0	0	21	0	0
9	33051540	rs7846968	T	G	21	12	33	0	0	33	0	0
9	33053344	rs41298163	T	A	10	4	14	0	1	15	0	0
9	33053544	rs79226160	G	T	38	15	53	0	1	55	1	0
9	33054120	rs75608945	G	T	22	12	34	0	0	34	0	0
9	33054162	rs7872744	C	T	14	7	21	0	1	22	0	0
9	33054274	rs1129912	T	C	23	11	34	0	0	34	0	0
9	33054722	rs17227872	A	G	22	19	41	0	0	41	0	0
9	33055471	rs10758183	G	A	17	6	23	0	0	23	0	0
9	33055716	rs10971371	G	C	21	15	36	0	0	36	0	0
9	33113166	rs190558555	A	C	217	119	336	0	5	341	0	0
9	33115510	rs74670969	G	C	9	5	14	0	0	14	0	0
9	33118904	rs1137642	A	G	6	2	8	0	0	8	0	0
9	33119583	rs7859454	T	A	2	6	8	0	0	8	0	0
9	33119818	rs10121987	A	G	4	5	9	0	0	9	0	0
9	33120706	rs3818593	A	G	5	6	11	0	0	11	0	0
9	33121480	rs10971417	C	T	2	4	6	0	1	7	0	0
9	33121570	rs10813948	G	A	3	4	7	0	1	8	0	0
9	33122024	rs10971418	C	A	4	5	9	0	0	9	0	0
9	33122370	rs10116966	T	A	4	4	8	0	0	8	0	0
9	33122626	rs10117038	T	C	6	5	11	0	0	11	0	0
9	33122645	rs10113903	G	C	5	5	10	0	2	12	0	0
9	33123106	rs6476400	T	A	0	6	6	0	0	6	0	0
9	33124042	rs7029897	T	C	5	4	9	0	0	9	0	0
9	33124161	rs10971419	T	C	3	5	8	0	0	8	0	0
9	33125000	rs10971420	T	C	3	4	7	0	0	7	0	0
9	33126570	rs7850878	A	G	3	4	7	0	0	7	0	0
9	33126608	.	T	G	6	1	7	0	0	7	0	0
9	33128076	rs10813952	G	A	10	9	19	0	0	19	0	0
9	33129839	rs3780490	A	G	2	5	7	0	0	7	0	0
9	33129844	rs3780489	G	T	2	5	7	0	0	7	0	0
9	33130877	rs11793020	A	G	5	2	7	0	0	7	0	0
9	33131651	rs10758192	G	A	2	5	7	0	0	7	0	0
9	33132354	rs73645257	C	T	3	3	6	0	0	6	0	0
9	33166234	rs10813959	T	C	3	4	7	0	0	7	0	0
9	33224655	rs112294877	A	G	3	5	8	0	0	8	0	0
9	33243694	rs62546680	G	C	4	2	6	0	0	6	0	0
9	33255483	rs11789000	G	C	9	10	19	0	0	19	0	0
9	33255743	rs706117	A	G	5	5	10	0	0	10	0	0
9	33265405	rs16919130	C	G	22	13	35	0	0	35	0	0
9	33265743	rs11791605	C	A	25	9	34	0	1	35	0	0
9	33266430	rs706122	A	G	2	6	8	0	0	8	0	0
9	33310993	rs41274035	G	A	2	4	6	0	0	6	0	0
9	33366398	rs4879688	C	T	14	5	19	0	0	19	0	0
9	33441826	rs16919255	C	A	7	7	14	0	0	14	0	0
9	33442952	rs2228332	G	A	1	9	10	0	0	10	0	0
9	33447424	rs591810	C	G	3	4	7	0	0	7	0	0
9	33461567	rs678859	A	G	68	94	162	0	0	162	0	0
9	33467577	rs2275228	T	C	3	9	12	0	1	13	0	0
9	33473893	rs2777744	T	G	4	5	9	0	0	9	0	0
9	33505087	rs11793814	C	G	12	12	24	0	0	24	0	0
9	33506086	rs73482878	A	G	6	5	11	0	0	11	0	0
9	33506248	rs10813989	T	C	11	8	19	0	1	20	0	0
9	33506670	rs10813990	C	T	6	9	15	0	0	15	0	0
9	33506980	rs10758210	G	A	5	4	9	0	0	9	0	0
9	33507015	rs10813991	T	A	4	2	6	0	0	6	0	0
9	33673792	rs7043915	A	G	4	4	8	0	0	8	0	0
9	33673796	rs7044016	C	A	5	4	9	0	0	9	0	0
9	33673935	rs7044249	C	T	4	3	7	0	0	7	0	0
9	33674789	rs10814026	A	C	1	5	6	0	0	6	0	0
9	33675130	rs117737192	C	T	2	8	10	0	0	10	0	0
9	33675629	rs7849845	A	C	6	3	9	0	0	9	0	0
9	33676173	rs111298584	C	T	4	5	9	0	0	9	0	0
9	33676773	rs112143506	G	C	4	10	14	0	0	14	0	0
9	33676827	rs113125106	G	T	5	7	12	0	2	14	0	0
9	33677339	rs150108908	A	C	6	2	8	0	0	8	0	0
9	33677474	rs77425313	C	T	16	14	30	0	1	31	0	0
9	33699546	rs1765371	C	A	14	8	22	0	0	22	0	0
9	33700435	rs143760176	T	G	4	5	9	0	0	9	0	0
9	33817617	rs855719	T	C	11	19	30	0	0	30	0	0
9	33819555	rs216367	A	T	13	16	29	0	1	30	0	0
9	33819955	rs216368	A	G	33	45	78	0	0	78	0	0
9	33826648	rs10971719	G	C	4	3	7	0	0	7	0	0
9	33855465	rs10971739	G	C	11	14	25	0	1	26	0	0
9	33917498	rs4817	T	C	94	122	216	0	1	217	0	0
9	33918816	rs72727327	C	T	10	54	64	0	1	65	0	0
9	33921919	rs11848	T	C	93	181	274	0	0	274	0	0
9	33921977	rs2781	G	C	144	218	362	0	5	367	0	0
9	33928464	rs41305331	G	A	1	6	7	0	0	7	0	0
9	33941759	rs307658	T	C	32	49	81	0	0	82	1	0
9	33942063	rs56150332	G	A	10	2	12	0	0	12	0	0
9	33942930	rs307660	C	T	5	1	6	0	0	6	0	0
9	33944730	rs72727350	A	T	3	3	6	0	0	6	0	0
9	33979798	rs2781279	G	A	0	10	10	0	0	10	0	0
9	33980067	rs2781280	C	T	0	7	7	0	0	7	0	0
9	34014605	rs568891381	C	T	5	1	6	0	0	6	0	0
9	34017106	rs1785506	C	T	19	17	36	0	0	36	0	0
9	34087246	rs10971903	C	T	58	37	95	0	0	95	0	0
9	34107504	rs1378	C	T	30	35	65	0	1	66	0	0
9	34119553	rs72731217	T	C	5	12	17	0	0	17	0	0
9	34119676	rs72731218	C	A	4	17	21	0	1	22	0	0
9	34120686	.	G	A	4	7	11	0	5	16	0	0
9	34120720	rs10971938	T	C	6	6	12	0	0	12	0	0
9	34121510	rs55857848	G	C	5	8	13	0	0	13	0	0
9	34122862	rs72731222	C	G	4	5	9	0	0	9	0	0
9	34122886	rs72731224	C	T	3	7	10	0	0	10	0	0
9	34124312	rs10511916	G	C	5	2	7	0	0	7	0	0
9	34124860	rs2275003	A	G	1	7	8	0	0	8	0	0
9	34181283	rs71521221	A	T	1	6	7	0	0	7	0	0
9	34181457	rs4421437	G	A	3	15	18	0	1	19	0	0
9	34181651	rs2769705	C	T	2	13	15	0	0	15	0	0
9	34213959	rs10972004	T	C	3	4	7	0	0	7	0	0
9	34215234	rs10972005	C	T	7	9	16	0	0	16	0	0
9	34215270	rs7341762	T	C	7	7	14	0	0	14	0	0
9	34215480	rs12378781	A	C	4	7	11	0	1	12	0	0
9	34215608	rs113482935	G	T	3	6	9	0	0	9	0	0
9	34221830	rs10972007	G	C	3	4	7	0	0	7	0	0
9	34223937	rs4242691	A	G	5	3	8	0	0	8	0	0
9	34224285	rs17258212	C	T	7	4	11	0	0	11	0	0
9	34228578	rs7046012	C	T	5	3	8	0	2	10	0	0
9	34228770	rs112645748	G	A	3	7	10	0	0	10	0	0
9	34229240	rs10972010	C	T	8	20	28	0	1	29	0	0
9	34229808	rs140365214	T	G	7	14	21	0	0	21	0	0
9	34232465	rs7025829	T	A	21	31	52	0	1	54	1	0
9	34242192	rs10972015	C	T	7	15	22	0	0	22	0	0
9	34243377	rs17349871	C	G	3	7	10	0	0	10	0	0
9	34244092	rs10972017	C	T	6	13	19	0	0	19	0	0
9	34244124	rs4008744	T	C	11	14	25	0	0	25	0	0
9	34246366	rs10972021	A	T	17	24	41	0	0	41	0	0
9	34247364	rs10972022	C	T	6	12	18	0	0	18	0	0
9	34247445	rs115145545	C	T	56	7	63	0	2	65	0	0
9	34249143	rs7470345	T	C	46	139	185	0	0	185	0	0
9	34249204	rs2380925	G	A	41	109	150	0	0	150	0	0
9	34249354	rs2380926	T	C	57	121	178	0	2	180	0	0
9	34252127	rs1049567	T	C	535	1034	1569	0	5	1574	0	0
9	34336266	rs7025269	C	T	4	19	23	0	0	23	0	0
9	34399338	rs885048	A	G	3	6	9	0	0	9	0	0
9	34400581	rs11793308	C	T	8	4	12	0	0	12	0	0
9	34610702	rs13339	C	T	45	19	64	0	0	64	0	0
9	34635337	rs41305341	T	G	26	40	66	0	0	66	0	0
9	34635749	rs61739588	G	A	28	15	43	0	0	43	0	0
9	34648418	rs2070075	C	T	24	29	53	0	0	53	0	0
9	34649442	rs2070074	A	G	40	62	102	0	1	103	0	0
9	34650101	rs117197951	C	G	5	2	7	0	0	7	0	0
9	34651354	rs77964992	T	C	33	17	50	0	0	50	0	0
9	34651618	rs78403209	G	A	15	26	41	0	0	41	0	0
9	34654371	rs117579366	G	A	10	26	36	0	0	36	0	0
9	34666231	rs28588979	T	G	7	1	8	0	0	8	0	0
9	34667928	rs10117859	A	G	17	4	21	0	0	21	0	0
9	34998003	rs9608	G	A	40	78	118	0	1	119	0	0
9	35041335	rs112250412	G	T	5	3	8	0	0	8	0	0
9	35049508	rs7048389	C	T	4	2	6	0	0	6	0	0
9	35058378	rs56793340	T	G	23	13	36	0	2	38	0	0
9	35060746	rs562381	A	G	96	46	142	0	1	143	0	0
9	35060955	rs2258240	T	C	17	17	34	0	1	35	0	0
9	35068948	rs2073576	T	C	9	2	11	0	0	11	0	0
9	35077441	rs554098	T	C	17	10	27	0	1	28	0	0
9	35077697	rs17885008	G	A	5	5	10	0	0	10	0	0
9	35100468	rs666549	T	C	9	7	16	0	0	16	0	0
9	35100569	rs586017	A	G	7	7	14	0	0	14	0	0
9	35101870	rs693325	C	G	4	2	6	0	0	6	0	0
9	35105257	rs7030595	G	A	206	76	282	0	2	285	1	0
9	35109949	rs944700	A	G	5	2	7	0	0	7	0	0
9	35397166	rs41276043	C	G	1	6	7	0	0	7	0	0
9	35657838	rs7021642	G	A	95	55	150	0	0	150	0	0
9	35657859	rs7021463	C	G	85	52	137	0	1	138	0	0
9	35659591	rs10441725	T	C	6	4	10	0	0	10	0	0
9	35659697	rs10441726	T	C	4	3	7	0	0	7	0	0
9	35659744	rs1890593	C	G	4	5	9	0	0	9	0	0
9	35659902	rs10972553	C	T	3	6	9	0	0	9	0	0
9	35660097	rs12350788	T	C	8	8	16	0	1	17	0	0
9	35660901	rs2275420	C	T	58	37	95	0	0	95	0	0
9	35682248	.	A	G	17	5	22	0	0	22	0	0
9	35708425	rs35461988	T	C	39	76	115	0	3	118	0	0
9	35728019	rs10972567	C	A	6	5	11	0	0	11	0	0
9	35734956	rs10814274	C	T	11	6	17	0	0	17	0	0
9	35748806	rs1570246	G	T	15	4	19	0	0	19	0	0
9	35754500	rs1322045	G	A	46	27	73	0	0	73	0	0
9	35757075	rs1951432	A	G	22	7	29	0	0	29	0	0
9	35757193	rs1951433	T	C	50	31	81	0	14	95	0	0
9	35757362	rs3750437	T	A	135	72	207	0	2	209	0	0
9	35789076	rs186691419	G	A	8	2	10	0	0	10	0	0
9	35972198	.	C	T	27	0	27	0	0	27	0	0
9	36038388	rs114670359	T	C	4	2	6	0	0	6	0	0
9	36085563	rs10814327	T	A	15	9	24	0	0	24	0	0
9	36142349	rs56743394	T	A	5	2	7	0	0	7	0	0
9	36143004	rs1541036	C	T	4	8	12	0	0	12	0	0
9	36144632	rs41277091	C	T	7	16	23	0	1	24	0	0
9	36145497	rs111600496	A	C	9	2	11	0	0	11	0	0
9	36145579	rs112951740	A	G	5	2	7	0	0	7	0	0
9	36146883	rs78009392	C	G	2	4	6	0	0	6	0	0
9	36147847	rs60088684	C	T	59	32	91	0	1	92	0	0
9	36150668	rs113485520	G	A	5	3	8	0	0	8	0	0
9	36150701	rs74802925	G	A	5	2	7	0	0	7	0	0
9	36150736	rs79178772	T	C	5	4	9	0	0	9	0	0
9	36152611	rs7022040	A	G	24	10	34	0	1	35	0	0
9	36153596	rs7026651	G	C	9	6	15	0	1	16	0	0
9	36153755	rs62543624	G	A	6	10	16	0	0	16	0	0
9	36153830	rs2381436	G	A	7	0	7	0	0	7	0	0
9	36154451	rs11794716	G	T	2	5	7	0	1	8	0	0
9	36155054	rs4260967	A	G	5	8	13	0	0	13	0	0
9	36159532	rs116127553	T	C	5	3	8	0	0	8	0	0
9	36160179	rs62543626	C	T	1	5	6	0	0	6	0	0
9	36160713	rs142422641	T	C	6	3	9	0	0	9	0	0
9	36161689	rs61523758	C	T	6	4	10	0	0	10	0	0
9	36163002	rs11588	C	T	39	19	58	0	0	58	0	0
9	36163563	rs6610	G	A	119	55	174	0	2	176	0	0
9	36163665	rs7874174	G	T	104	41	145	0	2	147	0	0
9	36163796	rs115803815	A	G	110	57	167	0	1	168	0	0
9	36215581	rs16933086	C	T	30	44	74	0	1	75	0	0
9	36285515	rs12380671	C	G	3	3	6	0	0	6	0	0
9	36287170	rs4879978	G	A	3	3	6	0	0	6	0	0
9	36304017	rs10972836	G	A	5	5	10	0	0	10	0	0
9	36480532	rs74307337	T	C	3	4	7	0	0	7	0	0
9	36481150	rs74193050	T	C	5	6	11	0	0	11	0	0
9	37425242	rs2235096	C	G	6	3	9	0	0	9	0	0
9	37426152	rs2768659	A	G	11	4	15	0	1	16	0	0
9	37426804	rs2768658	T	C	9	1	10	0	0	10	0	0
9	37427580	rs1887454	T	C	6	0	6	0	0	6	0	0
9	37429497	rs309460	C	T	13	11	24	0	0	24	0	0
9	37431399	rs309457	A	G	10	9	19	0	0	19	0	0
9	37436105	rs7867764	G	A	1	5	6	0	0	6	0	0
9	37441650	rs17502738	T	C	37	68	105	0	2	107	0	0
9	37464017	rs77511700	T	C	4	4	8	0	0	8	0	0
9	37464106	rs1410018	C	T	8	8	16	0	0	16	0	0
9	37464909	rs7049017	T	C	14	7	21	0	0	21	0	0
9	37503241	rs11792930	C	T	43	26	69	0	0	69	0	0
9	37509875	rs1006763	C	T	10	5	15	0	0	15	0	0
9	37510265	rs7033712	A	G	2	4	6	0	0	6	0	0
9	37772121	rs10973534	G	A	1	6	7	0	0	7	0	0
9	37772424	rs62539384	C	T	4	4	8	0	0	8	0	0
9	37773453	rs4382556	C	A	3	3	6	0	0	6	0	0
9	37774375	rs10973536	A	G	2	7	9	0	0	9	0	0
9	37774676	rs9858	T	A	10	19	29	0	0	29	0	0
9	37774893	rs10973537	G	A	22	27	49	0	0	49	0	0
9	37775177	rs10973538	C	T	16	30	46	0	0	46	0	0
9	37775467	rs4878174	T	C	6	15	21	0	0	21	0	0
9	37779623	rs6476661	G	A	3	12	15	0	0	15	0	0
9	37782111	rs7158	C	T	7	20	27	0	0	27	0	0
9	37789175	rs10814622	T	C	2	4	6	0	0	6	0	0
9	37789503	rs10973547	G	A	0	7	7	0	0	7	0	0
9	37789727	rs2147247	T	C	6	3	9	0	0	9	0	0
9	37789728	rs3827517	G	A	6	3	9	0	0	9	0	0
9	37801039	rs200916317	C	A	23	45	68	0	2	70	0	0
9	37864594	rs10973587	A	T	5	1	6	0	0	6	0	0
9	38540589	rs1058025	T	C	5	1	6	0	0	6	0	0
9	38546228	rs3861006	A	C	3	6	9	0	0	9	0	0
9	38547805	rs10973888	A	G	5	3	8	0	0	8	0	0
9	38564301	.	A	C	6	0	6	0	0	6	0	0
9	41954776	.	C	G	3	35	38	0	0	38	0	0
9	44076871	.	C	T	6	0	6	0	0	6	0	0
9	44990713	.	G	C	0	6	6	0	0	6	0	0
9	66457388	.	T	G	10	2	12	0	0	12	0	0
9	66457465	.	T	G	11	2	13	0	0	13	0	0
9	66457475	.	C	T	10	4	14	0	0	14	0	0
9	66460831	.	C	T	4	3	7	0	0	7	0	0
9	66461291	.	T	A	6	3	9	0	0	9	0	0
9	66461714	rs4055848	G	C	4	4	8	0	1	9	0	0
9	66461854	.	T	A	5	4	9	0	0	9	0	0
9	66461983	.	T	C	0	7	7	0	0	7	0	0
9	66462474	.	T	C	4	3	7	0	0	7	0	0
9	66463377	.	T	C	4	3	7	0	0	7	0	0
9	66463629	.	G	A	3	13	16	0	0	16	0	0
9	66464425	.	C	A	9	5	14	0	0	14	0	0
9	66464833	.	G	T	8	5	13	0	0	13	0	0
9	66465312	.	G	A	13	7	20	0	0	20	0	0
9	66465973	.	C	T	5	6	11	0	1	12	0	0
9	66467253	.	G	A	11	0	11	0	0	11	0	0
9	66467394	.	C	A	15	0	15	0	0	15	0	0
9	66467602	.	C	T	8	0	8	0	0	8	0	0
9	66467605	.	A	C	7	0	7	0	2	9	0	0
9	66467677	.	G	A	6	0	6	0	0	6	0	0
9	66469095	.	G	C	19	13	32	0	0	32	0	0
9	66469196	.	A	G	3	11	14	0	0	14	0	0
9	66494136	.	T	G	3	3	6	0	0	6	0	0
9	68413491	rs1809617	C	G	9	3	12	0	0	12	0	0
9	68413581	.	G	C	9	12	21	0	0	21	0	0
9	68413653	.	C	G	7	5	12	0	0	12	0	0
9	68413791	.	G	C	1	8	9	0	0	9	0	0
9	68413800	.	C	G	1	8	9	0	0	9	0	0
9	68413877	.	C	G	3	14	17	0	1	18	0	0
9	68413907	.	G	A	4	15	19	0	0	19	0	0
9	68413955	.	C	A	9	5	14	0	0	14	0	0
9	68413981	.	G	T	2	5	7	0	0	7	0	0
9	68414170	rs75137747	A	C	3	10	13	0	0	13	0	0
9	68415386	.	G	A	3	50	53	0	2	55	0	0
9	68741534	.	A	G	6	7	13	0	0	13	0	0
9	70209258	.	A	G	15	4	19	0	0	19	0	0
9	70209330	.	T	C	7	2	9	0	0	9	0	0
9	70885808	.	A	C	3	10	13	0	0	13	0	0
9	88456282	.	G	A	6	0	6	0	0	6	0	0
9	88456293	.	C	T	6	0	6	0	0	6	0	0
9	88456359	rs74877298	C	T	6	0	6	0	0	6	0	0
9	88456681	.	G	A	6	0	6	0	0	6	0	0
9	88456697	.	G	A	6	0	6	0	0	6	0	0
9	88456710	.	A	G	7	0	7	0	0	7	0	0
9	88456737	.	A	G	4	3	7	0	0	7	0	0
9	88456815	.	G	A	7	0	7	0	0	7	0	0
9	88456825	.	T	G	8	0	8	0	0	8	0	0
9	123596255	.	T	C	6	0	6	0	1	7	0	0
9	135864190	rs2073819	A	C	5	3	8	0	0	8	0	0
9	135866693	rs667805	A	G	87	59	146	0	1	147	0	0
9	135895096	.	T	C	143	0	143	0	5	148	0	0
9	135895185	.	G	T	155	0	155	0	36	192	1	0
9	135895949	rs71481399	T	G	364	1	365	0	47	413	1	0
9	135921752	rs113936463	G	A	2	4	6	0	0	6	0	0
9	135926017	rs1541331	A	G	6	1	7	0	0	7	0	0
9	135926993	rs73662421	A	G	4	4	8	0	0	8	0	0
9	135930789	rs8193017	T	C	8	6	14	0	0	14	0	0
9	135932944	rs645736	A	G	17	3	20	0	0	20	0	0
9	135961809	rs679779	T	C	5	2	7	0	0	7	0	0
9	135974079	rs1062356	G	C	142	276	418	0	0	418	0	0
9	135974100	rs886017	G	A	158	308	466	0	1	468	1	0
9	135975356	rs2773828	A	C	39	68	107	0	2	110	1	0
9	135976664	rs34018822	C	T	26	45	71	0	0	71	0	0
9	135976698	rs35108384	G	A	19	44	63	0	0	63	0	0
9	135985796	rs3761824	C	T	49	73	122	0	0	122	0	0
9	136037742	rs2073924	G	A	9	11	20	0	0	20	0	0
9	136037845	rs2073923	T	C	4	5	9	0	0	9	0	0
9	136129716	rs4962116	G	A	7	3	10	0	0	10	0	0
9	136130012	rs8176757	A	C	7	2	9	0	0	9	0	0
9	136130359	.	C	G	6	0	6	0	0	6	0	0
9	136130360	.	T	A	6	0	6	0	0	6	0	0
9	136131347	rs8176745	G	A	5	1	6	0	0	6	0	0
9	136132608	rs8176726	C	T	4	2	6	0	0	6	0	0
9	136134864	rs626792	C	A	0	6	6	0	0	6	0	0
9	136135047	rs547643	T	C	0	6	6	0	0	6	0	0
9	136135237	rs549443	A	G	3	3	6	0	0	6	0	0
9	136135238	rs549446	T	C	3	3	6	0	0	6	0	0
9	136136770	rs688976	A	C	0	8	8	0	0	8	0	0
9	136197834	rs12335	G	A	51	22	73	0	0	73	0	0
9	136198859	rs1800867	G	A	21	32	53	0	0	53	0	0
9	136199466	rs886089	G	A	67	88	155	0	3	158	0	0
9	136199503	rs886090	G	A	68	103	171	0	2	173	0	0
9	136200810	rs120858	G	A	28	26	54	0	0	54	0	0
9	136213521	rs616836	T	C	10	4	14	0	0	14	0	0
9	136214955	rs553877	A	G	2	4	6	0	0	6	0	0
9	136222490	rs658517	A	G	7	3	10	0	0	10	0	0
9	136223043	rs59358281	C	G	9	16	25	0	0	25	0	0
9	136227260	rs12763	A	G	47	32	79	0	0	79	0	0
9	136228007	rs61751475	C	T	19	7	26	0	0	26	0	0
9	136228865	rs1059773	C	A	456	921	1377	0	8	1385	0	0
9	136229833	rs2494	C	G	538	1003	1541	0	14	1555	0	0
9	136232758	rs2269894	T	C	14	23	37	0	1	38	0	0
9	136235100	rs28374096	G	C	9	50	59	0	0	59	0	0
9	136237783	rs4962046	C	A	60	9	69	0	0	69	0	0
9	136238509	rs1179037	G	A	50	7	57	0	0	57	0	0
9	136241189	rs1179038	C	T	16	6	22	0	0	22	0	0
9	136241639	rs1179040	C	T	20	11	31	0	1	32	0	0
9	136277480	rs2285486	A	G	15	11	26	0	0	26	0	0
9	136281753	rs3118663	G	A	8	3	11	0	0	11	0	0
9	136281917	rs3118664	A	C	3	6	9	0	0	9	0	0
9	136281925	rs3124780	A	G	4	5	9	0	0	9	0	0
9	136281966	rs3124779	A	G	5	5	10	0	0	10	0	0
9	136520282	rs2073833	G	C	19	0	19	0	0	19	0	0
9	136520662	rs732833	T	C	12	1	13	0	0	13	0	0
9	136534694	rs9409878	A	C	7	5	12	0	0	12	0	0
9	136628770	rs509590	T	C	9	8	17	0	0	17	0	0
9	136643908	rs56233098	G	A	3	7	10	0	0	10	0	0
9	136653551	rs56296048	G	A	11	3	14	0	0	14	0	0
9	136891370	rs417142	G	T	7	8	15	0	0	15	0	0
9	136892523	rs408307	C	T	12	4	16	0	0	16	0	0
9	136898627	rs433402	A	G	72	52	124	0	0	124	0	0
9	136902415	rs378569	T	C	2	6	8	0	0	8	0	0
9	136903363	rs457084	A	G	2	4	6	0	0	6	0	0
9	136903683	rs456793	G	A	7	1	8	0	0	8	0	0
9	136904835	rs467303	C	T	5	3	8	0	0	8	0	0
9	136905765	rs467369	C	T	4	3	7	0	0	7	0	0
9	136905981	rs464024	T	G	3	3	6	0	0	6	0	0
9	136907005	rs467387	G	A	37	17	54	0	0	54	0	0
9	136908549	rs416390	C	G	4	3	7	0	0	7	0	0
9	136909261	rs457420	C	T	6	2	8	0	0	8	0	0
9	136909309	rs460154	G	A	4	2	6	0	0	6	0	0
9	136912626	rs459571	C	T	72	51	123	0	3	126	0	0
9	136913123	rs460888	C	G	41	24	65	0	0	65	0	0
9	136913355	rs464826	T	C	104	55	159	0	1	160	0	0
9	136918137	rs2520100	A	T	12	5	17	0	1	18	0	0
9	136918139	rs2520099	T	C	12	6	18	0	0	18	0	0
9	136918662	rs2073818	C	A	45	24	69	0	2	71	0	0
9	136999386	rs28705801	A	G	4	6	10	0	0	10	0	0
9	136999589	rs28408860	T	C	3	11	14	0	0	14	0	0
9	136999786	rs28464304	A	G	0	7	7	0	0	7	0	0
9	137002910	rs28437234	G	C	3	3	6	0	0	6	0	0
9	137003821	rs35401074	A	T	2	5	7	0	0	7	0	0
9	137004530	rs35949820	T	G	6	3	9	0	0	9	0	0
9	137004742	rs34417824	C	A	3	3	6	0	0	6	0	0
9	137005023	rs11556390	C	T	42	39	81	0	3	84	0	0
9	137018130	rs28604373	G	A	2	6	8	0	1	9	0	0
9	137019277	rs28705314	T	C	2	6	8	0	0	8	0	0
9	137019511	rs28703244	T	C	4	6	10	0	0	10	0	0
9	137021803	rs28522840	C	T	7	8	15	0	0	15	0	0
9	137021806	.	C	T	9	7	16	0	0	16	0	0
9	137022327	rs28635910	C	A	6	7	13	0	0	13	0	0
9	137023979	rs11556391	G	A	3	22	25	0	4	29	0	0
9	137024248	rs1128044	G	C	49	54	103	0	0	103	0	0
9	137686951	rs41310207	G	A	5	3	8	0	0	8	0	0
9	137809685	rs10858293	C	A	73	140	213	0	1	214	0	0
9	138391774	rs2274652	C	T	3	3	6	0	0	6	0	0
9	138394124	rs80015265	C	T	3	4	7	0	0	7	0	0
9	138394852	rs78100744	C	T	8	6	14	0	0	14	0	0
9	138395052	rs75139894	C	T	6	6	12	0	0	12	0	0
9	138395122	rs79342731	G	A	9	11	20	0	0	20	0	0
9	138395969	rs3748199	A	G	118	156	274	0	13	287	0	0
9	138396120	rs3748200	A	T	114	150	264	0	2	266	0	0
9	138396198	rs3748201	A	G	132	158	290	0	4	294	0	0
9	138396251	rs535	A	G	132	148	280	0	1	281	0	0
9	138749392	rs11103202	T	G	4	2	6	0	0	6	0	0
9	138825117	rs6569	A	C	274	144	418	0	1	419	0	0
9	138830432	rs11103234	G	A	2	5	7	0	0	7	0	0
9	138831361	rs35925532	C	T	5	3	8	0	0	8	0	0
9	138831567	rs1044193	T	C	194	101	295	0	1	296	0	0
9	138833207	rs4842054	G	A	9	4	13	0	0	13	0	0
9	138834225	rs872373	A	G	6	1	7	0	0	7	0	0
9	138836366	rs12554408	G	C	2	8	10	0	0	10	0	0
9	138836695	rs2297692	G	A	6	2	8	0	0	8	0	0
9	138837113	rs10776856	T	C	12	14	26	0	0	26	0	0
9	138837958	rs2297691	C	T	15	1	16	0	0	16	0	0
9	138839189	rs7871519	C	G	5	3	8	0	0	8	0	0
9	138901176	rs117654243	A	G	3	8	11	0	0	11	0	0
9	138901270	rs10776868	A	G	4	3	7	0	0	7	0	0
9	138901319	rs7848231	T	C	8	4	12	0	0	12	0	0
9	138902790	rs7024676	A	G	4	2	6	0	0	6	0	0
9	138903671	rs9626	A	G	10	2	12	0	0	12	0	0
9	139008287	rs71508837	C	T	5	15	20	0	1	21	0	0
9	139099073	rs3780190	A	G	48	98	146	0	2	148	0	0
9	139100413	rs7024579	C	T	23	70	93	0	1	94	0	0
9	139100453	rs76160473	C	T	27	69	96	0	1	97	0	0
9	139100805	rs9696116	T	C	27	80	107	0	3	110	0	0
9	139101772	rs7031621	G	A	9	16	25	0	0	25	0	0
9	139102317	rs61482805	C	G	9	13	22	0	0	22	0	0
9	139103955	rs7040556	G	A	4	2	6	0	0	6	0	0
9	139109263	rs72773791	G	A	1	8	9	0	0	9	0	0
9	139109573	rs55683566	G	A	9	12	21	0	0	21	0	0
9	139110171	rs55726506	C	G	6	3	9	0	0	9	0	0
9	139110654	rs12684650	C	T	31	52	83	0	2	85	0	0
9	139111870	rs7849585	G	T	5	2	7	0	0	7	0	0
9	139121740	rs12338076	A	C	12	2	14	0	0	14	0	0
9	139122363	rs55679545	G	A	6	4	10	0	0	10	0	0
9	139371039	.	T	C	60	76	136	0	4	140	0	0
9	139426333	rs570172075	C	T	1	5	6	0	1	7	0	0
9	139435397	rs3013304	G	C	3	3	6	0	0	6	0	0
9	139437410	rs3013305	G	A	7	2	9	0	0	9	0	0
9	139443687	rs11792084	G	T	24	10	34	0	0	34	0	0
9	139443847	rs2282183	C	T	6	0	6	0	0	6	0	0
9	139443956	rs710411	G	A	18	12	30	0	0	30	0	0
9	139444091	rs1058232	A	G	14	12	26	0	0	26	0	0
9	139444102	rs1058233	C	T	11	13	24	0	0	24	0	0
9	139608215	rs11145838	C	T	79	71	150	0	1	151	0	0
9	139698049	rs11145888	T	A	6	2	8	0	0	8	0	0
9	139712826	.	A	C	8	0	8	0	7	15	0	0
9	139721513	rs2811751	T	C	5	4	9	0	0	9	0	0
9	139731531	rs140657278	G	A	22	20	42	0	0	42	0	0
9	139744807	rs872463	A	G	17	10	27	0	0	27	0	0
9	139746992	rs10123375	G	A	4	4	8	0	0	8	0	0
9	139752899	.	T	G	12	12	24	0	0	24	0	0
9	139790471	rs2784088	G	A	2	4	6	0	0	6	0	0
9	139790648	rs2811758	A	G	4	2	6	0	0	6	0	0
9	139811482	rs7039663	G	A	5	2	7	0	0	7	0	0
9	139811585	rs7027246	A	G	6	0	6	0	0	6	0	0
9	139820421	rs7852970	G	A	67	56	123	0	3	126	0	0
9	139836362	rs7040705	G	A	44	36	80	0	1	81	0	0
9	139837990	rs2271872	G	C	9	8	17	0	0	17	0	0
9	139838690	rs28578007	T	C	3	3	6	0	0	6	0	0
9	139840471	rs7862602	G	T	3	3	6	0	0	6	0	0
9	139902166	rs41306732	G	A	128	146	274	0	0	274	0	0
9	139904037	rs7048567	A	G	88	103	191	0	3	194	0	0
9	139906359	rs2271862	G	A	64	56	120	0	0	120	0	0
9	139912178	rs879854	G	A	3	3	6	0	0	6	0	0
9	139925383	rs61730153	C	T	13	9	22	0	0	22	0	0
9	139927062	rs4880192	A	G	2	5	7	0	0	7	0	0
9	139932211	rs1138628	C	A	19	22	41	0	1	42	0	0
9	139934020	rs6605	G	A	388	627	1015	0	8	1023	0	0
9	139934107	rs6604	G	A	434	672	1106	0	5	1112	1	0
9	139934907	rs9411298	G	A	3	7	10	0	0	10	0	0
9	139938793	rs9411299	G	C	40	56	96	0	0	96	0	0
9	139956954	rs10870175	T	C	4	11	15	0	0	15	0	0
9	139958296	rs3750517	T	C	4	8	12	0	0	12	0	0
9	139996933	rs10118812	T	G	15	5	20	0	0	20	0	0
9	139997293	rs142818580	C	T	14	0	14	0	1	15	0	0
9	139997294	rs62584555	A	G	10	1	11	0	4	15	0	0
9	139997295	rs560212932	C	G	14	1	15	0	0	15	0	0
9	139997386	rs62584557	A	G	17	1	18	0	2	20	0	0
9	139997719	rs111877141	A	G	16	6	22	0	1	23	0	0
9	139998089	rs4880205	C	T	12	1	13	0	0	13	0	0
9	139998480	rs4880206	G	A	31	12	43	0	0	43	0	0
9	139998677	rs11145995	G	A	21	8	29	0	0	29	0	0
9	139998693	rs4880207	G	T	20	10	30	0	1	31	0	0
9	140001978	rs12115325	C	A	7	1	8	0	0	8	0	0
9	140002187	rs12000517	C	T	10	3	13	0	0	13	0	0
9	140002220	rs10117795	A	G	11	0	11	0	1	12	0	0
9	140002261	rs11790092	A	G	6	0	6	0	0	6	0	0
9	140002501	rs6420280	T	C	21	6	27	0	0	27	0	0
9	140002754	rs4880090	C	T	29	10	39	0	1	40	0	0
9	140002989	rs4880091	T	C	268	148	416	0	3	419	0	0
9	140005256	rs112261926	G	A	5	4	9	0	0	9	0	0
9	140005916	rs72763269	G	A	14	5	19	0	0	19	0	0
9	140006425	rs10747048	C	G	889	408	1297	0	10	1308	1	0
9	140006491	rs10870180	C	T	27	11	38	0	0	38	0	0
9	140006892	rs10870181	C	G	238	118	356	0	2	358	0	0
9	140008750	rs10747049	G	C	220	99	319	0	1	320	0	0
9	140008934	rs11145999	A	G	200	94	294	0	1	295	0	0
9	140071163	rs28676711	G	C	30	29	59	0	0	59	0	0
9	140071411	rs55956196	A	G	22	23	45	0	1	46	0	0
9	140071683	rs28544087	A	G	27	34	61	0	0	61	0	0
9	140072573	rs28664164	T	C	25	25	50	0	0	50	0	0
9	140073120	rs28560209	T	C	19	18	37	0	0	37	0	0
9	140073294	rs28393706	T	C	12	20	32	0	0	32	0	0
9	140074578	rs55642373	C	T	21	14	35	0	0	35	0	0
9	140075181	rs73571568	G	C	18	21	39	0	0	39	0	0
9	140076358	rs28369482	G	A	5	6	11	0	1	12	0	0
9	140076439	rs28665875	T	C	7	10	17	0	0	17	0	0
9	140076464	rs72763283	G	A	5	9	14	0	0	14	0	0
9	140077027	rs9775861	G	C	4	11	15	0	0	15	0	0
9	140077639	rs11549105	G	A	63	83	146	0	2	148	0	0
9	140077729	rs28490558	G	A	0	6	6	0	0	6	0	0
9	140078767	rs72763284	A	G	10	14	24	0	0	24	0	0
9	140079522	rs11549106	G	A	26	53	79	0	0	79	0	0
9	140079975	rs76044090	C	A	35	12	47	0	0	47	0	0
9	140080008	rs28452292	C	G	11	30	41	0	0	41	0	0
9	140080499	rs3922734	A	G	6	15	21	0	0	21	0	0
9	140080583	rs3922735	G	A	7	19	26	0	1	27	0	0
9	140083122	rs111630032	G	A	1	11	12	0	0	12	0	0
9	140083320	rs11556579	G	C	2	7	9	0	0	9	0	0
9	140084376	rs11556580	G	A	267	210	477	0	7	484	0	0
9	140084485	rs3087779	G	A	281	202	483	0	4	487	0	0
9	140084753	rs1128395	A	G	67	49	116	0	1	117	0	0
9	140100224	rs7032361	A	G	12	12	24	0	1	25	0	0
9	140101685	rs7027347	G	A	6	12	18	0	1	19	0	0
9	140101687	rs6606564	A	G	6	13	19	0	0	19	0	0
9	140101944	rs6606563	A	G	8	8	16	0	0	16	0	0
9	140102104	rs7033551	A	G	9	6	15	0	0	15	0	0
9	140102939	rs7388751	C	A	4	3	7	0	0	7	0	0
9	140104704	rs7031301	T	C	12	3	15	0	1	16	0	0
9	140105550	rs7047363	A	G	13	6	19	0	0	19	0	0
9	140106538	rs34383296	G	A	16	11	27	0	1	28	0	0
9	140107336	rs7389314	G	T	31	18	49	0	0	49	0	0
9	140107714	rs7390308	A	G	52	32	84	0	0	84	0	0
9	140107921	rs7469085	A	G	38	35	73	0	0	73	0	0
9	140110274	rs7390663	T	C	6	1	7	0	0	7	0	0
9	140119884	rs6606567	A	G	1	5	6	0	0	6	0	0
9	140120396	rs6606566	C	T	11	16	27	0	0	27	0	0
9	140166597	rs61751916	G	A	116	81	197	0	0	197	0	0
9	140195149	rs114550172	T	C	14	13	27	0	1	28	0	0
9	140202194	rs13288421	T	C	11	8	19	0	0	19	0	0
9	140238885	rs7848746	A	G	9	17	26	0	0	26	0	0
9	140239578	rs11531966	C	T	5	10	15	0	0	15	0	0
9	140243844	rs28545754	C	T	7	16	23	0	0	23	0	0
9	140247143	rs7020732	T	G	14	16	30	0	1	31	0	0
9	140247973	rs11531965	A	G	1	7	8	0	0	8	0	0
9	140250808	rs76472430	C	T	6	9	15	0	0	15	0	0
9	140250818	rs7389423	C	T	5	10	15	0	0	15	0	0
9	140262426	rs11533158	C	T	31	46	77	0	0	77	0	0
9	140321666	rs11534413	C	T	11	18	29	0	0	29	0	0
9	140321703	rs11534414	A	G	13	19	32	0	0	32	0	0
9	140322404	rs28580293	C	G	30	44	74	0	0	74	0	0
9	140322640	rs28553346	C	T	16	12	28	0	1	29	0	0
9	140322814	rs13296446	A	G	17	23	40	0	0	40	0	0
9	140326893	rs6606581	A	G	6	1	7	0	0	7	0	0
9	140328077	rs35138580	C	T	31	62	93	0	0	93	0	0
9	140329141	rs28649497	C	T	8	1	9	0	0	9	0	0
9	140329265	rs28725243	G	C	8	0	8	0	0	8	0	0
9	140330976	rs13297080	T	C	4	2	6	0	0	6	0	0
9	140332478	rs6606582	A	G	9	0	9	0	0	9	0	0
9	140349874	rs28585539	C	G	22	31	53	0	0	53	0	0
9	140356422	rs28452008	G	C	19	16	35	0	0	35	0	0
9	140356721	rs78453847	C	T	15	17	32	0	0	32	0	0
9	140361847	rs61738892	G	A	4	6	10	0	1	11	0	0
9	140373575	rs61747535	C	G	3	4	7	0	0	7	0	0
9	140373607	rs61747526	C	T	6	4	10	0	0	10	0	0
9	140392616	rs61754920	G	A	7	6	13	0	0	13	0	0
9	140403805	rs35568998	A	G	4	2	6	0	0	6	0	0
9	140414410	rs11137410	C	T	6	2	8	0	0	8	0	0
9	140449582	rs10110	A	C	90	79	169	0	1	170	0	0
9	140450159	rs1105221	C	T	3	9	12	0	1	13	0	0
9	140470119	rs863701	A	G	5	6	11	0	0	11	0	0
9	140477032	rs74964161	T	C	79	145	224	0	8	232	0	0
9	140481884	rs2297006	A	G	15	11	26	0	0	26	0	0
9	140481946	rs2297005	G	A	16	14	30	0	0	30	0	0
9	140483339	rs2297004	G	A	13	3	16	0	0	16	0	0
9	140507480	rs62622789	C	T	52	43	95	0	0	96	1	0
9	140512555	rs1045777	G	A	23	17	40	0	0	40	0	0
9	140533378	rs11137163	C	G	3	4	7	0	0	7	0	0
9	140562536	rs11137173	T	C	0	6	6	0	0	6	0	0
9	140563979	.	T	G	9	42	51	0	3	54	0	0
9	140615749	.	A	G	14	4	18	0	3	21	0	0
9	140624195	rs112736461	A	C	18	11	29	0	1	30	0	0
9	140631779	rs112972781	A	G	2	6	8	0	0	8	0	0
9	140638416	rs1129767	G	A	65	95	160	0	0	160	0	0
X	217704	rs778125799	G	C	47	56	103	0	1	104	0	0
X	220724	rs145348080	G	A	12	8	20	0	0	20	0	0
X	222799	rs35298808	G	C	4	2	6	0	0	6	0	0
X	224593	rs28594653	T	C	17	18	35	0	0	35	0	0
X	224939	rs28590518	T	C	14	16	30	0	0	30	0	0
X	225957	rs28460549	C	G	4	4	8	0	0	8	0	0
X	229542	rs1140798	G	A	29	31	60	0	0	60	0	0
X	230206	rs35174923	A	G	1	7	8	0	0	8	0	0
X	230399	rs9646386	C	T	5	2	7	0	0	7	0	0
X	230592	rs4074621	G	C	4	4	8	0	0	8	0	0
X	230603	.	C	G	3	4	7	0	0	7	0	0
X	294800	rs1139186	C	T	4	2	6	0	0	6	0	0
X	295069	rs1133535	A	G	6	2	8	0	0	8	0	0
X	295097	rs14127	C	T	6	2	8	0	0	8	0	0
X	296098	rs28565116	G	C	9	8	17	0	0	17	0	0
X	296441	rs28654078	G	A	7	4	11	0	0	11	0	0
X	297263	rs28406082	C	T	4	2	6	0	0	6	0	0
X	299360	rs1133520	G	A	11	20	31	0	1	32	0	0
X	299501	rs2738374	C	T	2	8	10	0	0	10	0	0
X	299635	rs6655399	C	T	10	2	12	0	0	12	0	0
X	318819	rs2738326	T	C	4	5	9	0	0	9	0	0
X	319306	rs5987291	G	A	3	5	8	0	0	8	0	0
X	322161	rs3813594	A	G	6	13	19	0	0	19	0	0
X	322193	rs3813593	C	T	9	5	14	0	0	14	0	0
X	1314931	rs151218732	C	T	7	8	15	0	0	15	0	0
X	1315104	rs9803466	G	C	2	4	6	0	0	6	0	0
X	1324509	rs28719175	G	A	3	3	6	0	0	6	0	0
X	1331495	rs140859855	G	C	4	4	8	0	0	8	0	0
X	1412738	.	G	A	4	4	8	0	0	8	0	0
X	1419571	rs28484864	C	G	5	1	6	0	0	6	0	0
X	1455800	rs7471052	T	C	62	38	100	0	1	101	0	0
X	1456892	rs6607440	C	T	7	3	10	0	0	10	0	0
X	1460495	rs3202254	G	A	8	13	21	0	0	21	0	0
X	1487210	rs112024042	A	G	5	4	9	0	0	9	0	0
X	1487215	rs17881823	T	C	5	3	8	0	0	8	0	0
X	1498993	rs5989746	A	G	2	4	6	0	0	6	0	0
X	1499770	rs5989802	A	G	5	10	15	0	0	15	0	0
X	1499835	rs5989668	T	C	10	10	20	0	0	20	0	0
X	1499878	rs5989670	T	G	13	9	22	0	0	22	0	0
X	1506318	rs6644951	C	G	10	0	10	0	0	10	0	0
X	1506944	rs4589044	A	G	6	0	6	0	0	6	0	0
X	1507976	rs5989744	G	A	5	1	6	0	0	6	0	0
X	1508067	rs4244917	A	G	11	2	13	0	2	15	0	0
X	1508324	rs7205	G	A	1152	1115	2267	0	9	2276	0	0
X	1510983	.	C	T	315	243	558	0	2	560	0	0
X	1516114	rs4933054	A	C	9	11	20	0	0	20	0	0
X	1530313	rs28517674	C	T	7	0	7	0	0	7	0	0
X	1530458	rs28453965	T	C	6	2	8	0	0	8	0	0
X	1531265	rs28524067	T	C	1	5	6	0	0	6	0	0
X	1531416	rs5989841	T	C	3	4	7	0	0	7	0	0
X	1531442	rs28726233	G	T	4	3	7	0	0	7	0	0
X	1531648	rs1127297	C	T	129	145	274	0	4	278	0	0
X	1531765	rs5948842	C	G	88	31	119	0	0	119	0	0
X	1531770	rs5949004	T	C	78	31	109	0	3	112	0	0
X	1531838	rs5949005	A	G	66	14	80	0	1	81	0	0
X	1531962	rs5949007	G	C	68	17	85	0	0	85	0	0
X	1532137	rs4933099	C	G	8	33	41	0	0	41	0	0
X	1532147	rs5989683	C	T	36	8	44	0	0	44	0	0
X	1533946	rs7472831	G	C	1	6	7	0	0	7	0	0
X	1537881	rs4503285	C	T	42	40	82	0	0	82	0	0
X	1547202	rs191792639	G	A	10	4	14	0	0	14	0	0
X	1553246	rs113189122	G	C	9	1	10	0	0	10	0	0
X	1554997	rs6644940	C	A	8	11	19	0	1	20	0	0
X	1555085	rs6644941	G	C	3	6	9	0	0	9	0	0
X	1555153	rs112328103	G	A	1	6	7	0	0	7	0	0
X	1555157	rs186858909	C	G	1	7	8	0	0	8	0	0
X	1555159	rs188687086	G	A	1	7	8	0	0	8	0	0
X	1555196	rs6644942	T	A	2	5	7	0	0	7	0	0
X	1555820	rs28870774	T	C	7	8	15	0	0	15	0	0
X	1555928	rs28809182	C	G	2	6	8	0	0	8	0	0
X	1556120	rs55708076	A	G	2	6	8	0	0	8	0	0
X	1556135	rs111810539	G	A	2	5	7	0	0	7	0	0
X	1556952	rs6645247	T	C	5	2	7	0	0	7	0	0
X	1557100	rs28607525	C	A	5	2	7	0	0	7	0	0
X	1557274	rs28437053	C	G	4	7	11	0	0	11	0	0
X	1557280	rs28366454	A	T	4	6	10	0	0	10	0	0
X	1557304	rs28653052	T	C	4	5	9	0	0	9	0	0
X	1557307	rs28537349	G	C	4	5	9	0	0	9	0	0
X	1562290	.	T	A	6	2	8	0	1	9	0	0
X	1562300	rs193002489	G	A	4	4	8	0	2	10	0	0
X	1562309	rs62604193	T	A	5	2	7	0	0	7	0	0
X	1562480	rs5989669	C	T	9	6	15	0	0	15	0	0
X	1563002	rs4933089	A	G	4	3	7	0	0	7	0	0
X	1563658	rs5949197	T	C	3	3	6	0	0	6	0	0
X	1564343	rs6655422	T	C	4	4	8	0	1	9	0	0
X	1564370	rs141396562	A	G	4	6	10	0	0	10	0	0
X	1583481	rs73182974	C	T	51	49	100	0	0	100	0	0
X	1583926	rs62604197	G	A	47	30	77	0	2	79	0	0
X	1583979	rs62604198	C	T	45	26	71	0	0	71	0	0
X	1591207	rs4589043	A	G	5	1	6	0	0	6	0	0
X	1591249	rs55691527	A	G	5	1	6	0	0	6	0	0
X	1635629	rs28778049	A	G	6	0	6	0	0	6	0	0
X	1640371	rs6644727	T	C	3	11	14	0	0	14	0	0
X	1640573	rs6644728	G	T	10	4	14	0	0	14	0	0
X	1640746	rs73186942	C	T	5	8	13	0	0	13	0	0
X	1641710	.	G	C	7	6	13	0	0	13	0	0
X	1643200	rs73186946	C	T	3	4	7	0	0	7	0	0
X	1643897	rs73186948	A	G	4	9	13	0	0	13	0	0
X	1644087	rs28626201	A	G	4	3	7	0	0	7	0	0
X	1644278	rs28373193	C	T	1	5	6	0	0	6	0	0
X	1644333	rs28623387	T	C	4	3	7	0	0	7	0	0
X	1644843	rs5948937	A	T	3	4	7	0	0	7	0	0
X	1645215	rs73186953	C	A	8	5	13	0	0	13	0	0
X	1645336	rs5948939	G	A	2	6	8	0	0	8	0	0
X	1645816	rs73186956	C	T	4	3	7	0	0	7	0	0
X	1645852	rs113010926	T	C	4	3	7	0	0	7	0	0
X	1646273	rs73186961	C	A	8	4	12	0	0	12	0	0
X	1647697	rs73186965	T	A	4	2	6	0	0	6	0	0
X	1647809	rs73186966	G	T	3	3	6	0	0	6	0	0
X	1648397	rs73186969	T	G	8	7	15	0	0	15	0	0
X	1648516	rs5948941	C	T	4	6	10	0	0	10	0	0
X	1648518	rs73186971	C	A	6	4	10	0	0	10	0	0
X	1648558	rs73186972	C	T	5	3	8	0	0	8	0	0
X	1648777	rs73186974	T	G	4	3	7	0	0	7	0	0
X	1648783	rs6644734	G	A	3	3	6	0	0	6	0	0
X	1650593	rs73186987	A	C	6	2	8	0	0	8	0	0
X	1650713	rs113642995	C	T	6	0	6	0	0	6	0	0
X	1652018	rs4418527	C	T	5	2	7	0	0	7	0	0
X	1711165	rs7881311	A	G	5	3	8	0	0	8	0	0
X	1711423	rs138545663	C	T	4	3	7	0	1	8	0	0
X	1713021	rs6644621	C	T	118	114	232	0	0	232	0	0
X	1715137	.	C	A	3	7	10	0	1	11	0	0
X	1717021	rs28535368	G	A	3	3	6	0	0	6	0	0
X	1718360	rs58902273	G	A	27	28	55	0	0	55	0	0
X	1718647	rs61538707	G	A	22	23	45	0	0	45	0	0
X	1719897	rs28661622	C	G	56	52	108	0	1	109	0	0
X	1720821	rs1128551	C	T	301	227	528	0	13	541	0	0
X	1721163	rs11553959	T	G	259	314	573	0	2	575	0	0
X	1755404	rs4933063	C	T	4	4	8	0	0	8	0	0
X	1852868	rs5948866	G	C	5	2	7	0	0	7	0	0
X	2139200	rs3210910	T	C	14	5	19	0	0	19	0	0
X	2404619	rs1044307	G	A	43	54	97	0	1	98	0	0
X	2405042	rs6567595	T	C	48	56	104	0	1	105	0	0
X	2405396	rs1062804	C	A	33	48	81	0	0	81	0	0
X	2405741	rs17842876	A	G	32	33	65	0	0	65	0	0
X	2408437	rs3752331	G	A	12	5	17	0	0	17	0	0
X	2415233	rs5939505	T	C	6	8	14	0	0	14	0	0
X	2416792	rs4892935	C	T	5	3	8	0	1	9	0	0
X	2533098	rs7061856	A	G	3	3	6	0	0	6	0	0
X	2534707	rs5939243	C	T	6	3	9	0	0	9	0	0
X	2534840	rs7884116	T	A	3	6	9	0	1	10	0	0
X	2535527	rs5939244	A	C	3	5	8	0	1	9	0	0
X	2535604	rs5939245	A	G	4	11	15	0	0	15	0	0
X	2535980	rs5939246	C	G	13	11	24	0	0	24	0	0
X	2550308	.	C	T	6	0	6	0	0	6	0	0
X	2550312	.	A	G	6	0	6	0	0	6	0	0
X	2550460	rs5939253	A	G	7	1	8	0	0	8	0	0
X	2555569	rs6567632	G	A	3	5	8	0	0	8	0	0
X	2609717	rs5939299	G	T	4	7	11	0	0	11	0	0
X	2633474	rs7060867	A	G	0	11	11	0	0	11	0	0
X	2634821	rs7051896	A	T	1	11	12	0	0	12	0	0
X	2635244	rs28700076	C	G	4	13	17	0	0	17	0	0
X	2640910	rs187841346	C	T	8	7	15	0	0	15	0	0
X	2641009	rs144218590	G	A	9	9	18	0	1	19	0	0
X	2642566	rs312188	C	T	6	1	7	0	0	7	0	0
X	2643371	rs312190	T	C	2	6	8	0	0	8	0	0
X	2651839	rs41311467	G	T	3	3	6	0	0	6	0	0
X	2653552	rs311092	C	G	7	3	10	0	1	11	0	0
X	2654460	rs311094	A	G	8	4	12	0	0	12	0	0
X	2656850	rs1683997	C	T	7	3	10	0	0	10	0	0
X	2835863	.	G	T	11	0	11	0	0	11	0	0
X	2835964	.	G	A	10	0	10	0	1	11	0	0
X	2835985	rs748243474	G	A	10	0	10	0	1	11	0	0
X	2835989	rs143238998	A	C	11	0	11	0	0	11	0	0
X	2835993	rs755296450	G	A	11	0	11	0	0	11	0	0
X	2835995	.	C	A	10	0	10	0	0	10	0	0
X	2836037	rs211653	G	C	0	9	9	0	0	9	0	0
X	2836041	.	A	T	9	0	9	0	0	9	0	0
X	2836047	.	C	T	10	0	10	0	0	10	0	0
X	2836060	.	G	A	9	0	9	0	0	9	0	0
X	2836084	.	C	G	7	0	7	0	0	7	0	0
X	2836138	.	G	A	6	0	6	0	0	6	0	0
X	73802941	.	G	A	44	0	44	0	0	44	0	0
X	73802947	.	A	G	44	0	44	0	0	44	0	0
X	73802967	.	C	A	42	0	42	0	1	43	0	0
X	73802970	.	T	C	26	16	42	0	0	42	0	0
X	73803082	.	C	T	24	0	24	0	0	24	0	0
X	73803084	.	C	T	22	0	22	0	1	23	0	0
X	73803099	.	C	T	22	0	22	0	0	22	0	0
X	73803100	.	G	A	22	0	22	0	0	22	0	0
X	73803117	.	T	A	17	0	17	0	0	17	0	0
X	73803129	.	G	A	16	0	16	0	0	16	0	0
X	73803149	.	A	G	7	0	7	0	0	7	0	0
X	73803162	.	G	C	8	0	8	0	0	8	0	0
X	73803191	.	A	G	16	0	16	0	0	16	0	0
X	73803222	.	T	C	15	1	16	0	0	16	0	0
X	149115253	.	C	T	2	8	10	0	0	10	0	0
X	155111077	rs28413172	C	T	0	78	78	0	0	78	0	0
X	155111406	rs34455089	C	G	12	0	12	0	0	12	0	0
X	155115187	rs56077133	C	T	0	32	32	0	0	32	0	0
X	155128309	rs6642249	A	T	0	6	6	0	0	6	0	0
X	155166157	rs4893108	T	C	0	6	6	0	0	6	0	0
X	155167945	rs5983836	C	T	0	11	11	0	0	11	0	0
X	155169158	rs741960	C	T	0	9	9	0	0	9	0	0
X	155251631	.	A	G	10	1	11	0	0	11	0	0
X	155251634	rs200399479	G	A	11	2	13	0	0	13	0	0
X	155251698	.	G	A	5	6	11	0	2	13	0	0
X	155251726	.	G	C	15	4	19	0	0	19	0	0
X	155252104	.	T	C	24	8	32	0	1	33	0	0
X	155252329	.	T	C	7	7	14	0	0	14	0	0
X	155253444	.	G	C	13	4	17	0	0	17	0	0
X	155253526	.	A	T	13	50	63	0	1	64	0	0
X	155253590	.	C	T	77	81	158	0	0	158	0	0
X	155253826	rs779892608	T	C	73	15	88	0	1	89	0	0
X	155254016	.	T	C	0	16	16	0	0	16	0	0
X	155254689	.	C	T	2	11	13	0	0	13	0	0
X	155254781	.	G	A	0	26	26	0	0	26	0	0
X	155255248	.	C	T	67	0	67	0	1	68	0	0
