contig	position	variantID	refAllele	altAllele	refCount	altCount	totalCount	lowMAPQDepth	lowBaseQDepth	rawDepth	otherBases	improperPairs
1	14699	.	C	G	394	2	396	0	1	397	0	0
1	14907	.	A	G	10	22	32	0	1	33	0	0
1	14930	rs6682385	A	G	12	26	38	0	1	39	0	0
1	16298	.	C	T	46	36	82	0	0	82	0	0
1	16378	.	T	C	65	70	135	0	1	136	0	0
1	16534	.	C	T	45	54	99	0	4	103	0	0
1	16571	.	G	A	18	50	68	0	0	68	0	0
1	17746	.	A	G	8	2	10	0	0	10	0	0
1	753474	rs2073814	C	G	2	4	6	0	0	6	0	0
1	762589	rs3115848	G	C	4	8	12	0	0	12	0	0
1	762592	rs3131950	C	G	4	8	12	0	0	12	0	0
1	762601	rs3131949	T	C	4	7	11	0	1	12	0	0
1	762632	rs3131948	T	A	3	7	10	0	0	10	0	0
1	777122	rs2980319	A	T	12	11	23	0	0	23	0	0
1	778745	rs1055606	A	G	5	8	13	0	0	13	0	0
1	779322	rs4040617	A	G	3	3	6	0	0	6	0	0
1	787399	rs2905055	G	T	2	7	9	0	0	9	0	0
1	788840	.	T	C	4	8	12	0	1	13	0	0
1	788844	.	C	G	6	3	9	0	0	9	0	0
1	788889	.	C	T	8	1	9	0	0	9	0	0
1	791191	rs111818025	G	A	4	4	8	0	0	8	0	0
1	792263	rs1044922	A	G	9	6	15	0	0	15	0	0
1	878447	.	C	T	8	7	15	0	0	15	0	0
1	879676	rs6605067	G	A	103	115	218	0	9	227	0	0
1	879687	rs2839	T	C	110	119	229	0	3	232	0	0
1	881627	rs2272757	G	A	192	187	379	0	2	381	0	0
1	887801	rs3828047	A	G	162	157	319	0	4	323	0	0
1	888639	rs3748596	T	C	140	90	230	0	2	232	0	0
1	888659	rs3748597	T	C	145	99	244	0	2	246	0	0
1	889238	rs3828049	G	A	144	115	259	0	3	262	0	0
1	889638	rs13303206	G	C	10	9	19	0	0	19	0	0
1	889713	rs13303051	C	A	11	10	21	0	0	21	0	0
1	890930	.	G	C	5	5	10	0	1	11	0	0
1	891021	rs13302957	G	A	6	4	10	0	0	10	0	0
1	891059	rs13303065	C	T	4	7	11	0	0	11	0	0
1	897325	rs4970441	G	C	6	10	16	0	1	17	0	0
1	897564	rs13303229	T	C	5	9	14	0	0	14	0	0
1	897738	rs6696971	C	T	12	10	22	0	0	22	0	0
1	900730	rs3935066	G	A	6	6	12	0	0	12	0	0
1	900972	rs9697711	T	G	17	20	37	0	0	37	0	0
1	901023	rs13303351	T	C	8	15	23	0	0	23	0	0
1	949608	rs1921	G	A	55	53	108	0	1	109	0	0
1	990280	rs4275402	C	T	4	2	6	0	0	6	0	0
1	990380	rs3121561	C	T	3	4	7	0	0	7	0	0
1	990417	rs2465136	T	C	4	4	8	0	0	8	0	0
1	991203	.	A	C	14	7	21	0	0	21	0	0
1	995481	rs9442393	T	G	15	19	34	0	0	34	0	0
1	997012	.	G	A	11	11	22	0	0	22	0	0
1	1140435	rs1815606	G	T	7	7	14	0	0	14	0	0
1	1147422	rs17568	C	T	24	33	57	0	1	58	0	0
1	1147562	rs376947618	G	A	16	23	39	0	0	39	0	0
1	1153868	.	G	A	315	350	665	0	2	667	0	0
1	1155238	rs12134035	G	A	19	19	38	0	0	38	0	0
1	1156131	rs2887286	T	C	21	24	45	0	0	45	0	0
1	1156429	rs944369	C	G	8	23	31	0	0	31	0	0
1	1158631	rs6603781	A	G	310	352	662	0	3	665	0	0
1	1159517	rs6702268	T	C	4	2	6	0	0	6	0	0
1	1190523	rs1058161	C	T	75	76	151	0	1	152	0	0
1	1194804	rs11804831	T	C	3	5	8	0	0	8	0	0
1	1206482	.	C	A	4	2	6	0	0	6	0	0
1	1222996	rs140333930	C	T	1	5	6	0	0	6	0	0
1	1226889	rs609805	G	A	6	4	10	0	0	10	0	0
1	1227249	rs621668	T	C	8	5	13	0	0	13	0	0
1	1235710	rs640712	T	A	6	1	7	0	1	8	0	0
1	1240237	rs12409587	C	G	2	4	6	0	0	6	0	0
1	1241529	rs1536168	A	G	3	3	6	0	0	6	0	0
1	1247494	rs12103	T	C	202	156	358	0	2	360	0	0
1	1249187	rs12142199	G	A	184	147	331	0	2	333	0	0
1	1254255	rs62623580	G	A	4	3	7	0	0	7	0	0
1	1254436	rs1886773	A	G	5	4	9	0	0	9	0	0
1	1254443	rs1886772	G	A	7	4	11	0	0	11	0	0
1	1254841	rs10907179	C	G	147	116	263	0	0	263	0	0
1	1263144	rs307350	G	A	10	8	18	0	0	18	0	0
1	1263362	rs4970433	G	A	15	10	25	0	0	25	0	0
1	1310668	rs2242398	A	C	19	13	32	0	1	33	0	0
1	1323078	rs12729599	A	G	11	19	30	0	0	30	0	0
1	1324324	rs9726836	G	A	29	24	53	0	0	53	0	0
1	1325207	rs1240748	C	T	13	21	34	0	1	35	0	0
1	1328971	rs11485864	C	T	67	48	115	0	0	115	0	0
1	1329803	rs1240747	A	G	29	27	56	0	1	57	0	0
1	1330430	rs113548627	G	A	22	34	56	0	2	58	0	0
1	1330726	rs1240746	A	G	35	25	60	0	0	60	0	0
1	1332112	rs11488469	A	G	7	7	14	0	0	14	0	0
1	1333436	rs1240743	C	A	9	4	13	0	1	14	0	0
1	1335302	rs1240707	C	T	4	3	7	0	0	7	0	0
1	1336482	rs140894412	T	C	14	9	23	0	0	23	0	0
1	1336678	rs17139966	G	A	6	8	14	0	1	15	0	0
1	1337220	rs139295104	G	A	5	5	10	0	0	10	0	0
1	1337837	rs1240709	A	G	7	15	22	0	0	22	0	0
1	1340696	rs4970446	T	C	7	4	11	0	0	11	0	0
1	1344482	rs145326937	A	G	3	4	7	0	0	7	0	0
1	1375810	rs4590	C	G	12	12	24	0	1	25	0	0
1	1469546	rs3128344	G	A	49	11	60	0	0	60	0	0
1	1469598	rs9439464	C	G	63	1	64	0	2	66	0	0
1	1469599	rs3128343	G	C	65	1	66	0	0	66	0	0
1	1469606	rs35611435	C	T	67	3	70	0	0	70	0	0
1	1477244	rs7290	T	C	112	132	244	0	0	244	0	0
1	1479333	rs7533	A	G	209	174	383	0	2	385	0	0
1	1497008	rs3766170	T	C	4	4	8	0	0	8	0	0
1	1497201	rs3766169	A	C	2	7	9	0	0	9	0	0
1	1497824	rs2296716	C	T	42	52	94	0	0	94	0	0
1	1499298	rs9439468	A	G	38	50	88	0	6	94	0	0
1	1510801	rs7519837	C	T	7	9	16	0	0	16	0	0
1	1511104	rs7556282	G	C	0	6	6	0	0	6	0	0
1	1574019	rs9442412	A	G	6	4	10	0	0	10	0	0
1	1580054	.	C	A	8	22	30	0	0	30	0	0
1	1580738	rs4648767	T	A	2	15	17	0	0	17	0	0
1	1581096	.	C	T	15	31	46	0	1	47	0	0
1	1581759	.	G	A	19	8	27	0	0	27	0	0
1	1581926	.	G	T	16	1	17	0	1	18	0	0
1	1582202	rs61774918	C	T	32	54	86	0	0	86	0	0
1	1582841	.	A	G	11	22	33	0	0	33	0	0
1	1582844	.	G	T	10	20	30	0	0	30	0	0
1	1582880	.	G	C	8	16	24	0	0	24	0	0
1	1584504	.	C	T	8	0	8	0	0	8	0	0
1	1584517	.	G	A	8	0	8	0	0	8	0	0
1	1588717	.	G	A	15	2	17	0	0	17	0	0
1	1588737	.	C	T	13	2	15	0	0	15	0	0
1	1588743	.	A	T	12	1	13	0	0	13	0	0
1	1608229	rs61776790	C	T	12	9	21	0	0	21	0	0
1	1634928	.	C	T	50	43	93	0	1	94	0	0
1	1636158	.	C	T	33	3	36	0	0	36	0	0
1	1660726	rs1061884	T	C	9	43	52	0	0	52	0	0
1	1660735	.	T	C	9	48	57	0	1	58	0	0
1	1660812	.	A	G	12	32	44	0	0	44	0	0
1	1662315	rs144341301	C	G	3	4	7	0	0	7	0	0
1	1687284	rs74663170	G	A	8	4	12	0	0	12	0	0
1	1719079	rs140054448	G	A	14	12	26	0	1	27	0	0
1	1753686	rs12141314	A	G	5	4	9	0	0	9	0	0
1	1987993	rs12184	T	C	25	17	42	0	0	42	0	0
1	1991014	rs1878745	A	G	21	22	43	0	0	43	0	0
1	2113565	rs262688	T	G	8	5	13	0	0	13	0	0
1	2115342	rs148624904	C	A	4	7	11	0	0	11	0	0
1	2115564	.	G	A	6	3	9	0	0	9	0	0
1	2118339	rs262685	A	G	5	4	9	0	0	9	0	0
1	2121118	rs2503701	C	T	160	121	281	0	1	282	0	0
1	2161409	.	G	A	14	6	20	0	0	20	0	0
1	2162944	rs590367	C	T	0	7	7	0	0	7	0	0
1	2164935	rs263531	G	T	5	6	11	0	1	12	0	0
1	2165761	rs144490874	C	T	9	8	17	0	0	17	0	0
1	2167149	rs262680	C	T	4	5	9	0	0	9	0	0
1	2169215	rs696094	G	A	1	7	8	0	0	8	0	0
1	2169792	rs262679	C	T	2	6	8	0	0	8	0	0
1	2170231	rs698696	C	T	5	2	7	0	0	7	0	0
1	2171024	.	C	T	8	6	14	0	0	14	0	0
1	2172917	rs1692584	T	C	3	3	6	0	0	6	0	0
1	2172919	rs1692585	T	C	3	3	6	0	0	6	0	0
1	2173504	rs263526	T	C	5	3	8	0	1	9	0	0
1	2176038	rs10910034	C	T	7	4	11	0	0	11	0	0
1	2177727	rs263535	T	C	4	5	9	0	0	9	0	0
1	2197971	rs536342784	A	G	5	1	6	0	0	6	0	0
1	2202148	rs35797206	G	A	5	4	9	0	0	9	0	0
1	2202572	rs60635488	C	T	2	8	10	0	0	10	0	0
1	2202774	rs6673129	C	T	3	7	10	0	0	10	0	0
1	2203490	rs4648628	C	T	6	6	12	0	0	12	0	0
1	2205527	rs10910045	A	G	3	4	7	0	0	7	0	0
1	2205548	rs12047069	A	C	3	5	8	0	0	8	0	0
1	2205581	rs12045693	C	A	4	3	7	0	0	7	0	0
1	2222497	rs36043745	G	A	4	2	6	0	0	6	0	0
1	2222560	rs903920	A	G	7	2	9	0	0	9	0	0
1	2222583	rs903919	T	C	7	2	9	0	0	9	0	0
1	2223258	rs2132303	T	C	3	4	7	0	0	7	0	0
1	2223866	rs884940	C	T	4	2	6	0	0	6	0	0
1	2224282	rs903617	A	G	7	2	9	0	0	9	0	0
1	2224367	rs72643475	G	T	7	3	10	0	0	10	0	0
1	2225284	rs1532385	G	A	6	3	9	0	0	9	0	0
1	2226333	rs903918	T	A	6	3	9	0	0	9	0	0
1	2227166	rs2971438	A	G	15	20	35	0	0	35	0	0
1	2229140	rs12562729	C	T	8	9	17	0	1	18	0	0
1	2229447	rs2643888	A	G	15	8	23	0	1	24	0	0
1	2229478	rs12562937	C	T	11	7	18	0	1	19	0	0
1	2229553	rs2843161	C	T	11	10	21	0	0	21	0	0
1	2230799	rs10797419	T	C	10	10	20	0	0	20	0	0
1	2231463	rs903916	C	T	29	9	38	0	0	38	0	0
1	2231567	rs1809823	G	T	18	17	35	0	0	35	0	0
1	2233312	rs903618	A	G	22	21	43	0	0	43	0	0
1	2234251	rs1496555	A	G	20	10	30	0	1	31	0	0
1	2236697	rs2643904	A	G	22	19	41	0	1	42	0	0
1	2240006	rs2173049	T	C	183	203	386	0	6	392	0	0
1	2324336	rs3820010	T	C	15	13	28	0	0	28	0	0
1	2324881	rs11804135	G	C	7	14	21	0	0	21	0	0
1	2326918	rs10910063	G	A	6	4	10	0	0	10	0	0
1	2327075	rs3736330	C	T	8	12	20	0	0	20	0	0
1	2327815	rs2840532	C	T	11	14	25	0	0	25	0	0
1	2330002	rs6698978	A	G	9	9	18	0	0	18	0	0
1	2332391	rs12037485	C	T	15	13	28	0	0	28	0	0
1	2335969	rs12085089	C	G	20	16	36	0	0	36	0	0
1	2336210	rs1129332	C	T	26	37	63	0	1	64	0	0
1	2337032	rs1129171	C	T	23	39	62	0	0	62	0	0
1	2441358	rs2494620	T	C	2	4	6	0	0	6	0	0
1	2452569	rs2985862	T	C	2	4	6	0	0	6	0	0
1	3105563	rs2651919	G	T	4	2	6	0	0	6	0	0
1	3301721	rs2282198	C	T	22	2	24	0	1	25	0	0
1	3328659	rs2493292	C	T	2	18	20	0	0	20	0	0
1	3349900	rs34315398	C	T	3	4	7	0	0	7	0	0
1	3352228	rs12735779	G	C	3	42	45	0	0	45	0	0
1	3352541	rs1065247	T	C	35	6	41	0	0	41	0	0
1	3353637	rs35837267	G	A	0	12	12	0	0	12	0	0
1	3413868	rs4648506	C	G	25	19	44	0	0	44	0	0
1	3416210	.	A	G	43	27	70	0	0	70	0	0
1	3418391	rs4648508	C	T	37	45	82	0	1	83	0	0
1	3511934	rs7513275	A	G	20	26	46	0	4	50	0	0
1	3527944	rs10797402	C	G	3	7	10	0	0	10	0	0
1	3545592	rs41315304	G	A	55	39	94	0	4	98	0	0
1	3548832	rs2760320	G	C	19	7	26	0	0	26	0	0
1	3654190	rs1181864	A	G	17	26	43	0	0	43	0	0
1	3691958	.	C	T	3	3	6	0	0	6	0	0
1	3806074	rs4075974	G	A	47	50	97	0	3	100	0	0
1	3808171	rs6701422	T	C	4	5	9	0	0	9	0	0
1	6047176	rs806105	A	G	2	4	6	0	0	6	0	0
1	6049058	rs709207	C	T	5	3	8	0	0	8	0	0
1	6060647	rs34522455	C	T	3	3	6	0	0	6	0	0
1	6061648	rs481762	A	G	6	4	10	0	0	10	0	0
1	6063655	rs531099	G	A	4	4	8	0	0	8	0	0
1	6068817	rs517183	A	G	3	4	7	0	0	7	0	0
1	6070870	rs546526	C	T	4	3	7	0	0	7	0	0
1	6073439	rs482158	G	T	4	14	18	0	0	18	0	0
1	6073466	rs551310	C	G	5	12	17	0	0	17	0	0
1	6073850	rs905463	G	A	9	8	17	0	0	17	0	0
1	6075437	.	G	A	4	2	6	0	0	6	0	0
1	6077986	rs2250582	T	C	7	3	10	0	0	10	0	0
1	6078835	rs61760779	T	C	25	26	51	0	1	52	0	0
1	6092585	rs12566891	C	T	4	5	9	0	0	9	0	0
1	6134990	rs11578383	G	C	4	2	6	0	0	6	0	0
1	6139271	rs12757354	T	C	7	0	7	0	3	10	0	0
1	6139744	rs2871871	C	T	3	4	7	0	0	7	0	0
1	6140033	rs34638869	T	C	2	5	7	0	0	7	0	0
1	6140554	rs11581252	G	A	10	4	14	0	0	14	0	0
1	6140951	rs34133852	A	G	2	9	11	0	0	11	0	0
1	6141261	rs6701690	C	G	8	13	21	0	0	21	0	0
1	6141507	rs35183981	A	G	7	8	15	0	0	15	0	0
1	6141777	rs55995661	T	C	12	10	22	0	0	22	0	0
1	6142308	rs2227911	T	C	396	365	761	0	4	765	0	0
1	6142439	rs34308142	C	T	10	9	19	0	0	19	0	0
1	6143146	rs3789540	C	T	7	2	9	0	0	9	0	0
1	6143260	rs3789539	T	C	5	2	7	0	0	7	0	0
1	6143746	rs6690918	C	T	5	6	11	0	0	11	0	0
1	6144694	rs3789533	A	G	4	4	8	0	0	8	0	0
1	6144914	rs3789531	A	G	4	4	8	0	0	8	0	0
1	6145023	rs12128870	C	T	5	1	6	0	0	6	0	0
1	6145365	rs2294936	A	G	4	4	8	0	0	8	0	0
1	6145379	rs2294935	C	T	4	4	8	0	0	8	0	0
1	6145465	rs7512313	T	G	4	5	9	0	0	9	0	0
1	6149053	rs2273043	C	T	5	2	7	0	0	7	0	0
1	6149122	rs2273042	G	A	5	4	9	0	0	9	0	0
1	6149286	rs7553754	G	C	6	7	13	0	0	13	0	0
1	6150637	rs12081978	C	T	1	6	7	0	0	7	0	0
1	6153406	rs3789530	C	T	18	14	32	0	1	33	0	0
1	6154417	rs2294932	C	T	15	7	22	0	0	22	0	0
1	6157282	rs749434	C	T	3	6	9	0	0	9	0	0
1	6157297	rs749435	T	C	5	2	7	0	0	7	0	0
1	6157434	rs2311802	C	T	18	38	56	0	0	56	0	0
1	6157993	rs1883769	T	C	28	30	58	0	0	58	0	0
1	6158147	rs11586626	C	T	24	28	52	0	1	53	0	0
1	6257856	rs2294713	G	A	2	4	6	0	0	6	0	0
1	6258147	rs2247392	C	T	2	4	6	0	0	6	0	0
1	6258794	rs3789524	A	G	5	6	11	0	0	11	0	0
1	6259025	rs3789522	C	T	16	6	22	0	0	22	0	0
1	6259090	rs3789520	C	T	11	7	18	0	0	18	0	0
1	6259130	rs3827723	A	G	7	9	16	0	0	16	0	0
1	6640116	rs17029626	A	G	4	4	8	0	0	8	0	0
1	6644723	rs731024	G	A	5	4	9	0	0	9	0	0
1	6645867	rs6682920	G	A	7	5	12	0	0	12	0	0
1	6647697	rs77541275	G	A	1	6	7	0	0	7	0	0
1	6651093	rs201171	G	A	332	337	669	0	3	672	0	0
1	6651728	rs1556036	C	T	262	258	520	0	4	525	1	0
1	6655053	rs2235566	G	A	3	8	11	0	0	11	0	0
1	6658770	rs11122102	G	A	9	9	18	0	0	18	0	0
1	6659505	rs2232460	G	A	173	148	321	0	0	321	0	0
1	6661732	rs12028517	C	A	4	3	7	0	0	7	0	0
1	6662913	rs6674407	G	A	5	3	8	0	0	8	0	0
1	6681744	rs3747994	C	T	45	32	77	0	1	78	0	0
1	6683240	rs14057	G	A	79	86	165	0	2	167	0	0
1	6689319	rs1556034	G	A	1	5	6	0	0	6	0	0
1	6690140	rs742394	A	G	5	2	7	0	0	7	0	0
1	6693097	rs3174820	A	G	55	31	86	0	3	89	0	0
1	6694574	rs6804	G	A	23	26	49	0	0	49	0	0
1	6694980	rs1043683	G	A	30	31	61	0	0	61	0	0
1	6695123	rs1043681	C	T	35	28	63	0	0	63	0	0
1	6695244	rs10523	A	G	24	16	40	0	1	41	0	0
1	6695331	rs11892	G	T	21	20	41	0	0	41	0	0
1	6704635	rs200458	A	G	18	16	34	0	2	36	0	0
1	6713282	rs200440	A	G	5	2	7	0	0	7	0	0
1	6929760	rs6688732	G	A	4	3	7	0	0	7	0	0
1	6947717	rs3810982	C	T	69	72	141	0	0	141	0	0
1	6947973	rs3827726	C	T	40	37	77	0	0	77	0	0
1	6948204	rs8918	T	C	16	14	30	0	0	30	0	0
1	8021740	rs17523802	G	A	1	7	8	0	0	8	0	0
1	8037496	rs161807	G	A	2	4	6	0	0	6	0	0
1	8415290	rs1889853	C	A	5	5	10	0	0	10	0	0
1	8419420	rs6577484	A	G	5	10	15	0	0	15	0	0
1	8419629	rs7525559	T	C	6	13	19	0	0	19	0	0
1	8469789	rs2661868	C	T	4	5	9	0	0	9	0	0
1	8877619	rs137957533	G	A	21	21	42	0	0	42	0	0
1	8926868	rs2781064	C	T	3	5	8	0	0	8	0	0
1	8928125	rs2071412	G	T	48	43	91	0	1	92	0	0
1	8928811	rs7540170	C	T	21	7	28	0	1	29	0	0
1	8931149	rs2274971	C	T	39	29	68	0	0	68	0	0
1	8937772	rs12047420	A	C	4	2	6	0	0	6	0	0
1	8937773	rs201853842	A	C	2	4	6	0	0	6	0	0
1	9098122	.	G	A	2	6	8	0	0	8	0	0
1	9099727	rs769897	A	G	7	4	11	0	1	12	0	0
1	9101155	rs34488100	T	G	7	18	25	0	0	25	0	0
1	9129620	rs5438	C	T	98	24	122	0	2	124	0	0
1	9177317	rs1705299	T	C	3	4	7	0	0	7	0	0
1	9305248	rs138775586	C	T	4	8	12	0	0	12	0	0
1	9305445	rs34603401	A	C	11	6	17	0	0	17	0	0
1	9323910	rs6688832	G	A	5	4	9	0	0	9	0	0
1	9325001	rs41280760	C	T	10	5	15	0	0	15	0	0
1	9325205	rs114002338	C	T	8	5	13	0	0	13	0	0
1	9325265	rs9435159	C	T	10	3	13	0	0	13	0	0
1	9327413	rs11121354	T	G	11	6	17	0	0	17	0	0
1	9327732	rs114922064	T	C	10	9	19	0	0	19	0	0
1	9327733	rs115002815	G	T	10	9	19	0	0	19	0	0
1	9328211	rs9434747	T	C	3	3	6	0	0	6	0	0
1	9328284	rs150449231	T	G	3	6	9	0	0	9	0	0
1	9328808	rs3207316	C	T	5	5	10	0	0	10	0	0
1	9329107	rs546998968	A	T	11	6	17	0	0	17	0	0
1	9331277	rs9435163	G	T	14	11	25	0	0	25	0	0
1	9331331	rs9435164	A	T	4	4	8	0	1	9	0	0
1	9416151	rs9435243	G	A	9	5	14	0	1	15	0	0
1	9637896	.	C	T	4	3	7	0	0	7	0	0
1	9756975	rs7547337	A	G	5	2	7	0	0	7	0	0
1	9781412	rs12735071	C	G	30	27	57	0	1	58	0	0
1	9782386	rs139848768	C	T	109	98	207	0	1	208	0	0
1	9782556	rs11589267	C	T	15	6	21	0	0	21	0	0
1	9798509	rs144966243	G	C	4	5	9	0	0	9	0	0
1	9811653	rs35331030	C	T	139	153	292	0	0	292	0	0
1	10318652	rs12402052	C	G	108	47	155	0	1	156	0	0
1	10322153	rs4846210	A	G	3	3	6	0	0	6	0	0
1	10350438	rs7553228	G	C	5	2	7	0	0	7	0	0
1	10367591	rs1065828	T	C	2	4	6	0	0	6	0	0
1	10421878	rs12125492	A	G	7	8	15	0	0	15	0	0
1	10435324	rs11121552	C	A	5	5	10	0	0	10	0	0
1	10437778	rs4240912	C	T	3	11	14	0	0	14	0	0
1	10437804	rs4240913	G	A	3	9	12	0	0	12	0	0
1	10440556	rs1138791	A	G	6	3	9	0	0	9	0	0
1	10460485	rs1049887	T	C	297	356	653	0	3	656	0	0
1	10461107	rs11121560	T	C	5	1	6	0	0	6	0	0
1	10471789	rs2236678	A	T	6	1	7	0	0	7	0	0
1	10473196	rs2229687	C	T	445	411	856	0	7	863	0	0
1	10474430	rs35759975	A	T	0	7	7	0	0	7	0	0
1	10475120	rs11576384	G	C	3	5	8	0	0	8	0	0
1	10478586	rs3762287	C	T	15	16	31	0	0	31	0	0
1	10478727	rs3762286	G	A	20	23	43	0	0	43	0	0
1	10479678	rs1889309	G	A	5	4	9	0	0	9	0	0
1	10583531	rs2506886	A	G	3	9	12	0	0	12	0	0
1	10584346	rs7522072	T	C	7	2	9	0	0	9	0	0
1	10713765	rs284294	T	C	20	25	45	0	0	45	0	0
1	10724236	rs284324	G	A	9	24	33	0	0	33	0	0
1	11072885	rs4133584	C	T	3	7	10	0	0	10	0	0
1	11074250	rs3765895	A	G	13	7	20	0	2	22	0	0
1	11079077	rs2273348	A	G	4	2	6	0	0	6	0	0
1	11079413	rs7546126	T	A	5	7	12	0	0	12	0	0
1	11079773	rs1967714	A	G	2	6	8	0	0	8	0	0
1	11081210	rs1922991	T	A	14	8	22	0	1	23	0	0
1	11081880	rs1474891	G	T	31	13	44	0	0	44	0	0
1	11086717	rs1033638	A	G	13	13	26	0	0	26	0	0
1	11087524	rs1782455	G	A	9	14	23	0	3	26	0	0
1	11087835	rs1782454	T	C	7	15	22	0	0	22	0	0
1	11088777	rs28731187	T	G	4	2	6	0	0	6	0	0
1	11089463	rs1782457	T	A	13	9	22	0	0	22	0	0
1	11128654	rs2791655	G	A	6	2	8	0	0	8	0	0
1	11129848	rs2791653	A	G	5	7	12	0	0	12	0	0
1	11131433	.	T	C	12	11	23	0	2	25	0	0
1	11132217	rs1130683	G	A	108	92	200	0	1	201	0	0
1	11132541	rs2791650	G	C	7	6	13	0	0	13	0	0
1	11132561	rs2791649	A	G	8	5	13	0	0	13	0	0
1	11132638	rs2791648	G	T	4	5	9	0	0	9	0	0
1	11132801	rs2791647	G	A	3	3	6	0	0	6	0	0
1	11134157	rs2748876	T	G	8	4	12	0	0	12	0	0
1	11137778	rs2259886	C	T	12	8	20	0	0	20	0	0
1	11141187	rs2258621	C	G	43	38	81	0	0	81	0	0
1	11148759	rs1148485	G	A	3	4	7	0	0	7	0	0
1	11181327	rs11121691	C	T	30	31	61	0	2	63	0	0
1	11190646	rs2275527	G	A	27	14	41	0	0	41	0	0
1	11205058	rs1057079	C	T	17	22	39	0	0	39	0	0
1	11288758	rs1064261	G	A	16	15	31	0	1	32	0	0
1	11301714	rs1135172	A	G	8	8	16	0	0	16	0	0
1	11734293	rs1140272	A	G	13	11	24	0	0	25	1	0
1	11810505	rs8617	C	T	142	163	305	0	1	306	0	0
1	11813318	rs6665448	G	A	3	3	6	0	0	6	0	0
1	11979869	rs8247	C	T	8	7	15	0	1	16	0	0
1	11979909	rs3209284	T	C	9	8	17	0	0	17	0	0
1	11980449	rs17037529	T	C	6	14	20	0	0	20	0	0
1	11980912	rs6662151	T	G	11	7	18	0	0	18	0	0
1	11981270	rs9659237	G	A	12	17	29	0	1	30	0	0
1	11981807	rs9786969	G	A	0	8	8	0	0	8	0	0
1	11982544	rs2639453	T	C	3	7	10	0	0	10	0	0
1	11983206	rs3795408	A	G	67	89	156	0	2	158	0	0
1	12009956	rs7551175	G	A	38	37	75	0	0	75	0	0
1	12010469	rs2273285	G	T	41	49	90	0	0	90	0	0
1	12026355	rs2230898	A	C	36	60	96	0	0	96	0	0
1	12035173	.	C	G	115	75	190	0	0	190	0	0
1	12040479	rs2180183	T	C	1	5	6	0	1	7	0	0
1	12052405	rs6675934	G	A	2	5	7	0	0	7	0	0
1	12058802	rs41278626	T	C	11	21	32	0	0	32	0	0
1	12059498	rs78343636	G	A	15	11	26	0	0	26	0	0
1	12059548	rs78001030	A	G	16	9	25	0	0	25	0	0
1	12060869	rs17037564	A	G	22	14	36	0	1	37	0	0
1	12062017	rs6680984	T	C	10	10	20	0	1	21	0	0
1	12062205	rs2236057	A	G	7	2	9	0	0	9	0	0
1	12065841	rs1042837	C	T	65	66	131	0	1	132	0	0
1	12071680	rs1042842	A	G	82	86	168	0	1	169	0	0
1	12072722	rs41278638	A	G	137	134	271	0	10	281	0	0
1	12082334	rs11553925	A	T	78	58	136	0	1	137	0	0
1	12082461	rs11588712	C	T	52	69	121	0	1	122	0	0
1	12082926	rs2295283	A	G	74	71	145	0	3	148	0	0
1	12268637	rs5746073	C	T	133	109	242	0	1	243	0	0
1	12322507	.	C	T	12	6	18	0	0	18	0	0
1	12628188	rs4580	T	C	155	172	327	0	2	329	0	0
1	12629769	rs6541040	A	T	11	5	16	0	1	17	0	0
1	12629874	rs12030398	G	A	6	4	10	0	0	10	0	0
1	12630634	rs4846120	T	G	4	7	11	0	0	11	0	0
1	12630786	rs4845905	T	C	7	4	11	0	0	11	0	0
1	12633052	rs55991483	C	G	6	3	9	0	0	9	0	0
1	12633102	rs77155474	C	T	8	4	12	0	0	12	0	0
1	12633465	rs79708184	C	T	14	3	17	0	0	17	0	0
1	12634034	rs4300229	T	G	6	4	10	0	0	10	0	0
1	12634820	.	G	A	11	3	14	0	0	14	0	0
1	12638964	rs2275875	T	C	154	119	273	0	0	273	0	0
1	12639168	rs3128461	A	G	9	14	23	0	0	23	0	0
1	12639289	rs12041395	C	T	16	5	21	0	0	21	0	0
1	12639875	rs77434180	A	C	24	27	51	0	0	51	0	0
1	12640127	rs3128458	G	A	20	25	45	0	0	45	0	0
1	12640461	rs2275873	C	G	31	66	97	0	0	97	0	0
1	12642243	rs12029485	T	G	4	2	6	0	0	6	0	0
1	12645497	rs3121606	C	G	3	3	6	0	0	6	0	0
1	12645531	rs114934150	G	A	3	3	6	0	0	6	0	0
1	12659795	.	C	A	5	3	8	0	0	8	0	0
1	14032836	rs147717566	A	T	2	5	7	0	0	7	0	0
1	14040030	rs2495053	T	C	1	5	6	0	0	6	0	0
1	14075112	rs114514035	C	A	13	14	27	0	0	27	0	0
1	14076886	rs142034800	T	G	4	5	9	0	0	9	0	0
1	14079427	rs114547964	T	A	12	14	26	0	0	26	0	0
1	14079495	rs115140359	C	G	9	14	23	0	0	23	0	0
1	14080223	rs1211211	T	C	13	15	28	0	0	28	0	0
1	14080948	rs114317674	C	G	13	19	32	0	0	32	0	0
1	14081298	rs115824810	G	A	18	17	35	0	1	36	0	0
1	14083712	rs115231513	A	T	4	7	11	0	0	11	0	0
1	14084746	rs187588348	C	T	11	11	22	0	0	22	0	0
1	14085040	rs116254290	A	G	7	11	18	0	0	18	0	0
1	14085721	rs76085446	A	T	5	5	10	0	0	10	0	0
1	14087263	rs116068312	A	G	9	17	26	0	0	26	0	0
1	14087444	rs116360324	G	T	19	16	35	0	0	35	0	0
1	14087475	rs78354946	G	C	24	13	37	0	0	37	0	0
1	14089057	rs115718893	T	A	16	28	44	0	0	44	0	0
1	14089729	rs114100510	A	G	13	29	42	0	0	42	0	0
1	14089828	rs114954122	T	C	14	23	37	0	0	37	0	0
1	14092651	rs114782786	C	T	32	34	66	0	0	66	0	0
1	14092904	rs1919405	G	A	21	28	49	0	0	49	0	0
1	14094791	rs149760135	G	C	7	6	13	0	0	13	0	0
1	14096457	rs2235523	T	A	23	24	47	0	0	47	0	0
1	14097234	rs35438834	T	G	23	29	52	0	0	52	0	0
1	14098849	rs78538467	T	C	14	24	38	0	0	38	0	0
1	14099036	rs115853822	G	A	26	32	58	0	0	58	0	0
1	14101355	rs115958653	C	T	7	6	13	0	0	13	0	0
1	14101411	rs184280781	C	T	6	2	8	0	0	8	0	0
1	14102245	rs116636384	T	C	30	42	72	0	0	72	0	0
1	14102539	.	T	A	31	41	72	0	1	73	0	0
1	14102710	rs79900130	G	A	54	58	112	0	0	112	0	0
1	14102918	rs116973365	T	C	40	50	90	0	0	90	0	0
1	14103798	rs117494767	T	C	44	33	77	0	0	77	0	0
1	14104037	rs1203680	T	C	19	17	36	0	0	36	0	0
1	14104496	rs114029487	C	G	38	32	70	0	0	70	0	0
1	14104624	rs1203679	T	A	34	44	78	0	0	78	0	0
1	14105049	rs61747667	C	A	358	390	748	0	23	771	0	0
1	14105139	rs2076324	T	A	241	230	471	0	13	487	3	0
1	14105382	rs56201064	T	C	294	421	715	0	3	718	0	0
1	14105639	rs17350795	G	A	195	249	444	0	1	445	0	0
1	14105856	rs61747663	A	G	285	443	728	0	5	733	0	0
1	14105946	rs61747661	T	C	218	339	557	0	1	558	0	0
1	14106330	rs61747664	C	T	318	400	718	0	5	723	0	0
1	14107135	rs116238585	C	G	359	479	838	0	0	838	0	0
1	14107164	rs115572434	C	T	368	461	829	0	6	835	0	0
1	14108988	rs61747665	A	G	491	623	1114	0	6	1121	1	0
1	14109114	rs1203651	A	G	543	690	1233	0	14	1247	0	0
1	14109667	rs17346709	T	C	91	93	184	0	0	184	0	0
1	14109904	rs116204394	C	T	111	155	266	0	0	266	0	0
1	14111121	rs75856949	A	G	142	139	281	0	0	281	0	0
1	14113132	rs115795012	G	A	566	746	1312	0	5	1317	0	0
1	14117876	rs1980472	G	C	4	2	6	0	0	6	0	0
1	14143003	rs1046331	A	G	22	13	35	0	0	35	0	0
1	14149844	.	T	A	22	9	31	0	1	32	0	0
1	14150032	rs2697967	C	T	12	6	18	0	1	19	0	0
1	14150116	rs2697966	C	T	15	12	27	0	1	28	0	0
1	14150505	rs2697965	T	C	16	8	24	0	0	24	0	0
1	14150709	rs2697964	C	T	22	14	36	0	0	36	0	0
1	14150714	rs2744680	G	A	23	13	36	0	0	36	0	0
1	14150740	rs2697963	G	T	24	13	37	0	0	37	0	0
1	14150992	rs2697962	T	C	18	10	28	0	0	28	0	0
1	15438646	rs66777636	A	T	1	16	17	0	0	17	0	0
1	15438990	rs10803354	G	A	14	3	17	0	0	17	0	0
1	15439227	rs12046842	C	A	0	9	9	0	0	9	0	0
1	15442058	rs2235789	T	C	5	1	6	0	0	6	0	0
1	15442795	rs2235788	T	C	18	2	20	0	1	21	0	0
1	15443426	rs72640734	C	T	0	14	14	0	0	14	0	0
1	15443476	rs2235787	C	G	17	1	18	0	0	18	0	0
1	15443631	rs72640735	C	G	0	16	16	0	0	16	0	0
1	15443898	rs2235785	G	A	14	2	16	0	0	16	0	0
1	15444894	rs41269423	A	G	1	8	9	0	0	9	0	0
1	15444899	rs72640739	C	G	1	8	9	0	0	9	0	0
1	15466130	.	A	C	6	0	6	0	2	8	0	0
1	15541073	rs7551863	A	G	2	5	7	0	0	7	0	0
1	15541537	rs3753314	C	T	20	31	51	0	0	51	0	0
1	15545536	rs77627910	C	A	6	3	9	0	0	9	0	0
1	15546077	rs3753313	G	A	71	108	179	0	3	182	0	0
1	15742568	rs75645745	G	T	6	2	8	0	0	8	0	0
1	15754484	rs2473356	T	C	34	35	69	0	0	69	0	0
1	15756791	.	C	G	50	23	73	0	0	73	0	0
1	15832543	rs1052576	T	C	7	9	16	0	1	17	0	0
1	15844615	rs1132312	A	G	22	23	45	0	0	45	0	0
1	15850603	rs4645983	G	A	9	26	35	0	0	35	0	0
1	15850613	rs1052571	G	A	10	23	33	0	0	33	0	0
1	15892415	rs2236215	A	C	7	7	14	0	1	15	0	0
1	15896199	rs2145397	G	A	6	2	8	0	0	8	0	0
1	15896984	rs6656907	A	G	9	2	11	0	0	11	0	0
1	15904318	rs11544523	C	T	3	3	6	0	0	6	0	0
1	15959977	rs3795763	C	T	18	5	23	0	0	23	0	0
1	15982494	rs72647139	A	T	7	0	7	0	0	7	0	0
1	15983301	rs941686	A	G	5	1	6	0	0	6	0	0
1	15985940	rs6695903	G	A	4	3	7	0	0	7	0	0
1	15986547	rs3766163	T	C	30	11	41	0	0	41	0	0
1	15988702	rs10492986	T	C	5	2	7	0	0	7	0	0
1	15988957	rs1240333	G	A	7	4	11	0	0	11	0	0
1	15989141	rs7536654	C	G	10	2	12	0	0	12	0	0
1	15989918	rs998032	T	C	7	2	9	0	0	9	0	0
1	15990552	rs927207	A	G	7	3	10	0	0	10	0	0
1	15990912	rs79570154	T	C	7	0	7	0	0	7	0	0
1	15990983	rs17448966	T	G	7	0	7	0	0	7	0	0
1	15991645	rs55913949	T	C	10	2	12	0	0	12	0	0
1	15993208	rs34453754	G	C	14	6	20	0	0	20	0	0
1	15993338	rs10492987	A	G	6	4	10	0	0	10	0	0
1	15993514	rs35509554	C	T	8	2	10	0	0	10	0	0
1	16042766	rs12091750	T	C	181	164	345	0	6	351	0	0
1	16043979	rs58140482	A	G	3	4	7	0	0	7	0	0
1	16044401	rs16851970	G	A	209	195	404	0	4	408	0	0
1	16045250	rs10927840	A	G	3	5	8	0	0	8	0	0
1	16045261	rs10927841	T	C	3	5	8	0	0	8	0	0
1	16045579	rs7519899	A	G	4	3	7	0	0	7	0	0
1	16045773	rs7553484	C	T	2	4	6	0	0	6	0	0
1	16046109	rs1006147	C	T	7	5	12	0	0	12	0	0
1	16046920	rs36100011	C	T	9	1	10	0	0	10	0	0
1	16047329	rs6671429	A	T	6	8	14	0	0	14	0	0
1	16048951	rs12740492	A	T	7	3	10	0	0	10	0	0
1	16049285	rs41378647	C	G	7	10	17	0	0	17	0	0
1	16049893	rs6668919	C	T	7	2	9	0	0	9	0	0
1	16050470	rs12746673	A	C	8	4	12	0	0	12	0	0
1	16051349	rs61782448	C	A	9	8	17	0	0	17	0	0
1	16055039	rs12724755	C	T	62	39	101	0	0	101	0	0
1	16055732	rs6429772	C	T	5	3	8	0	0	8	0	0
1	16055931	rs7539884	T	C	7	6	13	0	0	13	0	0
1	16056364	rs3817269	G	A	338	339	677	0	8	685	0	0
1	16056740	rs6672142	C	A	31	9	40	0	1	41	0	0
1	16060678	rs7553242	T	C	441	408	849	0	6	855	0	0
1	16061035	rs7748	G	C	333	286	619	0	3	623	1	0
1	16160773	rs4661342	C	G	12	9	21	0	0	21	0	0
1	16162731	rs4661667	C	T	7	6	13	0	0	13	0	0
1	16173110	rs12744578	A	T	3	4	7	0	0	7	0	0
1	16175391	rs61782190	A	C	132	173	305	0	0	307	2	0
1	16204501	rs12125239	G	A	11	12	23	0	0	23	0	0
1	16241830	rs72649636	A	G	9	5	14	0	0	14	0	0
1	16241984	rs12139673	A	C	6	3	9	0	0	9	0	0
1	16242620	rs12063905	C	A	7	4	11	0	0	11	0	0
1	16255644	rs848208	C	T	90	77	167	0	0	167	0	0
1	16260916	rs848211	C	T	99	107	206	0	2	208	0	0
1	16262404	rs61749277	C	T	48	64	112	0	0	112	0	0
1	16264264	rs848213	G	A	4	4	8	0	0	8	0	0
1	16271156	rs12134932	C	A	78	72	150	0	2	152	0	0
1	16271180	rs848216	T	C	73	65	138	0	1	139	0	0
1	16272933	rs61782258	A	C	25	20	45	0	0	45	0	0
1	16273995	rs742617	T	C	18	15	33	0	0	33	0	0
1	16274769	rs698891	C	T	15	13	28	0	0	28	0	0
1	16532498	rs41269185	G	A	4	7	11	0	0	11	0	0
1	16573712	rs6675923	G	C	14	21	35	0	0	35	0	0
1	16676078	rs72638015	G	A	0	7	7	0	0	7	0	0
1	16678581	rs112982587	A	G	3	7	10	0	0	10	0	0
1	16713555	rs61770604	G	C	7	7	14	0	0	14	0	0
1	16720206	rs56344045	C	G	8	9	17	0	0	17	0	0
1	16720627	.	T	G	9	7	16	0	0	16	0	0
1	16722934	rs61769431	C	G	236	247	483	0	2	485	0	0
1	16723139	rs16852669	C	A	250	242	492	0	2	494	0	0
1	16723268	rs7529767	T	C	272	290	562	0	4	566	0	0
1	16776868	rs279780	G	A	2	5	7	0	0	7	0	0
1	16780060	rs279784	C	T	18	15	33	0	0	33	0	0
1	16780108	rs279785	T	C	18	17	35	0	0	35	0	0
1	16781026	rs279017	A	T	11	13	24	0	0	24	0	0
1	16781447	rs279786	A	G	25	21	46	0	1	47	0	0
1	16782995	rs279788	C	T	1	5	6	0	0	6	0	0
1	16785564	rs11543230	C	T	167	124	291	0	1	292	0	0
1	16788015	rs698865	G	A	6	2	8	0	0	8	0	0
1	16788184	rs698866	A	G	3	3	6	0	0	6	0	0
1	16788515	rs279025	T	C	10	2	12	0	0	12	0	0
1	16795685	rs14126	A	G	5	1	6	0	0	6	0	0
1	16796721	rs157252	A	C	5	1	6	0	0	6	0	0
1	16797485	rs149561	T	C	2	5	7	0	0	7	0	0
1	16797756	rs157134	T	C	6	3	9	0	0	9	0	0
1	16798902	rs157135	G	A	4	4	8	0	0	8	0	0
1	16804753	rs696097	T	C	3	3	6	0	0	6	0	0
1	16889158	.	A	C	13	11	24	0	0	24	0	0
1	16889529	.	T	C	7	3	10	0	0	10	0	0
1	16890421	.	G	A	25	10	35	0	0	35	0	0
1	16890602	.	T	G	11	13	24	0	1	25	0	0
1	16890639	.	C	T	19	7	26	0	0	26	0	0
1	16890644	.	C	T	12	12	24	0	1	25	0	0
1	16899669	.	C	T	7	0	7	0	0	7	0	0
1	16901668	.	T	C	7	2	9	0	0	9	0	0
1	16901714	.	G	A	7	0	7	0	0	7	0	0
1	16918717	.	C	T	6	1	7	0	0	7	0	0
1	16918734	.	G	C	7	1	8	0	0	8	0	0
1	16920002	.	G	C	1	5	6	0	0	6	0	0
1	16927039	rs1612798	C	T	1	5	6	0	0	6	0	0
1	16929100	.	C	T	2	4	6	0	0	6	0	0
1	16945065	rs7803	A	G	8	20	28	0	0	28	0	0
1	16945409	rs13566	T	A	39	15	54	0	1	55	0	0
1	16945504	.	C	T	33	15	48	0	1	49	0	0
1	16946535	.	T	C	11	1	12	0	0	12	0	0
1	16946562	.	C	A	4	8	12	0	0	12	0	0
1	16946630	.	G	A	6	1	7	0	0	7	0	0
1	16946723	rs375097	G	A	14	6	20	0	0	20	0	0
1	16946740	rs399721	C	T	10	4	14	0	0	14	0	0
1	16946749	rs425424	A	G	4	10	14	0	0	14	0	0
1	16948753	.	G	A	5	2	7	0	0	7	0	0
1	16950708	.	T	G	2	4	6	0	0	6	0	0
1	16952260	.	T	C	5	1	6	0	0	6	0	0
1	16952481	rs915311	A	G	23	21	44	0	1	45	0	0
1	16952993	rs942268	C	G	8	9	17	0	0	17	0	0
1	16958047	.	C	T	16	4	20	0	1	21	0	0
1	16958064	rs1622521	A	G	13	11	24	0	1	25	0	0
1	16959602	.	C	T	13	12	25	0	1	26	0	0
1	16959612	.	A	G	18	11	29	0	0	29	0	0
1	16961588	.	A	G	7	14	21	0	0	21	0	0
1	17216080	rs3738618	T	C	3	7	10	0	0	10	0	0
1	17270751	rs12025984	G	A	8	11	19	0	0	19	0	0
1	17279513	rs1997862	T	C	5	2	7	0	0	7	0	0
1	17301448	rs2235933	C	T	3	6	9	0	0	9	0	0
1	17301780	rs761422	A	G	9	9	18	0	0	18	0	0
1	17312743	rs3170740	C	T	36	29	65	0	1	66	0	0
1	17313157	rs2076605	G	A	6	0	6	0	0	6	0	0
1	17313343	rs9435659	G	A	51	42	93	0	2	95	0	0
1	17313654	rs761421	C	T	42	23	65	0	0	65	0	0
1	17314942	rs9435662	G	A	43	36	79	0	0	79	0	0
1	17345877	rs12045097	A	G	6	2	8	0	0	8	0	0
1	17345905	rs2871775	A	G	3	3	6	0	0	6	0	0
1	17347854	rs12144355	T	C	2	7	9	0	0	9	0	0
1	17353988	rs11203282	T	G	3	3	6	0	0	6	0	0
1	17657534	rs11203366	G	A	3	3	6	0	0	6	0	0
1	17657616	rs11203367	T	C	4	4	8	0	0	8	0	0
1	17741044	rs2019622	G	A	13	9	22	0	2	26	2	0
1	17748783	rs144828726	C	T	303	275	578	0	5	583	0	0
1	19198064	rs1138333	T	G	5	7	12	0	3	15	0	0
1	19198100	rs1138328	C	G	5	10	15	0	0	15	0	0
1	19198141	rs7366541	T	C	9	13	22	0	0	22	0	0
1	19198414	rs1140477	G	A	8	14	22	0	0	22	0	0
1	19198418	rs1138269	C	T	8	14	22	0	0	22	0	0
1	19198627	rs14311	G	A	6	7	13	0	0	13	0	0
1	19198637	rs3202002	G	A	6	6	12	0	0	12	0	0
1	19198895	rs9117	A	G	15	5	20	0	0	20	0	0
1	19199221	rs11740	C	T	5	10	15	0	0	15	0	0
1	19202896	rs2230707	G	A	8	4	12	0	0	12	0	0
1	19203997	rs2230705	C	G	4	2	6	0	0	6	0	0
1	19235606	rs6688134	G	A	4	2	6	0	0	6	0	0
1	19235658	rs16862355	T	C	2	4	6	0	0	6	0	0
1	19244240	rs28439774	C	G	2	4	6	0	0	6	0	0
1	19246320	rs41273181	G	A	3	4	7	0	0	7	0	0
1	19247509	rs35477144	G	A	8	8	16	0	0	16	0	0
1	19401405	rs2281748	G	A	3	6	9	0	0	9	0	0
1	19401728	rs1886026	G	A	9	1	10	0	0	10	0	0
1	19401814	rs1886025	A	G	5	3	8	0	0	8	0	0
1	19403867	rs2181598	C	G	13	5	18	0	1	19	0	0
1	19404071	rs2146867	A	T	7	8	15	0	0	15	0	0
1	19404176	rs2181597	G	A	7	5	12	0	0	12	0	0
1	19405237	rs2146866	A	G	9	8	17	0	0	17	0	0
1	19405284	rs2146865	G	C	9	8	17	0	0	17	0	0
1	19411129	rs1043905	A	G	169	152	321	0	2	323	0	0
1	19413261	rs12584	T	A	100	99	199	0	0	199	0	0
1	19415304	rs1043899	C	T	105	108	213	0	0	213	0	0
1	19418066	rs12563949	G	A	8	7	15	0	0	15	0	0
1	19420392	rs1106839	G	A	10	1	11	0	0	11	0	0
1	19430008	rs7515874	A	G	2	10	12	0	0	12	0	0
1	19433449	rs6426677	A	G	66	71	137	0	1	138	0	0
1	19447843	rs1044010	C	G	37	49	86	0	0	86	0	0
1	19473054	rs77965219	T	C	4	5	9	0	0	9	0	0
1	19480829	rs6691238	C	A	5	1	6	0	0	6	0	0
1	19544414	.	A	G	4	8	12	0	1	13	0	0
1	19565344	rs709683	C	G	30	17	47	0	0	47	0	0
1	19652063	rs11558390	G	A	18	17	35	0	0	35	0	0
1	19652874	rs41264079	G	A	24	26	50	0	0	50	0	0
1	19655734	rs41302028	G	A	10	7	17	0	0	17	0	0
1	19669117	rs214326	A	G	23	19	42	0	0	42	0	0
1	19669618	rs72651461	A	G	34	27	61	0	0	61	0	0
1	19669956	rs17477411	G	A	21	27	48	0	0	48	0	0
1	19671361	rs742686	T	C	25	21	46	0	0	46	0	0
1	19672539	rs67559618	C	A	8	10	18	0	0	18	0	0
1	19674070	rs214327	C	T	5	10	15	0	0	15	0	0
1	19674320	rs16862684	G	A	9	11	20	0	0	20	0	0
1	19675561	rs11805045	C	T	5	7	12	0	0	12	0	0
1	19677088	rs214331	T	C	4	2	6	0	0	6	0	0
1	19677222	rs214332	C	G	2	5	7	0	0	7	0	0
1	19677996	rs214335	G	A	5	7	12	0	0	12	0	0
1	19680391	rs214339	G	A	4	2	6	0	0	6	0	0
1	19680424	rs214340	C	T	6	4	10	0	0	10	0	0
1	19680544	rs17477654	A	G	6	4	10	0	0	10	0	0
1	19681273	rs7533994	G	T	3	7	10	0	0	10	0	0
1	19681647	rs214344	C	A	4	2	6	0	0	6	0	0
1	19682429	rs214346	G	A	8	2	10	0	0	10	0	0
1	19701015	rs3748753	G	A	3	3	6	0	0	6	0	0
1	19702007	rs7519264	A	G	3	3	6	0	0	6	0	0
1	19702189	rs79536226	A	G	3	3	6	0	0	6	0	0
1	19773433	rs1546263	G	A	5	2	7	0	0	7	0	0
1	19811938	rs550604780	C	T	277	316	593	0	5	598	0	0
1	19926058	rs79683471	C	A	4	3	7	0	0	7	0	0
1	19933092	rs145671235	T	C	3	5	8	0	0	8	0	0
1	19934634	rs115692978	G	A	2	7	9	0	0	9	0	0
1	19934724	rs61740467	C	T	4	5	9	0	0	9	0	0
1	19934900	rs61740466	G	A	5	2	7	0	0	7	0	0
1	19943823	rs2294629	C	A	15	8	23	0	0	23	0	0
1	19950062	rs1737428	T	C	68	70	138	0	0	138	0	0
1	19951535	rs1770481	A	G	4	6	10	0	0	10	0	0
1	19984236	rs116304476	G	C	3	3	6	0	0	7	1	0
1	19984461	rs3087566	C	T	7	12	19	0	1	20	0	0
1	20008880	rs9064	G	T	10	17	27	0	0	27	0	0
1	20020994	rs4515815	C	T	14	9	23	0	0	23	0	0
1	20066380	rs41303893	C	A	9	13	22	0	0	22	0	0
1	20072082	rs35760408	C	T	6	19	25	0	0	25	0	0
1	20073019	rs34281331	C	T	13	18	31	0	1	32	0	0
1	20082468	rs80169561	G	A	4	3	7	0	0	7	0	0
1	20082688	rs117193024	G	A	5	3	8	0	1	9	0	0
1	20083347	rs78480129	C	T	2	4	6	0	0	6	0	0
1	20084990	rs2235656	T	C	2	6	8	0	0	8	0	0
1	20091791	rs2281246	T	C	7	3	10	0	0	10	0	0
1	20091962	rs1266448	C	T	4	4	8	0	0	8	0	0
1	20093326	rs2235654	G	A	1	5	6	0	0	6	0	0
1	20093340	rs1737469	T	C	1	5	6	0	0	6	0	0
1	20097941	rs10917536	G	T	6	7	13	0	1	14	0	0
1	20233051	rs2298110	A	G	16	9	25	0	0	25	0	0
1	20233086	rs10916668	G	A	16	9	25	0	0	25	0	0
1	20235030	rs16823095	G	T	18	15	33	0	0	33	0	0
1	20235353	rs12403258	C	G	9	10	19	0	0	19	0	0
1	20236731	rs17401735	A	G	16	19	35	0	1	36	0	0
1	20237348	rs75715674	G	A	6	2	8	0	0	8	0	0
1	20237760	rs10492999	A	G	14	18	32	0	1	33	0	0
1	20238343	rs1046548	A	G	13	14	27	0	1	28	0	0
1	20826685	rs582984	T	A	167	87	254	0	4	258	0	0
1	20826686	rs583346	C	A	173	85	258	0	4	262	0	0
1	20826910	rs529974	G	A	149	99	248	0	0	248	0	0
1	20827031	rs531651	A	G	101	82	183	0	0	183	0	0
1	20827216	rs595980	C	T	126	96	222	0	3	225	0	0
1	20834610	rs6700034	C	A	14	19	33	0	1	34	0	0
1	20945055	rs1048977	C	T	4	7	11	0	0	11	0	0
1	20972698	rs114806694	G	A	5	5	10	0	0	10	0	0
1	20973872	rs7532296	A	G	0	8	8	0	0	8	0	0
1	20973892	rs9287034	C	T	7	0	7	0	0	7	0	0
1	20973941	rs12028312	C	T	10	2	12	0	0	12	0	0
1	20974046	rs76953237	C	A	1	5	6	0	0	6	0	0
1	20976163	rs545426	C	T	12	0	12	0	0	12	0	0
1	20977000	rs1043424	A	C	36	19	55	0	1	56	0	0
1	20977380	rs1043443	T	C	26	30	56	0	1	57	0	0
1	20977449	rs512550	G	T	33	25	58	0	1	59	0	0
1	20977748	rs1043502	T	G	7	13	20	0	0	20	0	0
1	20977856	rs2078073	T	C	5	6	11	0	0	11	0	0
1	20978024	rs1573132	C	A	7	7	14	0	0	14	0	0
1	20978058	rs650616	G	A	9	8	17	0	0	17	0	0
1	20978137	rs10916843	C	T	10	2	12	0	0	12	0	0
1	20978410	rs559542	T	C	318	255	573	0	3	576	0	0
1	20979573	rs36110575	C	T	19	6	25	0	0	25	0	0
1	20979580	rs12410193	T	G	19	7	26	0	0	26	0	0
1	20980450	rs2070660	G	T	12	11	23	0	0	23	0	0
1	20981438	rs594238	C	T	6	3	9	0	1	10	0	0
1	20982405	rs3738141	G	A	5	5	10	0	0	10	0	0
1	20982913	rs61778482	T	C	7	17	24	0	0	24	0	0
1	20983625	rs9662033	C	T	7	4	11	0	0	11	0	0
1	20983863	rs10799657	C	A	2	6	8	0	0	8	0	0
1	20983987	rs589709	G	A	7	4	11	0	0	11	0	0
1	20984254	rs10799658	C	T	5	7	12	0	0	12	0	0
1	20984554	rs640742	A	C	7	6	13	0	0	13	0	0
1	20986078	rs623817	G	A	7	7	14	0	0	14	0	0
1	20990905	rs10799659	G	A	11	3	14	0	0	14	0	0
1	21076754	rs12407704	C	G	6	5	11	0	0	11	0	0
1	21082074	rs10916856	A	C	25	22	47	0	0	47	0	0
1	21083435	rs113919494	G	A	19	20	39	0	0	39	0	0
1	21084367	rs12135548	G	A	4	3	7	0	0	7	0	0
1	21089133	rs611658	T	G	5	2	7	0	0	7	0	0
1	21089472	rs7548269	T	C	4	2	6	0	0	6	0	0
1	21090081	rs7548649	A	G	2	5	7	0	0	7	0	0
1	21091861	rs1985278	G	T	8	4	12	0	1	13	0	0
1	21194510	rs2167811	A	G	2	5	7	0	0	7	0	0
1	21544791	rs6701077	T	C	5	16	21	0	0	21	0	0
1	21573722	rs2229450	G	A	8	24	32	0	0	32	0	0
1	21649909	rs35204330	C	T	5	1	6	0	0	6	0	0
1	21656204	rs213038	A	C	4	2	6	0	0	6	0	0
1	21656901	rs68078765	T	A	9	6	15	0	0	15	0	0
1	21656941	rs61781578	C	G	8	5	13	0	0	13	0	0
1	21656944	rs61781579	G	A	8	5	13	0	0	13	0	0
1	21657507	rs7543687	C	T	5	3	8	0	0	8	0	0
1	21657819	rs12726080	C	A	5	1	6	0	0	6	0	0
1	21671943	rs2072654	T	G	7	3	10	0	0	10	0	0
1	21751142	.	A	G	6	0	6	0	0	6	0	0
1	21751214	.	G	A	9	0	9	0	0	9	0	0
1	21751325	rs140609058	G	C	5	5	10	0	0	10	0	0
1	21782542	rs76916472	A	C	9	20	29	0	0	29	0	0
1	21795288	rs61740199	C	T	3	8	11	0	0	11	0	0
1	21797204	rs72872292	G	C	7	2	9	0	0	9	0	0
1	21798144	rs142355608	C	T	10	1	11	0	0	11	0	0
1	21798249	rs72872297	C	G	8	5	13	0	0	13	0	0
1	21806571	rs41265989	A	G	7	9	16	0	0	16	0	0
1	21808159	rs71512991	G	A	4	5	9	0	0	9	0	0
1	21904374	rs1772719	A	C	3	3	6	0	0	6	0	0
1	21904574	rs2242421	A	G	3	3	6	0	0	6	0	0
1	22005665	rs1059218	C	T	0	6	6	0	2	8	0	0
1	22050649	rs2275668	C	A	7	6	13	0	0	13	0	0
1	22052070	rs12130039	C	A	4	4	8	0	0	8	0	0
1	22052387	rs7554400	T	C	5	5	10	0	0	10	0	0
1	22054427	rs16825896	C	A	12	11	23	0	0	23	0	0
1	22071992	rs12132216	G	C	24	7	31	0	0	31	0	0
1	22076705	rs2315931	G	A	4	5	9	0	0	9	0	0
1	22080687	rs72660393	C	G	7	4	11	0	0	11	0	0
1	22081980	rs12137072	G	A	15	9	24	0	0	24	0	0
1	22082566	rs146016524	G	C	5	9	14	0	0	14	0	0
1	22082664	rs10917040	T	A	5	3	8	0	0	8	0	0
1	22082794	rs10458383	T	C	1	8	9	0	0	9	0	0
1	22082923	rs10458384	G	A	3	5	8	0	1	9	0	0
1	22146509	rs61777193	T	C	3	4	7	0	0	7	0	0
1	22149183	rs1049644	G	C	113	112	225	0	0	225	0	0
1	22150120	rs3736360	C	T	56	75	131	0	2	133	0	0
1	22150160	.	G	T	63	82	145	0	0	145	0	0
1	22154845	rs2228347	A	G	84	75	159	0	1	160	0	0
1	22159008	rs2229487	C	A	101	117	218	0	1	219	0	0
1	22161275	rs2229492	G	A	76	52	128	0	0	128	0	0
1	22165901	rs2291826	A	G	58	52	110	0	1	111	0	0
1	22165987	rs2291827	G	A	48	66	114	0	0	114	0	0
1	22191454	rs897471	G	A	17	11	28	0	0	28	0	0
1	22352040	rs2255282	G	T	6	1	7	0	0	7	0	0
1	22352108	rs11801382	C	T	7	12	19	0	0	19	0	0
1	22353986	rs2501290	C	G	6	3	9	0	0	9	0	0
1	22353989	rs2501289	C	G	5	3	8	0	0	8	0	0
1	22354246	rs2473300	A	T	6	0	6	0	0	6	0	0
1	22354866	rs2473295	T	C	4	2	6	0	0	6	0	0
1	22356809	rs1063116	A	T	24	14	38	0	0	38	0	0
1	22356888	rs1063117	G	A	24	13	37	0	0	37	0	0
1	22356905	rs1063118	G	A	23	12	35	0	1	36	0	0
1	22357217	rs760923	G	T	37	33	70	0	0	70	0	0
1	22357549	rs2473291	G	T	18	7	25	0	1	26	0	0
1	22379360	rs16860621	G	A	2	12	14	0	0	14	0	0
1	22389388	rs16826309	A	G	2	6	8	0	0	8	0	0
1	22390078	rs11583790	G	A	1	8	9	0	0	9	0	0
1	22393524	rs12740791	C	T	5	4	9	0	0	9	0	0
1	22397248	rs11807562	C	T	7	7	14	0	0	14	0	0
1	22398905	rs34896897	A	G	12	12	24	0	0	24	0	0
1	22401538	rs10917139	G	A	4	3	7	0	0	7	0	0
1	22409094	rs2056974	T	A	6	1	7	0	0	7	0	0
1	22414070	rs11800014	C	T	38	35	73	0	1	74	0	0
1	22835677	rs209729	A	G	12	19	31	0	1	32	0	0
1	22852715	rs881646	G	C	22	16	38	0	0	38	0	0
1	22853141	rs2281354	G	A	16	17	33	0	0	33	0	0
1	22856601	rs1062663	T	C	25	29	54	0	0	54	0	0
1	23367138	rs1984576	A	G	38	55	93	0	2	95	0	0
1	23394062	rs2235548	G	A	7	1	8	0	0	8	0	0
1	23398065	rs12409321	C	T	6	5	11	0	0	11	0	0
1	23400969	rs1952527	T	C	16	7	23	0	0	23	0	0
1	23405872	rs2072944	T	C	27	16	43	0	0	43	0	0
1	23406485	rs2235547	C	G	23	13	36	0	0	36	0	0
1	23407081	rs12751560	C	A	21	23	44	0	0	44	0	0
1	23409538	rs2235546	G	A	42	29	71	0	0	71	0	0
1	23410138	rs12137204	T	G	12	21	33	0	1	34	0	0
1	23637670	rs150660854	A	G	4	3	7	0	0	7	0	0
1	23653041	rs114241021	G	A	5	6	11	0	1	12	0	0
1	23654085	rs143938231	A	T	2	4	6	0	0	6	0	0
1	24088128	rs1045017	G	A	96	103	199	0	2	201	0	0
1	24111280	.	C	T	5	3	8	0	0	8	0	0
1	24119627	rs2232982	C	T	5	5	10	0	0	10	0	0
1	24785393	rs2272935	C	T	20	11	31	0	0	31	0	0
1	24796838	rs12117331	A	G	11	11	22	0	0	22	0	0
1	24798001	rs195728	G	A	6	7	13	0	0	13	0	0
1	24798383	rs195729	C	T	13	11	24	0	0	24	0	0
1	24859617	rs196429	G	A	14	15	29	0	0	29	0	0
1	24859665	rs196430	G	A	12	12	24	0	0	24	0	0
1	24863285	rs11231	C	T	17	14	31	0	0	31	0	0
1	24981825	rs7546441	G	T	3	6	9	0	0	9	0	0
1	24986877	rs7549196	T	C	3	5	8	0	0	8	0	0
1	25125162	rs7550184	C	G	14	7	21	0	0	21	0	0
1	25125898	rs4641258	C	G	13	12	25	0	1	26	0	0
1	25168124	rs9259	G	C	101	96	197	0	5	202	0	0
1	25169634	rs12439	A	G	147	156	303	0	5	308	0	0
1	25245081	rs9438861	G	T	2	4	6	0	0	6	0	0
1	25251326	rs1507101	G	A	16	7	23	0	0	23	0	0
1	25251424	rs742230	G	A	21	7	28	0	0	28	0	0
1	25251456	rs742231	G	A	20	5	25	0	0	25	0	0
1	25251923	rs760805	A	T	5	4	9	0	0	9	0	0
1	25254317	rs7517302	C	T	35	30	65	0	0	65	0	0
1	25258301	rs4649037	G	T	14	15	29	0	0	29	0	0
1	25258585	rs11249203	G	C	5	4	9	0	0	9	0	0
1	25289734	rs72657048	C	G	4	6	10	0	0	10	0	0
1	25291010	rs6672420	A	T	15	16	31	0	0	31	0	0
1	25421107	rs4649064	A	G	2	4	6	0	0	6	0	0
1	25554364	.	C	T	3	3	6	0	0	6	0	0
1	25570081	rs1043879	T	C	102	118	220	0	1	221	0	0
1	25589199	rs28712173	A	G	84	31	115	0	0	115	0	0
1	25594264	rs34265899	C	G	9	17	26	0	0	26	0	0
1	25644654	rs28689927	A	G	2	5	7	0	0	7	0	0
1	25659525	rs28622222	G	A	127	32	159	0	0	159	0	0
1	25660621	rs60224697	A	G	55	76	131	0	0	131	0	0
1	25660831	rs4126583	C	T	49	59	108	0	0	108	0	0
1	25661137	rs4126584	G	C	47	40	87	0	0	87	0	0
1	25663071	rs596608	C	G	16	5	21	0	0	21	0	0
1	25684012	rs3093632	C	T	10	1	11	0	0	11	0	0
1	25685484	rs3093638	G	A	5	1	6	0	0	6	0	0
1	25687901	rs1053438	T	C	106	104	210	0	5	215	0	0
1	25688042	rs138543922	C	T	96	104	200	0	1	201	0	0
1	25688276	rs9689	A	G	108	106	214	0	1	215	0	0
1	25766897	.	A	G	8	2	10	0	0	10	0	0
1	25775682	rs12027110	A	T	7	5	12	0	0	12	0	0
1	25775733	rs12027135	A	T	7	4	11	0	0	11	0	0
1	25776343	rs7548114	C	G	6	5	11	0	0	11	0	0
1	25778106	rs7554255	C	T	6	2	8	0	0	8	0	0
1	25778832	rs4649085	G	A	15	13	28	0	0	28	0	0
1	25780668	rs34006994	C	T	5	4	9	0	0	9	0	0
1	25780893	rs61775167	A	G	9	9	18	0	0	18	0	0
1	25781153	rs67124498	A	G	4	6	10	0	0	10	0	0
1	25783066	rs35497030	A	G	13	19	32	0	0	32	0	0
1	25821125	rs552335655	G	A	2	7	9	0	0	9	0	0
1	25821671	rs35243054	G	T	2	4	6	0	0	6	0	0
1	25825781	rs61775206	G	A	61	60	121	0	0	121	0	0
1	25825950	rs67125653	G	T	17	17	34	0	1	35	0	0
1	25825956	rs72660967	T	C	21	12	33	0	2	35	0	0
1	25826328	rs11538134	G	A	6	11	17	0	0	17	0	0
1	25826502	rs34491689	A	G	12	31	43	0	1	44	0	0
1	25889632	rs6687605	T	C	16	17	33	0	0	33	0	0
1	25890189	rs28969504	A	G	13	18	31	0	0	31	0	0
1	25894853	rs11563	G	T	22	24	46	0	0	46	0	0
1	25895238	rs7491	C	T	15	13	28	0	0	28	0	0
1	26131638	rs35019869	A	G	116	80	196	0	1	197	0	0
1	26131654	rs7349185	G	A	92	123	215	0	1	216	0	0
1	26138262	rs760597	T	C	126	128	254	0	4	258	0	0
1	26140573	rs2294228	C	A	117	129	246	0	1	247	0	0
1	26143821	rs3203750	T	C	178	144	322	0	1	323	0	0
1	26143931	rs4659383	T	C	183	127	310	0	2	312	0	0
1	26144674	rs6872	G	A	105	86	191	0	0	191	0	0
1	26158962	rs15045	A	G	43	43	86	0	1	87	0	0
1	26161037	rs7555012	G	C	6	8	14	0	0	14	0	0
1	26161086	rs11247767	A	G	6	6	12	0	0	12	0	0
1	26188238	rs213638	G	A	45	46	91	0	1	92	0	0
1	26188625	rs213637	G	T	40	23	63	0	1	64	0	0
1	26211773	rs159528	C	T	2	6	8	0	0	8	0	0
1	26228409	rs159531	A	G	23	17	40	0	0	40	0	0
1	26448447	rs17257107	A	G	15	12	27	0	0	27	0	0
1	26448849	rs17356867	T	C	13	20	33	0	0	33	0	0
1	26449327	rs75786059	A	G	9	9	18	0	0	18	0	0
1	26449337	rs79778025	A	G	11	9	20	0	0	20	0	0
1	26449595	rs17257113	G	A	6	8	14	0	0	14	0	0
1	26450009	rs17163588	C	T	21	9	30	0	0	30	0	0
1	26450101	rs17257120	A	G	20	15	35	0	0	35	0	0
1	26496651	rs7087	T	C	97	60	157	0	0	157	0	0
1	26496870	rs2232654	A	G	3	4	7	0	0	7	0	0
1	26497340	rs8768	A	C	26	17	43	0	1	44	0	0
1	26561856	rs10493030	T	C	6	10	16	0	0	16	0	0
1	26563105	rs6656716	G	A	5	5	10	0	0	10	0	0
1	26564230	rs17163746	C	A	7	5	12	0	1	13	0	0
1	26582711	rs55791848	G	A	11	12	23	0	0	23	0	0
1	26582713	rs58038522	C	T	11	12	23	0	0	23	0	0
1	26585657	rs884533	G	T	4	2	6	0	0	6	0	0
1	26587918	rs12116908	G	A	3	3	6	0	0	6	0	0
1	26588730	rs6658236	G	A	4	3	7	0	0	7	0	0
1	26589698	rs12142535	T	A	4	5	9	0	0	9	0	0
1	26590182	rs11247890	G	A	3	4	7	0	0	7	0	0
1	26591255	rs17162105	A	G	9	10	19	0	0	19	0	0
1	26592310	rs7547520	C	T	7	5	12	0	0	12	0	0
1	26592871	rs7550127	C	T	8	7	15	0	0	15	0	0
1	26596080	rs7550997	G	A	56	49	105	0	0	105	0	0
1	26596563	rs2166901	G	C	5	2	7	0	0	7	0	0
1	26597673	rs11247894	G	A	9	7	16	0	1	17	0	0
1	26597781	rs10902727	C	T	5	4	9	0	0	9	0	0
1	26598281	rs10902728	T	C	9	11	20	0	0	20	0	0
1	26599542	rs11247895	G	A	3	6	9	0	0	9	0	0
1	26600793	rs10902731	A	G	6	7	13	0	0	13	0	0
1	26601385	rs3795685	G	A	15	7	22	0	1	23	0	0
1	26604071	rs11579354	T	G	71	95	166	0	4	170	0	0
1	26605069	rs8564	T	C	34	48	82	0	1	83	0	0
1	26606174	rs10902732	A	C	3	7	10	0	0	10	0	0
1	26606291	rs61775082	C	T	12	11	23	0	0	23	0	0
1	26607123	rs12759434	C	T	3	3	6	0	0	6	0	0
1	26607726	rs7544	T	G	2431	2572	5003	0	39	5043	1	0
1	26609259	rs7522905	C	T	63	44	107	0	1	108	0	0
1	26612460	rs11247900	G	A	27	40	67	0	0	67	0	0
1	26644399	rs41285347	C	T	12	3	15	0	0	15	0	0
1	26646726	rs1071849	A	G	167	1337	1504	0	5	1509	0	0
1	26646730	rs17645	A	G	164	1385	1549	0	6	1555	0	0
1	26786627	rs3816539	G	A	16	10	26	0	0	26	0	0
1	26797508	rs2290588	C	T	30	19	49	0	0	49	0	0
1	26797654	rs1055323	C	T	8	11	19	0	0	19	0	0
1	26800849	rs2445635	A	G	9	9	18	0	3	21	0	0
1	26801229	rs72651510	C	A	28	31	59	0	1	60	0	0
1	26870730	rs1466286	C	G	5	8	13	0	0	13	0	0
1	26879376	rs7543005	T	C	7	5	12	0	0	12	0	0
1	26884039	rs35245195	C	G	27	4	31	0	0	31	0	0
1	26884416	rs12726439	T	C	29	1	30	0	0	30	0	0
1	26887592	rs1064196	T	C	153	154	307	0	1	308	0	0
1	26888563	rs9971001	G	C	4	3	7	0	0	7	0	0
1	26891360	rs3127013	T	G	3	8	11	0	0	11	0	0
1	26892009	rs392814	T	C	3	5	8	0	0	8	0	0
1	26895802	rs282175	A	G	5	3	8	0	1	9	0	0
1	26898956	rs282176	T	C	24	52	76	0	0	76	0	0
1	26899444	rs190737	C	A	12	16	28	0	0	28	0	0
1	26899523	rs72651546	G	C	12	17	29	0	0	29	0	0
1	26899687	rs282178	C	A	10	15	25	0	0	25	0	0
1	26901319	rs7726	G	A	256	308	564	0	5	569	0	0
1	27093657	rs11247596	A	G	6	8	14	0	0	14	0	0
1	27104610	rs11802776	G	A	9	3	12	0	0	12	0	0
1	27123140	rs76388446	G	T	4	3	7	0	0	7	0	0
1	27180829	rs737524	A	C	37	87	124	0	1	125	0	0
1	27181427	rs760093	G	A	32	98	130	0	3	133	0	0
1	27182984	rs10902646	T	G	4	5	9	0	0	9	0	0
1	27207092	rs6680053	A	G	3	5	8	0	1	9	0	0
1	27210721	rs3170660	T	C	52	50	102	0	0	102	0	0
1	27269429	.	G	A	131	136	267	0	2	269	0	0
1	27652132	rs79070316	A	G	4	2	6	0	0	6	0	0
1	27652359	rs55663650	G	A	3	3	6	0	0	6	0	0
1	27654659	rs79311671	C	T	5	3	8	0	0	8	0	0
1	27655477	rs72882710	A	G	6	3	9	0	0	9	0	0
1	27655820	rs74648074	G	A	3	4	7	0	0	7	0	0
1	27655945	rs77535610	C	T	2	6	8	0	0	8	0	0
1	27659307	rs41291076	C	G	5	2	7	0	0	7	0	0
1	27660340	rs12758154	T	C	3	3	6	0	0	6	0	0
1	27662235	rs3813792	G	T	118	119	237	0	4	241	0	0
1	27662666	rs9203	A	G	102	105	207	0	0	207	0	0
1	27668748	rs7533455	A	G	49	42	91	0	2	93	0	0
1	27671698	rs12567637	G	A	21	10	31	0	0	31	0	0
1	27677930	rs12561870	G	A	4	3	7	0	0	7	0	0
1	27679797	rs3813795	A	G	142	171	313	0	5	318	0	0
1	27876482	rs2076457	C	A	5	3	8	0	0	8	0	0
1	28200702	rs11247700	C	T	8	4	12	0	0	12	0	0
1	28200760	rs11247701	G	A	5	5	10	0	0	10	0	0
1	28200909	rs10902674	T	C	5	4	9	0	0	9	0	0
1	28202162	rs143715955	T	C	12	10	22	0	0	22	0	0
1	28202643	rs12023566	C	T	4	3	7	0	0	7	0	0
1	28203620	rs11247702	G	T	20	14	34	0	0	34	0	0
1	28203653	rs11247703	C	G	19	13	32	0	0	32	0	0
1	28203981	rs34731385	C	T	3	4	7	0	0	7	0	0
1	28203984	rs34402280	C	T	3	3	6	0	0	6	0	0
1	28203986	rs36074736	G	A	3	3	6	0	0	6	0	0
1	28204080	rs12140012	T	C	5	1	6	0	0	6	0	0
1	28204089	rs12140013	T	C	5	1	6	0	0	6	0	0
1	28204128	rs139647844	A	G	1	5	6	0	0	6	0	0
1	28205006	.	T	C	13	0	13	0	0	13	0	0
1	28205884	rs12048235	G	A	14	18	32	0	0	32	0	0
1	28206588	rs12568383	T	C	99	140	239	0	2	241	0	0
1	28207052	rs7555608	G	A	112	40	152	0	5	158	1	0
1	28207822	rs35049624	T	C	23	12	35	0	0	35	0	0
1	28207887	rs35119733	A	G	32	36	68	0	1	69	0	0
1	28208312	rs35250731	C	A	34	52	86	0	1	87	0	0
1	28208327	rs34631302	A	G	35	50	85	0	1	86	0	0
1	28209305	rs3766398	A	G	233	327	560	0	2	562	0	0
1	28209362	rs3766399	T	C	299	423	722	0	3	725	0	0
1	28209366	rs3766400	A	G	312	422	734	0	5	739	0	0
1	28211384	rs2236074	G	A	68	64	132	0	1	133	0	0
1	28211403	rs1467465	A	G	66	66	132	0	2	134	0	0
1	28211650	rs1467464	T	C	66	89	155	0	0	155	0	0
1	28212272	rs11247705	G	A	12	26	38	0	0	38	0	0
1	28212975	rs6564	C	T	680	658	1338	0	7	1345	0	0
1	28213157	rs6565	T	C	103	98	201	0	0	201	0	0
1	28218100	rs7356	T	C	2	26	28	0	0	28	0	0
1	28298951	rs6699701	C	T	12	6	18	0	1	19	0	0
1	28477192	rs138629813	T	C	21	19	40	0	1	41	0	0
1	28586376	rs34315986	C	G	25	25	50	0	0	50	0	0
1	28800380	rs61785974	C	A	26	14	40	0	3	43	0	0
1	28822804	rs10915180	T	G	5	2	7	0	0	7	0	0
1	28823671	rs12139517	T	C	25	12	37	0	0	37	0	0
1	28825523	rs12141672	T	A	7	3	10	0	1	11	0	0
1	28826587	rs9107	G	A	53	32	85	0	0	85	0	0
1	28833494	rs2840758	G	A	3	3	6	0	0	6	0	0
1	28836046	rs41264145	C	T	268	197	465	0	3	472	4	0
1	28861636	rs2066726	G	A	28	36	64	0	0	64	0	0
1	28865710	rs2795321	A	G	2	4	6	0	0	6	0	0
1	28905649	rs9426360	T	C	2	4	6	0	0	6	0	0
1	29064036	rs61787567	C	T	74	67	141	0	2	143	0	0
1	29195941	rs464870	G	A	5	6	11	0	0	11	0	0
1	29196466	rs204063	T	G	6	7	13	0	0	13	0	0
1	29216798	rs204086	C	T	2	6	8	0	0	8	0	0
1	29218999	rs204085	T	C	6	0	6	0	0	6	0	0
1	29219755	rs157227	A	G	12	6	18	0	0	18	0	0
1	29220178	rs126014	G	A	13	13	26	0	0	26	0	0
1	29220270	rs126013	A	C	16	13	29	0	0	29	0	0
1	29442291	rs536178	C	T	139	82	221	0	0	221	0	0
1	29443675	rs502393	T	C	102	145	247	0	0	247	0	0
1	29444544	rs569716	G	A	95	74	169	0	0	169	0	0
1	29445514	rs553253	C	A	132	163	295	0	4	299	0	0
1	29475975	rs10915233	G	A	5	8	13	0	0	13	0	0
1	29493866	rs4654391	T	C	17	13	30	0	0	30	0	0
1	29497250	rs2452787	T	C	12	24	36	0	1	37	0	0
1	29505613	rs1961570	A	G	9	14	23	0	0	23	0	0
1	29507647	rs3094740	G	C	9	9	18	0	0	18	0	0
1	31192304	rs1149040	G	T	5	1	6	0	0	6	0	0
1	31198733	rs1149048	A	G	4	2	6	0	0	6	0	0
1	31205796	rs8048	T	C	3668	3278	6946	0	69	7015	0	0
1	31206637	rs3795438	C	T	1167	1164	2331	0	9	2340	0	0
1	31206806	rs3795437	T	C	18	22	40	0	0	40	0	0
1	31206957	rs12404920	T	C	32	21	53	0	0	53	0	0
1	31207256	rs55748171	G	T	28	37	65	0	1	66	0	0
1	31208042	rs35351292	C	T	3036	2702	5738	0	12	5750	0	0
1	31224193	rs7549164	C	T	10	5	15	0	0	15	0	0
1	31406732	rs10914237	G	A	37	23	60	0	0	60	0	0
1	31407680	rs77054916	C	G	32	23	55	0	2	57	0	0
1	31408106	rs57864908	C	T	33	20	53	0	1	54	0	0
1	31409898	rs72884036	C	T	6	5	11	0	1	12	0	0
1	31410915	rs60770428	G	A	10	5	15	0	0	15	0	0
1	31417458	rs12406355	T	C	3	3	6	0	0	6	0	0
1	31417838	rs12135102	G	A	2	5	7	0	0	7	0	0
1	31418119	rs12142833	C	T	6	3	9	0	0	9	0	0
1	31419887	rs6680401	C	G	3	3	6	0	0	6	0	0
1	31423758	rs6660431	T	C	4	9	13	0	0	13	0	0
1	31424590	rs67352588	C	T	4	3	7	0	1	8	0	0
1	31426815	rs2275741	A	G	120	127	247	0	4	251	0	0
1	31433511	rs2105345	C	G	8	7	15	0	0	15	0	0
1	31434764	rs7534060	T	A	15	9	24	0	0	24	0	0
1	31448207	rs12117717	T	G	3	3	6	0	0	6	0	0
1	31455678	rs6700556	C	A	21	11	32	0	0	32	0	0
1	31460338	rs7516039	A	G	5	3	8	0	0	8	0	0
1	31461438	rs947643	G	A	7	7	14	0	0	14	0	0
1	31462683	rs78169600	A	G	8	6	14	0	0	14	0	0
1	31463581	rs10798817	C	T	10	5	15	0	0	15	0	0
1	31465032	rs12033888	C	G	5	8	13	0	0	13	0	0
1	31492321	rs79646174	C	T	24	37	61	0	0	61	0	0
1	31516704	rs4949336	T	C	4	3	7	0	0	7	0	0
1	31516940	rs67150188	T	C	3	5	8	0	0	8	0	0
1	31517117	rs6425697	G	A	2	4	6	0	0	6	0	0
1	31517201	rs112378645	A	T	2	5	7	0	0	7	0	0
1	31898639	rs35976845	C	T	9	25	34	0	0	34	0	0
1	32498569	.	G	A	5	1	6	0	0	6	0	0
1	32501215	rs12094507	A	G	7	9	16	0	0	16	0	0
1	32631637	rs72666768	C	A	3	4	7	0	0	7	0	0
1	32669645	rs41263993	C	T	28	25	53	0	0	53	0	0
1	32689857	rs589034	A	G	8	10	18	0	0	18	0	0
1	32831583	rs41265847	C	T	138	148	286	0	2	288	0	0
1	33066299	rs2294815	C	A	23	14	37	0	0	37	0	0
1	33070737	rs146988136	C	T	3	5	8	0	0	8	0	0
1	33099637	rs704878	A	G	13	10	23	0	0	23	0	0
1	33131406	rs2762903	C	T	6	1	7	0	0	7	0	0
1	33140091	rs11808426	A	G	4	4	8	0	0	8	0	0
1	33142694	rs1136258	C	T	8	5	13	0	0	13	0	0
1	33142871	rs674636	G	A	3	3	6	0	0	6	0	0
1	33145448	rs4336811	C	T	133	157	290	0	2	292	0	0
1	33146501	rs360511	A	G	14	17	31	0	0	31	0	0
1	33147179	rs11809190	A	T	19	26	45	0	0	45	0	0
1	33148455	rs12568783	G	A	12	11	23	0	0	23	0	0
1	33149169	rs77721490	C	T	28	27	55	0	1	56	0	0
1	33150598	rs398500	T	C	7	11	18	0	0	18	0	0
1	33150643	rs634717	G	A	15	13	28	0	0	28	0	0
1	33150951	rs601637	T	C	31	30	61	0	0	61	0	0
1	33475687	.	C	G	147	0	147	0	1	148	0	0
1	33475750	.	A	G	297	0	297	0	4	301	0	0
1	33475767	.	G	A	313	1	314	0	0	314	0	0
1	33475791	.	A	G	299	0	299	0	0	299	0	0
1	33475879	.	C	T	280	0	280	0	3	283	0	0
1	33476032	.	T	C	204	0	204	0	1	205	0	0
1	33476065	.	G	A	154	0	154	0	0	154	0	0
1	33476074	.	A	T	152	0	152	0	0	152	0	0
1	33476090	.	T	C	170	0	170	0	0	170	0	0
1	33476143	.	G	A	148	0	148	0	2	150	0	0
1	33476165	.	G	A	149	0	149	0	0	149	0	0
1	33476239	.	T	C	64	0	64	0	0	64	0	0
1	33476292	.	A	G	50	0	50	0	1	51	0	0
1	33476353	.	C	T	76	0	76	0	0	76	0	0
1	33476385	.	C	G	142	0	142	0	0	142	0	0
1	33476387	.	C	T	145	0	145	0	0	145	0	0
1	33611890	rs689187	C	T	12	4	16	0	0	16	0	0
1	33612508	rs3766813	G	A	9	24	33	0	0	33	0	0
1	33789520	rs5861	C	A	211	240	451	0	1	452	0	0
1	33789588	rs1130804	T	C	188	215	403	0	2	405	0	0
1	33789670	rs11061	G	A	214	247	461	0	3	464	0	0
1	33789968	rs1130800	G	T	187	229	416	0	3	419	0	0
1	33790496	rs11554674	G	A	198	220	418	0	2	420	0	0
1	33792357	rs35990407	C	G	3	3	6	0	0	6	0	0
1	33800684	rs41265893	T	C	3	4	7	0	0	7	0	0
1	33809437	rs10798939	A	G	2	4	6	0	0	6	0	0
1	33819562	rs4233199	C	T	1	5	6	0	0	6	0	0
1	33819830	rs4653081	A	C	2	4	6	0	0	6	0	0
1	33820134	rs12026290	C	T	12	11	23	0	0	23	0	0
1	33832865	rs6425816	A	G	5	10	15	0	0	15	0	0
1	35316175	rs1054949	C	A	3	4	7	0	0	7	0	0
1	35316497	rs12076918	G	A	1	5	6	0	0	6	0	0
1	35317388	rs2025003	T	C	4	2	6	0	0	6	0	0
1	35317856	rs57939493	G	A	5	2	7	0	1	8	0	0
1	35320017	rs56145549	A	T	4	5	9	0	1	10	0	0
1	35320690	rs8621	T	G	25	22	47	0	0	47	0	0
1	35323395	rs7515410	T	G	13	6	19	0	0	19	0	0
1	35323550	rs7548854	C	T	5	3	8	0	0	8	0	0
1	35479295	rs71648001	G	A	11	5	16	0	0	16	0	0
1	35567194	rs11264066	C	T	2	6	8	0	0	8	0	0
1	35649642	.	T	G	583	715	1298	0	4	1302	0	0
1	35650653	.	G	C	220	205	425	0	0	426	1	0
1	36026509	.	G	A	9	11	20	0	0	20	0	0
1	36392546	.	T	G	5	3	8	0	1	9	0	0
1	36535669	rs274742	A	T	7	5	12	0	0	12	0	0
1	36637708	rs795047	A	G	26	35	61	0	1	62	0	0
1	36641729	rs2296263	C	T	5	6	11	0	0	11	0	0
1	36642420	rs475591	T	C	396	386	782	0	5	787	0	0
1	36642688	rs554008	G	A	13	14	27	0	0	27	0	0
1	36642858	rs4652903	C	T	14	16	30	0	0	30	0	0
1	36642991	rs6686192	C	T	17	20	37	0	0	37	0	0
1	36863456	rs1126984	G	A	12	9	21	0	0	21	0	0
1	37940438	rs2783730	C	A	8	5	13	0	0	13	0	0
1	37940638	rs2456802	G	A	12	13	25	0	0	25	0	0
1	37941953	rs1395718	A	G	27	24	51	0	0	51	0	0
1	37944506	rs11264060	G	A	27	34	61	0	0	61	0	0
1	37948212	rs215205	C	G	60	60	120	0	0	120	0	0
1	37948260	rs191923175	C	T	70	75	145	0	1	146	0	0
1	37958389	rs12133933	A	G	6	6	12	0	0	12	0	0
1	37958451	rs12144938	C	G	4	6	10	0	0	10	0	0
1	37958813	rs9253	C	G	1	6	7	0	0	7	0	0
1	37959450	rs215210	T	C	161	181	342	0	1	343	0	0
1	37959470	rs215211	C	G	170	170	340	0	1	341	0	0
1	37961613	rs2294873	A	G	5	3	8	0	0	8	0	0
1	37963541	rs4653294	A	G	6	2	8	0	0	8	0	0
1	38000482	rs532467576	C	T	3	8	11	0	0	11	0	0
1	38002068	rs41267303	C	T	5	9	14	0	0	14	0	0
1	38007121	rs12035095	G	C	11	6	17	0	0	17	0	0
1	38008119	rs35044953	T	G	5	7	12	0	0	12	0	0
1	38008523	rs61776184	C	T	2	7	9	0	0	9	0	0
1	38010651	rs61776185	G	A	3	4	7	0	1	8	0	0
1	38011993	rs61776186	G	C	4	6	10	0	0	10	0	0
1	38014478	rs11264069	A	G	4	22	26	0	0	26	0	0
1	38014601	rs10908354	A	G	3	4	7	0	1	8	0	0
1	38016705	rs11264071	C	T	7	1	8	0	0	8	0	0
1	38019198	rs12129777	T	C	11	10	21	0	0	21	0	0
1	38019210	rs12132301	G	A	11	10	21	0	1	22	0	0
1	38035286	rs10908355	G	T	3	4	7	0	0	7	0	0
1	38037032	rs34746385	A	G	4	3	7	0	0	7	0	0
1	38148765	rs684260	A	G	5	2	7	0	0	7	0	0
1	38174185	rs557897	G	T	6	1	7	0	0	7	0	0
1	38174366	rs7526362	G	T	6	11	17	0	0	17	0	0
1	38174987	rs7822	T	C	8	7	15	0	0	15	0	0
1	38268797	rs14614	A	G	71	87	158	0	0	158	0	0
1	38271190	rs540924	G	A	7	6	13	0	0	13	0	0
1	38275802	rs473279	T	C	15	23	38	0	1	39	0	0
1	38326547	rs1136994	C	T	27	37	64	0	0	64	0	0
1	38326654	rs1136990	A	G	34	16	50	0	2	52	0	0
1	38327358	rs111681950	C	T	11	17	28	0	0	28	0	0
1	38327447	rs12759400	T	C	24	17	41	0	1	42	0	0
1	38327982	rs3843	G	T	21	35	56	0	1	57	0	0
1	38329999	rs41311191	C	G	23	21	44	0	1	45	0	0
1	38338795	rs11488569	A	G	25	19	44	0	0	44	0	0
1	38348506	rs41307896	G	A	17	14	31	0	0	31	0	0
1	38397369	rs35267671	C	T	5	1	6	0	1	7	0	0
1	38480105	rs6688755	G	T	5	2	7	0	1	8	0	0
1	38480930	rs5018050	A	G	7	6	13	0	0	13	0	0
1	39311617	rs11549874	T	G	184	237	421	0	3	424	0	0
1	39329700	rs11538784	G	T	17	14	31	0	0	31	0	0
1	39380907	rs141597728	C	A	6	4	10	0	1	11	0	0
1	39457006	rs12043492	C	T	7	19	26	0	0	26	0	0
1	39457016	rs11547138	C	T	20	9	29	0	0	29	0	0
1	39457851	rs4660650	T	A	12	7	19	0	0	19	0	0
1	39457854	rs4660651	C	T	12	7	19	0	0	19	0	0
1	39457859	rs4660652	A	G	11	8	19	0	0	19	0	0
1	39458100	rs12133179	G	A	8	12	20	0	0	20	0	0
1	39458881	rs11205515	C	G	8	7	15	0	1	16	0	0
1	39459155	rs60452427	T	G	11	9	20	0	0	20	0	0
1	39459720	rs75647177	T	C	8	8	16	0	0	16	0	0
1	39460355	.	T	A	14	0	14	0	0	14	0	0
1	39460382	rs6659697	A	G	5	5	10	0	0	10	0	0
1	39460418	rs6670764	G	A	4	3	7	0	0	7	0	0
1	39460794	rs6662758	T	C	2	8	10	0	0	10	0	0
1	39461881	rs7368120	C	G	6	7	13	0	0	13	0	0
1	39462369	rs4370759	A	T	3	7	10	0	0	10	0	0
1	39462597	rs12145908	C	G	10	8	18	0	0	18	0	0
1	39463438	rs4147763	C	T	15	13	28	0	1	29	0	0
1	39465139	rs11205522	A	C	4	5	9	0	0	9	0	0
1	39465711	rs12133322	T	C	3	4	7	0	0	7	0	0
1	39465973	rs12143624	C	T	8	6	14	0	0	14	0	0
1	39466178	rs2013119	T	C	9	0	9	0	0	9	0	0
1	39466626	rs11205525	A	G	5	6	11	0	0	11	0	0
1	39467615	rs4147761	A	G	5	5	10	0	0	10	0	0
1	39467820	rs4147760	C	G	4	4	8	0	0	8	0	0
1	39467839	rs4147759	A	G	4	4	8	0	0	8	0	0
1	39468024	rs4147758	T	C	2	5	7	0	0	7	0	0
1	39470364	rs4147753	A	G	429	387	816	0	5	821	0	0
1	39748921	rs2275188	G	A	31	26	57	0	0	57	0	0
1	39799912	rs75770915	C	T	16	8	24	0	0	24	0	0
1	39816546	rs41270815	G	A	42	48	90	0	2	92	0	0
1	39838174	rs80197726	T	C	91	78	169	0	0	169	0	0
1	39908506	rs587404	G	A	179	171	350	0	2	352	0	0
1	39914363	rs668556	G	C	217	207	424	0	3	428	1	0
1	39917888	rs1746838	C	A	245	230	475	0	1	476	0	0
1	39948741	rs6691194	G	A	3	4	7	0	0	7	0	0
1	40032832	rs78260708	C	T	12	6	18	0	0	18	0	0
1	40033934	rs4660836	A	G	21	10	31	0	2	33	0	0
1	40036944	rs61743745	G	A	350	265	615	0	4	619	0	0
1	40041714	rs11557732	G	A	19	26	45	0	1	46	0	0
1	40090805	rs41264499	C	G	4	4	8	0	0	8	0	0
1	40147760	rs41301064	A	C	2	6	8	0	0	8	0	0
1	40149642	rs784634	G	T	3	3	6	0	0	6	0	0
1	40210468	rs12086750	G	C	2	6	8	0	0	8	0	0
1	40213670	rs58589165	A	T	4	12	16	0	0	16	0	0
1	40214367	rs41267029	A	G	5	16	21	0	0	21	0	0
1	40214375	rs553057	G	C	5	18	23	0	0	23	0	0
1	40219065	rs1046988	C	T	23	26	49	0	0	49	0	0
1	40219280	rs14528	T	C	15	8	23	0	0	23	0	0
1	40221067	rs2274949	G	A	4	4	8	0	0	8	0	0
1	40687368	rs61778546	T	A	8	5	13	0	0	13	0	0
1	40840353	rs1003710	A	G	12	14	26	0	0	26	0	0
1	40842933	rs76904272	G	A	21	18	39	0	0	39	0	0
1	40844402	rs3013458	T	G	15	4	19	0	0	19	0	0
1	40847822	rs79904641	T	C	15	14	29	0	2	31	0	0
1	40849203	rs78492778	G	T	25	28	53	0	0	53	0	0
1	40852821	rs209584	G	A	31	42	73	0	0	73	0	0
1	40853809	rs209585	A	G	24	14	38	0	0	38	0	0
1	40855691	rs453270	A	G	71	51	122	0	1	123	0	0
1	40856924	rs381231	A	G	7	5	12	0	0	12	0	0
1	40860357	rs209597	C	T	9	15	24	0	0	24	0	0
1	40861749	rs3013457	G	A	10	7	17	0	0	17	0	0
1	40861912	.	G	A	5	9	14	0	0	14	0	0
1	40865801	rs2982507	G	A	5	1	6	0	0	6	0	0
1	40866288	rs2982508	C	T	6	5	11	0	0	11	0	0
1	40869272	rs3013456	A	G	3	3	6	0	0	6	0	0
1	40871497	rs209599	A	G	5	4	9	0	0	9	0	0
1	40872195	rs209600	G	A	4	3	7	0	0	7	0	0
1	40879636	rs209604	T	C	28	26	54	0	1	55	0	0
1	40879808	rs209605	G	T	34	18	52	0	0	52	0	0
1	40879952	rs2294752	T	G	7	2	9	0	0	9	0	0
1	40881041	rs209606	C	G	269	253	522	0	1	523	0	0
1	40883266	rs427371	A	G	5	4	9	0	0	9	0	0
1	40916218	rs209607	T	C	3	3	6	0	0	6	0	0
1	40917246	rs12733709	A	G	1	6	7	0	0	7	0	0
1	40923019	rs2272994	G	A	7	11	18	0	0	18	0	0
1	40930549	rs3013466	C	A	2	4	6	0	0	6	0	0
1	40930624	rs2982502	A	G	4	3	7	0	0	7	0	0
1	41233227	rs823678	G	A	4	3	7	0	1	8	0	0
1	41234521	rs823685	A	G	4	5	9	0	0	9	0	0
1	41462032	rs12027691	C	T	4	2	6	0	0	6	0	0
1	41464455	rs12739052	C	A	3	6	9	0	0	9	0	0
1	41466221	rs12748235	G	A	5	3	8	0	0	8	0	0
1	41466472	rs12731155	A	G	10	7	17	0	0	17	0	0
1	41466550	rs12735455	T	A	5	6	11	0	0	11	0	0
1	41474400	rs35044078	C	G	3	4	7	0	0	7	0	0
1	41493111	rs3157	A	G	132	136	268	0	2	270	0	0
1	41493811	rs1140227	C	T	69	46	115	0	1	116	0	0
1	41494222	rs11578697	G	T	7	1	8	0	0	8	0	0
1	41505022	rs2300658	G	A	5	5	10	0	0	10	0	0
1	41726473	rs10524	T	C	0	9	9	0	0	9	0	0
1	41972198	rs2492082	A	T	9	9	18	0	1	19	0	0
1	41972283	rs1127985	C	T	3	7	10	0	2	12	0	0
1	41973400	rs71648554	G	A	30	23	53	0	1	54	0	0
1	41973908	rs1969749	C	T	16	23	39	0	0	39	0	0
1	41974164	rs11586958	C	G	15	22	37	0	0	37	0	0
1	41974258	rs2151674	G	A	21	17	38	0	0	38	0	0
1	41976017	rs678110	C	T	67	53	120	0	1	121	0	0
1	41976345	rs140839222	T	C	16	9	25	0	0	25	0	0
1	41979156	rs615177	A	G	25	13	38	0	0	38	0	0
1	42015389	rs1084462	G	A	4	2	6	0	0	6	0	0
1	42016863	.	A	G	4	5	9	0	0	9	0	0
1	42050366	rs2146315	C	T	22	10	32	0	0	32	0	0
1	42094498	rs2038976	A	G	21	17	38	0	0	38	0	0
1	42307194	rs509851	A	G	3	3	6	0	0	6	0	0
1	42644770	rs686247	C	T	101	107	208	0	4	212	0	0
1	42647914	rs624614	A	G	31	21	52	0	0	52	0	0
1	42650622	rs11210606	G	A	14	17	31	0	0	31	0	0
1	42652659	rs6673368	C	T	6	6	12	0	1	13	0	0
1	42653947	rs10890187	A	G	3	3	6	0	0	6	0	0
1	42656613	rs183667821	A	G	4	5	9	0	0	9	0	0
1	42656819	rs16829212	T	A	9	3	12	0	0	12	0	0
1	42925688	rs9787162	T	G	79	71	150	0	0	150	0	0
1	43042703	rs12049046	C	T	3	4	7	0	0	7	0	0
1	43047057	rs12037518	A	G	3	5	8	0	0	8	0	0
1	43163738	rs78661314	T	C	57	63	120	0	0	120	0	0
1	43245324	rs1570431	A	G	4	3	7	0	0	7	0	0
1	43247192	rs2760076	T	C	2	6	8	0	0	8	0	0
1	43272841	rs1044898	A	T	57	28	85	0	5	90	0	0
1	43279094	rs323714	T	C	22	11	33	0	0	33	0	0
1	43296118	rs12124733	G	A	13	5	18	0	0	18	0	0
1	43392250	rs4658	C	G	113	119	232	0	0	232	0	0
1	43395635	rs2229682	C	T	64	56	120	0	0	120	0	0
1	43396414	rs11537641	G	A	52	55	107	0	0	107	0	0
1	43408966	rs1385129	G	A	44	45	89	0	2	91	0	0
1	43424519	rs11537640	T	G	21	5	26	0	0	26	0	0
1	43825644	rs839763	T	C	7	3	10	0	0	10	0	0
1	43850140	.	G	A	7	13	20	0	0	20	0	0
1	43850473	rs11172	A	G	14	23	37	0	0	37	0	0
1	43886494	rs2782643	C	T	12	9	21	0	0	21	0	0
1	43892189	rs2782646	G	A	13	14	27	0	0	27	0	0
1	43899228	rs111538847	G	A	3	3	6	0	0	6	0	0
1	43899627	rs2842179	C	T	4	3	7	0	0	7	0	0
1	43906896	rs2027130	A	G	30	30	60	0	0	60	0	0
1	43915637	rs142316061	G	A	3	4	7	0	0	7	0	0
1	43916642	rs6954	T	C	97	75	172	0	0	172	0	0
1	43917409	rs2251804	T	C	8	13	21	0	0	21	0	0
1	43917637	rs2251802	G	A	106	88	194	0	0	194	0	0
1	43919413	rs6692611	A	G	7	4	11	0	0	11	0	0
1	44129779	rs669446	A	G	2	4	6	0	0	6	0	0
1	44137257	rs586339	C	A	21	27	48	0	0	48	0	0
1	44140075	rs10789442	A	C	4	5	9	0	0	9	0	0
1	44141149	rs9787076	A	C	11	10	21	0	0	21	0	0
1	44156683	.	C	T	27	28	55	0	0	55	0	0
1	44158129	rs2270972	C	G	8	12	20	0	1	21	0	0
1	44290530	rs37458	A	G	6	1	7	0	0	7	0	0
1	44396196	rs12561948	A	G	19	15	34	0	2	36	0	0
1	44396215	rs1859726	T	C	6	9	15	0	1	16	0	0
1	44396790	rs2485990	G	A	4	8	12	0	1	13	0	0
1	44402794	rs75209795	G	A	9	13	22	0	0	22	0	0
1	44415424	rs41270385	A	G	8	11	19	0	1	20	0	0
1	44440769	rs2286241	G	C	381	428	809	0	2	811	0	0
1	44441533	rs2286243	A	G	238	230	468	0	3	471	0	0
1	44442521	rs12410334	A	C	31	19	50	0	0	50	0	0
1	44442930	rs2428954	A	G	42	26	68	0	0	68	0	0
1	44443459	rs2428953	G	A	57	40	97	0	2	99	0	0
1	44447413	rs1859728	G	C	30	15	45	0	1	46	0	0
1	44451234	rs1061781	C	T	47	30	77	0	1	78	0	0
1	44461822	rs2301983	C	T	9	8	17	0	0	17	0	0
1	44681113	rs1291169	T	C	8	23	31	0	0	31	0	0
1	44686322	rs12419	T	C	26	22	48	0	0	48	0	0
1	44820248	rs226066	G	A	5	7	12	0	0	12	0	0
1	44878688	rs6690445	A	G	57	56	113	0	1	114	0	0
1	44879221	rs4660794	A	C	36	54	90	0	1	91	0	0
1	44881993	rs10890300	G	C	83	46	129	0	0	129	0	0
1	44885123	rs3866643	C	A	25	19	44	0	0	44	0	0
1	44891488	rs12022308	C	T	4	3	7	0	0	7	0	0
1	44892324	rs6680114	G	A	16	9	25	0	0	25	0	0
1	44898004	rs1987309	G	A	2	4	6	0	0	6	0	0
1	44898154	rs4454583	C	G	4	2	6	0	0	6	0	0
1	44902285	rs6429540	A	G	3	4	7	0	0	7	0	0
1	44904588	rs9660592	G	C	3	3	6	0	0	6	0	0
1	44912073	rs7518522	G	A	3	3	6	0	0	6	0	0
1	44921331	rs12071805	C	G	6	2	8	0	0	8	0	0
1	44921384	rs1340649	A	G	3	7	10	0	0	10	0	0
1	44922305	rs12724890	A	G	4	4	8	0	0	8	0	0
1	44922633	rs4233494	G	A	9	9	18	0	0	18	0	0
1	44922683	rs12746640	G	A	9	10	19	0	0	19	0	0
1	44924989	rs12730333	C	T	5	8	13	0	0	13	0	0
1	44925227	rs4660800	G	A	7	7	14	0	0	14	0	0
1	44925308	rs6662182	A	G	5	5	10	0	0	10	0	0
1	44925357	rs4660801	G	A	4	4	8	0	0	8	0	0
1	44925508	rs6664827	A	G	5	6	11	0	0	11	0	0
1	44926646	rs946960	T	C	5	11	16	0	0	16	0	0
1	44928522	rs56855065	G	A	2	10	12	0	0	12	0	0
1	44928780	rs4660802	G	A	8	5	13	0	0	13	0	0
1	44928908	.	G	A	19	25	44	0	0	44	0	0
1	44932028	rs12730027	C	T	7	2	9	0	1	10	0	0
1	44932398	rs4660804	C	A	10	2	12	0	0	12	0	0
1	44932745	rs4660278	A	G	13	7	20	0	1	21	0	0
1	44932970	rs4562668	A	G	6	0	6	0	0	6	0	0
1	44933234	rs4625324	C	T	7	1	8	0	0	8	0	0
1	44934194	rs35418918	G	A	5	2	7	0	0	7	0	0
1	44934387	rs10082024	A	G	3	5	8	0	0	8	0	0
1	44934647	rs12061037	A	G	4	2	6	0	0	6	0	0
1	44934795	rs12061137	A	G	3	3	6	0	0	6	0	0
1	44934995	rs2185500	T	C	10	7	17	0	0	17	0	0
1	44975005	rs811928	G	A	6	11	17	0	0	17	0	0
1	44975886	rs12747060	G	A	5	6	11	0	1	12	0	0
1	44976806	rs781790	A	G	6	2	8	0	0	8	0	0
1	45026717	rs12077259	A	G	5	4	9	0	0	9	0	0
1	45027315	rs12077531	A	G	7	2	9	0	0	9	0	0
1	45028041	rs17386574	G	C	4	5	9	0	0	9	0	0
1	45078152	rs272547	C	T	11	14	25	0	0	25	0	0
1	45081218	rs461659	C	G	4	2	6	0	0	6	0	0
1	45097584	rs114477934	C	T	24	28	52	0	0	52	0	0
1	45111713	rs6698388	A	C	6	5	11	0	1	12	0	0
1	45112717	rs3768440	G	A	6	4	10	0	0	10	0	0
1	45187486	rs115374922	T	C	10	8	18	0	0	18	0	0
1	45469215	rs188567783	C	T	34	37	71	0	0	71	0	0
1	45472923	.	G	A	29	21	50	0	0	50	0	0
1	45796354	rs3219492	G	T	5	1	6	0	0	6	0	0
1	45797505	rs3219489	C	G	21	32	53	0	0	53	0	0
1	45806432	rs3219463	C	T	14	7	21	0	0	21	0	0
1	45810091	rs9429072	A	G	27	34	61	0	1	62	0	0
1	45956681	rs16832545	G	A	11	12	23	0	0	23	0	0
1	45981834	rs6699702	C	T	8	4	12	0	0	12	0	0
1	45983080	rs11211129	C	T	4	4	8	0	0	8	0	0
1	46016501	rs28607905	G	A	22	15	37	0	0	37	0	0
1	46016687	rs9147	T	C	89	122	211	0	2	213	0	0
1	46032974	rs2088102	T	C	14	16	30	0	0	30	0	0
1	46033265	rs2356416	T	C	6	3	9	0	0	9	0	0
1	46033266	rs2356415	A	G	6	3	9	0	0	9	0	0
1	46033300	rs2088101	T	C	7	3	10	0	0	10	0	0
1	46033477	.	C	T	6	4	10	0	1	11	0	0
1	46100181	rs6699418	G	A	20	16	36	0	0	36	0	0
1	46100364	rs12091360	G	T	8	23	31	0	0	31	0	0
1	46100513	rs12060953	C	T	10	16	26	0	0	26	0	0
1	46101323	rs4431884	C	T	7	4	11	0	0	11	0	0
1	46116292	rs4660882	C	T	6	3	9	0	0	9	0	0
1	46116734	rs12070146	C	T	27	12	39	0	2	41	0	0
1	46116754	rs12070177	C	T	27	12	39	0	1	40	0	0
1	46117715	rs11211153	C	T	9	4	13	0	0	13	0	0
1	46119080	rs57671038	T	C	12	9	21	0	0	21	0	0
1	46119802	rs11211154	G	A	4	4	8	0	0	8	0	0
1	46122416	rs12745365	T	C	31	55	86	0	4	90	0	0
1	46123996	rs12057167	A	G	81	67	148	0	1	149	0	0
1	46124088	rs6656279	C	G	69	56	125	0	3	128	0	0
1	46124558	rs10789468	A	G	42	44	86	0	0	86	0	0
1	46124663	rs6671802	A	G	27	34	61	0	0	61	0	0
1	46124965	rs12063380	G	T	8	1	9	0	0	9	0	0
1	46126719	rs11211155	A	C	129	120	249	0	3	252	0	0
1	46126854	rs12757451	C	T	151	145	296	0	3	301	2	0
1	46493460	rs1707336	T	G	9	14	23	0	0	23	0	0
1	46500993	rs1052610	A	G	10	11	21	0	0	21	0	0
1	46767176	rs17413652	G	A	2	7	9	0	0	9	0	0
1	46774527	rs115033750	G	A	3	5	8	0	0	8	0	0
1	46779764	rs11588062	C	T	3	3	6	0	0	6	0	0
1	46810530	rs3737744	A	G	34	28	62	0	0	62	0	0
1	46810763	rs17102152	C	A	39	43	82	0	1	83	0	0
1	46830087	rs41294486	G	A	16	15	31	0	1	32	0	0
1	46830249	rs114487033	C	T	16	16	32	0	0	32	0	0
1	46830430	rs10252	G	A	14	17	31	0	0	31	0	0
1	46871986	rs324419	T	C	93	76	169	0	0	169	0	0
1	46873281	rs6697851	G	C	3	3	6	0	0	6	0	0
1	46874383	rs2295633	A	G	2	4	6	0	0	6	0	0
1	46875067	rs11576941	G	T	12	13	25	0	0	25	0	0
1	47023531	rs8602	C	A	46	50	96	0	2	98	0	0
1	47027943	rs11211303	T	C	6	2	8	0	0	8	0	0
1	47049493	rs11211312	G	A	2	5	7	0	0	7	0	0
1	47050333	rs1060478	T	C	6	6	12	0	0	12	0	0
1	47050655	rs55680528	G	A	4	4	8	0	0	8	0	0
1	47058195	rs9659890	G	A	4	5	9	0	0	9	0	0
1	47058863	rs12093643	C	T	2	5	7	0	0	7	0	0
1	47059431	rs59446321	G	T	5	13	18	0	0	19	1	0
1	47074462	rs2181413	A	G	26	12	38	0	0	38	0	0
1	47080679	rs6671527	G	A	3	3	6	0	0	6	0	0
1	47100099	rs1139759	C	A	2	5	7	0	0	7	0	0
1	47141718	rs12794	T	C	11	8	19	0	0	19	0	0
1	47717189	rs2758735	A	G	4	6	10	0	0	10	0	0
1	47766647	rs12141060	C	T	8	3	11	0	0	11	0	0
1	47767141	rs6689687	C	A	5	1	6	0	0	6	0	0
1	47767914	rs3125630	G	A	3	7	10	0	0	10	0	0
1	47799639	rs7543016	G	C	33	39	72	0	1	73	0	0
1	47842777	rs1044457	C	T	146	120	266	0	2	268	0	0
1	47844017	rs3088062	A	G	277	222	499	0	2	501	0	0
1	47844464	rs6795	G	A	5	6	11	0	0	11	0	0
1	48764419	rs1056042	C	T	8	16	24	0	0	24	0	0
1	48937691	rs2275309	A	T	4	4	8	0	0	8	0	0
1	49221214	rs12137284	G	A	2	4	6	0	0	6	0	0
1	49221356	rs12096331	A	G	10	4	14	0	0	14	0	0
1	49221899	rs11586913	G	A	2	4	6	0	0	6	0	0
1	49222528	rs10493135	G	A	32	8	40	0	0	40	0	0
1	49222904	rs1934409	G	A	9	28	37	0	0	37	0	0
1	49224065	rs12125554	C	T	44	77	121	0	1	122	0	0
1	49224243	rs3738311	C	T	45	57	102	0	0	103	1	0
1	49224584	rs1128934	G	T	77	100	177	0	2	179	0	0
1	50907438	rs4381241	T	C	10	5	15	0	0	15	0	0
1	50911157	rs718257	G	A	1	5	6	0	0	6	0	0
1	51414317	rs60914341	G	A	5	5	10	0	0	10	0	0
1	51437247	rs3176459	A	G	3	4	7	0	0	7	0	0
1	51439456	rs3176471	A	T	36	25	61	0	0	61	0	0
1	51716152	rs35646320	C	T	6	5	11	0	0	11	0	0
1	51820325	rs11554033	C	T	6	12	18	0	0	18	0	0
1	51820990	rs7308	T	G	67	71	138	0	1	139	0	0
1	51826177	rs12731329	A	C	10	9	19	0	0	19	0	0
1	51826242	rs12070243	G	A	7	2	9	0	0	9	0	0
1	51826921	rs17567	T	C	98	91	189	0	0	189	0	0
1	51827223	rs79064302	T	C	9	5	14	0	0	14	0	0
1	51873951	rs1065754	G	A	77	68	145	0	0	145	0	0
1	51915915	rs35380971	G	C	8	0	8	0	0	8	0	0
1	51924226	rs6672300	C	T	3	7	10	0	0	10	0	0
1	51942910	rs141543558	C	T	4	2	6	0	0	6	0	0
1	51942911	rs145493605	A	G	4	2	6	0	0	6	0	0
1	52183531	rs530866509	G	A	6	5	11	0	0	11	0	0
1	52191593	.	C	T	14	14	28	0	0	28	0	0
1	52220686	.	T	C	10	1	11	0	0	11	0	0
1	52266242	rs8375	G	A	211	193	404	0	5	409	0	0
1	52290984	rs11205896	T	G	140	115	255	0	5	260	0	0
1	52339759	rs7413471	T	C	5	1	6	0	0	6	0	0
1	52342427	rs1890946	T	C	23	17	40	0	1	41	0	0
1	52814394	rs147736665	C	T	10	12	22	0	0	22	0	0
1	52818188	rs7513934	G	A	5	7	12	0	0	12	0	0
1	52991638	rs12123698	C	T	108	71	179	0	0	179	0	0
1	53073327	rs946154	G	C	14	2	16	0	1	17	0	0
1	53073630	rs12122956	A	C	2	6	8	0	0	8	0	0
1	53074532	rs1047635	C	A	65	38	103	0	0	103	0	0
1	53238229	rs149698803	T	G	36	0	36	0	1	37	0	0
1	53698223	rs76569730	T	C	4	2	6	0	0	6	0	0
1	53738915	rs113753086	C	T	3	3	6	0	0	6	0	0
1	53743677	rs10788954	T	C	4	3	7	0	0	7	0	0
1	53746320	rs75624781	C	T	7	13	20	0	1	21	0	0
1	54322418	rs17109454	T	C	3	3	6	0	0	6	0	0
1	54354658	rs2294508	T	G	19	22	41	0	0	41	0	0
1	54354935	rs3817871	G	C	10	12	22	0	1	23	0	0
1	54355041	rs10888814	A	G	8	15	23	0	0	23	0	0
1	54493060	rs11800869	C	T	10	38	48	0	0	48	0	0
1	54493420	rs6699257	A	G	6	15	21	0	0	21	0	0
1	54497983	rs12092512	A	C	4	10	14	0	0	14	0	0
1	54500185	rs7528837	A	G	5	7	12	0	0	12	0	0
1	54500221	rs12064857	C	T	6	7	13	0	0	13	0	0
1	54500487	rs7539402	G	A	6	4	10	0	0	10	0	0
1	54501432	rs112142160	C	T	4	2	6	0	0	6	0	0
1	54505405	.	C	G	11	4	15	0	0	15	0	0
1	54505437	rs3766466	C	A	5	10	15	0	0	15	0	0
1	54505703	rs80255594	G	A	10	13	23	0	0	23	0	0
1	54505756	rs41331348	G	A	10	10	20	0	0	20	0	0
1	54513323	rs12065783	A	G	7	8	15	0	0	15	0	0
1	54514065	rs75737797	G	T	9	7	16	0	0	16	0	0
1	54517324	rs10489446	A	G	1	5	6	0	0	6	0	0
1	54563156	rs6588502	A	G	4	4	8	0	0	8	0	0
1	54681920	rs13571	G	C	183	186	369	0	3	372	0	0
1	54683856	rs15921	C	G	165	124	289	0	1	290	0	0
1	54683925	rs6621	G	A	114	95	209	0	0	209	0	0
1	54689643	rs10788975	A	G	4	6	10	0	0	10	0	0
1	54689765	rs11206306	C	G	4	8	12	0	0	12	0	0
1	54689962	rs11206307	G	C	2	13	15	0	0	15	0	0
1	54690037	rs2282332	C	T	7	9	16	0	1	17	0	0
1	54690954	rs3088379	T	C	39	16	55	0	0	55	0	0
1	54691465	rs9012	C	T	64	40	104	0	2	106	0	0
1	54703197	rs664696	A	C	6	1	7	0	0	7	0	0
1	54703198	rs644660	T	A	6	1	7	0	0	7	0	0
1	55060362	rs1702003	G	A	3	4	7	0	0	7	0	0
1	55062960	rs2304305	G	A	3	3	6	0	1	7	0	0
1	55074840	rs1617287	T	A	7	3	10	0	0	10	0	0
1	55119289	rs9332417	G	C	4	4	8	0	0	8	0	0
1	55119515	rs1655519	T	G	7	2	9	0	0	9	0	0
1	55182300	rs1147990	T	A	12	16	28	0	0	28	0	0
1	55207754	rs13046	C	G	19	27	46	0	0	46	0	0
1	55315611	rs7373	C	G	15	8	23	0	0	23	0	0
1	55316322	rs7374	A	G	21	7	28	0	0	28	0	0
1	55317685	rs1138030	G	A	12	7	19	0	0	19	0	0
1	55319902	rs718265	A	G	3	8	11	0	0	11	0	0
1	56961756	rs4628	A	G	9	12	21	0	0	21	0	0
1	58999853	rs75129043	T	C	10	7	17	0	0	17	0	0
1	59121036	rs10789069	A	C	13	15	28	0	1	29	0	0
1	59122871	rs232851	C	T	32	14	46	0	0	46	0	0
1	59123655	rs10889108	C	T	33	21	54	0	2	56	0	0
1	59123995	rs6682078	A	G	18	24	42	0	1	43	0	0
1	59124223	rs12080369	G	A	19	12	31	0	0	31	0	0
1	59124546	rs232775	A	G	13	11	24	0	0	24	0	0
1	59124803	rs232776	C	T	14	17	31	0	0	31	0	0
1	59125319	rs12562490	C	T	25	25	50	0	0	50	0	0
1	59125515	rs12737926	C	T	10	10	20	0	1	21	0	0
1	59127086	rs7523134	G	A	25	26	51	0	0	51	0	0
1	59127705	rs17118041	C	G	3	6	9	0	0	9	0	0
1	59142713	rs579110	T	C	23	10	33	0	0	33	0	0
1	59147926	rs12139511	T	C	5	7	12	0	0	12	0	0
1	59155683	rs2223698	T	C	1	6	7	0	0	7	0	0
1	59844471	rs835435	G	A	4	3	7	0	0	7	0	0
1	62147019	rs11539585	A	T	12	9	21	0	0	21	0	0
1	62147149	rs10493311	G	A	4	2	6	0	0	6	0	0
1	62902874	rs646179	A	G	64	56	120	0	2	122	0	0
1	62903547	rs9436223	C	T	6	5	11	0	0	11	0	0
1	62904936	rs11588261	G	A	3	5	8	0	0	8	0	0
1	62908538	rs641540	A	G	5	6	11	0	0	11	0	0
1	62914978	rs783291	G	A	10	13	23	0	0	23	0	0
1	62915473	rs11207970	C	T	23	22	45	0	0	45	0	0
1	62916796	rs583609	T	C	53	53	106	0	1	107	0	0
1	62960101	rs10889335	A	G	14	5	19	0	0	19	0	0
1	63153953	rs4344355	C	T	9	14	23	0	0	23	0	0
1	63881552	rs4630153	C	T	7	7	14	0	0	14	0	0
1	63908735	rs3009576	C	T	5	2	7	0	0	7	0	0
1	63922813	rs12747542	C	T	5	1	6	0	0	6	0	0
1	63991267	rs217478	T	C	7	3	10	0	0	10	0	0
1	64114301	rs11208257	T	C	24	23	47	0	1	48	0	0
1	64125368	rs8294	C	T	18	21	39	0	0	39	0	0
1	64125439	rs4643	A	C	19	22	41	0	1	42	0	0
1	65271101	rs17126987	G	A	6	5	11	0	0	11	0	0
1	65303131	rs17127024	G	T	3	8	11	0	0	11	0	0
1	65313945	rs2780898	A	G	11	4	15	0	0	15	0	0
1	65892464	rs12094974	G	A	5	9	14	0	1	15	0	0
1	65893960	rs4468199	A	G	4	2	6	0	0	6	0	0
1	65894069	rs7551385	C	G	5	5	10	0	0	10	0	0
1	65894342	rs3790433	C	T	9	7	16	0	0	16	0	0
1	65894813	rs77848204	G	A	9	11	20	0	0	20	0	0
1	65894940	rs75465244	A	G	10	14	24	0	0	24	0	0
1	65895927	rs9436301	T	C	12	4	16	0	0	16	0	0
1	65896545	rs9436741	A	G	11	4	15	0	0	15	0	0
1	65896561	rs9436302	G	A	11	4	15	0	0	15	0	0
1	65896674	rs9436303	A	G	13	5	18	0	1	19	0	0
1	65896687	rs9436304	G	C	12	4	16	0	0	16	0	0
1	65897747	rs1887285	A	G	42	39	81	0	0	81	0	0
1	65897951	rs7602	G	A	106	107	213	0	1	214	0	0
1	65897981	rs1045895	G	A	103	105	208	0	1	209	0	0
1	65898873	rs17750	G	C	117	123	240	0	24	264	0	0
1	65900357	rs55889533	G	T	32	23	55	0	1	56	0	0
1	65900690	rs55655800	G	T	34	34	68	0	1	69	0	0
1	65901208	rs6658922	G	A	27	24	51	0	0	51	0	0
1	66058513	rs1137101	A	G	3	3	6	0	1	7	0	0
1	66067109	rs1805134	T	C	5	1	6	0	0	6	0	0
1	66797772	.	C	A	10	1	11	0	0	11	0	0
1	66803080	rs1890196	C	T	1	6	7	0	0	7	0	0
1	66806953	rs2788646	T	C	2	4	6	0	0	6	0	0
1	66807544	rs475826	G	A	2	5	7	0	0	7	0	0
1	66808584	.	C	T	5	4	9	0	0	9	0	0
1	66808645	rs116661526	T	C	3	9	12	0	0	12	0	0
1	66809344	rs501997	A	G	2	4	6	0	0	6	0	0
1	66810657	rs491190	C	T	4	3	7	0	0	7	0	0
1	66831370	rs783036	G	A	197	163	360	0	0	360	0	0
1	66837253	rs61796507	C	T	11	4	15	0	0	15	0	0
1	67396739	rs12562761	C	T	6	3	9	0	0	9	0	0
1	67398119	rs11208974	A	T	5	4	9	0	0	9	0	0
1	67402832	rs72671702	C	T	5	4	9	0	0	9	0	0
1	67402953	rs4655660	G	A	3	9	12	0	0	12	0	0
1	67408828	rs4655661	A	C	10	14	24	0	0	24	0	0
1	67411057	rs66979028	T	G	6	8	14	0	1	15	0	0
1	67412235	rs41286730	G	A	33	15	48	0	0	48	0	0
1	67426340	rs72673722	A	T	4	2	6	0	0	6	0	0
1	67426487	rs12742428	A	G	4	2	6	0	0	6	0	0
1	67427306	rs2985796	G	T	3	7	10	0	0	10	0	0
1	67440702	rs11803444	G	A	2	8	10	0	0	10	0	0
1	67441675	rs11208977	G	T	5	3	8	0	0	8	0	0
1	67441715	rs111241793	G	A	6	3	9	0	0	9	0	0
1	67444783	rs66594421	T	C	7	4	11	0	0	11	0	0
1	67446686	rs11799699	C	A	2	4	6	0	0	6	0	0
1	67447050	rs77347645	C	G	6	3	9	0	0	9	0	0
1	67450416	.	G	A	184	173	357	0	1	358	0	0
1	67465988	.	A	T	15	14	29	0	1	30	0	0
1	67465989	.	A	T	15	13	28	0	1	29	0	0
1	67467486	rs61587608	G	A	24	35	59	0	1	60	0	0
1	67470855	rs2755254	C	T	7	12	19	0	0	19	0	0
1	67472280	rs2815349	G	A	8	5	13	0	0	13	0	0
1	67472506	rs12073258	C	T	8	4	12	0	0	12	0	0
1	67473214	rs17129589	T	C	3	6	9	0	0	9	0	0
1	67473378	rs17129595	G	A	4	5	9	0	0	9	0	0
1	67473977	rs2755266	A	G	6	2	8	0	0	8	0	0
1	67475616	rs1121824	C	A	4	3	7	0	0	7	0	0
1	67477408	rs2755241	C	A	7	5	12	0	0	12	0	0
1	67477543	rs6698599	T	C	3	4	7	0	0	7	0	0
1	67484563	rs11208989	A	G	2	4	6	0	0	6	0	0
1	67518534	rs10157422	C	T	22	23	45	0	0	45	0	0
1	67773649	rs11209046	T	C	3	5	8	0	0	8	0	0
1	67779676	rs10489627	A	G	3	3	6	0	0	6	0	0
1	67833527	rs2307145	G	C	5	12	17	0	0	17	0	0
1	67852335	rs2228420	G	A	4	9	13	0	0	13	0	0
1	67875106	rs3171013	C	A	11	16	27	0	2	29	0	0
1	67875414	rs4655707	T	C	18	19	37	0	1	38	0	0
1	67875533	rs4655708	T	A	13	10	23	0	0	23	0	0
1	67887563	rs12561767	G	A	13	17	30	0	0	30	0	0
1	67888931	rs112588573	G	A	15	8	23	0	0	23	0	0
1	67890526	rs6702742	A	G	6	6	12	0	0	12	0	0
1	68151980	rs2759219	T	G	13	11	24	0	0	24	0	0
1	68152363	rs3783468	G	A	21	23	44	0	0	44	0	0
1	68152388	rs681673	T	C	24	26	50	0	0	50	0	0
1	68152438	rs532446	C	T	34	32	66	0	0	66	0	0
1	70611208	rs676753	A	T	9	4	13	0	0	13	0	0
1	70627355	rs17131238	C	T	3	5	8	0	0	8	0	0
1	70688964	rs145573920	T	G	9	15	24	0	0	24	0	0
1	70690540	rs56299138	C	T	41	39	80	0	0	80	0	0
1	70714013	rs76757906	A	G	14	26	40	0	0	40	0	0
1	70718395	rs116458285	C	T	9	11	20	0	0	20	0	0
1	70820008	rs61782675	C	T	41	27	68	0	1	69	0	0
1	70833451	rs150671354	T	C	4	4	8	0	0	8	0	0
1	71529401	rs7411	C	T	17	18	35	0	0	35	0	0
1	71529544	.	A	C	63	69	132	0	0	132	0	0
1	71531596	rs17090778	A	G	5	8	13	0	1	14	0	0
1	71533287	rs66461782	A	T	5	1	6	0	0	6	0	0
1	71535608	rs1138177	T	C	9	9	18	0	0	18	0	0
1	71541524	rs12030413	G	C	13	15	28	0	0	28	0	0
1	71873154	rs41289154	T	G	12	9	21	0	0	21	0	0
1	71873225	.	G	A	15	11	26	0	0	26	0	0
1	76257488	rs7534288	C	T	12	5	17	0	0	17	0	0
1	77555481	rs169216	C	T	9	8	17	0	0	17	0	0
1	77555737	rs11162270	C	T	6	4	10	0	0	10	0	0
1	77558057	rs1048575	G	C	16	17	33	0	1	34	0	0
1	77759578	rs2815311	A	G	300	150	450	0	4	454	0	0
1	77760027	rs11583735	G	C	2	4	6	0	0	6	0	0
1	77878601	rs4949654	G	A	4	4	8	0	1	9	0	0
1	78025459	rs4949660	T	C	5	18	23	0	0	23	0	0
1	78182223	.	G	A	11	7	18	0	0	18	0	0
1	78184433	rs1963170	G	A	5	4	9	0	0	9	0	0
1	79123094	rs7514391	G	A	4	8	12	0	0	12	0	0
1	79128914	rs3766325	G	A	8	5	13	0	0	13	0	0
1	84670816	rs1057738	A	C	9	13	22	0	0	22	0	0
1	84702474	rs17131308	C	T	14	10	24	0	0	24	0	0
1	84944989	rs2292191	A	G	92	92	184	0	0	184	0	0
1	84956780	rs12136756	C	T	3	3	6	0	0	6	0	0
1	84956858	rs12126584	A	G	4	6	10	0	0	10	0	0
1	84957998	rs4907077	T	C	8	4	12	0	0	12	0	0
1	84958561	rs312401	G	A	4	6	10	0	0	10	0	0
1	84962335	rs74095424	G	A	9	2	11	0	1	12	0	0
1	84962423	rs12071149	A	G	11	2	13	0	0	13	0	0
1	84962577	rs2794217	T	C	5	1	6	0	0	6	0	0
1	84963000	rs1246159	A	G	5	3	8	0	0	8	0	0
1	84964259	rs151312092	G	T	10	7	17	0	0	17	0	0
1	84965364	rs12140555	C	T	4	4	8	0	0	8	0	0
1	84965623	rs56212819	C	T	7	11	18	0	0	18	0	0
1	84968749	rs17110519	G	T	7	10	17	0	0	17	0	0
1	84970107	rs3813607	A	G	18	12	30	0	0	30	0	0
1	84970884	rs1533374	T	A	7	9	16	0	0	16	0	0
1	84970947	rs3813605	C	T	9	12	21	0	0	21	0	0
1	84972099	rs2271620	G	T	7	3	10	0	1	11	0	0
1	85029077	rs15911	C	T	109	102	211	0	0	211	0	0
1	85031630	rs2994953	G	A	90	95	185	0	2	187	0	0
1	85113229	rs1057746	A	G	7	9	16	0	0	16	0	0
1	85721194	rs10873696	C	T	12	7	19	0	1	20	0	0
1	85721911	rs11161570	T	C	25	26	51	0	0	51	0	0
1	85723764	rs150794466	T	C	12	10	22	0	1	23	0	0
1	85724283	rs75989026	C	T	71	79	150	0	0	150	0	0
1	85732739	rs17124475	C	T	60	28	88	0	0	88	0	0
1	85738430	rs2647396	C	T	2	5	7	0	0	7	0	0
1	85738909	.	C	T	4	3	7	0	0	7	0	0
1	85742023	rs12037217	C	A	85	102	187	0	0	187	0	0
1	85742264	rs61771973	G	C	15	19	34	0	0	34	0	0
1	86416343	rs603297	A	C	3	4	7	0	0	7	0	0
1	86457867	rs28480217	G	A	6	0	6	0	0	6	0	0
1	86488232	rs641712	G	A	5	6	11	0	0	11	0	0
1	86512536	rs60891279	C	T	8	5	13	0	0	13	0	0
1	86557967	rs11161732	G	A	11	2	13	0	0	13	0	0
1	86590582	rs80262773	A	G	1	10	11	0	0	11	0	0
1	86591036	rs56046090	G	T	6	4	10	0	0	10	0	0
1	86591837	rs11161747	G	A	10	3	13	0	0	13	0	0
1	86815303	rs17129078	T	C	7	0	7	0	0	7	0	0
1	86815319	rs272493	A	G	8	0	8	0	0	8	0	0
1	86816987	rs272494	T	A	18	16	34	0	0	34	0	0
1	86817074	rs272495	G	T	16	12	28	0	0	28	0	0
1	86818572	rs272496	T	C	13	19	32	0	2	34	0	0
1	86820267	rs1182098	C	T	23	23	46	0	1	47	0	0
1	86823079	rs272499	C	T	1	5	6	0	1	7	0	0
1	86838158	rs421105	C	T	8	13	21	0	1	22	0	0
1	86843039	rs187971	T	G	5	2	7	0	0	7	0	0
1	86847955	rs272516	G	A	18	8	26	0	0	26	0	0
1	87169408	rs1058978	T	C	1	5	6	0	0	6	0	0
1	87190907	rs34389199	A	G	8	9	17	0	0	17	0	0
1	87194735	rs35261486	G	A	14	11	25	0	1	26	0	0
1	87196360	rs12064866	G	T	8	19	27	0	0	27	0	0
1	87196431	rs61802924	C	T	19	17	36	0	0	36	0	0
1	87197698	rs72961627	G	A	9	8	17	0	0	17	0	0
1	87204496	rs146600527	T	C	3	7	10	0	0	10	0	0
1	87204961	rs263479	C	T	6	3	9	0	0	9	0	0
1	87205252	rs372830	A	T	10	6	16	0	0	16	0	0
1	87205253	rs372828	A	T	10	6	16	0	0	16	0	0
1	87206716	rs6687821	C	G	8	7	15	0	0	15	0	0
1	87207041	rs17129445	A	G	2	8	10	0	0	10	0	0
1	87207800	rs166415	G	T	5	8	13	0	1	14	0	0
1	87208953	rs7805	T	A	198	148	346	0	3	349	0	0
1	87209658	rs263476	G	A	11	6	17	0	0	17	0	0
1	87211940	rs10489890	A	C	82	63	145	0	2	147	0	0
1	87212999	rs10446	A	G	72	71	143	0	1	144	0	0
1	87328525	rs5859	C	T	68	54	122	0	1	123	0	0
1	87328839	rs5845	G	A	194	182	376	0	0	376	0	0
1	87380631	rs548649	C	T	11	11	22	0	0	22	0	0
1	87570398	rs1621247	G	A	20	12	32	0	0	32	0	0
1	87572817	rs2764430	C	T	11	7	18	0	0	18	0	0
1	87573988	rs2798683	T	C	3	3	6	0	0	6	0	0
1	87574217	rs2798684	A	G	4	9	13	0	1	14	0	0
1	89157443	rs71666203	T	A	5	9	14	0	0	14	0	0
1	89457930	rs6428489	C	G	5	2	7	0	0	7	0	0
1	89473134	rs2077694	C	T	4	3	7	0	0	7	0	0
1	89473175	rs1409150	T	C	5	4	9	0	0	9	0	0
1	90177852	rs10922702	A	G	8	6	14	0	1	15	0	0
1	90227649	rs473412	G	A	1	7	8	0	0	8	0	0
1	90356728	rs2390830	C	T	2	5	7	0	0	7	0	0
1	90471768	rs12740926	G	A	9	5	14	0	0	14	0	0
1	91384826	rs10801834	G	A	8	4	12	0	0	12	0	0
1	92177938	rs1805113	A	G	5	3	8	0	0	8	0	0
1	92774767	rs11586355	G	A	5	3	8	0	0	8	0	0
1	92808334	rs7528377	T	C	3	3	6	0	0	6	0	0
1	92862046	rs11803457	T	C	5	3	8	0	0	8	0	0
1	92863103	rs7517541	G	A	3	3	6	0	0	6	0	0
1	92866627	rs4970699	T	C	4	2	6	0	0	6	0	0
1	92940411	rs41313373	C	T	312	248	560	0	4	564	0	0
1	92941357	rs4970714	A	G	594	547	1141	0	3	1144	0	0
1	92942466	rs942753	G	A	18	17	35	0	0	35	0	0
1	92944994	rs4970702	A	G	43	47	90	0	0	90	0	0
1	92945507	rs11164601	T	C	39	33	72	0	1	73	0	0
1	92947138	rs11164607	A	C	15	19	34	0	1	35	0	0
1	92947427	rs11164608	C	T	21	16	37	0	0	37	0	0
1	92950937	rs4565725	A	G	26	21	47	0	0	47	0	0
1	92951210	rs6689470	G	A	3	4	7	0	0	7	0	0
1	92975244	rs1059268	T	A	15	11	26	0	0	26	0	0
1	92975262	rs1059267	C	A	16	9	25	0	1	26	0	0
1	92975464	rs41286801	C	T	2	5	7	0	1	8	0	0
1	92975493	rs4970700	A	G	4	3	7	0	0	7	0	0
1	92975938	rs1886684	T	C	4	12	16	0	0	16	0	0
1	93073228	rs11808092	C	A	11	3	14	0	0	14	0	0
1	93298756	rs1854797	T	C	34	26	60	0	0	60	0	0
1	93303603	rs6604026	T	C	23	13	36	0	0	36	0	0
1	93304272	rs10782945	C	T	21	14	35	0	0	35	0	0
1	93305371	rs11586570	A	C	16	7	23	0	1	24	0	0
1	93306317	rs10874744	G	A	17	14	31	0	0	31	0	0
1	93591162	rs12064785	A	G	2	6	8	0	0	8	0	0
1	93600630	rs12736775	A	G	9	1	10	0	0	10	0	0
1	93601231	rs36057148	G	A	5	4	9	0	0	9	0	0
1	93604136	rs12062154	T	C	23	24	47	0	0	47	0	0
1	93616202	rs1572343	T	C	7	12	19	0	0	19	0	0
1	93617546	rs546	T	C	9	22	31	0	0	31	0	0
1	93620393	rs1060622	G	A	218	176	394	0	4	398	0	0
1	93622789	rs2783506	A	G	5	15	20	0	0	20	0	0
1	93624139	rs2749735	G	T	16	16	32	0	0	32	0	0
1	93624374	rs12130734	T	C	38	71	109	0	0	109	0	0
1	93628013	rs4847401	C	G	4	3	7	0	0	7	0	0
1	93628062	rs4847402	G	A	5	5	10	0	0	10	0	0
1	93645182	rs1335679	C	T	2	4	6	0	0	6	0	0
1	93646418	rs10874763	C	T	7	16	23	0	1	24	0	0
1	93646620	rs2815408	C	T	5	3	8	0	0	8	0	0
1	93672723	rs2815413	A	C	5	6	11	0	0	11	0	0
1	93685923	rs671559	T	C	6	0	6	0	0	6	0	0
1	93799002	rs10874774	C	T	6	1	7	0	0	7	0	0
1	93804952	rs1535699	G	A	11	7	18	0	0	18	0	0
1	93804987	rs1535700	C	G	15	7	22	0	0	22	0	0
1	93811569	rs10782959	A	G	77	65	142	0	2	144	0	0
1	93815490	rs3767964	T	C	1	18	19	0	0	19	0	0
1	93827456	rs771457	T	A	80	49	129	0	2	131	0	0
1	93828523	rs7525248	T	A	7	4	11	0	1	12	0	0
1	93828907	rs771456	C	T	25	22	47	0	1	48	0	0
1	93829248	rs4847412	C	G	53	40	93	0	2	95	0	0
1	93829869	rs698926	A	G	5	4	9	0	0	9	0	0
1	93830480	rs771455	G	C	13	18	31	0	0	31	0	0
1	93831694	rs771453	A	C	46	31	77	0	1	78	0	0
1	93831707	rs771452	G	A	45	24	69	0	1	70	0	0
1	93832565	rs7535214	A	T	9	10	19	0	0	19	0	0
1	93833101	rs771450	G	A	4	6	10	0	0	10	0	0
1	93833181	rs771449	A	G	6	6	12	0	0	12	0	0
1	94042011	rs67300695	T	C	4	5	9	0	0	9	0	0
1	94337048	rs2143992	T	C	2	4	6	0	0	6	0	0
1	94339747	rs11165028	T	G	8	8	16	0	0	16	0	0
1	94340556	rs4847264	G	T	7	7	14	0	0	14	0	0
1	94341267	rs2273165	A	G	192	213	405	0	1	406	0	0
1	94343023	rs2391322	A	G	177	171	348	0	5	353	0	0
1	94343233	rs3789457	T	C	131	146	277	0	0	277	0	0
1	94367783	rs7515813	G	A	3	3	6	0	0	6	0	0
1	94930345	rs16946	G	A	17	5	22	0	0	22	0	0
1	94983203	rs698951	C	T	4	3	7	0	0	7	0	0
1	94995411	rs841691	C	A	103	129	232	0	1	233	0	0
1	94995491	rs841692	C	T	93	104	197	0	0	197	0	0
1	94995819	rs3354	C	T	90	87	177	0	1	178	0	0
1	94997488	rs1034363	C	T	23	12	35	0	0	35	0	0
1	94997752	.	A	G	11	7	18	0	0	18	0	0
1	94999497	rs841695	A	G	12	13	25	0	0	25	0	0
1	94999520	rs2794470	T	C	18	13	31	0	0	31	0	0
1	94999659	rs841696	G	A	21	19	40	0	0	40	0	0
1	95000769	rs3917616	G	A	23	36	59	0	0	59	0	0
1	95709939	rs2296308	T	G	5	12	17	0	0	17	0	0
1	97266709	rs182276183	A	G	9	1	10	0	0	10	0	0
1	97543752	rs291593	G	A	6	4	10	0	0	10	0	0
1	100316589	rs2307130	A	G	6	5	11	0	0	11	0	0
1	100327183	rs2230305	T	C	5	3	8	0	0	8	0	0
1	100388748	rs3766603	T	C	4	2	6	0	0	6	0	0
1	100472604	rs534252	A	G	6	15	21	0	1	22	0	0
1	100488177	rs482466	C	T	23	16	39	0	0	39	0	0
1	100538621	rs629340	A	T	11	19	30	0	0	30	0	0
1	100540172	rs12077086	C	T	9	12	21	0	0	21	0	0
1	100540289	rs611421	A	G	8	7	15	0	0	15	0	0
1	100540405	rs60632291	T	A	11	11	22	0	0	22	0	0
1	100543962	rs644835	A	G	32	36	68	0	0	68	0	0
1	100546591	rs575971	T	C	4	3	7	0	0	7	0	0
1	100598866	rs472498	G	A	7	3	10	0	1	11	0	0
1	100598867	rs687513	C	T	7	4	11	0	0	11	0	0
1	100611168	rs72728140	A	G	7	4	11	0	0	11	0	0
1	100672060	rs12021720	T	C	8	2	10	0	0	10	0	0
1	100731820	rs57327535	G	A	14	3	17	0	0	17	0	0
1	100744105	rs4268370	T	C	5	1	6	0	0	6	0	0
1	100748790	rs4511130	G	A	7	1	8	0	0	8	0	0
1	100748795	rs4534406	C	G	7	1	8	0	0	8	0	0
1	100751055	rs10875286	G	C	6	1	7	0	0	7	0	0
1	100752992	rs6577165	T	G	14	11	25	0	0	25	0	0
1	100753180	rs72730117	T	A	5	4	9	0	0	9	0	0
1	100753841	rs5026409	C	A	4	3	7	0	1	8	0	0
1	100754434	rs11166424	A	G	7	19	26	0	0	26	0	0
1	100754482	rs12066043	A	G	20	12	32	0	0	32	0	0
1	100754583	rs11166425	T	G	21	6	27	0	0	27	0	0
1	100754660	rs11166426	A	G	18	11	29	0	0	29	0	0
1	100754862	rs9728652	G	T	19	10	29	0	1	30	0	0
1	100754864	rs9727631	T	G	20	9	29	0	2	31	0	0
1	100756252	rs115135282	G	A	30	39	69	0	0	69	0	0
1	100757763	rs6704125	T	C	50	22	72	0	0	72	0	0
1	100758049	.	G	T	60	26	86	0	0	86	0	0
1	100758155	rs11581889	T	C	52	26	78	0	0	78	0	0
1	100818178	rs529224	G	C	26	17	43	0	0	43	0	0
1	100876505	rs816179	T	C	4	3	7	0	0	7	0	0
1	100879914	rs12568038	C	T	5	2	7	0	0	7	0	0
1	100880328	rs612683	A	T	7	2	9	0	0	9	0	0
1	100887616	rs479269	A	G	6	10	16	0	0	16	0	0
1	100902936	rs491675	A	G	7	4	11	0	0	11	0	0
1	100965942	rs12042531	G	A	13	12	25	0	0	25	0	0
1	101362582	rs112578365	C	A	1	5	6	0	0	6	0	0
1	101704532	rs3737577	G	T	31	22	53	0	1	54	0	0
1	104076462	rs6697444	C	T	12	9	21	0	1	22	0	0
1	104094998	rs1060309	A	G	5	2	7	0	0	7	0	0
1	104096692	rs11184430	T	C	9	14	23	0	0	23	0	0
1	104097685	rs10754	C	T	21	23	44	0	0	44	0	0
1	107599918	rs2232016	C	T	4	2	6	0	0	6	0	0
1	108113856	rs8458	G	A	21	20	41	0	0	41	0	0
1	108113865	rs8676	G	A	22	23	45	0	0	45	0	0
1	108117406	rs11802848	C	G	8	3	11	0	1	12	0	0
1	108117879	rs12094574	A	G	2	5	7	0	0	7	0	0
1	108121323	rs1410404	C	A	7	13	20	0	0	20	0	0
1	108125303	rs11185138	C	T	1	5	6	0	0	6	0	0
1	108185301	rs12403266	C	G	76	61	137	0	1	138	0	0
1	108185309	rs12410676	G	A	77	59	136	0	1	137	0	0
1	108229087	rs59226361	A	G	5	5	10	0	0	10	0	0
1	108231895	rs12038018	T	C	5	1	6	0	0	6	0	0
1	108234660	rs11588526	C	T	5	3	8	0	0	8	0	0
1	108235719	rs7530592	G	T	3	5	8	0	0	8	0	0
1	108240826	rs61798893	A	T	5	5	10	0	0	10	0	0
1	108243134	rs10881478	C	T	5	2	7	0	0	7	0	0
1	108243575	rs12046282	G	C	4	4	8	0	0	8	0	0
1	108243795	rs12046347	G	T	4	4	8	0	0	8	0	0
1	108243838	rs12025398	C	T	4	3	7	0	0	7	0	0
1	108243851	rs12043814	T	C	4	2	6	0	0	6	0	0
1	108244185	rs11185165	C	T	2	9	11	0	0	11	0	0
1	108244195	rs9726002	A	C	9	2	11	0	0	11	0	0
1	108244275	rs9730466	C	T	8	4	12	0	0	12	0	0
1	108244281	rs9730467	C	A	9	5	14	0	0	14	0	0
1	108244366	rs9726335	T	C	9	2	11	0	1	12	0	0
1	108244453	rs9727445	G	A	12	2	14	0	0	14	0	0
1	108244476	rs9726347	T	C	11	3	14	0	0	14	0	0
1	108244614	rs2494063	C	T	3	9	12	0	0	12	0	0
1	108244683	rs12049255	C	T	3	3	6	0	0	6	0	0
1	108244730	rs11185166	C	A	5	3	8	0	0	8	0	0
1	108244739	rs11185167	G	T	5	3	8	0	0	8	0	0
1	108244919	rs2494064	G	A	4	2	6	0	0	6	0	0
1	108244975	rs2494065	G	A	6	4	10	0	0	10	0	0
1	108245615	rs2494067	C	T	6	3	9	0	0	9	0	0
1	108246069	rs10218617	T	C	5	4	9	0	0	9	0	0
1	108246265	rs11185168	G	A	2	4	6	0	0	6	0	0
1	108263314	rs10785828	T	C	3	3	6	0	0	6	0	0
1	108268985	rs11185171	T	C	3	5	8	0	0	8	0	0
1	108276775	rs11806453	C	T	5	5	10	0	0	10	0	0
1	108277172	rs10881480	C	G	3	4	7	0	0	7	0	0
1	108277173	rs10881481	C	G	3	4	7	0	0	7	0	0
1	108307727	rs7528153	T	A	55	45	100	0	1	101	0	0
1	108313258	rs6583048	C	T	46	19	65	0	0	65	0	0
1	108412542	rs115254217	T	C	13	4	17	0	0	17	0	0
1	108412944	rs56161040	G	A	7	4	11	0	0	11	0	0
1	108414847	rs72689607	C	A	7	4	11	0	0	11	0	0
1	108416421	rs439278	G	A	2	7	9	0	0	9	0	0
1	108677973	rs12065664	A	C	8	3	11	0	0	11	0	0
1	108678361	rs575371	T	C	29	16	45	0	1	46	0	0
1	108679151	rs17021096	A	G	33	16	49	0	0	49	0	0
1	108684831	rs12031483	G	C	1	5	6	0	0	6	0	0
1	108738360	rs505024	C	A	5	4	9	0	0	9	0	0
1	108738436	rs591763	A	C	4	4	8	0	0	8	0	0
1	108741065	rs594397	T	C	0	22	22	0	0	22	0	0
1	108742123	rs547364	C	G	3	4	7	0	0	7	0	0
1	108743178	rs663481	C	G	1	6	7	0	0	7	0	0
1	109290211	rs11102337	G	C	11	6	17	0	0	17	0	0
1	109323620	rs12131095	C	T	4	7	11	0	0	11	0	0
1	109324220	rs6697576	A	T	2	7	9	0	1	10	0	0
1	109324694	rs61797330	A	G	5	1	6	0	0	6	0	0
1	109338861	rs1127635	G	C	68	62	130	0	1	131	0	0
1	109349307	rs6680575	A	G	5	6	11	0	0	11	0	0
1	109350260	rs61797352	G	A	16	6	22	0	0	22	0	0
1	109350284	rs61797353	C	T	16	7	23	0	0	23	0	0
1	109486196	rs338466	A	G	21	12	33	0	0	33	0	0
1	109514115	.	C	T	38	51	89	0	0	89	0	0
1	110026989	rs2781553	G	T	3	3	6	0	0	6	0	0
1	110029475	rs1144594	C	T	4	3	7	0	0	7	0	0
1	110035159	rs11590351	T	C	8	8	16	0	0	16	0	0
1	110136458	rs2301230	A	G	30	48	78	0	0	78	0	0
1	110136884	rs41280328	T	C	23	23	46	0	1	47	0	0
1	110162918	rs28362580	T	C	5	2	7	0	0	7	0	0
1	110168888	rs493972	C	G	8	8	16	0	0	16	0	0
1	110212534	rs687643	T	C	31	11	42	0	0	42	0	0
1	110212916	rs1149177	G	A	13	11	24	0	0	24	0	0
1	110213000	rs1149178	T	A	19	13	32	0	0	32	0	0
1	110587924	rs7545124	G	A	9	3	12	0	0	12	0	0
1	110587956	rs7545139	G	A	10	3	13	0	0	13	0	0
1	110589579	rs1965990	G	A	2	6	8	0	0	8	0	0
1	110590816	rs12042401	C	T	7	12	19	0	0	19	0	0
1	110604747	rs2360635	G	A	13	2	15	0	0	15	0	0
1	110606606	rs751387	T	G	7	0	7	0	0	7	0	0
1	110606946	rs1077581	C	G	6	1	7	0	0	7	0	0
1	110908371	rs115344802	G	C	3	3	6	0	0	6	0	0
1	110909102	rs115677544	A	G	6	8	14	0	0	14	0	0
1	110914402	.	G	A	7	7	14	0	0	14	0	0
1	110915297	rs1055013	T	C	15	11	26	0	0	26	0	0
1	111199205	rs2797520	T	C	6	1	7	0	0	7	0	0
1	111215472	rs1058184	A	C	3	4	7	0	0	7	0	0
1	111415841	rs1494324	G	A	132	124	256	0	3	259	0	0
1	111434711	rs2070748	C	T	19	15	34	0	0	34	0	0
1	111437129	rs1343817	A	C	25	15	40	0	1	41	0	0
1	111438469	rs56298121	C	T	4	2	6	0	0	6	0	0
1	111440954	.	G	A	10	15	25	0	1	26	0	0
1	111494194	rs2232041	C	T	6	4	10	0	0	10	0	0
1	111726869	rs3795823	G	A	21	10	31	0	0	31	0	0
1	111957097	rs7825	C	G	9	13	22	0	0	22	0	0
1	111957245	rs9629	G	A	11	11	22	0	0	22	0	0
1	111957693	rs2485319	A	G	4	14	18	0	0	18	0	0
1	111964144	rs1264885	G	C	3	6	9	0	0	9	0	0
1	111966291	rs954739	C	T	8	4	12	0	0	12	0	0
1	111973893	rs1264914	C	T	4	2	6	0	0	6	0	0
1	111974621	rs77779101	C	T	6	0	6	0	0	6	0	0
1	111980355	rs1264907	C	A	3	3	6	0	0	6	0	0
1	111985229	rs1264902	G	T	5	6	11	0	0	11	0	0
1	111991845	rs1270853	C	A	5	3	8	0	0	8	0	0
1	111992095	rs1264899	C	T	44	58	102	0	0	102	0	0
1	111992823	rs1264898	G	T	8	10	18	0	0	18	0	0
1	111993641	rs12047745	C	T	15	8	23	0	0	23	0	0
1	111993963	rs1343348	G	C	3	11	14	0	0	14	0	0
1	111994028	rs1343347	G	C	8	6	14	0	0	14	0	0
1	111994588	rs182506736	T	A	5	2	7	0	0	7	0	0
1	111996558	rs11102278	G	A	12	13	25	0	0	25	0	0
1	111998679	rs12047479	C	A	9	6	15	0	0	15	0	0
1	112018657	rs6703267	G	A	32	43	75	0	1	76	0	0
1	112021029	rs1054680	A	G	55	53	108	0	0	108	0	0
1	112059148	rs12138958	G	C	5	2	7	0	0	7	0	0
1	112177391	rs492824	T	C	3	3	6	0	0	6	0	0
1	112178080	rs35404324	T	C	3	3	6	0	0	6	0	0
1	112247965	rs519412	G	T	5	3	8	0	0	9	1	0
1	112253333	rs72991095	A	G	6	3	9	0	0	9	0	0
1	112253397	rs846261	G	A	3	5	8	0	0	8	0	0
1	112254674	rs543081	C	T	4	2	6	0	0	6	0	0
1	112266592	rs2447945	T	C	3	4	7	0	0	7	0	0
1	112298378	rs28372703	T	C	3	5	8	0	0	8	0	0
1	112303791	rs17569368	A	T	17	16	33	0	0	33	0	0
1	112309926	rs17504173	A	G	17	12	29	0	0	29	0	0
1	113083439	rs10745330	C	T	7	3	10	0	0	10	0	0
1	113156426	rs1994604	C	T	6	5	11	0	0	11	0	0
1	113160170	rs11102513	C	T	6	5	11	0	0	11	0	0
1	113160343	.	A	T	3	4	7	0	0	7	0	0
1	113160419	rs11102514	C	T	7	8	15	0	0	15	0	0
1	113195789	rs3013440	G	A	28	34	62	0	1	63	0	0
1	113196198	rs200137493	A	T	7	6	13	0	1	14	0	0
1	113196896	rs3790598	G	A	5	4	9	0	0	9	0	0
1	113207243	rs12756815	C	A	3	5	8	0	0	8	0	0
1	113207531	rs12046329	T	C	9	7	16	0	0	16	0	0
1	113208039	rs12046466	T	C	3	7	10	0	0	10	0	0
1	113231286	rs12126971	T	C	9	11	20	0	0	20	0	0
1	113236087	rs902289	C	T	4	4	8	0	0	8	0	0
1	113236681	rs3748656	C	T	13	21	34	0	0	34	0	0
1	113237171	rs883593	A	G	22	20	42	0	0	42	0	0
1	113239382	rs17030651	G	A	30	25	55	0	0	55	0	0
1	113241052	rs2306940	T	C	33	44	77	0	1	78	0	0
1	113242122	rs1106287	T	G	19	15	34	0	0	34	0	0
1	113242488	rs3013431	C	T	3	6	9	0	0	9	0	0
1	113243048	rs6679	C	T	47	44	91	0	1	92	0	0
1	114263251	.	T	C	3	3	6	0	0	6	0	0
1	114311796	rs112438759	C	G	5	3	8	0	0	8	0	0
1	114438951	rs1217401	A	G	29	29	58	0	0	58	0	0
1	114439025	rs114201291	A	G	26	32	58	0	0	58	0	0
1	114439522	rs1310183	T	C	3	3	6	0	0	6	0	0
1	114443899	rs17464525	G	A	28	30	58	0	2	60	0	0
1	114444444	rs34751342	T	G	34	36	70	0	0	70	0	0
1	114446341	rs10858022	A	G	6	9	15	0	0	15	0	0
1	114447034	rs6661817	G	C	7	8	15	0	0	15	0	0
1	114447565	rs1217397	G	A	13	10	23	0	0	23	0	0
1	114455907	rs6674384	G	A	4	6	10	0	0	10	0	0
1	114496048	rs115319740	A	G	1	5	6	0	0	6	0	0
1	114503636	rs7545300	T	A	4	5	9	0	1	10	0	0
1	114504860	rs41302825	G	A	19	16	35	0	1	36	0	0
1	114505000	rs17852555	G	A	172	171	343	0	7	350	0	0
1	114506675	rs6669370	C	A	5	2	7	0	0	7	0	0
1	114508685	rs72691850	A	G	3	5	8	0	0	8	0	0
1	114511635	rs11102708	G	A	11	6	17	0	0	17	0	0
1	114512083	rs11102709	G	C	17	13	30	0	0	30	0	0
1	114512277	rs113921455	A	G	14	20	34	0	1	35	0	0
1	114515717	rs2358996	G	A	227	217	444	0	13	457	0	0
1	114516330	rs10108	C	T	245	206	451	0	0	451	0	0
1	114519132	.	A	G	260	275	535	0	6	541	0	0
1	114519351	rs10732635	T	G	305	280	585	0	4	589	0	0
1	114936079	rs41313288	T	A	10	8	18	0	0	18	0	0
1	114938289	rs41314009	T	G	1	5	6	0	0	6	0	0
1	114943348	rs72693901	G	T	6	8	14	0	0	14	0	0
1	114944681	rs35031220	T	C	0	7	7	0	0	7	0	0
1	114951390	rs71662879	T	A	7	2	9	0	1	10	0	0
1	114973429	rs12083584	T	C	33	27	60	0	0	60	0	0
1	115259599	rs8453	G	T	256	303	559	0	2	561	0	0
1	115259768	rs1065634	T	C	726	594	1320	0	16	1336	0	0
1	115260643	rs6851	C	T	593	566	1159	0	10	1169	0	0
1	115269211	rs2144428	G	A	9	5	14	0	0	14	0	0
1	115271225	.	A	C	5	9	14	0	1	15	0	0
1	115297088	rs75472789	C	T	10	8	18	0	0	18	0	0
1	115299486	rs78782041	A	G	8	7	15	0	0	15	0	0
1	115592670	rs79690531	T	C	1	13	14	0	0	14	0	0
1	115592820	rs3738706	T	C	2	5	7	0	0	7	0	0
1	115601528	rs3738702	C	G	7	4	11	0	0	11	0	0
1	115604798	rs10776795	C	T	9	3	12	0	0	12	0	0
1	115879904	.	T	G	8	0	8	0	3	11	0	0
1	116932563	rs850609	T	A	4	3	7	0	0	7	0	0
1	117311147	rs699738	C	A	17	9	26	0	0	26	0	0
1	117617705	rs998532	A	G	78	70	148	0	0	148	0	0
1	117618067	rs1289673	C	T	119	86	205	0	0	205	0	0
1	117910682	rs1146297	G	A	30	27	57	0	1	58	0	0
1	118068558	rs2767318	G	A	16	21	37	0	0	37	0	0
1	118148830	rs1775815	G	T	3	6	9	0	1	10	0	0
1	118151935	rs1808809	C	T	4	2	6	0	0	6	0	0
1	118155152	rs199858224	A	G	3	3	6	0	0	6	0	0
1	118155620	rs3767812	G	A	1	8	9	0	0	9	0	0
1	118156053	rs1370297	G	A	7	3	10	0	0	10	0	0
1	118158355	rs12408825	A	G	3	5	8	0	0	8	0	0
1	118158607	rs1657820	A	G	3	5	8	0	0	8	0	0
1	118158614	rs1775828	T	C	3	4	7	0	0	7	0	0
1	118164722	rs826404	T	C	5	6	11	0	0	11	0	0
1	118164771	rs10923357	C	G	4	6	10	0	0	10	0	0
1	118164794	rs10923358	A	G	4	6	10	0	0	10	0	0
1	118165328	rs844108	T	C	4	11	15	0	0	15	0	0
1	118165973	rs1627787	C	T	377	391	768	0	5	773	0	0
1	118166096	rs2884587	C	T	481	627	1108	0	13	1121	0	0
1	118166750	rs2066411	A	G	439	454	893	0	8	901	0	0
1	118168826	rs11581122	C	T	94	91	185	0	1	186	0	0
1	118420452	rs733833	C	G	7	3	10	0	0	10	0	0
1	118432938	rs12116827	G	C	5	3	8	0	0	8	0	0
1	119584949	rs33960696	G	A	10	13	23	0	0	23	0	0
1	119683063	rs3934789	G	A	6	2	8	0	0	8	0	0
1	119683390	rs12096448	G	A	10	1	11	0	0	11	0	0
1	120254545	rs562038	G	C	7	12	19	0	0	19	0	0
1	120533042	.	C	T	2	10	12	0	0	12	0	0
1	120533209	.	A	G	0	17	17	0	0	17	0	0
1	120533263	.	G	C	25	1	26	0	0	26	0	0
1	120533276	.	C	T	27	1	28	0	0	28	0	0
1	120533409	.	G	A	0	9	9	0	0	9	0	0
1	120533453	.	G	A	14	0	14	0	0	14	0	0
1	120536913	.	G	C	3	23	26	0	0	26	0	0
1	120537142	.	C	G	2	8	10	0	0	10	0	0
1	120538966	.	G	A	9	1	10	0	0	10	0	0
1	120539331	.	C	T	0	7	7	0	0	7	0	0
1	120572547	.	T	C	32	5	37	0	1	38	0	0
1	120572572	.	C	T	38	6	44	0	1	45	0	0
1	120594223	.	T	C	66	26	92	0	0	92	0	0
1	120596307	.	A	G	9	1	10	0	0	10	0	0
1	120596847	.	C	T	4	3	7	0	0	7	0	0
1	120598489	.	G	A	12	2	14	0	0	14	0	0
1	120604299	.	T	G	7	6	13	0	0	13	0	0
1	120605106	.	C	A	2	4	6	0	0	6	0	0
1	120607162	.	T	C	5	1	6	0	0	6	0	0
1	120611964	.	G	C	35	9	44	0	0	44	0	0
1	120612006	rs4021006	G	A	39	6	45	0	0	45	0	0
1	120612168	.	C	T	158	10	168	0	0	168	0	0
1	120695720	.	T	C	6	0	6	0	0	6	0	0
1	120836371	.	C	T	9	0	9	0	0	9	0	0
1	120838232	.	T	C	9	1	10	0	1	11	0	0
1	121112178	.	C	G	1	5	6	0	0	6	0	0
1	121116688	.	A	G	20	7	27	0	0	27	0	0
1	121118830	.	G	A	2	6	8	0	0	8	0	0
1	121121451	.	A	G	12	1	13	0	0	13	0	0
1	121123347	.	C	T	7	3	10	0	1	11	0	0
1	121124362	.	C	G	4	7	11	0	0	11	0	0
1	121132722	rs1137590	T	A	13	5	18	0	0	18	0	0
1	121132825	.	T	C	13	3	16	0	0	16	0	0
1	121132854	.	G	A	5	1	6	0	0	6	0	0
1	121132994	rs11249358	T	C	17	2	19	0	2	21	0	0
1	121133066	.	A	G	19	10	29	0	0	29	0	0
1	121133376	.	A	T	34	12	46	0	0	46	0	0
1	121133392	.	T	C	32	13	45	0	0	45	0	0
1	121133574	.	T	C	18	12	30	0	1	31	0	0
1	121133733	.	G	A	40	15	55	0	1	56	0	0
1	121133779	.	C	G	30	11	41	0	1	42	0	0
1	121134049	.	T	C	26	3	29	0	0	29	0	0
1	121320311	.	C	T	3	3	6	0	0	6	0	0
1	121321810	rs28495740	G	A	5	4	9	0	0	9	0	0
1	121321866	rs61805513	A	G	3	3	6	0	0	6	0	0
1	121321948	rs28366816	A	C	2	4	6	0	0	6	0	0
1	143162167	.	G	C	7	0	7	0	0	7	0	0
1	143162257	rs4094758	A	G	7	0	7	0	0	7	0	0
1	143743625	.	C	A	7	1	8	0	0	8	0	0
1	143743783	.	G	C	31	1	32	0	0	32	0	0
1	143744411	.	G	C	12	19	31	0	2	33	0	0
1	143744564	.	T	C	11	7	18	0	0	18	0	0
1	143745242	.	C	T	1	5	6	0	0	6	0	0
1	143984543	.	C	T	7	15	22	0	0	22	0	0
1	143985102	rs715466	T	C	3	11	14	0	0	14	0	0
1	144014051	.	G	A	90	51	141	0	1	142	0	0
1	144014068	.	T	C	26	116	142	0	0	142	0	0
1	144014234	.	A	G	17	8	25	0	0	25	0	0
1	144014253	.	A	T	5	21	26	0	0	26	0	0
1	144014345	.	C	T	16	11	27	0	0	27	0	0
1	144014526	.	T	A	11	1	12	0	0	12	0	0
1	144014528	.	T	A	11	1	12	0	0	12	0	0
1	144014530	rs76791488	T	A	11	1	12	0	0	12	0	0
1	144014532	rs77705691	T	A	10	2	12	0	0	12	0	0
1	144014672	.	T	C	12	6	18	0	0	18	0	0
1	144014737	.	G	A	12	7	19	0	0	19	0	0
1	144015041	.	G	T	19	8	27	0	0	27	0	0
1	144015141	rs56064064	C	G	7	2	9	0	1	10	0	0
1	144015174	rs6688767	G	A	9	2	11	0	0	11	0	0
1	144015180	.	T	C	8	2	10	0	1	11	0	0
1	144015222	.	G	A	7	8	15	0	0	15	0	0
1	144015565	.	G	T	2	14	16	0	0	16	0	0
1	144015573	.	G	C	7	10	17	0	0	17	0	0
1	144015730	.	T	A	10	16	26	0	1	27	0	0
1	144015863	rs1476380	A	G	8	14	22	0	0	22	0	0
1	144015980	.	A	G	8	23	31	0	0	31	0	0
1	144016042	.	T	C	8	31	39	0	0	39	0	0
1	144016222	.	T	A	19	12	31	0	0	31	0	0
1	144016245	.	A	G	13	12	25	0	1	26	0	0
1	144016280	.	T	G	4	8	12	0	0	12	0	0
1	144481235	.	A	G	16	16	32	0	0	32	0	0
1	144534092	.	G	A	7	4	11	0	0	11	0	0
1	144534096	.	T	C	7	4	11	0	0	11	0	0
1	144593886	rs71527377	G	A	9	3	12	0	0	12	0	0
1	144594483	rs10907358	A	G	2	4	6	0	0	6	0	0
1	144594764	rs554578	G	A	5	1	6	0	0	6	0	0
1	144594789	.	C	T	6	1	7	0	0	7	0	0
1	144596438	.	T	C	16	9	25	0	0	25	0	0
1	144596488	.	C	G	3	4	7	0	0	7	0	0
1	144596563	.	G	A	3	4	7	0	0	7	0	0
1	144598755	rs2660554;rs75487090	G	A	39	30	69	0	0	69	0	0
1	144614842	rs9441130	C	G	34	7	41	0	0	41	0	0
1	144614931	.	G	A	37	9	46	0	0	46	0	0
1	144615080	rs3896864	A	G	37	0	37	0	0	37	0	0
1	144618144	rs28691033	A	G	6	59	65	0	1	66	0	0
1	144619903	.	T	A	55	0	55	0	0	55	0	0
1	144620091	rs61810898	C	T	14	0	14	0	0	14	0	0
1	144621642	rs11485968	A	G	63	0	63	0	0	63	0	0
1	144621643	rs11488527	G	A	63	0	63	0	1	64	0	0
1	144828764	.	G	T	44	120	164	0	0	164	0	0
1	144828765	rs1043478	A	T	43	120	163	0	0	163	0	0
1	144828784	.	A	G	40	170	210	0	2	212	0	0
1	144828910	.	A	T	20	107	127	0	0	127	0	0
1	144851537	rs10943	A	G	1	9	10	0	0	10	0	0
1	144851848	.	G	A	2	16	18	0	0	18	0	0
1	144851903	.	G	A	4	13	17	0	0	17	0	0
1	144851999	.	A	C	4	11	15	0	0	15	0	0
1	144852080	.	T	C	2	11	13	0	0	13	0	0
1	144852167	.	G	T	2	4	6	0	0	6	0	0
1	144852235	rs75842891	T	C	4	3	7	0	0	7	0	0
1	144852236	rs78034674	C	G	4	3	7	0	0	7	0	0
1	144852249	.	C	T	5	4	9	0	0	9	0	0
1	144852321	.	C	A	6	10	16	0	0	16	0	0
1	144852379	.	G	T	7	5	12	0	0	12	0	0
1	144852390	.	C	T	4	6	10	0	0	10	0	0
1	144852476	rs1616066	T	C	2	14	16	0	0	16	0	0
1	144854180	.	T	C	19	0	19	0	0	19	0	0
1	144854528	.	A	G	9	0	9	0	0	9	0	0
1	144854537	.	T	C	7	0	7	0	1	8	0	0
1	144854581	.	T	C	9	0	9	0	0	9	0	0
1	144854597	rs3851873	T	C	1	6	7	0	0	7	0	0
1	144854598	.	C	T	1	6	7	0	0	7	0	0
1	144855812	.	T	C	4	11	15	0	0	15	0	0
1	144855866	.	A	G	2	7	9	0	0	9	0	0
1	144865850	.	G	T	2	13	15	0	0	15	0	0
1	144866643	.	G	A	1	10	11	0	0	11	0	0
1	144866662	.	T	C	1	12	13	0	0	13	0	0
1	144868170	.	C	T	0	11	11	0	0	11	0	0
1	144873887	.	C	T	0	13	13	0	0	13	0	0
1	144874760	.	T	C	1	7	8	0	0	8	0	0
1	144874815	.	T	C	4	2	6	0	0	6	0	0
1	144877176	.	C	T	0	7	7	0	0	7	0	0
1	144879264	rs2798901	A	G	2	7	9	0	0	9	0	0
1	144879375	.	T	C	2	7	9	0	0	9	0	0
1	144881840	.	A	G	0	8	8	0	0	8	0	0
1	144882009	.	C	A	1	5	6	0	0	6	0	0
1	144886197	.	A	T	1	6	7	0	0	7	0	0
1	144890833	.	T	C	2	10	12	0	0	12	0	0
1	144891582	.	G	T	3	10	13	0	0	13	0	0
1	144891803	.	G	A	5	1	6	0	0	6	0	0
1	144892089	.	G	T	3	3	6	0	0	6	0	0
1	144892149	.	G	A	6	5	11	0	0	11	0	0
1	144906508	rs34169189	C	T	34	11	45	0	0	45	0	0
1	144912233	.	C	T	43	8	51	0	0	51	0	0
1	144915561	.	G	A	39	13	52	0	2	54	0	0
1	144915624	rs1778112	G	A	28	10	38	0	0	38	0	0
1	144916748	.	C	G	27	5	32	0	0	32	0	0
1	144917546	.	A	G	34	6	40	0	0	40	0	0
1	144917841	.	T	C	29	3	32	0	0	32	0	0
1	144918957	.	T	A	28	3	31	0	1	32	0	0
1	144922583	.	G	A	23	7	30	0	0	30	0	0
1	144925977	.	G	A	12	1	13	0	0	13	0	0
1	144926116	.	G	A	12	2	14	0	0	14	0	0
1	144927910	.	A	G	13	3	16	0	0	16	0	0
1	144928731	.	G	A	8	2	10	0	0	10	0	0
1	144928976	.	C	T	15	0	15	0	0	15	0	0
1	144929053	.	T	C	11	0	11	0	0	11	0	0
1	144929250	.	G	A	7	0	7	0	0	7	0	0
1	144929611	.	T	C	9	3	12	0	0	12	0	0
1	144929930	.	T	C	3	4	7	0	0	7	0	0
1	144930441	.	G	T	6	1	7	0	0	7	0	0
1	144930571	.	C	A	9	2	11	0	0	11	0	0
1	144930596	.	C	A	30	6	36	0	0	36	0	0
1	144930940	.	T	C	37	7	44	0	0	44	0	0
1	144931087	.	T	C	30	5	35	0	0	35	0	0
1	144931330	.	C	T	25	15	40	0	0	40	0	0
1	144931392	.	G	A	18	9	27	0	0	27	0	0
1	144931461	.	A	T	23	4	27	0	0	27	0	0
1	144932086	rs1324349	G	C	10	1	11	0	0	11	0	0
1	144932151	.	G	T	10	0	10	0	0	10	0	0
1	144952220	.	C	T	7	1	8	0	0	8	0	0
1	144982598	.	A	G	12	0	12	0	1	13	0	0
1	144982610	.	G	A	14	0	14	0	0	14	0	0
1	145014053	.	T	C	80	20	100	0	1	101	0	0
1	145014715	.	A	C	9	2	11	0	1	12	0	0
1	145014718	rs1611951	A	G	8	3	11	0	0	11	0	0
1	145015442	.	C	A	13	2	15	0	0	15	0	0
1	145016535	.	C	T	17	1	18	0	1	19	0	0
1	145016747	.	C	G	13	1	14	0	1	15	0	0
1	145016770	.	C	A	13	1	14	0	0	14	0	0
1	145016824	.	C	T	11	2	13	0	0	13	0	0
1	145016914	.	A	C	7	2	9	0	0	9	0	0
1	145017182	.	C	G	19	1	20	0	0	20	0	0
1	145017187	.	C	A	18	2	20	0	1	21	0	0
1	145017347	rs2252126	G	A	13	4	17	0	0	17	0	0
1	145017409	.	G	T	13	3	16	0	0	16	0	0
1	145017723	.	T	G	6	1	7	0	0	7	0	0
1	145018490	rs12119644	G	A	6	0	6	0	1	7	0	0
1	145018788	.	T	C	9	1	10	0	0	10	0	0
1	145018870	rs3099817	G	A	8	1	9	0	0	9	0	0
1	145019586	.	A	C	7	0	7	0	0	7	0	0
1	145020000	.	T	C	6	0	6	0	0	6	0	0
1	145020936	.	A	G	11	3	14	0	0	14	0	0
1	145025116	.	C	T	6	0	6	0	0	6	0	0
1	145027338	.	G	A	6	2	8	0	1	9	0	0
1	145027419	.	C	G	1	5	6	0	0	6	0	0
1	145028149	.	G	A	11	0	11	0	0	11	0	0
1	145028541	.	G	T	13	1	14	0	0	14	0	0
1	145028840	.	T	C	7	2	9	0	0	9	0	0
1	145029933	.	C	T	6	0	6	0	0	6	0	0
1	145030196	.	T	C	7	0	7	0	0	7	0	0
1	145030209	rs2477089	A	G	1	7	8	0	0	8	0	0
1	145030435	.	A	G	6	2	8	0	0	8	0	0
1	145030473	.	G	T	4	2	6	0	0	6	0	0
1	145031266	rs1778679	A	C	4	2	6	0	1	7	0	0
1	145031524	.	C	T	5	1	6	0	0	6	0	0
1	145032069	rs1778674	T	C	11	1	12	0	0	12	0	0
1	145032741	.	A	G	3	6	9	0	0	9	0	0
1	145032781	.	T	C	9	2	11	0	0	11	0	0
1	145032904	.	C	G	5	1	6	0	0	6	0	0
1	145033038	.	G	A	6	0	6	0	0	6	0	0
1	145034263	.	C	A	10	0	10	0	0	10	0	0
1	145035113	.	G	A	8	1	9	0	0	9	0	0
1	145035210	.	C	T	9	1	10	0	0	10	0	0
1	145035327	.	G	T	8	1	9	0	0	9	0	0
1	145035332	.	A	G	6	1	7	0	1	8	0	0
1	145035356	.	G	A	7	2	9	0	0	9	0	0
1	145035890	rs1778664	C	T	5	1	6	0	0	6	0	0
1	145036036	.	T	G	4	2	6	0	0	6	0	0
1	145036058	.	T	A	4	2	6	0	0	6	0	0
1	145036101	.	G	A	5	2	7	0	0	7	0	0
1	145036274	.	A	T	4	2	6	0	0	6	0	0
1	145036346	.	G	T	10	2	12	0	0	12	0	0
1	145036572	.	T	C	6	2	8	0	0	8	0	0
1	145036603	rs2266043	C	T	12	4	16	0	0	16	0	0
1	145036672	.	G	C	10	6	16	0	0	16	0	0
1	145037660	.	C	A	7	1	8	0	0	8	0	0
1	145037735	.	C	T	7	2	9	0	0	9	0	0
1	145037757	.	T	G	7	2	9	0	0	9	0	0
1	145037766	rs2442662	C	T	7	2	9	0	0	9	0	0
1	145037893	.	A	G	11	3	14	0	0	14	0	0
1	145037903	.	G	A	10	3	13	0	0	13	0	0
1	145037984	rs2489136	T	G	10	2	12	0	0	12	0	0
1	145038572	.	G	A	8	1	9	0	0	9	0	0
1	145038736	.	C	G	12	1	13	0	0	13	0	0
1	145038952	rs1663881	C	T	15	1	16	0	0	16	0	0
1	145039562	.	C	T	6	1	7	0	0	7	0	0
1	145039866	.	A	G	70	6	76	0	0	76	0	0
1	145101004	.	C	T	0	8	8	0	0	8	0	0
1	145101750	.	G	A	0	10	10	0	0	10	0	0
1	145101767	.	A	G	0	11	11	0	0	11	0	0
1	145103928	rs2596251	G	A	0	33	33	0	0	33	0	0
1	145103947	.	T	C	0	31	31	0	0	31	0	0
1	145109583	.	C	A	3	37	40	0	0	40	0	0
1	145110257	.	T	C	8	0	8	0	0	8	0	0
1	145110367	.	C	A	0	8	8	0	0	8	0	0
1	145110574	.	G	T	0	12	12	0	0	12	0	0
1	145111366	.	T	A	8	0	8	0	0	8	0	0
1	145111485	.	A	G	0	12	12	0	0	12	0	0
1	145111608	.	A	T	7	0	7	0	0	7	0	0
1	145111637	.	G	A	0	9	9	0	0	9	0	0
1	145111981	.	T	A	7	0	7	0	0	7	0	0
1	145112003	.	G	T	0	7	7	0	0	7	0	0
1	145112072	rs2490185	G	C	0	10	10	0	0	10	0	0
1	145112287	rs2794042	T	C	0	13	13	0	0	13	0	0
1	145113555	.	T	A	0	6	6	0	0	6	0	0
1	145113602	rs2794027	G	C	0	8	8	0	0	8	0	0
1	145114628	.	C	G	0	11	11	0	0	11	0	0
1	145114779	.	G	A	0	7	7	0	0	7	0	0
1	145116027	.	T	C	3	33	36	0	0	36	0	0
1	145116152	rs74909635	C	T	22	0	22	0	0	22	0	0
1	145116411	.	A	C	26	0	26	0	0	26	0	0
1	145116453	.	C	G	27	0	27	0	1	28	0	0
1	145209330	.	G	C	70	30	100	0	1	101	0	0
1	145212100	.	C	A	4	3	7	0	0	7	0	0
1	145213094	.	T	C	4	4	8	0	1	9	0	0
1	145213327	.	G	A	9	3	12	0	0	12	0	0
1	145214786	.	A	G	6	1	7	0	0	7	0	0
1	145220402	.	G	A	9	2	11	0	0	11	0	0
1	145220413	.	G	A	9	2	11	0	1	12	0	0
1	145220545	.	G	A	4	4	8	0	0	8	0	0
1	145220549	.	G	A	4	3	7	0	0	7	0	0
1	145222247	.	G	A	7	1	8	0	0	8	0	0
1	145224448	.	T	G	2	4	6	0	1	7	0	0
1	145224585	.	G	A	10	4	14	0	0	14	0	0
1	145224897	.	C	T	12	0	12	0	0	12	0	0
1	145226481	.	A	G	7	3	10	0	0	10	0	0
1	145226797	.	T	C	31	6	37	0	0	37	0	0
1	145226875	.	G	A	18	5	23	0	0	23	0	0
1	145227257	.	A	G	34	11	45	0	0	45	0	0
1	145227407	.	C	A	4	6	10	0	0	10	0	0
1	145230168	.	A	G	7	0	7	0	0	7	0	0
1	145230356	.	A	C	22	0	22	0	6	28	0	0
1	145230421	.	T	C	9	0	9	0	0	9	0	0
1	145230434	.	T	G	8	0	8	0	0	8	0	0
1	145230516	.	G	A	13	0	13	0	0	13	0	0
1	145248601	.	G	C	7	0	7	0	0	7	0	0
1	145248605	.	C	G	7	0	7	0	0	7	0	0
1	145250794	.	T	C	7	2	9	0	0	9	0	0
1	145251017	.	G	A	11	1	12	0	0	12	0	0
1	145251671	.	A	G	10	0	10	0	0	10	0	0
1	145251715	rs61815741	G	A	6	4	10	0	0	10	0	0
1	145251744	.	C	A	4	4	8	0	0	8	0	0
1	145252138	.	C	T	7	0	7	0	0	7	0	0
1	145282600	.	A	C	26	10	36	0	0	36	0	0
1	145283699	.	G	A	2	5	7	0	0	7	0	0
1	145283718	rs4649855	G	A	3	6	9	0	0	9	0	0
1	145283733	.	A	G	3	5	8	0	0	8	0	0
1	145284175	.	G	C	6	0	6	0	0	6	0	0
1	145284432	.	G	A	5	3	8	0	0	8	0	0
1	145285310	.	C	A	14	0	14	0	0	15	1	0
1	145286272	rs1619746	C	G	6	4	10	0	0	10	0	0
1	145286370	.	T	C	3	5	8	0	0	8	0	0
1	145286910	.	C	T	10	3	13	0	0	13	0	0
1	145287999	.	T	C	5	7	12	0	0	12	0	0
1	145289096	.	T	C	28	34	62	0	0	62	0	0
1	145289385	.	T	C	9	0	9	0	0	9	0	0
1	145289804	.	T	G	19	6	25	0	0	25	0	0
1	145290083	.	T	C	19	9	28	0	1	29	0	0
1	145290250	.	T	C	11	5	16	0	0	16	0	0
1	145290346	.	A	G	14	2	16	0	0	16	0	0
1	145290818	.	C	G	6	1	7	0	0	7	0	0
1	145292442	.	G	T	24	10	34	0	0	34	0	0
1	145292721	.	G	A	28	5	33	0	0	33	0	0
1	145296372	.	A	G	14	8	22	0	0	22	0	0
1	145296478	.	G	T	13	13	26	0	1	27	0	0
1	145298186	.	C	G	23	4	27	0	0	27	0	0
1	145301793	.	A	G	22	2	24	0	0	24	0	0
1	145301802	.	C	G	20	5	25	0	0	25	0	0
1	145302704	rs3926769	A	G	24	2	26	0	0	26	0	0
1	145303971	rs10910794	A	G	15	4	19	0	0	19	0	0
1	145312716	rs200946158	C	A	4	2	6	0	0	6	0	0
1	145349584	.	T	A	10	0	10	0	0	10	0	0
1	145352489	.	T	C	7	1	8	0	1	9	0	0
1	145366857	.	G	T	58	4	62	0	0	62	0	0
1	145367863	.	A	T	61	38	99	0	0	99	0	0
1	145368837	.	C	A	205	311	516	0	1	517	0	0
1	145369322	.	A	T	92	109	201	0	1	202	0	0
1	145369339	rs199531492	A	G	86	98	184	0	0	184	0	0
1	145369340	rs199803686	A	T	86	98	184	0	0	184	0	0
1	145369354	.	C	T	91	88	179	0	0	179	0	0
1	145438581	rs9245	C	A	651	645	1296	0	5	1301	0	0
1	145441620	rs7211	T	C	2399	2163	4562	0	19	4582	1	0
1	145442254	rs7212	G	C	3022	2766	5788	0	20	5809	1	0
1	145442264	rs4755	T	A	3019	2772	5791	0	19	5813	3	0
1	145510376	rs1058534	A	G	17	28	45	0	0	45	0	0
1	145511798	rs201225488	T	G	11	4	15	0	0	15	0	0
1	145588536	rs9286836	C	T	3	3	6	0	0	6	0	0
1	145595423	rs913513	G	A	4	2	6	0	0	6	0	0
1	145597417	rs9728345	C	A	7	3	10	0	0	10	0	0
1	145662666	rs2318299	T	C	3	3	6	0	0	6	0	0
1	145689271	rs17354678	A	G	17	19	36	0	0	36	0	0
1	145690472	rs12123298	C	T	66	57	123	0	1	124	0	0
1	145691349	rs1284306	C	T	8	4	12	0	0	12	0	0
1	145693383	rs17352469	A	G	5	5	10	0	0	10	0	0
1	146215189	.	G	C	17	63	80	0	0	80	0	0
1	146466322	rs1284539	A	G	35	4	39	0	0	39	0	0
1	146684095	rs58351438	T	C	10	12	22	0	0	22	0	0
1	146736137	rs36008075	A	G	98	99	197	0	1	198	0	0
1	146745842	rs77028247	C	T	17	21	38	0	0	38	0	0
1	147076702	rs12126758	A	G	19	22	41	0	0	41	0	0
1	147081187	rs613089	G	A	1	6	7	0	0	7	0	0
1	147083114	rs583583	C	T	4	3	7	0	0	7	0	0
1	147096794	rs867270	A	G	29	29	58	0	1	59	0	0
1	147097635	rs3766512	C	T	48	15	63	0	0	63	0	0
1	147124310	.	T	G	5	17	22	0	0	22	0	0
1	147142296	rs2883202	T	C	4	10	14	0	1	15	0	0
1	147994268	rs2743793	T	C	15	1	16	0	0	16	0	0
1	148004232	.	G	A	30	33	63	0	1	64	0	0
1	148004440	rs61810197	C	A	77	21	98	0	0	98	0	0
1	148005064	.	C	A	6	0	6	0	0	6	0	0
1	148010911	.	G	A	90	22	112	0	1	113	0	0
1	148012902	.	C	G	4	6	10	0	0	10	0	0
1	148017578	rs61810777	C	T	33	1	34	0	0	34	0	0
1	148342488	.	T	C	3	9	12	0	1	13	0	0
1	148556676	.	C	G	0	17	17	0	0	17	0	0
1	148556752	.	A	C	2	21	23	0	0	23	0	0
1	148756432	.	C	A	8	0	8	0	0	8	0	0
1	148756448	rs201036679	G	A	1	8	9	0	0	9	0	0
1	149290301	rs828283	T	C	0	7	7	0	0	7	0	0
1	149291675	.	C	A	0	11	11	0	0	11	0	0
1	149778885	rs60450929	C	A	7	6	13	0	0	13	0	0
1	149783063	rs7553723	G	C	18	20	38	0	1	39	0	0
1	149818561	rs67567469	G	A	3	3	6	0	1	7	0	0
1	150199123	rs7522034	G	T	70	79	149	0	1	150	0	0
1	150234282	rs3850839	T	G	4	2	6	0	0	6	0	0
1	150241230	rs2275780	G	T	301	310	611	0	9	620	0	0
1	150266338	rs3818978	T	A	20	21	41	0	3	44	0	0
1	150266559	rs1050818	A	C	54	64	118	0	0	118	0	0
1	150280801	rs8006	G	C	25	17	42	0	0	42	0	0
1	150281343	rs71622690	C	T	0	6	6	0	0	6	0	0
1	150299145	rs698913	G	A	4	4	8	0	0	8	0	0
1	150308032	rs112385890	G	A	4	2	6	0	0	6	0	0
1	150308136	rs1260409	A	G	8	2	10	0	0	10	0	0
1	150308277	.	G	A	4	3	7	0	0	7	0	0
1	150308309	rs142893220	C	T	3	3	6	0	0	6	0	0
1	150308389	rs59325647	C	T	5	3	8	0	0	8	0	0
1	150311662	rs67733549	G	A	5	3	8	0	0	8	0	0
1	150319884	rs698917	G	A	2	5	7	0	0	7	0	0
1	150319892	rs55973252	T	C	1	5	6	0	0	6	0	0
1	150319901	rs7522820	T	C	2	7	9	0	0	9	0	0
1	150322591	rs2794680	T	C	3	3	6	0	0	6	0	0
1	150323522	rs1776265	T	C	7	4	11	0	0	11	0	0
1	150324284	rs11587682	C	T	3	7	10	0	0	10	0	0
1	150325231	rs41300865	A	G	6	11	17	0	0	17	0	0
1	150337289	rs72696841	G	T	28	23	51	0	0	51	0	0
1	150419865	rs4926435	T	C	3	3	6	0	0	6	0	0
1	150429944	rs41273537	A	G	42	42	84	0	0	84	0	0
1	150447269	rs7411534	G	A	16	10	26	0	0	26	0	0
1	150447633	.	G	A	26	34	60	0	0	60	0	0
1	150448666	rs36020363	C	G	32	30	62	0	1	63	0	0
1	150448707	rs12141218	T	C	28	39	67	0	0	67	0	0
1	150448766	rs1043293	G	C	29	41	70	0	0	70	0	0
1	150460842	rs41264059	A	C	3	4	7	0	0	7	0	0
1	150460850	rs41264139	C	T	2	4	6	0	0	6	0	0
1	150531008	rs10888382	T	C	35	8	43	0	0	43	0	0
1	150779260	.	G	A	24	17	41	0	0	41	0	0
1	151554503	rs1891592	T	C	4	5	9	0	0	9	0	0
1	151555701	rs6587605	C	T	4	5	9	0	0	9	0	0
1	151555741	rs12749	A	G	3	5	8	0	0	8	0	0
1	151668295	rs1308137	A	C	19	11	30	0	1	31	0	0
1	151669442	rs1308139	C	T	11	20	31	0	1	32	0	0
1	151669555	rs3204344	C	A	24	19	43	0	0	43	0	0
1	151669997	rs1048694	C	A	14	11	25	0	0	25	0	0
1	151846719	rs4845385	A	G	9	5	14	0	0	14	0	0
1	151847180	rs10749666	A	G	15	6	21	0	0	21	0	0
1	151867560	rs3762427	G	A	17	11	28	0	0	28	0	0
1	151879799	rs10888451	C	T	3	7	10	0	0	10	0	0
1	151881885	rs3748805	A	C	6	1	7	0	0	7	0	0
1	151958144	rs3791153	A	G	5	8	13	0	0	13	0	0
1	153362788	rs41264638	T	C	3	8	11	0	0	11	0	0
1	153610607	.	T	G	76	75	151	0	3	154	0	0
1	153637404	rs6427671	A	G	25	20	45	0	0	45	0	0
1	153720690	rs6427268	G	A	2	4	6	0	0	6	0	0
1	153745867	.	C	T	53	44	97	0	1	98	0	0
1	153779236	rs1127092	C	T	118	118	236	0	20	256	0	0
1	153782011	rs35036680	C	T	41	52	93	0	3	96	0	0
1	153787279	rs113422987	C	T	9	5	14	0	0	14	0	0
1	153788211	rs72694220	T	C	6	4	10	0	0	10	0	0
1	153788442	rs9427231	T	C	11	7	18	0	0	18	0	0
1	153903883	rs1572788	T	C	6	8	14	0	0	14	0	0
1	153904214	rs11586593	T	C	5	5	10	0	0	10	0	0
1	153904338	rs11264619	G	A	10	6	16	0	0	16	0	0
1	153904574	rs11264620	T	C	6	7	13	0	0	13	0	0
1	153909069	rs1043608	G	C	130	129	259	0	1	260	0	0
1	153912623	rs113191295	G	A	1	15	16	0	0	16	0	0
1	153915881	rs12044455	C	T	1	8	9	0	0	9	0	0
1	153917369	rs6680140	C	T	6	5	11	0	0	11	0	0
1	153920286	rs8450	G	A	195	217	412	0	0	412	0	0
1	153920564	rs10559	A	G	382	317	699	0	2	701	0	0
1	153923276	rs10127983	C	T	22	8	30	0	0	30	0	0
1	153924952	.	G	A	19	24	43	0	0	43	0	0
1	153926078	rs11264680	T	C	148	167	315	0	1	316	0	0
1	153927052	rs10908557	C	G	21	18	39	0	1	40	0	0
1	153927270	rs10908558	T	C	15	13	28	0	1	29	0	0
1	153932212	rs6724	G	C	100	95	195	0	0	195	0	0
1	153934203	rs3791187	T	C	3	3	6	0	0	6	0	0
1	153935543	rs2072704	G	A	6	3	9	0	0	9	0	0
1	153941514	rs11264743	C	T	35	23	58	0	0	58	0	0
1	153948705	rs11264763	C	T	10	5	15	0	0	15	0	0
1	154128672	rs4540651	G	A	5	3	8	0	0	8	0	0
1	154129265	rs1051370	A	G	1182	1283	2465	0	13	2479	1	0
1	154134557	rs3196889	A	C	3	4	7	0	0	7	0	0
1	154141908	rs4845364	A	G	2	4	6	0	0	6	0	0
1	154146095	rs7517127	G	A	6	5	11	0	0	11	0	0
1	154149129	.	G	A	19	9	28	0	1	29	0	0
1	154149240	rs10797047	G	A	34	31	65	0	1	66	0	0
1	154150911	rs12063830	A	G	21	27	48	0	0	48	0	0
1	154153106	rs4579747	A	G	22	15	37	0	0	37	0	0
1	154179679	rs6719	T	C	212	241	453	0	4	457	0	0
1	154186918	rs12408458	G	C	5	3	8	0	0	8	0	0
1	154191791	rs9803857	G	A	3	3	6	0	0	6	0	0
1	154224512	rs1986709	C	T	3	4	7	0	0	7	0	0
1	154227239	.	C	A	5	2	7	0	0	7	0	0
1	154228287	rs1194603	T	C	13	11	24	0	1	25	0	0
1	154233016	rs2220390	G	A	25	17	42	0	1	43	0	0
1	154237638	rs10797067	G	T	6	6	12	0	0	12	0	0
1	154243097	rs2282227	G	A	37	43	80	0	0	80	0	0
1	154243115	rs1044013	C	T	47	47	94	0	0	94	0	0
1	154245142	rs11265425	T	G	14	29	43	0	0	43	0	0
1	154245446	.	C	T	13	9	22	0	0	22	0	0
1	154245512	rs1194593	A	G	8	7	15	0	0	15	0	0
1	154303976	rs6702754	T	C	10	16	26	0	0	26	0	0
1	154317153	rs1194587	C	T	23	21	44	0	1	45	0	0
1	154426970	rs2228145	A	C	32	22	54	0	0	54	0	0
1	154572455	rs11578437	C	T	11	15	26	0	0	26	0	0
1	154917701	rs906594	A	G	3	4	7	0	0	7	0	0
1	154987526	rs11264295	C	T	4	11	15	0	0	15	0	0
1	154988957	rs2242195	A	G	11	6	17	0	0	17	0	0
1	154989595	rs6673081	T	C	14	6	20	0	0	20	0	0
1	154990297	rs2242194	C	G	11	10	21	0	0	21	0	0
1	155033918	rs41264285	C	T	72	63	135	0	0	135	0	0
1	155034632	rs45444697	C	G	4	3	7	0	0	7	0	0
1	155106227	rs4745	A	T	4	6	10	0	0	10	0	0
1	155106550	rs9297	A	G	2	4	6	0	0	6	0	0
1	155652036	rs139006072	T	A	15	12	27	0	1	28	0	0
1	155736168	.	C	A	60	44	104	0	0	104	0	0
1	155868309	.	A	T	27	19	46	0	7	53	0	0
1	156005431	rs10919	C	G	16	9	25	0	0	25	0	0
1	156006013	rs3820592	T	C	36	39	75	0	1	76	0	0
1	156011444	rs2297792	T	C	34	24	58	0	0	58	0	0
1	156107166	rs41310120	A	G	11	30	41	0	0	41	0	0
1	156146218	rs12401573	C	T	228	263	491	0	1	492	0	0
1	156147326	rs7695	T	C	302	355	657	0	0	657	0	0
1	156165290	rs3001790	T	G	5	1	6	0	0	6	0	0
1	156165317	rs2984615	G	C	5	1	6	0	0	6	0	0
1	156165342	rs2842882	T	G	6	1	7	0	0	7	0	0
1	156169610	rs2072499	A	G	7	5	12	0	0	12	0	0
1	156181007	rs2241108	C	G	12	19	31	0	0	31	0	0
1	156181770	rs2853641	A	G	25	29	54	0	0	54	0	0
1	156191149	rs887953	T	C	3	6	9	0	0	9	0	0
1	156192028	rs909269	C	T	5	5	10	0	0	10	0	0
1	156192351	rs2006302	G	T	3	3	6	0	1	7	0	0
1	156202173	rs1052053	A	G	194	182	376	0	0	376	0	0
1	156204653	rs2842873	C	T	3	5	8	0	0	8	0	0
1	156205301	rs2758612	T	C	4	2	6	0	0	6	0	0
1	156205383	rs2736611	A	C	4	2	6	0	0	6	0	0
1	156206121	rs1052067	G	A	217	127	344	0	1	345	0	0
1	156208216	rs2736612	T	C	7	2	9	0	0	9	0	0
1	156213257	rs759330	G	A	3	5	8	0	0	8	0	0
1	156252562	.	G	A	9	12	21	0	0	21	0	0
1	156303074	rs2764403	C	A	0	12	12	0	0	12	0	0
1	156434703	rs1050316	G	T	279	264	543	0	2	545	0	0
1	156439000	rs1109751	T	C	88	51	139	0	1	140	0	0
1	156439267	.	C	A	58	58	116	0	3	119	0	0
1	156442956	rs6700679	C	T	46	57	103	0	1	104	0	0
1	156444934	.	G	A	1122	1172	2294	0	10	2304	0	0
1	156446242	rs2274316	C	A	77	92	169	0	2	171	0	0
1	156446450	rs12131289	C	T	52	50	102	0	5	107	0	0
1	156446903	rs2274317	T	C	1169	1059	2228	0	14	2242	0	0
1	156448209	rs4450010	T	G	23	32	55	0	0	55	0	0
1	156448426	rs6658120	G	C	26	13	39	0	0	39	0	0
1	156450719	rs1185700	G	A	898	819	1717	0	12	1730	1	0
1	156450740	rs1925950	G	A	822	802	1624	0	18	1642	0	0
1	156451264	rs1171557	C	T	8	10	18	0	0	18	0	0
1	156451349	rs3790454	T	G	5	8	13	0	0	13	0	0
1	156452093	rs1171558	G	A	6	7	13	0	0	13	0	0
1	156452870	rs2282286	G	A	20	30	50	0	0	50	0	0
1	156453247	rs2274320	T	A	3	3	6	0	0	6	0	0
1	156453441	rs3818463	C	T	8	4	12	0	0	12	0	0
1	156454395	.	A	T	5	6	11	0	0	11	0	0
1	156455173	rs11264486	G	A	6	3	9	0	0	9	0	0
1	156455898	rs1171561	G	A	3	3	6	0	0	6	0	0
1	156456301	rs3790455	C	T	4	5	9	0	0	9	0	0
1	156456529	rs1171563	T	G	6	8	14	0	0	14	0	0
1	156458840	rs3790457	C	T	6	4	10	0	0	10	0	0
1	156459535	rs12038396	C	T	5	5	10	0	0	10	0	0
1	156459699	rs3790458	A	T	7	4	11	0	0	11	0	0
1	156465029	rs3790460	C	G	2	9	11	0	0	11	0	0
1	156556023	rs11264503	C	T	5	2	7	0	0	7	0	0
1	156564640	rs3795732	G	A	17	30	47	0	1	48	0	0
1	156564922	rs3795733	C	T	25	21	46	0	0	46	0	0
1	156693135	rs1133856	C	T	63	61	124	0	1	125	0	0
1	156698265	rs3806415	C	T	17	13	30	0	0	30	0	0
1	156713558	rs4399146	G	A	735	779	1514	0	4	1518	0	0
1	156718448	rs11264533	G	C	5	2	7	0	0	7	0	0
1	156758337	rs56338469	T	C	5	10	15	0	0	15	0	0
1	156758602	rs111896519	C	T	6	10	16	0	0	16	0	0
1	156758864	rs1758186	C	T	6	10	16	0	0	16	0	0
1	156759585	rs4443882	G	A	9	6	15	0	0	15	0	0
1	156760036	rs6700964	G	C	16	9	25	0	2	27	0	0
1	156764038	rs11264555	T	C	4	3	7	0	0	7	0	0
1	156765973	rs3765783	C	T	2	4	6	0	0	6	0	0
1	156904837	rs139355036	G	T	13	10	23	0	1	24	0	0
1	156907081	rs945508	T	C	9	16	25	0	0	25	0	0
1	156907115	rs868188	T	C	14	15	29	0	0	29	0	0
1	156911718	rs35187704	C	T	8	13	21	0	0	21	0	0
1	157101925	rs2182464	C	G	36	53	89	0	0	89	0	0
1	157102453	rs998842	G	T	12	6	18	0	0	18	0	0
1	158580887	rs3768535	T	C	3	4	7	0	0	7	0	0
1	158592935	rs3753068	G	A	3	5	8	0	0	8	0	0
1	158606449	rs3738791	G	T	3	3	6	0	0	6	0	0
1	158607935	rs857725	T	G	6	3	9	0	0	9	0	0
1	158813819	rs857870	A	G	7	2	9	0	0	9	0	0
1	159842379	rs34241039	A	G	3	4	7	0	0	7	0	0
1	159844058	rs2501329	C	T	5	2	7	0	0	7	0	0
1	159844672	rs74367572	A	C	4	5	9	0	0	9	0	0
1	159844819	rs7521729	C	A	3	4	7	0	0	7	0	0
1	159846091	rs74381625	C	T	1	6	7	0	0	7	0	0
1	159889686	rs2252815	G	A	21	17	38	0	0	38	0	0
1	159890459	rs11265297	T	C	12	20	32	0	2	34	0	0
1	159890969	rs55633025	G	A	19	11	30	0	0	31	1	0
1	159891917	rs6427499	C	T	14	19	33	0	2	35	0	0
1	159892088	rs2789422	G	A	9	13	22	0	0	22	0	0
1	159892780	rs7551141	G	A	13	12	25	0	1	26	0	0
1	160000435	rs12409352	A	T	6	1	7	0	0	7	0	0
1	160324681	rs6700962	G	T	4	4	8	0	0	8	0	0
1	160604473	rs164288	G	A	5	6	11	0	1	12	0	0
1	160605999	rs11580370	G	A	7	9	16	0	0	16	0	0
1	160606092	rs11579060	T	G	8	4	12	0	1	13	0	0
1	160606283	rs79026315	C	T	6	5	11	0	0	11	0	0
1	160607318	.	A	G	3	4	7	0	0	7	0	0
1	160808664	.	G	A	5	1	6	0	0	6	0	0
1	161094834	rs10908823	C	T	8	6	14	0	0	14	0	0
1	161141432	rs6779	C	G	71	57	128	0	1	129	0	0
1	161143312	rs11579514	T	C	5	3	8	0	0	8	0	0
1	161172525	rs10908826	C	T	4	2	6	0	0	6	0	0
1	161179877	rs4656994	G	A	8	13	21	0	0	21	0	0
1	161183516	rs1136207	C	T	221	154	375	0	1	376	0	0
1	161185058	rs2070901	G	T	2	4	6	0	0	6	0	0
1	161187665	rs2070902	C	T	4	3	7	0	0	7	0	0
1	161188936	rs11421	T	C	57	24	81	0	0	81	0	0
1	161479745	rs1801274	A	G	26	24	50	0	1	51	0	0
1	161518336	.	C	T	6	0	6	0	0	6	0	0
1	161721707	rs1063178	C	T	93	88	181	0	1	182	0	0
1	161751741	rs1058405	A	G	49	54	103	0	0	103	0	0
1	161762761	rs4657106	A	T	3	4	7	0	0	7	0	0
1	161768416	.	A	T	5	6	11	0	0	11	0	0
1	161793612	rs11581556	G	A	5	4	9	0	0	9	0	0
1	161833233	rs3767632	G	A	5	7	12	0	0	12	0	0
1	161834580	rs10918092	T	A	18	14	32	0	0	32	0	0
1	161930730	rs2499853	A	G	3	5	8	0	0	8	0	0
1	161930954	rs11579627	G	A	3	4	7	0	0	7	0	0
1	161931260	rs2499851	T	C	6	7	13	0	0	13	0	0
1	161931562	rs3795649	G	A	10	8	18	0	0	18	0	0
1	161932193	rs10737521	C	T	9	6	15	0	0	15	0	0
1	162469091	rs6667797	G	A	5	2	7	0	0	7	0	0
1	162470191	rs2342714	C	T	10	6	16	0	0	16	0	0
1	162470503	rs905718	G	A	27	14	41	0	0	41	0	0
1	162471952	rs4656371	C	G	7	2	9	0	0	9	0	0
1	162471993	rs4657199	T	G	6	1	7	0	0	7	0	0
1	162472466	rs6687743	C	T	4	4	8	0	0	8	0	0
1	162473095	rs10919551	C	T	3	6	9	0	1	10	0	0
1	162493009	rs1062174	C	T	23	13	36	0	0	36	0	0
1	162493123	rs2236581	A	G	43	32	75	0	0	75	0	0
1	162493665	rs9405	T	G	25	32	57	0	0	57	0	0
1	162494683	rs3820486	G	T	43	32	75	0	2	77	0	0
1	162497663	rs4657201	G	A	35	24	59	0	2	61	0	0
1	162498599	rs10737484	T	C	25	25	50	0	1	51	0	0
1	162498946	rs1045901	A	G	94	109	203	0	1	204	0	0
1	162564835	rs12040665	A	G	4	7	11	0	0	11	0	0
1	162565070	rs12040734	A	G	8	6	14	0	0	14	0	0
1	162565221	rs12040754	A	G	8	6	14	0	0	14	0	0
1	162567225	rs16863833	T	C	2	9	11	0	0	11	0	0
1	165604991	rs4147599	T	C	1	8	9	0	0	9	0	0
1	165616588	rs6686643	T	C	5	1	6	0	0	6	0	0
1	165622207	rs2297765	C	T	7	4	11	0	0	11	0	0
1	165622211	rs2297764	G	A	7	4	11	0	0	11	0	0
1	165622662	rs2297763	G	A	3	4	7	0	0	7	0	0
1	165624799	rs8133	G	T	71	29	100	0	0	100	0	0
1	165631506	rs11506	A	G	45	57	102	0	0	102	0	0
1	165634425	rs3820362	C	G	8	9	17	0	0	17	0	0
1	165635944	rs12122497	G	A	7	4	11	0	0	11	0	0
1	165636749	rs2176151	A	G	16	12	28	0	0	28	0	0
1	165637442	rs2348727	C	T	21	30	51	0	0	51	0	0
1	165637541	rs2348728	T	C	15	32	47	0	2	49	0	0
1	165637619	rs2348729	T	C	17	26	43	0	0	43	0	0
1	165639490	rs12123278	T	C	8	8	16	0	0	16	0	0
1	165648709	rs1143661	C	T	80	95	175	0	3	178	0	0
1	165648886	rs4646896	G	A	1	5	6	0	0	6	0	0
1	165648894	rs4646895	C	G	1	5	6	0	0	6	0	0
1	165650616	rs4578194	C	T	6	0	6	0	0	6	0	0
1	165652273	rs1143659	A	G	73	66	139	0	0	139	0	0
1	165862264	rs3790654	C	T	1	5	6	0	0	6	0	0
1	165862323	rs3790655	T	A	7	0	7	0	0	7	0	0
1	165865694	rs2241965	G	A	3	3	6	0	1	7	0	0
1	165869367	rs4656466	T	C	4	3	7	0	0	7	0	0
1	165879622	rs6426943	A	C	25	24	49	0	0	49	0	0
1	166818566	rs2075946	A	G	32	26	58	0	0	58	0	0
1	166819115	.	T	C	43	33	76	0	1	77	0	0
1	166820186	rs12062326	G	A	7	7	14	0	0	14	0	0
1	166820284	rs3820387	A	T	9	12	21	0	0	21	0	0
1	166822183	rs10918585	G	A	28	39	67	0	1	68	0	0
1	166822566	rs2232526	A	G	21	6	27	0	1	28	0	0
1	166827094	.	G	T	4	3	7	0	0	7	0	0
1	166828464	rs4657608	C	T	5	2	7	0	0	7	0	0
1	166828957	rs12562794	A	G	9	7	16	0	0	16	0	0
1	166838075	rs7532247	C	G	3	4	7	0	0	7	0	0
1	166882737	rs1053407	C	T	2	6	8	0	0	8	0	0
1	167022445	rs41270686	G	T	83	75	158	0	2	160	0	0
1	167022701	rs3753914	A	G	64	61	125	0	2	127	0	0
1	167022839	.	G	A	52	58	110	0	1	111	0	0
1	167022920	rs12076250	C	G	58	64	122	0	3	125	0	0
1	167023426	rs3820388	C	T	40	41	81	0	0	81	0	0
1	167389619	rs4657657	G	T	9	2	11	0	0	11	0	0
1	167389761	rs2902147	G	T	8	5	13	0	0	13	0	0
1	167389821	rs1773541	A	G	5	6	11	0	1	12	0	0
1	167391498	rs2949663	G	A	15	14	29	0	0	29	0	0
1	167392702	rs2949666	A	G	11	10	21	0	2	23	0	0
1	167393128	rs4233416	T	C	19	21	40	0	0	40	0	0
1	167393635	rs885458	G	A	26	18	44	0	0	44	0	0
1	167510837	rs2860662	T	C	475	635	1110	0	6	1116	0	0
1	167510996	rs2143300	G	A	649	690	1339	0	5	1344	0	0
1	167512580	rs4657667	G	T	5	17	22	0	0	22	0	0
1	167513418	rs1229430	C	T	6	20	26	0	0	26	0	0
1	167514705	rs4657668	G	A	4	15	19	0	0	19	0	0
1	167515797	rs7516079	T	C	3	8	11	0	0	11	0	0
1	167516862	rs2076464	G	C	5	7	12	0	0	12	0	0
1	167601884	rs1311451	A	C	4	3	7	0	0	7	0	0
1	167602641	rs1229396	G	A	1	18	19	0	0	19	0	0
1	167609013	rs12023442	G	A	5	3	8	0	0	8	0	0
1	167609027	rs12023444	G	A	5	3	8	0	0	8	0	0
1	167611370	rs4656547	A	C	86	68	154	0	1	155	0	0
1	167611826	rs3738226	T	C	72	91	163	0	1	164	0	0
1	167611909	rs3738227	C	T	72	83	155	0	5	160	0	0
1	167611952	rs1229384	T	G	98	70	168	0	0	168	0	0
1	167612162	rs72695395	C	T	90	94	184	0	0	184	0	0
1	167670439	rs4656550	C	T	4	2	6	0	0	6	0	0
1	167670467	rs4657696	C	T	4	2	6	0	0	6	0	0
1	167671442	rs7541226	G	A	3	4	7	0	0	7	0	0
1	167671456	rs12744727	G	A	3	4	7	0	0	7	0	0
1	167672809	rs1890129	C	T	2	4	6	0	0	6	0	0
1	167672969	rs1890130	A	G	4	3	7	0	0	7	0	0
1	167674303	rs4656551	T	C	121	0	121	0	0	121	0	0
1	167674653	rs2297777	C	G	172	160	332	0	3	335	0	0
1	167758262	rs720612	C	T	32	18	50	0	0	50	0	0
1	167758651	rs10125	C	T	51	38	89	0	0	89	0	0
1	167758998	rs12745388	C	G	47	44	91	0	1	92	0	0
1	167759281	rs7605	T	C	53	35	88	0	1	89	0	0
1	167759419	rs11807657	C	G	59	57	116	0	2	118	0	0
1	167759573	rs14212	T	C	75	73	148	0	0	148	0	0
1	168148829	rs10918838	G	A	44	27	71	0	0	71	0	0
1	168148971	rs11801584	G	T	2	4	6	0	0	6	0	0
1	168149004	rs11801585	G	T	1	6	7	0	0	7	0	0
1	168149572	rs4657742	A	G	4	4	8	0	0	8	0	0
1	168153090	rs2038035	A	T	8	4	12	0	0	12	0	0
1	168168750	rs2072778	A	G	2	5	7	0	0	7	0	0
1	168168773	rs2072777	G	A	1	6	7	0	0	7	0	0
1	168169452	rs2072776	G	A	3	3	6	0	0	6	0	0
1	168202544	rs2235179	T	A	8	10	18	0	0	18	0	0
1	168202963	rs2235178	T	C	4	8	12	0	0	12	0	0
1	168207297	rs6664426	T	C	6	7	13	0	1	14	0	0
1	168208308	rs12142742	T	C	9	12	21	0	0	21	0	0
1	168212234	rs2280989	G	A	75	73	148	0	0	148	0	0
1	168212709	rs2280988	A	G	39	40	79	0	0	79	0	0
1	168215499	rs2205699	C	A	12	7	19	0	0	19	0	0
1	168215505	rs2205698	A	G	13	6	19	0	0	19	0	0
1	168215575	rs2205697	G	A	24	25	49	0	0	49	0	0
1	168218504	rs11799946	T	C	39	63	102	0	1	103	0	0
1	168220052	rs11800493	A	G	122	120	242	0	2	244	0	0
1	168221225	rs12608	A	C	137	198	335	0	1	336	0	0
1	168221986	rs906	G	T	87	149	236	0	0	236	0	0
1	168545864	rs116453184	A	G	7	8	15	0	0	15	0	0
1	169293721	rs1140523	G	A	6	2	8	0	0	8	0	0
1	169349823	rs113548186	G	A	19	20	39	0	0	39	0	0
1	169350309	rs10429893	G	A	6	5	11	0	0	11	0	0
1	169350726	rs6669901	T	C	3	3	6	0	0	6	0	0
1	169356833	rs6427185	G	T	24	14	38	0	1	39	0	0
1	169436603	rs6692649	C	G	1	9	10	0	0	10	0	0
1	169436678	rs3862937	G	A	6	1	7	0	1	8	0	0
1	169436830	rs1883167	A	G	4	4	8	0	0	8	0	0
1	169441299	rs12733037	A	T	2	4	6	0	0	6	0	0
1	169442211	rs6656463	T	C	4	2	6	0	0	6	0	0
1	169446561	rs137970656	C	T	17	14	31	0	1	32	0	0
1	169660002	rs7553	G	T	234	228	462	0	3	465	0	0
1	169762807	rs10489177	T	G	4	5	9	0	0	9	0	0
1	169819605	rs6664099	A	G	3	3	6	0	0	6	0	0
1	169819892	rs7519364	A	G	5	4	9	0	0	9	0	0
1	169823718	rs4656197	T	C	14	15	29	0	0	29	0	0
1	169840546	rs6658548	C	T	4	2	6	0	0	6	0	0
1	169842292	rs10737551	A	G	4	4	8	0	0	8	0	0
1	169951997	rs33943686	C	T	6	4	10	0	0	10	0	0
1	170503928	rs56066714	G	A	4	2	6	0	0	6	0	0
1	170504019	rs2183372	G	A	3	3	6	0	0	6	0	0
1	170521376	rs913257	G	A	15	12	27	0	0	27	0	0
1	171461787	rs10753119	G	A	6	3	9	0	0	9	0	0
1	171462571	rs138034920	G	A	4	7	11	0	0	11	0	0
1	171463431	rs4916389	G	A	1	6	7	0	0	7	0	0
1	171498429	rs760643	T	C	4	2	6	0	0	6	0	0
1	171503013	rs7535044	G	A	26	26	52	0	0	52	0	0
1	171503935	rs968156	G	A	10	6	16	0	0	16	0	0
1	171503936	rs958021	C	T	9	6	15	0	0	15	0	0
1	171509327	rs760644	G	A	261	197	458	0	1	459	0	0
1	171511039	rs1687064	C	G	380	237	617	0	3	620	0	0
1	171511442	rs2272810	A	G	2	5	7	0	0	7	0	0
1	171513475	rs235465	C	T	5	5	10	0	0	10	0	0
1	171513542	rs235466	T	C	3	4	7	0	0	7	0	0
1	171514731	rs235468	C	G	314	279	593	0	31	624	0	0
1	171516784	.	T	G	61	14	75	0	9	84	0	0
1	171516785	.	G	T	38	34	72	0	11	83	0	0
1	171518366	rs170969	A	G	7	3	10	0	0	10	0	0
1	171518409	rs235469	G	C	11	9	20	0	0	20	0	0
1	171519487	rs235470	A	C	1	5	6	0	0	6	0	0
1	171520223	rs577787037	G	A	7	5	12	0	0	12	0	0
1	171520289	rs235473	G	A	5	5	10	0	0	10	0	0
1	171520726	rs235474	C	G	7	2	9	0	0	9	0	0
1	171521079	rs143707130	T	C	2	4	6	0	0	6	0	0
1	171521201	rs170970	G	A	6	5	11	0	0	11	0	0
1	171521245	rs235475	C	T	5	3	8	0	0	8	0	0
1	171521595	rs235476	A	C	5	11	16	0	0	16	0	0
1	171522398	rs142514864	G	A	4	8	12	0	0	12	0	0
1	171522399	rs144858279	T	A	4	8	12	0	0	12	0	0
1	171522408	rs190092769	G	C	5	9	14	0	0	14	0	0
1	171522409	rs183823549	T	C	5	9	14	0	0	14	0	0
1	171522410	rs188366607	G	A	6	9	15	0	0	15	0	0
1	171522459	rs235478	A	T	4	4	8	0	0	8	0	0
1	171524024	rs235479	G	A	12	8	20	0	1	21	0	0
1	171525064	rs235480	G	T	9	9	18	0	0	18	0	0
1	171525260	rs235481	C	T	9	12	21	0	0	21	0	0
1	171526570	rs1687057	G	A	459	362	821	0	7	828	0	0
1	171526910	rs12025905	G	A	405	320	725	0	13	738	0	0
1	171527322	rs235482	A	G	264	189	453	0	1	454	0	0
1	171527525	rs235483	T	A	53	55	108	0	2	110	0	0
1	171556165	rs235501	G	C	90	95	185	0	2	187	0	0
1	171558516	rs235503	C	T	5	1	6	0	0	6	0	0
1	171561225	rs235907	C	T	34	48	82	0	0	82	0	0
1	171561250	rs235908	G	A	24	27	51	0	0	51	0	0
1	171561307	rs13722	A	G	27	44	71	0	0	71	0	0
1	172363488	rs1052256	A	G	9	8	17	0	0	17	0	0
1	172363524	rs10752944	C	T	9	11	20	0	0	20	0	0
1	172363526	rs1132148	A	G	11	9	20	0	0	20	0	0
1	172410967	rs1063412	G	A	72	77	149	0	0	149	0	0
1	172411496	rs2230471	A	G	51	37	88	0	0	88	0	0
1	172502340	rs2285143	T	C	9	9	18	0	0	18	0	0
1	172502479	rs2285144	T	C	17	26	43	0	1	44	0	0
1	172524788	rs2239817	T	A	5	5	10	0	0	10	0	0
1	172541379	rs145055485	T	C	8	1	9	0	0	9	0	0
1	172547465	rs2285664	A	G	57	41	98	0	0	98	0	0
1	172570550	rs7553020	A	C	16	5	21	0	0	21	0	0
1	172571568	rs3830150	A	G	8	5	13	0	0	13	0	0
1	172573002	rs7514814	A	G	4	5	9	0	0	9	0	0
1	173855208	rs16846520	A	G	6	6	12	0	0	12	0	0
1	174928183	rs75077789	T	C	3	3	6	0	0	6	0	0
1	175126524	rs1057301	T	C	2	4	6	0	0	6	0	0
1	175127534	rs1057246	G	C	3	5	8	0	1	9	0	0
1	175127771	rs2685	C	T	7	12	19	0	1	20	0	0
1	175128536	rs72719370	G	C	2	8	10	0	0	10	0	0
1	175128537	rs67332874	G	A	2	8	10	0	0	10	0	0
1	175128543	rs34270511	C	T	1	8	9	0	0	9	0	0
1	175128726	rs6664840	A	G	3	7	10	0	0	10	0	0
1	175129562	.	T	C	8	6	14	0	0	14	0	0
1	175130204	rs1057239	G	A	9	7	16	0	0	16	0	0
1	175130276	rs1135289	G	A	3	11	14	0	0	14	0	0
1	175161849	rs2272784	G	T	4	4	8	0	1	9	0	0
1	175371253	rs35627767	C	G	24	0	24	0	0	24	0	0
1	178886463	.	T	C	5	10	15	0	0	15	0	0
1	179006462	rs6425513	G	A	5	1	6	0	0	6	0	0
1	179010607	rs11581232	G	A	9	6	15	0	0	15	0	0
1	179041398	rs2025584	A	G	7	6	13	0	0	13	0	0
1	179042227	rs9725887	T	C	18	14	32	0	1	33	0	0
1	179042300	rs4652352	C	A	14	13	27	0	0	27	0	0
1	179042450	rs4652353	T	G	4	7	11	0	0	11	0	0
1	179043539	rs3766626	T	G	22	20	42	0	0	42	0	0
1	179044723	rs16853621	A	G	13	14	27	0	0	27	0	0
1	179050935	rs12124177	C	T	6	1	7	0	0	7	0	0
1	179052006	rs2274227	G	T	15	16	31	0	0	31	0	0
1	179053051	rs4652355	C	G	18	18	36	0	0	36	0	0
1	179053993	rs12116579	C	A	26	24	50	0	0	50	0	0
1	179054692	rs912758	T	G	19	15	34	0	1	35	0	0
1	179057504	rs11589113	G	A	4	2	6	0	0	6	0	0
1	179057824	rs76029399	G	A	7	7	14	0	0	14	0	0
1	179058010	rs16853640	G	A	5	2	7	0	0	7	0	0
1	179058875	rs12121752	C	T	5	5	10	0	0	10	0	0
1	179060617	rs56949555	C	T	4	5	9	0	1	10	0	0
1	179061317	rs73045671	T	C	6	5	11	0	0	11	0	0
1	179061427	rs10798652	C	T	4	3	7	0	0	7	0	0
1	179061862	rs10158768	G	T	6	6	12	0	0	12	0	0
1	179062458	rs67939704	G	C	8	9	17	0	1	18	0	0
1	179062497	rs16853647	A	G	8	5	13	0	0	13	0	0
1	179077613	rs17277288	T	C	12	8	20	0	0	20	0	0
1	179084779	rs28913568	A	G	3	5	8	0	0	8	0	0
1	179315738	rs7518843	C	T	5	11	16	0	0	16	0	0
1	179315898	rs4421551	C	A	7	11	18	0	0	18	0	0
1	179318713	rs12746331	C	T	4	2	6	0	0	6	0	0
1	179325729	rs34315375	A	T	1	6	7	0	0	7	0	0
1	179812163	rs6660030	A	G	17	3	20	0	0	20	0	0
1	179813352	rs2794583	C	T	19	29	48	0	0	48	0	0
1	179813499	rs1281408	G	A	13	23	36	0	1	37	0	0
1	179813564	rs1281409	C	A	12	15	27	0	0	27	0	0
1	179813613	rs1281410	T	C	13	18	31	0	0	31	0	0
1	179814457	rs1281411	A	C	11	15	26	0	1	27	0	0
1	179836320	rs1281419	T	C	12	4	16	0	0	16	0	0
1	179838064	rs2794584	G	A	35	17	52	0	0	52	0	0
1	179839483	rs2762857	A	G	5	2	7	0	0	7	0	0
1	179841487	rs17370666	C	T	9	13	22	0	0	22	0	0
1	179841792	rs651455	T	C	9	6	15	0	1	16	0	0
1	179842107	rs479094	C	T	6	7	13	0	0	13	0	0
1	179843291	rs668813	T	G	11	15	26	0	0	26	0	0
1	179845022	rs589780	G	A	20	16	36	0	0	36	0	0
1	179852074	rs1281378	T	C	87	77	164	0	0	164	0	0
1	179852552	rs605807	T	G	6	8	14	0	0	14	0	0
1	179853096	rs480498	G	C	4	3	7	0	0	7	0	0
1	179876988	rs609521	C	G	138	131	269	0	4	273	0	0
1	179879185	rs600553	C	T	4	4	8	0	0	8	0	0
1	179879604	rs480377	T	A	8	8	16	0	0	16	0	0
1	179882450	rs524166	A	T	3	5	8	0	0	8	0	0
1	179883494	rs555270	G	A	2	5	7	0	0	7	0	0
1	179885433	rs599185	A	G	6	5	11	0	0	11	0	0
1	179885939	rs612215	A	G	4	3	7	0	0	7	0	0
1	179887125	rs627897	G	A	196	209	405	0	1	406	0	0
1	179887681	rs530854	G	C	121	125	246	0	2	248	0	0
1	179887788	rs531814	C	T	121	104	225	0	0	225	0	0
1	179888228	rs549650	G	C	131	118	249	0	0	250	1	0
1	179891092	rs522534	C	T	5	3	8	0	0	8	0	0
1	179938305	rs539324	G	C	2	6	8	0	0	8	0	0
1	179938798	rs2762859	A	G	3	6	9	0	0	9	0	0
1	179979828	rs2477107	T	C	2	5	7	0	0	7	0	0
1	179983665	rs2501607	G	A	28	25	53	0	1	54	0	0
1	179989742	rs2477120	G	C	23	23	46	0	0	46	0	0
1	180010911	rs16855164	A	G	22	39	61	0	0	61	0	0
1	180022343	rs9425854	T	G	3	4	7	0	0	7	0	0
1	180034602	rs6659911	G	A	4	2	6	0	0	6	0	0
1	180037987	rs6692394	A	G	5	6	11	0	0	11	0	0
1	180052017	rs4651055	A	G	5	1	6	0	0	6	0	0
1	180239473	rs357044	C	T	5	6	11	0	1	12	0	0
1	180239535	rs1043744	T	C	4	9	13	0	0	13	0	0
1	180359282	rs12128560	A	C	2	4	6	0	0	6	0	0
1	180380021	rs10913987	T	C	9	0	9	0	0	9	0	0
1	180380205	rs80162449	A	G	1	11	12	0	0	12	0	0
1	180467416	rs74132915	C	T	5	4	9	0	0	9	0	0
1	180470867	rs12121043	T	C	2	4	6	0	0	6	0	0
1	180471054	rs12723183	C	A	4	5	9	0	0	9	0	0
1	180806234	rs76590838	C	T	13	7	20	0	0	20	0	0
1	180854905	rs80034284	G	A	16	12	28	0	0	28	0	0
1	180857232	rs41268446	C	T	3	3	6	0	0	6	0	0
1	180920181	rs3820313	C	T	2	5	7	0	0	7	0	0
1	180943529	rs1044595	C	T	5	4	9	0	0	9	0	0
1	180953853	rs3747957	A	G	16	16	32	0	0	32	0	0
1	181026238	rs4652551	G	A	4	3	7	0	0	7	0	0
1	181026704	rs4652553	C	T	8	5	13	0	0	13	0	0
1	181027841	rs6686208	A	G	2	4	6	0	0	6	0	0
1	181028733	rs10797667	T	C	3	3	6	0	0	6	0	0
1	181030115	rs10158625	C	T	4	6	10	0	0	10	0	0
1	181030499	rs4048650	A	G	4	3	7	0	0	7	0	0
1	181058313	rs3747955	G	A	54	58	112	0	2	114	0	0
1	181058618	rs1416829	C	G	21	6	27	0	0	27	0	0
1	181060791	rs6658698	G	A	3	3	6	0	0	6	0	0
1	182356051	.	A	G	86	67	153	0	0	153	0	0
1	182358944	rs12136955	G	A	39	54	93	0	0	93	0	0
1	182360315	rs12403634	C	T	53	56	109	0	1	110	0	0
1	182568729	rs680431	C	G	18	21	39	0	0	39	0	0
1	182571003	rs610367	C	T	3	3	6	0	1	7	0	0
1	182834764	rs9425563	A	G	7	5	12	0	0	12	0	0
1	183112204	rs17536791	C	T	34	16	50	0	0	50	0	0
1	183113545	.	A	G	8	19	27	0	1	28	0	0
1	183512605	rs193087969	A	T	5	1	6	0	0	6	0	0
1	183516440	rs2702182	G	A	5	8	13	0	0	13	0	0
1	183517971	rs2702180	T	C	3	3	6	0	0	6	0	0
1	183521283	rs699245	C	T	116	125	241	0	4	245	0	0
1	183537474	rs3845462	T	G	5	5	10	0	0	10	0	0
1	183537478	rs3845463	G	T	5	5	10	0	0	10	0	0
1	183537859	rs2236384	G	C	6	3	9	0	0	9	0	0
1	183538025	rs2236385	A	G	4	9	13	0	0	13	0	0
1	183539125	rs3820691	A	G	2	6	8	0	0	8	0	0
1	183539449	rs3843293	G	T	6	10	16	0	1	17	0	0
1	183542387	rs2274064	T	C	121	111	232	0	4	236	0	0
1	183566913	rs41439047	C	T	3	4	7	0	0	7	0	0
1	183567085	rs35682376	G	A	6	2	8	0	0	8	0	0
1	183592570	rs17488675	C	T	0	7	7	0	0	7	0	0
1	183596136	rs11755	A	G	58	77	135	0	0	135	0	0
1	183876182	rs11591089	C	T	5	1	6	0	0	6	0	0
1	184661642	rs6663178	G	A	1	7	8	0	0	8	0	0
1	184663537	rs9425343	A	C	6	4	10	0	0	10	0	0
1	184663581	rs9425634	T	C	7	5	12	0	0	12	0	0
1	184675814	rs1062994	G	A	10	6	16	0	0	16	0	0
1	184677464	rs3736757	G	A	2	4	6	0	0	6	0	0
1	184702008	rs41264582	G	A	8	3	11	0	0	11	0	0
1	184760433	rs7360	C	T	35	27	62	0	1	63	0	0
1	184761186	rs492126	G	A	30	18	48	0	0	48	0	0
1	184761365	rs682331	A	G	19	28	47	0	0	47	0	0
1	184762603	rs526024	T	A	26	16	42	0	0	42	0	0
1	184763525	rs14426	A	G	28	25	53	0	0	53	0	0
1	184763596	rs14023	C	T	37	34	71	0	1	72	0	0
1	184764067	rs581100	C	G	27	22	49	0	2	51	0	0
1	186286782	rs34585917	A	G	7	4	11	0	0	11	0	0
1	186290333	rs3820182	G	A	10	15	25	0	0	25	0	0
1	186290495	rs10494583	C	G	8	13	21	0	0	21	0	0
1	186290521	rs10494584	C	T	5	11	16	0	0	16	0	0
1	186293757	rs2178214	T	C	1	5	6	0	0	6	0	0
1	186294577	rs10911847	T	C	2	6	8	0	0	8	0	0
1	186310858	.	T	C	0	6	6	0	0	6	0	0
1	186311812	rs3766705	A	C	5	4	9	0	0	9	0	0
1	186311842	rs3766704	G	T	6	4	10	0	0	10	0	0
1	186316488	rs3753565	C	T	57	37	94	0	1	95	0	0
1	186326175	rs6664763	A	C	6	3	9	0	0	9	0	0
1	186326210	rs6689129	C	T	5	4	9	0	0	9	0	0
1	186363119	rs12084264	C	G	35	31	66	0	0	66	0	0
1	186374412	rs12082399	A	G	7	6	13	0	0	13	0	0
1	186374762	rs2383480	G	A	4	3	7	0	0	7	0	0
1	186374985	rs75856021	T	G	5	7	12	0	0	12	0	0
1	186380465	rs7525634	C	A	10	2	12	0	0	12	0	0
1	186381770	rs7339969	G	A	3	3	6	0	0	6	0	0
1	186643058	rs5275	A	G	21	34	55	0	1	56	0	0
1	192133915	rs10921099	T	C	26	24	50	0	0	50	0	0
1	192134053	rs10921100	T	G	36	27	63	0	0	63	0	0
1	192134307	rs12145398	G	A	28	29	57	0	0	57	0	0
1	192547052	rs10921202	G	T	89	28	117	0	1	118	0	0
1	192779227	rs2746073	T	A	30	47	77	0	1	78	0	0
1	192781120	rs139141127	A	G	1278	844	2122	0	15	2137	0	0
1	192781172	rs4606	C	G	685	1052	1737	0	9	1746	0	0
1	193030600	rs7554496	G	A	2	4	6	0	0	6	0	0
1	193037467	rs79647399	G	A	4	3	7	0	0	7	0	0
1	193039381	rs10921307	C	G	3	4	7	0	0	7	0	0
1	193054088	rs72740218	C	T	64	76	140	0	2	142	0	0
1	193054154	rs10921309	G	A	76	48	124	0	1	125	0	0
1	193074511	rs148212596	A	G	3	3	6	0	0	6	0	0
1	193146585	.	G	A	10	11	21	0	0	21	0	0
1	193186626	rs78788098	C	T	4	4	8	0	0	8	0	0
1	193203650	rs7551897	A	G	5	3	8	0	0	8	0	0
1	193210415	rs6667670	G	A	4	3	7	0	0	7	0	0
1	193212375	rs139514876	C	G	2	4	6	0	0	6	0	0
1	197123043	rs1127661	T	C	4	2	6	0	0	6	0	0
1	197127323	.	C	A	3	3	6	0	0	6	0	0
1	197128726	rs12128631	G	A	4	7	11	0	0	11	0	0
1	198288709	rs6679100	A	G	7	6	13	0	0	13	0	0
1	198615005	rs1536316	T	G	5	1	6	0	0	6	0	0
1	198618104	rs35320232	C	A	2	4	6	0	0	6	0	0
1	198618707	rs6686725	G	T	6	4	10	0	0	10	0	0
1	198619888	rs1326272	T	G	3	5	8	0	1	9	0	0
1	198622043	rs16843591	A	G	6	7	13	0	0	13	0	0
1	198622081	rs57114949	A	G	3	6	9	0	0	9	0	0
1	198622082	rs59147127	G	T	3	6	9	0	0	9	0	0
1	198622086	rs34411674	G	A	3	6	9	0	0	9	0	0
1	198632182	rs6692438	C	T	5	4	9	0	0	9	0	0
1	198632356	rs1998843	C	T	4	4	8	0	0	8	0	0
1	198650513	rs1326279	T	A	2	4	6	0	0	6	0	0
1	198683005	rs191851393	T	C	9	12	21	0	0	21	0	0
1	198836079	rs73069276	C	T	3	7	10	0	0	10	0	0
1	198839667	rs1475166	T	C	3	5	8	0	0	8	0	0
1	198840934	rs143031547	G	T	8	13	21	0	0	21	0	0
1	198841559	rs7417080	G	A	2	4	6	0	0	6	0	0
1	198842658	rs10919599	A	T	2	5	7	0	0	7	0	0
1	198865606	rs76046356	T	C	3	4	7	0	0	7	0	0
1	198876258	rs1322916	T	C	7	5	12	0	0	12	0	0
1	198878979	rs12035894	A	C	4	6	10	0	1	11	0	0
1	198879278	rs75568859	G	A	13	10	23	0	0	23	0	0
1	198883179	rs4915326	C	T	5	3	8	0	0	8	0	0
1	198886414	rs10919603	C	T	7	6	13	0	0	13	0	0
1	198886710	rs932688	A	G	3	5	8	0	0	8	0	0
1	198887167	rs1590311	C	T	7	5	12	0	0	12	0	0
1	198889074	rs10489689	T	C	1	7	8	0	0	8	0	0
1	200522269	rs6667775	G	A	4	2	6	0	0	6	0	0
1	200620495	.	G	T	3	4	7	0	0	7	0	0
1	200620516	rs73074945	C	T	3	3	6	0	0	6	0	0
1	200627632	rs3924121	G	T	4	4	8	0	0	8	0	0
1	200635550	rs3795634	T	C	12	18	30	0	0	30	0	0
1	200635560	rs3795633	T	C	11	20	31	0	1	32	0	0
1	200638990	rs12731153	C	T	4	4	8	0	0	8	0	0
1	200939642	rs3208703	C	T	18	23	41	0	0	41	0	0
1	200940180	rs3198583	G	A	12	11	23	0	0	23	0	0
1	200941716	rs3738255	G	A	13	8	21	0	0	21	0	0
1	201104556	rs11540083	C	A	68	53	121	0	0	121	0	0
1	201104589	rs1059625	A	G	59	71	130	0	3	133	0	0
1	201790239	rs2016475	A	G	5	8	13	0	0	13	0	0
1	201790270	rs1022361	A	G	4	13	17	0	0	17	0	0
1	201790826	rs1032524	T	C	24	12	36	0	0	36	0	0
1	201792306	rs10464	T	C	12	28	40	0	0	40	0	0
1	201793440	rs2644128	C	G	8	5	13	0	0	13	0	0
1	201845575	rs8024	C	A	13	13	26	0	0	26	0	0
1	201849926	rs41304257	A	G	6	14	20	0	0	20	0	0
1	201850057	rs1517810	T	C	16	10	26	0	0	26	0	0
1	201851492	rs2644134	A	G	3	3	6	0	0	6	0	0
1	201853165	rs41299585	G	T	4	3	7	0	0	7	0	0
1	201927583	rs2819375	C	T	4	6	10	0	1	11	0	0
1	201931219	rs2819376	C	A	3	14	17	0	0	17	0	0
1	201931388	rs2820308	G	A	5	6	11	0	0	11	0	0
1	201931896	rs2486748	G	A	7	14	21	0	0	21	0	0
1	201938995	rs7513	C	T	84	83	167	0	4	171	0	0
1	201959455	rs16849483	G	T	7	8	15	0	0	15	0	0
1	201959490	rs12734984	C	T	3	5	8	0	0	8	0	0
1	201959738	rs10800805	G	A	7	5	12	0	0	12	0	0
1	201960125	rs6691193	C	A	5	3	8	0	0	8	0	0
1	201965661	rs10920298	A	G	6	3	9	0	0	9	0	0
1	201973565	rs3820439	G	A	81	93	174	0	0	174	0	0
1	201975030	.	C	A	124	109	233	0	0	233	0	0
1	202103802	rs4342901	G	A	19	32	51	0	1	52	0	0
1	202106488	rs66572093	C	G	20	2	22	0	0	22	0	0
1	202106797	rs16849710	A	G	15	13	28	0	0	28	0	0
1	202108428	rs189705150	C	T	16	9	25	0	0	25	0	0
1	202109041	rs12402757	G	T	21	13	34	0	1	35	0	0
1	202111236	rs11583274	A	T	6	4	10	0	0	10	0	0
1	202111237	rs11583275	A	C	6	4	10	0	0	10	0	0
1	202111779	rs4950771	T	G	14	13	27	0	0	27	0	0
1	202111945	rs60471116	C	T	20	13	33	0	0	33	0	0
1	202112285	rs4363479	A	G	19	13	32	0	0	32	0	0
1	202112899	rs3934809	C	A	19	16	35	0	0	35	0	0
1	202116238	rs9077	G	A	121	95	216	0	1	217	0	0
1	202116957	rs4623766	T	A	101	96	197	0	6	203	0	0
1	202119052	rs61250341	C	T	7	12	19	0	0	19	0	0
1	202119205	rs55813259	C	A	11	9	20	0	0	20	0	0
1	202128179	rs10920345	T	C	10	6	16	0	0	16	0	0
1	202554937	rs11589866	T	C	4	7	11	0	0	11	0	0
1	202704060	rs10920467	C	T	14	6	20	0	0	20	0	0
1	202705455	rs1141109	G	C	217	139	356	0	1	357	0	0
1	202715284	rs1141108	G	A	173	121	294	0	0	294	0	0
1	202716131	rs2363965	C	T	14	7	21	0	0	21	0	0
1	202718202	rs1892164	G	A	155	145	300	0	2	302	0	0
1	202720924	rs10800859	T	C	5	3	8	0	0	8	0	0
1	202721848	rs12133311	G	A	6	5	11	0	0	11	0	0
1	202733178	rs61749325	A	G	118	109	227	0	2	229	0	0
1	202733238	rs3196669	C	T	117	114	231	0	0	231	0	0
1	202734258	rs7553366	T	C	20	12	32	0	0	32	0	0
1	202735751	rs12140729	T	C	35	36	71	0	2	73	0	0
1	202736619	rs10800864	C	G	36	50	86	0	1	87	0	0
1	202736626	rs12409769	T	C	39	44	83	0	0	83	0	0
1	202737047	rs9660926	C	T	23	19	42	0	2	44	0	0
1	202737249	rs10920478	C	T	40	63	103	0	0	103	0	0
1	202737866	.	A	G	12	4	16	0	1	17	0	0
1	202738322	rs12022505	A	G	12	11	23	0	0	23	0	0
1	202740428	rs12127137	C	T	21	26	47	0	1	48	0	0
1	202740437	rs12142024	G	T	21	25	46	0	2	48	0	0
1	202740447	rs12127139	C	T	21	23	44	0	1	45	0	0
1	202740716	rs61290465	A	T	18	16	34	0	1	35	0	0
1	202741068	rs9660046	A	T	25	15	40	0	0	40	0	0
1	202741266	rs4245711	C	T	43	28	71	0	0	71	0	0
1	202745429	rs4950946	A	C	3	4	7	0	0	7	0	0
1	202780530	rs2275895	T	C	7	4	11	0	0	11	0	0
1	202780663	rs2275896	T	C	3	6	9	0	0	9	0	0
1	202848587	rs4950885	G	A	7	10	17	0	0	17	0	0
1	202849723	rs1131906	G	A	12	19	31	0	0	31	0	0
1	202849770	rs1131905	T	C	21	21	42	0	0	42	0	0
1	202861566	rs1042990	A	G	33	31	64	0	0	64	0	0
1	202876085	rs10753926	C	T	3	4	7	0	0	7	0	0
1	202909974	rs7539542	G	C	8	10	18	0	0	18	0	0
1	203148359	rs77111685	C	A	6	4	10	0	0	10	0	0
1	203152801	rs880633	T	C	5	1	6	0	0	6	0	0
1	203712996	rs970	T	C	54	68	122	0	2	124	0	0
1	203713133	rs568	G	A	38	37	75	0	1	76	0	0
1	203766827	rs872032	T	C	26	20	46	0	0	46	0	0
1	203768909	.	C	G	34	24	58	0	1	59	0	0
1	203771420	rs138419531	G	A	7	8	15	0	0	15	0	0
1	203790415	rs66989691	A	G	4	3	7	0	0	7	0	0
1	203803481	rs113351522	C	T	5	2	7	0	0	7	0	0
1	203803645	rs6674694	C	T	7	1	8	0	0	8	0	0
1	203805538	rs2365980	T	C	6	4	10	0	0	10	0	0
1	203805760	rs112407081	C	T	4	4	8	0	0	8	0	0
1	203818973	rs41299639	C	A	268	272	540	0	0	541	1	0
1	203819177	rs11808915	T	C	7	3	10	0	0	10	0	0
1	203821314	rs41264265	G	A	257	283	540	0	7	547	0	0
1	203821981	rs180808990	A	G	160	171	331	0	3	334	0	0
1	203823066	rs7311	G	C	189	165	354	0	3	357	0	0
1	203839273	rs2298870	C	T	10	9	19	0	1	20	0	0
1	204082118	.	G	A	7	6	13	0	0	13	0	0
1	204095573	rs3737658	G	A	16	10	26	0	1	27	0	0
1	204095687	rs3737659	C	A	13	14	27	0	0	27	0	0
1	204095920	rs11541600	G	T	29	18	47	0	0	47	0	0
1	204365749	rs7530308	C	T	6	3	9	0	0	9	0	0
1	204365997	rs2942145	T	C	11	18	29	0	0	29	0	0
1	204366099	rs3125164	T	C	17	13	30	0	0	30	0	0
1	204366437	rs3014621	G	C	10	8	18	0	0	18	0	0
1	204366713	rs11240736	G	A	5	4	9	0	0	9	0	0
1	204367207	rs11240737	A	G	6	9	15	0	0	15	0	0
1	204367303	rs11240738	A	G	8	13	21	0	0	21	0	0
1	204368977	rs6694389	T	C	4	4	8	0	0	8	0	0
1	204369875	rs2942133	T	G	10	7	17	0	0	17	0	0
1	204375669	rs3014624	G	C	4	2	6	0	0	6	0	0
1	204377473	.	T	C	7	3	10	0	0	10	0	0
1	204392442	rs4951374	G	A	37	31	68	0	1	69	0	0
1	204396830	rs17334387	G	A	33	27	60	0	0	60	0	0
1	204399061	rs2271419	A	G	20	25	45	0	0	45	0	0
1	204399064	rs2271420	G	A	20	25	45	0	0	45	0	0
1	204399577	rs112872702	G	A	7	1	8	0	1	9	0	0
1	204399631	rs111723317	A	G	5	2	7	0	0	7	0	0
1	204399665	rs112459101	G	A	5	2	7	0	0	7	0	0
1	204501383	rs4252697	C	T	9	7	16	0	0	16	0	0
1	204501660	rs143854824	C	G	3	4	7	0	0	7	0	0
1	204505487	rs10458588	T	C	7	12	19	0	0	19	0	0
1	204519187	rs4252745	C	G	96	88	184	0	2	186	0	0
1	204525132	rs72753810	A	G	91	91	182	0	0	182	0	0
1	204525568	rs10900598	G	T	191	145	336	0	1	337	0	0
1	204526721	rs12118859	G	A	147	119	266	0	1	267	0	0
1	205052939	rs4950979	G	A	3	5	8	0	0	8	0	0
1	205055949	rs7537322	G	A	20	23	43	0	0	43	0	0
1	205056476	rs12409915	T	C	14	16	30	0	0	30	0	0
1	205112911	rs3795556	T	C	43	39	82	0	3	85	0	0
1	205113833	rs3183297	A	G	25	18	43	0	1	44	0	0
1	205114873	rs12048743	C	G	22	33	55	0	0	55	0	0
1	205115150	rs1061132	C	A	17	27	44	0	1	45	0	0
1	205115739	rs11808879	G	A	6	12	18	0	0	18	0	0
1	205129319	rs1062715	G	A	21	17	38	0	0	38	0	0
1	205272926	rs1106201	C	T	144	72	216	0	1	217	0	0
1	205272983	rs1106202	C	G	131	65	196	0	1	197	0	0
1	205273142	rs41264881	G	C	75	122	197	0	2	199	0	0
1	205274675	rs1539695	C	T	17	10	27	0	0	27	0	0
1	205275972	rs1110303	A	G	5	4	9	0	0	9	0	0
1	205276025	rs1110304	G	A	7	1	8	0	0	8	0	0
1	205279612	rs17345997	C	T	4	3	7	0	0	7	0	0
1	205320428	rs55962699	A	T	45	0	45	0	0	45	0	0
1	205320469	rs4951205	G	A	44	0	44	0	0	44	0	0
1	205473772	rs77694338	T	C	4	6	10	0	0	10	0	0
1	205500543	rs11240507	T	C	34	34	68	0	0	68	0	0
1	205500988	rs41310907	G	A	30	24	54	0	0	54	0	0
1	205501181	rs3820377	T	C	36	38	74	0	0	74	0	0
1	205685352	rs951366	T	C	24	21	45	0	0	45	0	0
1	205717175	rs56382128	A	C	28	59	87	0	0	87	0	0
1	205717823	rs4951261	A	C	22	22	44	0	0	44	0	0
1	205738302	rs823137	G	A	18	21	39	0	0	39	0	0
1	205738843	rs11807208	C	T	12	12	24	0	0	24	0	0
1	205739200	rs16856287	C	T	24	11	35	0	2	37	0	0
1	205739266	rs708723	C	T	12	22	34	0	1	35	0	0
1	205739396	rs823139	T	G	6	19	25	0	0	25	0	0
1	205744138	rs708725	G	T	5	7	12	0	0	12	0	0
1	205759195	rs1772159	G	A	22	25	47	0	0	47	0	0
1	205759537	rs113992447	G	A	14	14	28	0	0	28	0	0
1	205767885	rs708727	G	A	8	21	29	0	1	30	0	0
1	205779231	rs11240569	G	A	23	7	30	0	0	30	0	0
1	206277827	.	C	T	12	4	16	0	0	16	0	0
1	206516261	.	C	T	6	3	9	0	0	9	0	0
1	206565189	.	C	T	6	0	6	0	0	6	0	0
1	206566904	rs2919105	T	C	57	16	73	0	0	73	0	0
1	206567100	.	C	T	10	2	12	0	0	12	0	0
1	206579798	.	T	C	6	0	6	0	0	6	0	0
1	206579936	.	A	G	2	4	6	0	0	6	0	0
1	206580084	.	C	G	1	17	18	0	0	18	0	0
1	206582910	.	A	G	0	6	6	0	0	6	0	0
1	206583000	.	G	A	3	8	11	0	0	11	0	0
1	206603535	rs2297539	G	A	35	31	66	0	0	66	0	0
1	206626607	rs11120575	G	A	43	39	82	0	0	82	0	0
1	206635570	rs11576488	C	T	7	3	10	0	0	10	0	0
1	206636879	rs3813981	T	C	9	8	17	0	0	17	0	0
1	206637395	rs9242	C	T	6	4	10	0	0	10	0	0
1	206650065	rs41296034	A	G	7	17	24	0	0	25	1	0
1	206730641	rs71633591	C	A	9	13	22	0	1	23	0	0
1	206730691	rs67223538	G	C	14	20	34	0	0	34	0	0
1	206732931	rs11579605	T	A	2	4	6	0	0	6	0	0
1	206734830	rs12563848	T	C	3	3	6	0	0	6	0	0
1	206757070	rs12724616	C	T	5	5	10	0	0	10	0	0
1	206758077	rs4418597	T	A	12	21	33	0	0	33	0	0
1	206759637	rs4073393	C	G	16	13	29	0	0	29	0	0
1	206759783	rs7535580	A	G	20	11	31	0	0	31	0	0
1	206759975	rs10779488	G	A	18	10	28	0	0	28	0	0
1	206760474	rs7541244	T	C	139	151	290	0	0	290	0	0
1	206761938	rs11589	T	C	217	185	402	0	1	403	0	0
1	206861935	rs10436961	G	A	4	2	6	0	0	6	0	0
1	206864573	rs6683282	G	A	5	4	9	0	0	9	0	0
1	206866203	rs12756861	G	A	4	5	9	0	0	9	0	0
1	206866514	rs143044784	G	A	2	8	10	0	0	10	0	0
1	206867003	rs71633597	A	G	9	2	11	0	0	11	0	0
1	206871335	rs4845129	A	G	40	48	88	0	1	89	0	0
1	206879122	rs4072677	G	T	3	3	6	0	0	6	0	0
1	206884120	rs12127807	A	C	2	4	6	0	1	7	0	0
1	206887176	rs7527443	A	G	2	5	7	0	0	7	0	0
1	206889712	rs12126261	C	A	4	4	8	0	0	8	0	0
1	206890138	rs4548444	A	G	5	3	8	0	0	8	0	0
1	206896876	rs4845131	G	T	10	6	16	0	0	16	0	0
1	206897727	rs6540574	G	A	10	5	15	0	0	15	0	0
1	206897810	rs6540576	G	T	10	3	13	0	0	13	0	0
1	206900229	rs7547594	C	G	8	13	21	0	0	21	0	0
1	206900379	rs12132083	C	T	15	6	21	0	0	21	0	0
1	206905043	rs4073250	C	T	820	865	1685	0	14	1700	1	0
1	206944645	rs1518111	T	C	4	3	7	0	0	7	0	0
1	206944952	rs3021094	T	G	5	1	6	0	0	6	0	0
1	207077210	rs3093438	A	T	4	7	11	0	0	11	0	0
1	207087435	rs167082	C	T	7	7	14	0	0	14	0	0
1	207219603	rs17258711	T	C	16	24	40	0	0	40	0	0
1	207220031	rs41277168	T	C	24	20	44	0	0	44	0	0
1	207220282	rs12123107	G	A	22	18	40	0	0	40	0	0
1	207220800	rs2629665	C	A	8	13	21	0	0	21	0	0
1	207221612	rs2054780	C	T	60	59	119	0	0	119	0	0
1	207221929	rs3790619	T	G	68	57	125	0	2	127	0	0
1	207234206	rs11585761	C	T	4	3	7	0	0	7	0	0
1	207235954	rs2075863	G	A	7	3	10	0	0	10	0	0
1	207250300	rs1060286	G	A	5	10	15	0	0	15	0	0
1	207252647	rs17258746	T	A	3	3	6	0	0	6	0	0
1	207253031	rs3748671	C	T	2	4	6	0	0	6	0	0
1	207253133	rs6673109	A	G	5	3	8	0	0	8	0	0
1	207253167	rs61815044	G	A	4	2	6	0	0	6	0	0
1	207253487	rs6673422	A	G	4	6	10	0	0	10	0	0
1	207496129	rs4844590	C	T	5	4	9	0	0	9	0	0
1	207496896	rs28371597	G	T	3	3	6	0	0	6	0	0
1	207497811	rs28371601	A	G	2	4	6	0	0	6	0	0
1	207520376	rs2404781	T	C	4	3	7	0	0	8	1	0
1	207523366	.	T	G	6	1	7	0	0	7	0	0
1	207532046	rs28371652	A	T	5	3	8	0	0	8	0	0
1	207941191	rs2724374	G	T	5	1	6	0	0	6	0	0
1	207943158	rs2724360	C	T	6	2	8	0	0	8	0	0
1	207965852	rs41318007	C	G	6	9	15	0	0	15	0	0
1	207966393	rs12568382	G	A	12	2	14	0	0	14	0	0
1	207979577	rs11118612	T	A	3	6	9	0	0	9	0	0
1	208061626	.	T	C	2	4	6	0	0	6	0	0
1	208063505	rs1009897	G	A	15	13	28	0	0	28	0	0
1	209849002	rs3817870	T	C	53	45	98	0	3	101	0	0
1	209849406	rs1473683	T	G	83	50	133	0	0	133	0	0
1	209929453	rs2272866	G	T	7	7	14	0	0	14	0	0
1	209933528	rs2076149	G	A	35	35	70	0	2	72	0	0
1	209933660	rs2076151	G	C	40	17	57	0	0	57	0	0
1	209952865	rs623360	C	G	42	22	64	0	1	65	0	0
1	210004199	rs585627	C	G	15	4	19	0	1	20	0	0
1	210006603	rs656566	C	T	13	14	27	0	0	27	0	0
1	211531329	rs11119729	G	A	4	2	6	0	0	6	0	0
1	211745154	rs11277	C	G	53	62	115	0	0	115	0	0
1	211745290	rs11553543	T	A	27	35	62	0	0	62	0	0
1	211747902	rs7531277	A	T	8	11	19	0	1	20	0	0
1	211748118	rs7519865	C	T	31	36	67	0	0	67	0	0
1	211918115	rs4480424	C	T	10	3	13	0	0	13	0	0
1	211919937	rs3795834	T	C	4	4	8	0	0	8	0	0
1	211920624	rs10465691	G	A	16	14	30	0	0	30	0	0
1	211921229	rs11119806	C	A	19	12	31	0	0	31	0	0
1	211921767	rs11119807	C	T	32	28	60	0	0	60	0	0
1	211922355	rs61828259	C	T	34	25	59	0	0	59	0	0
1	211922603	rs28368551	G	A	32	26	58	0	1	59	0	0
1	212114860	rs2808385	T	C	3	7	10	0	0	10	0	0
1	212224946	rs113106720	G	T	135	0	135	0	1	136	0	0
1	212277107	rs1387815	T	G	10	3	13	0	0	13	0	0
1	212459257	rs351409	A	G	5	7	12	0	0	12	0	0
1	212459615	rs75232123	C	G	54	32	86	0	0	86	0	0
1	212460478	rs7526983	T	C	4	2	6	0	0	6	0	0
1	212465109	rs351399	G	C	2	5	7	0	0	7	0	0
1	212516875	rs12736502	C	T	11	3	14	0	0	14	0	0
1	212517205	rs12726409	T	A	5	4	9	0	0	9	0	0
1	212523716	rs2921128	A	G	3	6	9	0	0	9	0	0
1	212524446	rs11577005	A	C	6	2	8	0	0	8	0	0
1	212526288	rs792442	C	T	7	10	17	0	0	17	0	0
1	212527646	rs34080686	G	A	5	8	13	0	0	13	0	0
1	212533082	rs72754308	C	G	7	8	15	0	0	15	0	0
1	212533780	rs11587555	C	G	20	15	35	0	0	35	0	0
1	212538456	rs12073615	T	G	56	77	133	0	1	134	0	0
1	212548723	rs72754324	A	G	6	10	16	0	0	16	0	0
1	212556678	rs792446	A	C	1	5	6	0	0	6	0	0
1	212556744	rs792447	G	A	1	5	6	0	0	6	0	0
1	212587320	rs4951595	T	C	6	9	15	0	0	15	0	0
1	212588190	rs2297306	C	A	17	10	27	0	0	27	0	0
1	212588206	rs518793	C	G	3	10	13	0	0	13	0	0
1	212782500	rs6666492	T	C	57	38	95	0	2	97	0	0
1	212785460	rs10735510	G	C	39	31	70	0	2	72	0	0
1	212785577	rs11571532	A	T	32	26	58	0	2	60	0	0
1	212786163	rs7516737	T	C	40	30	70	0	1	71	0	0
1	212786920	rs11571536	G	A	45	31	76	0	0	76	0	0
1	212787092	rs11571538	A	G	57	57	114	0	3	117	0	0
1	212789529	rs9429889	T	C	14	17	31	0	0	31	0	0
1	212790335	rs12070345	A	G	18	45	63	0	0	63	0	0
1	212790959	rs3123544	T	A	36	29	65	0	0	65	0	0
1	212792191	rs11571552	A	G	105	99	204	0	4	208	0	0
1	213167762	rs2132428	A	G	2	5	7	0	0	7	0	0
1	213252041	rs56076309	G	A	40	38	78	0	0	78	0	0
1	214498421	rs17729519	T	C	2	4	6	0	0	6	0	0
1	214820099	rs3748697	A	G	5	1	6	0	0	6	0	0
1	214826196	rs335524	G	A	10	6	16	0	0	16	0	0
1	215741053	rs2275768	T	G	6	2	8	0	0	8	0	0
1	215753355	rs11803705	T	G	6	4	10	0	0	10	0	0
1	215781574	rs3767255	A	G	7	9	16	0	0	16	0	0
1	215793834	rs14137	G	A	22	20	42	0	0	42	0	0
1	217604124	rs166449	T	C	7	6	13	0	0	13	0	0
1	217804325	rs944730	G	A	12	12	24	0	0	24	0	0
1	219366546	.	T	C	4	5	9	0	1	10	0	0
1	219370603	rs11118235	C	T	3	3	6	0	0	6	0	0
1	219385003	.	C	G	15	6	21	0	0	21	0	0
1	220142023	rs1061248	C	T	33	32	65	0	2	67	0	0
1	220142070	rs1061242	C	T	40	39	79	0	0	79	0	0
1	220154768	rs1061160	C	T	59	41	100	0	0	100	0	0
1	220322043	.	C	G	3	6	9	0	0	9	0	0
1	220871320	rs337153	T	C	4	2	6	0	0	6	0	0
1	221050400	rs2738750	G	A	3	8	11	0	0	11	0	0
1	221051566	rs41369048	A	G	7	7	14	0	0	14	0	0
1	221051713	rs2738751	C	G	7	8	15	0	0	15	0	0
1	221052640	rs2807857	T	C	15	23	38	0	0	38	0	0
1	221052765	rs2738752	A	G	40	26	66	0	1	67	0	0
1	221052937	rs2738754	A	C	79	40	119	0	1	120	0	0
1	221055463	rs2247213	G	A	40	54	94	0	0	94	0	0
1	221056216	rs1317189	T	C	132	100	232	0	4	236	0	0
1	221056390	rs868058	A	T	77	58	135	0	1	136	0	0
1	221056674	rs2491259	C	G	149	89	238	0	7	245	0	0
1	221057646	rs2738755	C	T	989	900	1889	0	29	1919	1	0
1	221057739	rs11578466	C	G	849	785	1634	0	7	1641	0	0
1	221058059	rs2738756	C	T	697	662	1359	0	12	1372	1	0
1	221876222	rs2280339	C	T	10	6	16	0	0	16	0	0
1	221876510	rs12405549	C	T	5	4	9	0	0	9	0	0
1	221878139	rs1519463	T	C	21	18	39	0	0	39	0	0
1	221878749	rs61820079	G	A	15	19	34	0	0	34	0	0
1	221880195	rs12029722	A	G	5	7	12	0	0	12	0	0
1	221880851	rs12126069	A	G	4	4	8	0	0	8	0	0
1	221882970	rs115888457	C	T	13	8	21	0	1	22	0	0
1	221883225	rs908858	C	T	6	4	10	0	0	10	0	0
1	221883496	rs12749729	G	A	4	6	10	0	0	10	0	0
1	221885140	rs10746413	C	G	3	3	6	0	0	6	0	0
1	221888340	rs55920838	T	C	3	3	6	0	0	6	0	0
1	221897346	rs11118838	A	C	4	4	8	0	0	8	0	0
1	221903047	rs12134633	T	C	3	4	7	0	0	7	0	0
1	221904615	rs6689705	A	T	5	5	10	0	0	10	0	0
1	221908908	rs61823529	G	A	19	15	34	0	0	34	0	0
1	222224277	rs2584320	C	T	15	8	23	0	0	23	0	0
1	222224342	rs2790748	A	G	13	9	22	0	0	22	0	0
1	222224354	rs2800849	G	T	11	9	20	0	0	20	0	0
1	222224449	rs2584321	C	G	9	2	11	0	0	11	0	0
1	222733017	rs17163214	C	T	2	4	6	0	0	6	0	0
1	222836733	rs3008630	T	C	5	5	10	0	0	10	0	0
1	222893880	rs61824333	A	G	2	4	6	0	0	6	0	0
1	223905532	rs17596	G	A	74	74	148	0	2	150	0	0
1	223933079	rs17598	C	T	93	94	187	0	3	190	0	0
1	223934720	rs17600	G	A	91	95	186	0	2	188	0	0
1	223940933	rs2298256	C	A	2	10	12	0	0	12	0	0
1	223940967	rs7540481	C	T	2	7	9	0	0	9	0	0
1	223945631	.	C	T	7	4	11	0	0	11	0	0
1	223945766	rs1222077	G	T	7	10	17	0	0	17	0	0
1	223945833	rs1222078	G	C	5	8	13	0	0	13	0	0
1	223946433	.	A	G	5	2	7	0	0	7	0	0
1	223946830	rs1222080	G	A	6	3	9	0	0	9	0	0
1	223977884	rs146939078	G	A	17	12	29	0	0	29	0	0
1	224139191	rs8960	G	A	8	3	11	0	0	11	0	0
1	224139286	rs9219	C	T	8	13	21	0	0	21	0	0
1	224139650	rs61825422	T	C	16	11	27	0	0	27	0	0
1	224139708	rs61825423	T	C	19	3	22	0	0	22	0	0
1	224183608	rs11825	T	C	3	3	6	0	0	6	0	0
1	224302047	rs73124414	C	T	80	74	154	0	1	155	0	0
1	224373608	rs4653996	T	G	4	4	8	0	0	8	0	0
1	224376734	rs36086207	A	G	6	0	6	0	0	6	0	0
1	224379041	rs11810089	G	A	4	2	6	0	0	6	0	0
1	224380921	rs1060394	A	T	14	8	22	0	0	22	0	0
1	224418939	.	T	C	18	15	33	0	0	33	0	0
1	224488315	rs16846339	T	C	33	21	54	0	0	54	0	0
1	224492746	rs3754090	C	T	26	21	47	0	1	48	0	0
1	224492783	.	T	A	26	20	46	0	0	46	0	0
1	224495852	rs7534447	C	T	25	30	55	0	0	55	0	0
1	224517842	rs2896990	C	T	6	5	11	0	0	11	0	0
1	224575018	rs17503938	C	T	101	78	179	0	2	181	0	0
1	224575373	rs4653586	G	A	86	102	188	0	1	189	0	0
1	224575874	rs11809710	C	A	92	107	199	0	2	201	0	0
1	224578925	rs35341841	G	A	3	3	6	0	0	6	0	0
1	224580405	rs6691779	C	T	0	6	6	0	0	6	0	0
1	224580880	rs12759275	C	T	4	5	9	0	0	9	0	0
1	224583040	.	T	C	12	5	17	0	0	17	0	0
1	224585344	rs11810160	G	A	5	7	12	0	0	12	0	0
1	224585772	.	A	T	4	5	9	0	0	9	0	0
1	224586334	rs73125526	A	G	10	3	13	0	0	13	0	0
1	224589639	rs7547931	G	T	25	18	43	0	1	44	0	0
1	224600568	.	C	A	14	18	32	0	1	33	0	0
1	224601770	rs12747286	T	C	2	5	7	0	0	7	0	0
1	224611157	rs111292316	T	C	64	67	131	0	0	131	0	0
1	224614625	rs28434172	C	T	5	3	8	0	0	8	0	0
1	224615970	rs35277713	C	T	10	8	18	0	0	18	0	0
1	224616353	rs12758302	C	G	10	6	16	0	0	16	0	0
1	224616773	.	G	A	11	6	17	0	0	17	0	0
1	224616896	rs35011635	G	A	5	8	13	0	0	13	0	0
1	224618498	rs2211327	C	T	5	9	14	0	0	14	0	0
1	224621934	rs35365551	G	C	85	130	215	0	2	217	0	0
1	225157350	rs75170178	C	T	4	2	6	0	1	7	0	0
1	225610751	rs6686405	G	A	3	6	9	0	0	9	0	0
1	225610861	rs6678087	T	C	3	3	6	0	0	6	0	0
1	225610906	rs6686611	G	T	6	0	6	0	0	6	0	0
1	225965832	rs1461957	G	T	18	9	27	0	0	27	0	0
1	226019653	rs1131873	G	A	10	5	15	0	0	15	0	0
1	226026406	rs2234922	A	G	9	3	12	0	1	13	0	0
1	226027548	rs34143170	C	T	6	9	15	0	0	15	0	0
1	226029557	rs2854452	A	G	19	15	34	0	0	34	0	0
1	226029949	.	A	G	33	24	57	0	0	57	0	0
1	226032229	rs1051741	C	T	28	28	56	0	0	56	0	0
1	226033969	rs2740174	A	G	18	8	26	0	0	26	0	0
1	226037318	rs2292558	C	G	1	5	6	0	0	6	0	0
1	226050609	rs10158985	C	A	4	7	11	0	1	12	0	0
1	226052638	rs6426090	T	C	2	5	7	0	0	7	0	0
1	226052830	rs360083	A	G	5	7	12	0	0	12	0	0
1	226053805	rs7515156	G	A	10	18	28	0	0	28	0	0
1	226054714	rs2292563	G	A	8	11	19	0	0	19	0	0
1	226055595	rs2292564	G	A	21	13	34	0	0	34	0	0
1	226056663	rs56108141	G	A	3	5	8	0	0	8	0	0
1	226056793	rs12747508	C	T	5	4	9	0	0	9	0	0
1	226067382	rs360100	G	A	5	3	8	0	0	8	0	0
1	226067799	rs360101	G	A	2	4	6	0	0	6	0	0
1	226067862	rs360102	G	A	3	3	6	0	0	6	0	0
1	226110243	rs10915898	G	A	9	4	13	0	0	13	0	0
1	226332471	rs183942858	A	G	16	12	28	0	0	28	0	0
1	226334605	rs41303309	T	C	3	6	9	0	0	9	0	0
1	226341527	rs114078387	T	C	11	7	18	0	0	18	0	0
1	226453581	rs10799343	T	C	3	3	6	0	0	6	0	0
1	226548554	rs8679	A	G	86	114	200	0	0	200	0	0
1	226549498	rs2271347	G	A	6	10	16	0	0	16	0	0
1	226552068	rs3219142	G	A	3	5	8	0	0	8	0	0
1	226553042	rs3219140	C	T	11	7	18	0	0	18	0	0
1	226557878	rs3219110	T	C	1	5	6	0	0	6	0	0
1	226819833	rs1144840	A	G	53	59	112	0	0	112	0	0
1	226820252	rs1144839	C	G	54	40	94	0	3	97	0	0
1	226820500	rs1050492	G	A	60	64	124	0	3	127	0	0
1	226821139	rs3738723	T	A	57	67	124	0	1	125	0	0
1	226821306	rs1144838	A	G	44	56	100	0	1	101	0	0
1	226829990	rs17522524	T	C	3	3	6	0	0	6	0	0
1	226830948	rs883507	G	A	5	3	8	0	0	8	0	0
1	226835632	rs3768372	C	G	3	4	7	0	0	7	0	0
1	226865290	rs3820639	C	A	3	3	6	0	0	6	0	0
1	226865315	rs59886785	T	C	4	2	6	0	0	6	0	0
1	226903535	rs708767	G	C	4	9	13	0	0	13	0	0
1	226903551	rs10916028	G	A	10	5	15	0	0	15	0	0
1	226908479	rs144149766	G	A	7	1	8	0	0	8	0	0
1	227155983	rs10916072	C	T	3	5	8	0	1	9	0	0
1	227156620	rs28534769	T	A	6	8	14	0	0	14	0	0
1	227156621	rs28660358	A	C	6	7	13	0	1	14	0	0
1	227157608	rs7553837	C	A	2	4	6	0	0	6	0	0
1	227162524	rs11583489	G	T	13	13	26	0	1	27	0	0
1	227165097	rs3806263	G	A	7	9	16	0	0	16	0	0
1	227170298	rs2297412	A	G	30	38	68	0	0	68	0	0
1	227170543	rs2297413	C	G	16	12	28	0	0	28	0	0
1	227171737	rs1574184	G	T	3	14	17	0	7	24	0	0
1	227172290	rs12593	C	T	292	241	533	0	4	537	0	0
1	227172903	rs2297415	G	A	6	2	8	0	0	8	0	0
1	227172935	rs2297416	C	G	8	3	11	0	0	11	0	0
1	227173477	rs3768419	G	C	9	8	17	0	1	18	0	0
1	227173537	rs3768420	C	T	14	10	24	0	0	24	0	0
1	227173892	rs17592479	T	A	6	10	16	0	0	16	0	0
1	227174145	rs7552783	T	C	8	5	13	0	0	13	0	0
1	227174210	rs3738725	T	C	373	391	764	0	0	764	0	0
1	227174902	rs8159	G	A	382	332	714	0	8	722	0	0
1	227920061	rs1060295	T	G	6	7	13	0	0	13	0	0
1	227920103	rs3087908	G	A	7	10	17	0	0	17	0	0
1	227935444	rs2236359	A	G	8	7	15	0	0	15	0	0
1	227968033	rs9786978	T	C	3	3	6	0	0	6	0	0
1	228271153	rs3754357	T	A	7	16	23	0	0	23	0	0
1	228274018	rs11582265	C	T	10	11	21	0	0	21	0	0
1	228277048	rs10916265	G	A	12	14	26	0	0	26	0	0
1	228277135	rs3738681	C	T	10	6	16	0	0	16	0	0
1	228277690	rs1188975	C	T	9	12	21	0	2	23	0	0
1	228277869	rs822727	A	G	14	19	33	0	0	33	0	0
1	228278108	rs3768329	G	T	12	12	24	0	1	25	0	0
1	228278508	rs3768330	G	C	12	14	26	0	0	26	0	0
1	228279023	rs1048503	G	A	22	23	45	0	0	45	0	0
1	228282329	rs11582704	G	C	17	16	33	0	0	33	0	0
1	228282695	rs3768331	C	T	18	23	41	0	0	41	0	0
1	228283876	rs708126	T	C	28	28	56	0	0	56	0	0
1	228284991	rs2070960	C	T	39	23	62	0	2	64	0	0
1	228331040	rs2313602	C	A	13	14	27	0	0	27	0	0
1	228333652	rs11577976	G	A	36	46	82	0	0	82	0	0
1	228334277	rs10916268	C	T	74	62	136	0	1	137	0	0
1	228335125	rs1803695	C	T	404	357	761	0	6	767	0	0
1	228335707	rs12116745	G	C	11	8	19	0	0	19	0	0
1	228335959	rs11580599	C	T	3	11	14	0	0	14	0	0
1	228364558	rs4653914	A	T	7	4	11	0	0	11	0	0
1	228364605	rs4653915	T	C	8	4	12	0	0	12	0	0
1	228367200	rs28587961	C	T	6	6	12	0	0	12	0	0
1	228368454	rs4653536	T	C	6	2	8	0	0	8	0	0
1	228369612	rs12039801	G	A	7	6	13	0	0	13	0	0
1	228391591	rs12022917	G	C	2	5	7	0	0	7	0	0
1	228391808	rs11800309	G	T	9	3	12	0	0	12	0	0
1	228431095	rs1771455	A	G	14	8	22	0	0	22	0	0
1	228433217	rs2487384	A	G	17	9	26	0	0	26	0	0
1	228434395	rs7517088	T	C	22	8	30	0	0	30	0	0
1	228434467	rs7517108	T	C	12	4	16	0	0	16	0	0
1	228438900	rs6668967	G	A	6	7	13	0	0	13	0	0
1	228439320	rs4653932	A	G	3	5	8	0	0	8	0	0
1	228440468	rs12407114	T	G	7	2	9	0	0	9	0	0
1	228440869	.	T	A	3	3	6	0	0	6	0	0
1	228451826	rs453140	C	T	6	6	12	0	1	13	0	0
1	228456943	rs549590	T	C	6	1	7	0	0	7	0	0
1	228461129	rs1188724	A	G	15	11	26	0	0	26	0	0
1	228464248	rs1188721	T	G	6	5	11	0	0	11	0	0
1	228464276	rs1188722	T	C	9	6	15	0	0	15	0	0
1	228468458	rs1188697	G	A	18	1	19	0	0	19	0	0
1	228475848	rs437129	G	A	30	16	46	0	0	46	0	0
1	228480282	rs1150908	A	G	9	15	24	0	0	24	0	0
1	228482010	rs449133	C	T	23	14	37	0	0	37	0	0
1	228483369	rs564636	C	T	16	12	28	0	0	28	0	0
1	228492044	rs1150910	G	A	12	3	15	0	0	15	0	0
1	228494790	rs435776	G	A	15	2	17	0	0	17	0	0
1	228503677	rs1150912	A	G	10	4	14	0	0	14	0	0
1	228504472	rs1188732	T	C	7	3	10	0	0	10	0	0
1	228504670	rs11810627	C	T	11	5	16	0	0	16	0	0
1	228505668	rs1188729	C	G	11	11	22	0	0	22	0	0
1	228505699	rs1188728	T	C	15	9	24	0	0	24	0	0
1	228509427	rs373610	A	G	13	5	18	0	1	19	0	0
1	228520973	rs369909	C	G	20	11	31	0	0	31	0	0
1	228521002	.	C	A	12	24	36	0	0	36	0	0
1	228524961	rs3795808	C	A	30	11	41	0	1	42	0	0
1	228526665	rs505629	T	C	31	8	39	0	1	40	0	0
1	228528563	rs1188710	C	G	28	11	39	0	0	39	0	0
1	228539034	.	C	T	26	60	86	0	0	86	0	0
1	228544905	rs3178839	C	A	3	3	6	0	0	6	0	0
1	228545686	rs4653945	C	G	3	11	14	0	0	14	0	0
1	228546242	rs4653946	C	T	1	6	7	0	0	7	0	0
1	228546472	rs10799474	A	G	4	11	15	0	0	15	0	0
1	228547901	rs12035900	C	T	19	52	71	0	1	72	0	0
1	228559994	rs500049	C	T	3	5	8	0	0	8	0	0
1	228560700	rs512253	T	C	8	7	15	0	0	15	0	0
1	228683139	rs10916331	A	G	2	5	7	0	0	7	0	0
1	228782630	rs55724370	G	C	8	3	11	0	0	11	0	0
1	228783474	rs56043220	G	C	3	5	8	0	0	8	0	0
1	228784907	rs6672815	C	T	3	3	6	0	0	6	0	0
1	229461882	rs9435840	A	C	3	4	7	0	0	7	0	0
1	229729769	rs41309641	C	T	44	36	80	0	0	80	0	0
1	229729777	rs41315605	C	T	42	34	76	0	1	77	0	0
1	229730452	rs2295625	G	A	35	24	59	0	0	59	0	0
1	229737227	rs3820359	G	A	25	20	45	0	0	45	0	0
1	229738170	rs3753886	T	G	53	45	98	0	1	99	0	0
1	229739148	rs10916525	G	A	9	3	12	0	0	12	0	0
1	229739496	rs10916526	C	A	2	5	7	0	0	7	0	0
1	229740181	rs12756465	C	T	7	7	14	0	0	14	0	0
1	229740431	rs2839863	T	C	5	4	9	0	0	9	0	0
1	229746019	rs2273573	C	T	7	6	13	0	0	13	0	0
1	229746970	rs10916527	T	C	8	4	12	0	0	12	0	0
1	229762054	rs71652397	T	A	5	5	10	0	0	10	0	0
1	229772693	rs3811473	T	G	14	14	28	0	0	28	0	0
1	229790048	rs7521953	A	G	13	20	33	0	0	33	0	0
1	229795070	rs1048306	T	G	23	27	50	0	0	50	0	0
1	229795330	rs3820361	T	C	25	17	42	0	2	44	0	0
1	230227094	rs10864683	T	G	3	6	9	0	0	9	0	0
1	230227100	rs2038394	T	C	3	5	8	0	0	8	0	0
1	230227101	rs2038395	G	A	3	5	8	0	0	8	0	0
1	230227208	rs12029443	C	G	6	6	12	0	0	12	0	0
1	230395485	rs137946352	A	G	3	3	6	0	0	6	0	0
1	230398241	rs16851269	C	T	6	6	12	0	0	12	0	0
1	230399410	rs16851270	G	A	4	3	7	0	0	7	0	0
1	230400121	rs16851275	C	G	10	6	16	0	0	16	0	0
1	230400355	rs2279432	T	C	9	14	23	0	1	24	0	0
1	230412836	rs7529464	G	C	3	3	6	0	0	6	0	0
1	230413313	rs9432148	T	C	4	6	10	0	0	10	0	0
1	230415293	rs2273967	C	T	55	52	107	0	2	109	0	0
1	230416038	rs3213495	G	A	39	53	92	0	1	93	0	0
1	230416320	rs3213497	C	T	30	29	59	0	0	59	0	0
1	230416399	rs1043897	G	T	43	44	87	0	2	89	0	0
1	230416744	rs1043900	G	A	52	59	111	0	0	111	0	0
1	230416832	rs16851339	T	A	48	70	118	0	3	121	0	0
1	230417557	rs1043941	T	C	48	25	73	0	1	74	0	0
1	230417560	rs1043944	A	G	50	26	76	0	0	76	0	0
1	231042732	rs3811502	T	A	8	10	18	0	1	19	0	0
1	231359931	rs16854007	C	T	5	5	10	0	0	10	0	0
1	231408091	rs11558492	A	G	64	63	127	0	1	128	0	0
1	231468606	rs953	A	G	27	35	62	0	0	62	0	0
1	231468953	rs2064766	G	A	70	57	127	0	2	129	0	0
1	231470650	rs10489609	T	C	64	67	131	0	0	131	0	0
1	231470772	rs11122272	A	G	62	41	103	0	1	104	0	0
1	231664203	rs1630250	G	C	5	3	8	0	0	8	0	0
1	231679662	rs3767754	G	A	6	2	8	0	1	9	0	0
1	231830295	rs3738401	G	A	25	20	45	0	0	45	0	0
1	231954872	rs11588937	C	T	5	1	6	0	0	6	0	0
1	232025174	rs1073179	A	G	4	3	7	0	0	7	0	0
1	232144598	rs821616	A	T	17	19	36	0	2	38	0	0
1	232144887	rs821617	A	G	10	13	23	0	0	23	0	0
1	232176769	rs11803088	C	T	7	7	14	0	0	14	0	0
1	232534957	rs12043251	T	C	35	22	57	0	0	57	0	0
1	232650867	rs4649383	C	T	13	4	17	0	0	17	0	0
1	233398713	rs1033325	C	T	14	11	25	0	0	25	0	0
1	234508852	rs141196097	T	A	32	34	66	0	1	67	0	0
1	234537992	rs12031728	G	A	5	7	12	0	0	12	0	0
1	234538007	.	C	T	3	6	9	0	0	9	0	0
1	234542225	rs17517734	T	C	19	21	40	0	0	40	0	0
1	234582651	rs4920246	T	C	36	52	88	0	0	88	0	0
1	234584231	rs2102596	C	T	40	42	82	0	0	82	0	0
1	234603386	rs270502	G	T	31	25	56	0	0	56	0	0
1	234740141	rs8823	G	A	20	11	31	0	0	31	0	0
1	234744413	rs4636	C	A	173	280	453	0	3	456	0	0
1	234745009	rs7545855	A	G	7	7	14	0	0	14	0	0
1	235093673	rs115791703	C	T	7	4	11	0	1	12	0	0
1	235094242	rs16844279	G	A	4	3	7	0	0	7	0	0
1	235095444	rs2802929	A	G	9	7	16	0	0	16	0	0
1	235115954	rs6586358	G	C	12	17	29	0	0	29	0	0
1	235276289	rs4551650	C	T	5	2	7	0	0	7	0	0
1	235285740	rs4659823	C	T	3	3	6	0	0	6	0	0
1	235302256	rs4659549	T	C	12	22	34	0	0	34	0	0
1	235303232	rs79902876	C	T	11	6	17	0	1	18	0	0
1	235305217	rs67736021	G	A	9	12	21	0	0	21	0	0
1	235306563	rs4659941	C	T	12	5	17	0	0	17	0	0
1	235313921	rs74868495	G	A	10	6	16	0	0	16	0	0
1	235315671	rs4660022	T	C	3	3	6	0	0	6	0	0
1	235315711	rs2273741	C	T	6	6	12	0	0	12	0	0
1	235317741	rs4660042	C	T	11	4	15	0	0	15	0	0
1	235317747	rs111494659	C	T	6	8	14	0	0	14	0	0
1	235318711	rs112368830	T	C	6	5	11	0	1	12	0	0
1	235319373	rs4659601	C	G	6	7	13	0	1	14	0	0
1	235322660	rs6429293	T	C	6	6	12	0	0	12	0	0
1	235324070	.	G	C	20	27	47	0	0	47	0	0
1	235332648	rs6670078	T	C	6	1	7	0	0	7	0	0
1	235333174	rs12739051	G	A	14	5	19	0	0	19	0	0
1	235335177	rs12749859	G	A	6	1	7	0	0	7	0	0
1	235335817	rs12035188	C	T	5	4	9	0	0	9	0	0
1	235336270	rs6429413	G	A	4	2	6	0	0	6	0	0
1	235337418	rs9793257	A	G	5	3	8	0	0	8	0	0
1	235337761	rs7339935	T	C	7	1	8	0	0	8	0	0
1	235338377	rs12731779	G	A	7	2	9	0	0	9	0	0
1	235350554	rs2891013	A	G	2	4	6	0	0	6	0	0
1	235377979	rs6677573	T	G	16	14	30	0	0	30	0	0
1	235378344	rs10925125	G	A	42	32	74	0	2	76	0	0
1	235378659	rs10925127	C	T	26	13	39	0	0	39	0	0
1	235378767	rs10925128	T	G	8	7	15	0	0	15	0	0
1	235378896	rs7531921	A	G	22	20	42	0	1	43	0	0
1	235378898	rs7531922	A	G	23	20	43	0	0	43	0	0
1	235379186	rs4659647	G	A	23	16	39	0	1	40	0	0
1	235380147	rs12022924	G	T	4	5	9	0	0	9	0	0
1	235381342	rs12029822	T	G	10	12	22	0	0	22	0	0
1	235382775	rs4659653	T	C	5	4	9	0	0	9	0	0
1	235383188	rs4659654	A	G	214	184	398	0	0	398	0	0
1	235385934	rs12027832	A	G	46	21	67	0	1	68	0	0
1	235387854	rs9787250	T	A	7	10	17	0	0	17	0	0
1	235389354	rs12032572	T	C	3	5	8	0	0	8	0	0
1	235389548	rs10495361	C	T	3	5	8	0	0	8	0	0
1	235389998	rs12027647	G	A	12	21	33	0	0	33	0	0
1	235390396	rs10495362	T	C	26	32	58	0	0	58	0	0
1	235391264	rs10925162	C	T	16	15	31	0	0	31	0	0
1	235391446	rs1933246	T	C	14	20	34	0	0	34	0	0
1	235391922	.	G	A	24	21	45	0	1	46	0	0
1	235392083	rs4659673	A	C	23	20	43	0	0	43	0	0
1	235392354	rs4659674	T	A	5	8	13	0	0	13	0	0
1	235392546	rs12731746	T	C	146	98	244	0	9	253	0	0
1	235395983	rs61836148	T	A	3	4	7	0	0	7	0	0
1	235396345	rs12725756	G	A	2	4	6	0	0	6	0	0
1	235396577	rs4659676	A	C	3	6	9	0	0	9	0	0
1	235396697	rs4659678	A	G	5	4	9	0	0	9	0	0
1	235398812	rs12036412	T	C	7	12	19	0	0	19	0	0
1	235399332	rs12034913	C	T	10	7	17	0	0	17	0	0
1	235400328	rs10925191	T	C	14	1	15	0	0	15	0	0
1	235401292	rs10925194	G	C	2	5	7	0	0	7	0	0
1	235402133	rs2185019	G	A	7	6	13	0	0	13	0	0
1	235402174	.	G	A	4	4	8	0	0	8	0	0
1	235402230	rs2382617	A	G	3	5	8	0	0	8	0	0
1	235405211	rs12745603	G	A	3	5	8	0	0	8	0	0
1	235405245	rs12760850	C	G	6	5	11	0	0	11	0	0
1	235405654	rs12035746	C	T	9	6	15	0	0	15	0	0
1	235408410	rs2185018	T	C	7	4	11	0	1	12	0	0
1	235464620	rs12736498	A	C	5	9	14	0	0	14	0	0
1	235465045	rs72758049	G	T	4	4	8	0	0	8	0	0
1	235465059	rs61836167	C	T	6	2	8	0	0	8	0	0
1	235492546	rs3806393	T	G	8	9	17	0	0	17	0	0
1	235493804	rs10754614	G	A	5	4	9	0	0	9	0	0
1	235506918	rs2789367	G	C	2	4	6	0	0	6	0	0
1	235611285	rs6429095	G	C	23	11	34	0	0	34	0	0
1	235611293	rs6429096	G	A	17	13	30	0	1	31	0	0
1	235640283	rs291379	A	G	2	4	6	0	0	6	0	0
1	235641636	rs291380	A	G	4	3	7	0	0	7	0	0
1	235641745	rs696240	G	A	4	3	7	0	0	7	0	0
1	235642359	rs167092	A	G	4	2	6	0	0	6	0	0
1	235642606	rs397905	C	T	11	4	15	0	0	15	0	0
1	235643100	rs291383	G	A	6	5	11	0	0	11	0	0
1	235652513	rs291396	T	C	7	6	13	0	0	13	0	0
1	235659543	.	C	T	1	11	12	0	0	12	0	0
1	235901433	rs2145402	C	A	36	36	72	0	0	72	0	0
1	235998123	rs71642809	A	G	2	4	6	0	1	7	0	0
1	236027956	rs12760043	G	A	2	4	6	0	0	6	0	0
1	236140082	.	A	G	11	16	27	0	1	28	0	0
1	236175339	rs2031487	T	C	2	19	21	0	0	21	0	0
1	236176845	rs35714220	C	T	3	6	9	0	0	9	0	0
1	236187449	rs34743457	C	T	3	7	10	0	0	10	0	0
1	236189278	rs16833131	C	T	7	4	11	0	0	11	0	0
1	236208773	rs10733133	C	T	8	1	9	0	0	9	0	0
1	236212038	rs6665008	G	A	9	6	15	0	0	15	0	0
1	236227080	rs10927371	C	G	3	3	6	0	0	6	0	0
1	236227408	rs7534529	G	C	11	7	18	0	0	18	0	0
1	236379149	rs2449	A	C	10	10	20	0	0	20	0	0
1	236379623	rs2463193	G	A	5	1	6	0	0	6	0	0
1	236381349	rs1726630	C	G	7	5	12	0	0	12	0	0
1	236381825	rs1055851	G	C	12	9	21	0	0	21	0	0
1	236394926	rs941238	T	C	3	4	7	0	0	7	0	0
1	236413230	rs2477599	T	A	9	19	28	0	1	29	0	0
1	236418576	rs1749564	C	T	6	0	6	0	0	6	0	0
1	236700805	.	G	A	26	36	62	0	0	62	0	0
1	236700807	rs1126407	T	A	26	35	61	0	1	62	0	0
1	236700823	rs1041934	T	C	22	40	62	0	0	62	0	0
1	236700857	rs1041935	C	T	33	39	72	0	1	73	0	0
1	236702209	rs1041936	C	T	43	34	77	0	1	78	0	0
1	236702210	rs1041937	A	G	41	34	75	0	1	76	0	0
1	236702374	rs2472126	G	A	43	37	80	0	1	81	0	0
1	236702714	rs66675787	C	T	5	1	6	0	0	6	0	0
1	236702722	rs67726805	C	T	6	1	7	0	0	7	0	0
1	236702728	rs72632866	G	A	6	1	7	0	0	7	0	0
1	236702749	rs72755768	G	A	6	1	7	0	0	7	0	0
1	236702750	rs11807244	A	T	6	1	7	0	0	7	0	0
1	236703687	rs2799413	T	C	5	5	10	0	0	10	0	0
1	236703700	rs2244659	A	G	5	4	9	0	0	9	0	0
1	236703734	rs2243405	T	C	5	2	7	0	0	7	0	0
1	236703767	rs2758994	C	T	5	2	7	0	0	7	0	0
1	236704754	rs2799412	C	T	3	4	7	0	0	7	0	0
1	236704813	rs2758169	A	C	4	4	8	0	0	8	0	0
1	236704825	rs2853611	G	A	4	3	7	0	0	7	0	0
1	236705434	rs2799411	C	T	5	3	8	0	0	8	0	0
1	236706352	rs2758174	A	C	2	6	8	0	0	8	0	0
1	236706371	rs2758175	A	G	0	6	6	0	0	6	0	0
1	236706425	rs2244267	G	A	3	6	9	0	1	10	0	0
1	236706467	rs2244261	C	T	6	10	16	0	0	16	0	0
1	236706671	rs2243530	T	A	8	3	11	0	0	11	0	0
1	236706780	rs2243527	C	T	10	8	18	0	0	18	0	0
1	236706862	rs2243525	G	C	44	44	88	0	0	88	0	0
1	236708224	rs2244063	A	C	6	6	12	0	0	12	0	0
1	236708316	rs2758181	A	G	5	1	6	0	0	6	0	0
1	236710370	rs911957	A	T	4	3	7	0	0	7	0	0
1	236711323	rs15701	T	C	40	50	90	0	0	90	0	0
1	236711586	rs1160	G	A	30	31	61	0	0	61	0	0
1	236711810	rs2758997	A	G	34	16	50	0	0	50	0	0
1	236711882	rs1041940	G	T	62	37	99	0	0	99	0	0
1	236711886	rs1041941	C	T	64	38	102	0	0	102	0	0
1	236711951	rs1041942	T	A	61	46	107	0	0	107	0	0
1	236711956	rs1041943	A	C	58	47	105	0	1	106	0	0
1	236711981	rs1041944	C	T	59	46	105	0	2	107	0	0
1	236712857	rs8698	C	T	20	21	41	0	0	41	0	0
1	236713556	rs1803919	G	A	47	38	85	0	0	85	0	0
1	236713828	rs2758998	G	A	50	30	80	0	0	80	0	0
1	236714064	rs6989	A	C	48	41	89	0	1	90	0	0
1	236714335	rs2254487	C	T	13	11	24	0	1	25	0	0
1	236714384	rs2254483	G	A	20	13	33	0	0	33	0	0
1	236714747	rs1042275	T	C	49	41	90	0	0	90	0	0
1	236714916	rs2540	T	C	60	34	94	0	0	94	0	0
1	236715517	rs3189	T	C	7	9	16	0	0	16	0	0
1	236715710	rs2758999	G	A	3	4	7	0	0	7	0	0
1	236716959	rs2275685	C	T	45	40	85	0	1	86	0	0
1	236717926	rs2275687	T	C	31	36	67	0	1	68	0	0
1	236718620	rs1126627	T	C	28	43	71	0	0	71	0	0
1	236719135	rs1885532	T	C	52	40	92	0	1	93	0	0
1	236719193	rs1885533	A	G	48	40	88	0	0	88	0	0
1	236721610	rs2275688	G	A	30	24	54	0	0	54	0	0
1	236721660	rs2275689	T	C	27	22	49	0	0	49	0	0
1	236724605	rs1077438	G	T	3	3	6	0	0	6	0	0
1	236728484	rs2799433	G	T	4	3	7	0	0	7	0	0
1	236728792	rs2564745	G	A	5	1	6	0	0	6	0	0
1	236729458	rs2564744	G	C	4	2	6	0	0	6	0	0
1	236729956	rs653737	T	C	17	18	35	0	0	35	0	0
1	236732054	rs2799430	A	G	4	2	6	0	0	6	0	0
1	236732776	rs2794778	A	G	3	7	10	0	1	11	0	0
1	236733473	rs509767	T	C	4	6	10	0	0	10	0	0
1	236733926	rs2853603	T	C	5	1	6	0	0	6	0	0
1	236734216	rs2794776	A	G	4	4	8	0	0	8	0	0
1	236738781	rs2794775	A	G	8	5	13	0	0	13	0	0
1	236739210	rs2794774	C	G	8	4	12	0	0	12	0	0
1	236739301	rs2853598	T	C	5	4	9	0	0	9	0	0
1	236739416	rs2115740	C	T	10	12	22	0	0	22	0	0
1	236744712	rs4518892	C	A	15	10	25	0	0	25	0	0
1	236746443	rs2794768	C	T	17	9	26	0	0	26	0	0
1	236748505	rs1006456	T	C	17	12	29	0	0	29	0	0
1	236749649	rs2794763	T	C	10	11	21	0	0	21	0	0
1	236755837	rs2564739	C	T	10	20	30	0	0	30	0	0
1	236758887	rs2794751	T	C	18	19	37	0	1	38	0	0
1	236767330	rs10802551	A	G	26	25	51	0	0	51	0	0
1	237054569	rs2229276	A	G	8	4	12	0	0	12	0	0
1	237054799	rs2282369	A	G	5	2	7	0	0	7	0	0
1	237055305	rs10802569	G	C	4	2	6	0	0	6	0	0
1	237056002	rs1252252	A	T	3	6	9	0	0	9	0	0
1	237056436	rs3845567	G	A	4	4	8	0	0	8	0	0
1	237057608	rs2297965	G	A	1	5	6	0	0	6	0	0
1	237058744	rs12070777	C	A	6	4	10	0	0	10	0	0
1	237058828	rs1131449	C	T	9	5	14	0	0	14	0	0
1	237061056	rs2853522	A	C	6	8	14	0	1	15	0	0
1	237061849	rs1131450	G	A	5	2	7	0	0	7	0	0
1	237062198	rs2853523	A	C	13	12	25	0	0	25	0	0
1	237062305	rs1050993	A	G	16	14	30	0	0	30	0	0
1	237063335	rs1050996	G	C	8	16	24	0	0	24	0	0
1	237063504	rs9779	A	G	15	5	20	0	0	20	0	0
1	237065326	rs4659746	C	T	8	0	8	0	0	8	0	0
1	237065583	rs10925264	G	T	1	5	6	0	0	6	0	0
1	241667233	rs4660099	C	T	3	4	7	0	0	7	0	0
1	241757549	rs3765809	G	T	14	11	25	0	1	26	0	0
1	241794056	rs3765820	C	A	5	2	7	0	0	7	0	0
1	241796284	rs676750	A	G	9	4	13	0	0	13	0	0
1	243306451	rs67686929	G	T	3	3	6	0	0	6	0	0
1	243348854	rs10803122	A	T	21	41	62	0	0	62	0	0
1	243355204	rs10926961	G	A	7	3	10	0	0	10	0	0
1	243356779	rs10926963	A	G	6	2	8	0	0	8	0	0
1	243360954	rs12746953	C	G	5	4	9	0	0	9	0	0
1	243374815	rs12072595	T	G	22	20	42	0	0	42	0	0
1	243385636	rs10926972	A	G	6	6	12	0	0	12	0	0
1	243396119	rs6669104	C	T	6	6	12	0	0	12	0	0
1	243396326	rs10926974	C	T	3	5	8	0	0	8	0	0
1	243411386	rs12097743	G	C	2	4	6	0	0	6	0	0
1	243417832	rs546279210	C	T	5	2	7	0	0	7	0	0
1	243419429	rs3904682	T	A	59	37	96	0	0	96	0	0
1	243451853	rs12748870	T	A	2	4	6	0	0	6	0	0
1	243468694	rs12759571	C	A	3	6	9	0	0	9	0	0
1	243469029	rs12758920	G	A	14	9	23	0	0	23	0	0
1	243471949	rs10926987	C	A	2	5	7	0	0	7	0	0
1	243481431	rs2783972	A	G	29	28	57	0	0	57	0	0
1	243481556	rs2636323	C	G	42	23	65	0	0	65	0	0
1	243493907	rs2275155	A	T	26	33	59	0	0	59	0	0
1	243579112	rs10927011	G	A	28	27	55	0	1	56	0	0
1	244215864	rs1389622	G	A	15	8	23	0	0	23	0	0
1	244606220	rs112305094	A	C	4	3	7	0	0	7	0	0
1	244609092	rs3006004	G	A	6	5	11	0	0	11	0	0
1	244612252	rs3003212	A	G	4	4	8	0	0	8	0	0
1	244817239	rs41269389	G	T	57	84	141	0	0	141	0	0
1	245004094	rs3191	T	G	30	38	68	0	0	68	0	0
1	245005085	rs12058012	G	C	41	42	83	0	0	83	0	0
1	245005373	rs10927335	A	G	11	19	30	0	0	31	1	0
1	245005713	rs12095737	A	C	12	18	30	0	0	30	0	0
1	245005828	rs12070200	C	T	9	16	25	0	0	25	0	0
1	245005841	rs12096894	T	A	8	14	22	0	1	23	0	0
1	245006827	rs1053700	A	G	18	22	40	0	0	40	0	0
1	245011049	.	T	C	9	10	19	0	1	20	0	0
1	245012509	rs12146095	T	G	4	7	11	0	0	11	0	0
1	245013807	rs1495946	G	A	5	2	7	0	0	7	0	0
1	245018624	rs10927336	C	A	38	35	73	0	0	73	0	0
1	245020285	rs1874393	T	C	6	3	9	0	0	9	0	0
1	245021132	rs9730334	C	G	5	1	6	0	0	6	0	0
1	245022990	rs12068974	G	C	13	9	22	0	1	23	0	0
1	245023311	rs12069105	G	A	101	88	189	0	4	193	0	0
1	245023365	rs12079538	C	T	98	74	172	0	1	173	0	0
1	245025692	rs12124462	A	T	50	47	97	0	1	98	0	0
1	245026341	rs529176068	G	A	9	13	22	0	0	22	0	0
1	245027349	rs6675421	C	T	189	187	376	0	24	400	0	0
1	245028453	rs78304699	G	T	17	12	29	0	0	29	0	0
1	245028509	rs9661182	G	T	10	13	23	0	0	23	0	0
1	245133662	rs61844237	G	C	4	11	15	0	1	16	0	0
1	245210798	rs594857	G	A	1	5	6	0	0	6	0	0
1	245210852	rs10803254	G	A	6	0	6	0	0	6	0	0
1	245245402	rs10927387	C	T	24	46	70	0	0	70	0	0
1	245247180	rs10754849	G	A	7	2	9	0	0	9	0	0
1	245247420	rs2365410	G	A	4	3	7	0	0	7	0	0
1	245249437	.	C	T	3	6	9	0	0	9	0	0
1	245251020	rs1047707	G	T	10	27	37	0	0	37	0	0
1	245251439	rs4658696	G	A	5	1	6	0	0	6	0	0
1	245251607	rs2152908	G	T	3	6	9	0	0	9	0	0
1	245252343	rs11806396	G	A	7	8	15	0	0	15	0	0
1	245285303	rs10927398	A	C	7	5	12	0	0	12	0	0
1	245288239	rs945953	G	A	7	3	10	0	0	10	0	0
1	245912840	rs8025	C	T	53	41	94	0	2	96	0	0
1	246670481	rs7520453	C	G	19	14	33	0	0	33	0	0
1	246715961	rs2340791	A	G	5	3	8	0	0	8	0	0
1	246716019	rs12138869	T	C	4	6	10	0	1	11	0	0
1	246716048	rs2340792	T	A	4	6	10	0	0	10	0	0
1	246716505	rs55873125	A	G	8	3	11	0	0	11	0	0
1	246716517	rs56177973	C	T	7	3	10	0	0	10	0	0
1	246716604	rs4654291	C	T	1	5	6	0	0	6	0	0
1	246716949	rs56263741	G	A	5	1	6	0	0	6	0	0
1	246717298	rs12082288	T	C	9	17	26	0	0	26	0	0
1	246717371	rs10465618	C	T	10	16	26	0	0	26	0	0
1	246717391	rs55741541	A	G	7	12	19	0	0	19	0	0
1	246717466	rs56367289	G	A	6	5	11	0	0	11	0	0
1	246717807	rs3129580	T	A	7	3	10	0	0	10	0	0
1	246717818	rs61852366	C	T	8	1	9	0	0	9	0	0
1	246723313	rs2341679	C	T	4	3	7	0	0	7	0	0
1	246724195	rs114242021	C	T	6	3	9	0	0	9	0	0
1	246732947	rs3124073	G	A	7	1	8	0	0	8	0	0
1	246762089	.	G	C	5	7	12	0	0	12	0	0
1	246796458	.	G	A	8	3	11	0	0	11	0	0
1	246816033	rs13374825	A	G	8	4	12	0	0	12	0	0
1	246816035	rs13374826	A	G	8	4	12	0	0	12	0	0
1	246854862	rs10802432	T	C	1	5	6	0	0	6	0	0
1	246930564	rs7779	G	C	333	334	667	0	5	672	0	0
1	246931057	rs3314	A	G	46	46	92	0	0	92	0	0
1	246939513	rs3795467	G	A	6	2	8	0	0	8	0	0
1	246949298	rs61852525	G	A	4	2	6	0	0	6	0	0
1	247005539	rs12094061	G	A	2	5	7	0	0	7	0	0
1	247006160	rs5021094	G	T	5	10	15	0	0	15	0	0
1	247007113	rs146417813	T	C	40	14	54	0	1	55	0	0
1	247027779	rs1691251	T	C	8	12	20	0	0	20	0	0
1	247032247	rs12409091	C	T	4	2	6	0	0	6	0	0
1	247032290	rs7551921	G	C	5	2	7	0	0	7	0	0
1	247033078	rs1779977	C	T	6	1	7	0	0	7	0	0
1	247041225	rs11583611	A	T	2	4	6	0	0	6	0	0
1	247044692	rs2642984	A	C	2	5	7	0	0	7	0	0
1	247048834	rs2642990	T	C	43	20	63	0	1	64	0	0
1	247081904	rs10924865	C	T	10	8	18	0	0	18	0	0
1	247149996	rs4971310	A	G	2	4	6	0	0	6	0	0
1	247150740	rs3749427	T	C	6	6	12	0	0	12	0	0
1	247151557	rs2642992	A	G	6	4	10	0	0	10	0	0
1	247351283	rs6668154	T	C	2	6	8	0	0	8	0	0
1	247351643	rs6704274	C	A	8	7	15	0	0	15	0	0
1	247351679	rs6670847	T	C	12	6	18	0	0	18	0	0
1	247353180	rs1115202	A	G	36	52	88	0	1	89	0	0
1	247353330	rs4351686	T	C	125	125	250	0	2	252	0	0
1	247353355	rs1115201	G	A	136	112	248	0	1	249	0	0
1	247353783	rs12071728	T	C	54	69	123	0	1	124	0	0
1	247354581	rs6678604	A	C	2	4	6	0	0	6	0	0
1	247361756	rs58405512	C	T	4	5	9	0	1	10	0	0
1	247361918	.	A	C	5	3	8	0	0	8	0	0
1	247362287	rs10924961	G	A	1	5	6	0	0	6	0	0
1	247362478	rs6698690	G	C	8	2	10	0	0	10	0	0
1	247363833	rs7546908	T	A	49	48	97	0	0	97	0	0
1	247364329	rs56029850	A	C	10	20	30	0	0	30	0	0
1	247364344	rs55643126	A	G	21	26	47	0	0	47	0	0
1	247364560	rs76520525	T	C	28	32	60	0	3	63	0	0
1	247365430	rs10754539	A	G	4	7	11	0	0	11	0	0
1	247366435	rs11811599	C	A	2	7	9	0	0	9	0	0
1	247367105	rs2892054	T	C	3	8	11	0	0	11	0	0
1	247370978	rs61840059	T	C	10	7	17	0	0	17	0	0
1	247371652	rs75028588	T	C	10	12	22	0	0	22	0	0
1	247372009	rs56340510	T	A	13	77	90	0	2	92	0	0
1	247372163	rs17269923	G	T	7	53	60	0	0	60	0	0
1	247372672	rs6691539	C	T	24	84	108	0	0	108	0	0
1	247373571	rs4582838	C	A	10	16	26	0	1	27	0	0
1	247373628	rs4314914	T	C	9	13	22	0	1	23	0	0
1	247373894	rs56338561	T	C	3	4	7	0	0	7	0	0
1	247462048	rs2153631	A	G	68	59	127	0	1	128	0	0
1	247462273	rs9725334	A	G	73	65	138	0	0	138	0	0
1	247462701	rs1616299	C	T	56	55	111	0	2	113	0	0
1	247465244	rs4925615	C	G	4	6	10	0	0	10	0	0
1	247466538	rs56399534	C	T	19	8	27	0	0	27	0	0
1	247466744	rs56037169	C	T	3	4	7	0	0	7	0	0
1	247468146	rs9426180	G	T	8	7	15	0	0	15	0	0
1	247468572	rs9426181	G	A	3	7	10	0	0	10	0	0
1	247472200	rs1771948	T	A	3	8	11	0	0	11	0	0
1	247473889	rs61838684	C	T	4	2	6	0	0	6	0	0
1	247485117	rs61838689	T	C	6	2	8	0	0	8	0	0
1	247487629	rs7418221	G	C	3	3	6	0	0	6	0	0
1	247493031	rs6674425	C	G	3	10	13	0	0	13	0	0
1	247494123	rs4925620	C	A	6	2	8	0	0	8	0	0
1	247579710	rs72553859	C	G	10	4	14	0	0	14	0	0
1	247579749	rs72553860	A	G	8	5	13	0	1	14	0	0
1	247581209	rs12137901	T	C	4	11	15	0	1	16	0	0
1	247582756	rs57801316	C	T	23	23	46	0	0	46	0	0
1	247583010	rs79796552	A	G	16	10	26	0	0	26	0	0
1	247583221	rs7512998	C	T	10	3	13	0	0	13	0	0
1	247587531	rs4925543	A	G	194	252	446	0	2	448	0	0
1	247590493	rs74154638	C	G	3	4	7	0	0	7	0	0
1	247593420	rs6673762	C	T	6	6	12	0	0	12	0	0
1	247593562	rs6699944	G	A	13	11	24	0	0	24	0	0
1	247594890	rs12564791	C	T	8	10	18	0	0	18	0	0
1	247596057	rs4925654	A	G	8	15	23	0	0	23	0	0
1	247596317	rs7514428	G	C	6	2	8	0	0	8	0	0
1	247596527	rs7516771	G	A	12	5	17	0	0	17	0	0
1	247596824	rs68078384	A	C	14	10	24	0	0	24	0	0
1	247596860	rs74154640	C	A	14	9	23	0	1	24	0	0
1	247597329	rs12124866	C	T	8	4	12	0	1	13	0	0
1	247597365	rs10925022	G	A	10	4	14	0	1	15	0	0
1	247598111	rs74460651	C	T	7	1	8	0	0	8	0	0
1	247599025	rs10925024	C	T	3	4	7	0	0	7	0	0
1	247599070	rs4612666	T	C	3	3	6	0	0	6	0	0
1	247599232	rs10754557	G	A	4	4	8	0	0	8	0	0
1	247600301	rs1539019	A	C	4	5	9	0	0	9	0	0
1	247601160	rs10925025	G	A	7	3	10	0	0	10	0	0
1	247601357	rs12143966	G	A	4	5	9	0	0	9	0	0
1	247601595	rs12239046	T	C	6	7	13	0	0	13	0	0
1	247601778	rs58546652	C	T	4	3	7	0	0	7	0	0
1	247601886	rs56015600	A	G	4	3	7	0	0	7	0	0
1	247602308	rs67090117	T	G	4	3	7	0	1	8	0	0
1	247602968	rs4925546	A	G	5	4	9	0	0	9	0	0
1	247603463	rs4925659	G	A	2	4	6	0	0	6	0	0
1	247605599	rs10157379	C	T	7	8	15	0	0	15	0	0
1	247606276	rs56188865	T	C	6	3	9	0	0	9	0	0
1	247607052	rs10159239	G	A	13	6	19	0	0	19	0	0
1	247607642	rs12130711	C	T	2	5	7	0	0	7	0	0
1	247608910	rs12131812	C	T	5	4	9	0	0	9	0	0
1	247610411	rs56383829	C	T	8	5	13	0	0	13	0	0
1	247612036	rs10754558	G	C	193	194	387	0	4	391	0	0
1	248023966	rs3737277	C	T	12	4	16	0	0	16	0	0
1	248028219	rs946696	G	A	5	17	22	0	0	22	0	0
1	248039713	rs3811445	A	G	7	8	15	0	0	15	0	0
1	248039789	.	T	C	9	7	16	0	0	16	0	0
1	248040018	rs4925574	A	G	3	3	6	0	0	6	0	0
1	248041182	rs10888263	T	G	5	4	9	0	0	9	0	0
1	248041417	rs45445998	A	T	4	4	8	0	0	8	0	0
1	248041795	rs61855715	A	G	9	7	16	0	0	16	0	0
1	248042937	rs72774616	C	T	21	13	34	0	1	35	0	0
1	248043238	rs61855717	C	T	13	9	22	0	0	22	0	0
10	856918	rs4229	A	T	18	14	32	0	0	32	0	0
10	858394	rs7703	C	T	27	32	59	0	0	59	0	0
10	878895	rs11817793	G	A	3	7	10	0	1	11	0	0
10	879697	rs11812170	C	T	3	3	6	0	0	6	0	0
10	879756	rs11818325	G	A	3	6	9	0	0	9	0	0
10	879776	rs35443149	C	T	3	4	7	0	0	7	0	0
10	882312	.	C	T	4	2	6	0	0	6	0	0
10	889320	rs12244253	G	T	2	5	7	0	0	7	0	0
10	889323	rs11253462	T	G	2	5	7	0	0	7	0	0
10	890714	rs34318754	G	A	5	5	10	0	0	10	0	0
10	953842	rs112691179	C	T	5	12	17	0	0	17	0	0
10	953874	rs34254874	G	T	9	3	12	0	0	12	0	0
10	954956	rs572893996	C	T	6	2	8	0	0	8	0	0
10	954957	rs6560859	A	G	6	2	8	0	0	8	0	0
10	955031	rs7070876	A	G	7	2	9	0	0	9	0	0
10	955051	rs7908870	G	A	3	6	9	0	0	9	0	0
10	955580	rs11592807	G	C	3	3	6	0	0	6	0	0
10	964306	rs11253509	C	T	6	7	13	0	0	13	0	0
10	1034412	rs12772979	C	T	46	18	64	0	0	64	0	0
10	1040159	rs1250891	G	C	6	3	9	0	0	9	0	0
10	1043667	rs11253557	C	T	16	7	23	0	0	23	0	0
10	1043983	rs11253558	T	C	4	4	8	0	0	8	0	0
10	1044809	rs11253559	T	C	17	9	26	0	0	26	0	0
10	1045099	rs3763720	C	T	9	6	15	0	0	15	0	0
10	1055055	rs12356612	C	T	1	5	6	0	0	6	0	0
10	1055271	rs10904597	C	T	5	6	11	0	0	11	0	0
10	1055866	rs4880751	A	T	14	12	26	0	0	26	0	0
10	1055868	rs7070545	A	G	15	12	27	0	0	27	0	0
10	1056169	rs71494945	C	T	17	5	22	0	0	22	0	0
10	1056252	rs17293608	C	T	10	3	13	0	0	13	0	0
10	1056821	.	T	C	8	8	16	0	0	16	0	0
10	1056837	.	C	G	11	8	19	0	0	19	0	0
10	1056842	.	C	T	11	7	18	0	1	19	0	0
10	1056846	.	A	G	10	6	16	0	0	16	0	0
10	1057554	rs4880754	C	A	14	28	42	0	0	42	0	0
10	1058196	rs17131848	C	T	14	9	23	0	0	23	0	0
10	1060218	rs3207775	G	A	176	211	387	0	2	389	0	0
10	1061767	rs2306405	G	A	186	209	395	0	7	402	0	0
10	1065191	rs17221491	A	G	15	17	32	0	0	32	0	0
10	1065406	rs41260144	G	T	13	14	27	0	0	27	0	0
10	1089616	rs11250238	T	C	54	46	100	0	0	100	0	0
10	1090366	rs67205460	C	T	21	21	42	0	0	42	0	0
10	1090469	rs66797613	C	T	24	24	48	0	0	48	0	0
10	1090684	rs67696450	C	T	19	16	35	0	0	35	0	0
10	1090988	rs7072554	C	T	11	13	24	0	0	24	0	0
10	1091308	rs1135416	A	T	11	13	24	0	0	24	0	0
10	1092195	rs28512382	G	C	11	14	25	0	0	25	0	0
10	1093992	rs4880759	A	G	14	12	26	0	0	26	0	0
10	1101882	rs117038941	G	T	4	6	10	0	0	10	0	0
10	1103590	rs35657988	A	G	6	7	13	0	0	13	0	0
10	1124531	rs7091030	C	T	5	3	8	0	0	8	0	0
10	1128238	rs60503326	G	A	6	4	10	0	0	10	0	0
10	1130127	rs7093837	C	T	8	2	10	0	0	10	0	0
10	1142424	rs10794717	A	G	4	3	7	0	0	7	0	0
10	1142860	rs59245488	A	T	3	8	11	0	0	11	0	0
10	1142978	rs75261041	G	A	4	3	7	0	0	7	0	0
10	1143212	rs67615426	G	A	4	4	8	0	0	8	0	0
10	1144049	rs7067536	C	T	6	4	10	0	0	10	0	0
10	1145284	rs34964132	C	A	6	6	12	0	0	12	0	0
10	1145635	rs11250261	G	A	13	5	18	0	0	18	0	0
10	1148672	rs10903368	C	G	9	7	16	0	0	16	0	0
10	1173641	rs4880769	A	G	4	2	6	0	0	6	0	0
10	1175894	rs11250281	A	G	14	21	35	0	0	35	0	0
10	1177236	rs76312690	C	T	66	63	129	0	1	130	0	0
10	3110218	rs76073697	T	C	3	8	11	0	0	11	0	0
10	3110752	rs41285619	A	G	10	16	26	0	0	26	0	0
10	3111057	rs113189067	C	T	5	9	14	0	1	15	0	0
10	3111685	rs74504363	G	A	23	40	63	0	0	63	0	0
10	3111797	rs78195233	T	C	20	24	44	0	0	44	0	0
10	3111800	rs76947028	T	C	20	24	44	0	0	44	0	0
10	3112575	rs41288711	G	A	9	14	23	0	0	23	0	0
10	3112709	rs17284739	A	G	7	9	16	0	0	16	0	0
10	3112944	rs78021546	T	C	7	11	18	0	0	18	0	0
10	3113176	rs80322866	G	C	12	8	20	0	0	20	0	0
10	3113232	rs78882784	T	C	16	12	28	0	0	28	0	0
10	3113271	rs76914228	A	G	15	14	29	0	0	29	0	0
10	3113362	rs113154165	C	T	13	8	21	0	0	21	0	0
10	3113386	rs75366957	C	T	10	6	16	0	0	16	0	0
10	3117132	rs35741420	G	C	3	4	7	0	0	7	0	0
10	3117195	rs2388552	C	T	4	6	10	0	0	10	0	0
10	3117988	rs112720077	G	A	4	3	7	0	0	7	0	0
10	3118048	rs112242452	G	T	4	4	8	0	0	8	0	0
10	3122966	rs72778566	C	G	3	4	7	0	0	7	0	0
10	3125188	rs11599643	C	A	4	2	6	0	0	6	0	0
10	3145906	rs11251719	A	C	6	8	14	0	0	14	0	0
10	3146760	rs11251720	C	T	14	17	31	0	0	31	0	0
10	3150898	rs11251721	C	T	114	119	233	0	4	237	0	0
10	3150973	rs1132173	C	T	138	120	258	0	0	258	0	0
10	3151863	rs77187733	C	T	3	3	6	0	0	6	0	0
10	3152025	rs188621133	C	T	2	4	6	0	0	6	0	0
10	3155353	rs3816699	C	T	128	118	246	0	0	246	0	0
10	3155540	rs4881085	A	G	2	6	8	0	0	8	0	0
10	3155698	rs4881086	C	T	137	118	255	0	3	258	0	0
10	3155753	rs4881087	G	C	6	11	17	0	0	17	0	0
10	3155790	rs4881089	C	T	7	10	17	0	0	17	0	0
10	3156214	rs2388566	C	T	16	21	37	0	2	39	0	0
10	3156364	rs4595438	C	T	14	2	16	0	0	16	0	0
10	3156387	rs4517415	A	G	15	9	24	0	0	24	0	0
10	3156404	rs4306207	T	C	12	10	22	0	0	22	0	0
10	3156877	rs4881092	C	A	12	17	29	0	0	29	0	0
10	3156900	rs11251723	T	C	19	12	31	0	0	31	0	0
10	3156901	rs11251724	G	A	19	12	31	0	0	31	0	0
10	3157094	rs35375917	C	A	21	11	32	0	1	33	0	0
10	3157109	rs34260521	T	C	26	12	38	0	0	38	0	0
10	3157131	rs12250915	A	T	31	17	48	0	0	48	0	0
10	3157230	rs34795068	C	T	31	16	47	0	0	47	0	0
10	3157523	.	C	T	7	11	18	0	8	26	0	0
10	3157895	rs9423680	A	T	24	28	52	0	0	52	0	0
10	3157982	rs74451751	G	A	27	17	44	0	0	44	0	0
10	3158187	rs76496015	A	G	22	12	34	0	0	34	0	0
10	3158294	rs200974548	A	G	10	1	11	0	0	11	0	0
10	3158733	rs41288719	G	A	25	11	36	0	0	36	0	0
10	3158848	rs7086902	C	T	36	13	49	0	0	49	0	0
10	3159255	rs116912533	C	T	6	17	23	0	0	23	0	0
10	3160616	rs9423461	C	T	2	8	10	0	0	10	0	0
10	3160726	rs9423462	T	C	3	11	14	0	0	14	0	0
10	3160775	rs9423463	A	G	5	15	20	0	0	20	0	0
10	3160847	rs4881098	G	A	7	14	21	0	1	22	0	0
10	3160913	rs3829912	G	A	8	19	27	0	0	27	0	0
10	3160917	rs3829913	T	C	7	18	25	0	0	25	0	0
10	3161131	rs3829914	C	T	7	7	14	0	0	14	0	0
10	3161148	rs3829915	G	C	7	9	16	0	0	16	0	0
10	3161627	.	G	A	4	2	6	0	0	6	0	0
10	3161729	rs7911657	G	A	3	4	7	0	0	7	0	0
10	3161744	rs7898894	A	C	3	6	9	0	0	9	0	0
10	3162410	rs3814588	T	A	4	3	7	0	0	7	0	0
10	3162423	rs6602026	G	A	5	5	10	0	0	10	0	0
10	3166326	rs9423478	C	T	13	7	20	0	0	20	0	0
10	3177320	rs9423490	C	T	37	27	64	0	1	65	0	0
10	3177663	rs2306314	C	A	17	13	30	0	2	32	0	0
10	3178881	rs1053000	C	T	91	77	168	0	1	169	0	0
10	3178915	rs541	C	T	54	40	94	0	1	95	0	0
10	3180227	rs6901	T	C	84	88	172	0	1	173	0	0
10	3180298	rs10175	C	T	94	98	192	0	2	194	0	0
10	3180316	rs11414	T	C	92	96	188	0	0	188	0	0
10	3180818	rs10795007	G	A	10	15	25	0	0	25	0	0
10	3180951	rs2279216	G	A	20	31	51	0	0	51	0	0
10	3181003	rs2279217	A	G	22	27	49	0	0	49	0	0
10	3183747	rs7094698	A	G	14	9	23	0	0	23	0	0
10	3184198	.	T	C	8	4	12	0	0	12	0	0
10	3184507	rs7898695	A	G	6	5	11	0	0	11	0	0
10	3184540	rs78801351	G	A	7	9	16	0	0	16	0	0
10	3184802	rs7911918	G	C	11	7	18	0	0	18	0	0
10	3185798	rs3736093	T	C	8	8	16	0	2	18	0	0
10	3186307	rs3752802	G	A	3	3	6	0	0	6	0	0
10	3186458	rs3752803	C	G	2	6	8	0	0	8	0	0
10	3187258	rs7081092	C	T	5	4	9	0	0	9	0	0
10	3189380	rs3740607	C	T	55	47	102	0	1	103	0	0
10	3190265	rs4881111	A	G	7	9	16	0	0	16	0	0
10	3190298	rs4881112	C	T	8	7	15	0	0	15	0	0
10	3190699	rs2291102	G	A	4	4	8	0	0	8	0	0
10	3190797	rs2291103	T	C	6	5	11	0	0	11	0	0
10	3190853	rs4881113	T	G	7	4	11	0	0	11	0	0
10	3191181	rs4881114	T	C	8	5	13	0	0	13	0	0
10	3191203	rs4881115	A	G	5	4	9	0	0	9	0	0
10	3191340	rs150924040	G	A	15	6	21	0	0	21	0	0
10	3191527	rs2388557	T	C	8	6	14	0	0	14	0	0
10	3200292	rs3182535	G	A	48	38	86	0	0	86	0	0
10	3202065	rs4242746	T	C	44	49	93	0	1	94	0	0
10	3204682	rs5017749	A	G	5	3	8	0	0	8	0	0
10	3204935	rs11251746	G	T	5	5	10	0	0	10	0	0
10	3205709	rs6602033	C	A	6	0	6	0	1	7	0	0
10	3205851	rs6602034	C	G	5	4	9	0	0	9	0	0
10	3206027	rs4609511	A	G	41	38	79	0	0	79	0	0
10	3208557	rs12359035	A	G	40	37	77	0	1	78	0	0
10	3819209	rs7005	C	T	1634	1500	3134	0	27	3161	0	0
10	3819760	.	C	T	1615	1515	3130	0	16	3146	0	0
10	3820114	rs112407993	G	T	829	512	1341	0	5	1347	1	0
10	3823188	rs12414935	C	G	65	71	136	0	0	136	0	0
10	3823419	rs12221160	A	G	47	54	101	0	1	102	0	0
10	3823531	rs3829201	G	A	54	46	100	0	0	100	0	0
10	3825801	rs3793919	C	T	20	19	39	0	0	39	0	0
10	3825824	rs146944391	A	T	15	19	34	0	0	34	0	0
10	4869493	rs181288427	T	A	4	8	12	0	0	12	0	0
10	4872930	rs61745201	G	A	4	9	13	0	0	13	0	0
10	4889732	rs74111762	C	T	3	4	7	0	0	7	0	0
10	4919647	rs74111786	C	T	31	0	31	0	0	31	0	0
10	4926511	rs10904365	C	T	6	4	10	0	0	10	0	0
10	5136651	rs12529	C	G	5	9	14	0	1	15	0	0
10	5138607	rs7741	G	A	11	6	17	0	0	17	0	0
10	5149703	rs3209896	G	A	12	15	27	0	0	27	0	0
10	5477131	rs10795277	C	T	3	3	6	0	0	6	0	0
10	5489784	rs4881452	G	A	3	3	6	0	0	6	0	0
10	5489789	rs4881453	T	C	4	3	7	0	0	7	0	0
10	5490932	rs12570751	A	T	4	4	8	0	0	8	0	0
10	5491495	rs56676146	A	G	10	8	18	0	0	18	0	0
10	5491564	rs12778283	T	C	4	5	9	0	0	9	0	0
10	5498248	rs4242790	G	T	5	1	6	0	0	6	0	0
10	5498390	rs10904507	C	T	4	10	14	0	0	14	0	0
10	5499173	rs11791	A	G	71	74	145	0	2	148	1	0
10	5708077	rs4747997	G	T	3	7	10	0	0	10	0	0
10	5727323	rs2282457	T	C	6	6	12	0	0	12	0	0
10	5728174	rs4750553	A	G	13	13	26	0	0	26	0	0
10	5760199	rs72774070	A	G	3	3	6	0	0	6	0	0
10	5767514	rs1317420	G	A	2	4	6	0	0	6	0	0
10	5783733	rs10737019	G	A	12	6	18	0	0	18	0	0
10	5784151	rs45575338	A	G	31	31	62	0	1	63	0	0
10	5799613	rs2275774	A	G	70	70	140	0	2	142	0	0
10	5807608	rs2497	A	G	333	186	519	0	2	521	0	0
10	5808086	rs1129614	G	A	423	304	727	0	2	729	0	0
10	5845061	rs74116316	A	G	4	3	7	0	0	7	0	0
10	5920121	rs1052420	T	C	15	4	19	0	0	19	0	0
10	5922815	rs600706	C	A	5	1	6	0	0	6	0	0
10	5957602	rs61834496	C	T	3	5	8	0	0	8	0	0
10	5957982	rs41290315	A	G	4	2	6	0	0	6	0	0
10	5958072	rs668498	A	G	8	5	13	0	0	13	0	0
10	5966854	rs11594794	G	A	5	2	7	0	0	7	0	0
10	5967158	rs2669126	C	T	12	2	14	0	0	14	0	0
10	6014984	rs8177656	G	A	3	5	8	0	0	8	0	0
10	6018594	rs8177636	T	C	4	2	6	0	0	6	0	0
10	6018880	rs4749856	C	T	4	16	20	0	1	21	0	0
10	6018970	rs36055263	A	G	16	5	21	0	0	21	0	0
10	6019015	rs8177633	C	G	24	3	27	0	0	27	0	0
10	6091148	rs809356	C	T	2	4	6	0	0	6	0	0
10	6092346	rs12253981	T	G	3	6	9	0	0	9	0	0
10	6095410	rs2476491	A	T	5	2	7	0	0	7	0	0
10	6096600	rs7917726	G	A	2	4	6	0	0	6	0	0
10	6097165	rs2256774	T	C	5	3	8	0	0	8	0	0
10	6097283	rs12722495	T	C	6	2	8	0	0	8	0	0
10	6101129	rs3118469	A	T	3	6	9	0	0	9	0	0
10	6101713	rs3118470	T	C	4	4	8	0	0	8	0	0
10	6103631	rs35338693	C	T	4	5	9	0	0	9	0	0
10	6131892	rs61839683	C	G	9	0	9	0	0	9	0	0
10	6134869	rs1571025	A	G	5	3	8	0	0	8	0	0
10	6138153	rs7100767	T	A	5	7	12	0	0	12	0	0
10	6139907	rs41295135	A	G	7	5	12	0	0	12	0	0
10	6141942	rs7902931	A	G	15	8	23	0	1	24	0	0
10	6144488	rs41295151	C	T	12	14	26	0	0	26	0	0
10	6147359	.	A	G	9	12	21	0	0	21	0	0
10	6148897	rs7904213	C	T	39	35	74	0	1	75	0	0
10	6150837	rs568171478	C	T	29	0	29	0	0	29	0	0
10	6150843	rs56386047	G	A	26	0	26	0	0	26	0	0
10	6150844	rs556548595	C	A	26	0	26	0	0	26	0	0
10	6150845	rs568467063	C	T	25	0	25	0	0	25	0	0
10	6151262	rs34410111	G	A	16	16	32	0	0	32	0	0
10	6151327	rs7916878	C	A	12	11	23	0	0	23	0	0
10	6152220	rs41295353	C	G	8	11	19	0	0	19	0	0
10	6153799	rs10905818	T	C	30	7	37	0	0	37	0	0
10	6153868	rs10905819	G	A	33	5	38	0	1	39	0	0
10	6155870	rs2274357	T	C	12	13	25	0	0	25	0	0
10	6155876	rs2274356	A	G	13	11	24	0	0	24	0	0
10	6158412	rs8463	A	G	104	98	202	0	1	203	0	0
10	6187766	rs11256977	T	C	4	2	6	0	0	6	0	0
10	6188949	rs1409330	A	G	7	4	11	0	0	11	0	0
10	6189920	rs17151086	T	C	4	8	12	0	0	12	0	0
10	6189975	rs17151090	T	C	3	6	9	0	0	9	0	0
10	6190343	rs725105	C	T	10	4	14	0	0	14	0	0
10	6191222	rs7068194	G	T	7	11	18	0	0	18	0	0
10	6191288	rs7092605	T	C	5	5	10	0	0	10	0	0
10	6191317	rs144642096	A	G	5	6	11	0	0	11	0	0
10	6258433	rs2251469	C	G	38	20	58	0	0	58	0	0
10	6259239	rs2516624	G	A	58	47	105	0	2	107	0	0
10	6259285	rs10906022	G	A	52	44	96	0	1	97	0	0
10	6259501	rs77790077	G	A	45	34	79	0	0	79	0	0
10	6259662	rs11257345	G	T	32	44	76	0	0	76	0	0
10	6260548	rs2148290	C	T	67	73	140	0	4	144	0	0
10	6260793	rs77387395	C	T	180	108	288	0	0	289	1	0
10	6262113	rs7915298	A	G	23	19	42	0	0	42	0	0
10	6262195	rs7915327	A	G	30	26	56	0	1	57	0	0
10	6263135	rs947478	C	G	86	73	159	0	3	162	0	0
10	6267175	rs4747952	C	A	14	14	28	0	0	28	0	0
10	6269855	rs7071157	T	C	86	73	159	0	2	161	0	0
10	6270465	rs3793721	G	T	78	63	141	0	0	141	0	0
10	6270511	rs12357847	A	G	83	77	160	0	1	161	0	0
10	6271291	rs12255582	C	T	82	42	124	0	1	125	0	0
10	6271556	rs7904794	T	C	70	39	109	0	3	112	0	0
10	6271564	rs10906037	A	G	75	42	117	0	1	118	0	0
10	6274511	rs11257456	T	G	116	82	198	0	3	201	0	0
10	6275498	rs11541590	G	A	668	485	1153	0	3	1156	0	0
10	6275772	rs36102318	A	G	671	486	1157	0	8	1165	0	0
10	6275776	rs55643411	T	C	501	675	1176	0	10	1186	0	0
10	6276574	rs1064891	T	C	596	414	1010	0	8	1018	0	0
10	6527143	rs2236379	G	A	12	15	27	0	0	27	0	0
10	6875909	rs146679862	A	G	8	16	24	0	0	24	0	0
10	7202028	rs2692760	C	T	71	38	109	0	1	110	0	0
10	7203228	rs2692758	G	A	48	42	90	0	0	90	0	0
10	7203237	rs9665413	C	T	41	42	83	0	0	83	0	0
10	7204878	rs10795530	A	G	30	26	56	0	1	57	0	0
10	7230824	rs2762607	A	C	5	1	6	0	0	6	0	0
10	7376033	rs72775545	C	G	5	1	6	0	0	6	0	0
10	7391115	rs2764386	A	G	6	10	16	0	0	16	0	0
10	7798350	rs7073356	A	T	3	3	6	0	0	6	0	0
10	7803310	rs546462245	G	A	5	1	6	0	0	6	0	0
10	7810071	rs11255351	C	T	8	3	11	0	0	11	0	0
10	7839225	rs1981015	G	C	3	4	7	0	0	7	0	0
10	7842900	rs12770829	C	T	4	2	6	0	0	6	0	0
10	7844906	rs1244431	T	G	3	5	8	0	0	8	0	0
10	7845298	rs1244432	T	A	6	9	15	0	0	15	0	0
10	7845507	rs10905233	G	A	3	4	7	0	0	7	0	0
10	7846974	rs1244434	C	T	3	11	14	0	1	15	0	0
10	7847441	rs1244435	G	T	3	5	8	0	0	8	0	0
10	7847889	rs12413175	A	G	5	7	12	0	1	13	0	0
10	7848481	rs1244438	G	A	4	5	9	0	2	11	0	0
10	7848604	rs1244439	A	G	3	7	10	0	0	10	0	0
10	7848611	rs7902363	C	T	3	5	8	0	0	8	0	0
10	7849341	rs11255369	T	A	3	6	9	0	0	9	0	0
10	7938830	rs10905242	C	T	4	5	9	0	0	9	0	0
10	7939115	rs7915234	C	T	4	4	8	0	0	8	0	0
10	8006798	rs4747647	A	G	18	19	37	0	0	37	0	0
10	8007559	rs10795583	G	C	15	14	29	0	0	29	0	0
10	8007560	rs1244229	T	C	15	14	29	0	0	29	0	0
10	8097368	rs10905277	G	A	12	7	19	0	1	20	0	0
10	8115908	rs11567941	G	A	20	14	34	0	0	34	0	0
10	8116598	rs1058240	G	A	18	14	32	0	1	33	0	0
10	11210466	rs688830	A	G	5	4	9	0	0	9	0	0
10	11210860	rs993284	C	G	3	7	10	0	0	10	0	0
10	11211204	rs685672	A	T	4	2	6	0	0	6	0	0
10	11212381	rs614162	A	G	2	6	8	0	0	8	0	0
10	11212425	rs614099	T	C	2	9	11	0	0	11	0	0
10	11213184	rs1745230	T	A	5	2	7	0	0	7	0	0
10	11214218	rs9424123	A	G	5	6	11	0	0	11	0	0
10	11215311	rs660676	T	C	3	7	10	0	0	10	0	0
10	11215710	rs662464	C	G	5	6	11	0	0	11	0	0
10	11215946	rs2759642	T	C	3	3	6	0	1	7	0	0
10	11217012	rs117193249	A	G	4	3	7	0	0	7	0	0
10	11217722	rs584228	T	G	4	2	6	0	0	6	0	0
10	11220787	rs17149708	A	G	9	2	11	0	0	11	0	0
10	11227299	rs654751	A	G	9	9	18	0	1	19	0	0
10	11227341	rs638920	C	T	9	7	16	0	0	16	0	0
10	11231472	rs55946325	G	C	5	5	10	0	0	10	0	0
10	11233620	rs74745951	C	T	8	5	13	0	1	14	0	0
10	11234399	rs532930922	A	C	8	13	21	0	0	21	0	0
10	11237509	rs4747895	G	A	14	13	27	0	0	27	0	0
10	11238195	rs2399659	G	A	12	22	34	0	1	35	0	0
10	11239076	rs4994968	C	T	38	42	80	0	1	81	0	0
10	11239462	rs74756975	C	T	31	16	47	0	1	48	0	0
10	11240695	rs2399660	A	G	10	14	24	0	0	24	0	0
10	11240799	rs2399661	A	G	10	4	14	0	1	15	0	0
10	11242317	rs2399663	C	T	9	6	15	0	0	15	0	0
10	11242471	rs17452064	G	C	7	8	15	0	1	16	0	0
10	11242776	.	A	T	6	7	13	0	0	13	0	0
10	11244049	rs142448393	G	A	6	9	15	0	0	15	0	0
10	11245664	rs882783	T	C	23	20	43	0	0	43	0	0
10	11245783	rs142822032	C	T	25	22	47	0	1	48	0	0
10	11245951	rs10752215	G	A	15	11	26	0	0	26	0	0
10	11245983	rs188498371	G	A	10	11	21	0	1	22	0	0
10	11246337	rs1109860	A	G	22	19	41	0	0	41	0	0
10	11248339	rs10905917	C	G	11	9	20	0	0	20	0	0
10	11248497	rs12570743	G	A	22	20	42	0	0	42	0	0
10	11249196	rs10795849	G	A	22	19	41	0	1	42	0	0
10	11249239	rs10795850	T	C	19	17	36	0	1	37	0	0
10	11249240	rs10795851	C	T	22	17	39	0	0	39	0	0
10	11249278	rs10795852	T	C	27	18	45	0	0	45	0	0
10	11249367	rs4297371	A	C	27	17	44	0	0	44	0	0
10	11249387	rs12217692	A	G	18	24	42	0	0	42	0	0
10	11249520	rs7906166	T	C	11	21	32	0	1	33	0	0
10	11249570	rs7918076	C	T	12	17	29	0	0	29	0	0
10	11250880	rs117435922	C	G	20	20	40	0	0	40	0	0
10	11251376	rs2399667	T	G	31	21	52	0	2	54	0	0
10	11253174	rs7079326	C	T	10	7	17	0	0	17	0	0
10	11256442	rs7094118	C	T	3	4	7	0	0	7	0	0
10	11258812	rs11596782	G	A	1	6	7	0	0	7	0	0
10	11258834	rs4750029	G	A	5	1	6	0	0	6	0	0
10	11258948	rs11592621	C	T	0	6	6	0	0	6	0	0
10	11260497	rs75031973	G	A	4	10	14	0	0	14	0	0
10	11263204	rs10160031	A	C	1	7	8	0	0	8	0	0
10	11263461	rs4511201	C	T	6	5	11	0	0	11	0	0
10	11263513	rs2399669	T	C	7	5	12	0	1	13	0	0
10	11264641	rs4306214	T	C	9	4	13	0	0	13	0	0
10	11265094	rs74722156	C	T	5	7	12	0	0	12	0	0
10	11266097	rs35287838	G	A	4	9	13	0	0	13	0	0
10	11266499	rs11597417	C	T	6	6	12	0	0	12	0	0
10	11267303	rs11594733	C	T	12	16	28	0	0	28	0	0
10	11268348	rs74582934	A	G	24	8	32	0	0	32	0	0
10	11271827	rs7922355	A	G	5	2	7	0	0	7	0	0
10	11272938	rs76527036	T	C	15	26	41	0	0	41	0	0
10	11273393	rs7913575	G	A	23	15	38	0	0	38	0	0
10	11273752	rs7091391	C	T	10	9	19	0	0	19	0	0
10	11274523	rs34509103	G	A	4	4	8	0	0	8	0	0
10	11275763	rs11257025	G	A	6	3	9	0	0	9	0	0
10	11276441	rs148416608	G	A	4	6	10	0	0	10	0	0
10	11278208	rs59071901	C	T	6	3	9	0	0	9	0	0
10	11281353	rs6602489	A	G	3	3	6	0	0	6	0	0
10	11285050	rs3740190	T	C	4	2	6	0	0	6	0	0
10	11287062	rs4750033	G	A	2	4	6	0	0	6	0	0
10	11288390	rs2653523	C	G	4	2	6	0	0	6	0	0
10	11288418	rs2765974	C	A	6	2	8	0	0	8	0	0
10	11289236	rs11595295	A	T	4	4	8	0	0	8	0	0
10	11290351	rs2653521	A	G	3	5	8	0	0	8	0	0
10	11290997	rs2653522	A	C	0	6	6	0	0	6	0	0
10	11299011	rs11257034	C	T	7	0	7	0	0	7	0	0
10	11299629	rs41291247	G	C	4	2	6	0	0	6	0	0
10	11300652	rs7917675	A	G	13	2	15	0	0	15	0	0
10	11303759	rs11257036	G	A	6	10	16	0	0	16	0	0
10	11304145	rs77467331	A	G	6	6	12	0	0	12	0	0
10	11310498	rs56251303	C	T	15	7	22	0	0	22	0	0
10	11312324	rs2653530	T	C	13	13	26	0	0	26	0	0
10	11313918	rs11257041	C	T	11	3	14	0	0	14	0	0
10	11314769	rs2765986	A	G	3	6	9	0	0	9	0	0
10	11315002	rs11257042	C	T	10	4	14	0	0	14	0	0
10	11315131	rs2938018	C	T	3	7	10	0	0	10	0	0
10	11315302	rs2653532	T	C	7	3	10	0	0	11	1	0
10	11315393	rs2765985	A	G	9	3	12	0	0	12	0	0
10	11315794	rs10795856	C	T	6	6	12	0	0	12	0	0
10	11316236	rs3780998	C	T	11	3	14	0	0	14	0	0
10	11316535	rs2765984	G	C	5	6	11	0	0	11	0	0
10	11316987	rs2244573	G	A	9	4	13	0	0	13	0	0
10	11327285	rs11257046	C	T	4	2	6	0	0	6	0	0
10	11328850	rs11257047	T	A	4	4	8	0	0	8	0	0
10	11330525	rs2277214	G	A	6	0	6	0	0	6	0	0
10	11330548	rs2277215	G	A	1	5	6	0	0	6	0	0
10	11341632	rs12570164	G	C	18	4	22	0	1	23	0	0
10	11342601	rs1910231	C	T	6	2	8	0	0	8	0	0
10	11342887	rs10905928	C	A	10	7	17	0	0	17	0	0
10	11343675	rs57772083	C	T	3	4	7	0	1	8	0	0
10	11343872	rs2938017	C	T	4	4	8	0	0	8	0	0
10	11343904	rs12769037	C	T	3	4	7	0	0	7	0	0
10	11348956	rs11814383	G	A	1	5	6	0	0	6	0	0
10	11348961	rs7076008	T	C	1	5	6	0	0	6	0	0
10	11355672	rs7087063	G	A	3	7	10	0	0	10	0	0
10	11359469	rs3781053	G	A	9	9	18	0	0	18	0	0
10	11360673	rs2279809	A	G	15	12	27	0	0	27	0	0
10	11367045	rs12261260	C	A	40	28	68	0	0	68	0	0
10	11367447	rs10905930	C	T	58	33	91	0	1	93	1	0
10	11368747	rs12268544	G	A	7	3	10	0	0	10	0	0
10	11369250	rs2378991	G	A	3	6	9	0	0	9	0	0
10	11369870	rs9329334	C	T	9	6	15	0	0	15	0	0
10	11377471	rs3814629	A	G	42	46	88	0	0	88	0	0
10	11499731	rs12359186	A	C	5	4	9	0	0	9	0	0
10	11504752	rs12570211	T	C	16	38	54	0	0	54	0	0
10	11505175	rs3740204	A	G	15	22	37	0	0	37	0	0
10	11797675	rs3750695	G	A	13	2	15	0	0	15	0	0
10	11873798	rs78723553	C	G	3	3	6	0	0	6	0	0
10	11908429	.	G	A	14	18	32	0	0	32	0	0
10	11916375	rs189637716	A	C	13	6	19	0	1	20	0	0
10	11962266	rs17471939	A	G	97	168	265	0	0	265	0	0
10	11962888	rs41291277	C	A	136	146	282	0	2	284	0	0
10	11963828	rs112166002	G	A	6	6	12	0	1	13	0	0
10	11963877	rs117556012	A	G	9	10	19	0	0	20	1	0
10	11963920	rs76572950	G	C	14	7	21	0	0	21	0	0
10	11965777	rs12413857	G	A	3	6	9	0	0	9	0	0
10	11967945	rs4462245	A	G	4	3	7	0	0	7	0	0
10	11968860	rs34655625	T	C	4	3	7	0	0	7	0	0
10	11969937	rs11594447	G	T	4	2	6	0	0	6	0	0
10	11970247	rs11599531	C	A	2	5	7	0	0	7	0	0
10	11984190	rs12414375	C	T	20	9	29	0	1	30	0	0
10	11986159	rs73571339	C	G	14	8	22	0	1	23	0	0
10	11986391	rs147760240	T	G	7	9	16	0	0	16	0	0
10	11986463	rs4750145	G	A	10	12	22	0	0	22	0	0
10	11988972	rs118005383	G	T	6	10	16	0	0	16	0	0
10	11989470	rs74509772	A	G	5	4	9	0	0	9	0	0
10	11989523	rs11818295	A	G	7	9	16	0	0	16	0	0
10	11991310	rs11819344	A	G	7	6	13	0	0	13	0	0
10	11993314	rs145876866	G	A	7	5	12	0	0	12	0	0
10	11993441	rs10906038	T	C	6	7	13	0	0	13	0	0
10	11994460	rs11257445	C	T	6	3	9	0	0	9	0	0
10	11994505	rs11594544	G	A	6	1	7	0	0	7	0	0
10	11995440	rs11593210	A	G	14	18	32	0	0	32	0	0
10	11996746	rs118076838	G	A	9	17	26	0	0	26	0	0
10	11996801	rs116944791	C	T	10	14	24	0	0	24	0	0
10	12003530	rs11595294	T	C	1	5	6	0	0	6	0	0
10	12014631	rs11257458	G	A	6	3	9	0	0	9	0	0
10	12014935	rs150237541	C	T	5	6	11	0	0	11	0	0
10	12015166	rs192624464	C	T	4	2	6	0	0	6	0	0
10	12015465	rs138950548	A	G	7	3	10	0	0	10	0	0
10	12035602	rs11814459	C	A	4	2	6	0	0	6	0	0
10	12037238	rs11819586	A	C	7	4	11	0	0	11	0	0
10	12037256	rs11813706	G	A	7	3	10	0	0	10	0	0
10	12043790	rs11595168	T	G	73	86	159	0	1	160	0	0
10	12058749	rs12413846	C	T	13	10	23	0	1	24	0	0
10	12059319	rs11257484	G	A	3	6	9	0	0	9	0	0
10	12059469	rs12415895	T	C	4	8	12	0	0	12	0	0
10	12061576	rs10906049	A	G	8	15	23	0	1	24	0	0
10	12062400	rs112259944	G	A	9	5	14	0	0	14	0	0
10	12062492	rs116851077	C	T	6	11	17	0	0	17	0	0
10	12062814	rs10906050	T	C	17	15	32	0	0	32	0	0
10	12062899	rs11257486	C	T	12	12	24	0	0	24	0	0
10	12063088	rs7072151	T	C	13	9	22	0	0	22	0	0
10	12063143	rs7075540	T	G	12	9	21	0	0	21	0	0
10	12063253	rs7072138	A	G	12	14	26	0	0	26	0	0
10	12063865	rs116993733	C	A	10	10	20	0	0	20	0	0
10	12063878	rs9665347	C	A	12	10	22	0	0	22	0	0
10	12063893	rs4750150	T	C	11	12	23	0	0	23	0	0
10	12064014	rs4750151	A	G	6	4	10	0	0	10	0	0
10	12064869	rs10795919	A	G	11	9	20	0	0	20	0	0
10	12065444	rs7098410	C	T	3	4	7	0	0	7	0	0
10	12065466	rs7097405	G	A	4	5	9	0	0	9	0	0
10	12065765	rs7082491	A	G	4	2	6	0	0	6	0	0
10	12066027	rs7086517	T	G	4	2	6	0	0	6	0	0
10	12067267	rs11591462	T	C	9	4	13	0	0	13	0	0
10	12067790	rs11599803	A	T	5	6	11	0	0	11	0	0
10	12068542	rs12415637	C	T	36	43	79	0	1	80	0	0
10	12069562	rs7079622	T	C	50	43	93	0	1	94	0	0
10	12074225	rs144280539	G	A	18	5	23	0	0	23	0	0
10	12075960	rs10906052	T	C	3	4	7	0	0	7	0	0
10	12076735	rs113295235	C	T	2	6	8	0	0	8	0	0
10	12127271	rs10795933	T	C	4	2	6	0	0	6	0	0
10	12127899	rs11257528	G	A	5	1	6	0	0	6	0	0
10	12129008	rs72779624	A	C	6	6	12	0	0	12	0	0
10	12131081	rs3740015	T	G	37	38	75	0	1	76	0	0
10	12131218	rs3740016	C	T	38	31	69	0	4	73	0	0
10	12159668	rs12416681	G	A	2	7	9	0	0	9	0	0
10	12225007	rs149064493	A	T	4	7	11	0	0	11	0	0
10	12868304	rs1644391	A	C	6	7	13	0	0	13	0	0
10	12871167	rs1644394	C	T	25	21	46	0	1	47	0	0
10	12872880	rs2431623	A	G	11	13	24	0	2	26	0	0
10	12873352	rs1757063	G	A	21	23	44	0	0	44	0	0
10	12873463	rs1644395	A	G	13	22	35	0	0	35	0	0
10	12874715	rs2431621	T	G	20	15	35	0	1	36	0	0
10	12875263	rs2431637	G	A	6	10	16	0	0	16	0	0
10	12875491	rs2431634	A	G	24	21	45	0	0	45	0	0
10	12876247	rs1047721	T	C	27	36	63	0	2	65	0	0
10	12876850	rs2482073	A	G	38	79	117	0	0	117	0	0
10	12877007	rs15980	G	A	51	61	112	0	1	113	0	0
10	12877510	rs7500	C	T	8	9	17	0	0	17	0	0
10	13142251	rs11548142	G	A	42	50	92	0	0	92	0	0
10	13151224	rs2234968	G	A	61	58	119	0	3	122	0	0
10	13152515	rs79529484	T	G	6	2	8	0	0	8	0	0
10	13159362	rs58505537	G	A	9	3	12	0	0	12	0	0
10	13160035	rs57057378	G	A	3	5	8	0	0	8	0	0
10	13160103	rs10752286	A	T	5	6	11	0	0	11	0	0
10	13160212	rs57199113	T	C	3	5	8	0	0	8	0	0
10	13160258	rs10796026	C	T	4	5	9	0	0	9	0	0
10	13163104	rs67295059	G	A	3	3	6	0	0	6	0	0
10	13164596	rs489040	A	G	3	3	6	0	0	6	0	0
10	13165481	rs2043947	C	G	5	12	17	0	0	17	0	0
10	13174759	rs67121368	A	T	10	8	18	0	0	18	0	0
10	13175860	rs7068612	G	C	2	5	7	0	0	7	0	0
10	13178057	rs12766076	C	T	3	3	6	0	0	6	0	0
10	13239651	rs2274110	A	G	7	2	9	0	0	9	0	0
10	13375906	rs10752297	T	C	73	39	112	0	0	112	0	0
10	13378445	rs2275128	A	G	4	2	6	0	0	6	0	0
10	13378690	rs7901303	T	G	4	2	6	0	0	6	0	0
10	13380084	rs3802583	A	G	5	4	9	0	0	9	0	0
10	13381835	rs1414399	A	C	5	5	10	0	0	10	0	0
10	13382754	rs10752298	T	C	6	4	10	0	0	10	0	0
10	13388578	rs10752299	A	G	3	4	7	0	0	7	0	0
10	13388644	rs36108296	G	C	5	1	6	0	0	6	0	0
10	13667731	rs7089227	G	T	3	4	7	0	0	7	0	0
10	13680892	rs5783336	G	C	1	8	9	0	0	9	0	0
10	13697651	rs73588485	C	G	4	5	9	0	0	9	0	0
10	14561500	rs8563	G	A	22	22	44	0	0	44	0	0
10	14563097	rs3780915	A	G	85	95	180	0	2	182	0	0
10	14571363	rs7918464	C	T	4	2	6	0	0	6	0	0
10	14607610	rs17155483	T	C	0	6	6	0	0	6	0	0
10	14610612	rs6602740	A	G	1	5	6	0	0	6	0	0
10	14645179	rs61842709	C	T	5	1	6	0	0	6	0	0
10	14880394	rs45622935	G	T	84	73	157	0	2	159	0	0
10	14880395	rs45480695	C	T	86	74	160	0	0	160	0	0
10	15902303	rs2297882	A	G	10	8	18	0	0	18	0	0
10	16479007	rs7922050	C	G	10	4	14	0	0	14	0	0
10	16509209	rs6602121	C	T	6	2	8	0	0	8	0	0
10	16558985	rs2298126	C	A	4	9	13	0	0	13	0	0
10	16729607	rs7076105	C	G	3	3	6	0	0	6	0	0
10	16934034	rs2669150	C	G	0	8	8	0	0	8	0	0
10	17189590	rs11254402	T	C	6	5	11	0	1	12	0	0
10	17189744	rs11254403	G	C	4	2	6	0	0	6	0	0
10	17190181	rs10904889	G	T	4	2	6	0	0	6	0	0
10	17199778	rs11254408	C	A	19	3	22	0	0	22	0	0
10	17204187	rs11254413	G	A	9	4	13	0	0	13	0	0
10	17210881	rs7096233	A	G	6	5	11	0	0	11	0	0
10	17216556	rs2273734	C	T	13	5	18	0	0	18	0	0
10	17243046	rs7082679	G	T	10	3	13	0	0	13	0	0
10	17243119	rs7895248	T	C	3	5	8	0	0	8	0	0
10	17270912	rs3758412	A	G	24	18	42	0	0	42	0	0
10	17271110	rs3758411	G	C	4	4	8	0	1	9	0	0
10	17271400	rs3758410	G	C	1500	1677	3177	0	4	3182	1	0
10	17274297	rs7914640	G	A	21	12	33	0	0	33	0	0
10	17276066	rs57465155	C	T	30	44	74	0	0	74	0	0
10	17278171	.	C	G	167	109	276	0	1	277	0	0
10	17278800	rs11254468	C	T	18	19	37	0	1	38	0	0
10	17279517	rs3249	C	T	972	1142	2114	0	25	2139	0	0
10	17738105	rs7350432	G	T	4	2	6	0	0	6	0	0
10	17742769	rs11254737	A	C	1	5	6	0	0	6	0	0
10	18966741	rs1055114	T	C	46	41	87	0	0	87	0	0
10	18967608	rs45499092	T	G	48	63	111	0	0	111	0	0
10	18967618	rs8181345	A	G	52	67	119	0	1	120	0	0
10	18967941	rs10829199	C	A	10	7	17	0	0	17	0	0
10	21827796	rs1802669	G	A	92	25	117	0	0	117	0	0
10	21830347	rs12268489	C	G	5	4	9	0	0	9	0	0
10	22027644	rs2050905	G	A	0	7	7	0	0	7	0	0
10	22031556	rs78154192	C	A	36	62	98	0	0	98	0	0
10	22092092	rs75844688	A	G	0	6	6	0	0	6	0	0
10	22154881	rs148543003	T	C	0	8	8	0	0	8	0	0
10	22156520	rs114914389	C	T	0	7	7	0	0	7	0	0
10	22169146	rs76179804	C	T	0	12	12	0	0	12	0	0
10	22251380	rs2807967	T	C	2	4	6	0	0	6	0	0
10	22251530	rs116224076	G	A	0	6	6	0	0	6	0	0
10	22255599	rs2666761	A	G	0	16	16	0	0	16	0	0
10	22276819	rs4146689	A	C	0	7	7	0	0	7	0	0
10	22292481	rs61850563	A	T	14	0	14	0	0	14	0	0
10	22292482	rs114829490	C	A	0	14	14	0	0	14	0	0
10	22654676	.	G	A	9	0	9	0	1	10	0	0
10	22727279	rs77396787	A	G	0	6	6	0	0	6	0	0
10	22824416	rs10734041	G	A	99	69	168	0	1	169	0	0
10	22825133	rs8341	T	C	23	20	43	0	1	44	0	0
10	22825596	rs1048244	C	T	13	4	17	0	0	17	0	0
10	22826093	rs1053454	A	C	64	40	104	0	3	107	0	0
10	23003226	rs1132816	A	G	25	18	43	0	0	43	0	0
10	23408278	rs7427	C	T	36	31	67	0	0	67	0	0
10	23409809	rs15404	G	A	24	25	49	0	0	49	0	0
10	26733172	rs6482560	C	T	5	2	7	0	0	7	0	0
10	26733201	rs6482561	C	T	6	2	8	0	0	8	0	0
10	26733355	rs4747559	G	A	3	3	6	0	0	6	0	0
10	26733534	rs4749132	A	G	4	4	8	0	0	8	0	0
10	26733545	rs4749133	A	G	5	2	7	0	0	7	0	0
10	26733591	rs4749134	A	G	4	3	7	0	0	7	0	0
10	26785554	rs2479880	G	A	4	5	9	0	0	9	0	0
10	26785991	rs12781142	G	T	14	10	24	0	0	24	0	0
10	26788462	rs10764627	T	G	3	3	6	0	0	6	0	0
10	26788530	rs12413644	T	C	4	5	9	0	1	10	0	0
10	26788544	rs10764628	T	C	5	5	10	0	0	10	0	0
10	26790659	rs3802617	G	A	30	47	77	0	0	77	0	0
10	27038969	rs7078119	C	T	6	1	7	0	1	8	0	0
10	27038983	rs7078227	C	T	6	1	7	0	0	7	0	0
10	27044049	rs2368185	C	T	14	16	30	0	0	30	0	0
10	27044460	rs12220461	G	T	13	19	32	0	1	33	0	0
10	27045387	rs1031858	C	T	3	6	9	0	0	9	0	0
10	27047593	rs1998634	G	A	6	3	9	0	0	9	0	0
10	27047739	rs1998632	G	A	4	2	6	0	0	6	0	0
10	27047820	rs1998631	A	G	2	4	6	0	0	6	0	0
10	27049011	.	T	A	6	15	21	0	1	22	0	0
10	27054375	rs7915128	C	T	10	12	22	0	0	22	0	0
10	27057755	rs75653529	T	C	8	10	18	0	0	18	0	0
10	27059608	rs1324637	C	T	1	5	6	0	0	6	0	0
10	27059636	rs11015277	C	T	2	6	8	0	0	8	0	0
10	27060810	rs3802616	A	G	4	3	7	0	0	7	0	0
10	27799309	rs12356076	G	C	4	5	9	0	0	9	0	0
10	27802834	rs16927998	C	T	5	2	7	0	0	7	0	0
10	27810575	rs61843363	A	G	4	4	8	0	0	8	0	0
10	27820742	rs2763308	C	G	19	7	26	0	0	26	0	0
10	27820781	.	A	G	17	17	34	0	0	34	0	0
10	27821004	rs11598492	A	G	11	10	21	0	0	21	0	0
10	27830433	rs11015861	G	A	9	10	19	0	0	19	0	0
10	28347988	rs2252206	A	G	2	6	8	0	0	8	0	0
10	28812514	rs200814819	T	G	39	14	53	0	1	54	0	0
10	28812515	.	T	G	30	23	53	0	2	55	0	0
10	28827253	rs117296823	G	A	15	7	22	0	0	22	0	0
10	28832820	rs61848477	G	C	3	3	6	0	0	7	1	0
10	28843022	rs2012189	C	T	3	4	7	0	0	7	0	0
10	28873202	rs2790462	C	T	11	2	13	0	0	13	0	0
10	28875950	rs117989838	G	A	13	12	25	0	0	25	0	0
10	28880160	rs332153	A	G	7	6	13	0	0	13	0	0
10	28880992	rs332155	T	C	3	6	9	0	0	9	0	0
10	28890160	rs2772431	C	T	4	6	10	0	0	10	0	0
10	28891174	rs182815	A	G	3	5	8	0	0	8	0	0
10	28893554	rs332164	G	A	7	2	9	0	0	9	0	0
10	28894247	rs332167	C	T	8	7	15	0	0	15	0	0
10	28894295	rs2772432	G	A	10	7	17	0	0	17	0	0
10	28902618	rs2532744	T	G	12	18	30	0	0	30	0	0
10	28903828	.	G	T	31	16	47	0	1	48	0	0
10	28905079	rs332176	A	G	27	13	40	0	0	40	0	0
10	28908141	rs2772434	G	A	3	5	8	0	0	8	0	0
10	29710788	rs16930212	C	T	48	49	97	0	1	98	0	0
10	29711903	rs4749422	T	G	9	12	21	0	0	21	0	0
10	29713379	rs34246948	A	G	5	4	9	0	0	9	0	0
10	29714004	rs35569401	A	G	9	11	20	0	0	20	0	0
10	29714336	rs16930216	G	A	5	9	14	0	0	14	0	0
10	29714448	rs16930217	C	T	7	8	15	0	0	15	0	0
10	29715181	rs12770932	G	A	7	15	22	0	0	22	0	0
10	29715292	rs12770626	A	G	5	6	11	0	0	11	0	0
10	29715442	rs12770852	A	G	9	13	22	0	0	22	0	0
10	29716353	rs8317	C	T	17	7	24	0	0	24	0	0
10	29716449	rs369009550	G	A	4	2	6	0	0	6	0	0
10	29774155	rs3858231	G	C	2	4	6	0	0	6	0	0
10	29779936	rs45519332	G	A	13	3	16	0	0	16	0	0
10	29783885	.	A	G	6	9	15	0	0	15	0	0
10	29812602	rs7070678	G	T	10	13	23	0	0	23	0	0
10	29839864	rs1270874	A	C	11	11	22	0	1	23	0	0
10	30020894	rs141635598	C	T	1	7	8	0	0	8	0	0
10	30020918	rs7908314	C	A	5	1	6	0	0	6	0	0
10	30628829	rs77886882	A	G	11	15	26	0	0	26	0	0
10	30723831	rs306589	A	G	132	158	290	0	0	290	0	0
10	30727084	rs303448	G	T	123	141	264	0	3	267	0	0
10	30727454	rs928620	G	A	364	225	589	0	5	594	0	0
10	30728101	rs1042058	T	C	1271	1901	3172	0	13	3185	0	0
10	30728250	rs2907	A	G	984	1401	2385	0	5	2390	0	0
10	30728489	rs303446	C	T	205	252	457	0	4	461	0	0
10	30729657	rs8176972	T	C	5	3	8	0	0	8	0	0
10	30731146	rs928055	G	A	5	1	6	0	0	6	0	0
10	30731171	rs3824589	T	A	6	0	6	0	0	6	0	0
10	30731660	rs8176984	G	T	2	4	6	0	0	6	0	0
10	30742388	rs598672	C	T	5	1	6	0	0	6	0	0
10	30748867	rs634550	T	G	4	3	7	0	0	7	0	0
10	30749895	rs3034	G	A	176	154	330	0	4	334	0	0
10	32301899	rs211393	G	A	5	6	11	0	0	11	0	0
10	32307811	rs77480280	A	G	24	18	42	0	0	42	0	0
10	32327779	rs45615333	C	G	3	4	7	0	0	7	0	0
10	32345154	.	G	C	62	67	129	0	0	129	0	0
10	32391505	rs211403	T	C	0	6	6	0	0	6	0	0
10	32558454	rs12772050	C	A	1	5	6	0	0	6	0	0
10	32558550	rs12772092	A	C	2	5	7	0	0	7	0	0
10	32559859	rs3006614	A	G	6	1	7	0	0	7	0	0
10	32561648	rs2104619	G	A	7	4	11	0	0	11	0	0
10	32564594	rs3124225	T	C	6	1	7	0	0	7	0	0
10	32571849	rs2182820	A	C	6	3	9	0	0	9	0	0
10	32571852	rs2182821	A	T	6	3	9	0	0	9	0	0
10	32572518	rs2094463	T	C	8	8	16	0	0	16	0	0
10	32580205	rs72789797	C	T	84	74	158	0	1	159	0	0
10	32634991	rs12261018	C	T	60	30	90	0	0	90	0	0
10	32635971	rs7897530	G	C	237	234	471	0	2	473	0	0
10	32651861	rs2505349	T	C	2	4	6	0	0	6	0	0
10	35299085	rs1131510	C	T	43	44	87	0	0	87	0	0
10	36812362	rs2503084	C	T	77	0	77	0	0	77	0	0
10	43012693	rs210236	T	C	4	4	8	0	0	8	0	0
10	43047958	rs210267	A	G	2	4	6	0	0	6	0	0
10	43292647	rs787795	A	G	15	17	32	0	0	32	0	0
10	43636862	rs183060485	A	G	5	3	8	0	0	8	0	0
10	43647258	rs75970561	G	A	6	0	6	0	0	6	0	0
10	43650915	rs41298781	C	T	214	152	366	0	3	369	0	0
10	43654194	rs35718664	A	G	211	169	380	0	3	383	0	0
10	43656475	rs75694158	A	G	24	21	45	0	2	47	0	0
10	43657811	rs2257767	T	G	31	16	47	0	0	47	0	0
10	43658265	rs76468668	T	C	42	22	64	0	0	64	0	0
10	43660860	rs75472595	T	G	5	3	8	0	0	8	0	0
10	43660995	rs76169834	C	T	18	11	29	0	0	29	0	0
10	43661214	rs147524812	G	A	22	14	36	0	1	37	0	0
10	43661836	rs2435337	G	C	35	22	57	0	0	57	0	0
10	43661891	rs79636561	A	G	22	22	44	0	0	44	0	0
10	43663665	rs140316499	T	C	5	4	9	0	0	9	0	0
10	43666016	rs2505557	C	T	8	3	11	0	0	11	0	0
10	43666195	rs75574954	G	A	12	8	20	0	0	20	0	0
10	43666872	rs116931908	C	T	11	6	17	0	1	18	0	0
10	43667398	rs2503863	G	A	8	5	13	0	0	13	0	0
10	43669190	rs2003317	G	C	4	4	8	0	0	8	0	0
10	43669835	rs74538500	C	T	9	7	16	0	0	16	0	0
10	43675671	rs2435383	T	C	4	4	8	0	0	8	0	0
10	43676852	rs76471484	C	A	5	3	8	0	0	8	0	0
10	43679800	rs1059484	T	G	182	148	330	0	1	331	0	0
10	43680228	rs144715082	G	A	81	53	134	0	0	134	0	0
10	43690253	rs11238472	C	T	8	4	12	0	0	12	0	0
10	43690391	rs1254967	G	A	12	9	21	0	0	21	0	0
10	43691691	rs1254968	C	T	11	15	26	0	0	26	0	0
10	43696279	rs41301585	A	G	11	10	21	0	0	21	0	0
10	43881094	rs1126709	T	G	4	3	7	0	0	7	0	0
10	43883342	rs1126487	T	A	204	209	413	0	5	418	0	0
10	43883645	rs10793430	G	T	2	7	9	0	0	9	0	0
10	43883758	rs75513862	T	C	3	3	6	0	0	6	0	0
10	43888193	rs17153617	G	A	1	6	7	0	0	7	0	0
10	43890151	rs17153622	G	A	4	3	7	0	0	7	0	0
10	43891378	rs76889847	C	T	3	3	6	0	0	6	0	0
10	43903732	rs148243209	C	T	4	3	7	0	0	7	0	0
10	43916493	rs2066044	T	C	5	2	7	0	0	7	0	0
10	43932542	rs114589475	C	T	5	1	6	0	0	6	0	0
10	43978087	rs3750890	A	G	5	6	11	0	0	11	0	0
10	44144898	rs10899849	T	G	3	3	6	0	0	6	0	0
10	44145012	rs10899850	G	T	5	1	6	0	0	6	0	0
10	45455227	rs12773699	T	C	7	5	12	0	0	12	0	0
10	45486634	.	A	C	5	9	14	0	0	14	0	0
10	45950992	.	G	C	51	45	96	0	0	96	0	0
10	46134784	rs35599803	T	G	3	3	6	0	0	6	0	0
10	46254201	rs371471717	G	A	8	7	15	0	0	15	0	0
10	46280791	.	C	G	5	1	6	0	0	6	0	0
10	47416908	.	A	G	8	2	10	0	0	10	0	0
10	47420614	rs61843707	G	A	3	7	10	0	0	10	0	0
10	47640726	rs11259761	C	T	25	0	25	0	0	25	0	0
10	47640757	rs11259762	T	C	21	0	21	0	1	22	0	0
10	48235892	.	C	T	4	8	12	0	0	12	0	0
10	49239513	rs138900870	C	A	11	0	11	0	0	11	0	0
10	49538435	rs56274242	T	C	3	3	6	0	0	6	0	0
10	49542380	rs10745269	C	T	5	2	7	0	0	7	0	0
10	49542733	rs10776596	A	C	6	5	11	0	0	11	0	0
10	49643570	rs9284	T	G	59	59	118	0	0	118	0	0
10	49644416	rs8428	T	C	12	8	20	0	0	20	0	0
10	49654195	rs1051509	A	G	16	18	34	0	0	34	0	0
10	49654342	rs1051508	C	T	28	17	45	0	0	45	0	0
10	49654403	rs1051507	C	T	22	14	36	0	0	36	0	0
10	49687800	rs4080665	G	A	12	4	16	0	0	16	0	0
10	50025396	rs7097397	G	A	19	28	47	0	0	47	0	0
10	50038800	rs3747874	A	G	30	36	66	0	0	66	0	0
10	50040722	rs12761517	C	A	27	35	62	0	0	62	0	0
10	50086944	rs17699605	G	A	5	4	9	0	0	9	0	0
10	50109895	rs35423873	A	C	29	32	61	0	1	62	0	0
10	50171949	rs41283297	C	T	20	25	45	0	1	46	0	0
10	50183042	rs61733240	G	A	55	48	103	0	1	104	0	0
10	50184949	rs2271565	C	T	68	76	144	0	0	144	0	0
10	50186415	rs2292584	C	T	49	62	111	0	2	113	0	0
10	50190799	rs1054553	C	T	65	71	136	0	0	136	0	0
10	50665031	rs11101137	A	G	7	4	11	0	0	11	0	0
10	50681033	rs2229760	G	A	3	4	7	0	0	7	0	0
10	50727356	rs2281792	T	C	4	2	6	0	0	6	0	0
10	50727542	rs2281793	C	T	4	4	8	0	0	8	0	0
10	50728420	rs2281794	T	C	4	2	6	0	0	6	0	0
10	50732280	rs2228528	C	T	19	11	30	0	0	30	0	0
10	50733075	rs4253043	C	A	8	3	11	0	0	11	0	0
10	50740600	rs4253013	C	T	32	27	59	0	0	59	0	0
10	50740876	rs2228524	G	C	23	19	42	0	1	43	0	0
10	50747071	rs4253005	C	A	9	10	19	0	0	19	0	0
10	51274153	.	C	A	0	6	6	0	0	6	0	0
10	51573474	rs72795888	G	A	6	0	6	0	0	6	0	0
10	51580410	rs72795895	C	A	6	5	11	0	0	11	0	0
10	51582894	rs41306524	C	T	728	758	1486	0	6	1493	1	0
10	51587237	rs56148635	G	A	23	17	40	0	0	40	0	0
10	51589581	rs11548236	C	G	404	368	772	0	11	783	0	0
10	51592727	rs72797707	C	G	22	17	39	0	0	39	0	0
10	51593354	rs7085433	G	A	53	37	90	0	0	90	0	0
10	51593577	.	T	C	11	9	20	0	2	22	0	0
10	51594462	rs7350420	T	C	8	11	19	0	0	19	0	0
10	51595719	.	T	C	12	15	27	0	0	27	0	0
10	51607441	.	T	C	7	5	12	0	0	12	0	0
10	51607552	.	C	T	9	3	12	0	0	12	0	0
10	51607599	.	G	A	5	2	7	0	0	7	0	0
10	51607952	.	T	C	11	1	12	0	0	12	0	0
10	51607980	.	G	A	11	1	12	0	0	12	0	0
10	51608062	.	T	C	3	3	6	0	0	6	0	0
10	51608082	.	G	A	3	3	6	0	0	6	0	0
10	51623147	.	C	T	6	8	14	0	0	14	0	0
10	51623174	.	C	A	5	9	14	0	0	14	0	0
10	51623190	.	T	C	4	9	13	0	1	14	0	0
10	51632906	.	G	A	3	4	7	0	0	7	0	0
10	51632971	.	A	G	6	5	11	0	0	11	0	0
10	51633027	.	T	C	15	8	23	0	0	23	0	0
10	51723270	rs12778942	C	T	5	3	8	0	0	8	0	0
10	51723277	rs12764268	A	T	6	2	8	0	1	9	0	0
10	51723773	rs137943880	G	A	2	4	6	0	0	6	0	0
10	51723779	rs149455167	C	T	2	4	6	0	0	6	0	0
10	51724692	.	C	T	4	3	7	0	0	7	0	0
10	51726214	rs146855742	T	C	5	4	9	0	0	9	0	0
10	51727785	.	C	T	3	3	6	0	0	6	0	0
10	51728101	rs61847131;rs75513388	A	G	4	3	7	0	1	8	0	0
10	51728462	rs56411646	G	A	7	1	8	0	0	8	0	0
10	51734153	rs370799782	A	T	23	21	44	0	0	44	0	0
10	51769562	rs201341309	G	A	17	23	40	0	0	40	0	0
10	51769670	rs201151847	C	T	17	16	33	0	0	33	0	0
10	51859758	.	A	G	25	1	26	0	0	26	0	0
10	52094616	rs1436212	G	T	4	3	7	0	0	7	0	0
10	52094626	rs1436213	C	T	4	3	7	0	0	7	0	0
10	52094647	rs1436214	T	C	6	3	9	0	0	9	0	0
10	52103707	rs10763354	A	G	8	7	15	0	0	15	0	0
10	54148888	rs1194667	C	A	6	0	6	0	0	6	0	0
10	54148923	rs1194666	G	A	7	0	7	0	0	7	0	0
10	54149243	rs6480837	A	C	5	2	7	0	0	7	0	0
10	54171706	rs7893873	G	T	2	6	8	0	0	8	0	0
10	54210641	rs12570796	A	G	3	6	9	0	0	9	0	0
10	54373862	rs10824676	G	A	18	20	38	0	0	38	0	0
10	54373889	rs10824677	T	C	18	17	35	0	0	35	0	0
10	54513596	rs1017525	T	C	7	9	16	0	0	16	0	0
10	58118630	rs2241666	T	C	20	19	39	0	1	40	0	0
10	60147270	rs10826178	G	A	2	4	6	0	0	6	0	0
10	60147784	rs10763537	G	A	3	3	6	0	0	6	0	0
10	60151026	rs10826179	A	G	1	5	6	0	0	6	0	0
10	60155120	rs1049432	G	T	83	85	168	0	1	169	0	0
10	60156584	rs11006133	G	A	12	15	27	0	0	27	0	0
10	60157339	rs7089361	C	T	9	12	21	0	0	21	0	0
10	60158385	rs12259591	G	A	6	2	8	0	0	8	0	0
10	60158446	rs12254586	T	C	7	4	11	0	0	11	0	0
10	61549215	rs1127327	C	A	57	44	101	0	7	108	0	0
10	61549818	rs11540401	A	G	93	129	222	0	1	223	0	0
10	61551428	rs10821594	T	C	5	5	10	0	0	10	0	0
10	61552692	rs1053266	G	T	160	112	272	0	0	272	0	0
10	61665886	rs1171830	C	A	75	86	161	0	1	162	0	0
10	62553763	rs1871446	A	G	3	4	7	0	0	7	0	0
10	63661340	rs4509706	T	C	2	5	7	0	0	7	0	0
10	63662458	.	G	A	12	9	21	0	0	21	0	0
10	63663395	rs74868128	A	G	4	9	13	0	0	13	0	0
10	63664036	rs36082697	G	T	2	6	8	0	0	8	0	0
10	63738081	rs10994992	T	A	5	1	6	0	0	6	0	0
10	63738083	rs10994993	A	G	5	1	6	0	0	6	0	0
10	63809527	rs10740059	G	A	2	4	6	0	0	6	0	0
10	63811678	rs10821949	T	C	14	13	27	0	2	29	0	0
10	63811967	rs10821950	T	C	4	4	8	0	0	8	0	0
10	63812294	rs75964285	A	G	26	17	43	0	0	43	0	0
10	63846025	rs7913651	C	A	8	10	18	0	1	19	0	0
10	63846156	rs7914112	G	A	6	9	15	0	0	15	0	0
10	63846361	rs7914048	A	G	2	8	10	0	1	11	0	0
10	63846886	rs145947185	G	A	5	3	8	0	0	8	0	0
10	63847284	rs7903722	T	C	2	5	7	0	0	7	0	0
10	63847565	rs7919088	G	A	6	3	9	0	0	9	0	0
10	63847731	rs9415638	C	A	2	5	7	0	0	7	0	0
10	63847832	rs148989466	G	A	6	3	9	0	0	9	0	0
10	63847883	rs10761605	C	T	1	8	9	0	0	9	0	0
10	63847888	rs10761606	C	T	2	8	10	0	0	10	0	0
10	63847895	rs10761607	A	G	2	8	10	0	0	10	0	0
10	63847904	rs10761608	G	A	3	9	12	0	0	12	0	0
10	63848456	rs9415639	C	G	7	5	12	0	2	14	0	0
10	63848656	rs9414761	C	T	6	4	10	0	0	10	0	0
10	63848923	rs9415640	G	A	4	7	11	0	0	11	0	0
10	63849790	rs7913907	A	G	8	9	17	0	0	17	0	0
10	63850049	rs2393727	A	G	8	12	20	0	0	20	0	0
10	63852965	rs4948506	C	G	133	107	240	0	1	241	0	0
10	63856070	rs140702604	T	C	81	64	145	0	0	145	0	0
10	64914372	rs13095	G	C	12	24	36	0	0	36	0	0
10	64927823	rs1935	C	G	314	261	575	0	6	581	0	0
10	64932779	rs1904296	C	G	35	20	55	0	0	55	0	0
10	64933268	rs4466712	G	C	28	25	53	0	0	53	0	0
10	64934331	rs10995453	T	C	20	25	45	0	0	45	0	0
10	64934548	rs10822145	C	T	17	16	33	0	1	34	0	0
10	64936361	rs10995455	G	A	5	3	8	0	0	8	0	0
10	64936679	rs907	A	G	3	3	6	0	0	6	0	0
10	64945364	rs3211105	G	A	181	206	387	0	3	390	0	0
10	64955767	rs148821160	C	T	4	2	6	0	0	6	0	0
10	64956607	rs61855465	A	T	5	5	10	0	0	10	0	0
10	64960755	rs117286393	A	C	1	5	6	0	0	6	0	0
10	64961412	rs7895472	G	A	10	10	20	0	0	20	0	0
10	64961659	rs7895610	C	T	14	9	23	0	0	23	0	0
10	64964148	rs12413730	C	T	5	6	11	0	0	11	0	0
10	64970448	rs1579045	G	A	103	89	192	0	2	194	0	0
10	64972176	rs7920159	C	G	23	39	62	0	0	62	0	0
10	64974537	rs10761725	A	T	80	66	146	0	0	146	0	0
10	64976297	rs10822147	C	T	4	2	6	0	0	6	0	0
10	70100196	rs1162758	C	T	22	9	31	0	0	31	0	0
10	70104567	rs41278506	T	G	12	5	17	0	0	17	0	0
10	70661532	rs10998478	C	T	5	6	11	0	0	11	0	0
10	70661571	rs10998479	C	T	4	2	6	0	0	6	0	0
10	70666068	rs118051852	G	C	16	14	30	0	0	30	0	0
10	70696818	rs61743874	C	T	69	64	133	0	2	135	0	0
10	70700944	rs5030900	A	G	96	84	180	0	0	180	0	0
10	70730440	rs142601088	G	T	3	10	13	0	0	13	0	0
10	70730628	rs12411932	C	T	11	6	17	0	0	17	0	0
10	70731286	rs74139951	G	T	12	13	25	0	0	25	0	0
10	70732545	rs10998511	C	T	13	17	30	0	0	30	0	0
10	70735135	rs7908750	C	T	4	6	10	0	0	10	0	0
10	70742192	rs2251911	T	G	5	2	7	0	0	7	0	0
10	70742931	rs12412103	A	G	165	158	323	0	2	325	0	0
10	70743422	rs4554	G	A	143	130	273	0	12	285	0	0
10	70749644	rs79521970	G	A	8	3	11	0	0	11	0	0
10	70849959	rs2855022	G	A	28	24	52	0	0	52	0	0
10	70850195	rs2805906	C	G	21	23	44	0	0	44	0	0
10	70856455	rs2805907	G	A	4	6	10	0	0	10	0	0
10	70856473	rs75467312	T	C	11	4	15	0	0	15	0	0
10	70856510	rs2855020	C	T	7	15	22	0	0	22	0	0
10	70856852	rs2229498	G	A	1409	1222	2631	0	12	2643	0	0
10	70857215	rs2805911	G	C	9	3	12	0	1	13	0	0
10	70857221	rs2855021	C	T	10	3	13	0	0	13	0	0
10	70857278	rs2805912	G	A	10	2	12	0	0	12	0	0
10	70858062	rs2805913	T	C	23	22	45	0	0	45	0	0
10	70859204	rs10998572	C	A	15	26	41	0	0	41	0	0
10	70859291	rs2805914	A	G	23	25	48	0	0	48	0	0
10	70860475	rs2008553	C	G	28	13	41	0	0	41	0	0
10	70860599	rs2008541	A	G	17	18	35	0	0	35	0	0
10	70861859	rs12412035	T	C	25	26	51	0	0	51	0	0
10	70863184	rs10998573	A	G	4	4	8	0	0	8	0	0
10	70864065	rs12437	T	C	241	199	440	0	5	445	0	0
10	70864397	rs7377	G	T	1188	1069	2257	0	4	2261	0	0
10	70926902	rs10998615	G	A	5	3	8	0	0	8	0	0
10	70932191	rs11552063	A	C	71	68	139	0	0	139	0	0
10	70952031	rs10823312	A	G	7	14	21	0	0	21	0	0
10	70952115	rs10823313	G	A	3	5	8	0	0	8	0	0
10	70952758	rs12414176	C	T	15	12	27	0	0	27	0	0
10	70954234	rs12244906	A	C	7	5	12	0	0	12	0	0
10	70954375	rs12267611	T	G	5	11	16	0	0	16	0	0
10	70954661	rs906217	T	C	4	11	15	0	0	15	0	0
10	70959027	rs2271096	A	C	7	8	15	0	0	15	0	0
10	70959282	rs4342912	T	C	11	14	25	0	0	25	0	0
10	70959617	rs10733850	C	T	5	5	10	0	0	10	0	0
10	70959710	rs1506769	T	C	9	9	18	0	0	18	0	0
10	71143951	rs2305197	T	C	3	16	19	0	0	19	0	0
10	71152886	rs12098572	C	T	6	0	6	0	0	6	0	0
10	71152967	rs4746850	C	T	2	5	7	0	0	7	0	0
10	71153066	rs28510843	C	T	3	4	7	0	0	7	0	0
10	71153722	rs3793845	G	T	4	2	6	0	0	6	0	0
10	71153882	rs3793846	C	T	5	3	8	0	0	8	0	0
10	71155835	rs10762291	C	T	5	3	8	0	0	8	0	0
10	71158268	rs1227938	C	T	2	5	7	0	2	9	0	0
10	71164655	rs2229170	C	T	4	4	8	0	0	8	0	0
10	71874683	rs2271696	G	A	6	2	8	0	0	8	0	0
10	71874734	rs2271695	G	A	8	3	11	0	1	12	0	0
10	71874866	rs61736904	T	C	3	4	7	0	0	7	0	0
10	71910630	rs1046747	G	A	117	131	248	0	2	250	0	0
10	71910663	rs15801	C	T	129	118	247	0	2	249	0	0
10	71912664	rs4746023	G	A	9	5	14	0	1	15	0	0
10	71919188	rs10823491	G	A	6	6	12	0	1	13	0	0
10	71919271	rs10999165	G	A	7	3	10	0	0	10	0	0
10	71921591	rs2271690	G	A	4	7	11	0	0	11	0	0
10	71925446	rs6480443	T	C	7	8	15	0	0	15	0	0
10	71926620	rs10159731	G	A	12	12	24	0	0	24	0	0
10	71928995	rs3858169	T	G	6	4	10	0	0	10	0	0
10	71929746	rs870801	C	A	12	3	15	0	0	15	0	0
10	71966819	rs9415004	C	T	3	4	7	0	0	7	0	0
10	71971554	rs2184334	G	A	6	1	7	0	0	7	0	0
10	71972828	rs2151834	T	C	5	1	6	0	0	6	0	0
10	72171244	rs35914122	G	A	6	4	10	0	0	10	0	0
10	72171579	rs36038032	C	A	9	4	13	0	0	13	0	0
10	72176133	rs34843983	G	A	7	6	13	0	0	13	0	0
10	72181802	rs7093504	G	C	106	63	169	0	0	169	0	0
10	72182030	rs4746035	A	G	98	61	159	0	1	160	0	0
10	72184188	rs4279932	T	A	3	6	9	0	0	9	0	0
10	72185771	rs140685571	A	G	5	7	12	0	0	12	0	0
10	72188189	rs7784	T	C	6	10	16	0	0	16	0	0
10	72289256	rs56017067	A	T	5	3	8	0	0	8	0	0
10	72289778	rs2275060	C	T	15	10	25	0	0	25	0	0
10	72290449	rs7475451	C	T	2	4	6	0	0	6	0	0
10	72326400	rs10999406	G	A	8	15	23	0	0	23	0	0
10	72358577	rs885822	G	A	12	13	25	0	2	27	0	0
10	72358655	rs885821	G	A	14	12	26	0	0	26	0	0
10	72575861	.	A	C	21	21	42	0	0	42	0	0
10	72622985	rs7907169	C	T	1	5	6	0	0	6	0	0
10	72637176	rs77332227	T	A	34	26	60	0	0	60	0	0
10	72639621	rs877034	C	T	45	25	70	0	0	70	0	0
10	73062149	rs12262480	A	C	2	5	7	0	0	7	0	0
10	73082563	rs2277257	A	G	3	3	6	0	1	7	0	0
10	73499561	rs10762474	C	G	4	3	7	0	0	7	0	0
10	73504129	rs75920512	C	A	3	3	6	0	0	6	0	0
10	73505161	rs79657570	C	T	7	10	17	0	0	17	0	0
10	73505702	rs72642240	T	G	7	7	14	0	0	14	0	0
10	73506272	rs12255880	T	C	8	8	16	0	0	16	0	0
10	73506359	rs80005036	C	T	6	9	15	0	0	15	0	0
10	73506514	rs12248205	C	A	4	10	14	0	0	14	0	0
10	73507183	rs10740388	G	A	4	7	11	0	0	11	0	0
10	73507645	rs1055518	T	C	554	621	1175	0	16	1191	0	0
10	73508791	rs748113	T	C	489	333	822	0	5	827	0	0
10	73512373	rs7074978	C	T	67	57	124	0	4	128	0	0
10	73512933	rs3747857	G	A	60	57	117	0	1	118	0	0
10	73513902	rs10999983	C	G	18	20	38	0	1	39	0	0
10	73514364	rs7084874	G	A	39	22	61	0	0	61	0	0
10	73514554	rs7908979	A	G	41	44	85	0	0	85	0	0
10	73515103	rs3747858	G	T	21	19	40	0	1	41	0	0
10	73515662	rs6480552	T	C	18	18	36	0	2	38	0	0
10	73517225	rs9415995	C	T	23	26	49	0	1	50	0	0
10	73517520	rs10823840	G	A	14	20	34	0	0	34	0	0
10	73520391	rs10999987	C	T	21	19	40	0	0	40	0	0
10	73520828	rs3747868	G	T	10	13	23	0	0	23	0	0
10	73521371	rs3747867	C	T	1239	1100	2339	0	76	2415	0	0
10	73522694	rs9415039	T	C	76	79	155	0	1	156	0	0
10	73522768	rs9415040	G	A	64	76	140	0	1	141	0	0
10	73522929	rs7909934	T	G	26	39	65	0	0	65	0	0
10	73524184	rs9415041	G	A	25	22	47	0	0	47	0	0
10	73524368	rs9415996	G	A	42	37	79	0	0	79	0	0
10	73524622	rs2894169	A	G	22	35	57	0	0	57	0	0
10	73525525	rs7919533	T	C	20	22	42	0	1	43	0	0
10	73526202	rs2121538	G	A	33	28	61	0	1	62	0	0
10	73526292	rs6480554	C	G	35	37	72	0	0	72	0	0
10	73527925	rs7075746	T	C	38	19	57	0	1	58	0	0
10	73528301	rs7076317	T	C	17	18	35	0	1	36	0	0
10	73529295	rs10823841	G	T	8	11	19	0	0	19	0	0
10	73529327	rs76959136	C	T	20	20	40	0	0	40	0	0
10	73529329	rs77919471	A	G	20	20	40	0	0	40	0	0
10	73529332	rs111625591	A	G	20	23	43	0	0	43	0	0
10	73529341	rs4747187	A	C	19	28	47	0	1	48	0	0
10	73530939	rs7905535	G	A	31	36	67	0	0	67	0	0
10	73533177	rs3747862	A	G	595	591	1186	0	6	1193	1	0
10	73576307	rs7869	C	T	881	755	1636	0	4	1640	0	0
10	73577626	rs9415054	A	T	17	14	31	0	2	33	0	0
10	73578159	rs10762482	A	T	9	12	21	0	1	22	0	0
10	73578503	rs885828	G	A	7	15	22	0	0	22	0	0
10	73578672	rs749823	G	A	9	14	23	0	0	23	0	0
10	73578882	rs4747203	T	C	5	27	32	0	0	32	0	0
10	73579217	rs11000016	C	T	9	28	37	0	0	37	0	0
10	73579405	rs3747860	C	T	7	9	16	0	0	16	0	0
10	73581076	rs9416009	C	A	4	3	7	0	0	7	0	0
10	73582034	rs9415055	G	A	22	14	36	0	0	36	0	0
10	73582752	rs727415	T	A	3	8	11	0	0	11	0	0
10	73582781	rs727414	G	T	2	4	6	0	2	8	0	0
10	73584245	rs11000017	G	C	9	14	23	0	0	23	0	0
10	73584426	rs1015193	T	C	6	6	12	0	0	12	0	0
10	73610982	rs2070188	G	A	322	337	659	0	3	662	0	0
10	74767617	.	C	T	61	0	61	0	0	61	0	0
10	74767618	.	A	G	60	0	60	0	0	60	0	0
10	74767652	.	G	A	51	0	51	0	0	51	0	0
10	74767669	.	C	T	46	0	46	0	0	46	0	0
10	74767680	.	A	G	52	0	52	0	0	52	0	0
10	74767686	.	G	A	51	0	51	0	1	52	0	0
10	75142187	rs143611609	A	G	3	4	7	0	0	7	0	0
10	75431675	rs11000743	T	G	4	2	6	0	0	6	0	0
10	75473052	rs10762558	G	A	5	4	9	0	0	9	0	0
10	75487081	rs7099599	C	T	2	5	7	0	0	7	0	0
10	75490217	rs11814282	T	C	4	6	10	0	0	10	0	0
10	75496161	rs12253429	C	G	1	5	6	0	0	6	0	0
10	75506674	rs2306325	T	C	46	60	106	0	0	106	0	0
10	75524021	rs60809795	G	A	3	4	7	0	0	7	0	0
10	75524802	rs10762563	C	A	9	5	14	0	0	14	0	0
10	75525407	rs112950248	A	G	3	4	7	0	0	7	0	0
10	75527197	rs4746146	C	T	3	9	12	0	0	12	0	0
10	75527708	rs4746147	A	G	55	44	99	0	0	99	0	0
10	75528130	rs10824032	G	A	5	12	17	0	1	18	0	0
10	75530013	rs3088070	C	T	16	23	39	0	0	39	0	0
10	75530962	rs11541237	C	T	69	73	142	0	3	145	0	0
10	75539010	rs11000775	T	C	1	8	9	0	0	9	0	0
10	75539598	rs78790589	G	A	0	6	6	0	0	6	0	0
10	75539812	rs4082339	T	C	5	14	19	0	0	19	0	0
10	75549916	rs2292307	C	A	1	5	6	0	0	6	0	0
10	75554541	rs7908825	C	G	1	5	6	0	0	6	0	0
10	75559077	rs11000780	G	A	50	53	103	0	1	104	0	0
10	75562108	rs2075641	G	A	104	112	216	0	1	217	0	0
10	75562161	rs13013	C	A	118	118	236	0	0	236	0	0
10	75565935	rs4746150	A	G	1	9	10	0	0	10	0	0
10	75566829	rs4114992	A	G	29	34	63	0	0	63	0	0
10	75573088	.	T	C	123	116	239	0	1	240	0	0
10	75573778	rs2306327	A	T	110	114	224	0	1	225	0	0
10	75574079	rs1057410	G	A	12	3	15	0	0	15	0	0
10	75576366	rs12262649	C	T	14	18	32	0	0	32	0	0
10	75576374	rs12262650	C	A	14	17	31	0	1	32	0	0
10	75576405	rs12220394	G	C	15	12	27	0	0	27	0	0
10	75576483	rs12217245	T	C	19	20	39	0	0	39	0	0
10	75577843	rs7080350	G	A	11	5	16	0	0	16	0	0
10	75578318	.	G	A	5	5	10	0	0	10	0	0
10	75578720	rs4746151	G	T	8	8	16	0	1	17	0	0
10	75579510	rs2306328	C	T	6	7	13	0	0	13	0	0
10	75580042	rs7098444	C	T	13	18	31	0	0	31	0	0
10	75632760	rs2675671	C	T	71	47	118	0	1	119	0	0
10	75672378	rs2227558	G	T	3	4	7	0	0	7	0	0
10	75673731	rs2227566	C	T	11	11	22	0	1	23	0	0
10	75673879	rs2227568	C	T	103	91	194	0	3	197	0	0
10	75674740	rs2227571	C	T	29	14	43	0	0	43	0	0
10	75676464	rs4065	C	T	120	94	214	0	1	215	0	0
10	75791639	rs10824058	G	A	4	3	7	0	0	7	0	0
10	75864372	rs2131959	G	C	5	5	10	0	0	10	0	0
10	75865065	rs767809	G	A	60	52	112	0	1	113	0	0
10	75869065	rs2270551	T	C	20	20	40	0	1	41	0	0
10	75869938	rs12415418	A	G	11	11	22	0	0	22	0	0
10	75870890	rs16931177	C	G	26	25	51	0	0	51	0	0
10	75871735	rs2131956	C	G	25	21	46	0	0	46	0	0
10	75873165	rs34885185	C	T	16	31	47	0	1	48	0	0
10	75873639	rs10824071	C	T	33	38	71	0	0	71	0	0
10	75873892	rs10824072	C	T	35	28	63	0	0	63	0	0
10	75879511	rs703258	T	A	78	112	190	0	0	190	0	0
10	75880424	rs6480717	C	T	4	10	14	0	0	14	0	0
10	75881676	rs6688	G	A	43	36	79	0	0	79	0	0
10	75883394	rs184307043	G	A	32	22	54	0	1	55	0	0
10	75936611	rs10824095	C	T	51	40	91	0	1	92	0	0
10	75965255	rs7896617	A	G	2	4	6	0	0	6	0	0
10	75965672	rs12359146	A	C	3	3	6	0	0	6	0	0
10	75978943	rs187333189	G	A	6	0	6	0	1	7	0	0
10	75980572	rs11000928	T	C	4	5	9	0	0	9	0	0
10	75981328	rs10762585	T	C	8	6	14	0	0	14	0	0
10	75981540	.	G	A	6	2	8	0	0	8	0	0
10	76003073	rs6480727	C	T	3	4	7	0	0	7	0	0
10	76468851	rs1189553	C	T	3	3	6	0	0	6	0	0
10	76762890	rs17714745	A	T	2	4	6	0	0	6	0	0
10	76938263	rs2804529	T	A	21	27	48	0	1	49	0	0
10	76939342	rs1910870	T	A	7	10	17	0	0	17	0	0
10	76939773	rs2135164	C	G	21	29	50	0	6	68	12	0
10	76940216	rs1989667	A	G	27	26	53	0	0	53	0	0
10	76970613	rs11543	G	C	194	73	267	0	0	267	0	0
10	76982863	rs1259497	T	C	8	2	10	0	0	10	0	0
10	76986741	rs1259498	T	C	4	4	8	0	0	8	0	0
10	76988066	rs1259499	T	G	6	10	16	0	3	19	0	0
10	76990113	rs1259500	A	G	4	4	8	0	1	9	0	0
10	76990185	rs1259501	G	A	12	17	29	0	0	29	0	0
10	77807027	rs1898071	T	C	17	12	29	0	0	29	0	0
10	79552092	rs2165046	C	T	4	4	8	0	0	8	0	0
10	79552107	rs1058203	G	A	5	3	8	0	0	8	0	0
10	79579222	rs1248634	G	A	14	12	26	0	0	26	0	0
10	79579251	rs2289308	G	A	5	7	12	0	0	12	0	0
10	79769647	rs34588967	C	A	8	6	14	0	0	14	0	0
10	80853508	rs1250013	C	T	4	3	7	0	0	7	0	0
10	80853575	rs753271	A	G	4	4	8	0	0	8	0	0
10	80854025	rs946716	G	A	3	5	8	0	0	8	0	0
10	80856901	rs7079181	G	A	3	4	7	0	0	7	0	0
10	80857828	rs4564274	T	C	2	4	6	0	0	6	0	0
10	80859755	rs56038371	A	G	3	3	6	0	1	7	0	0
10	80863226	rs11597192	T	C	1	6	7	0	0	7	0	0
10	80863610	rs7083272	A	G	2	4	6	0	0	6	0	0
10	80864015	.	C	T	7	9	16	0	0	16	0	0
10	80864094	rs946009	C	T	4	4	8	0	0	8	0	0
10	81000520	rs2025629	A	C	6	3	9	0	0	9	0	0
10	81004948	rs11002889	C	T	6	9	15	0	0	15	0	0
10	81007151	rs10824730	A	G	4	6	10	0	0	10	0	0
10	81008483	rs1408944	A	G	3	5	8	0	0	8	0	0
10	81009237	rs10824731	C	T	6	5	11	0	0	11	0	0
10	81009788	rs10824732	G	A	7	10	17	0	0	17	0	0
10	81010281	rs1250598	C	T	6	8	14	0	0	14	0	0
10	81010623	rs1250599	G	A	7	10	17	0	0	17	0	0
10	81011589	rs11002892	C	T	4	13	17	0	0	17	0	0
10	81011673	rs1250602	G	A	8	5	13	0	0	13	0	0
10	81013096	rs10762855	T	C	10	6	16	0	0	16	0	0
10	81013421	rs4980052	G	A	10	6	16	0	0	16	0	0
10	81014170	rs75318397	C	T	11	5	16	0	2	18	0	0
10	81014299	rs2031517	G	T	7	12	19	0	0	19	0	0
10	81015896	rs11593576	C	T	4	11	15	0	0	15	0	0
10	81016209	rs1250534	G	C	13	15	28	0	0	28	0	0
10	81019059	rs11002897	G	C	7	11	18	0	0	18	0	0
10	81020402	rs7908992	T	G	12	18	30	0	0	30	0	0
10	81069268	rs942790	G	C	7	13	20	0	0	20	0	0
10	81069413	rs942789	A	G	7	13	20	0	0	20	0	0
10	81073515	rs3824718	C	G	355	359	714	0	3	717	0	0
10	81074816	rs3740259	G	A	315	346	661	0	4	665	0	0
10	81108482	rs6480931	T	C	37	43	80	0	0	80	0	0
10	81108956	rs2233718	A	G	13	10	23	0	0	23	0	0
10	81109708	rs2000404	T	C	134	131	265	0	0	265	0	0
10	81110307	rs1316313	C	T	159	180	339	0	8	347	0	0
10	81110417	rs1316312	G	C	129	121	250	0	4	254	0	0
10	81111036	rs876678	G	T	29	28	57	0	0	57	0	0
10	81114060	rs7332	G	A	1108	1110	2218	0	9	2227	0	0
10	81114813	rs8837	C	G	291	399	690	0	4	694	0	0
10	81114959	rs7898	C	T	248	286	534	0	1	535	0	0
10	81142365	rs6858	C	T	6	2	8	0	0	8	0	0
10	81425263	.	G	A	7	0	7	0	0	7	0	0
10	81425282	.	A	G	6	0	6	0	0	6	0	0
10	81425315	.	G	A	8	0	8	0	0	8	0	0
10	81425324	.	C	G	8	0	8	0	0	8	0	0
10	81451545	rs1048903	A	G	9	0	9	0	0	9	0	0
10	81471458	.	A	C	5	2	7	0	0	7	0	0
10	81508444	rs145295177	A	G	1	6	7	0	0	7	0	0
10	81841692	rs1932574	G	T	4	8	12	0	0	12	0	0
10	81851731	rs11201641	T	C	8	10	18	0	0	18	0	0
10	81918776	rs112550067	C	A	10	11	21	0	0	21	0	0
10	81941179	rs34613979	T	C	26	6	32	0	0	32	0	0
10	82272189	rs75442315	T	C	11	13	24	0	1	25	0	0
10	82274574	rs55992253	G	A	4	4	8	0	0	8	0	0
10	82278163	rs117485833	C	T	158	157	315	0	3	318	0	0
10	82279960	rs873258	C	T	101	101	202	0	5	207	0	0
10	82282751	rs2138285	G	A	3	5	8	0	0	8	0	0
10	85900174	rs11593984	G	T	25	18	43	0	0	43	0	0
10	85900245	rs12570814	G	A	34	25	59	0	3	62	0	0
10	85900580	rs10887240	T	G	14	17	31	0	0	31	0	0
10	85900834	rs11200880	T	C	18	18	36	0	0	36	0	0
10	85901942	rs11200881	A	G	45	32	77	0	1	78	0	0
10	85902394	rs3816716	G	C	36	30	66	0	0	66	0	0
10	85903888	rs10887241	G	A	10	5	15	0	0	15	0	0
10	85905705	rs12413307	G	A	6	10	16	0	0	16	0	0
10	85906102	rs12412411	T	A	31	18	49	0	0	49	0	0
10	85907779	rs11595523	G	A	2	4	6	0	0	6	0	0
10	85908079	rs4933310	C	T	9	13	22	0	0	22	0	0
10	85910852	rs4933311	C	G	3	3	6	0	0	6	0	0
10	85910956	rs10887246	T	G	3	3	6	0	0	6	0	0
10	85912606	rs7576	A	C	236	245	481	0	1	483	1	0
10	86274302	rs11915	C	G	17	19	36	0	0	36	0	0
10	86274871	rs2784846	C	T	3	4	7	0	0	7	0	0
10	86275392	rs11201083	A	G	4	3	7	0	0	7	0	0
10	86276233	rs11201084	T	C	2	6	8	0	0	8	0	0
10	88196377	rs145449621	G	A	44	25	69	0	2	71	0	0
10	88208203	rs12781862	G	C	3	3	6	0	0	6	0	0
10	88729314	rs11202278	C	T	2	4	6	0	0	6	0	0
10	88930249	rs11202365	A	T	41	29	70	0	0	70	0	0
10	88930392	rs147849599	C	T	46	34	80	0	0	80	0	0
10	88948017	rs10887702	T	C	3	5	8	0	0	8	0	0
10	88968003	rs7078492	A	G	17	9	26	0	0	26	0	0
10	88968166	rs7095182	C	T	27	7	34	0	0	34	0	0
10	88975783	rs28533204	C	T	5	8	13	0	0	13	0	0
10	88992622	rs200484233	C	T	9	2	11	0	0	11	0	0
10	88998470	rs12262768	T	C	5	8	13	0	0	13	0	0
10	89005496	rs11202400	T	G	9	10	19	0	0	19	0	0
10	89005906	rs603393	C	A	72	38	110	0	0	110	0	0
10	89005916	rs4111057	C	T	62	37	99	0	0	99	0	0
10	89005930	rs4040134	G	A	72	33	105	0	0	105	0	0
10	89069591	rs12241520	G	A	4	3	7	0	0	7	0	0
10	89078954	.	A	T	17	17	34	0	0	34	0	0
10	89086718	rs76652728	T	C	3	3	6	0	0	6	0	0
10	89087404	.	C	T	18	0	18	0	0	18	0	0
10	89087772	rs12251946	T	C	6	13	19	0	0	19	0	0
10	89088274	.	C	T	16	4	20	0	0	20	0	0
10	89088308	rs11202405	A	T	14	4	18	0	0	18	0	0
10	89102129	rs2986480	A	C	38	12	50	0	0	50	0	0
10	89102299	rs2767166	A	G	7	7	14	0	0	14	0	0
10	89104500	rs3128132	T	C	4	2	6	0	0	6	0	0
10	89115767	.	G	A	8	5	13	0	0	13	0	0
10	89631427	rs74566162	T	A	4	3	7	0	0	7	0	0
10	89689321	rs1234213	G	A	3	3	6	0	0	6	0	0
10	89705429	rs2735343	G	C	8	2	10	0	0	10	0	0
10	89707265	rs2248293	T	C	4	3	7	0	0	7	0	0
10	89720907	rs555895	T	G	5	5	10	0	0	10	0	0
10	89726745	rs701848	T	C	5	12	17	0	0	17	0	0
10	90674382	rs139001360	A	C	5	4	9	0	0	9	0	0
10	90770439	rs2296600	C	G	1	5	6	0	0	6	0	0
10	90770852	rs1571020	C	T	5	7	12	0	0	12	0	0
10	90771829	rs2234978	T	C	12	21	33	0	0	33	0	0
10	90973492	rs13500	G	A	44	39	83	0	1	84	0	0
10	91066769	rs1727	C	A	85	69	154	0	0	154	0	0
10	91067438	rs4934470	T	C	41	47	88	0	1	89	0	0
10	91162497	rs303211	A	G	10	4	14	0	0	14	0	0
10	91352966	rs2296616	G	A	10	2	12	0	0	12	0	0
10	91394107	rs10727	A	G	13	5	18	0	0	18	0	0
10	91404448	rs11185826	C	G	5	2	7	0	0	7	0	0
10	91470834	rs1048057	A	C	26	26	52	0	1	53	0	0
10	91480236	rs7085805	G	A	4	2	6	0	0	6	0	0
10	91480739	rs11185857	T	C	5	2	7	0	0	7	0	0
10	91480744	rs11185858	A	G	5	2	7	0	0	7	0	0
10	91480811	rs10881633	G	A	2	4	6	0	0	6	0	0
10	91481110	rs10430647	C	A	5	5	10	0	0	10	0	0
10	91484780	rs8181361	G	A	32	24	56	0	0	56	0	0
10	91497631	rs1062465	T	A	16	11	27	0	1	28	0	0
10	91498127	rs1886996	T	C	25	16	41	0	1	42	0	0
10	91498254	rs1886997	A	G	11	21	32	0	0	32	0	0
10	91498318	rs1886998	A	G	11	16	27	0	0	27	0	0
10	91502803	rs7909550	G	A	4	3	7	0	0	7	0	0
10	91503660	rs1126480	A	G	33	26	59	0	0	59	0	0
10	91505886	rs56664691	G	A	7	6	13	0	0	13	0	0
10	91506082	rs7912347	T	G	9	9	18	0	0	18	0	0
10	91513506	rs10881657	T	C	2	5	7	0	0	7	0	0
10	91525903	rs10881662	A	G	4	2	6	0	0	6	0	0
10	91526067	rs10881663	T	C	4	5	9	0	0	9	0	0
10	91534524	rs12948	G	T	19	6	25	0	0	25	0	0
10	91534527	rs10982	G	A	22	7	29	0	0	29	0	0
10	91596920	rs7076219	T	G	5	5	10	0	0	10	0	0
10	91596946	rs68147789	G	C	6	7	13	0	0	13	0	0
10	91597108	rs61869800	G	A	5	6	11	0	2	13	0	0
10	91597426	rs3740040	T	C	5	12	17	0	0	17	0	0
10	91597627	rs1326199	C	G	4	6	10	0	0	10	0	0
10	91597636	rs1326198	A	G	4	7	11	0	0	11	0	0
10	91597919	rs3740042	T	G	6	6	12	0	0	12	0	0
10	91598174	rs58933281	G	T	12	9	21	0	0	21	0	0
10	91599043	rs3802651	C	T	19	6	25	0	0	25	0	0
10	91599896	rs17128049	C	T	8	9	17	0	0	17	0	0
10	91600497	rs3087663	C	T	12	11	23	0	0	23	0	0
10	92500724	rs1045949	C	T	9	12	21	0	0	21	0	0
10	92501279	rs115474018	C	T	11	26	37	0	0	37	0	0
10	92508658	rs10159742	T	C	9	32	41	0	0	41	0	0
10	92610045	rs12259062	A	G	5	6	11	0	0	11	0	0
10	92611234	rs112988876	C	T	1	8	9	0	1	10	0	0
10	92615185	rs7919103	T	C	3	3	6	0	0	6	0	0
10	92636726	rs61481895	C	A	2	8	10	0	0	10	0	0
10	92655559	rs10881848	T	A	3	5	8	0	0	8	0	0
10	92659610	rs181554626	T	A	2	4	6	0	0	6	0	0
10	92663108	rs7089472	C	T	4	6	10	0	0	10	0	0
10	92663546	rs11186356	T	G	0	6	6	0	0	6	0	0
10	92665783	rs17102188	T	C	7	6	13	0	0	13	0	0
10	92665993	rs76854523	T	C	6	10	16	0	0	16	0	0
10	92666683	rs4522081	T	A	1	5	6	0	0	6	0	0
10	92667175	rs11186358	T	C	5	13	18	0	0	18	0	0
10	92667387	rs11186359	T	C	3	13	16	0	0	16	0	0
10	92667807	rs7903584	C	T	7	13	20	0	0	20	0	0
10	92987510	rs1057971	C	T	164	192	356	0	0	356	0	0
10	93019324	rs12249713	G	C	3	8	11	0	0	11	0	0
10	93019355	rs35981490	C	T	4	9	13	0	0	13	0	0
10	93038530	rs2450445	G	A	5	4	9	0	0	9	0	0
10	93040501	rs73314513	C	T	26	19	45	0	0	45	0	0
10	93042251	rs7075114	T	G	7	5	12	0	0	12	0	0
10	93595853	rs12220444	G	A	3	4	7	0	0	7	0	0
10	93596361	rs7912927	C	A	4	7	11	0	0	11	0	0
10	93602457	rs10881981	G	T	6	7	13	0	0	13	0	0
10	93604133	rs10786019	C	G	8	2	10	0	0	10	0	0
10	93604600	rs2297960	A	T	3	7	10	0	0	10	0	0
10	93608142	rs3758499	G	A	83	62	145	0	2	147	0	0
10	93611991	rs9420573	A	C	4	2	6	0	0	6	0	0
10	93613430	rs1538832	A	G	4	4	8	0	0	8	0	0
10	93613894	rs7913999	G	T	4	4	8	0	0	8	0	0
10	93622323	rs2259094	C	A	11	6	17	0	0	17	0	0
10	93624672	rs2258946	G	A	39	23	62	0	0	62	0	0
10	93668110	rs1107947	T	A	7	8	15	0	1	16	0	0
10	93704183	rs12780724	C	T	5	5	10	0	0	10	0	0
10	93704803	rs10786026	C	G	5	7	12	0	0	12	0	0
10	93719087	rs12774665	G	T	13	4	17	0	0	17	0	0
10	93721008	rs11818046	C	A	5	4	9	0	0	9	0	0
10	93721025	rs4642987	A	G	5	5	10	0	0	10	0	0
10	93721643	rs12413858	G	A	3	4	7	0	1	8	0	0
10	93722298	.	G	A	10	6	16	0	0	16	0	0
10	93724588	rs11817266	G	C	5	5	10	0	0	10	0	0
10	93725957	rs4933707	A	C	7	14	21	0	0	21	0	0
10	93726090	rs4933224	C	T	8	6	14	0	0	14	0	0
10	93727581	rs12774295	C	A	4	6	10	0	0	10	0	0
10	93727616	rs10786027	A	G	5	7	12	0	1	13	0	0
10	93729335	rs7909870	T	C	9	7	16	0	0	16	0	0
10	93729998	rs2252204	T	C	4	10	14	0	0	14	0	0
10	93730058	rs2252200	C	T	7	11	18	0	0	18	0	0
10	93730492	rs2676825	A	T	13	9	22	0	2	24	0	0
10	93730592	rs2676824	C	T	13	8	21	0	0	21	0	0
10	93731391	rs2676823	A	G	5	2	7	0	0	7	0	0
10	93731477	rs2792018	C	T	4	11	15	0	0	15	0	0
10	93731617	rs2676822	A	G	7	5	12	0	1	13	0	0
10	93732286	rs11812701	T	C	4	4	8	0	0	8	0	0
10	93733327	rs72823200	A	T	7	8	15	0	1	16	0	0
10	93747839	rs72825305	C	T	10	7	17	0	0	17	0	0
10	93810872	rs1776209	A	G	4	8	12	0	0	12	0	0
10	93999850	rs3824734	A	G	3	3	6	0	0	6	0	0
10	94052347	.	G	T	3	3	6	0	0	6	0	0
10	94105923	rs10748580	T	C	2	7	9	0	0	9	0	0
10	94109870	rs10786037	A	G	44	23	67	0	0	67	0	0
10	94109877	rs2255718	G	T	27	42	69	0	0	69	0	0
10	94110118	rs61875243	A	G	50	44	94	0	0	94	0	0
10	94112156	rs1057848	G	C	13	10	23	0	0	23	0	0
10	94695617	rs1326331	C	T	10	12	22	0	0	22	0	0
10	94733827	.	A	T	11	9	20	0	0	20	0	0
10	94818581	rs189568097	A	G	3	5	8	0	0	8	0	0
10	94819053	rs8211	C	T	2	13	15	0	0	15	0	0
10	95441272	rs11187583	G	A	26	20	46	0	1	47	0	0
10	95454631	.	A	C	20	19	39	0	0	39	0	0
10	96093375	rs11558740	C	T	4	3	7	0	0	7	0	0
10	96093632	rs1678	C	G	5	4	9	0	0	9	0	0
10	96098373	rs17517578	C	T	4	10	14	0	0	14	0	0
10	96114835	rs12572897	G	A	6	2	8	0	0	8	0	0
10	96292988	rs12260063	T	A	12	14	26	0	0	26	0	0
10	96293504	rs12268719	A	G	13	11	24	0	0	24	0	0
10	96294851	rs2281791	T	C	18	17	35	0	0	35	0	0
10	96313960	rs11188019	A	C	4	4	8	0	0	8	0	0
10	96361776	rs1048196	C	T	2	5	7	0	0	7	0	0
10	96371443	rs701885	T	C	1	6	7	0	0	7	0	0
10	96371928	rs11638	G	A	2	8	10	0	0	10	0	0
10	96372903	rs12783717	T	C	2	9	11	0	0	11	0	0
10	96997589	rs1049961	A	G	371	281	652	0	3	655	0	0
10	96998458	rs2901832	C	T	6	2	8	0	0	8	0	0
10	96998519	rs2860998	T	C	5	1	6	0	0	6	0	0
10	97000206	rs2026680	G	C	3	3	6	0	0	6	0	0
10	97023630	rs2296961	T	C	262	291	553	0	6	559	0	0
10	97365820	rs4037	G	A	15	8	23	0	0	23	0	0
10	97366107	rs8758	A	G	12	18	30	0	1	31	0	0
10	97366364	rs1053905	C	T	16	15	31	0	1	32	0	0
10	97387248	rs41291566	A	G	8	8	16	0	0	16	0	0
10	97423708	rs6946	C	A	27	34	61	0	3	64	0	0
10	97426086	rs10882649	A	G	3	5	8	0	0	8	0	0
10	97447373	rs10786229	A	T	54	33	87	0	0	87	0	0
10	97447910	rs1933167	C	T	2	6	8	0	0	8	0	0
10	97450005	rs7075081	T	C	3	4	7	0	0	7	0	0
10	97632808	rs3192654	A	C	3	4	7	0	0	7	0	0
10	97633021	rs11188513	C	T	23	22	45	0	0	45	0	0
10	97805074	rs915506	G	A	8	7	15	0	0	15	0	0
10	97806333	rs61858613	A	T	6	0	6	0	0	6	0	0
10	97807041	rs10732776	G	C	4	4	8	0	0	8	0	0
10	97807735	rs2901894	G	C	5	3	8	0	0	8	0	0
10	97808509	rs7913418	A	G	4	2	6	0	0	6	0	0
10	97814475	rs1414918	G	A	5	7	12	0	0	12	0	0
10	97814761	rs11188575	G	A	16	16	32	0	1	33	0	0
10	97816420	rs7099399	G	A	14	14	28	0	0	28	0	0
10	97820339	rs1047370	G	T	73	65	138	0	3	141	0	0
10	97920798	rs12761705	C	T	8	8	16	0	0	16	0	0
10	97926918	rs12766762	C	A	3	3	6	0	0	6	0	0
10	97949572	rs11188656	A	C	3	7	10	0	0	10	0	0
10	98278823	rs1044029	A	G	29	25	54	0	1	55	0	0
10	98279053	rs9093	A	G	42	41	83	0	0	83	0	0
10	98282160	rs17391197	A	G	13	10	23	0	0	23	0	0
10	98283111	rs60471672	T	C	16	16	32	0	0	32	0	0
10	98283258	rs4919030	C	T	9	11	20	0	0	20	0	0
10	98284894	rs10509711	C	A	14	10	24	0	1	25	0	0
10	98285951	rs7915046	G	C	21	12	33	0	0	33	0	0
10	98287261	rs3789957	G	C	13	14	27	0	1	28	0	0
10	98289250	rs10882811	A	C	18	20	38	0	0	38	0	0
10	98289951	rs79353623	T	C	3	9	12	0	1	13	0	0
10	98291627	rs11592108	T	C	5	5	10	0	0	10	0	0
10	98292159	rs61858496	A	T	3	3	6	0	0	6	0	0
10	98292461	rs10882812	C	T	4	7	11	0	0	11	0	0
10	98292501	rs10748682	G	C	3	6	9	0	0	9	0	0
10	98293392	rs10882813	G	C	5	2	7	0	0	7	0	0
10	98315446	rs55822182	C	T	4	2	6	0	0	6	0	0
10	98319016	rs11188827	G	C	0	6	6	0	0	6	0	0
10	98319815	rs17392013	T	C	16	21	37	0	1	38	0	0
10	98323314	rs11188829	T	C	4	3	7	0	0	7	0	0
10	98327266	rs9633703	T	C	10	4	14	0	0	14	0	0
10	98328368	rs9633704	A	T	6	2	8	0	0	8	0	0
10	98332823	rs4919032	A	G	2	5	7	0	0	7	0	0
10	98334182	rs2861555	C	T	9	5	14	0	0	14	0	0
10	98334340	rs11188835	C	A	9	6	15	0	0	15	0	0
10	98336341	rs61858555	C	A	5	6	11	0	0	11	0	0
10	98353213	rs7448	C	T	32	25	57	0	0	57	0	0
10	98354812	rs11592969	A	G	52	37	89	0	0	89	0	0
10	98380277	rs3748234	C	T	33	25	58	0	1	59	0	0
10	98462204	rs139565111	C	T	31	18	49	0	3	52	0	0
10	98462830	rs1436183	C	G	4	12	16	0	0	16	0	0
10	98463435	rs17484875	T	C	8	10	18	0	0	18	0	0
10	98469507	rs3748229	C	A	64	60	124	0	1	125	0	0
10	98716653	rs61858089	T	C	27	34	61	0	1	62	0	0
10	98982749	rs3814164	G	A	34	35	69	0	0	69	0	0
10	98983955	rs10748691	G	A	17	16	33	0	0	33	0	0
10	99006083	rs13439	G	A	14	16	30	0	0	30	0	0
10	99080585	rs3781373	C	T	44	41	85	0	0	85	0	0
10	99080981	rs1334892	G	T	20	9	29	0	0	29	0	0
10	99094436	rs1890966	G	A	4	3	7	0	0	7	0	0
10	99116903	rs1048445	C	T	101	100	201	0	1	202	0	0
10	99117097	rs7923385	T	A	6	1	7	0	0	7	0	0
10	99118382	rs2297988	T	C	4	3	7	0	0	7	0	0
10	99118929	rs66531566	G	A	10	7	17	0	0	17	0	0
10	99120925	rs7924254	C	T	5	2	7	0	0	7	0	0
10	99121361	rs11189163	C	T	6	10	16	0	0	16	0	0
10	99122288	rs17112676	G	A	3	4	7	0	0	7	0	0
10	99123006	rs954148	T	C	3	6	9	0	0	9	0	0
10	99123457	rs11189165	A	G	2	7	9	0	0	9	0	0
10	99124389	rs61863815	A	G	10	4	14	0	0	14	0	0
10	99125722	rs11189167	A	G	3	4	7	0	0	7	0	0
10	99125769	rs11189168	T	C	4	4	8	0	0	8	0	0
10	99125788	rs10882907	G	C	5	5	10	0	0	10	0	0
10	99125949	rs2275580	C	T	73	72	145	0	1	146	0	0
10	99126249	rs2275581	G	A	77	59	136	0	1	137	0	0
10	99128503	rs61863816	G	A	4	3	7	0	0	7	0	0
10	99132083	rs6584123	C	T	5	6	11	0	0	11	0	0
10	99132701	rs3818908	A	G	9	6	15	0	0	15	0	0
10	99134923	rs12412478	C	T	2	4	6	0	0	6	0	0
10	99135215	rs11189172	T	C	1	6	7	0	0	7	0	0
10	99135262	rs7084654	G	A	3	3	6	0	0	6	0	0
10	99135539	rs7088410	G	T	3	3	6	0	0	6	0	0
10	99136359	rs12359257	A	T	4	5	9	0	0	9	0	0
10	99136403	rs61863818	C	T	5	7	12	0	0	12	0	0
10	99137839	rs4635018	G	C	4	2	6	0	1	7	0	0
10	99137998	rs10882909	G	C	4	4	8	0	1	9	0	0
10	99138043	rs10882910	G	A	5	5	10	0	0	10	0	0
10	99138064	rs10882911	A	C	4	6	10	0	0	10	0	0
10	99138077	rs10882912	C	T	3	5	8	0	0	8	0	0
10	99141205	rs2275089	A	G	25	24	49	0	0	49	0	0
10	99141484	rs12218483	C	T	22	32	54	0	0	54	0	0
10	99155984	rs3814553	G	A	24	27	51	0	0	51	0	0
10	99160152	rs1048442	A	G	25	27	52	0	1	53	0	0
10	99188252	rs28616696	C	T	3	3	6	0	0	6	0	0
10	99219885	rs2152092	G	A	27	43	70	0	0	70	0	0
10	99220707	rs3740526	C	T	44	37	81	0	1	82	0	0
10	99225846	rs17112809	C	T	32	36	68	0	0	68	0	0
10	99515144	rs34360519	G	A	7	4	11	0	0	11	0	0
10	99520574	rs41290466	G	C	25	37	62	0	0	62	0	0
10	99912544	rs7083160	C	T	3	6	9	0	0	9	0	0
10	99917316	rs7911317	T	C	3	8	11	0	0	11	0	0
10	99918976	rs4468282	A	G	4	13	17	0	0	17	0	0
10	99969475	rs34494334	A	C	33	32	65	0	0	65	0	0
10	99983310	rs12781480	T	C	5	8	13	0	0	13	0	0
10	100000645	rs61875309	A	C	3	3	6	0	0	6	0	0
10	100003785	rs1359508	T	C	3	10	13	0	0	13	0	0
10	100004360	rs1048754	G	A	44	35	79	0	0	79	0	0
10	100004441	rs1048757	G	C	39	26	65	0	2	67	0	0
10	100189138	rs1061135	A	G	47	73	120	0	2	122	0	0
10	100190920	rs1801287	G	A	136	118	254	0	2	256	0	0
10	100204727	rs10786422	C	T	4	3	7	0	0	7	0	0
10	100205107	rs1804689	G	T	151	211	362	0	3	365	0	0
10	101286207	rs7917446	T	C	11	4	15	0	0	15	0	0
10	101287785	rs10883366	G	A	7	1	8	0	0	8	0	0
10	101288347	rs7085798	C	A	9	6	15	0	0	15	0	0
10	101290027	rs77114732	G	A	2	5	7	0	0	7	0	0
10	101293035	rs41290504	C	A	44	47	91	0	1	92	0	0
10	101293318	rs7908704	G	A	18	12	30	0	0	30	0	0
10	101293341	rs7893840	T	C	19	11	30	0	0	30	0	0
10	101293468	rs7911680	A	C	9	6	15	0	0	15	0	0
10	101293921	rs77927889	T	C	9	13	22	0	1	23	0	0
10	101379795	rs12252561	G	C	10	3	13	0	0	13	0	0
10	101466983	rs17112172	C	G	5	3	8	0	0	8	0	0
10	101502968	rs3740076	A	G	17	33	50	0	0	50	0	0
10	101610533	rs8187707	C	T	5	1	6	0	0	6	0	0
10	101611294	rs8187710	G	A	4	3	7	0	0	7	0	0
10	101635461	rs7652	T	A	38	45	83	0	0	83	0	0
10	101636163	rs12769233	C	G	40	29	69	0	3	72	0	0
10	101636648	rs2002109	T	C	41	36	77	0	0	77	0	0
10	101639796	rs2255901	G	A	25	42	67	0	0	67	0	0
10	101640920	rs2001223	T	C	5	3	8	0	0	8	0	0
10	101645498	rs2490763	T	C	34	39	73	0	1	74	0	0
10	101937194	rs17112705	T	C	6	6	12	0	0	12	0	0
10	102009907	.	C	A	28	16	44	0	0	44	0	0
10	102011147	rs61286369	T	A	12	13	25	0	0	25	0	0
10	102014506	rs663123	C	A	3	9	12	0	0	12	0	0
10	102121449	rs79791375	G	A	6	2	8	0	0	8	0	0
10	102246512	rs2970	C	T	6	20	26	0	0	26	0	0
10	102247408	rs2298075	C	A	14	10	24	0	1	25	0	0
10	102247526	rs2298074	G	C	14	6	20	0	0	20	0	0
10	102248884	rs3750720	C	T	10	9	19	0	0	19	0	0
10	102248950	rs3750719	C	G	7	8	15	0	0	15	0	0
10	102265183	rs2295772	G	A	13	8	21	0	0	21	0	0
10	102265815	rs2295773	A	G	15	4	19	0	0	19	0	0
10	102265847	rs2295774	A	C	12	6	18	0	0	18	0	0
10	102269085	rs3793706	C	A	11	3	14	0	0	14	0	0
10	102284449	rs12358187	C	G	16	13	29	0	0	29	0	0
10	102287520	rs74210981	C	T	4	7	11	0	0	11	0	0
10	102288343	rs4919468	G	C	9	7	16	0	0	16	0	0
10	102289078	rs1800662	C	A	4	2	6	0	0	6	0	0
10	102295836	rs2295778	C	G	5	8	13	0	0	13	0	0
10	102308214	rs3750633	G	A	12	6	18	0	0	18	0	0
10	102308516	rs10883512	A	G	12	17	29	0	0	29	0	0
10	102308817	rs117727370	G	C	26	0	26	0	0	26	0	0
10	102309220	rs11816840	G	C	23	21	44	0	1	45	0	0
10	102312565	rs1054399	C	T	18	20	38	0	0	38	0	0
10	102313607	rs11292	A	G	16	6	22	0	0	22	0	0
10	102715845	rs72842161	T	C	5	1	6	0	0	6	0	0
10	102762256	rs752974	C	T	19	14	33	0	0	33	0	0
10	102797259	rs2275382	C	T	6	11	17	0	0	17	0	0
10	102798346	rs807049	T	C	4	5	9	0	0	9	0	0
10	102800360	rs807048	A	G	39	58	97	0	15	112	0	0
10	102800428	rs144099885	C	T	77	51	128	0	4	132	0	0
10	103552580	.	G	A	58	51	109	0	0	109	0	0
10	104157947	rs45487496	C	A	3	13	16	0	0	16	0	0
10	104211058	rs3740417	G	C	3	3	6	0	0	6	0	0
10	104225832	rs10883723	T	C	1	7	8	0	0	8	0	0
10	104225837	rs11191294	T	G	1	8	9	0	0	9	0	0
10	104229785	rs41306870	C	T	10	9	19	0	0	19	0	0
10	104231054	rs11191295	A	G	12	11	23	0	0	23	0	0
10	104231651	rs7081110	A	G	4	2	6	0	0	6	0	0
10	104231662	rs7081467	G	C	5	1	6	0	1	7	0	0
10	104235956	rs10883725	G	C	4	5	9	0	0	9	0	0
10	104235978	rs11595149	C	T	5	2	7	0	0	7	0	0
10	104236276	rs10883726	C	T	7	3	10	0	0	10	0	0
10	104236481	rs1056738	G	A	6	10	16	0	1	17	0	0
10	104236542	rs1056739	T	C	11	5	16	0	0	16	0	0
10	104236552	rs1056740	C	T	12	5	17	0	0	17	0	0
10	104236640	rs1056741	A	C	6	8	14	0	0	14	0	0
10	104236687	rs1056744	A	G	7	2	9	0	0	9	0	0
10	104239100	rs5870	T	C	99	99	198	0	0	198	0	0
10	104240003	rs1056857	C	T	83	77	160	0	1	161	0	0
10	104240438	rs13287	A	G	114	111	225	0	1	226	0	0
10	104240498	rs12162	A	G	116	103	219	0	1	220	0	0
10	104240974	rs2296578	C	G	4	5	9	0	0	9	0	0
10	104241375	rs2296579	A	G	6	7	13	0	0	13	0	0
10	104241683	rs2296580	G	T	8	8	16	0	0	16	0	0
10	104242886	rs2296581	G	A	23	10	33	0	0	33	0	0
10	104243883	rs7079810	C	T	11	9	20	0	0	20	0	0
10	104248087	rs2296588	T	C	3	4	7	0	0	7	0	0
10	104248106	rs2296589	T	A	3	4	7	0	0	7	0	0
10	104249919	rs7092622	T	G	7	2	9	0	0	9	0	0
10	104249922	rs7074444	A	G	7	2	9	0	0	9	0	0
10	104250278	rs17709610	A	G	12	14	26	0	0	26	0	0
10	104265047	rs7072351	C	T	3	4	7	0	0	7	0	0
10	104391034	rs11596235	C	T	15	9	24	0	0	24	0	0
10	104391584	rs117196884	A	G	9	16	25	0	0	25	0	0
10	104392580	rs11594179	C	T	6	1	7	0	0	7	0	0
10	104405850	rs80146619	G	A	8	8	16	0	1	17	0	0
10	104408272	rs12241712	C	A	5	8	13	0	0	13	0	0
10	104410736	rs17783771	C	T	7	9	16	0	0	16	0	0
10	104411958	rs11191361	C	T	19	10	29	0	0	29	0	0
10	104412742	rs3862031	G	T	6	12	18	0	0	18	0	0
10	104413385	rs12764388	G	A	14	9	23	0	0	23	0	0
10	104414221	rs3850699	A	G	9	9	18	0	0	18	0	0
10	104854262	rs148828123	G	A	2	8	10	0	0	10	0	0
10	105205374	.	A	G	20	21	41	0	0	41	0	0
10	105345327	rs7100958	C	T	3	8	11	0	0	11	0	0
10	105677557	rs11191866	G	C	4	5	9	0	0	9	0	0
10	106075081	rs34043167	G	A	118	127	245	0	2	247	0	0
10	111647738	rs472049	C	T	1	6	7	0	0	7	0	0
10	111873436	.	G	A	2	7	9	0	0	9	0	0
10	112258425	rs143273538	C	T	7	10	17	0	0	17	0	0
10	112259493	rs11195157	G	C	6	10	16	0	1	17	0	0
10	112262125	rs2282239	C	T	16	12	28	0	0	28	0	0
10	112262843	rs11594185	C	T	60	43	103	0	0	103	0	0
10	112263030	rs1889568	C	T	51	56	107	0	1	108	0	0
10	112263999	rs17127463	A	G	41	22	63	0	0	63	0	0
10	112265135	rs3793892	G	T	34	33	67	0	0	67	0	0
10	112266046	rs1334944	C	T	37	45	82	0	0	82	0	0
10	112266771	rs1889567	C	T	981	932	1913	0	12	1925	0	0
10	112268640	rs146201783	C	T	57	42	99	0	0	99	0	0
10	112268801	rs17127481	C	T	47	40	87	0	1	88	0	0
10	112269400	rs7090060	A	G	40	58	98	0	0	98	0	0
10	112269486	rs3829192	G	C	62	81	143	0	0	143	0	0
10	112270675	rs1042606	A	C	1233	1124	2357	0	5	2362	0	0
10	112271288	rs3750811	A	G	60	68	128	0	0	128	0	0
10	112344468	rs112855982	C	T	3	7	10	0	0	10	0	0
10	112345372	rs6584996	T	G	2	4	6	0	0	6	0	0
10	112345933	rs113361489	T	G	6	6	12	0	1	13	0	0
10	112346194	rs79280941	C	T	11	6	17	0	0	17	0	0
10	112349422	rs75323904	T	C	235	219	454	0	3	457	0	0
10	112355748	rs7899213	A	G	5	5	10	0	0	10	0	0
10	112357518	rs10787255	A	T	4	5	9	0	0	9	0	0
10	112629911	rs1322995	G	A	35	20	55	0	0	55	0	0
10	112630041	rs11597928	G	C	15	42	57	0	0	57	0	0
10	112631211	rs6585018	G	A	4	2	6	0	0	6	0	0
10	112632407	rs73343803	G	A	11	13	24	0	0	24	0	0
10	112633671	rs11558147	T	C	3	6	9	0	0	9	0	0
10	112634453	rs11813593	A	C	2	7	9	0	0	9	0	0
10	112635448	rs11593462	A	G	10	6	16	0	0	16	0	0
10	112641053	rs7081726	A	G	175	130	305	0	2	307	0	0
10	112643417	rs6585020	C	T	18	15	33	0	0	33	0	0
10	112645088	rs34104444	G	A	217	182	399	0	4	403	0	0
10	112647195	rs10787287	C	T	4	4	8	0	0	8	0	0
10	112648771	rs182331154	C	T	3	3	6	0	0	6	0	0
10	112650055	rs6585021	T	C	4	3	7	0	0	7	0	0
10	112651895	rs56233990	A	T	3	4	7	0	0	7	0	0
10	112652873	rs1327548	A	G	5	9	14	0	1	15	0	0
10	112653252	rs55647014	T	C	7	7	14	0	0	14	0	0
10	112657207	rs10787289	A	G	26	25	51	0	0	51	0	0
10	112657331	rs11195368	T	C	9	17	26	0	0	26	0	0
10	112658148	rs61469604	G	A	170	156	326	0	2	328	0	0
10	112659463	rs55858908	G	C	47	47	94	0	0	94	0	0
10	112659477	rs149734425	C	T	50	63	113	0	0	113	0	0
10	112662777	rs56237211	A	G	5	3	8	0	0	8	0	0
10	112663986	rs77898756	C	T	6	3	9	0	0	9	0	0
10	112664114	rs58164562	T	C	5	3	8	0	0	8	0	0
10	112666882	rs74156310	T	C	3	5	8	0	0	8	0	0
10	112666952	rs7072811	G	A	7	4	11	0	0	11	0	0
10	112670141	rs17128130	C	T	5	4	9	0	0	9	0	0
10	112680950	rs11195376	A	G	5	2	7	0	0	7	0	0
10	112755296	rs11816269	A	C	4	2	6	0	0	6	0	0
10	112757976	rs12247996	C	T	8	2	10	0	0	10	0	0
10	112758009	rs11593479	G	C	3	8	11	0	0	11	0	0
10	113910721	rs1129555	A	G	8	7	15	0	0	15	0	0
10	113913222	rs2297991	T	C	5	6	11	0	1	12	0	0
10	113917085	rs2254537	T	A	4	3	7	0	0	7	0	0
10	113920465	rs2277207	G	A	2	4	6	0	0	6	0	0
10	114187787	rs8624	T	C	31	22	53	0	1	54	0	0
10	114192285	rs2306158	G	A	3	9	12	0	0	12	0	0
10	114200355	rs2306159	G	A	10	10	20	0	0	20	0	0
10	114205389	rs4918752	G	A	26	34	60	0	0	60	0	0
10	114575767	rs3740144	T	C	13	12	25	0	0	25	0	0
10	114746580	rs4073980	C	G	33	13	46	0	0	46	0	0
10	114747277	rs4073288	G	A	23	20	43	0	1	44	0	0
10	114912534	rs1555485	C	T	6	3	9	0	0	9	0	0
10	114913559	rs10509969	A	T	3	3	6	0	0	6	0	0
10	114917442	rs1885510	T	C	5	3	8	0	0	8	0	0
10	114920089	rs4081699	A	G	5	2	7	0	0	7	0	0
10	114926455	rs56386996	T	C	31	34	65	0	2	67	0	0
10	114926790	rs11196251	C	T	111	106	217	0	0	217	0	0
10	115894959	rs7902873	C	G	4	3	7	0	0	7	0	0
10	116191301	rs117804319	C	T	16	7	23	0	1	24	0	0
10	116193917	rs10787530	A	G	3	6	9	0	0	9	0	0
10	116195155	rs1057144	T	C	4	3	7	0	0	7	0	0
10	116195156	rs1057143	G	A	4	3	7	0	0	7	0	0
10	116582419	rs1359080	C	A	6	5	11	0	0	11	0	0
10	116582502	rs1359079	A	G	2	7	9	0	1	10	0	0
10	116582560	rs758585	C	A	6	6	12	0	0	12	0	0
10	116583753	rs2420065	A	G	4	2	6	0	0	6	0	0
10	116593175	rs11196939	C	T	18	9	27	0	0	27	0	0
10	116593532	rs10490909	C	T	9	7	16	0	0	16	0	0
10	116593791	rs11196940	T	G	14	33	47	0	0	47	0	0
10	116594934	rs11819372	A	G	13	18	31	0	1	32	0	0
10	116601888	rs765174	C	T	6	6	12	0	0	12	0	0
10	116602074	rs11196948	C	T	5	5	10	0	0	10	0	0
10	116603198	rs7079877	G	A	8	13	21	0	0	21	0	0
10	116607256	rs11196950	T	C	11	12	23	0	0	23	0	0
10	116607261	rs11196951	T	G	12	14	26	0	0	26	0	0
10	116607592	rs11196952	G	A	12	11	23	0	0	23	0	0
10	116607707	rs11196953	A	G	9	9	18	0	0	18	0	0
10	116609098	rs10885614	C	T	3	7	10	0	0	10	0	0
10	116615045	rs3180654	T	C	150	165	315	0	2	317	0	0
10	116616162	rs10490908	T	C	1	5	6	0	0	6	0	0
10	116621154	rs34064819	C	A	18	5	23	0	1	24	0	0
10	116622339	rs41284358	A	G	89	70	159	0	0	159	0	0
10	116623059	rs36089581	G	C	23	17	40	0	2	42	0	0
10	116624067	rs1046492	C	T	37	26	63	0	1	64	0	0
10	119028940	rs2532810	G	A	2	4	6	0	0	6	0	0
10	119038528	rs363237	T	C	4	9	13	0	0	13	0	0
10	119043554	rs363294	C	T	159	126	285	0	1	286	0	0
10	120074100	rs2151528	A	G	11	8	19	0	1	20	0	0
10	120082538	rs10886222	T	C	4	7	11	0	0	11	0	0
10	120442514	rs41284408	C	T	53	36	89	0	0	89	0	0
10	120444642	rs76461536	C	T	27	17	44	0	0	44	0	0
10	120444880	rs4443992	A	C	50	49	99	0	1	100	0	0
10	120446397	rs60285883	T	A	8	6	14	0	0	14	0	0
10	120446828	rs76599689	C	A	8	2	10	0	0	10	0	0
10	120448203	rs17097964	A	G	7	6	13	0	0	13	0	0
10	120448570	rs3824821	A	G	3	3	6	0	0	6	0	0
10	120453168	rs10510046	T	C	14	13	27	0	0	27	0	0
10	120455617	rs12412606	C	T	2	5	7	0	0	7	0	0
10	120458635	rs11819341	A	G	3	4	7	0	0	7	0	0
10	120458663	rs17586204	A	T	3	3	6	0	0	6	0	0
10	120822906	rs76473913	T	C	7	3	10	0	0	10	0	0
10	120896927	rs4752252	G	A	13	18	31	0	0	31	0	0
10	120897063	rs4751697	C	T	21	26	47	0	1	48	0	0
10	120897151	rs1048713	C	T	16	7	23	0	0	23	0	0
10	120897179	rs10886401	T	C	6	11	17	0	0	17	0	0
10	120927544	rs3377	T	G	25	25	50	0	1	51	0	0
10	120927793	rs7768	G	C	40	35	75	0	2	77	0	0
10	120971464	rs10510055	C	G	4	3	7	0	1	8	0	0
10	121338507	rs3009879	C	T	19	13	32	0	1	33	0	0
10	121338702	rs7098960	G	A	32	30	62	0	1	63	0	0
10	121339814	rs181256030	A	G	7	11	18	0	0	18	0	0
10	121343589	rs10886515	T	C	1	5	6	0	0	6	0	0
10	121346763	rs11199030	G	A	3	3	6	0	0	6	0	0
10	121349237	rs4751742	G	T	3	3	6	0	0	6	0	0
10	121356382	rs7919868	C	T	11	12	23	0	1	24	0	0
10	121429633	rs2234962	T	C	81	86	167	0	2	169	0	0
10	121429762	rs196326	C	G	4	6	10	0	0	10	0	0
10	121429842	rs196327	A	G	4	9	13	0	0	13	0	0
10	121433675	rs72842207	C	T	4	2	6	0	0	6	0	0
10	121435955	rs196294	A	C	3	3	6	0	0	6	0	0
10	121436362	rs196295	A	G	186	203	389	0	5	394	0	0
10	121437012	rs8946	G	C	145	148	293	0	3	296	0	0
10	121551581	rs2289306	A	C	2	6	8	0	0	8	0	0
10	121586827	rs56055506	A	G	13	15	28	0	0	28	0	0
10	121586882	rs3188055	A	G	13	18	31	0	0	31	0	0
10	121588537	rs1048120	A	G	6	4	10	0	0	10	0	0
10	121596498	rs34118671	C	T	76	89	165	0	0	165	0	0
10	122612470	rs41287984	G	A	5	4	9	0	0	9	0	0
10	122649482	rs2289337	A	G	20	24	44	0	0	44	0	0
10	122663585	rs1652727	G	A	27	19	46	0	0	46	0	0
10	122665758	rs2420894	T	C	4	4	8	0	0	8	0	0
10	123501815	rs3763756	T	C	6	9	15	0	0	15	0	0
10	123501836	rs3763755	T	C	7	11	18	0	0	18	0	0
10	123502150	rs3763752	G	C	27	20	47	0	0	47	0	0
10	123549691	rs35350755	T	G	43	45	88	0	1	89	0	0
10	124009124	rs56075957	G	C	3	4	7	0	0	7	0	0
10	124013604	rs3763763	C	A	4	10	14	0	0	14	0	0
10	124749740	rs11190	A	C	11	17	28	0	1	29	0	0
10	124752128	rs4980172	C	T	43	26	69	0	1	70	0	0
10	124754529	rs9423242	T	C	3	3	6	0	0	6	0	0
10	124755057	rs9423243	A	G	48	35	83	0	0	83	0	0
10	124755111	rs9423244	G	T	38	27	65	0	0	65	0	0
10	124757122	rs10159750	G	A	15	17	32	0	1	33	0	0
10	124757500	rs4980242	T	A	20	22	42	0	0	42	0	0
10	124758693	rs9423245	A	G	20	14	34	0	0	34	0	0
10	124759408	rs9328841	C	T	2	6	8	0	0	8	0	0
10	124763196	rs9423306	A	G	11	5	16	0	0	16	0	0
10	124764030	rs12254453	G	A	9	7	16	0	0	16	0	0
10	124764662	rs7899321	T	A	3	3	6	0	0	6	0	0
10	124765811	rs10510118	T	G	23	91	114	0	0	114	0	0
10	124765857	rs9328842	T	C	22	99	121	0	0	121	0	0
10	124766799	rs10510119	A	G	0	12	12	0	0	12	0	0
10	124767745	rs4511227	A	G	12	13	25	0	0	25	0	0
10	124767832	rs3824685	G	T	10	17	27	0	0	27	0	0
10	124768034	rs2277249	A	G	11	13	24	0	0	24	0	0
10	124768292	rs2277250	G	A	18	12	30	0	0	30	0	0
10	126086326	rs2459216	G	A	215	107	322	0	19	341	0	0
10	126089434	rs11461	G	A	289	371	660	0	3	663	0	0
10	126094472	rs11244746	G	A	2	8	10	0	0	10	0	0
10	126433498	rs11245348	T	A	7	9	16	0	0	16	0	0
10	126433570	rs3824765	C	G	6	9	15	0	0	15	0	0
10	126436279	rs2280450	C	T	6	2	8	0	0	8	0	0
10	126440395	rs10901816	G	A	4	3	7	0	0	7	0	0
10	126446592	rs1055256	A	G	7	7	14	0	0	14	0	0
10	126447545	rs4962697	G	C	4	6	10	0	0	10	0	0
10	126517989	rs2303611	G	A	26	18	44	0	0	44	0	0
10	126674860	rs142478896	G	A	41	147	188	0	7	195	0	0
10	127430464	rs4962484	G	A	23	33	56	0	0	56	0	0
10	127431047	rs72839211	T	C	22	19	41	0	0	41	0	0
10	127432259	rs10901421	A	G	1	6	7	0	0	7	0	0
10	127482950	rs2149019	G	A	2	4	6	0	0	6	0	0
10	127511756	rs4256900	C	T	6	3	9	0	0	9	0	0
10	127518538	rs11244667	G	A	2	4	6	0	0	6	0	0
10	127522988	rs2185740	A	T	7	6	13	0	0	13	0	0
10	127524156	rs113387133	A	C	5	2	7	0	0	7	0	0
10	127524612	rs4075326	C	T	8	6	14	0	0	14	0	0
10	127525072	rs7320	A	C	4	4	8	0	1	9	0	0
10	127530325	rs3208565	T	C	15	19	34	0	0	34	0	0
10	128797717	rs2275540	T	C	7	2	9	0	0	9	0	0
10	128797809	rs41282888	T	C	9	3	12	0	0	12	0	0
10	128830409	rs2229597	A	G	57	18	75	0	0	75	0	0
10	128926013	rs1060561	A	G	32	60	92	0	1	93	0	0
10	128928535	rs1770387	A	C	6	9	15	0	0	15	0	0
10	128928537	rs1780111	T	A	6	9	15	0	0	15	0	0
10	128929234	rs2251928	A	G	6	20	26	0	0	26	0	0
10	128929376	rs2251922	A	C	13	29	42	0	0	42	0	0
10	128929767	rs1167519	T	C	4	19	23	0	1	24	0	0
10	128930318	rs2489397	C	T	7	11	18	0	0	18	0	0
10	128930784	rs1770386	C	T	6	24	30	0	0	30	0	0
10	128930792	rs12769565	C	G	23	6	29	0	0	29	0	0
10	128931208	rs2486968	A	G	7	31	38	0	0	38	0	0
10	129160458	rs2296635	G	A	14	36	50	0	0	50	0	0
10	129228609	rs72843724	G	A	2	4	6	0	0	6	0	0
10	129242515	rs11371	G	A	18	50	68	0	0	68	0	0
10	129245684	rs869801	G	A	51	14	65	0	0	65	0	0
10	129249676	rs2229604	C	T	29	68	97	0	0	97	0	0
10	129249693	rs2229605	G	A	30	65	95	0	0	95	0	0
10	129249914	rs3824814	T	C	32	55	87	0	0	87	0	0
10	129249925	rs10765104	T	C	34	54	88	0	0	88	0	0
10	129250075	rs3740543	A	G	34	68	102	0	0	102	0	0
10	129250603	rs1051039	G	C	5	4	9	0	0	9	0	0
10	129845902	rs71474240	G	A	81	76	157	0	0	157	0	0
10	129846010	rs7911904	G	A	6	9	15	0	0	15	0	0
10	129850031	rs35466784	G	A	15	16	31	0	0	31	0	0
10	129852056	rs4335463	T	G	7	5	12	0	0	12	0	0
10	129852604	rs4072674	C	T	10	19	29	0	0	29	0	0
10	129854145	rs11016039	C	T	16	14	30	0	0	30	0	0
10	129854170	rs147627764	C	T	17	15	32	0	0	32	0	0
10	129855074	rs56195584	G	A	16	13	29	0	0	29	0	0
10	129855795	rs12249657	G	A	10	16	26	0	0	26	0	0
10	129856766	rs78631845	C	T	19	19	38	0	2	40	0	0
10	129857384	rs72848757	G	A	11	8	19	0	1	20	0	0
10	129858737	.	G	T	22	34	56	0	0	56	0	0
10	129859408	rs55962763	T	C	21	29	50	0	1	51	0	0
10	129859424	rs9943415	C	A	30	24	54	0	1	55	0	0
10	129859769	rs9943332	G	A	32	12	44	0	0	44	0	0
10	129860197	rs4462252	A	G	18	8	26	0	2	28	0	0
10	129860534	rs56365377	G	A	22	27	49	0	0	49	0	0
10	129862757	rs79215471	G	A	12	9	21	0	1	22	0	0
10	129870254	.	G	A	6	10	16	0	0	16	0	0
10	129878899	rs4353188	T	C	12	15	27	0	0	27	0	0
10	129879700	rs2096285	A	G	14	13	27	0	0	27	0	0
10	129880141	rs12252890	T	C	16	13	29	0	0	29	0	0
10	129880619	rs115853816	G	T	2	5	7	0	0	7	0	0
10	129880911	rs72848780	G	A	9	3	12	0	0	12	0	0
10	129881990	rs71474245	C	G	77	92	169	0	2	171	0	0
10	129882098	rs7474666	C	G	91	69	160	0	0	160	0	0
10	129882573	rs35359629	T	C	44	47	91	0	0	91	0	0
10	129883291	rs4750684	G	T	84	93	177	0	0	177	0	0
10	129895361	rs1050793	C	G	6	9	15	0	0	15	0	0
10	129895452	rs2071497	G	C	7	12	19	0	0	19	0	0
10	129895483	rs12248905	G	T	7	13	20	0	0	20	0	0
10	129896232	rs7347	A	G	11	17	28	0	0	28	0	0
10	129896503	rs28574934	G	A	18	16	34	0	0	34	0	0
10	129897314	rs4750935	C	G	15	12	27	0	0	27	0	0
10	129899543	rs10082504	C	T	21	22	43	0	0	43	0	0
10	129900858	rs3191122	C	T	11	7	18	0	0	18	0	0
10	129901393	rs11016071	T	C	19	8	27	0	0	27	0	0
10	129901501	rs2071496	G	C	18	20	38	0	0	38	0	0
10	129901722	rs10082432	G	A	11	11	22	0	1	23	0	0
10	129901726	rs10082533	C	T	12	10	22	0	1	23	0	0
10	129901747	rs10764749	C	T	13	10	23	0	1	24	0	0
10	129901825	rs10082391	T	C	9	14	23	0	0	23	0	0
10	129901946	rs1050767	T	G	8	20	28	0	0	28	0	0
10	129902158	rs12777740	C	T	8	11	19	0	0	19	0	0
10	129903280	.	T	C	10	12	22	0	0	22	0	0
10	129903465	rs2857028	A	G	15	7	22	0	0	22	0	0
10	129904474	rs61738284	G	A	6	15	21	0	0	21	0	0
10	129904477	rs11591817	C	T	6	15	21	0	0	21	0	0
10	129905429	rs7918199	C	T	4	11	15	0	0	15	0	0
10	129905896	rs3740423	T	A	8	7	15	0	0	15	0	0
10	129906364	rs4750685	G	A	7	8	15	0	0	15	0	0
10	129906468	rs4750936	C	T	10	8	18	0	0	18	0	0
10	129906980	rs2152143	C	T	7	5	12	0	0	12	0	0
10	129907544	rs2240	G	C	4	8	12	0	0	12	0	0
10	129910475	rs997983	T	G	6	3	9	0	0	9	0	0
10	129911856	.	C	G	6	9	15	0	0	15	0	0
10	129913960	rs7095325	A	T	7	6	13	0	0	13	0	0
10	129921195	rs1063536	A	T	6	5	11	0	0	11	0	0
10	131934747	rs13991	G	C	32	28	60	0	0	60	0	0
10	133752420	rs67378218	A	C	4	2	6	0	0	6	0	0
10	133761285	rs34473884	G	A	31	31	62	0	0	62	0	0
10	133767445	rs11146324	A	C	5	2	7	0	0	7	0	0
10	133769482	rs7894	G	C	50	31	81	0	0	81	0	0
10	133769848	rs7199	C	G	26	29	55	0	1	56	0	0
10	133772817	rs7911999	G	C	6	3	9	0	0	9	0	0
10	133781798	rs4550	C	T	5	7	12	0	1	13	0	0
10	133782549	rs7079909	C	T	7	1	8	0	0	8	0	0
10	133782616	rs45519634	C	T	6	2	8	0	0	8	0	0
10	133783275	rs45545137	G	A	4	3	7	0	0	7	0	0
10	133783450	rs45581832	T	C	6	4	10	0	0	10	0	0
10	133787021	rs4880405	G	A	6	5	11	0	0	11	0	0
10	134021149	rs1046577	T	C	3	15	18	0	0	18	0	0
10	134036193	rs2818401	A	G	21	3	24	0	1	25	0	0
10	134137627	rs7914257	T	C	5	2	7	0	0	7	0	0
10	134143942	rs1052281	C	T	6	14	20	0	0	20	0	0
10	134143985	rs1132165	G	T	8	12	20	0	0	20	0	0
10	134143986	rs1132164	C	T	8	12	20	0	0	20	0	0
10	134145136	rs7086691	A	G	17	7	24	0	0	24	0	0
10	134145138	rs7080014	C	G	16	7	23	0	0	23	0	0
10	134145153	rs7100410	G	A	15	8	23	0	0	23	0	0
10	134145166	rs13882	T	C	14	10	24	0	0	24	0	0
10	134145288	rs12778987	C	A	4	5	9	0	0	9	0	0
10	134145293	rs12784130	G	T	4	3	7	0	1	8	0	0
10	134161517	rs2474329	C	T	5	3	8	0	0	8	0	0
10	134180353	rs45626936	C	T	5	2	7	0	0	7	0	0
10	134218296	rs10747057	C	G	15	34	49	0	2	51	0	0
10	134219852	rs12242690	A	C	41	55	96	0	0	96	0	0
10	134220016	rs72863868	C	T	32	28	60	0	1	61	0	0
10	134223182	rs12246301	C	G	5	9	14	0	0	14	0	0
10	134223845	rs35169962	G	T	1	6	7	0	1	8	0	0
10	134225058	rs10781572	A	G	11	7	18	0	0	18	0	0
10	134228029	rs7901449	G	A	8	6	14	0	0	14	0	0
10	134459388	rs1133400	A	G	97	68	165	0	1	166	0	0
10	134521156	rs34288714	C	T	4	2	6	0	0	6	0	0
10	134591389	rs4880427	T	C	7	4	11	0	1	12	0	0
10	134592370	rs4609519	A	G	8	9	17	0	0	17	0	0
10	134594316	rs3793687	A	G	9	10	19	0	0	19	0	0
10	134595424	.	C	T	41	38	79	0	1	80	0	0
10	135054523	rs9419037	G	A	5	2	7	0	0	7	0	0
10	135054904	rs2980729	T	C	12	3	15	0	0	15	0	0
10	135055251	rs3750849	G	A	6	2	8	0	0	8	0	0
10	135101521	rs147278644	G	A	10	6	16	0	0	16	0	0
10	135118347	rs148379074	G	A	3	3	6	0	0	6	0	0
10	135158172	rs61363926	G	A	6	10	16	0	0	16	0	0
10	135186806	rs10466126	A	G	17	24	41	0	0	41	0	0
11	134704	.	G	A	6	0	6	0	0	6	0	0
11	202253	rs939916	G	A	9	0	9	0	0	9	0	0
11	204715	rs56357554	C	T	220	56	276	0	0	276	0	0
11	207698	rs56186913	C	T	2	4	6	0	0	6	0	0
11	236091	rs28365927	G	A	2	12	14	0	0	14	0	0
11	237087	rs1045288	A	G	140	354	494	0	3	497	0	0
11	237312	rs3817629	T	C	3	3	6	0	0	6	0	0
11	242624	rs7395328	T	A	3	4	7	0	0	7	0	0
11	243672	rs6598063	G	A	10	13	23	0	0	23	0	0
11	244106	rs10902112	A	G	13	11	24	0	0	24	0	0
11	244108	rs7107362	A	G	12	11	23	0	1	24	0	0
11	244115	rs7128044	G	A	11	10	21	0	0	21	0	0
11	244129	rs7116130	C	T	11	8	19	0	0	19	0	0
11	244197	rs1128322	T	C	177	467	644	0	1	645	0	0
11	244964	rs7124022	G	A	2	5	7	0	1	8	0	0
11	245686	rs7478850	A	G	4	4	8	0	0	8	0	0
11	247102	rs3829999	G	A	6	7	13	0	0	13	0	0
11	247160	rs3830000	A	G	8	11	19	0	0	19	0	0
11	251034	rs6598057	C	T	11	25	36	0	0	36	0	0
11	290816	rs10902120	A	G	11	25	36	0	0	36	0	0
11	295445	rs1060814	A	C	32	59	91	0	0	91	0	0
11	308314	rs14408	T	C	986	1004	1990	0	11	2001	0	0
11	308363	rs1058935	G	C	797	969	1766	0	11	1778	1	0
11	308426	rs1058964	G	C	517	279	796	0	9	805	0	0
11	320394	rs6421983	C	T	15	0	15	0	0	15	0	0
11	320805	rs1136853	G	T	0	1822	1822	0	8	1831	1	0
11	320836	rs34481144	C	T	909	0	909	0	7	916	0	0
11	330061	rs9666761	A	G	10	12	22	0	0	22	0	0
11	411681	.	T	G	7	1	8	0	2	10	0	0
11	496073	rs176939	C	G	19	5	24	0	0	24	0	0
11	497387	rs211525	G	A	6	10	16	0	3	19	0	0
11	497397	rs12277857	G	A	8	17	25	0	1	26	0	0
11	606749	rs936469	G	A	18	13	31	0	0	31	0	0
11	609068	rs7928902	G	A	152	52	204	0	4	208	0	0
11	611868	rs702965	C	T	109	30	139	0	1	140	0	0
11	611919	rs702966	C	G	117	49	166	0	1	167	0	0
11	613192	rs12422022	A	G	35	12	47	0	0	47	0	0
11	615010	rs12290989	G	T	7	4	11	0	1	12	0	0
11	615011	rs12272434	A	T	8	4	12	0	0	12	0	0
11	650751	rs149797391	C	T	8	8	16	0	1	17	0	0
11	650836	rs75163677	G	A	18	7	25	0	0	25	0	0
11	651768	rs10902182	C	G	2	9	11	0	0	11	0	0
11	653185	rs11246242	T	C	14	11	25	0	0	25	0	0
11	653248	.	G	C	17	10	27	0	0	27	0	0
11	653253	rs527589534	T	G	18	9	27	0	0	27	0	0
11	654043	rs10902188	G	A	450	164	614	0	0	614	0	0
11	703175	rs7107522	A	G	38	23	61	0	0	61	0	0
11	762441	rs4963163	A	C	22	7	29	0	0	29	0	0
11	771034	rs7930569	A	G	97	37	134	0	1	135	0	0
11	802379	rs10902221	T	C	65	32	97	0	0	97	0	0
11	802902	rs28360884	T	G	11	7	18	0	2	20	0	0
11	810113	rs146929030	G	A	8	5	13	0	0	13	0	0
11	810882	rs10902222	G	T	6	4	10	0	0	10	0	0
11	820268	rs7925131	A	G	160	55	215	0	3	218	0	0
11	820754	rs61876744	T	C	193	67	260	0	1	261	0	0
11	823809	rs1135628	C	G	414	889	1303	0	10	1314	1	0
11	837582	rs1130663	G	A	164	25	189	0	0	189	0	0
11	838424	rs1130680	C	T	44	3	47	0	1	48	0	0
11	838542	rs1130698	C	T	186	25	211	0	0	211	0	0
11	838634	rs8672	C	G	124	34	158	0	2	160	0	0
11	842543	rs28372895	C	G	9	5	14	0	0	14	0	0
11	866794	rs7091	A	G	0	7	7	0	0	7	0	0
11	927108	rs7480178	T	C	19	3	22	0	1	23	0	0
11	927355	rs7396951	G	A	10	0	10	0	0	10	0	0
11	927500	rs7394862	T	C	18	4	22	0	0	22	0	0
11	927553	rs7395182	A	C	20	4	24	0	0	24	0	0
11	928669	rs6597970	C	A	9	0	9	0	0	9	0	0
11	946228	rs10794351	C	T	7	0	7	0	0	7	0	0
11	946294	rs10794352	T	C	7	1	8	0	0	8	0	0
11	969818	rs11246362	C	T	7	0	7	0	0	7	0	0
11	970510	rs7396798	G	T	10	1	11	0	0	11	0	0
11	973374	rs10794357	T	C	6	0	6	0	0	6	0	0
11	985547	rs10794358	C	T	472	31	503	0	3	506	0	0
11	991099	rs6597953	G	A	21	1	22	0	1	23	0	0
11	993694	rs36081583	G	A	11	0	11	0	0	11	0	0
11	999620	rs11246375	T	C	20	4	24	0	0	24	0	0
11	999622	rs11246376	C	T	21	4	25	0	0	25	0	0
11	1001561	rs7396049	G	A	40	1	41	0	0	41	0	0
11	1001607	rs7396041	G	A	31	0	31	0	0	31	0	0
11	1003523	rs10902264	G	A	34	1	35	0	0	35	0	0
11	1003642	rs10902265	G	A	43	1	44	0	0	44	0	0
11	1004276	rs6597949	T	C	35	2	37	0	1	38	0	0
11	1004432	rs7481713	C	G	31	3	34	0	1	35	0	0
11	1005108	rs7394783	A	G	71	2	73	0	0	73	0	0
11	1010649	rs72842410	C	T	66	726	792	0	8	800	0	0
11	1010694	rs1128413	C	T	855	53	908	0	2	910	0	0
11	1011490	rs7950955	G	A	155	10	165	0	1	166	0	0
11	1300406	rs3829223	C	T	10	3	13	0	0	13	0	0
11	1311489	.	C	T	66	183	249	0	3	252	0	0
11	1320672	rs5743922	C	T	12	28	40	0	2	42	0	0
11	1321060	rs4963060	G	A	34	8	42	0	0	42	0	0
11	1321596	rs5743915	G	A	17	30	47	0	1	48	0	0
11	1323284	rs5743900	G	C	8	34	42	0	0	42	0	0
11	1493132	rs12801744	C	T	17	3	20	0	0	20	0	0
11	1755542	rs7939461	G	A	21	7	28	0	0	28	0	0
11	1755971	rs2292959	A	C	20	5	25	0	0	25	0	0
11	1784133	rs61869050	G	A	4	7	11	0	0	11	0	0
11	1902097	rs4980383	C	T	5	9	14	0	1	15	0	0
11	1976306	rs11600982	G	A	6	1	7	0	0	7	0	0
11	2317496	rs80058569	C	G	48	69	117	0	0	117	0	0
11	2337693	rs2234308	G	A	11	18	29	0	0	29	0	0
11	2338240	rs11022258	A	T	8	4	12	0	0	12	0	0
11	2357368	rs74050360	C	T	3	3	6	0	0	6	0	0
11	2403002	rs874330	C	T	3	5	8	0	0	8	0	0
11	2408523	rs11022565	G	T	1	8	9	0	0	9	0	0
11	2409339	rs11826179	C	T	1	6	7	0	0	7	0	0
11	2410343	rs74050514	A	T	3	6	9	0	0	9	0	0
11	2410347	rs12289704	C	T	3	6	9	0	0	9	0	0
11	2410438	rs7939051	T	C	3	5	8	0	0	8	0	0
11	2410771	rs7939184	A	G	1	9	10	0	0	10	0	0
11	2410797	rs7952267	G	A	1	7	8	0	1	9	0	0
11	2411244	rs74050520	A	G	1	8	9	0	0	9	0	0
11	2412366	rs79073497	C	G	0	11	11	0	0	11	0	0
11	2412386	rs74050522	A	G	0	9	9	0	0	9	0	0
11	2412645	rs78574124	C	G	4	15	19	0	0	19	0	0
11	2412662	rs60543097	A	G	7	21	28	0	0	28	0	0
11	2413857	rs11022591	C	G	8	26	34	0	0	34	0	0
11	2414495	rs2074240	G	A	10	15	25	0	0	25	0	0
11	2414496	rs2074241	C	A	10	15	25	0	0	25	0	0
11	2414837	rs7940819	C	A	9	39	48	0	0	48	0	0
11	2414891	rs2074245	T	C	10	40	50	0	0	50	0	0
11	2414935	rs2074246	A	G	6	27	33	0	0	33	0	0
11	2416118	rs12277341	G	A	14	40	54	0	0	54	0	0
11	2416884	rs60058561	T	G	5	11	16	0	0	16	0	0
11	2416922	rs78678325	G	C	5	18	23	0	0	23	0	0
11	2417270	rs11022606	G	T	4	16	20	0	0	20	0	0
11	2417523	rs11022607	A	G	23	58	81	0	1	82	0	0
11	2417893	rs14077	C	T	554	1735	2289	0	11	2303	3	0
11	2797237	rs1057128	G	A	2	5	7	0	0	7	0	0
11	2870108	rs8234	A	G	1	5	6	0	0	6	0	0
11	3398741	.	G	A	8	3	11	0	0	11	0	0
11	3650884	rs10834659	C	G	0	6	6	0	0	6	0	0
11	3650897	rs61878493	T	A	6	1	7	0	0	7	0	0
11	3652616	rs10767372	A	G	8	9	17	0	0	17	0	0
11	3701451	rs35670193	A	G	7	2	9	0	0	9	0	0
11	3723730	.	C	T	397	118	515	0	1	516	0	0
11	3731308	rs10834920	G	C	14	2	16	0	1	17	0	0
11	3756686	rs276907	T	C	122	53	175	0	5	180	0	0
11	3773204	rs276896	G	A	0	12	12	0	0	12	0	0
11	3778311	rs2957871	C	A	0	7	7	0	0	7	0	0
11	3778432	rs7933512	T	C	11	4	15	0	0	15	0	0
11	3804054	.	C	A	3	3	6	0	0	6	0	0
11	3808138	rs10767587	T	G	7	1	8	0	0	8	0	0
11	3877074	rs10835206	C	T	28	92	120	0	2	122	0	0
11	3905512	rs10835236	G	T	0	6	6	0	0	6	0	0
11	3909286	rs1869084	G	A	0	6	6	0	0	6	0	0
11	3910306	rs10835247	G	A	3	4	7	0	0	7	0	0
11	3910328	rs10835248	G	A	3	4	7	0	0	7	0	0
11	3911198	rs10835250	G	T	1	5	6	0	0	6	0	0
11	3911216	rs10767679	A	C	1	5	6	0	0	6	0	0
11	3958828	rs10835337	C	T	1	5	6	0	0	6	0	0
11	4071429	rs10835540	T	A	4	11	15	0	0	15	0	0
11	4071513	.	G	C	4	12	16	0	0	16	0	0
11	4107584	rs2412344	T	C	9	8	17	0	0	17	0	0
11	4142592	rs3817657	T	C	1	5	6	0	0	6	0	0
11	4159457	rs9937	A	G	57	19	76	0	0	76	0	0
11	4414162	rs928913	T	G	2	4	6	0	0	6	0	0
11	5700340	rs3740995	T	C	52	11	63	0	1	64	0	0
11	5717762	rs10838543	T	C	42	134	176	0	0	176	0	0
11	5718159	rs10838545	C	T	15	21	36	0	0	36	0	0
11	5718213	rs10838546	C	A	11	24	35	0	0	35	0	0
11	5718517	rs7935564	G	A	40	153	193	0	1	194	0	0
11	5718712	rs7936676	C	T	14	34	48	0	1	49	0	0
11	5719848	rs7950912	C	T	7	2	9	0	0	9	0	0
11	5722100	rs2133261	C	A	0	7	7	0	0	7	0	0
11	5724342	rs10742775	G	T	2	4	6	0	0	6	0	0
11	5728898	rs5021595	T	C	3	10	13	0	0	13	0	0
11	5730343	rs12364019	G	A	164	53	217	0	1	218	0	0
11	5737663	rs12280066	G	A	4	3	7	0	0	7	0	0
11	6238960	rs3750943	C	A	4	12	16	0	0	16	0	0
11	6413366	rs72896268	C	T	41	20	61	0	0	61	0	0
11	6580495	rs72901756	G	A	5	1	6	0	0	6	0	0
11	6613232	rs7109662	C	T	2	7	9	0	0	9	0	0
11	6616815	rs4758437	C	T	9	19	28	0	1	29	0	0
11	6618548	rs11040930	G	A	13	42	55	0	0	55	0	0
11	6622714	rs2288283	G	A	34	162	196	0	1	198	1	0
11	6622857	rs11826421	G	A	10	28	38	0	0	38	0	0
11	6638174	rs1800710	A	G	4	13	17	0	0	17	0	0
11	8009420	rs12278319	G	A	4	2	6	0	0	6	0	0
11	8014112	rs3903047	C	A	10	4	14	0	0	14	0	0
11	8014138	rs3892448	A	G	11	4	15	0	0	15	0	0
11	8969309	rs10279	T	C	140	397	537	0	5	542	0	0
11	8971555	rs56680262	C	T	5	9	14	0	0	14	0	0
11	8973168	rs2653594	G	A	3	10	13	0	0	13	0	0
11	8977830	rs2568068	A	G	104	268	372	0	1	373	0	0
11	8998158	rs2252102	C	A	11	3	14	0	0	14	0	0
11	9002147	rs2653609	G	A	18	14	32	0	0	32	0	0
11	9002824	rs2742473	A	G	63	52	115	0	0	115	0	0
11	9003942	rs117684084	C	A	69	50	119	0	2	121	0	0
11	9007669	rs3815991	G	A	5	4	9	0	0	9	0	0
11	9010006	rs2568047	A	C	3	7	10	0	0	10	0	0
11	9162006	rs140558609	T	C	48	24	72	0	0	72	0	0
11	9195522	.	C	T	17	3	20	0	0	20	0	0
11	9451800	rs7122252	G	A	5	9	14	0	0	14	0	0
11	9468367	rs4810	A	G	17	70	87	0	3	90	0	0
11	9468454	rs8785	G	A	43	162	205	0	2	207	0	0
11	9599653	rs4910480	G	A	3	4	7	0	0	7	0	0
11	9602009	.	C	T	1	5	6	0	1	7	0	0
11	9604208	rs12419221	C	T	7	15	22	0	0	22	0	0
11	9605635	rs35198914	C	T	6	6	12	0	1	13	0	0
11	10038211	rs2896517	T	C	16	8	24	0	0	24	0	0
11	10491945	rs61314883	C	T	5	4	9	0	0	9	0	0
11	10491950	rs4909933	G	A	4	5	9	0	0	9	0	0
11	10491992	rs4909934	G	T	5	4	9	0	0	9	0	0
11	10503756	rs16907852	G	A	26	59	85	0	2	87	0	0
11	10772555	rs2279696	A	G	16	5	21	0	0	21	0	0
11	10793612	rs7933831	A	T	0	8	8	0	0	8	0	0
11	11979592	rs11255	G	A	12	1	13	0	1	14	0	0
11	11979674	rs1979687	A	G	9	2	11	0	1	12	0	0
11	11980397	rs13903	T	C	11	3	14	0	0	14	0	0
11	11980449	rs2279566	A	G	12	3	15	0	1	16	0	0
11	12246233	rs3816921	G	C	39	14	53	0	1	54	0	0
11	12265337	rs2270509	C	G	5	1	6	0	0	6	0	0
11	12265542	rs2270511	A	G	6	1	7	0	1	8	0	0
11	12283928	rs10765933	C	T	52	23	75	0	0	75	0	0
11	12284741	rs3812749	A	T	62	20	82	0	0	82	0	0
11	12316085	rs3812753	T	A	0	8	8	0	0	8	0	0
11	13365588	rs12274451	C	T	0	6	6	0	0	6	0	0
11	13398608	rs12363415	A	G	1	5	6	0	0	6	0	0
11	13441126	rs7114113	A	G	5	21	26	0	1	27	0	0
11	13697121	rs371845778	C	T	5	1	6	0	0	6	0	0
11	13707479	rs10741623	A	G	9	3	12	0	0	12	0	0
11	13713576	rs113319334	G	A	1	5	6	0	0	6	0	0
11	13716530	rs7130943	A	G	5	13	18	0	0	18	0	0
11	13726910	rs1023772	T	G	26	67	93	0	1	94	0	0
11	13727306	rs11022941	C	G	10	18	28	0	0	28	0	0
11	14497269	rs2597194	C	T	12	1	13	0	0	13	0	0
11	14516695	rs577733321	C	T	8	1	9	0	0	9	0	0
11	14530127	rs77689837	A	G	24	2	26	0	1	27	0	0
11	14532338	rs2597218	C	T	6	3	9	0	0	9	0	0
11	14672984	rs1403249	G	A	352	103	455	0	2	457	0	0
11	14683683	rs146128209	A	G	43	28	71	0	0	71	0	0
11	14685886	rs6486200	T	C	75	15	90	0	0	90	0	0
11	14686743	rs78474492	T	G	75	26	101	0	0	101	0	0
11	14693935	rs11023302	C	G	5	2	7	0	0	7	0	0
11	14695046	rs12290926	A	G	12	2	14	0	0	14	0	0
11	14725263	rs11023310	T	G	15	1	16	0	0	16	0	0
11	14810762	rs4757268	A	G	88	27	115	0	1	116	0	0
11	14828261	rs10832303	C	T	6	2	8	0	0	8	0	0
11	14913575	rs12794714	G	A	18	1	19	0	0	19	0	0
11	16760724	rs11826990	T	G	14	2	16	0	0	16	0	0
11	16760796	rs10766342	G	A	10	1	11	0	0	11	0	0
11	16760991	rs61881964	C	T	9	3	12	0	0	12	0	0
11	16764442	rs4757429	C	T	20	2	22	0	0	22	0	0
11	16772832	rs61881966	A	G	24	10	34	0	0	34	0	0
11	16809573	rs1557875	G	A	7	2	9	0	0	9	0	0
11	16810599	rs77525146	C	T	2	4	6	0	0	6	0	0
11	17096211	rs1541533	A	G	40	240	280	0	0	280	0	0
11	17148917	rs138129848	G	A	4	3	7	0	0	7	0	0
11	17191019	rs214936	A	G	8	36	44	0	0	44	0	0
11	17298365	rs214087	G	C	349	101	450	0	1	452	1	0
11	17305600	rs214069	G	A	6	1	7	0	0	7	0	0
11	17305650	rs214068	T	C	6	1	7	0	0	7	0	0
11	17354775	rs11024256	T	G	73	10	83	0	0	83	0	0
11	17397273	rs10832782	G	C	8	0	8	0	0	8	0	0
11	18303169	rs7945996	T	C	5	4	9	0	0	9	0	0
11	18317864	rs11024606	C	A	9	2	11	0	0	11	0	0
11	18631527	rs11024731	T	C	18	4	22	0	0	22	0	0
11	18631650	rs75690693	A	G	3	21	24	0	0	24	0	0
11	18633971	rs11605097	G	A	194	499	693	0	16	711	2	0
11	22646025	rs4447177	G	A	12	12	24	0	0	24	0	0
11	27527972	rs188711613	C	T	17	10	27	0	0	27	0	0
11	30344725	rs4071559	C	T	30	86	116	0	0	116	0	0
11	30355197	rs7122449	C	T	2	7	9	0	0	9	0	0
11	30356420	rs12272134	T	C	2	5	7	0	0	7	0	0
11	30359231	rs7116893	A	G	12	31	43	0	1	44	0	0
11	32121040	rs11031589	C	T	1	6	7	0	0	7	0	0
11	32122003	rs2281411	C	A	2	10	12	0	0	12	0	0
11	32123016	rs10835840	A	G	0	8	8	0	2	10	0	0
11	32123672	rs4922891	G	A	4	16	20	0	0	20	0	0
11	32124685	rs223059	G	A	3	28	31	0	0	31	0	0
11	32417945	rs16754	T	C	5	105	110	0	0	110	0	0
11	32457774	rs2301253	G	A	4	18	22	0	0	22	0	0
11	32458507	rs3886325	G	A	1	48	49	0	0	49	0	0
11	32468058	rs10767938	T	C	0	7	7	0	0	7	0	0
11	32625854	rs11031895	A	G	14	7	21	0	1	22	0	0
11	32878615	rs34196291	G	C	30	11	41	0	0	41	0	0
11	32879174	rs12786991	G	A	31	5	36	0	0	36	0	0
11	32930439	rs10835991	T	C	2	4	6	0	0	6	0	0
11	32956620	rs7481878	A	G	41	19	60	0	0	60	0	0
11	33061663	rs2273541	C	T	3	17	20	0	4	24	0	0
11	33061738	rs2273542	C	T	8	12	20	0	0	20	0	0
11	33061814	rs2273543	C	T	2	11	13	0	1	14	0	0
11	33076191	rs2273544	T	C	39	110	149	0	0	149	0	0
11	33088024	rs10836019	A	G	1	5	6	0	0	6	0	0
11	33097828	rs2273552	G	A	13	41	54	0	0	54	0	0
11	33291462	rs10836046	G	A	6	7	13	0	1	14	0	0
11	33293958	rs4755552	T	A	2	4	6	0	0	6	0	0
11	33302158	rs1610316	C	T	4	12	16	0	0	16	0	0
11	33305142	rs10836049	A	G	1	6	7	0	0	7	0	0
11	33765683	rs11032363	T	C	10	22	32	0	0	32	0	0
11	33766630	rs831596	A	G	37	101	138	0	0	138	0	0
11	33768086	rs7120610	T	G	57	13	70	0	0	70	0	0
11	33769336	rs12295284	G	C	4	2	6	0	0	6	0	0
11	33778882	rs10836105	C	G	22	7	29	0	0	29	0	0
11	33779018	rs12146621	A	T	2	6	8	0	0	8	0	0
11	33779415	rs1112840	T	G	7	21	28	0	0	28	0	0
11	33779565	rs1578986	C	A	5	14	19	0	0	19	0	0
11	33792977	rs1464487	G	A	9	29	38	0	1	39	0	0
11	33793165	rs1464486	T	C	8	32	40	0	0	40	0	0
11	33884816	.	T	C	50	33	83	0	3	86	0	0
11	33885268	rs3781574	A	G	97	34	131	0	1	132	0	0
11	33892656	rs11606830	G	T	27	5	32	0	1	33	0	0
11	33895527	rs11032433	T	C	9	4	13	0	0	13	0	0
11	33896780	rs7111491	T	C	16	4	20	0	0	20	0	0
11	33909421	rs11032438	A	G	4	2	6	0	0	6	0	0
11	33912790	rs11032440	C	T	19	68	87	0	0	87	0	0
11	34160326	rs12421526	T	A	6	17	23	0	0	23	0	0
11	34477876	rs2073059	G	C	3	6	9	0	0	9	0	0
11	34479711	rs12273124	A	G	11	5	16	0	0	16	0	0
11	34481095	rs10836244	G	T	3	6	9	0	1	10	0	0
11	34481996	.	T	C	9	0	9	0	1	10	0	0
11	34482908	rs769217	C	T	316	925	1241	0	3	1244	0	0
11	34484205	rs4755372	C	T	1	5	6	0	0	6	0	0
11	34484234	rs4755373	A	G	1	5	6	0	0	6	0	0
11	34913265	rs2985388	G	A	14	2	16	0	0	16	0	0
11	34917809	rs2986428	A	G	6	1	7	0	0	7	0	0
11	34969112	rs11539202	A	G	3	13	16	0	0	16	0	0
11	35161423	rs12362973	A	G	5	23	28	0	0	28	0	0
11	35163114	rs11033008	T	C	4	27	31	0	0	31	0	0
11	35165800	rs187116	G	A	5	43	48	0	0	48	0	0
11	35166798	rs1425803	C	T	1	27	28	0	0	28	0	0
11	35172657	rs353622	T	C	3	56	59	0	0	59	0	0
11	35175045	rs353618	T	C	7	45	52	0	1	53	0	0
11	35177479	rs353615	C	T	1	12	13	0	0	13	0	0
11	35178531	rs353614	A	G	0	10	10	0	0	10	0	0
11	35178583	rs353613	T	C	0	10	10	0	0	10	0	0
11	35181613	rs353644	T	C	3	16	19	0	0	19	0	0
11	35181679	rs353643	C	G	5	11	16	0	0	16	0	0
11	35183019	rs353641	G	A	5	22	27	0	0	27	0	0
11	35184364	rs353639	T	G	9	17	26	0	0	26	0	0
11	35184730	rs353636	G	T	3	5	8	0	0	8	0	0
11	35184823	rs353635	G	C	0	7	7	0	0	7	0	0
11	35187568	rs353631	T	C	3	19	22	0	0	22	0	0
11	35188507	rs353628	G	C	3	15	18	0	2	20	0	0
11	35192629	rs112762	C	T	6	15	21	0	0	21	0	0
11	35196599	rs75761035	C	T	4	13	17	0	0	17	0	0
11	35200916	rs3794105	G	A	2	4	6	0	0	6	0	0
11	35208251	rs3736812	A	G	9	3	12	0	0	12	0	0
11	35210798	rs996076	G	A	17	61	78	0	0	78	0	0
11	35213126	rs7934770	G	T	22	91	113	0	0	113	0	0
11	35215726	rs10128562	T	G	23	64	87	0	0	87	0	0
11	35216814	rs7947433	A	G	18	30	48	0	1	49	0	0
11	35224531	rs75199214	G	A	126	49	175	0	2	177	0	0
11	35225044	rs79685344	T	A	81	31	112	0	1	113	0	0
11	35241229	rs2295756	T	C	10	28	38	0	0	38	0	0
11	35241637	rs10836342	C	G	9	21	30	0	0	30	0	0
11	35242907	rs10734436	G	A	2	10	12	0	0	12	0	0
11	35248598	rs117145986	C	T	47	8	55	0	1	56	0	0
11	35282649	rs56290831	A	G	5	10	15	0	1	16	0	0
11	35827958	rs61881297	A	G	57	20	77	0	3	80	0	0
11	36298197	rs71481909	C	T	1	6	7	0	0	7	0	0
11	36408143	rs452465	A	C	5	2	7	0	0	7	0	0
11	36422702	.	G	A	19	24	43	0	1	44	0	0
11	36475328	rs890258	C	G	2	4	6	0	0	6	0	0
11	36476021	rs44883	T	C	5	1	6	0	0	6	0	0
11	36480142	rs57910561	G	A	5	2	7	0	0	7	0	0
11	36509776	rs5030483	A	T	79	244	323	0	3	326	0	0
11	36510026	rs5030482	T	C	250	81	331	0	5	336	0	0
11	36510618	rs505296	T	C	82	167	249	0	2	251	0	0
11	36513011	.	C	G	2	8	10	0	0	10	0	0
11	36513786	rs5030472	C	T	66	18	84	0	0	84	0	0
11	43347040	rs56109100	G	A	91	25	116	0	1	117	0	0
11	43855072	rs10838183	A	G	2	4	6	0	0	6	0	0
11	43857418	rs7931097	A	G	1	12	13	0	0	13	0	0
11	43858682	rs2139154	A	G	0	6	6	0	0	6	0	0
11	43876698	rs11555762	C	T	170	23	193	0	1	194	0	0
11	43877934	rs1061810	C	A	177	24	201	0	1	202	0	0
11	43913604	rs16937692	G	A	16	30	46	0	0	46	0	0
11	43917976	rs35224339	C	T	0	6	6	0	0	6	0	0
11	43920006	rs7107050	A	G	5	17	22	0	0	22	0	0
11	44098985	rs2074043	G	A	4	5	9	0	0	9	0	0
11	44607849	rs10838310	A	T	19	3	22	0	0	22	0	0
11	44608605	rs1981994	C	G	7	21	28	0	0	28	0	0
11	44610777	rs11038074	G	C	9	3	12	0	0	12	0	0
11	44610791	rs6485547	G	A	3	8	11	0	0	11	0	0
11	44612714	rs934177	C	G	7	2	9	0	0	9	0	0
11	44615096	rs34163838	C	T	5	3	8	0	0	8	0	0
11	44616542	rs7925603	A	G	8	15	23	0	1	24	0	0
11	44616829	rs891307	G	A	9	12	21	0	0	21	0	0
11	44620957	rs4755850	G	A	13	20	33	0	0	33	0	0
11	44622733	rs11038078	G	A	6	5	11	0	0	11	0	0
11	44631655	rs11601257	T	C	35	17	52	0	1	53	0	0
11	44633060	rs11820032	G	A	67	26	93	0	0	93	0	0
11	44638655	rs10838316	G	A	224	52	276	0	3	279	0	0
11	44640268	rs1139971	A	G	1353	3354	4707	0	22	4731	2	0
11	45185779	rs732161	C	G	2	5	7	0	0	7	0	0
11	45832935	rs1139266	G	A	10	8	18	0	0	18	0	0
11	45833960	rs4756026	C	T	8	5	13	0	0	13	0	0
11	45883268	rs72902439	C	G	21	9	30	0	0	30	0	0
11	45883298	rs17787106	T	A	10	7	17	0	0	17	0	0
11	45894636	rs17787136	C	G	8	1	9	0	1	10	0	0
11	45934552	.	T	A	7	3	10	0	0	10	0	0
11	45934553	rs117348264	T	A	8	3	11	0	0	11	0	0
11	45934556	rs75195029	T	A	8	3	11	0	0	11	0	0
11	45934697	rs4505038	T	G	15	8	23	0	0	23	0	0
11	45935689	rs35214605	C	G	70	171	241	0	1	242	0	0
11	45936817	rs939108	G	C	5	5	10	0	0	10	0	0
11	45951306	rs10838533	T	C	51	14	65	0	1	66	0	0
11	45958637	rs7934681	G	A	9	1	10	0	0	10	0	0
11	45958648	rs7934572	C	G	10	1	11	0	0	11	0	0
11	45964993	rs7108028	A	C	6	0	6	0	0	6	0	0
11	45984400	rs10769177	T	C	48	11	59	0	0	59	0	0
11	46646703	.	T	C	10	4	14	0	0	14	0	0
11	46692689	rs76533702	C	T	3	9	12	0	0	12	0	0
11	46723603	rs10769205	G	A	13	0	13	0	0	13	0	0
11	46810916	rs11038993	C	A	4	6	10	0	0	10	0	0
11	47182353	rs7940473	A	G	7	5	12	0	0	12	0	0
11	47182368	rs10769244	A	G	5	7	12	0	0	12	0	0
11	47182370	rs10769245	G	A	5	7	12	0	0	12	0	0
11	47193367	rs57323109	T	G	8	36	44	0	0	44	0	0
11	47193566	rs11600668	G	A	9	28	37	0	0	37	0	0
11	47255317	rs3781619	G	A	3	5	8	0	1	9	0	0
11	47255598	rs326224	T	C	4	3	7	0	0	7	0	0
11	47259993	rs4647757	G	A	5	5	10	0	0	10	0	0
11	47303275	rs326217	T	C	178	68	246	0	3	249	0	0
11	47312892	rs10838687	T	G	1	19	20	0	0	20	0	0
11	47323821	rs11493249	G	C	0	20	20	0	1	21	0	0
11	47334524	rs10838689	G	A	2	6	8	0	0	8	0	0
11	47345100	rs10838692	T	C	6	20	26	0	0	26	0	0
11	47346145	rs2290148	G	A	3	7	10	0	0	10	0	0
11	47349969	rs753993	C	A	22	55	77	0	2	79	0	0
11	47350287	rs2305280	G	A	6	11	17	0	0	17	0	0
11	47350553	rs10838693	G	C	4	5	9	0	0	9	0	0
11	47393494	rs79513206	C	T	8	0	8	0	0	8	0	0
11	47431703	rs61897432	A	G	95	24	119	0	1	120	0	0
11	47441356	rs3781628	G	T	5	21	26	0	0	26	0	0
11	47443654	rs141325867	C	T	13	2	15	0	0	15	0	0
11	47500267	rs2242081	T	C	108	44	152	0	3	155	0	0
11	47501619	rs59631865	T	G	14	27	41	0	3	44	0	0
11	47501888	rs57680742	C	T	27	10	37	0	0	37	0	0
11	47602879	rs75422278	G	A	49	6	55	0	0	57	2	0
11	47740662	rs2869534	G	A	9	3	12	0	0	12	0	0
11	47753370	rs2290851	C	T	23	72	95	0	1	96	0	0
11	47773518	rs6485775	A	G	9	39	48	0	0	48	0	0
11	47805856	rs12226431	G	A	10	1	11	0	0	11	0	0
11	47857253	rs3816605	T	C	26	9	35	0	1	36	0	0
11	68697414	.	T	C	4	7	11	0	0	11	0	0
11	89925762	rs1061470	C	T	4	2	6	0	0	6	0	0
11	89935586	rs1045861	G	T	244	152	396	0	3	399	0	0
11	89936992	rs10830440	A	C	2	7	9	0	0	9	0	0
11	89937684	rs11018909	C	T	14	7	21	0	0	21	0	0
11	89937821	rs11018910	G	A	14	7	21	0	0	21	0	0
11	89938026	rs10765273	C	T	10	9	19	0	0	19	0	0
11	89938348	rs2186606	T	G	9	2	11	0	0	11	0	0
11	89939448	rs1943381	G	A	12	12	24	0	0	24	0	0
11	89939569	rs723715	T	C	11	8	19	0	0	19	0	0
11	89941238	.	T	A	4	6	10	0	0	10	0	0
11	89941327	rs10741327	G	A	11	5	16	0	0	16	0	0
11	89942062	rs7111107	T	C	11	15	26	0	0	26	0	0
11	89942655	rs11018913	G	C	8	8	16	0	0	16	0	0
11	89942879	rs11018915	G	A	15	9	24	0	0	24	0	0
11	89943221	rs11018916	G	A	13	7	20	0	0	20	0	0
11	89943420	rs3740820	A	C	7	5	12	0	0	12	0	0
11	89944964	rs10765275	C	T	30	12	42	0	0	42	0	0
11	89945358	rs10765276	C	A	60	36	96	0	3	99	0	0
11	89945381	rs10830443	A	G	62	35	97	0	0	97	0	0
11	89945647	rs11018917	A	C	42	31	73	0	0	73	0	0
11	89945668	rs2226571	C	T	43	29	72	0	0	72	0	0
11	89950035	rs10830444	G	T	6	2	8	0	0	8	0	0
11	89950271	rs10830445	C	A	11	2	13	0	0	13	0	0
11	89950478	rs11018918	C	T	4	8	12	0	0	12	0	0
11	89952015	rs11018919	A	G	4	4	8	0	0	8	0	0
11	89955389	rs6483036	G	T	5	2	7	0	0	7	0	0
11	92879172	rs67573258	T	C	4	3	7	0	0	7	0	0
11	92880243	rs12574282	G	A	6	11	17	0	0	17	0	0
11	92880279	rs12221889	G	A	16	3	19	0	1	20	0	0
11	92881044	rs1062050	T	G	37	47	84	0	0	84	0	0
11	92893654	rs1508607	A	T	3	3	6	0	0	6	0	0
11	92906312	rs202215471	T	C	6	2	8	0	0	8	0	0
11	92910599	rs150195070	G	A	2	4	6	0	0	6	0	0
11	92910905	rs10831000	G	A	6	1	7	0	0	7	0	0
11	92914765	rs61920515	T	C	6	2	8	0	0	8	0	0
11	92915338	rs3957618	C	T	6	1	7	0	0	7	0	0
11	92915544	rs11020190	A	G	2	4	6	0	0	6	0	0
11	92916819	rs16918625	A	G	1	5	6	0	0	6	0	0
11	92917108	rs10765592	C	T	8	4	12	0	0	12	0	0
11	92918587	rs10831005	C	T	4	4	8	0	1	9	0	0
11	92931056	rs11020196	G	T	4	2	6	0	0	6	0	0
11	92931057	rs11020197	C	T	4	2	6	0	0	6	0	0
11	93914451	rs1046805	G	A	24	17	41	0	0	41	0	0
11	93914709	rs1046812	T	C	40	27	67	0	0	67	0	0
11	93914956	rs1070	A	G	20	19	39	0	0	39	0	0
11	93921742	rs7927496	C	T	15	0	15	0	2	17	0	0
11	94300503	rs72963841	C	T	5	5	10	0	0	10	0	0
11	94863186	rs503612	C	A	3	6	9	0	0	9	0	0
11	94917229	rs185281880	A	T	3	4	7	0	0	7	0	0
11	95505257	rs75900376	T	C	4	5	9	0	0	9	0	0
11	95508524	rs10831429	C	A	6	4	10	0	0	10	0	0
11	95508562	rs61902242	T	C	8	4	12	0	0	12	0	0
11	95512060	rs1150360	A	G	212	157	369	0	4	373	0	0
11	95516536	rs7949888	A	G	45	24	69	0	0	69	0	0
11	95517737	rs61902245	C	T	9	3	12	0	1	13	0	0
11	95518505	rs61902247	T	C	36	19	55	0	1	56	0	0
11	95519157	rs3748251	T	C	29	14	43	0	1	44	0	0
11	95519195	rs3748252	A	T	26	13	39	0	1	40	0	0
11	95519486	.	C	T	8	7	15	0	0	15	0	0
11	95519506	rs3748253	G	A	11	5	16	0	0	16	0	0
11	95519658	rs57631568	C	T	3	3	6	0	1	7	0	0
11	95520406	rs78040382	T	G	12	8	20	0	0	20	0	0
11	95520695	rs1313288	T	C	14	4	18	0	0	18	0	0
11	95521648	rs1727165	A	G	4	4	8	0	0	8	0	0
11	95522468	rs61902252	G	A	11	6	17	0	0	17	0	0
11	95523433	rs1622515	A	G	10	5	15	0	0	15	0	0
11	95524067	rs12272061	G	T	8	5	13	0	0	13	0	0
11	95524133	rs60668630	C	T	7	5	12	0	0	12	0	0
11	95524421	rs12273579	G	A	9	1	10	0	0	10	0	0
11	95525550	rs151305907	T	C	5	9	14	0	0	14	0	0
11	95526117	rs16922543	A	G	4	2	6	0	0	6	0	0
11	95527525	rs77122249	T	G	6	4	10	0	0	10	0	0
11	95528714	rs522536	C	T	35	1	36	0	0	36	0	0
11	95554283	rs603625	G	A	3	3	6	0	0	6	0	0
11	95556257	rs1057194	G	A	20	19	39	0	0	39	0	0
11	95556945	rs146709489	A	T	18	12	30	0	0	30	0	0
11	95558418	rs61903296	T	A	23	21	44	0	0	44	0	0
11	95558954	rs188147595	G	A	16	11	27	0	0	27	0	0
11	95565288	rs7902	A	G	48	31	79	0	1	80	0	0
11	95567058	rs16922615	G	A	6	17	23	0	1	24	0	0
11	95567388	rs16922622	A	G	23	52	75	0	1	76	0	0
11	95591351	rs7107251	C	T	5	7	12	0	0	12	0	0
11	95647422	rs187282743	T	A	6	14	20	0	0	20	0	0
11	96093603	rs4315032	C	T	4	7	11	0	0	11	0	0
11	96096137	rs56015144	T	C	4	2	6	0	0	6	0	0
11	96097210	rs10831515	T	C	2	7	9	0	0	9	0	0
11	96114165	rs12796830	C	T	5	4	9	0	0	9	0	0
11	96115744	rs11021563	C	T	7	9	16	0	0	16	0	0
11	96115803	rs11021564	A	T	10	7	17	0	0	17	0	0
11	96116444	rs10831519	T	C	38	114	152	0	0	152	0	0
11	96119605	rs12273522	G	A	11	24	35	0	2	37	0	0
11	96121855	rs11021568	C	T	8	21	29	0	0	29	0	0
11	96122428	rs12365516	C	T	14	26	40	0	0	40	0	0
11	101868415	rs1783742	C	T	5	15	20	0	0	20	0	0
11	102268603	rs61895387	A	T	644	410	1054	0	28	1082	0	0
11	102275620	rs679366	A	G	10	2	12	0	0	12	0	0
11	102281044	rs139269986	A	T	6	15	21	0	0	21	0	0
11	102285040	.	C	T	6	5	11	0	0	11	0	0
11	102582941	rs7934972	G	A	6	6	12	0	0	12	0	0
11	102583033	rs1939017	T	A	3	6	9	0	0	9	0	0
11	102583075	rs7925438	T	C	4	6	10	0	0	10	0	0
11	102583373	rs1291327	T	C	4	4	8	0	0	8	0	0
11	102583394	rs1276282	A	G	3	4	7	0	0	7	0	0
11	103229027	rs2566913	T	C	6	3	9	0	0	9	0	0
11	104813887	rs547584	C	T	4	2	6	0	0	6	0	0
11	105878844	rs1043144	C	T	14	11	25	0	0	25	0	0
11	105891999	rs10895893	A	G	1	6	7	0	0	7	0	0
11	107197235	rs1046095	A	T	7	12	19	0	0	19	0	0
11	107197256	rs1046094	C	G	7	17	24	0	0	24	0	0
11	107197536	rs630782	C	T	17	16	33	0	0	33	0	0
11	107197640	rs3758911	T	C	13	15	28	0	0	28	0	0
11	107198610	rs11212162	A	G	6	7	13	0	0	13	0	0
11	107198731	rs11212163	G	A	4	6	10	0	0	10	0	0
11	107198839	rs11212164	T	C	3	8	11	0	0	11	0	0
11	107200431	rs10502086	G	T	3	3	6	0	0	6	0	0
11	107253627	rs474290	G	A	4	2	6	0	0	6	0	0
11	107374531	rs10502092	C	T	13	10	23	0	0	23	0	0
11	107396158	rs12574614	T	C	3	3	6	0	0	6	0	0
11	107405648	rs621303	A	G	5	7	12	0	0	12	0	0
11	107406057	rs61908194	T	C	21	5	26	0	0	26	0	0
11	107408223	rs61908195	T	C	4	3	7	0	0	7	0	0
11	107408239	rs61908196	A	C	4	3	7	0	0	7	0	0
11	107410123	rs2037823	T	C	6	2	8	0	0	8	0	0
11	107410527	rs4754230	G	A	7	4	11	0	0	11	0	0
11	107421504	rs580821	C	G	1	7	8	0	0	8	0	0
11	107421515	rs630480	G	A	1	7	8	0	0	8	0	0
11	107421915	rs147671155	A	G	0	10	10	0	0	10	0	0
11	107662790	rs518852	A	G	77	158	235	0	2	237	0	0
11	107662841	rs518073	A	G	65	116	181	0	3	184	0	0
11	107663103	rs516091	C	G	125	205	330	0	1	331	0	0
11	107673300	rs558952	A	G	5	7	12	0	0	12	0	0
11	107673628	rs556153	T	C	7	16	23	0	1	24	0	0
11	107908386	rs35185685	A	G	5	2	7	0	0	7	0	0
11	107920374	rs72996496	A	G	6	2	8	0	1	9	0	0
11	107930040	rs72998471	G	A	2	6	8	0	0	8	0	0
11	107931063	rs12793438	G	A	11	4	15	0	0	15	0	0
11	107947757	rs35237843	T	C	7	3	10	0	0	10	0	0
11	107971350	rs60762047	A	G	5	1	6	0	0	6	0	0
11	108175462	rs1801516	G	A	14	17	31	0	1	32	0	0
11	108344081	rs7943203	G	A	13	9	22	0	0	22	0	0
11	108344264	rs72992191	C	T	11	10	21	0	0	21	0	0
11	109964568	rs11213260	C	T	2	4	6	0	0	6	0	0
11	109964829	rs10891053	A	T	7	8	15	0	0	15	0	0
11	109971229	rs4554858	A	G	4	2	6	0	0	6	0	0
11	110109702	rs12575162	G	A	18	17	35	0	0	35	0	0
11	110110833	rs12798091	C	T	4	3	7	0	0	7	0	0
11	110111053	rs12798519	C	T	6	1	7	0	0	7	0	0
11	110126870	rs11213326	T	C	5	7	12	0	0	12	0	0
11	110312784	rs116924208	A	G	5	2	7	0	0	7	0	0
11	111223111	rs1042752	A	G	4	2	6	0	0	6	0	0
11	111596144	rs45540232	T	G	7	12	19	0	0	19	0	0
11	111618261	rs144761259	T	C	8	5	13	0	0	13	0	0
11	112014136	rs5744292	T	C	206	555	761	0	3	764	0	0
11	112021767	rs5744258	C	G	1	35	36	0	1	37	0	0
11	112022848	rs5744256	A	G	13	16	29	0	1	30	0	0
11	112023827	rs1834481	C	G	2	11	13	0	0	13	0	0
11	112100673	rs76051337	C	A	20	11	31	0	0	31	0	0
11	113634068	rs149589163	T	C	3	7	10	0	0	10	0	0
11	113634178	rs146047944	C	T	3	5	8	0	0	8	0	0
11	113949232	rs1784692	T	C	6	3	9	0	0	9	0	0
11	113949740	rs1791800	G	A	6	4	10	0	0	10	0	0
11	114273064	rs79975601	C	T	8	6	14	0	0	14	0	0
11	114275226	rs78226978	T	C	12	6	18	0	0	18	0	0
11	114275839	rs3863299	C	G	11	9	20	0	0	20	0	0
11	114280775	rs9326243	A	G	57	54	111	0	0	111	0	0
11	114281162	rs75472325	T	C	4	8	12	0	0	12	0	0
11	114282158	rs11214982	G	A	5	3	8	0	0	8	0	0
11	114298395	rs4938104	C	G	1	5	6	0	0	6	0	0
11	114314972	rs2271716	C	T	16	9	25	0	0	25	0	0
11	114317253	rs74711984	T	G	1	9	10	0	0	10	0	0
11	114319760	rs525173	A	G	5	7	12	0	0	12	0	0
11	114320923	rs9619	A	G	39	49	88	0	0	88	0	0
11	116621770	rs17440396	G	A	3	3	6	0	0	6	0	0
11	116628401	rs2075295	T	C	3	3	6	0	0	6	0	0
11	116629905	rs17519093	G	A	10	2	12	0	0	12	0	0
11	116629949	rs4938310	C	T	2	7	9	0	1	10	0	0
11	116633947	rs10488698	G	A	31	20	51	0	0	51	0	0
11	116648776	rs78296522	C	A	409	201	610	0	4	614	0	0
11	116748905	rs61907566	C	G	7	3	10	0	0	10	0	0
11	116797442	rs112701434	T	C	45	60	105	0	0	105	0	0
11	116883241	rs111708971	T	A	4	4	8	0	0	8	0	0
11	117036446	.	C	G	23	26	49	0	0	49	0	0
11	117079260	.	C	T	15	0	15	0	0	15	0	0
11	117080120	.	C	T	21	0	21	0	0	21	0	0
11	117080760	.	A	C	28	0	28	0	0	28	0	0
11	117118038	rs488538	T	G	4	5	9	0	0	9	0	0
11	117118481	rs2925771	C	T	2	4	6	0	0	6	0	0
11	117119552	rs523366	A	G	9	20	29	0	0	29	0	0
11	117120027	rs605531	T	G	5	10	15	0	0	15	0	0
11	117120473	rs509565	T	C	13	22	35	0	1	36	0	0
11	117163824	rs638405	C	G	4	3	7	0	0	7	0	0
11	117252489	rs897836	T	C	17	15	32	0	0	32	0	0
11	117261853	rs494553	C	T	19	17	36	0	0	36	0	0
11	117266312	rs2305830	C	G	21	19	40	0	0	40	0	0
11	117282979	rs521099	C	G	32	55	87	0	1	88	0	0
11	117283091	rs2279013	C	T	36	46	82	0	1	83	0	0
11	117283471	rs573965	C	T	32	43	75	0	0	75	0	0
11	117283626	rs572884	A	G	38	56	94	0	1	95	0	0
11	117283634	rs572862	A	G	37	54	91	0	1	92	0	0
11	117771769	rs73020470	T	C	4	2	6	0	0	6	0	0
11	117772179	rs11821311	C	T	5	4	9	0	0	9	0	0
11	117772229	rs575535	G	C	3	4	7	0	0	7	0	0
11	117772955	rs73020481	T	C	1	6	7	0	0	7	0	0
11	117858983	rs4252248	G	A	40	24	64	0	0	64	0	0
11	117860582	rs2512143	A	G	20	19	39	0	2	41	0	0
11	117862298	rs2512144	A	G	18	23	41	0	0	41	0	0
11	117863032	rs2512145	A	G	33	21	54	0	0	54	0	0
11	117863829	rs2508450	T	C	37	24	61	0	1	62	0	0
11	117864047	rs2256111	A	G	733	502	1235	0	5	1240	0	0
11	117864063	rs3135932	A	G	509	613	1122	0	8	1130	0	0
11	117867008	rs2512146	A	G	10	1	11	0	1	12	0	0
11	117867397	rs2508454	T	C	48	37	85	0	1	86	0	0
11	117869670	rs2229113	A	G	633	471	1104	0	10	1114	0	0
11	117872086	rs9610	G	A	489	351	840	0	5	845	0	0
11	118068521	rs1613643	T	G	6	0	6	0	0	6	0	0
11	118071762	rs11216812	G	A	4	20	24	0	0	24	0	0
11	118071836	rs11216813	G	A	7	23	30	0	0	30	0	0
11	118071857	rs11216814	A	G	11	21	32	0	0	32	0	0
11	118072232	rs11216815	G	A	6	11	17	0	0	17	0	0
11	118072716	rs12801003	C	T	4	15	19	0	0	19	0	0
11	118073344	rs17121871	T	C	8	3	11	0	0	11	0	0
11	118075474	rs11216817	C	T	0	6	6	0	0	6	0	0
11	118076004	rs1806	C	T	9	8	17	0	0	17	0	0
11	118076069	rs1805	T	G	24	12	36	0	0	36	0	0
11	118076953	rs11602739	T	A	6	2	8	0	0	8	0	0
11	118076954	rs11600544	C	G	6	2	8	0	0	8	0	0
11	118081345	rs17121881	A	T	165	76	241	0	0	241	0	0
11	118098890	rs1793156	T	C	21	22	43	0	0	43	0	0
11	118098962	rs1793155	G	A	6	4	10	0	0	10	0	0
11	118099617	rs11216825	G	A	18	10	28	0	0	28	0	0
11	118099713	rs11216826	A	T	17	16	33	0	0	33	0	0
11	118100411	rs869638	G	C	14	9	23	0	0	23	0	0
11	118103367	rs117826233	G	A	1	5	6	0	0	6	0	0
11	118103542	rs10790246	A	T	5	6	11	0	0	11	0	0
11	118104577	rs1715422	T	C	3	3	6	0	0	6	0	0
11	118104627	rs1573559	G	A	3	6	9	0	0	9	0	0
11	118105222	rs1547885	C	T	3	3	6	0	0	6	0	0
11	118105473	rs12362596	G	C	3	4	7	0	1	8	0	0
11	118105599	rs1715420	T	A	5	1	6	0	0	6	0	0
11	118108331	rs55768116	C	A	4	3	7	0	0	7	0	0
11	118109196	rs35409990	G	A	3	3	6	0	0	6	0	0
11	118111676	rs11216828	T	A	4	4	8	0	0	8	0	0
11	118120802	rs61900655	G	C	22	2	24	0	0	24	0	0
11	118178007	rs1126924	C	T	18	15	33	0	0	33	0	0
11	118182885	.	C	T	20	14	34	0	0	34	0	0
11	118231584	rs4938507	A	G	3	3	6	0	0	6	0	0
11	118262706	rs61900932	C	T	5	3	8	0	1	9	0	0
11	118358068	rs525549	T	A	5	4	9	0	0	9	0	0
11	118391375	rs576950	A	G	10	2	12	0	0	12	0	0
11	118404804	rs6589664	G	A	84	151	235	0	4	239	0	0
11	118431003	rs3132828	A	G	5	8	13	0	0	13	0	0
11	118448644	rs117375104	G	A	6	2	8	0	0	8	0	0
11	118462367	rs11216919	A	G	2	4	6	0	0	6	0	0
11	118620697	rs488219	T	C	332	431	763	0	1	764	0	0
11	118622985	rs3825057	T	C	10	5	15	0	0	15	0	0
11	118624919	rs11217013	G	C	4	6	10	0	0	10	0	0
11	118626286	rs11217014	T	C	7	5	12	0	0	12	0	0
11	118627149	rs11217016	A	C	22	15	37	0	0	37	0	0
11	118627778	rs10892282	G	C	9	2	11	0	0	11	0	0
11	118629031	rs555639	G	A	11	20	31	0	0	31	0	0
11	118629364	rs73001486	G	A	56	31	87	0	0	87	0	0
11	118631653	rs1784543	A	T	4	7	11	0	0	11	0	0
11	118632522	rs581045	C	T	1	6	7	0	0	7	0	0
11	118632996	.	T	A	1	6	7	0	0	7	0	0
11	118635151	rs614554	T	C	7	12	19	0	0	19	0	0
11	118635364	rs11217018	T	C	9	3	12	0	0	12	0	0
11	118657297	rs487177	C	G	7	1	8	0	0	8	0	0
11	118657311	rs570806	C	A	1	9	10	0	0	10	0	0
11	118658075	rs515523	A	G	3	4	7	0	0	7	0	0
11	118659896	rs2105782	T	C	19	24	43	0	0	43	0	0
11	118661376	rs73003294	C	T	6	3	9	0	0	9	0	0
11	118870413	rs10892319	C	T	6	2	8	0	0	8	0	0
11	118872404	rs6589713	T	C	11	9	20	0	0	20	0	0
11	118872581	rs4558175	G	A	6	3	9	0	0	9	0	0
11	118872741	rs4573680	T	C	5	2	7	0	0	7	0	0
11	118873385	rs10892320	C	T	7	5	12	0	0	12	0	0
11	118873840	rs9645663	T	C	15	6	21	0	0	21	0	0
11	118873987	rs9645664	T	C	25	13	38	0	0	38	0	0
11	118875727	rs4936457	A	G	11	16	27	0	0	27	0	0
11	118875761	rs4936458	T	G	19	10	29	0	1	30	0	0
11	118876552	rs74884652	T	C	19	18	37	0	0	37	0	0
11	118877563	rs58709307	C	T	17	18	35	0	0	35	0	0
11	118877891	rs75154936	T	C	18	10	28	0	1	29	0	0
11	118878222	rs11606357	T	C	12	14	26	0	0	26	0	0
11	118879285	rs7120445	A	C	50	45	95	0	1	96	0	0
11	118879824	rs73559119	T	C	37	25	62	0	2	64	0	0
11	118880012	rs11825284	G	A	32	14	46	0	0	46	0	0
11	118880668	rs11607569	T	C	15	4	19	0	0	19	0	0
11	118883491	rs60065241	C	A	4	4	8	0	0	8	0	0
11	118884708	rs61381062	G	A	5	3	8	0	1	9	0	0
11	118884726	rs58601794	T	C	8	4	12	0	0	12	0	0
11	118886117	rs10111	C	T	64	49	113	0	0	113	0	0
11	118886656	rs7131534	G	A	39	35	74	0	0	74	0	0
11	118887568	rs7121270	T	G	67	32	99	0	0	99	0	0
11	118887581	rs7105187	C	T	60	33	93	0	1	94	0	0
11	118887887	rs3916581	G	T	52	24	76	0	1	77	0	0
11	118887888	rs3916582	C	T	52	25	77	0	0	77	0	0
11	118888542	.	G	A	439	332	771	0	6	777	0	0
11	118888619	rs11602764	A	G	374	299	673	0	4	677	0	0
11	118888831	rs11820805	T	C	263	116	379	0	1	380	0	0
11	118889132	rs11217124	A	G	130	113	243	0	3	246	0	0
11	118889185	rs11217125	T	C	111	91	202	0	2	204	0	0
11	118889378	rs7113753	G	A	10	12	22	0	1	23	0	0
11	118890085	rs4938619	C	T	32	10	42	0	0	42	0	0
11	118892277	rs4938621	C	T	32	21	53	0	0	53	0	0
11	118892757	rs117289748	C	G	31	6	37	0	0	37	0	0
11	118892759	rs143660533	A	C	30	6	36	0	0	36	0	0
11	118892835	rs61179449	G	C	23	7	30	0	0	30	0	0
11	118892872	rs58955701	C	T	14	8	22	0	0	22	0	0
11	118892940	rs12280288	T	C	9	2	11	0	0	11	0	0
11	118893023	rs7127188	A	C	11	3	14	0	0	14	0	0
11	118893134	.	C	G	17	5	22	0	1	28	5	0
11	118893767	rs111345266	C	T	23	21	44	0	0	44	0	0
11	118893878	rs111322300	T	C	32	24	56	0	0	56	0	0
11	118894287	rs569	A	G	136	103	239	0	0	239	0	0
11	118895202	rs11006	A	G	33	18	51	0	0	51	0	0
11	118895495	rs8301	C	G	33	18	51	0	0	51	0	0
11	118895686	rs8192696	C	T	32	18	50	0	0	50	0	0
11	118901262	rs3759012	C	T	1	5	6	0	0	6	0	0
11	118915755	rs13929	G	C	125	60	185	0	0	185	0	0
11	118915944	rs1043314	A	G	81	115	196	0	0	196	0	0
11	118925341	rs538478	G	A	57	60	117	0	1	118	0	0
11	118938315	rs1786141	C	T	11	1	12	0	0	12	0	0
11	118938371	rs1784460	T	A	8	2	10	0	0	10	0	0
11	118938388	rs1784459	C	A	8	2	10	0	0	10	0	0
11	118938880	rs584115	A	G	53	58	111	0	0	111	0	0
11	118938957	rs1786685	G	A	9	12	21	0	1	22	0	0
11	118939154	.	C	A	1	5	6	0	1	7	0	0
11	118939155	.	C	T	5	2	7	0	0	7	0	0
11	118939488	rs10892327	C	G	13	5	18	0	1	19	0	0
11	118940957	rs1784302	C	G	189	119	308	0	1	309	0	0
11	118941596	rs7925100	G	A	13	11	24	0	0	24	0	0
11	118942048	rs1784305	G	A	13	8	21	0	0	21	0	0
11	118942067	rs1786690	T	C	15	11	26	0	0	26	0	0
11	118942638	rs1614264	A	C	22	17	39	0	0	39	0	0
11	118942654	rs10892328	T	A	23	19	42	0	0	42	0	0
11	118942928	rs685044	G	A	10	20	30	0	1	31	0	0
11	118943433	rs1185460	A	G	20	9	29	0	0	29	0	0
11	118944675	rs3825061	C	T	10	4	14	0	0	16	2	0
11	118945337	rs1184902	A	G	5	2	7	0	0	7	0	0
11	118947634	rs540261	C	T	133	201	334	0	4	339	1	0
11	118949083	rs1177563	G	A	102	55	157	0	0	158	1	0
11	118949331	rs1177562	C	T	236	159	395	0	3	398	0	0
11	118949799	rs1168568	G	A	15	20	35	0	1	36	0	0
11	118950217	rs1307145	C	G	11	5	16	0	0	16	0	0
11	118951642	rs2508948	T	A	15	17	32	0	1	33	0	0
11	118952173	rs15818	A	G	416	271	687	0	3	690	0	0
11	118952371	rs4614	A	G	407	265	672	0	0	672	0	0
11	118955679	rs589925	C	T	33	23	56	0	0	56	0	0
11	118962230	rs1131488	G	T	32	30	62	0	0	62	0	0
11	118994418	.	T	A	6	0	6	0	0	6	0	0
11	120196433	rs36011588	C	G	9	13	22	0	0	22	0	0
11	120196897	rs11217818	T	C	23	6	29	0	1	30	0	0
11	120198093	rs1893261	G	A	6	8	14	0	0	14	0	0
11	120199080	rs11823300	G	A	1	6	7	0	0	7	0	0
11	120202099	rs11217821	T	C	9	16	25	0	0	25	0	0
11	120203559	rs34298380	A	G	17	15	32	0	0	32	0	0
11	120203628	rs12806740	G	A	12	17	29	0	0	29	0	0
11	120328858	rs766894	T	C	4	6	10	0	0	10	0	0
11	120355791	rs9625	G	T	12	9	21	0	0	21	0	0
11	120356317	rs11217889	C	G	3	6	9	0	0	9	0	0
11	121178302	rs1061332	A	C	40	48	88	0	1	89	0	0
11	121327778	rs12270557	A	G	0	7	7	0	0	7	0	0
11	121328037	rs536360	C	A	4	2	6	0	0	6	0	0
11	121328502	rs3824963	A	G	110	336	446	0	2	448	0	0
11	121328954	rs661057	T	C	170	67	237	0	2	239	0	0
11	121329041	rs3862605	T	C	50	94	144	0	0	144	0	0
11	121367626	rs12364988	T	C	101	350	451	0	1	452	0	0
11	121408956	rs626885	C	G	4	2	6	0	0	6	0	0
11	121409914	rs3933404	A	G	2	8	10	0	0	10	0	0
11	121409979	rs3933403	G	T	4	5	9	0	0	9	0	0
11	121411041	rs3781827	A	G	0	7	7	0	0	7	0	0
11	121411112	rs688503	G	A	16	1	17	0	0	17	0	0
11	121412265	rs10892754	A	G	3	8	11	0	0	11	0	0
11	121416187	rs11218325	A	C	12	58	70	0	0	70	0	0
11	121416828	rs7933552	T	G	12	59	71	0	1	73	1	0
11	121417124	rs11218326	G	A	17	51	68	0	0	68	0	0
11	121418806	rs7103597	C	T	8	15	23	0	0	23	0	0
11	121420155	rs10790446	G	T	4	20	24	0	0	24	0	0
11	121420184	rs11218335	C	T	4	19	23	0	0	23	0	0
11	121420381	rs114739102	A	G	3	6	9	0	0	9	0	0
11	121420383	rs114324570	T	A	3	6	9	0	0	9	0	0
11	121425827	rs147621692	C	A	20	6	26	0	0	26	0	0
11	121432647	rs639648	T	G	3	3	6	0	0	6	0	0
11	121435329	.	A	G	3	3	6	0	0	6	0	0
11	121437267	rs1699108	A	T	4	7	11	0	0	11	0	0
11	121439718	rs1699106	C	T	5	17	22	0	0	22	0	0
11	121439878	rs4559697	G	A	7	1	8	0	0	8	0	0
11	121440231	rs7118902	G	A	11	2	13	0	0	13	0	0
11	121443794	rs7104977	G	A	4	2	6	0	0	6	0	0
11	121448090	rs2070045	T	G	304	78	382	0	3	385	0	0
11	121456962	rs1699102	C	T	186	221	407	0	3	411	1	0
11	121459522	rs1792122	C	T	8	4	12	0	0	12	0	0
11	121460664	rs1625828	G	A	5	3	8	0	0	8	0	0
11	121475922	rs3824968	T	A	534	422	956	0	8	964	0	0
11	121477096	rs1629493	G	A	24	13	37	0	0	37	0	0
11	121478495	rs2282648	C	T	30	23	53	0	0	53	0	0
11	121478958	rs2282649	C	T	37	44	81	0	0	81	0	0
11	121480609	rs1010157	T	C	51	27	78	0	1	79	0	0
11	121481407	rs726601	C	T	74	88	162	0	0	162	0	0
11	121482938	rs1784931	C	A	33	30	63	0	2	65	0	0
11	121483401	rs1010159	C	T	70	40	110	0	0	110	0	0
11	121483651	rs1010158	G	A	31	15	46	0	0	46	0	0
11	121483912	rs1699098	G	A	25	21	46	0	1	47	0	0
11	121486552	rs1503415	C	A	41	39	80	0	1	81	0	0
11	121487372	rs10790447	C	T	64	77	141	0	1	142	0	0
11	121491307	rs10892760	C	A	14	65	79	0	1	80	0	0
11	121491325	rs10750192	G	C	14	63	77	0	0	77	0	0
11	121491542	rs1699096	A	G	37	11	48	0	0	48	0	0
11	121493001	rs1614735	T	G	19	16	35	0	1	36	0	0
11	121495141	rs9633951	T	C	25	47	72	0	1	73	0	0
11	121495555	rs10790448	G	A	15	18	33	0	0	33	0	0
11	121496933	rs11218363	C	T	14	15	29	0	1	30	0	0
11	121497884	rs10892761	T	C	14	16	30	0	0	30	0	0
11	121499336	rs1393914	G	A	93	101	194	0	2	196	0	0
11	121501238	rs10892762	G	A	396	337	733	0	7	740	0	0
11	121501406	rs10790449	T	C	628	615	1243	0	16	1259	0	0
11	121501755	rs1133174	G	A	745	588	1333	0	8	1341	0	0
11	121502745	rs1131497	C	G	1015	871	1886	0	7	1893	0	0
11	121502768	rs3087925	A	G	997	815	1812	0	19	1831	0	0
11	121502894	rs1131499	T	C	1066	902	1968	0	7	1975	0	0
11	122535470	rs118069235	G	A	6	4	10	0	0	10	0	0
11	122559117	rs117671449	A	G	17	12	29	0	0	29	0	0
11	122565566	rs78351563	A	G	6	5	11	0	0	11	0	0
11	122565872	rs138696990	A	G	11	10	21	0	0	21	0	0
11	122571803	rs76688790	C	T	1	5	6	0	0	6	0	0
11	122572371	rs76755046	A	G	3	4	7	0	0	7	0	0
11	122576973	rs7939482	G	A	9	6	15	0	0	15	0	0
11	122578670	rs4936728	C	T	5	1	6	0	0	6	0	0
11	122580119	rs10790521	G	T	7	1	8	0	0	8	0	0
11	122581725	rs7930792	C	G	12	2	14	0	0	14	0	0
11	122581874	rs78496823	C	T	2	16	18	0	0	18	0	0
11	122582647	rs56164231	G	C	2	8	10	0	0	10	0	0
11	122582976	rs60097576	T	C	6	88	94	0	0	94	0	0
11	122583001	rs2271719	T	C	5	90	95	0	1	96	0	0
11	122583143	rs938632	C	T	26	5	31	0	0	31	0	0
11	122583170	rs938631	G	A	25	6	31	0	0	31	0	0
11	122583867	rs12577970	G	A	7	0	7	0	0	7	0	0
11	122583894	rs113148010	C	T	1	12	13	0	0	13	0	0
11	122584017	rs73016292	G	A	5	18	23	0	0	23	0	0
11	122584090	rs73016293	T	C	2	16	18	0	0	18	0	0
11	122584209	rs73016294	C	T	3	7	10	0	1	11	0	0
11	122584232	rs73016297	G	A	2	10	12	0	0	12	0	0
11	122584607	rs2233	C	G	33	6	39	0	1	40	0	0
11	122584675	rs2234	A	C	2	32	34	0	0	34	0	0
11	122584816	rs55829392	G	A	5	19	24	0	0	24	0	0
11	122584880	rs2362	T	C	6	17	23	0	0	23	0	0
11	122584889	rs2361	T	C	6	19	25	0	0	25	0	0
11	122584904	rs55787795	G	A	6	16	22	0	0	22	0	0
11	122585086	rs2187519	C	A	32	11	43	0	1	44	0	0
11	122585214	rs56101607	T	C	11	40	51	0	1	52	0	0
11	122585288	rs55903243	C	T	6	32	38	0	0	38	0	0
11	122585599	rs114489948	T	A	34	115	149	0	4	153	0	0
11	122585606	rs116427186	C	T	31	55	86	0	0	86	0	0
11	122585615	rs74557777	G	A	26	37	63	0	1	64	0	0
11	122586944	rs12277819	A	G	1	6	7	0	0	7	0	0
11	122587016	rs938630	G	A	4	3	7	0	0	7	0	0
11	122587235	rs12292477	C	T	6	1	7	0	0	7	0	0
11	122587572	rs10790522	C	T	5	4	9	0	0	9	0	0
11	122588149	rs1000722	G	A	3	3	6	0	0	6	0	0
11	122593299	rs1945395	A	G	3	7	10	0	0	10	0	0
11	122593906	rs7944444	T	A	4	3	7	0	0	7	0	0
11	122594394	rs4936730	A	G	5	4	9	0	0	9	0	0
11	122595781	rs7115231	A	G	4	3	7	0	0	7	0	0
11	122595973	rs7937493	C	T	5	5	10	0	0	10	0	0
11	122596197	rs76761236	C	T	18	17	35	0	0	35	0	0
11	122596271	rs55905145	C	A	6	5	11	0	0	11	0	0
11	122597060	.	T	C	7	6	13	0	0	13	0	0
11	122598095	rs7924691	G	A	1	5	6	0	0	6	0	0
11	122598435	rs1945396	G	C	4	7	11	0	0	11	0	0
11	122598784	rs1945398	A	G	3	11	14	0	0	14	0	0
11	122599663	rs74599168	C	T	8	9	17	0	0	17	0	0
11	122600930	rs7951379	T	G	30	34	64	0	1	65	0	0
11	122608704	rs61910264	C	T	2	4	6	0	0	6	0	0
11	122614353	rs7942399	G	A	6	7	13	0	0	13	0	0
11	122619384	rs17246816	G	A	4	2	6	0	0	6	0	0
11	122619401	rs1540111	A	T	5	2	7	0	0	7	0	0
11	122620308	rs10790524	G	A	4	4	8	0	0	8	0	0
11	122620957	rs10892892	G	A	5	6	11	0	0	11	0	0
11	122625616	rs7114985	C	G	7	1	8	0	0	8	0	0
11	122631578	rs4935810	T	C	5	1	6	0	0	6	0	0
11	122635055	rs4936740	G	C	5	5	10	0	0	10	0	0
11	122635455	rs7120651	T	G	7	3	10	0	0	10	0	0
11	122635961	rs2040320	G	C	2	6	8	0	0	8	0	0
11	122637613	rs7120946	C	T	5	5	10	0	0	10	0	0
11	122638643	rs1981408	C	T	5	3	8	0	0	8	0	0
11	122641086	rs4936742	T	C	3	10	13	0	0	13	0	0
11	122641495	rs4936743	C	T	7	7	14	0	0	14	0	0
11	122641855	rs10790529	T	G	6	8	14	0	0	14	0	0
11	122642957	rs7112568	C	G	10	7	17	0	1	18	0	0
11	122643829	rs4935812	G	T	8	12	20	0	0	20	0	0
11	122643880	rs7925381	T	C	6	11	17	0	0	17	0	0
11	122644077	rs10892897	C	T	4	10	14	0	0	14	0	0
11	122644554	rs1879885	C	G	10	9	19	0	0	19	0	0
11	122645912	rs76451291	G	A	14	11	25	0	0	25	0	0
11	122646438	rs10790532	C	T	8	9	17	0	0	17	0	0
11	122648713	rs6589949	T	C	9	5	14	0	0	14	0	0
11	122648720	rs191144085	G	A	9	5	14	0	0	14	0	0
11	122648733	rs6589950	T	C	7	5	12	0	0	12	0	0
11	122650172	rs4935813	C	G	12	7	19	0	0	19	0	0
11	122651857	rs6589952	T	G	10	7	17	0	0	17	0	0
11	122653335	rs10790533	C	G	15	12	27	0	0	27	0	0
11	122653572	rs11218809	T	C	16	25	41	0	0	41	0	0
11	122654056	rs2156801	G	A	14	18	32	0	1	33	0	0
11	122654486	rs7126436	T	C	3	7	10	0	0	10	0	0
11	122661124	rs11604648	A	G	8	5	13	0	0	13	0	0
11	122679885	rs3107637	C	G	8	5	13	0	0	13	0	0
11	122682156	rs3134428	A	G	273	315	588	0	4	592	0	0
11	122683382	rs3134430	A	T	299	344	643	0	5	648	0	0
11	122684468	rs3134439	A	T	19	18	37	0	1	38	0	0
11	122742028	rs1916036	C	G	8	8	16	0	0	16	0	0
11	122742154	rs56148911	C	A	4	8	12	0	0	12	0	0
11	122742460	rs3134421	A	T	6	2	8	0	0	8	0	0
11	122776007	rs74695569	T	C	10	7	17	0	0	17	0	0
11	122795688	rs11218891	T	C	6	7	13	0	0	13	0	0
11	122805487	rs34653644	A	G	13	5	18	0	0	18	0	0
11	122830214	rs7107502	G	A	6	7	13	0	0	13	0	0
11	122830264	rs76252188	C	A	8	5	13	0	0	13	0	0
11	122830274	rs1057704	T	C	6	7	13	0	0	13	0	0
11	122928622	rs4802	A	G	2212	1487	3699	0	28	3727	0	0
11	122928634	rs3763897	A	T	11	6	17	0	0	17	0	0
11	122928875	rs4936770	C	T	8	8	16	0	0	16	0	0
11	122929997	.	G	T	20	9	29	0	0	29	0	0
11	122931154	rs56828988	G	A	5	3	8	0	1	9	0	0
11	122932365	rs4935825	A	C	2	10	12	0	0	12	0	0
11	122932409	rs11218941	A	G	10	2	12	0	0	12	0	0
11	122932776	rs2276074	G	C	854	513	1367	0	12	1379	0	0
11	122933527	rs2236660	A	G	8	5	13	0	0	13	0	0
11	122933750	rs11218942	C	G	10	7	17	0	0	17	0	0
11	123306172	rs17671708	T	C	1	6	7	0	1	8	0	0
11	123480981	rs10893053	T	C	4	6	10	0	0	10	0	0
11	123494808	.	A	G	5	1	6	0	0	6	0	0
11	123497971	rs3741116	A	G	7	8	15	0	0	15	0	0
11	124016724	rs11601839	T	C	10	15	25	0	0	25	0	0
11	124016740	rs9326269	A	T	13	16	29	0	0	29	0	0
11	124016820	rs3824997	A	G	8	23	31	0	0	31	0	0
11	124017091	rs1939861	C	T	25	29	54	0	1	55	0	0
11	124017158	rs1939860	C	G	21	27	48	0	0	48	0	0
11	124017493	rs4936894	G	A	14	13	27	0	0	27	0	0
11	124494676	rs686567	T	C	16	23	39	0	0	39	0	0
11	124746644	rs11219822	A	C	8	3	11	0	0	11	0	0
11	124746770	rs11219823	T	C	20	26	46	0	0	46	0	0
11	124747837	rs7933204	G	A	12	4	16	0	0	16	0	0
11	124754611	rs12823	T	A	15	12	27	0	0	27	0	0
11	124958122	rs3802808	A	G	30	35	65	0	0	65	0	0
11	124958326	rs7110840	G	C	28	29	57	0	0	57	0	0
11	124958397	rs3802809	T	C	33	28	61	0	0	61	0	0
11	124958459	rs3824926	C	T	32	38	70	0	0	70	0	0
11	124958576	rs10750295	G	A	28	30	58	0	0	58	0	0
11	124958709	rs4936977	T	C	27	24	51	0	0	51	0	0
11	124958710	rs73024339	G	A	27	24	51	0	0	51	0	0
11	124958844	rs7111168	A	G	28	28	56	0	1	57	0	0
11	124958914	rs4936978	T	C	22	36	58	0	1	59	0	0
11	124958973	rs7111308	A	G	26	25	51	0	0	51	0	0
11	124959175	rs6590129	C	T	26	33	59	0	1	60	0	0
11	124959392	rs7937112	G	T	10	18	28	0	0	28	0	0
11	124959422	rs7936882	A	G	5	7	12	0	0	12	0	0
11	124960284	rs1142924	A	C	24	24	48	0	0	48	0	0
11	124967487	rs1043821	T	A	40	97	137	0	0	137	0	0
11	124972208	rs14065	A	G	31	42	73	0	0	73	0	0
11	124972377	rs2155663	C	T	10	22	32	0	1	33	0	0
11	124972518	rs2155664	A	G	19	20	39	0	0	39	0	0
11	124972522	rs2155665	T	C	13	20	33	0	1	34	0	0
11	124972691	rs2155666	T	C	40	65	105	0	0	105	0	0
11	125453890	rs7094	C	T	162	205	367	0	1	368	0	0
11	126072294	rs480153	C	T	14	26	40	0	1	41	0	0
11	126072688	rs627911	C	T	71	72	143	0	0	143	0	0
11	126076824	rs659551	C	A	9	6	15	0	0	15	0	0
11	126077463	rs646427	A	C	5	6	11	0	1	12	0	0
11	126078285	rs510767	C	T	6	7	13	0	0	13	0	0
11	126078501	rs631372	G	T	4	2	6	0	0	6	0	0
11	126078767	.	C	T	6	2	8	0	0	8	0	0
11	126133576	rs1049666	A	G	397	559	956	0	13	969	0	0
11	126133587	rs3189850	C	A	396	596	992	0	0	992	0	0
11	126133632	rs1049665	T	C	347	543	890	0	31	921	0	0
11	126134698	rs638766	T	C	41	61	102	0	0	102	0	0
11	126135785	rs11220432	G	A	10	2	12	0	0	12	0	0
11	126137854	rs7130615	G	A	73	126	199	0	1	200	0	0
11	126138381	rs3809004	G	C	47	64	111	0	0	111	0	0
11	126139100	rs1786702	T	C	2	17	19	0	0	19	0	0
11	126163691	rs611953	A	G	8	9	17	0	0	17	0	0
11	126164349	rs625413	T	C	4	9	13	0	0	13	0	0
11	126225617	.	C	T	9	4	13	0	0	13	0	0
11	126274003	rs1007690	T	C	0	6	6	0	0	6	0	0
11	126277216	rs2230278	C	T	408	711	1119	0	3	1122	0	0
11	126278075	rs2230279	C	T	405	586	991	0	5	996	0	0
11	126278203	rs2298475	T	C	619	319	938	0	6	944	0	0
11	126278522	rs4935965	C	T	3	6	9	0	0	9	0	0
11	126279365	rs1316361	A	T	5	7	12	0	0	12	0	0
11	126280544	rs3781780	G	T	3	3	6	0	0	6	0	0
11	126280545	rs3781781	T	C	3	3	6	0	0	6	0	0
11	126281620	rs4937125	G	C	7	13	20	0	1	21	0	0
11	126281897	rs4937126	G	A	4	4	8	0	0	8	0	0
11	126282606	rs7116008	G	A	2	5	7	0	0	7	0	0
11	126301449	rs3802816	T	C	6	15	21	0	0	21	0	0
11	126315056	rs3802820	C	A	6	1	7	0	0	7	0	0
11	126315677	rs4312077	G	A	0	7	7	0	0	7	0	0
11	126315727	rs4294574	T	C	0	8	8	0	0	8	0	0
11	126315873	rs4313595	G	C	4	6	10	0	0	10	0	0
11	126316004	rs12806545	C	T	1	8	9	0	0	9	0	0
11	126316103	rs7924681	C	G	3	5	8	0	0	8	0	0
11	126317444	rs7936304	G	A	12	3	15	0	0	15	0	0
11	126322796	rs78103604	A	C	26	4	30	0	0	30	0	0
11	126324005	rs12801097	C	T	6	3	9	0	0	9	0	0
11	126324033	rs116417234	C	T	3	5	8	0	0	8	0	0
11	126324865	rs78047702	C	G	7	2	9	0	0	9	0	0
11	126325508	rs7481810	G	A	5	2	7	0	0	7	0	0
11	126326896	rs76137490	C	T	3	4	7	0	0	7	0	0
11	126327306	rs115167614	G	A	7	4	11	0	0	11	0	0
11	126327360	rs56972407	A	C	3	3	6	0	0	6	0	0
11	126327715	rs57716161	C	T	8	5	13	0	0	13	0	0
11	126327778	rs11220501	G	A	2	5	7	0	0	7	0	0
11	126328279	rs2155309	C	T	4	4	8	0	0	8	0	0
11	126340300	rs113904735	C	T	10	7	17	0	0	17	0	0
11	126340372	rs111512978	C	T	10	4	14	0	0	14	0	0
11	126340777	rs112296590	G	T	5	6	11	0	0	11	0	0
11	126340887	rs12796090	A	G	7	6	13	0	0	13	0	0
11	126340901	rs11220511	A	T	6	6	12	0	0	12	0	0
11	126340991	rs12798030	T	G	8	7	15	0	0	15	0	0
11	126341177	rs113575442	A	G	3	3	6	0	0	6	0	0
11	126467975	rs482042	G	T	1	6	7	0	0	7	0	0
11	126481305	rs680610	A	G	6	1	7	0	0	7	0	0
11	126481440	rs571911	T	C	4	5	9	0	0	9	0	0
11	128383687	rs11221333	C	T	1	11	12	0	0	12	0	0
11	128383924	rs7117768	C	G	11	0	11	0	0	11	0	0
11	128385169	rs10790962	G	A	11	2	13	0	1	14	0	0
11	128385365	rs35951893	T	C	8	11	19	0	0	19	0	0
11	128385906	rs11221335	T	C	8	11	19	0	0	19	0	0
11	128386614	rs11822739	A	T	5	5	10	0	0	10	0	0
11	128387020	rs75805575	G	A	9	8	17	0	0	17	0	0
11	128387422	rs7946009	T	C	11	11	22	0	0	22	0	0
11	128389259	rs11820002	G	C	4	3	7	0	0	7	0	0
11	128390069	rs7120822	A	T	17	15	32	0	0	32	0	0
11	128390425	rs12223343	T	C	17	21	38	0	0	38	0	0
11	128563037	rs4526784	G	C	21	5	26	0	0	26	0	0
11	128568943	rs614542	C	T	2	6	8	0	0	8	0	0
11	128569454	rs626020	T	C	2	5	7	0	0	7	0	0
11	128569569	rs617274	C	T	4	7	11	0	0	11	0	0
11	128571043	rs607724	A	G	8	4	12	0	0	12	0	0
11	128571080	rs607670	T	C	6	4	10	0	0	10	0	0
11	128571257	rs644818	A	G	7	3	10	0	0	10	0	0
11	128571710	rs594479	T	C	7	4	11	0	0	11	0	0
11	128574173	rs500090	G	A	7	4	11	0	0	11	0	0
11	128575343	rs532019	G	A	3	6	9	0	0	9	0	0
11	128577471	rs648566	C	G	4	3	7	0	0	7	0	0
11	128582944	rs609017	C	T	7	5	12	0	0	12	0	0
11	128584813	rs624505	G	A	8	5	13	0	0	13	0	0
11	128584824	rs587786	A	G	8	3	11	0	2	13	0	0
11	128586155	rs654723	C	A	10	2	12	0	0	12	0	0
11	128586262	rs668248	G	C	6	5	11	0	0	11	0	0
11	128589472	rs606707	C	T	15	9	24	0	0	24	0	0
11	128591597	rs659652	T	G	5	5	10	0	0	10	0	0
11	128592637	rs686605	A	G	9	9	18	0	0	18	0	0
11	128593493	rs947930	G	A	7	2	9	0	0	9	0	0
11	128594161	rs684150	C	T	10	6	16	0	0	16	0	0
11	128594851	rs615716	C	T	8	16	24	0	0	24	0	0
11	128619775	rs626816	G	A	2	6	8	0	1	9	0	0
11	128644741	rs601627	T	A	2	5	7	0	0	7	0	0
11	128654244	rs670163	A	G	5	1	6	0	0	6	0	0
11	128654290	rs670516	C	T	6	2	8	0	0	8	0	0
11	128654431	rs670991	T	C	4	2	6	0	0	6	0	0
11	128655777	rs565888	A	C	4	3	7	0	0	7	0	0
11	128770473	rs2846699	C	T	9	15	24	0	0	24	0	0
11	128770474	rs2846698	A	G	9	15	24	0	0	24	0	0
11	128835758	rs546239	C	T	18	12	30	0	0	30	0	0
11	128842873	rs581258	T	C	29	13	42	0	0	42	0	0
11	129729775	rs74238128	C	T	12	25	37	0	0	37	0	0
11	129736157	rs10894158	T	C	4	3	7	0	0	7	0	0
11	129736989	rs61913688	C	T	4	3	7	0	0	7	0	0
11	129738351	rs2288402	G	C	2	4	6	0	0	6	0	0
11	129752991	rs2293664	G	C	4	6	10	0	0	10	0	0
11	129753308	.	A	G	9	11	20	0	0	20	0	0
11	129753900	rs2303663	T	C	1	5	6	0	0	6	0	0
11	129754644	rs1131972	A	G	60	70	130	0	1	131	0	0
11	129758327	rs1650823	G	A	11	27	38	0	0	38	0	0
11	129764526	rs1783919	C	T	2	7	9	0	0	9	0	0
11	129764568	rs3829264	C	T	2	11	13	0	0	13	0	0
11	129769926	rs1043654	T	C	19	23	42	0	0	42	0	0
11	129772013	rs3734078	C	T	31	30	61	0	0	61	0	0
11	129775599	rs3734076	C	T	11	20	31	0	1	32	0	0
11	129784764	rs117750366	C	T	17	12	29	0	0	29	0	0
11	129801043	rs2277033	C	T	10	10	20	0	1	21	0	0
11	129866277	rs7110196	T	C	0	7	7	0	0	7	0	0
11	129866320	rs11826993	C	A	0	6	6	0	0	6	0	0
11	129866618	rs11827079	G	A	6	11	17	0	0	17	0	0
11	129866653	rs7124927	C	T	8	10	18	0	0	18	0	0
11	130066867	rs4245086	T	C	10	5	15	0	0	15	0	0
11	130066871	rs4245087	C	T	11	5	16	0	0	16	0	0
11	130066900	rs2242184	C	T	13	8	21	0	0	21	0	0
11	130066902	rs2324001	G	A	13	8	21	0	0	21	0	0
11	130066957	rs2324002	C	T	11	9	20	0	0	20	0	0
11	130067069	rs2324003	G	C	10	4	14	0	0	14	0	0
11	130067226	rs2324004	G	A	12	2	14	0	0	14	0	0
11	130067764	rs583863	G	T	166	232	398	0	6	404	0	0
11	130067987	rs595073	A	C	4	8	12	0	0	12	0	0
11	130070544	rs7938567	G	A	2	4	6	0	0	6	0	0
11	130070899	rs513461	A	G	2	4	6	0	0	6	0	0
11	130072384	rs672442	G	A	6	7	13	0	0	13	0	0
11	130076334	rs12271379	C	T	6	4	10	0	0	10	0	0
11	130736271	rs3234	T	G	7	1	8	0	0	8	0	0
11	130776556	rs61909161	T	C	38	49	87	0	1	88	0	0
11	130786308	rs7106771	T	C	7	10	17	0	0	17	0	0
11	130786345	rs3751033	C	A	5	4	9	0	0	9	0	0
11	134020848	rs641024	G	A	4	5	9	0	0	9	0	0
11	134021477	rs643447	G	T	4	7	11	0	1	12	0	0
11	134021859	rs655627	G	A	4	3	7	0	0	7	0	0
11	134023728	rs94499	A	G	15	7	22	0	0	22	0	0
11	134025568	rs622260	G	A	7	1	8	0	0	8	0	0
11	134026088	rs624477	G	A	6	3	9	0	0	9	0	0
11	134031246	rs609631	G	C	18	1	19	0	0	19	0	0
11	134047243	rs2276265	T	C	30	13	43	0	1	44	0	0
11	134091813	rs11223729	A	G	6	5	11	0	0	11	0	0
11	134092051	rs2010438	T	A	2	6	8	0	0	8	0	0
11	134094398	rs11223730	G	T	6	4	10	0	0	10	0	0
11	134094399	rs7130894	T	C	6	4	10	0	0	10	0	0
11	134101903	rs522134	G	A	3	7	10	0	1	11	0	0
11	134106052	rs12800423	A	T	6	2	8	0	0	8	0	0
11	134116125	rs12180	G	A	155	245	400	0	1	401	0	0
11	134132559	rs561945	G	A	4	2	6	0	0	6	0	0
11	134202036	rs7124693	C	T	10	3	13	0	0	13	0	0
12	77176	.	T	C	6	0	6	0	0	6	0	0
12	80024	.	A	G	8	1	9	0	0	9	0	0
12	80030	.	A	C	2	7	9	0	0	9	0	0
12	80118	.	A	G	8	6	14	0	0	14	0	0
12	80139	.	C	T	6	7	13	0	0	13	0	0
12	80171	.	C	T	9	8	17	0	0	17	0	0
12	80311	.	A	G	4	8	12	0	0	12	0	0
12	80315	rs372123746	A	G	4	6	10	0	0	10	0	0
12	80562	.	T	C	10	1	11	0	0	11	0	0
12	80572	.	C	G	9	1	10	0	0	10	0	0
12	82343	.	A	G	4	6	10	0	0	10	0	0
12	82857	.	T	C	2	4	6	0	0	6	0	0
12	83011	rs370570891	T	C	2	9	11	0	0	11	0	0
12	83012	rs374646339	C	G	2	9	11	0	0	11	0	0
12	83263	.	C	T	2	4	6	0	0	6	0	0
12	83508	.	T	G	4	3	7	0	0	7	0	0
12	83560	rs368663404	G	T	2	4	6	0	0	6	0	0
12	83757	.	G	C	11	7	18	0	2	20	0	0
12	83801	rs367621886	T	A	12	5	17	0	0	17	0	0
12	83802	rs371798112	G	A	12	5	17	0	0	17	0	0
12	83865	.	T	C	9	6	15	0	0	15	0	0
12	83979	.	T	C	8	2	10	0	0	10	0	0
12	84000	.	C	G	8	3	11	0	0	11	0	0
12	84096	.	C	G	14	10	24	0	1	25	0	0
12	84205	.	C	T	15	12	27	0	0	27	0	0
12	84243	.	C	T	9	11	20	0	0	20	0	0
12	84286	rs376266576	G	T	8	13	21	0	0	21	0	0
12	84296	.	G	C	11	12	23	0	0	23	0	0
12	84343	.	T	C	13	13	26	0	0	26	0	0
12	84433	.	C	A	11	8	19	0	1	20	0	0
12	84552	.	G	T	19	4	23	0	0	23	0	0
12	84568	.	G	A	19	7	26	0	0	26	0	0
12	84588	.	C	T	18	6	24	0	0	24	0	0
12	84590	.	A	G	17	6	23	0	0	23	0	0
12	84598	.	T	G	17	6	23	0	0	23	0	0
12	84650	.	G	A	15	10	25	0	0	25	0	0
12	84668	.	T	C	12	11	23	0	1	24	0	0
12	84674	.	T	C	12	12	24	0	0	24	0	0
12	84676	.	T	C	19	6	25	0	0	25	0	0
12	84716	.	G	A	12	14	26	0	0	26	0	0
12	84755	.	T	A	12	5	17	0	0	17	0	0
12	84772	.	T	A	14	4	18	0	0	18	0	0
12	84856	.	G	T	11	9	20	0	0	20	0	0
12	84871	.	G	C	13	11	24	0	0	24	0	0
12	84963	.	T	C	14	7	21	0	0	21	0	0
12	85105	.	G	A	9	9	18	0	0	18	0	0
12	86381	.	C	G	6	4	10	0	0	10	0	0
12	86386	.	C	T	6	5	11	0	0	11	0	0
12	86754	.	C	T	6	5	11	0	0	11	0	0
12	87997	.	T	C	71	53	124	0	1	125	0	0
12	88936	.	A	C	57	11	68	0	1	69	0	0
12	89419	.	A	T	28	14	42	0	1	43	0	0
12	89564	rs372772361	G	A	53	32	85	0	1	86	0	0
12	89912	.	C	T	14	7	21	0	1	22	0	0
12	90736	rs71227148	T	C	8	5	13	0	0	13	0	0
12	90914	rs17353727	C	T	256	262	518	0	1	519	0	0
12	248202	rs56204927	C	G	4	3	7	0	0	7	0	0
12	270229	rs10848455	G	A	7	9	16	0	0	16	0	0
12	270773	rs3817018	C	G	3	4	7	0	0	7	0	0
12	274647	rs4980859	T	C	53	26	79	0	0	79	0	0
12	284058	rs216230	T	C	8	4	12	0	0	12	0	0
12	284930	rs7959974	C	T	13	10	23	0	0	23	0	0
12	285027	rs7960096	C	A	15	10	25	0	0	25	0	0
12	286331	rs216232	A	G	15	1	16	0	1	17	0	0
12	286514	rs60912613	C	G	26	6	32	0	0	32	0	0
12	391609	rs17800738	T	C	6	3	9	0	0	9	0	0
12	396456	rs576994	A	G	4	9	13	0	0	13	0	0
12	398749	rs479803	T	C	3	3	6	0	0	6	0	0
12	400466	rs17800744	A	C	2	5	7	0	0	7	0	0
12	405259	rs2284332	T	C	4	8	12	0	0	12	0	0
12	405474	rs2284333	C	G	7	3	10	0	0	10	0	0
12	406292	rs2229351	G	A	91	95	186	0	1	187	0	0
12	427575	rs11062385	A	G	98	105	203	0	2	205	0	0
12	432654	rs3213750	T	A	4	7	11	0	0	11	0	0
12	432666	rs3213751	G	C	4	3	7	0	0	7	0	0
12	457645	rs10848814	G	C	7	0	7	0	0	7	0	0
12	457655	rs10848815	T	C	7	1	8	0	0	8	0	0
12	457843	rs11615564	C	G	10	11	21	0	0	21	0	0
12	457844	rs7132845	A	G	11	11	22	0	0	22	0	0
12	460226	rs7135768	C	T	2	5	7	0	0	7	0	0
12	460726	rs887311	T	G	5	6	11	0	1	12	0	0
12	463245	.	G	A	81	57	138	0	1	139	0	0
12	480950	rs9739950	T	G	17	25	42	0	0	42	0	0
12	480961	rs9669094	G	T	16	24	40	0	0	40	0	0
12	482159	rs151213767	C	T	14	15	29	0	1	30	0	0
12	483130	rs6489463	G	T	12	21	33	0	0	33	0	0
12	485095	rs2098094	C	G	14	15	29	0	0	29	0	0
12	485259	rs2079785	G	A	9	9	18	0	0	18	0	0
12	485608	rs2159364	C	G	4	5	9	0	0	9	0	0
12	485702	rs7963937	A	G	7	7	14	0	0	14	0	0
12	485791	rs7977462	T	C	4	4	8	0	0	8	0	0
12	485844	rs12311569	G	A	14	23	37	0	0	37	0	0
12	489205	rs10744616	T	C	33	36	69	0	2	71	0	0
12	489739	rs10848868	T	C	3	5	8	0	0	8	0	0
12	495217	rs10774152	G	T	12	4	16	0	1	17	0	0
12	495558	rs6489475	G	C	12	10	22	0	0	22	0	0
12	495606	rs6489477	T	C	12	7	19	0	1	20	0	0
12	495652	rs10774153	C	T	10	6	16	0	0	16	0	0
12	495842	rs6489478	A	G	12	5	17	0	0	17	0	0
12	496439	rs7965303	A	T	13	14	27	0	0	27	0	0
12	496533	rs10848877	C	T	3	3	6	0	0	6	0	0
12	496695	rs10774154	G	A	8	10	18	0	0	18	0	0
12	496962	rs10848879	T	C	14	11	25	0	0	25	0	0
12	497910	rs2253565	T	G	28	21	49	0	0	49	0	0
12	551550	rs1048466	G	A	5	2	7	0	0	7	0	0
12	673515	rs2245918	T	C	3	4	7	0	0	7	0	0
12	673704	rs2245910	T	A	3	8	11	0	0	11	0	0
12	673788	rs2245906	A	G	10	14	24	0	1	25	0	0
12	862641	rs3088353	T	G	28	17	45	0	0	45	0	0
12	863517	rs3858703	G	A	72	59	131	0	1	132	0	0
12	863833	rs7972667	A	G	60	40	100	0	0	100	0	0
12	865970	rs6489746	C	G	10	8	18	0	0	18	0	0
12	867023	rs7975272	G	A	6	6	12	0	0	12	0	0
12	867708	rs7959054	C	T	4	2	6	0	0	6	0	0
12	867710	rs181881729	T	C	4	2	6	0	0	6	0	0
12	867714	rs7959060	C	T	5	2	7	0	0	7	0	0
12	871211	rs11064519	G	C	6	4	10	0	1	11	0	0
12	871472	rs11064520	T	A	10	8	18	0	0	18	0	0
12	874764	rs10774457	A	G	8	11	19	0	0	19	0	0
12	936468	rs2158502	C	G	7	17	24	0	0	24	0	0
12	939302	rs10774466	A	G	39	36	75	0	1	76	0	0
12	971317	rs11833299	A	G	42	33	75	0	0	75	0	0
12	979721	rs12305739	G	A	7	1	8	0	0	8	0	0
12	987482	rs1012729	G	A	63	49	112	0	0	112	0	0
12	988894	rs9804992	G	A	5	8	13	0	0	13	0	0
12	1021557	rs1051672	G	A	4	5	9	0	0	9	0	0
12	1022352	rs11571475	A	G	10	4	14	0	0	14	0	0
12	1022452	rs1051669	C	T	4	7	11	0	0	11	0	0
12	1139203	rs12424936	C	T	7	5	12	0	0	12	0	0
12	1481038	rs35478691	C	T	22	19	41	0	1	42	0	0
12	1486243	rs10848465	A	C	1	5	6	0	0	6	0	0
12	1486249	rs11061727	C	T	1	5	6	0	0	6	0	0
12	1553797	rs12319376	A	G	28	15	43	0	0	43	0	0
12	1599698	rs11837825	C	T	25	23	48	0	0	48	0	0
12	1600058	rs78680208	G	A	20	17	37	0	0	37	0	0
12	1600160	rs79833769	G	A	15	14	29	0	0	29	0	0
12	1600231	rs11610729	T	C	15	16	31	0	0	31	0	0
12	1600767	rs61912169	T	G	12	13	25	0	0	25	0	0
12	1601820	.	C	G	25	23	48	0	1	49	0	0
12	1603006	rs114925632	C	T	19	26	45	0	0	45	0	0
12	1603428	rs76374659	T	C	17	31	48	0	0	48	0	0
12	1604490	rs1046473	A	C	36	32	68	0	0	68	0	0
12	1702912	rs35466364	C	T	82	60	142	0	0	142	0	0
12	1836979	rs1058322	C	T	3	4	7	0	0	7	0	0
12	1889823	rs767870	G	A	2	7	9	0	0	9	0	0
12	1890199	rs16928751	G	A	20	7	27	0	0	27	0	0
12	1893077	rs35854772	C	A	87	51	138	0	0	138	0	0
12	1893170	rs9805042	C	T	104	64	168	0	0	168	0	0
12	1895372	rs730032	G	A	62	81	143	0	0	143	0	0
12	1896956	rs1044471	C	T	57	102	159	0	1	160	0	0
12	1897284	rs2286380	A	T	136	92	228	0	0	229	1	0
12	1901434	rs13219	C	T	50	60	110	0	0	110	0	0
12	1901485	rs1044825	G	T	51	54	105	0	0	105	0	0
12	1902164	rs2286379	C	T	30	56	86	0	0	86	0	0
12	1902766	rs2058111	T	G	29	51	80	0	0	80	0	0
12	2106649	rs11062054	T	A	3	3	6	0	0	6	0	0
12	2907087	rs41456246	G	A	5	4	9	0	0	9	0	0
12	2937013	rs4765998	G	C	10	9	19	0	0	19	0	0
12	2945970	rs4765999	C	T	10	5	15	0	0	15	0	0
12	3716385	rs17697432	A	G	10	12	22	0	0	22	0	0
12	3722102	rs12812210	G	A	7	9	16	0	0	16	0	0
12	3781953	rs7350575	A	G	5	1	6	0	0	6	0	0
12	3918475	rs700481	G	A	4	10	14	0	0	14	0	0
12	3919162	rs11062839	A	G	9	6	15	0	0	15	0	0
12	4383036	rs1049606	C	T	50	62	112	0	0	112	0	0
12	4388084	rs3217805	C	G	160	106	266	0	0	266	0	0
12	4399054	rs3217861	C	T	29	11	40	0	0	40	0	0
12	4399917	rs3217867	G	A	15	16	31	0	0	31	0	0
12	4399918	rs3217868	A	C	15	16	31	0	0	31	0	0
12	4400808	rs3217874	C	T	6	2	8	0	0	8	0	0
12	4402688	rs3217881	A	G	2	4	6	0	0	6	0	0
12	4402817	rs3217882	A	G	8	6	14	0	0	14	0	0
12	4404158	rs3217896	G	A	5	2	7	0	0	7	0	0
12	4404376	rs3217898	A	G	4	8	12	0	0	12	0	0
12	4405389	rs3217901	A	G	6	1	7	0	0	7	0	0
12	4406281	rs12299509	A	G	5	3	8	0	0	8	0	0
12	4406582	rs7398804	C	A	2	4	6	0	0	6	0	0
12	4406836	rs3217907	C	A	5	1	6	0	0	6	0	0
12	4411683	rs3217926	T	C	107	164	271	0	1	272	0	0
12	4412762	rs1049612	A	G	106	162	268	0	0	268	0	0
12	4413000	rs3217933	T	C	167	131	298	0	2	300	0	0
12	4462040	rs1046161	C	T	50	27	77	0	0	77	0	0
12	4462146	rs1046164	G	A	28	20	48	0	0	48	0	0
12	4662210	rs17850028	T	C	5	6	11	0	0	11	0	0
12	4778463	rs7312558	C	G	5	5	10	0	0	10	0	0
12	4778627	rs2240762	A	G	2	6	8	0	0	8	0	0
12	4791451	rs34076756	C	T	120	113	233	0	0	233	0	0
12	4793704	rs2240761	A	G	2	8	10	0	0	10	0	0
12	4794351	rs2240760	A	G	8	1	9	0	1	10	0	0
12	6433202	rs3782719	G	T	6	2	8	0	0	8	0	0
12	6493351	rs10849448	A	G	6	3	9	0	0	9	0	0
12	6495275	rs2364480	C	A	177	123	300	0	2	302	0	0
12	6500105	rs12354	T	G	218	155	373	0	2	375	0	0
12	6554628	rs25680	G	A	7	11	18	0	0	18	0	0
12	6578469	rs2240867	A	G	4	5	9	0	0	9	0	0
12	6643927	rs3741915	T	G	7	3	10	0	0	10	0	0
12	6645565	rs2886093	T	C	55	51	106	0	0	106	0	0
12	6688973	rs7973027	C	A	1	6	7	0	0	7	0	0
12	6748035	rs12826388	C	T	5	3	8	0	0	8	0	0
12	6760367	rs76327967	C	T	22	35	57	0	0	57	0	0
12	6775967	rs6786	A	G	26	28	54	0	0	54	0	0
12	6779223	rs7980637	G	T	5	7	12	0	0	12	0	0
12	6840057	rs118080174	C	T	10	4	14	0	0	14	0	0
12	6858126	rs2302371	G	A	564	603	1167	0	9	1176	0	0
12	6858365	rs6489733	G	A	18	15	33	0	0	33	0	0
12	6858971	rs7970575	C	T	26	22	48	0	0	48	0	0
12	6859191	rs7969956	G	A	36	6	42	0	0	42	0	0
12	6859308	rs2302370	T	C	42	9	51	0	1	52	0	0
12	6859729	rs2302369	G	A	34	23	57	0	0	57	0	0
12	6859797	rs2302368	T	C	28	28	56	0	0	56	0	0
12	6860030	rs59347851	C	T	4	7	11	0	0	11	0	0
12	6860515	rs61546725	A	G	4	2	6	0	0	6	0	0
12	6860562	rs142332705	T	C	4	3	7	0	0	7	0	0
12	6861043	rs2302367	T	C	4	4	8	0	0	8	0	0
12	6887020	rs870849	T	C	5	5	10	0	0	10	0	0
12	6926363	rs1055141	T	C	10	6	16	0	1	17	0	0
12	6928075	rs12821756	T	C	16	15	31	0	0	31	0	0
12	6928747	rs3213427	T	C	10	17	27	0	1	28	0	0
12	6929018	rs3829972	A	G	13	11	24	0	0	24	0	0
12	7032253	rs1061223	C	T	39	24	63	0	0	63	0	0
12	7047143	rs7969685	C	A	35	48	83	0	1	84	0	0
12	7053239	.	T	G	185	99	284	0	5	289	0	0
12	7053362	rs915997	A	G	38	30	68	0	0	68	0	0
12	7055860	rs2301262	T	C	4	3	7	0	0	7	0	0
12	7063755	rs56212533	G	A	33	20	53	0	0	53	0	0
12	7063805	rs117089024	C	T	28	15	43	0	0	43	0	0
12	7067555	rs2071079	G	A	15	14	29	0	0	29	0	0
12	7068608	rs11608598	C	T	27	18	45	0	0	45	0	0
12	7242299	rs1801046	G	A	3	3	6	0	0	6	0	0
12	7342636	rs113752912	T	A	7	5	12	0	0	12	0	0
12	7360892	rs117123444	T	C	5	1	6	0	0	6	0	0
12	7362960	rs3813737	G	A	56	37	93	0	2	95	0	0
12	7757084	rs11054742	T	C	4	5	9	0	0	9	0	0
12	8077542	.	T	A	112	0	112	0	1	113	0	0
12	8077622	.	G	A	0	176	176	0	0	176	0	0
12	8082158	.	T	G	12	8	20	0	1	21	0	0
12	8206167	rs10846411	A	G	24	24	48	0	0	48	0	0
12	8206500	rs17728610	G	A	26	22	48	0	1	49	0	0
12	8850706	rs112263725	G	T	50	35	85	0	0	85	0	0
12	8927429	rs34892777	G	A	25	36	61	0	0	61	0	0
12	8932201	rs2377585	T	G	16	9	25	0	1	26	0	0
12	9070366	rs4883198	T	A	63	27	90	0	0	90	0	0
12	9074259	rs1805741	C	T	34	24	58	0	0	58	0	0
12	9086898	rs1049925	A	G	78	82	160	0	2	162	0	0
12	9092774	.	A	G	2	5	7	0	0	7	0	0
12	9093001	rs6832	G	A	51	49	100	0	0	100	0	0
12	9094548	rs1805765	A	G	11	12	23	0	0	23	0	0
12	9095226	rs1805731	T	C	8	15	23	0	0	23	0	0
12	9095268	rs1805730	A	T	6	11	17	0	0	17	0	0
12	9095749	rs7309922	T	C	7	5	12	0	0	12	0	0
12	9097795	rs1805726	A	G	1	6	7	0	0	7	0	0
12	9099034	rs4140911	G	A	6	4	10	0	0	10	0	0
12	9099533	rs1805761	T	C	3	8	11	0	0	11	0	0
12	9447484	.	C	T	4	5	9	0	0	9	0	0
12	9447492	.	T	C	8	1	9	0	0	9	0	0
12	9451120	rs199885577	G	A	4	4	8	0	0	8	0	0
12	9451397	.	G	A	8	5	13	0	0	13	0	0
12	9466099	rs2377762	C	T	12	0	12	0	0	12	0	0
12	9466113	rs2911816	T	C	0	11	11	0	0	11	0	0
12	9466194	.	G	A	3	9	12	0	0	12	0	0
12	9564727	.	C	T	5	1	6	0	0	6	0	0
12	9570703	.	A	G	17	1	18	0	0	18	0	0
12	9570768	.	G	A	15	7	22	0	0	22	0	0
12	9570798	rs4402390	A	G	10	6	16	0	0	16	0	0
12	9570816	rs4312149	A	G	8	3	11	0	0	11	0	0
12	9570971	rs7487238	G	A	9	9	18	0	0	18	0	0
12	9571764	.	T	G	12	1	13	0	0	13	0	0
12	9573130	.	C	T	3	3	6	0	0	6	0	0
12	9573224	.	C	T	6	0	6	0	0	6	0	0
12	9573474	rs4763341	C	T	2	4	6	0	0	6	0	0
12	9574042	rs7298124	C	A	9	5	14	0	0	14	0	0
12	9574451	.	G	A	2	5	7	0	0	7	0	0
12	9581791	rs4763566	T	C	6	2	8	0	0	8	0	0
12	9583324	.	G	A	5	3	8	0	1	9	0	0
12	9801485	rs180671267	G	T	63	22	85	0	1	86	0	0
12	9906324	rs111791571	A	G	191	173	364	0	7	371	0	0
12	10005778	rs2594072	A	G	83	17	100	0	0	100	0	0
12	10005780	rs2539933	G	A	83	17	100	0	0	100	0	0
12	10006420	rs253156	G	A	72	82	154	0	3	157	0	0
12	10007363	rs12305497	A	G	56	47	103	0	0	103	0	0
12	10007761	rs7957621	A	G	117	144	261	0	3	264	0	0
12	10007863	rs33870	A	G	64	88	152	0	0	152	0	0
12	10007897	rs33871	C	T	48	79	127	0	1	128	0	0
12	10008002	rs33872	C	T	24	50	74	0	2	76	0	0
12	10009633	rs2268141	C	T	125	127	252	0	3	255	0	0
12	10011240	rs253154	C	G	6	22	28	0	1	29	0	0
12	10012749	rs253151	G	A	3	3	6	0	0	6	0	0
12	10013128	rs7962689	T	C	3	5	8	0	0	8	0	0
12	10014936	rs253148	A	T	3	5	8	0	0	8	0	0
12	10015082	rs253147	G	A	7	7	14	0	0	14	0	0
12	10015649	rs10743867	G	A	7	12	19	0	0	19	0	0
12	10016906	rs11615049	G	A	3	5	8	0	0	8	0	0
12	10017519	rs7295874	C	T	2	8	10	0	0	10	0	0
12	10020972	rs11053489	C	A	6	0	6	0	0	6	0	0
12	10131939	rs536947	C	T	80	83	163	0	1	164	0	0
12	10136297	rs1323461	C	A	6	8	14	0	0	14	0	0
12	10138475	rs602320	G	A	4	5	9	0	0	9	0	0
12	10147850	rs521040	T	C	5	7	12	0	0	12	0	0
12	10160241	rs510630	G	C	3	3	6	0	0	6	0	0
12	10165849	rs17205511	T	C	4	2	6	0	1	7	0	0
12	10365574	.	C	G	40	187	227	0	2	229	0	0
12	10365670	rs11545794	G	C	77	169	246	0	3	249	0	0
12	10369238	rs10845075	A	G	12	13	25	0	0	25	0	0
12	10370157	rs118048352	C	T	9	23	32	0	0	32	0	0
12	10370763	rs73058099	A	G	4	10	14	0	0	14	0	0
12	10525365	rs1049174	G	C	11	10	21	0	0	21	0	0
12	10525644	rs1351113	A	G	15	7	22	0	0	22	0	0
12	10525740	rs1049172	C	T	15	6	21	0	0	21	0	0
12	10562089	rs1841958	A	C	2	5	7	0	0	7	0	0
12	10758703	rs1052871	A	G	5	4	9	0	0	9	0	0
12	10763236	rs10845182	G	C	10	8	18	0	0	18	0	0
12	10851772	rs7270	A	T	105	62	167	0	0	167	0	0
12	10853668	rs11053908	C	T	14	12	26	0	1	27	0	0
12	10854451	rs2305850	A	G	3	4	7	0	0	7	0	0
12	10854878	rs3782670	A	G	29	15	44	0	0	44	0	0
12	10856219	rs2418102	C	T	50	35	85	0	0	85	0	0
12	10856255	rs2418103	A	G	34	26	60	0	0	60	0	0
12	10856799	rs7963247	T	C	19	10	29	0	0	29	0	0
12	10858081	rs11053910	G	C	15	5	20	0	0	20	0	0
12	10858319	rs797171	G	C	10	6	16	0	0	16	0	0
12	10858817	rs4763577	G	A	14	8	22	0	1	23	0	0
12	10859611	rs10845208	A	G	5	1	6	0	0	6	0	0
12	10859925	rs12578723	A	G	16	7	23	0	0	23	0	0
12	10861308	rs4763578	C	T	58	14	72	0	1	73	0	0
12	10861760	rs11053912	C	T	8	15	23	0	2	25	0	0
12	10861962	rs34254429	C	T	7	8	15	0	0	15	0	0
12	10864173	rs11053913	T	C	49	23	72	0	0	72	0	0
12	10866397	rs7953251	T	C	5	3	8	0	0	8	0	0
12	10867400	rs7302837	C	T	3	3	6	0	0	6	0	0
12	10869299	rs61912197	G	A	25	27	52	0	0	52	0	0
12	10870398	.	C	T	17	18	35	0	1	36	0	0
12	10872216	rs10772356	G	A	6	9	15	0	0	15	0	0
12	10875488	rs1126501	T	C	220	162	382	0	4	386	0	0
12	10875525	rs1042085	G	A	123	78	201	0	2	203	0	0
12	11980401	rs2723836	T	G	41	30	71	0	0	71	0	0
12	11981298	rs2855736	G	A	24	22	46	0	1	47	0	0
12	11982347	rs2954933	G	A	58	42	100	0	0	100	0	0
12	11982349	rs2954934	G	A	58	42	100	0	0	100	0	0
12	11982519	rs3020817	C	T	34	42	76	0	0	76	0	0
12	11982551	rs2855737	G	C	29	42	71	0	0	71	0	0
12	11986346	rs2723819	G	A	20	25	45	0	0	45	0	0
12	11987759	rs2855738	T	C	38	47	85	0	1	86	0	0
12	11990610	rs10505762	C	T	82	66	148	0	0	148	0	0
12	11991667	rs928939	G	A	86	86	172	0	3	175	0	0
12	11992168	rs11611479	G	A	244	232	476	0	2	478	0	0
12	11993949	rs10505764	G	A	9	3	12	0	0	12	0	0
12	11994028	rs12305968	T	A	2	5	7	0	0	7	0	0
12	11995697	rs11054470	G	T	2	4	6	0	0	6	0	0
12	12035649	rs2710310	C	T	18	19	37	0	0	37	0	0
12	12035664	rs2739085	A	G	22	16	38	0	0	38	0	0
12	12035714	rs2710311	C	T	23	22	45	0	0	45	0	0
12	12036224	.	T	C	22	1	23	0	0	23	0	0
12	12036227	.	T	C	21	1	22	0	0	22	0	0
12	12036529	rs2238134	A	G	25	16	41	0	0	41	0	0
12	12041454	rs10772512	G	T	4	7	11	0	0	11	0	0
12	12041455	rs10772513	T	C	4	7	11	0	0	11	0	0
12	12264480	.	G	A	0	18	18	0	1	19	0	0
12	12270290	rs2160525	A	G	10	7	17	0	0	17	0	0
12	12270560	rs71457129	A	G	7	3	10	0	0	10	0	0
12	12271574	rs71457130	C	T	15	5	20	0	0	20	0	0
12	12272466	rs12314259	C	G	9	6	15	0	0	15	0	0
12	12272656	rs35025692	T	C	6	2	8	0	0	8	0	0
12	12284915	rs1012672	G	A	13	5	18	0	0	18	0	0
12	12330179	rs17819999	G	A	6	2	8	0	0	8	0	0
12	12331538	rs7957531	A	G	5	4	9	0	0	9	0	0
12	12334006	rs10082834	G	C	4	11	15	0	0	15	0	0
12	12336966	rs7978064	A	G	7	12	19	0	0	19	0	0
12	12355243	rs7311064	G	A	5	8	13	0	0	13	0	0
12	12367992	rs56998126	C	T	2	9	11	0	0	11	0	0
12	12369072	rs75798211	C	A	3	6	9	0	0	9	0	0
12	12419719	rs78631600	G	T	13	11	24	0	0	24	0	0
12	12618809	rs66487618	C	T	8	5	13	0	0	13	0	0
12	12618843	rs28932168	C	T	6	5	11	0	0	11	0	0
12	12629542	rs10845553	T	C	6	1	7	0	0	7	0	0
12	12647902	rs17312926	G	A	8	1	9	0	0	9	0	0
12	12796872	rs4555	T	C	3	4	7	0	0	7	0	0
12	12796960	.	C	T	2	6	8	0	1	9	0	0
12	12797151	rs9531	G	C	9	5	14	0	0	14	0	0
12	12870695	rs34330	T	C	263	283	546	0	4	550	0	0
12	12873653	rs34328	C	T	45	55	100	0	0	100	0	0
12	12873748	rs34327	T	C	66	76	142	0	1	143	0	0
12	12879057	rs34323	G	A	3	3	6	0	0	6	0	0
12	12879254	rs7956514	T	G	16	4	20	0	0	20	0	0
12	12879570	rs34322	T	C	8	20	28	0	1	29	0	0
12	12967127	rs1051374	C	T	177	133	310	0	1	311	0	0
12	12967442	rs960892	G	A	8	6	14	0	0	14	0	0
12	12969740	rs11055087	G	T	6	5	11	0	0	11	0	0
12	12970396	rs7314333	G	C	9	5	14	0	0	14	0	0
12	12970792	rs2058609	A	G	6	4	10	0	0	10	0	0
12	12973815	rs7960210	T	G	6	8	14	0	0	14	0	0
12	12978058	rs6488558	A	G	7	8	15	0	1	16	0	0
12	12978405	rs6488559	C	G	14	15	29	0	0	29	0	0
12	12978616	rs6488560	T	C	5	4	9	0	0	9	0	0
12	12979621	rs10845644	C	T	9	10	19	0	1	20	0	0
12	12980446	rs12425168	G	T	4	6	10	0	0	10	0	0
12	12980810	rs71433476	C	T	3	3	6	0	0	6	0	0
12	13004136	rs3825274	A	G	0	10	10	0	0	10	0	0
12	13362163	rs11612827	C	T	2	4	6	0	0	6	0	0
12	13362446	rs11608741	G	A	2	4	6	0	0	6	0	0
12	14520241	rs10845987	T	C	2	4	6	0	0	6	0	0
12	14521587	rs16909839	A	G	2	4	6	0	0	6	0	0
12	14529720	.	A	G	7	2	9	0	0	9	0	0
12	14529725	rs79821755	T	C	6	2	8	0	0	8	0	0
12	14587301	rs3213764	A	G	71	70	141	0	0	141	0	0
12	14593020	rs10772783	G	A	7	6	13	0	0	13	0	0
12	14643717	rs4764094	T	G	2	4	6	0	1	7	0	0
12	14643755	rs111871437	C	G	3	3	6	0	0	6	0	0
12	14656768	rs1600	G	C	4	7	11	0	0	11	0	0
12	14927994	rs2195199	T	C	5	7	12	0	0	12	0	0
12	14930055	rs3789999	G	T	5	1	6	0	0	6	0	0
12	14945585	rs7314317	G	C	13	18	31	0	0	31	0	0
12	14948434	rs2052325	C	G	3	9	12	0	0	12	0	0
12	14948611	rs7963211	C	T	7	5	12	0	0	12	0	0
12	14955702	rs7959540	T	A	5	2	7	0	1	8	0	0
12	16513364	rs2287150	A	C	6	1	7	0	0	7	0	0
12	16513370	rs9332929	A	G	2	6	8	0	0	8	0	0
12	19404273	rs112180673	A	G	2	5	7	0	0	7	0	0
12	19427764	rs76626801	T	C	29	25	54	0	1	55	0	0
12	19427766	rs77598867	A	G	30	25	55	0	0	55	0	0
12	19529068	rs8601	T	C	8	13	21	0	1	22	0	0
12	19593473	rs7312357	C	T	274	201	475	0	1	476	0	0
12	19593516	rs61914968	A	G	233	225	458	0	13	471	0	0
12	19594142	rs10770484	T	G	27	31	58	0	0	58	0	0
12	19616101	rs16915489	G	C	5	5	10	0	0	10	0	0
12	19705853	rs61919028	G	A	4	2	6	0	0	6	0	0
12	21610362	rs7133445	T	G	7	3	10	0	0	10	0	0
12	21621817	rs10841827	A	C	4	3	7	0	0	7	0	0
12	21621891	rs7319	T	C	5	4	9	0	0	9	0	0
12	21622822	rs71582885	T	C	7	5	12	0	0	12	0	0
12	21623122	rs13035	T	G	6	14	20	0	0	20	0	0
12	21623511	rs71530950	A	G	7	21	28	0	0	28	0	0
12	21654407	rs1061627	G	A	11	9	20	0	1	21	0	0
12	21654492	rs71581963	C	T	8	15	23	0	0	23	0	0
12	21654825	rs71539408	G	C	40	59	99	0	0	99	0	0
12	21654831	rs1060126	G	T	64	39	103	0	0	103	0	0
12	21662107	rs149228505	C	T	6	6	12	0	0	12	0	0
12	21662748	rs10841837	C	G	10	7	17	0	0	17	0	0
12	21663039	rs35538394	A	T	5	8	13	0	0	13	0	0
12	21663369	rs78874807	A	C	7	12	19	0	0	19	0	0
12	21663985	rs74389864	A	C	7	4	11	0	0	11	0	0
12	21667236	rs768833	A	G	5	3	8	0	0	8	0	0
12	21669027	rs1366	A	G	49	57	106	0	2	108	0	0
12	21669996	rs4565955	G	A	7	13	20	0	0	20	0	0
12	21670410	rs10770819	C	A	40	27	67	0	1	68	0	0
12	21803770	rs1650307	C	T	5	5	10	0	0	10	0	0
12	22666996	rs11046453	C	G	5	4	9	0	0	9	0	0
12	22667063	rs11046454	G	A	3	3	6	0	0	6	0	0
12	22787796	rs10842041	T	C	2	6	8	0	0	8	0	0
12	22791208	rs112165395	C	A	4	2	6	0	0	6	0	0
12	22791281	rs73080473	G	T	3	9	12	0	0	12	0	0
12	22840092	rs3741784	A	G	14	9	23	0	0	23	0	0
12	22842778	rs16925301	A	G	1	5	6	0	0	6	0	0
12	24964383	rs1043881	T	C	38	34	72	0	1	73	0	0
12	24964523	rs1043851	C	T	103	76	179	0	1	180	0	0
12	24965708	rs11047652	T	C	57	62	119	0	0	119	0	0
12	24966845	rs2353483	C	T	14	20	34	0	2	36	0	0
12	24967033	rs2353482	G	A	23	30	53	0	0	53	0	0
12	24967063	rs2353481	T	C	17	28	45	0	0	45	0	0
12	24967157	rs1872644	A	C	20	35	55	0	1	56	0	0
12	24967212	rs1872645	C	T	18	31	49	0	1	50	0	0
12	24967470	rs6487419	T	C	14	19	33	0	1	34	0	0
12	24967608	rs7296995	T	C	18	24	42	0	0	42	0	0
12	24967775	rs1054281	G	A	7	10	17	0	2	19	0	0
12	24968069	rs1054279	T	C	13	25	38	0	0	38	0	0
12	24968131	rs1054277	G	A	10	15	25	0	0	25	0	0
12	24968150	rs6487420	A	C	13	14	27	0	0	27	0	0
12	24968749	rs4453321	A	G	10	12	22	0	0	22	0	0
12	24968828	rs1471842	T	C	8	7	15	0	0	15	0	0
12	24969054	rs2046524	T	C	11	12	23	0	0	23	0	0
12	24969363	rs3198082	C	G	16	11	27	0	0	27	0	0
12	24969627	rs7305794	T	C	17	23	40	0	0	40	0	0
12	24969722	rs7134619	A	C	12	18	30	0	0	30	0	0
12	24969738	rs7134734	A	G	15	21	36	0	0	36	0	0
12	24969809	rs7134871	C	T	18	23	41	0	0	41	0	0
12	24970235	rs6487421	A	G	13	6	19	0	0	19	0	0
12	24970708	rs2220269	G	A	9	12	21	0	0	21	0	0
12	24970966	rs117200620	G	A	36	15	51	0	0	51	0	0
12	25055006	rs2291895	C	G	3	4	7	0	0	7	0	0
12	25098303	rs17316319	G	A	12	15	27	0	0	27	0	0
12	25243115	rs1908946	G	C	68	60	128	0	0	128	0	0
12	25243270	rs11047823	G	T	2	4	6	0	0	6	0	0
12	25244179	rs7964195	T	C	4	3	7	0	0	7	0	0
12	25247088	rs11047825	T	C	3	3	6	0	0	6	0	0
12	25247640	rs10842463	A	G	4	2	6	0	0	6	0	0
12	25252178	rs7960092	C	A	4	2	6	0	0	6	0	0
12	25252288	rs7960428	G	A	4	3	7	0	0	7	0	0
12	25255508	rs10842468	C	T	26	29	55	0	0	55	0	0
12	25255704	rs7972632	C	T	16	31	47	0	0	47	0	0
12	25256305	rs7976145	C	T	25	12	37	0	0	37	0	0
12	25256310	rs7976355	G	A	26	12	38	0	1	39	0	0
12	25256354	rs7976254	C	T	16	5	21	0	0	21	0	0
12	25257166	rs12828225	T	A	3	9	12	0	0	12	0	0
12	25257990	rs12425900	C	A	4	11	15	0	0	15	0	0
12	25259750	rs17386824	G	A	3	4	7	0	0	7	0	0
12	25348672	rs11047887	A	C	8	10	18	0	0	18	0	0
12	25348816	rs11047888	C	T	10	13	23	0	0	23	0	0
12	25358650	rs12245	A	T	83	73	156	0	5	161	0	0
12	25358828	rs12587	T	G	18	22	40	0	1	41	0	0
12	25358943	rs8720	T	C	11	7	18	0	1	19	0	0
12	25358969	rs1137196	T	G	8	7	15	0	0	15	0	0
12	25359328	rs1137189	A	T	20	15	35	0	0	35	0	0
12	25359352	rs1137188	G	A	14	11	25	0	1	26	0	0
12	25359841	rs13096	T	C	18	13	31	0	1	32	0	0
12	25361074	rs7973623	G	A	19	42	61	0	2	63	0	0
12	25361142	rs7973450	A	G	16	38	54	0	0	54	0	0
12	25361646	rs7960917	T	C	98	107	205	0	0	205	0	0
12	25362217	rs9266	A	G	76	54	130	0	0	130	0	0
12	25362552	rs712	A	C	26	30	56	0	3	59	0	0
12	25362777	rs1137282	A	G	48	71	119	0	0	119	0	0
12	25367838	rs4963859	A	C	5	2	7	0	0	7	0	0
12	25381346	rs11047904	G	C	4	4	8	0	0	8	0	0
12	25381353	rs10842512	C	G	5	4	9	0	0	9	0	0
12	25386623	rs117052079	C	T	2	8	10	0	0	10	0	0
12	25388316	rs7133640	G	C	19	8	27	0	0	27	0	0
12	25388897	rs34527025	T	G	6	13	19	0	0	19	0	0
12	25389182	rs17388573	A	G	6	6	12	0	0	12	0	0
12	25391456	rs6487464	C	T	6	3	9	0	0	9	0	0
12	25392282	rs10842514	C	T	2	9	11	0	0	11	0	0
12	25392293	rs11047915	G	A	11	2	13	0	0	13	0	0
12	25393523	rs10842515	T	C	19	10	29	0	0	29	0	0
12	25394779	rs12813551	C	T	4	9	13	0	0	13	0	0
12	25957846	rs536476742	G	A	8	0	8	0	0	8	0	0
12	26426420	rs9668810	T	C	2	4	6	0	0	6	0	0
12	26426671	rs9300169	A	G	4	9	13	0	0	13	0	0
12	26427183	rs17382507	A	T	3	8	11	0	0	11	0	0
12	26427462	rs73072457	C	T	1	6	7	0	1	8	0	0
12	26554742	rs2277349	T	C	4	10	14	0	0	14	0	0
12	26554780	rs2277350	G	C	5	8	13	0	0	13	0	0
12	26555054	rs73081111	G	A	7	7	14	0	0	14	0	0
12	26555158	rs901840	A	G	7	7	14	0	0	14	0	0
12	26555978	rs11048498	A	G	12	6	18	0	0	18	0	0
12	26556111	rs11048499	C	T	6	8	14	0	0	14	0	0
12	26563399	rs12826091	A	G	4	4	8	0	0	8	0	0
12	26576064	rs7967826	G	C	3	3	6	0	0	6	0	0
12	26648092	rs2230381	C	T	21	14	35	0	0	35	0	0
12	26732987	rs2230376	G	A	13	18	31	0	0	31	0	0
12	26733062	rs2230375	T	C	12	22	34	0	0	34	0	0
12	26749831	rs2230377	G	A	13	13	26	0	0	26	0	0
12	26806955	rs2230380	G	A	11	9	20	0	0	20	0	0
12	27111321	rs840896	C	T	6	1	7	0	0	7	0	0
12	27115395	rs6487582	C	T	3	6	9	0	0	9	0	0
12	27118613	rs900743	C	A	43	46	89	0	3	92	0	0
12	27124876	rs7314184	T	G	31	31	62	0	2	64	0	0
12	27126196	rs1127782	T	G	44	27	71	0	1	72	0	0
12	27130635	rs7309280	T	C	2	4	6	0	0	6	0	0
12	27134789	rs17408108	A	G	1	5	6	0	0	6	0	0
12	27152666	rs7314394	T	C	5	1	6	0	0	6	0	0
12	27167220	rs144765532	G	A	2	5	7	0	0	7	0	0
12	27175640	rs1872191	A	G	5	4	9	0	0	9	0	0
12	27177147	rs11048820	T	C	4	8	12	0	0	12	0	0
12	27181513	rs8628	T	G	15	29	44	0	0	44	0	0
12	27181799	rs1872193	G	A	81	82	163	0	2	165	0	0
12	27182956	rs111936388	A	T	11	11	22	0	0	22	0	0
12	27183456	rs73091125	G	A	9	6	15	0	0	15	0	0
12	27183860	rs11835886	T	G	11	7	18	0	0	18	0	0
12	27183897	rs11838107	A	G	14	6	20	0	0	20	0	0
12	27184709	rs7971802	G	T	11	9	20	0	0	20	0	0
12	27187462	rs73091136	G	C	4	4	8	0	0	8	0	0
12	27188585	rs61920364	C	T	6	3	9	0	1	10	0	0
12	27188789	rs10842829	A	G	13	5	18	0	0	18	0	0
12	27189393	rs138329233	A	G	15	14	29	0	0	29	0	0
12	27189520	rs113755376	C	T	12	8	20	0	0	20	0	0
12	27189914	rs149493937	G	T	20	11	31	0	0	31	0	0
12	27190295	rs7132507	T	G	13	7	20	0	0	20	0	0
12	27190371	rs7301549	A	C	21	5	26	0	0	26	0	0
12	27190432	rs7302040	G	A	20	4	24	0	0	24	0	0
12	27191710	rs10771317	T	G	16	27	43	0	0	43	0	0
12	27194656	rs10842837	A	G	4	3	7	0	0	7	0	0
12	27196304	rs11048830	A	G	6	1	7	0	0	7	0	0
12	27196317	rs11048831	G	A	5	2	7	0	0	7	0	0
12	27199180	rs1388659	G	A	4	3	7	0	0	7	0	0
12	27199920	rs9668412	C	T	5	1	6	0	0	6	0	0
12	27470788	rs10771336	C	T	10	11	21	0	0	21	0	0
12	27476545	rs10842902	A	G	33	39	72	0	0	72	0	0
12	27788021	rs2075378	G	A	3	3	6	0	0	6	0	0
12	27845924	rs3764010	C	T	6	8	14	0	0	14	0	0
12	27952620	rs17801400	T	G	7	3	10	0	2	12	0	0
12	27952633	rs17224065	C	T	8	5	13	0	0	13	0	0
12	27954507	rs1050287	T	C	6	9	15	0	0	15	0	0
12	27955296	rs1050288	C	T	4	3	7	0	1	8	0	0
12	27955841	rs9029	C	G	2	4	6	0	0	6	0	0
12	28412372	rs11049488	G	A	7	15	22	0	0	22	0	0
12	29309702	rs4930855	T	C	10	16	26	0	0	26	0	0
12	29324418	rs4931157	C	T	4	7	11	0	0	11	0	0
12	29324429	rs11050095	C	T	9	2	11	0	1	12	0	0
12	29324505	rs11050096	G	A	10	5	15	0	0	15	0	0
12	30782076	rs7327	T	C	8	11	19	0	0	19	0	0
12	30782301	rs7326	A	G	22	20	42	0	0	42	0	0
12	30782402	rs7325	T	C	13	14	27	0	1	28	0	0
12	30782492	rs8414	C	T	11	13	24	0	0	24	0	0
12	30782598	rs14139	T	C	8	12	20	0	0	20	0	0
12	30782646	rs10843796	A	C	9	16	25	0	0	25	0	0
12	30783184	rs4082413	C	G	11	8	19	0	0	19	0	0
12	30783475	rs11051005	A	G	5	7	12	0	0	12	0	0
12	30783743	rs2278558	C	T	10	8	18	0	0	18	0	0
12	30823971	rs1054426	A	G	5	4	9	0	0	9	0	0
12	30868002	rs13656	C	T	6	5	11	0	0	11	0	0
12	30881809	rs2304630	T	C	5	5	10	0	0	10	0	0
12	31944691	rs3759294	A	C	9	0	9	0	0	9	0	0
12	32114454	rs7955585	C	T	3	3	6	0	0	6	0	0
12	32134240	rs2388982	C	T	38	30	68	0	0	68	0	0
12	32134638	rs2166807	T	C	21	28	49	0	0	49	0	0
12	32134943	rs10771894	A	G	44	24	68	0	0	68	0	0
12	32135441	rs3759301	T	C	25	30	55	0	0	55	0	0
12	32137447	rs3759300	C	T	44	57	101	0	0	101	0	0
12	32137512	rs3759299	C	G	46	52	98	0	0	98	0	0
12	32138924	rs7302975	T	C	9	11	20	0	0	20	0	0
12	32139042	rs10844082	A	G	11	4	15	0	1	16	0	0
12	32139418	rs10771895	T	G	4	8	12	0	0	12	0	0
12	32141495	rs4931000	A	G	3	5	8	0	0	8	0	0
12	32143169	rs4931002	C	A	4	4	8	0	0	8	0	0
12	32144465	rs35771026	G	A	5	2	7	0	0	7	0	0
12	32854366	rs10844308	A	C	37	34	71	0	0	71	0	0
12	32859757	rs10844309	C	T	5	6	11	0	0	11	0	0
12	32860302	rs2272238	G	A	34	39	73	0	0	73	0	0
12	32864459	rs11052198	C	T	5	1	6	0	0	6	0	0
12	32864527	rs11052199	G	A	6	3	9	0	0	9	0	0
12	32875406	rs10844318	A	G	47	45	92	0	0	92	0	0
12	32878475	rs10844323	A	G	4	8	12	0	0	12	0	0
12	32878563	rs12303426	T	C	4	3	7	0	0	7	0	0
12	32879346	rs10844324	C	A	3	4	7	0	0	7	0	0
12	32879976	rs7310136	G	A	4	2	6	0	0	6	0	0
12	32890161	rs7302970	C	T	7	9	16	0	0	16	0	0
12	32892678	rs7955582	C	T	13	18	31	0	2	33	0	0
12	32896365	rs1059422	G	C	83	79	162	0	0	162	0	0
12	32896366	rs3200103	A	T	77	79	156	0	0	156	0	0
12	32896615	rs1020670	C	G	47	34	81	0	0	81	0	0
12	32896944	rs3600	C	T	67	66	133	0	1	134	0	0
12	32897088	rs1971911	A	T	52	46	98	0	1	99	0	0
12	32897437	rs1971910	T	C	45	49	94	0	1	95	0	0
12	32897557	rs11052213	G	T	62	56	118	0	0	118	0	0
12	32897586	rs10844336	G	A	69	63	132	0	2	134	0	0
12	32908237	rs11539445	C	A	18	12	30	0	0	30	0	0
12	32908518	rs11539444	G	A	13	8	21	0	0	21	0	0
12	38710583	rs7296576	C	T	4	4	8	0	0	8	0	0
12	38715965	rs6582599	T	G	4	4	8	0	0	8	0	0
12	39087609	rs3759139	G	A	6	12	18	0	0	18	0	0
12	39097312	rs826896	G	T	4	4	8	0	0	8	0	0
12	39097377	rs826895	C	T	4	3	7	0	0	7	0	0
12	39210794	rs112207355	G	C	3	3	6	0	0	6	0	0
12	39212757	rs4002228	A	C	6	1	7	0	0	7	0	0
12	42477570	rs17666080	T	C	3	6	9	0	0	9	0	0
12	42481545	rs17801478	T	C	3	6	9	0	0	9	0	0
12	42619524	rs34289722	G	A	75	51	126	0	1	127	0	0
12	42626105	rs187476792	G	A	9	4	13	0	0	13	0	0
12	42718391	rs11181421	A	C	2	8	10	0	0	10	0	0
12	42718552	rs11181422	G	A	3	6	9	0	0	9	0	0
12	42719890	rs3747560	A	G	39	42	81	0	0	81	0	0
12	42749339	rs12228205	T	G	6	3	9	0	0	9	0	0
12	42749849	rs4768401	C	T	12	16	28	0	0	28	0	0
12	42752189	rs79100018	A	C	7	5	12	0	0	12	0	0
12	42753937	rs73122408	A	G	20	10	30	0	2	32	0	0
12	42754246	rs73122414	A	G	7	3	10	0	0	10	0	0
12	42754414	rs73122418	C	G	17	11	28	0	0	28	0	0
12	42755576	rs4768402	A	G	8	8	16	0	0	16	0	0
12	42770415	rs1669911	C	T	2	4	6	0	0	6	0	0
12	42772335	rs1669910	A	C	4	2	6	0	0	6	0	0
12	42774700	rs721447	A	G	6	9	15	0	0	15	0	0
12	42776692	.	C	T	9	9	18	0	0	18	0	0
12	42840955	rs1796382	C	G	9	13	22	0	0	22	0	0
12	42853350	rs1043656	A	G	6	0	6	0	0	6	0	0
12	44116330	rs77407520	T	C	2	6	8	0	0	8	0	0
12	44148773	rs33999797	A	C	7	7	14	0	0	14	0	0
12	44164305	rs4238087	A	G	3	3	6	0	0	6	0	0
12	44164689	rs1461567	G	A	5	4	9	0	0	9	0	0
12	44182706	rs1141168	A	G	20	14	34	0	0	34	0	0
12	46172034	rs73095497	C	A	9	13	22	0	0	22	0	0
12	46239012	rs247930	G	A	8	2	10	0	0	10	0	0
12	46289948	rs11183229	G	A	9	8	17	0	0	17	0	0
12	46313638	rs1366024	G	A	17	16	33	0	1	34	0	0
12	46314392	rs10880867	A	G	28	16	44	0	3	47	0	0
12	46317004	rs1062905	T	A	2	4	6	0	0	6	0	0
12	46321514	rs7315731	A	T	63	73	136	0	2	138	0	0
12	46332497	rs17096327	G	A	7	8	15	0	0	15	0	0
12	46336258	rs11183243	G	A	4	4	8	0	0	8	0	0
12	46341867	rs4768670	T	G	4	2	6	0	0	6	0	0
12	46347124	rs997307	G	A	7	2	9	0	0	9	0	0
12	46348076	rs7967208	A	G	10	8	18	0	0	18	0	0
12	46348859	rs17096361	T	C	5	3	8	0	1	9	0	0
12	46356651	rs11183251	T	C	5	2	7	0	0	7	0	0
12	46367903	rs10880879	T	C	20	15	35	0	0	35	0	0
12	46367939	rs11183268	G	T	53	29	82	0	0	82	0	0
12	46367944	rs11183269	A	G	28	64	92	0	0	92	0	0
12	46577071	rs1049358	G	A	347	301	648	0	5	653	0	0
12	46577893	rs3742055	G	C	294	274	568	0	4	572	0	0
12	46577921	rs1049304	G	T	260	313	573	0	1	574	0	0
12	46578010	rs3742057	A	G	312	290	602	0	6	609	1	0
12	46579388	rs3497	A	G	227	189	416	0	2	418	0	0
12	46579590	rs11183385	A	G	155	180	335	0	0	336	1	0
12	46581309	rs3742060	T	G	170	165	335	0	0	335	0	0
12	46589453	.	C	G	17	25	42	0	1	43	0	0
12	46604068	rs11183395	A	G	4	3	7	0	0	7	0	0
12	46607280	rs962683	C	T	4	3	7	0	0	7	0	0
12	46608618	rs4768108	G	A	5	5	10	0	0	10	0	0
12	46613819	rs960117	C	T	5	4	9	0	0	9	0	0
12	46618715	rs7970176	T	C	5	1	6	0	0	6	0	0
12	46633328	rs7959095	G	T	23	21	44	0	0	44	0	0
12	46637351	rs56988021	T	C	15	12	27	0	0	27	0	0
12	46639635	rs4768692	T	C	2	10	12	0	0	12	0	0
12	46641744	rs4445700	A	G	4	6	10	0	0	10	0	0
12	46644291	rs11504510	A	T	4	2	6	0	0	6	0	0
12	46647998	rs7312682	C	T	21	10	31	0	0	31	0	0
12	46648983	rs12580460	G	A	7	8	15	0	0	15	0	0
12	46649528	rs12303214	A	G	10	11	21	0	0	21	0	0
12	46650737	rs2408496	A	G	14	13	27	0	0	27	0	0
12	46655287	rs3847985	G	A	11	3	14	0	0	14	0	0
12	46658059	rs4768109	C	T	3	3	6	0	0	6	0	0
12	46658425	rs117756486	G	A	2	5	7	0	0	7	0	0
12	46658695	rs973988	T	A	5	6	11	0	0	11	0	0
12	46660508	rs1492888	C	T	5	7	12	0	0	12	0	0
12	46661279	rs2279560	A	G	9	8	17	0	0	17	0	0
12	46661387	rs1060735	A	G	7	8	15	0	0	15	0	0
12	46662485	rs2242355	G	C	99	112	211	0	1	212	0	0
12	46755112	rs7961994	A	T	9	11	20	0	0	20	0	0
12	46757985	rs3782904	T	C	10	12	22	0	0	22	0	0
12	46758494	rs2307061	A	G	19	20	39	0	0	39	0	0
12	46759017	rs7968173	T	A	21	23	44	0	1	45	0	0
12	46759057	rs12307969	G	C	18	18	36	0	1	37	0	0
12	46759136	rs7968283	T	C	15	24	39	0	1	40	0	0
12	46759788	rs956910	A	G	23	30	53	0	2	55	0	0
12	46761127	rs10880959	G	A	47	26	73	0	0	73	0	0
12	46761324	rs1873793	C	T	55	63	118	0	2	120	0	0
12	46761829	rs10880960	T	G	29	37	66	0	1	67	0	0
12	46763686	rs2897968	G	A	14	21	35	0	0	35	0	0
12	46766360	.	A	C	182	101	283	0	3	286	0	0
12	47470997	rs34535517	G	T	1	5	6	0	0	6	0	0
12	48139933	rs4768162	A	G	3	5	8	0	0	8	0	0
12	48140381	rs11168223	T	C	3	6	9	0	0	9	0	0
12	48152605	rs56304982	G	C	6	1	7	0	0	7	0	0
12	48174275	rs59205218	C	T	16	10	26	0	0	26	0	0
12	48174641	rs7964310	T	C	18	19	37	0	0	37	0	0
12	48175093	rs2525042	A	G	27	11	38	0	0	38	0	0
12	48175570	rs74854988	C	T	5	4	9	0	0	9	0	0
12	48175604	rs4760652	A	G	9	7	16	0	0	16	0	0
12	48175837	rs4760654	A	G	10	8	18	0	0	18	0	0
12	48176792	rs7418	C	T	277	261	538	0	5	543	0	0
12	48176900	rs9859	T	G	271	292	563	0	3	566	0	0
12	48177073	rs2408874	A	G	221	241	462	0	5	467	0	0
12	48177238	rs13632	A	G	152	168	320	0	3	323	0	0
12	48177906	rs7306788	C	T	111	126	237	0	0	237	0	0
12	48178127	rs3192737	A	G	10	11	21	0	0	21	0	0
12	48178194	rs7307046	A	G	9	8	17	0	0	17	0	0
12	48178212	rs7307367	G	A	9	7	16	0	0	16	0	0
12	48178465	rs3815138	T	C	9	12	21	0	0	21	0	0
12	48178513	rs7972177	A	G	16	16	32	0	0	32	0	0
12	48178909	rs3815136	C	A	7	16	23	0	0	23	0	0
12	48179044	rs3815133	C	G	6	12	18	0	0	18	0	0
12	48179347	rs1006476	C	T	7	2	9	0	0	9	0	0
12	48180022	rs2240109	T	C	18	14	32	0	0	32	0	0
12	48180984	rs76664121	C	T	6	4	10	0	0	10	0	0
12	48181260	rs73291230	C	T	4	4	8	0	0	8	0	0
12	48186563	rs2544026	T	A	3	5	8	0	0	8	0	0
12	48186738	rs2525055	T	G	8	11	19	0	0	19	0	0
12	48190044	rs11831883	C	T	69	92	161	0	2	163	0	0
12	48190269	rs112689589	C	T	6	1	7	0	0	7	0	0
12	48362412	rs6823	G	C	23	18	41	0	0	41	0	0
12	48438290	rs60629297	T	A	31	23	54	0	2	56	0	0
12	48449163	rs4760677	C	T	4	2	6	0	0	6	0	0
12	48492922	rs10875741	A	C	3	31	34	0	0	34	0	0
12	48545553	rs10783230	G	T	4	4	8	0	0	8	0	0
12	48545791	rs10875751	T	C	5	2	7	0	0	7	0	0
12	48734609	rs901963	A	G	14	7	21	0	0	21	0	0
12	48735304	rs2634679	G	T	9	8	17	0	0	17	0	0
12	48735309	rs34157519	T	A	9	8	17	0	0	17	0	0
12	49048738	rs3741628	G	T	471	416	887	0	16	903	0	0
12	49048985	rs6580690	G	A	7	9	16	0	0	16	0	0
12	49050182	rs7138190	C	A	5	1	6	0	0	6	0	0
12	49052736	rs61942047	A	G	18	15	33	0	0	33	0	0
12	49052758	rs3943899	G	A	24	12	36	0	0	36	0	0
12	49052795	rs12426435	C	G	29	13	42	0	0	42	0	0
12	49054491	rs3741629	G	C	7	6	13	0	0	13	0	0
12	49055179	rs7314665	C	T	5	3	8	0	0	8	0	0
12	49056663	rs1895994	G	A	3	5	8	0	0	8	0	0
12	49056787	rs2409084	G	A	6	9	15	0	0	15	0	0
12	49058156	rs35717253	A	G	16	12	28	0	0	28	0	0
12	49065727	rs7303113	T	C	348	283	631	0	3	634	0	0
12	49074613	rs113534893	T	C	4	5	9	0	0	9	0	0
12	49074763	rs10783276	G	A	2	4	6	0	0	6	0	0
12	49074764	.	C	A	2	4	6	0	0	6	0	0
12	49075983	rs61942052	C	G	114	87	201	0	1	202	0	0
12	49075984	rs61942053	T	G	115	87	202	0	0	202	0	0
12	49083394	rs3209584	G	T	107	120	227	0	1	228	0	0
12	49084434	rs3803025	G	A	105	118	223	0	1	224	0	0
12	49086963	rs3741632	G	A	75	82	157	0	1	158	0	0
12	49087656	rs3013	G	C	84	74	158	0	0	159	1	0
12	49106363	.	A	T	7	0	7	0	6	13	0	0
12	49110223	rs11168699	C	A	4	3	7	0	0	7	0	0
12	49110225	rs11168700	C	A	5	2	7	0	1	8	0	0
12	49110248	rs1110432	G	A	3	3	6	0	0	6	0	0
12	49222217	rs954	T	C	6	6	12	0	0	12	0	0
12	49222269	.	C	T	7	3	10	0	1	11	0	0
12	49422094	rs10875914	A	G	3	4	7	0	0	7	0	0
12	49499666	.	T	G	33	26	59	0	0	59	0	0
12	49663961	rs117028987	A	C	1	6	7	0	0	7	0	0
12	50157053	.	C	T	249	219	468	0	3	471	0	0
12	50185334	rs2290442	A	G	45	57	102	0	0	102	0	0
12	50188391	rs12314502	C	A	4	2	6	0	0	6	0	0
12	50189807	rs2720298	C	A	31	32	63	0	0	63	0	0
12	50189834	rs2603104	T	G	29	35	64	0	0	64	0	0
12	50195390	rs1077498	A	G	3	5	8	0	0	8	0	0
12	50196281	rs112665992	C	T	5	2	7	0	0	7	0	0
12	50482211	rs646782	T	C	5	2	7	0	1	8	0	0
12	50482921	rs3782323	G	A	14	10	24	0	0	24	0	0
12	50484013	rs73121544	G	A	11	9	20	0	0	20	0	0
12	50490099	rs836172	C	G	3	5	8	0	0	8	0	0
12	50490616	.	T	C	4	3	7	0	0	7	0	0
12	50491141	rs836173	C	T	3	7	10	0	0	10	0	0
12	50491229	rs836174	G	A	7	2	9	0	0	9	0	0
12	50491630	rs836176	C	T	4	2	6	0	0	6	0	0
12	50491821	rs836177	A	G	6	6	12	0	0	12	0	0
12	50494221	.	T	C	133	127	260	0	5	265	0	0
12	50512279	rs55639096	C	T	13	0	13	0	0	13	0	0
12	50512293	rs12229758	G	A	18	0	18	0	0	18	0	0
12	50523947	rs7279	A	G	107	103	210	0	1	211	0	0
12	50523964	rs7532	T	C	107	103	210	0	0	210	0	0
12	50526495	.	G	C	14	1	15	0	0	15	0	0
12	50526814	rs2242507	G	A	9	10	19	0	1	20	0	0
12	50537815	rs7302981	A	G	42	38	80	0	3	83	0	0
12	50538625	rs2008537	A	G	11	7	18	0	0	18	0	0
12	51020471	rs2700479	A	G	4	4	8	0	0	8	0	0
12	51112586	rs3803181	T	C	38	30	68	0	0	68	0	0
12	51140410	rs7303202	C	G	68	75	143	0	1	144	0	0
12	51141883	rs4768915	A	G	88	102	190	0	0	190	0	0
12	51583441	rs1126905	T	C	1	6	7	0	0	7	0	0
12	51583506	rs3490	G	A	4	2	6	0	0	6	0	0
12	51641870	rs73109020	G	A	2	4	6	0	0	6	0	0
12	51685429	.	G	A	254	206	460	0	2	462	0	0
12	51722311	rs7138439	C	T	13	5	18	0	0	18	0	0
12	51745834	rs10516	C	T	32	28	60	0	0	60	0	0
12	51785889	rs55697954	G	A	12	10	22	0	0	22	0	0
12	51902249	rs2292220	C	T	3	3	6	0	0	6	0	0
12	52379854	rs2220805	A	G	3	6	9	0	1	10	0	0
12	52445872	rs2087978	C	T	47	38	85	0	0	85	0	0
12	52447752	rs2603756	T	C	25	18	43	0	1	44	0	0
12	52450046	rs12812582	C	T	67	61	128	0	2	130	0	0
12	52452220	rs1882116	C	T	41	54	95	0	1	96	0	0
12	52452357	rs1882121	G	A	14	26	40	0	0	40	0	0
12	53069014	rs14024	T	C	22	12	34	0	1	35	0	0
12	53433795	rs118039944	A	G	16	5	21	0	0	21	0	0
12	53459335	rs11545160	C	T	18	10	28	0	1	29	0	0
12	53581376	rs3101059	C	T	11	9	20	0	0	20	0	0
12	53605344	rs3741434	T	C	5	4	9	0	0	9	0	0
12	53646369	rs6580938	T	G	5	1	6	0	0	6	0	0
12	53647373	rs10876422	T	C	48	37	85	0	0	85	0	0
12	53700853	rs142953883	G	A	68	70	138	0	0	138	0	0
12	53777171	rs3741651	A	G	55	53	108	0	1	109	0	0
12	53806655	rs17695156	C	T	82	78	160	0	0	160	0	0
12	53839956	rs8707	C	G	634	614	1248	0	2	1250	0	0
12	53840385	rs8652	T	C	168	79	247	0	0	247	0	0
12	54575458	rs971	T	C	2	4	6	0	0	6	0	0
12	54581614	rs3087404	T	C	3	5	8	0	0	8	0	0
12	54625518	rs116944265	A	G	23	13	36	0	0	36	0	0
12	54686187	.	G	A	105	80	185	0	2	187	0	0
12	54903308	rs1795845	T	C	3	3	6	0	0	6	0	0
12	54911426	rs2270581	C	T	158	119	277	0	2	279	0	0
12	54911768	rs1795838	C	T	20	23	43	0	1	44	0	0
12	54931555	rs12817091	A	G	3	5	8	0	0	8	0	0
12	54934932	rs60666964	A	G	5	3	8	0	0	8	0	0
12	54967656	.	T	A	2	9	11	0	0	11	0	0
12	54967658	.	T	A	6	6	12	0	0	12	0	0
12	54967739	rs3782410	G	A	2	8	10	0	0	10	0	0
12	54967901	rs3782411	C	T	9	4	13	0	0	13	0	0
12	54969998	rs1249949	A	G	4	2	6	0	0	6	0	0
12	54970454	rs1249950	T	C	12	26	38	0	0	38	0	0
12	54972843	rs10783631	A	G	14	28	42	0	0	42	0	0
12	54972992	rs3825195	T	C	6	6	12	0	0	12	0	0
12	55368245	rs4758993	G	A	7	7	14	0	0	14	0	0
12	55368368	rs4758994	G	A	14	14	28	0	0	28	0	0
12	55377875	rs10506334	G	T	6	0	6	0	0	6	0	0
12	56077740	rs11615467	C	T	4	6	10	0	0	10	0	0
12	56082025	rs17117883	G	C	5	3	8	0	0	8	0	0
12	56089357	rs1800974	C	T	4	6	10	0	1	11	0	0
12	56110364	rs78784079	G	A	7	7	14	0	1	15	0	0
12	56115785	rs3138140	C	T	9	6	15	0	1	16	0	0
12	56115883	rs3138139	T	C	6	5	11	0	0	11	0	0
12	56117700	rs13193	C	G	11	14	25	0	0	25	0	0
12	56120589	rs2231464	C	T	18	9	27	0	0	27	0	0
12	56121449	rs3138132	G	C	5	6	11	0	0	11	0	0
12	56123365	rs2231462	G	A	2	10	12	0	0	12	0	0
12	56148291	rs1081732	C	G	3	3	6	0	0	6	0	0
12	56151291	rs7068	T	C	185	191	376	0	4	380	0	0
12	56151960	rs59980563	C	G	16	19	35	0	1	36	0	0
12	56170893	rs1463591	A	G	10	12	22	0	0	22	0	0
12	56216070	rs12308277	G	T	13	11	24	0	0	24	0	0
12	56222968	rs112561781	C	G	34	15	49	0	0	49	0	0
12	56224732	rs17118032	G	C	81	82	163	0	1	164	0	0
12	56225284	rs7965333	C	G	14	6	20	0	0	20	0	0
12	56229110	.	T	C	93	94	187	0	0	187	0	0
12	56236043	rs2291268	G	A	0	6	6	0	0	6	0	0
12	56326499	.	A	G	5	4	9	0	0	9	0	0
12	56335107	rs1136082	A	G	47	39	86	0	2	88	0	0
12	56435929	rs1131017	C	G	11	6	17	0	1	18	0	0
12	56634260	.	A	T	13	1	14	0	4	18	0	0
12	56634267	.	A	T	7	2	9	0	9	18	0	0
12	56634583	rs61937675	C	G	9	20	29	0	0	29	0	0
12	56814653	rs2291739	G	A	17	16	33	0	0	33	0	0
12	56815922	rs774047	C	T	5	14	19	0	0	19	0	0
12	56822378	rs774027	T	A	6	7	13	0	0	13	0	0
12	56825311	rs774033	C	T	11	8	19	0	1	20	0	0
12	56827694	rs2279665	C	G	12	8	20	0	0	20	0	0
12	56983252	rs941208	C	T	9	8	17	0	0	17	0	0
12	56983425	rs941209	T	C	8	6	14	0	1	15	0	0
12	57037227	.	A	G	974	1022	1996	0	13	2009	0	0
12	57394123	rs3803018	C	A	7	15	22	0	0	22	0	0
12	57394654	rs2371717	G	A	10	14	24	0	0	24	0	0
12	57395678	rs754398	T	G	9	10	19	0	2	21	0	0
12	57397033	rs61752546	C	T	5	6	11	0	0	11	0	0
12	57449610	rs4039	T	G	4	2	6	0	0	6	0	0
12	57449705	rs1044939	T	C	6	8	14	0	0	14	0	0
12	57449810	rs1044931	C	T	12	12	24	0	0	24	0	0
12	57450840	rs10506351	G	C	7	6	13	0	0	13	0	0
12	57452308	rs17119407	T	C	7	7	14	0	0	14	0	0
12	57489616	rs12371273	T	C	306	117	423	0	2	425	0	0
12	57489648	rs4559	C	T	322	123	445	0	2	447	0	0
12	57489828	rs703817	C	T	300	226	526	0	2	528	0	0
12	57492996	rs841718	G	A	12	7	19	0	0	19	0	0
12	57497005	rs703816	T	C	4	5	9	0	0	9	0	0
12	57497970	rs56214329	G	A	4	6	10	0	0	10	0	0
12	57503775	rs167769	C	T	12	2	14	0	0	14	0	0
12	57637593	rs3204635	G	A	3	8	11	0	0	11	0	0
12	57823192	rs567895	C	T	4	3	7	0	0	7	0	0
12	57869447	rs2277318	T	C	13	6	19	0	0	19	0	0
12	57869476	rs2277317	G	A	16	9	25	0	0	25	0	0
12	57869486	rs2277316	A	G	15	8	23	0	0	23	0	0
12	57869582	rs2277315	T	C	19	10	29	0	0	29	0	0
12	57870155	rs11544238	A	C	99	85	184	0	1	185	0	0
12	57923211	.	A	C	9	1	10	0	0	10	0	0
12	57923214	.	A	C	9	1	10	0	1	11	0	0
12	57933073	rs111995174	A	G	6	2	8	0	0	8	0	0
12	57985204	rs11537654	C	T	5	3	8	0	0	8	0	0
12	58109707	rs73125477	T	G	454	406	860	0	55	915	0	0
12	58112189	rs799265	A	G	524	629	1153	0	11	1164	0	0
12	58113158	rs799267	C	T	8	5	13	0	0	13	0	0
12	58113416	rs701007	C	A	4	4	8	0	0	8	0	0
12	58115271	rs1050045	T	C	327	264	591	0	2	593	0	0
12	58117645	rs701008	T	C	9	11	20	0	0	20	0	0
12	58117737	rs238517	T	G	14	7	21	0	0	21	0	0
12	58118248	rs2269720	T	C	5	7	12	0	0	12	0	0
12	58126234	rs17852479	C	A	36	23	59	0	0	59	0	0
12	58145156	rs2270777	C	T	3	3	6	0	0	6	0	0
12	58162739	rs703842	A	G	14	19	33	0	1	34	0	0
12	58176614	rs10747783	T	C	26	30	56	0	1	57	0	0
12	58177437	rs2014886	C	T	6	9	15	0	0	15	0	0
12	58177943	rs1599932	G	A	3	10	13	0	0	13	0	0
12	58196802	rs1875124	A	G	2	4	6	0	0	6	0	0
12	58219681	rs871871	G	A	6	3	9	0	0	9	0	0
12	58222672	rs4760332	C	A	14	15	29	0	0	29	0	0
12	58329820	rs2372309	G	A	18	7	25	0	1	26	0	0
12	58335330	rs3751326	C	G	3	3	6	0	0	6	0	0
12	58335626	rs3751325	A	T	13	2	15	0	0	15	0	0
12	58350631	rs10122	C	T	19	8	27	0	0	27	0	0
12	60173406	rs3763979	C	T	4	7	11	0	0	11	0	0
12	60173888	rs4432061	G	A	3	5	8	0	0	8	0	0
12	62698716	rs1389134	G	A	1	5	6	0	0	6	0	0
12	62699378	rs34301355	G	A	4	6	10	0	0	10	0	0
12	62715931	rs34684698	C	T	7	4	11	0	0	11	0	0
12	62716878	rs34251904	A	G	5	4	9	0	0	9	0	0
12	62727870	rs34007988	A	C	8	8	16	0	2	18	0	0
12	62729222	rs2242032	G	C	165	187	352	0	3	355	0	0
12	62729606	.	C	T	82	70	152	0	1	153	0	0
12	62730727	rs11174429	T	A	4	2	6	0	0	6	0	0
12	62778065	rs2044846	A	G	29	30	59	0	2	61	0	0
12	62785663	rs11174457	T	C	37	40	77	0	1	78	0	0
12	62799401	rs11174462	A	G	3	8	11	0	0	11	0	0
12	62895478	.	A	G	21	12	33	0	0	33	0	0
12	62905723	rs11559995	G	A	3	5	8	0	0	8	0	0
12	62908482	rs79304148	G	T	5	4	9	0	0	9	0	0
12	62909179	rs78662428	T	C	4	2	6	0	0	6	0	0
12	62959137	rs11174549	A	G	6	9	15	0	0	15	0	0
12	63038698	rs3825305	C	A	5	5	10	0	0	10	0	0
12	63083521	rs11174604	G	A	5	6	11	0	0	11	0	0
12	63359168	rs699596	G	A	95	0	95	0	4	99	0	0
12	63359409	rs699597	C	A	58	0	58	0	5	63	0	0
12	65004520	rs77813527	A	G	19	16	35	0	0	35	0	0
12	65020484	rs35860561	G	A	3	3	6	0	0	6	0	0
12	65108160	rs1061743	G	C	18	27	45	0	0	45	0	0
12	65108494	.	A	G	19	18	37	0	0	37	0	0
12	65109168	rs1269548	C	T	28	17	45	0	0	45	0	0
12	65110141	rs674	G	A	35	34	69	0	0	69	0	0
12	65110252	rs2279597	G	A	26	24	50	0	0	50	0	0
12	65146532	.	C	T	11	13	24	0	0	24	0	0
12	65571343	rs7312038	G	A	6	5	11	0	0	11	0	0
12	65571921	rs61923514	C	T	7	5	12	0	0	12	0	0
12	65572183	rs11612097	A	G	3	6	9	0	1	10	0	0
12	65578635	rs12425024	A	T	4	3	7	0	0	7	0	0
12	65578987	rs10878239	A	C	3	3	6	0	1	7	0	0
12	65641985	rs2888	C	T	16	17	33	0	0	33	0	0
12	65754242	rs1370938	C	A	3	4	7	0	0	7	0	0
12	65858214	rs1142467	G	A	109	90	199	0	6	205	0	0
12	66561008	.	A	G	5	14	19	0	0	19	0	0
12	66593678	.	T	C	5	5	10	0	0	10	0	0
12	66598562	rs201243730	A	G	11	1	12	0	0	12	0	0
12	66635304	rs1152916	A	T	12	19	31	0	0	31	0	0
12	66636640	rs1865914	A	G	11	9	20	0	0	20	0	0
12	66636770	rs7298971	C	T	16	4	20	0	0	20	0	0
12	66642974	rs143962121	C	T	31	25	56	0	1	57	0	0
12	66644111	rs10506481	T	C	66	48	114	0	0	114	0	0
12	66646199	rs7972963	G	T	105	97	202	0	2	204	0	0
12	66646981	rs1058221	A	G	46	40	86	0	0	86	0	0
12	66647187	rs11176099	G	A	68	43	111	0	2	113	0	0
12	66725160	rs1185244	C	T	10	10	20	0	0	20	0	0
12	66731864	rs1168329	C	A	10	9	19	0	0	19	0	0
12	66732458	rs1168290	A	C	3	6	9	0	0	9	0	0
12	66732488	rs1168291	T	C	4	5	9	0	0	9	0	0
12	66732660	rs1168292	C	T	2	5	7	0	0	7	0	0
12	66733904	rs1168293	G	A	4	2	6	0	0	6	0	0
12	66733988	rs1168294	T	C	5	4	9	0	0	9	0	0
12	66735644	rs1168297	T	C	4	8	12	0	0	12	0	0
12	66736074	rs1168299	C	G	1	5	6	0	0	6	0	0
12	66739539	rs1168307	A	G	5	3	8	0	1	9	0	0
12	67663978	rs710623	T	G	6	6	12	0	0	12	0	0
12	67664163	rs7968645	A	C	3	4	7	0	0	7	0	0
12	67664578	rs775306	C	T	4	4	8	0	0	8	0	0
12	67664839	rs710622	A	G	2	5	7	0	1	8	0	0
12	67671523	.	A	G	9	11	20	0	1	21	0	0
12	67671666	rs1252405	G	T	18	8	26	0	0	26	0	0
12	67682551	rs775309	C	A	4	3	7	0	0	7	0	0
12	67687571	rs2248751	T	C	4	4	8	0	0	8	0	0
12	67687792	rs1658780	G	C	3	3	6	0	1	7	0	0
12	67696822	rs800166	G	A	4	4	8	0	0	8	0	0
12	67697317	rs710630	C	T	2	5	7	0	0	7	0	0
12	67697856	rs710629	G	A	7	3	10	0	0	10	0	0
12	67701103	rs812325	G	A	8	8	16	0	0	16	0	0
12	67705187	rs11176678	A	G	30	29	59	0	0	59	0	0
12	67705912	rs1252402	T	G	4	2	6	0	0	6	0	0
12	67706466	rs1060350	G	A	120	172	292	0	2	294	0	0
12	67707441	rs1137465	A	G	1	6	7	0	0	7	0	0
12	67708800	rs11176681	C	T	7	3	10	0	0	10	0	0
12	68055812	rs10467153	T	C	26	17	43	0	1	44	0	0
12	68688939	rs7958232	C	T	5	1	6	0	0	6	0	0
12	68708761	rs2306393	C	T	11	8	19	0	0	19	0	0
12	68720627	rs962976	G	A	14	3	17	0	0	17	0	0
12	68721040	rs962977	A	G	5	2	7	0	0	7	0	0
12	68724951	rs3741808	G	T	9	4	13	0	0	13	0	0
12	69094607	rs35589976	A	G	14	5	19	0	0	19	0	0
12	69108909	rs2701095	T	C	10	5	15	0	0	15	0	0
12	69127245	rs34342902	C	T	20	21	41	0	0	41	0	0
12	69159872	rs148851680	T	C	1	6	7	0	0	7	0	0
12	69161272	rs144752523	G	A	6	3	9	0	0	9	0	0
12	69202164	rs937283	A	G	37	53	90	0	1	91	0	0
12	69211339	rs1795472	G	C	4	2	6	0	0	6	0	0
12	69211660	rs3730533	C	A	1	6	7	0	0	7	0	0
12	69212831	rs1625525	T	C	3	10	13	0	0	13	0	0
12	69215525	rs1206251	A	T	6	6	12	0	0	12	0	0
12	69215726	rs3730554	C	T	7	12	19	0	0	19	0	0
12	69215795	rs12821879	T	C	9	6	15	0	0	15	0	0
12	69216521	rs3730556	T	G	6	3	9	0	0	9	0	0
12	69228043	rs1695146	G	A	7	1	8	0	0	8	0	0
12	69228488	rs1690922	G	T	3	3	6	0	0	6	0	0
12	69230297	rs3730642	T	G	0	7	7	0	0	7	0	0
12	69233634	rs710633	C	T	61	49	110	0	1	111	0	0
12	69235406	rs1690916	G	A	143	104	247	0	4	251	0	0
12	69633379	rs2305642	A	G	21	10	31	0	0	31	0	0
12	69633978	rs552950022	T	C	27	35	62	0	0	62	0	0
12	69636314	rs1350166	G	T	11	12	23	0	1	24	0	0
12	69638082	rs113097474	C	G	11	13	24	0	0	24	0	0
12	69638298	rs10878945	T	C	8	8	16	0	0	16	0	0
12	69639145	rs66543960	C	G	10	4	14	0	0	14	0	0
12	69639238	rs1026331	T	G	9	11	20	0	1	21	0	0
12	69639679	rs111532166	A	G	18	25	43	0	0	43	0	0
12	69643321	rs12368406	C	T	6	0	6	0	0	6	0	0
12	69646914	rs2305641	G	A	128	130	258	0	1	259	0	0
12	69647962	rs11177570	C	T	6	5	11	0	0	11	0	0
12	69654187	rs7300266	A	G	13	10	23	0	0	23	0	0
12	69659299	rs7308481	A	G	5	1	6	0	0	6	0	0
12	69659678	rs12305999	G	A	12	6	18	0	0	18	0	0
12	69663852	rs12184493	G	C	10	5	15	0	0	15	0	0
12	69667075	rs1463335	T	A	12	11	23	0	0	23	0	0
12	69747834	rs1384	C	T	191	118	309	0	6	315	0	0
12	69753595	rs622656	C	T	35	24	59	0	0	59	0	0
12	69773411	rs11177632	G	A	3	3	6	0	0	6	0	0
12	69773903	rs112734423	A	C	5	9	14	0	1	15	0	0
12	69774377	rs7133487	G	A	10	9	19	0	0	19	0	0
12	69774563	rs501212	A	G	12	9	21	0	0	21	0	0
12	69774618	rs7304714	T	G	15	3	18	0	0	18	0	0
12	69774877	rs1670737	G	A	7	5	12	0	0	12	0	0
12	69775103	rs2870902	T	C	11	5	16	0	0	16	0	0
12	69775772	rs12300197	C	T	9	9	18	0	0	18	0	0
12	69775972	rs56054057	C	T	9	5	14	0	0	14	0	0
12	69776083	rs10878971	C	T	6	6	12	0	1	13	0	0
12	69776183	rs2603086	A	G	12	10	22	0	0	22	0	0
12	69776299	rs2603088	A	G	11	10	21	0	1	22	0	0
12	69776461	rs4761237	C	G	21	9	30	0	0	30	0	0
12	69776800	rs2603089	A	G	11	9	20	0	0	20	0	0
12	69776886	rs4761239	T	A	5	14	19	0	0	19	0	0
12	69777188	rs2603090	G	A	4	11	15	0	0	15	0	0
12	69777615	rs10878972	G	C	10	17	27	0	1	28	0	0
12	69864170	rs221070	A	G	9	5	14	0	0	14	0	0
12	69952510	rs551565	G	A	3	5	8	0	0	8	0	0
12	69957690	rs521001	C	G	4	2	6	0	0	6	0	0
12	69969010	rs11177726	G	T	29	23	52	0	0	52	0	0
12	69970100	rs12300911	G	A	41	23	64	0	0	64	0	0
12	69972381	rs530055	G	A	23	17	40	0	0	40	0	0
12	69980028	rs485288	G	A	13	8	21	0	0	21	0	0
12	69980141	rs484319	G	C	6	14	20	0	0	20	0	0
12	69981111	rs11177732	G	A	12	15	27	0	0	27	0	0
12	69981862	rs530701	G	A	4	6	10	0	0	10	0	0
12	69982854	rs11177733	A	G	19	19	38	0	0	38	0	0
12	69986788	rs1043434	A	G	230	199	429	0	2	431	0	0
12	69990580	rs710767	G	T	6	3	9	0	0	9	0	0
12	69992448	rs4761246	G	A	7	6	13	0	0	13	0	0
12	69995273	rs7200	T	C	42	48	90	0	0	90	0	0
12	70686063	rs7968203	C	A	3	4	7	0	0	7	0	0
12	70688813	rs788375	C	T	5	5	10	0	0	10	0	0
12	70718437	rs720653	C	T	4	6	10	0	0	10	0	0
12	70718694	rs1404125	T	C	3	3	6	0	1	7	0	0
12	70720803	rs4761196	T	C	4	5	9	0	0	9	0	0
12	70728679	rs10879130	C	A	21	13	34	0	2	36	0	0
12	70736113	rs17108008	A	G	14	5	19	0	0	19	0	0
12	70737506	rs7311366	T	G	9	20	29	0	0	29	0	0
12	70740194	rs3817487	G	A	5	5	10	0	0	10	0	0
12	72007529	rs1292514	C	T	11	10	21	0	0	21	0	0
12	72009850	.	A	T	7	4	11	0	0	11	0	0
12	72011767	.	G	A	5	2	7	0	0	7	0	0
12	72012653	rs17110012	A	G	5	1	6	0	0	6	0	0
12	72013832	rs1298463	A	G	11	8	19	0	0	19	0	0
12	72015050	rs2700169	T	C	6	4	10	0	0	10	0	0
12	72015382	rs74236526	G	A	9	3	12	0	0	12	0	0
12	72018662	rs1148988	G	A	3	3	6	0	0	6	0	0
12	72035610	rs724211	A	G	6	8	14	0	0	14	0	0
12	72053031	rs12425141	G	C	8	9	17	0	1	18	0	0
12	72054970	rs7298678	C	A	7	1	8	0	0	8	0	0
12	72179691	rs11178946	T	G	90	89	179	0	12	191	0	0
12	72302333	rs12810964	G	A	9	12	21	0	0	21	0	0
12	74932159	rs590352	G	C	97	103	200	0	1	201	0	0
12	74933868	rs5002508	T	G	80	41	121	0	3	125	1	0
12	74934162	rs1389488	C	T	82	106	188	0	2	190	0	0
12	74934589	rs73190463	C	A	93	102	195	0	0	195	0	0
12	75877304	rs11611121	A	G	3	4	7	0	0	7	0	0
12	75877848	rs11180546	A	C	3	4	7	0	0	7	0	0
12	75878059	rs11180547	A	G	4	2	6	0	0	6	0	0
12	75878093	.	T	A	3	4	7	0	0	7	0	0
12	75878751	rs10879922	A	G	2	4	6	0	0	6	0	0
12	75882455	rs7299877	A	G	5	2	7	0	0	7	0	0
12	75883580	rs10879923	C	T	4	2	6	0	0	6	0	0
12	75884254	rs28932170	C	T	78	132	210	0	0	210	0	0
12	75886695	rs35619460	A	C	7	2	9	0	0	9	0	0
12	75887350	rs12827668	A	G	8	7	15	0	0	15	0	0
12	75888251	rs15513	G	A	22	17	39	0	0	39	0	0
12	75889601	rs12819511	T	C	11	5	16	0	0	16	0	0
12	75889876	rs61933361	C	T	21	10	31	0	0	31	0	0
12	75890007	rs61933362	C	T	29	15	44	0	0	44	0	0
12	75890333	rs1501634	A	G	25	17	42	0	0	42	0	0
12	75890652	rs11611609	G	A	26	18	44	0	0	44	0	0
12	75890961	.	G	A	36	51	87	0	0	87	0	0
12	75891253	rs3741496	T	C	22	47	69	0	0	69	0	0
12	75891678	rs11180552	A	G	27	16	43	0	0	43	0	0
12	75893399	rs1056904	T	G	33	43	76	0	0	76	0	0
12	75893486	rs1056900	A	G	119	182	301	0	5	306	0	0
12	75894114	rs1051446	T	C	17	16	33	0	0	33	0	0
12	75894746	rs11355	T	C	14	38	52	0	1	53	0	0
12	75896664	rs2279244	C	T	7	8	15	0	0	15	0	0
12	75898340	rs1604381	T	C	11	20	31	0	0	31	0	0
12	75899918	rs7966268	G	T	35	15	50	0	0	50	0	0
12	75900588	rs2070162	A	G	208	268	476	0	0	476	0	0
12	75904102	rs12812559	T	C	9	11	20	0	0	20	0	0
12	75904837	rs17218895	G	A	12	7	19	0	0	19	0	0
12	76766165	rs2369128	G	T	3	8	11	0	0	11	0	0
12	76797693	rs73383551	T	C	4	7	11	0	0	11	0	0
12	76866400	rs11829590	C	T	5	12	17	0	0	17	0	0
12	76882269	rs73385514	G	A	11	7	18	0	0	18	0	0
12	76884927	rs34600115	G	T	3	3	6	0	0	6	0	0
12	76885985	rs2137377	C	A	7	1	8	0	0	8	0	0
12	76887124	rs36037778	T	C	1	5	6	0	0	6	0	0
12	76889806	rs55677062	T	A	5	3	8	0	0	8	0	0
12	76897382	rs11837690	G	A	2	4	6	0	0	6	0	0
12	76902328	rs35415185	G	A	3	5	8	0	0	8	0	0
12	76903583	rs75535291	G	C	4	3	7	0	0	7	0	0
12	76904677	rs79202717	A	T	4	4	8	0	0	8	0	0
12	76904682	rs111456855	A	G	4	3	7	0	1	8	0	0
12	76906211	rs73385534	T	C	3	3	6	0	0	6	0	0
12	76911567	rs57859057	G	A	2	4	6	0	0	6	0	0
12	77216701	rs2126682	C	T	8	10	18	0	0	18	0	0
12	77217193	rs17814011	T	C	7	14	21	0	1	22	0	0
12	77220089	rs10778945	A	G	6	7	13	0	1	14	0	0
12	77220514	rs4761342	T	A	5	3	8	0	0	8	0	0
12	77222970	rs10862594	G	A	5	2	7	0	0	7	0	0
12	77245749	rs702062	A	G	19	12	31	0	1	32	0	0
12	77245750	rs702063	A	T	19	13	32	0	0	32	0	0
12	77253551	rs2071326	G	T	8	16	24	0	0	24	0	0
12	77254511	rs10735466	C	T	12	13	25	0	1	26	0	0
12	77255578	rs7300303	T	C	12	14	26	0	1	27	0	0
12	77255739	rs7135903	C	T	28	9	37	0	0	37	0	0
12	77256267	rs7312867	G	A	30	19	49	0	0	49	0	0
12	77256681	rs2047227	T	G	29	11	40	0	1	41	0	0
12	77257423	rs10219621	G	A	15	13	28	0	2	30	0	0
12	77257608	rs7308963	T	C	23	9	32	0	0	32	0	0
12	77257894	rs6539759	G	A	12	9	21	0	0	21	0	0
12	77258853	rs4761452	A	T	11	6	17	0	0	17	0	0
12	77258903	rs4761453	G	A	8	6	14	0	0	14	0	0
12	77259508	rs762786	G	A	5	2	7	0	0	7	0	0
12	77259767	rs762785	G	A	10	6	16	0	0	16	0	0
12	77260765	rs4604937	G	A	6	3	9	0	0	9	0	0
12	77260899	rs4315131	G	A	3	5	8	0	0	8	0	0
12	77261869	rs11115918	T	C	4	3	7	0	0	7	0	0
12	77261958	rs10746289	T	C	3	3	6	0	0	6	0	0
12	77261994	rs10746290	C	T	4	3	7	0	0	7	0	0
12	77265361	rs12814287	T	C	0	7	7	0	0	7	0	0
12	77265399	rs4421792	C	T	7	0	7	0	0	7	0	0
12	77265569	rs73129320	C	G	1	5	6	0	0	6	0	0
12	77270863	rs11115946	C	T	5	7	12	0	0	12	0	0
12	83081182	rs12422405	A	C	7	2	9	0	0	9	0	0
12	83528215	rs3168365	T	C	8	6	14	0	1	15	0	0
12	88432232	rs35025238	A	G	4	3	7	0	0	7	0	0
12	89745477	rs2279574	C	A	258	272	530	0	6	536	0	0
12	89913419	rs1054807	C	T	3	3	6	0	0	6	0	0
12	89914261	rs10858894	T	C	23	13	36	0	0	36	0	0
12	89916811	rs2230283	C	T	36	43	79	0	0	79	0	0
12	89918677	rs11105310	C	A	7	4	11	0	0	11	0	0
12	89919568	rs10777184	C	T	8	8	16	0	0	16	0	0
12	89989599	rs1401982	G	A	3	7	10	0	1	11	0	0
12	89993507	rs11105337	A	T	5	2	7	0	0	7	0	0
12	89995466	rs2854371	G	A	4	4	8	0	0	8	0	0
12	90013089	rs2681492	T	C	22	13	35	0	0	35	0	0
12	90031395	rs10858914	C	T	5	3	8	0	0	8	0	0
12	90060586	rs17249754	G	A	5	1	6	0	0	6	0	0
12	90062662	rs17782841	A	G	4	3	7	0	0	7	0	0
12	90067500	rs150052931	C	T	7	2	9	0	0	9	0	0
12	90103702	rs2280715	C	G	65	60	125	0	1	126	0	0
12	92484138	rs6538319	A	G	2	4	6	0	0	6	0	0
12	92522861	rs188280634	G	C	6	3	9	0	0	9	0	0
12	92534370	rs35666	G	T	8	8	16	0	0	16	0	0
12	92534795	rs79619065	T	C	21	20	41	0	0	41	0	0
12	93174109	.	C	T	8	2	10	0	0	10	0	0
12	93202801	rs7970286	C	T	5	8	13	0	0	13	0	0
12	93796425	rs12597	G	A	11	13	24	0	0	24	0	0
12	93800678	rs7968453	T	C	5	3	8	0	0	8	0	0
12	93809565	rs34318510	C	T	10	9	19	0	0	19	0	0
12	93896315	rs11542615	G	A	10	18	28	0	0	28	0	0
12	93936794	.	A	G	5	2	7	0	0	7	0	0
12	93960917	rs10859532	G	C	7	6	13	0	0	13	0	0
12	93969376	rs35402510	G	T	26	31	57	0	0	57	0	0
12	94543506	rs2230754	C	T	24	19	43	0	1	44	0	0
12	94544652	rs3847798	T	C	17	21	38	0	0	38	0	0
12	94545155	rs7312498	T	G	22	21	43	0	0	43	0	0
12	94575010	.	C	G	8	2	10	0	0	10	0	0
12	94657996	rs73228155	G	A	3	6	9	0	0	9	0	0
12	94661045	rs11107489	G	A	27	28	55	0	0	55	0	0
12	94661511	rs56725874	T	G	10	11	21	0	0	21	0	0
12	94662671	rs73228161	G	A	7	3	10	0	0	10	0	0
12	94662747	rs10507036	G	A	11	7	18	0	0	18	0	0
12	94662928	rs17022333	G	C	12	4	16	0	0	16	0	0
12	94664145	rs978949	A	G	4	3	7	0	0	7	0	0
12	94671743	rs832506	G	C	2	4	6	0	0	6	0	0
12	94683204	rs4761470	G	A	9	14	23	0	0	23	0	0
12	94683490	rs75997341	C	T	2	4	6	0	0	6	0	0
12	94701318	rs8553	C	T	6	7	13	0	0	13	0	0
12	94769769	rs74340001	G	A	10	6	16	0	0	16	0	0
12	94964157	rs1290005	T	C	15	12	27	0	0	27	0	0
12	94964365	rs11107606	T	C	14	8	22	0	0	22	0	0
12	94965058	rs1290910	G	C	11	17	28	0	0	28	0	0
12	94976159	rs3747551	T	C	14	15	29	0	1	30	0	0
12	95036497	rs12813077	A	T	4	2	6	0	0	6	0	0
12	95037021	rs12818810	A	T	7	2	9	0	0	9	0	0
12	95040371	rs7979149	T	C	6	2	8	0	0	8	0	0
12	95042839	rs7975526	C	G	13	6	19	0	0	19	0	0
12	95043123	rs2279793	T	C	44	21	65	0	0	65	0	0
12	95391097	rs10745715	G	A	4	8	12	0	0	12	0	0
12	95392154	rs7312863	C	T	5	3	8	0	0	8	0	0
12	95397275	rs17321986	G	T	5	4	9	0	0	9	0	0
12	95445222	rs75135781	G	A	3	4	7	0	0	7	0	0
12	95446288	rs933899	A	G	3	6	9	0	0	9	0	0
12	95467354	rs7397218	T	C	3	5	8	0	0	8	0	0
12	95655281	rs11107956	G	A	10	4	14	0	2	16	0	0
12	95659557	rs77535747	T	C	7	8	15	0	0	15	0	0
12	95661135	rs17023862	C	T	11	12	23	0	0	23	0	0
12	95662067	rs10859864	C	T	6	8	14	0	0	14	0	0
12	95662317	rs118006310	G	T	19	8	27	0	0	27	0	0
12	95662318	rs77252010	G	T	18	8	26	0	0	26	0	0
12	95663552	rs17023867	T	G	5	5	10	0	0	10	0	0
12	95666650	rs10859865	G	A	6	3	9	0	0	9	0	0
12	95681597	rs10507051	G	A	43	44	87	0	0	87	0	0
12	95693144	.	A	C	14	19	33	0	0	33	0	0
12	95694547	rs1046007	A	G	45	52	97	0	0	97	0	0
12	95695260	rs3185701	C	T	6	10	16	0	0	16	0	0
12	95861401	.	C	T	8	0	8	0	0	8	0	0
12	95873132	rs301013	C	A	2	4	6	0	0	6	0	0
12	95875201	rs3850023	A	C	4	2	6	0	0	6	0	0
12	95876046	rs111800988	C	A	4	4	8	0	1	9	0	0
12	95877796	rs301038	C	T	8	7	15	0	0	15	0	0
12	95891972	rs66628102	C	T	4	2	6	0	0	6	0	0
12	95892555	rs66713976	C	T	2	4	6	0	0	6	0	0
12	95895370	rs111708795	A	G	3	4	7	0	0	7	0	0
12	95896329	rs10859890	T	G	4	4	8	0	0	8	0	0
12	95897447	rs66765539	C	T	12	7	19	0	0	19	0	0
12	95908749	rs1057739	C	T	33	27	60	0	0	60	0	0
12	96256261	rs28762087	G	A	4	2	6	0	0	6	0	0
12	96256344	rs7962359	C	T	4	3	7	0	0	7	0	0
12	96258339	rs10777744	C	A	2	4	6	0	0	6	0	0
12	96259992	rs703693	T	C	70	74	144	0	0	144	0	0
12	96261568	rs6538678	A	G	3	3	6	0	0	6	0	0
12	96274219	rs11108316	G	A	3	3	6	0	0	6	0	0
12	96274690	rs2196457	A	G	4	4	8	0	0	8	0	0
12	96366698	rs1059845	G	A	8	5	13	0	0	13	0	0
12	96366769	rs1059844	T	G	13	5	18	0	0	18	0	0
12	96367900	rs2230885	G	T	13	6	19	0	0	19	0	0
12	96374614	rs7297245	C	T	15	7	22	0	0	22	0	0
12	96374672	rs6538695	T	C	7	1	8	0	0	8	0	0
12	96374683	rs6538696	C	T	7	1	8	0	0	8	0	0
12	96374750	rs2270318	G	A	4	2	6	0	0	6	0	0
12	96375682	rs10859995	T	C	4	5	9	0	0	9	0	0
12	96375785	rs17676451	G	A	2	4	6	0	0	6	0	0
12	96376333	rs73216216	G	A	4	3	7	0	0	7	0	0
12	96376763	rs56361316	C	T	5	3	8	0	1	9	0	0
12	96390358	rs7134860	C	A	18	12	30	0	0	30	0	0
12	96403199	rs2072510	G	A	5	3	8	0	0	8	0	0
12	96404275	rs2540497	T	A	0	6	6	0	0	6	0	0
12	96405077	rs2660900	T	C	4	14	18	0	0	18	0	0
12	97346924	rs1044910	G	A	27	21	48	0	1	49	0	0
12	98908812	rs11768	T	G	2	4	6	0	1	7	0	0
12	98908959	rs73136483	A	G	5	4	9	0	0	9	0	0
12	98910533	.	T	C	1	6	7	0	0	7	0	0
12	98994255	rs7138165	A	G	9	16	25	0	0	25	0	0
12	98994441	rs10745831	T	C	17	14	31	0	0	31	0	0
12	99046194	rs10082736	G	A	4	4	8	0	0	8	0	0
12	99046527	rs10777940	T	C	11	7	18	0	1	19	0	0
12	99050366	rs7315397	A	G	3	3	6	0	0	6	0	0
12	99059023	rs2372445	T	C	10	12	22	0	1	23	0	0
12	99128357	rs73142318	G	A	5	13	18	0	0	18	0	0
12	100427955	rs7137280	T	C	3	4	7	0	0	7	0	0
12	100444984	rs7296162	G	A	46	33	79	0	0	79	0	0
12	100465795	rs10778039	A	T	9	8	17	0	0	17	0	0
12	100465821	rs112070622	T	C	12	7	19	0	0	19	0	0
12	100472619	rs75346681	G	A	8	4	12	0	0	12	0	0
12	100477550	rs7305297	C	T	2	4	6	0	1	7	0	0
12	100477758	rs7305442	A	G	2	4	6	0	0	6	0	0
12	100480246	rs75920669	C	G	2	4	6	0	0	6	0	0
12	100483739	rs76557708	T	C	4	3	7	0	0	7	0	0
12	100708367	rs33968174	C	T	16	12	28	0	0	28	0	0
12	101683929	rs703715	C	T	4	3	7	0	0	7	0	0
12	101707067	rs7980431	A	G	2	5	7	0	0	7	0	0
12	101732655	rs56265469	C	T	8	2	10	0	0	10	0	0
12	101780269	rs3199856	C	T	9	7	16	0	0	16	0	0
12	101787608	rs11555441	C	T	14	9	23	0	0	23	0	0
12	101796965	rs12370450	G	A	2	5	7	0	0	7	0	0
12	101800809	rs11612569	G	A	5	1	6	0	0	6	0	0
12	102161498	rs12822705	T	G	7	2	9	0	0	9	0	0
12	102161677	rs12822003	G	A	5	2	7	0	1	8	0	0
12	102172889	rs66621546	T	C	13	14	27	0	0	27	0	0
12	102189301	rs145135629	C	T	5	1	6	0	0	6	0	0
12	102314631	rs11111084	G	A	4	2	6	0	0	6	0	0
12	102444064	rs7958593	C	T	6	7	13	0	0	13	0	0
12	102455729	rs3751129	G	A	15	13	28	0	0	28	0	0
12	102494849	rs17438178	T	C	6	5	11	0	1	12	0	0
12	102517804	rs2036771	G	A	14	7	21	0	1	22	0	0
12	102540842	rs138234608	T	A	3	3	6	0	0	6	0	0
12	104135940	rs7316328	C	G	5	4	9	0	0	9	0	0
12	104166760	rs1043469	T	G	30	36	66	0	0	66	0	0
12	104167044	rs73192028	G	A	37	36	73	0	0	73	0	0
12	104167382	rs9084	G	A	24	29	53	0	1	54	0	0
12	104167404	rs9142	A	G	20	28	48	0	0	48	0	0
12	104168087	rs10735389	A	G	14	12	26	0	0	26	0	0
12	104168263	rs55865204	C	A	18	16	34	0	0	34	0	0
12	104168355	rs56181523	G	A	13	14	27	0	0	27	0	0
12	104168876	rs73192032	G	A	14	8	22	0	1	23	0	0
12	104168982	rs6539101	T	C	20	24	44	0	0	44	0	0
12	104169828	rs11111761	T	C	14	8	22	0	0	22	0	0
12	104170351	rs11111764	G	A	11	10	21	0	0	21	0	0
12	104171271	.	C	G	19	22	41	0	0	41	0	0
12	104171503	rs73192034	C	T	6	6	12	0	1	13	0	0
12	104171742	rs17034524	C	T	19	21	40	0	2	42	0	0
12	104190523	rs12425205	G	A	11	9	20	0	1	21	0	0
12	104324182	rs2070908	C	G	15	13	28	0	0	28	0	0
12	104324266	rs17797090	G	A	209	259	468	0	5	473	0	0
12	104325111	rs1165681	T	C	10	10	20	0	0	20	0	0
12	104325649	rs2722188	T	G	24	21	45	0	1	46	0	0
12	104325871	rs1183212	T	C	31	29	60	0	0	60	0	0
12	104325924	rs1165682	T	A	28	28	56	0	0	56	0	0
12	104326991	rs1920413	A	G	4	9	13	0	0	13	0	0
12	104328548	rs1165684	T	C	13	15	28	0	0	28	0	0
12	104329196	rs73177929	C	T	10	16	26	0	1	27	0	0
12	104329541	rs3794240	C	A	16	13	29	0	0	29	0	0
12	104330382	rs1437502	G	A	4	14	18	0	0	18	0	0
12	104330515	rs10861147	T	C	5	18	23	0	0	23	0	0
12	104339014	rs2583262	C	T	23	10	33	0	0	33	0	0
12	104339610	rs2583264	T	C	16	8	24	0	0	24	0	0
12	104339978	rs1165692	G	A	24	6	30	0	0	30	0	0
12	104340080	rs10861148	C	A	27	14	41	0	0	41	0	0
12	104340204	rs1165693	G	A	27	19	46	0	0	46	0	0
12	104341015	rs1165694	T	C	3	7	10	0	0	10	0	0
12	104341103	rs7645	C	T	877	984	1861	0	4	1865	0	0
12	104341398	rs1165695	T	A	4	10	14	0	0	14	0	0
12	104345123	rs15805	A	G	4	3	7	0	0	7	0	0
12	104345253	rs11111854	A	G	9	4	13	0	0	13	0	0
12	104350851	rs703657	T	A	6	2	8	0	0	8	0	0
12	104363181	rs1882018	A	G	2	4	6	0	0	6	0	0
12	104381355	.	G	C	44	0	44	0	0	44	0	0
12	104493079	rs2629754	C	T	2	4	6	0	0	6	0	0
12	104512918	rs2466551	T	G	13	4	17	0	0	17	0	0
12	104527129	rs7310193	T	C	7	4	11	0	0	11	0	0
12	104659095	rs35651749	C	T	145	0	145	0	10	155	0	0
12	104738825	rs61937916	A	G	4	5	9	0	0	9	0	0
12	104851523	rs12299738	A	C	14	12	26	0	1	27	0	0
12	104851559	.	G	A	9	6	15	0	1	16	0	0
12	104851570	rs12320316	T	G	7	5	12	0	1	13	0	0
12	104851589	rs78440019	C	T	7	7	14	0	0	14	0	0
12	104853067	rs3751319	C	G	12	9	21	0	1	22	0	0
12	104853467	rs3751320	C	T	11	9	20	0	0	20	0	0
12	104853592	rs3751321	A	G	9	8	17	0	1	18	0	0
12	104853787	rs3751322	T	C	9	9	18	0	0	18	0	0
12	104854011	rs1922261	G	A	14	9	23	0	0	23	0	0
12	104854420	rs10778334	C	T	10	7	17	0	0	17	0	0
12	104854458	rs7307713	A	G	11	9	20	0	3	23	0	0
12	104854967	rs11112066	A	G	37	27	64	0	0	64	0	0
12	104855553	rs12320787	C	T	20	14	34	0	0	34	0	0
12	104855630	rs7976781	C	T	35	26	61	0	0	61	0	0
12	104855835	rs12322339	C	G	91	122	213	0	0	213	0	0
12	104856091	rs4964795	G	A	7	9	16	0	0	16	0	0
12	104856122	rs73382371	C	T	8	13	21	0	0	21	0	0
12	104856172	rs73382373	T	C	12	19	31	0	1	32	0	0
12	104856342	rs73382376	C	T	38	44	82	0	0	82	0	0
12	104856807	rs12309301	A	C	4	3	7	0	0	7	0	0
12	104857256	rs11112067	G	C	17	17	34	0	0	34	0	0
12	104858328	rs7953927	T	C	16	12	28	0	0	28	0	0
12	104859492	rs1343928	C	T	12	20	32	0	0	32	0	0
12	104859655	rs11112068	T	G	14	9	23	0	1	24	0	0
12	104861494	rs4964797	G	T	30	34	64	0	0	64	0	0
12	104862816	rs7137559	C	T	1	5	6	0	0	6	0	0
12	104864883	rs6419387	G	A	4	3	7	0	0	7	0	0
12	104874300	rs7953577	G	C	19	29	48	0	0	48	0	0
12	104875438	rs3902812	G	T	11	6	17	0	0	18	1	0
12	104875480	rs3902813	C	T	8	7	15	0	1	16	0	0
12	104875993	rs7961056	C	T	10	12	22	0	0	22	0	0
12	104876215	rs12313521	C	T	13	10	23	0	0	23	0	0
12	104876567	rs7976717	T	G	13	16	29	0	0	29	0	0
12	104877607	rs11112077	G	A	14	23	37	0	0	37	0	0
12	104879273	rs2103391	A	G	18	17	35	0	1	36	0	0
12	104879777	rs1882494	T	G	14	14	28	0	1	29	0	0
12	104880469	rs7956477	C	G	29	15	44	0	1	45	0	0
12	104881167	rs2091769	C	G	20	16	36	0	0	36	0	0
12	104881328	rs10861225	T	C	18	10	28	0	0	28	0	0
12	104881616	rs7960741	C	T	12	4	16	0	0	16	0	0
12	104882004	rs7963874	C	A	21	24	45	0	2	47	0	0
12	104882199	rs11112078	C	G	17	18	35	0	1	36	0	0
12	104882922	rs7133503	T	C	27	28	55	0	1	56	0	0
12	104883003	rs7133525	T	C	24	30	54	0	0	54	0	0
12	104883474	rs2888823	T	C	25	17	42	0	1	43	0	0
12	104883476	rs2374397	T	C	25	17	42	0	0	42	0	0
12	104883910	rs7971806	C	G	34	44	78	0	1	79	0	0
12	104884438	rs10778336	G	T	36	50	86	0	0	86	0	0
12	104885460	rs10778337	T	C	33	22	55	0	1	56	0	0
12	104885863	rs6539155	C	T	35	30	65	0	0	65	0	0
12	104886384	rs17035655	G	A	17	31	48	0	1	49	0	0
12	104888056	rs1882493	C	G	70	64	134	0	1	135	0	0
12	104888494	rs1882492	G	A	62	44	106	0	0	106	0	0
12	104889033	rs28629798	G	A	70	70	140	0	1	141	0	0
12	104889991	rs59632603	T	G	92	61	153	0	1	154	0	0
12	104894707	rs2141855	G	A	0	6	6	0	0	6	0	0
12	104897227	rs11112083	C	T	2	4	6	0	0	6	0	0
12	104897650	rs75200019	G	A	5	1	6	0	0	6	0	0
12	104912634	rs1704909	G	C	7	5	12	0	0	12	0	0
12	104912786	rs1624481	G	A	13	2	15	0	1	16	0	0
12	104937731	rs1625417	C	T	23	6	29	0	0	29	0	0
12	104938727	rs1795867	T	C	7	3	10	0	1	11	0	0
12	104956551	rs10861232	C	A	3	3	6	0	0	6	0	0
12	104963476	rs1533085	A	T	1	5	6	0	0	6	0	0
12	104964366	rs143650949	T	C	4	8	12	0	0	12	0	0
12	104965188	rs10861234	G	A	3	6	9	0	0	9	0	0
12	104965584	rs313315	C	A	4	5	9	0	1	10	0	0
12	104966151	rs192859	G	T	3	3	6	0	0	6	0	0
12	104967025	rs1097134	A	G	6	8	14	0	0	14	0	0
12	104967218	rs9705782	C	T	2	9	11	0	0	11	0	0
12	104968196	rs10861238	A	G	3	18	21	0	0	21	0	0
12	104968808	rs865606	G	A	6	4	10	0	0	10	0	0
12	104968885	rs10746003	T	C	8	5	13	0	0	13	0	0
12	105037956	rs2559643	G	T	4	2	6	0	0	6	0	0
12	105089782	rs312143	A	G	4	3	7	0	0	7	0	0
12	105510335	rs1196800	A	G	9	0	9	0	0	9	0	0
12	105513465	rs1196798	A	G	5	7	12	0	0	12	0	0
12	105514480	rs1196837	A	G	4	5	9	0	0	9	0	0
12	105516783	rs1196833	T	A	1	7	8	0	0	8	0	0
12	105518196	rs1196830	A	G	4	2	6	0	0	6	0	0
12	105530153	rs1196812	T	A	1	5	6	0	0	6	0	0
12	105530370	rs1196811	A	T	2	5	7	0	0	7	0	0
12	105535335	rs1196807	T	C	7	10	17	0	0	17	0	0
12	105536006	rs1196806	A	G	5	1	6	0	1	7	0	0
12	105537785	rs1196805	C	A	6	1	7	0	0	7	0	0
12	105541931	rs2464173	A	G	60	51	111	0	0	111	0	0
12	105546172	rs1663564	G	A	34	27	61	0	0	61	0	0
12	105561664	rs1196873	C	T	4	2	6	0	1	7	0	0
12	105562038	rs1196872	T	C	42	38	80	0	1	81	0	0
12	105567572	rs10071	A	G	34	22	56	0	1	57	0	0
12	105567611	rs9143	A	G	23	15	38	0	0	38	0	0
12	105568122	rs935241	G	A	78	45	123	0	1	124	0	0
12	105568176	rs935240	G	A	57	39	96	0	0	96	0	0
12	105571547	rs1196864	A	G	3	3	6	0	0	6	0	0
12	105572370	rs1196862	C	T	10	0	10	0	0	10	0	0
12	105572429	rs1196861	A	C	8	1	9	0	0	9	0	0
12	105576344	rs1196858	T	C	5	1	6	0	0	6	0	0
12	105576543	rs1196857	G	A	5	3	8	0	0	8	0	0
12	105579848	rs1196853	A	T	4	2	6	0	0	6	0	0
12	105629865	rs1196785	C	G	4	2	6	0	0	6	0	0
12	105764984	rs6797	T	G	5	3	8	0	0	8	0	0
12	105765097	rs1061749	T	C	15	19	34	0	0	34	0	0
12	106633569	rs3088113	C	T	3	12	15	0	0	15	0	0
12	106710175	rs2264757	A	G	2	4	6	0	0	6	0	0
12	106710320	rs117800101	T	G	0	6	6	0	0	6	0	0
12	106723190	rs11112940	A	G	4	2	6	0	0	6	0	0
12	106903321	rs13561	T	C	2	4	6	0	0	6	0	0
12	106903674	rs2288266	A	G	6	2	8	0	0	8	0	0
12	107360246	rs4964511	T	C	6	1	7	0	0	7	0	0
12	107364483	rs12309494	G	A	29	6	35	0	0	35	0	0
12	107364873	rs10778520	C	T	7	10	17	0	0	17	0	0
12	107367224	rs1053050	T	C	2	6	8	0	0	8	0	0
12	107367225	rs1053051	T	C	2	6	8	0	0	8	0	0
12	107367439	rs3204848	A	G	21	24	45	0	0	45	0	0
12	107369860	rs12310458	G	A	2	4	6	0	0	6	0	0
12	107372277	rs1043156	C	T	11	7	18	0	0	18	0	0
12	107385610	rs1056560	C	A	6	6	12	0	0	12	0	0
12	107395106	rs8192440	A	G	25	33	58	0	0	58	0	0
12	107396797	rs10778522	G	A	3	3	6	0	0	6	0	0
12	107486912	rs3809237	C	T	15	27	42	0	1	43	0	0
12	107487069	rs3809235	C	T	12	15	27	0	0	27	0	0
12	107712880	rs10082935	C	T	17	19	36	0	0	36	0	0
12	107937768	rs1558781	G	A	13	26	39	0	2	41	0	0
12	107944798	rs7963272	A	T	3	7	10	0	0	10	0	0
12	108035903	rs9919712	T	C	29	15	44	0	0	44	0	0
12	108043350	rs61939998	G	A	3	4	7	0	0	7	0	0
12	108051406	rs12303478	G	A	41	29	70	0	0	70	0	0
12	108052816	rs11113424	T	G	69	35	104	0	0	104	0	0
12	108053219	rs11893	G	T	82	46	128	0	2	130	0	0
12	108094018	rs10861767	G	T	4	4	8	0	0	8	0	0
12	108098039	rs7980305	T	C	5	2	7	0	0	7	0	0
12	108126854	rs1045749	T	C	31	48	79	0	1	80	0	0
12	108127273	rs1045741	C	G	41	53	94	0	0	94	0	0
12	108127778	rs1045739	C	T	38	34	72	0	0	72	0	0
12	108127965	rs17306603	A	G	23	18	41	0	0	41	0	0
12	108143445	rs56332415	G	A	4	2	6	0	0	6	0	0
12	108144740	rs1468880	G	A	6	4	10	0	0	10	0	0
12	108145022	rs1468881	T	C	4	4	8	0	0	8	0	0
12	108149611	rs10861776	C	G	5	3	8	0	0	8	0	0
12	108154752	rs11113465	G	A	5	7	12	0	0	12	0	0
12	108956433	rs2287555	C	T	67	56	123	0	1	124	0	0
12	108962804	rs10187	C	T	234	201	435	0	2	437	0	0
12	109017898	rs2228315	C	T	23	24	47	0	0	47	0	0
12	109039794	rs2111212	A	C	118	102	220	0	0	220	0	0
12	109039869	rs2111211	T	C	75	72	147	0	0	147	0	0
12	109048742	rs117301595	A	G	1	7	8	0	0	8	0	0
12	109049215	rs150363868	G	A	6	2	8	0	0	8	0	0
12	109049366	rs7310556	G	C	11	8	19	0	0	19	0	0
12	109049471	rs146021826	G	A	5	8	13	0	0	13	0	0
12	109049497	rs56092188	G	A	3	8	11	0	0	11	0	0
12	109115688	rs10778655	T	C	4	2	6	0	0	6	0	0
12	109115755	rs77866012	G	A	4	4	8	0	0	8	0	0
12	109117378	rs12582815	C	A	5	3	8	0	0	8	0	0
12	109117989	rs12423733	C	T	5	1	6	0	0	6	0	0
12	109177540	rs73193451	T	A	57	46	103	0	0	103	0	0
12	109178003	rs3741781	C	A	35	65	100	0	1	101	0	0
12	109178973	rs2003242	T	G	37	42	79	0	0	79	0	0
12	109180115	rs78866567	G	T	34	31	65	0	0	65	0	0
12	109182049	rs3741778	T	C	24	25	49	0	1	50	0	0
12	109205468	rs7314329	A	G	2	4	6	0	0	6	0	0
12	109525439	rs1059257	G	A	42	36	78	0	0	78	0	0
12	109525735	rs1059262	T	G	3	7	10	0	0	10	0	0
12	109639465	.	G	A	6	2	8	0	0	8	0	0
12	109704177	rs2075262	G	A	21	8	29	0	0	29	0	0
12	109887436	rs143893351	C	T	18	15	33	0	0	33	0	0
12	109887525	rs73194266	C	T	12	11	23	0	0	23	0	0
12	109888482	rs73194269	A	G	49	23	72	0	0	72	0	0
12	109888700	rs11540748	A	G	49	60	109	0	0	109	0	0
12	109888886	rs11540749	C	T	49	49	98	0	1	99	0	0
12	109890510	rs4766602	T	C	4	9	13	0	0	13	0	0
12	109891238	rs117836348	A	G	3	4	7	0	0	7	0	0
12	109896165	rs7313797	T	C	5	3	8	0	0	8	0	0
12	109973292	rs73196297	G	T	18	8	26	0	0	26	0	0
12	110289501	rs7304559	T	G	39	26	65	0	0	65	0	0
12	110290073	rs1055794	G	A	49	26	75	0	1	76	0	0
12	110341933	rs10774978	A	G	7	4	11	0	0	11	0	0
12	110352299	.	G	A	13	4	17	0	0	17	0	0
12	110352361	rs16940680	G	A	3	13	16	0	0	16	0	0
12	110354523	rs79886630	C	G	9	9	18	0	0	18	0	0
12	110368201	rs2292354	G	A	37	19	56	0	1	57	0	0
12	110368804	rs77766064	C	A	35	22	57	0	0	57	0	0
12	110369872	rs3742010	G	A	23	15	38	0	1	39	0	0
12	110370141	rs7314498	C	T	20	8	28	0	0	28	0	0
12	110378517	rs56089557	G	T	2	4	6	0	0	6	0	0
12	110379213	rs11068984	T	C	3	3	6	0	0	6	0	0
12	110388150	rs74792875	T	C	4	9	13	0	0	13	0	0
12	110397119	rs11069060	T	C	2	8	10	0	0	10	0	0
12	110399856	rs11069066	A	T	24	27	51	0	2	53	0	0
12	110400961	rs61391330	C	T	16	22	38	0	0	38	0	0
12	110402892	rs3922879	T	G	16	33	49	0	0	49	0	0
12	110403264	rs10851035	C	G	11	22	33	0	0	33	0	0
12	110404464	rs76103803	A	C	13	5	18	0	0	18	0	0
12	110406290	rs112724392	G	A	4	2	6	0	0	6	0	0
12	110406386	rs9634314	G	A	3	3	6	0	0	6	0	0
12	110406660	rs9634317	A	G	5	1	6	0	0	6	0	0
12	110407996	rs73419581	T	C	5	9	14	0	0	14	0	0
12	110408009	rs6606744	A	C	5	9	14	0	0	14	0	0
12	110413252	rs11069139	G	C	5	6	11	0	0	11	0	0
12	110414576	rs111233513	T	C	5	5	10	0	0	10	0	0
12	110418724	rs80000006	G	C	5	5	10	0	0	10	0	0
12	110439635	rs74725620	T	G	6	2	8	0	0	8	0	0
12	110448256	rs6606680	A	G	0	6	6	0	0	6	0	0
12	110450687	rs7976412	C	G	6	3	9	0	0	9	0	0
12	110456175	rs2302689	A	G	117	106	223	0	2	225	0	0
12	110476595	rs1044994	T	A	133	118	251	0	3	254	0	0
12	110481546	rs1974706	A	G	5	1	6	0	0	6	0	0
12	110481882	rs11064833	C	A	3	5	8	0	0	8	0	0
12	110486272	rs7137233	T	C	11	9	20	0	0	20	0	0
12	110566907	rs34684319	A	G	4	4	8	0	0	8	0	0
12	110783261	rs148478211	G	T	82	79	161	0	1	162	0	0
12	110814018	.	C	G	46	74	120	0	1	122	1	0
12	110874502	rs28615662	T	A	3	9	12	0	0	12	0	0
12	110874516	.	T	C	7	3	10	0	1	11	0	0
12	110971143	rs185551447	A	G	128	165	293	0	0	293	0	0
12	111082836	rs118096349	G	T	16	10	26	0	0	26	0	0
12	111800258	rs3809272	G	A	8	3	11	0	0	11	0	0
12	111865049	rs7310615	C	G	4	5	9	0	0	9	0	0
12	111884608	rs3184504	T	C	133	150	283	0	6	289	0	0
12	112318442	rs138020572	C	T	6	3	9	0	0	9	0	0
12	112319786	rs139340467	G	A	4	2	6	0	0	6	0	0
12	113348870	rs1131454	G	A	4	6	10	0	0	10	0	0
12	113357442	rs2660	G	A	9	0	9	0	0	9	0	0
12	113376320	rs3815178	C	T	3	4	7	0	0	7	0	0
12	113376331	rs1859331	C	A	3	5	8	0	0	8	0	0
12	113376388	rs1859330	G	A	5	3	8	0	0	8	0	0
12	113376452	rs1859329	C	T	5	2	7	0	0	7	0	0
12	113380008	rs10735079	G	A	4	7	11	0	0	11	0	0
12	113386779	rs2285933	C	G	7	3	10	0	0	10	0	0
12	113386950	rs2285932	T	C	3	6	9	0	0	9	0	0
12	113403684	rs2240188	C	T	7	3	10	0	0	10	0	0
12	113408208	rs2010604	G	C	8	4	12	0	0	12	0	0
12	113408874	rs739903	A	G	11	5	16	0	0	16	0	0
12	113409413	rs4767045	C	T	14	7	21	0	0	21	0	0
12	113409981	rs7138267	C	T	13	6	19	0	0	19	0	0
12	113410316	rs10744791	G	A	9	9	18	0	0	18	0	0
12	113410975	rs7023	C	A	16	8	24	0	0	24	0	0
12	113424893	rs2072138	C	G	8	6	14	0	1	15	0	0
12	113425154	rs1293767	C	G	5	4	9	0	0	9	0	0
12	113425493	rs1293765	T	C	11	2	13	0	0	13	0	0
12	113425537	rs12425514	G	A	6	2	8	0	0	8	0	0
12	113425679	rs1293764	T	C	5	4	9	0	0	9	0	0
12	113447572	rs1293743	C	T	4	2	6	0	0	6	0	0
12	113448288	rs15895	A	G	7	5	12	0	0	12	0	0
12	113448652	rs13311	C	A	6	6	12	0	0	12	0	0
12	113449116	rs1058480	G	C	2	7	9	0	0	9	0	0
12	113602765	rs4767063	A	C	11	9	20	0	0	20	0	0
12	113629949	rs1043845	C	T	12	5	17	0	0	17	0	0
12	113736116	rs8202	C	T	42	53	95	0	1	96	0	0
12	114254995	rs1043810	T	C	17	13	30	0	0	30	0	0
12	114255320	rs7312601	C	T	9	7	16	0	0	16	0	0
12	114255756	rs7312304	G	A	11	12	23	0	0	23	0	0
12	114256137	rs7970186	T	C	10	10	20	0	0	20	0	0
12	114256513	rs11066769	G	A	5	12	17	0	0	17	0	0
12	114256942	rs11066770	A	G	5	5	10	0	0	10	0	0
12	114256994	rs11066771	A	G	7	3	10	0	0	10	0	0
12	114257275	rs11066772	C	A	12	5	17	0	0	17	0	0
12	114257434	rs16943276	C	T	8	2	10	0	0	10	0	0
12	114258394	rs7314142	T	G	8	3	11	0	0	11	0	0
12	114258763	rs35763329	C	G	11	4	15	0	0	15	0	0
12	114260163	rs60891385	A	G	17	17	34	0	0	34	0	0
12	114261053	rs11066773	G	A	28	17	45	0	1	46	0	0
12	114374887	rs2290787	T	C	17	33	50	0	0	50	0	0
12	114377263	rs16943428	C	T	1	6	7	0	0	7	0	0
12	114377272	rs79443555	C	T	1	6	7	0	0	7	0	0
12	114377835	rs2290788	A	G	18	25	43	0	0	43	0	0
12	114377877	rs2290789	T	C	18	26	44	0	1	45	0	0
12	114377885	rs2290790	G	C	29	18	47	0	0	47	0	0
12	114383651	rs12321179	C	T	18	35	53	0	0	53	0	0
12	114384505	rs2290795	C	T	4	2	6	0	0	6	0	0
12	114384952	rs3782460	C	T	4	2	6	0	0	6	0	0
12	114385062	.	T	G	2	5	7	0	0	7	0	0
12	114385066	rs12296525	C	G	3	5	8	0	0	8	0	0
12	114385768	rs10850251	C	G	1	5	6	0	0	6	0	0
12	114386572	rs7980086	C	T	4	4	8	0	0	8	0	0
12	114386639	rs7966348	A	G	27	35	62	0	0	62	0	0
12	114395651	rs10850256	T	C	30	21	51	0	1	52	0	0
12	114397160	rs151212724	C	T	23	15	38	0	1	39	0	0
12	116398626	rs66898998	A	C	287	301	588	0	4	593	1	0
12	116424665	rs2241768	A	G	3	5	8	0	0	8	0	0
12	116441072	.	A	G	8	14	22	0	0	22	0	0
12	116444807	rs7132048	C	T	12	8	20	0	0	20	0	0
12	116689210	rs147928270	C	T	7	4	11	0	0	11	0	0
12	116691789	.	C	T	3	5	8	0	0	8	0	0
12	116956620	rs2733636	A	G	4	4	8	0	0	8	0	0
12	117135803	.	C	G	128	71	199	0	1	200	0	0
12	117582617	rs1060233	G	T	12	12	24	0	0	24	0	0
12	118473054	rs9788041	T	C	33	21	54	0	2	56	0	0
12	118595249	rs114623980	C	G	58	49	107	0	0	107	0	0
12	118777166	rs146025723	C	G	4	4	8	0	0	8	0	0
12	120119183	rs4213	T	G	34	38	72	0	0	72	0	0
12	120544824	rs12315041	G	A	4	3	7	0	0	7	0	0
12	120565188	rs2422	G	A	83	75	158	0	1	159	0	0
12	120589160	rs2286046	A	G	40	41	81	0	3	84	0	0
12	120591251	rs10735071	C	T	4	2	6	0	0	6	0	0
12	120606163	rs6490286	T	C	5	12	17	0	0	17	0	0
12	120649970	rs3742039	C	T	146	135	281	0	2	283	0	0
12	120661977	rs4767884	T	C	88	98	186	0	1	187	0	0
12	120762815	.	T	C	4	3	7	0	0	7	0	0
12	120877113	rs2294287	G	T	15	13	28	0	0	28	0	0
12	120933977	rs580016	T	C	44	39	83	0	2	85	0	0
12	120960057	rs503335	C	T	5	14	19	0	0	19	0	0
12	120998728	rs79207443	T	C	5	5	10	0	0	10	0	0
12	121013067	.	T	C	25	17	42	0	0	42	0	0
12	121126438	rs3829290	T	C	7	6	13	0	0	13	0	0
12	121127347	rs10431384	A	G	7	3	10	0	0	10	0	0
12	121128633	rs1814851	C	G	3	10	13	0	0	13	0	0
12	121128699	rs2005455	A	G	1	15	16	0	0	16	0	0
12	121128882	rs10431385	T	C	6	6	12	0	0	12	0	0
12	121128926	rs10431386	C	T	7	3	10	0	0	10	0	0
12	121130046	rs7306541	A	G	4	9	13	0	0	13	0	0
12	121131891	rs2393749	C	T	8	6	14	0	0	14	0	0
12	121135467	rs7976497	T	C	27	32	59	0	2	61	0	0
12	121149064	rs998727	T	G	15	14	29	0	0	29	0	0
12	121149475	rs17847	A	G	8	3	11	0	0	11	0	0
12	121156290	rs35360964	T	C	5	2	7	0	0	7	0	0
12	121156496	rs34030695	G	A	4	5	9	0	0	9	0	0
12	121157535	rs56179458	G	A	8	3	11	0	0	11	0	0
12	121157536	rs55730005	C	A	8	3	11	0	0	11	0	0
12	121157851	rs3752531	A	G	86	62	148	0	0	148	0	0
12	121159380	rs696337	T	C	99	72	171	0	1	172	0	0
12	121160615	rs2066938	A	G	101	96	197	0	3	200	0	0
12	121166163	rs61239175	C	T	6	3	9	0	0	9	0	0
12	121168083	rs3794215	T	C	5	2	7	0	0	7	0	0
12	121168245	rs3794214	T	C	5	4	9	0	0	9	0	0
12	121169436	rs696339	A	T	7	1	8	0	0	8	0	0
12	121171803	rs558314	C	G	5	3	8	0	0	8	0	0
12	121171891	rs34673751	G	A	5	5	10	0	1	11	0	0
12	121174899	rs3914	T	C	59	63	122	0	0	122	0	0
12	121175524	rs2014355	T	C	3	13	16	0	0	16	0	0
12	121175984	rs555404	T	C	8	8	16	0	0	16	0	0
12	121176083	rs1799958	G	A	55	59	114	0	1	115	0	0
12	121176679	rs3915	C	T	58	60	118	0	2	120	0	0
12	121177272	rs3916	G	C	46	57	103	0	1	104	0	0
12	121177778	rs9204	A	G	32	30	62	0	0	62	0	0
12	121200609	rs618482	C	T	21	28	49	0	2	51	0	0
12	121201167	rs13746	C	T	65	38	103	0	0	103	0	0
12	121202664	rs9431	A	C	210	215	425	0	1	426	0	0
12	121207147	rs12579868	C	T	7	12	19	0	2	21	0	0
12	121208114	.	G	A	5	6	11	0	0	11	0	0
12	121209302	rs10849786	A	G	3	3	6	0	0	6	0	0
12	121210139	rs10849787	A	G	5	6	11	0	0	11	0	0
12	121210220	rs1467283	G	C	6	8	14	0	0	14	0	0
12	121211841	rs10849788	G	A	7	3	10	0	0	10	0	0
12	121211914	rs10437838	A	T	5	5	10	0	0	10	0	0
12	121216000	.	A	G	3	4	7	0	0	7	0	0
12	121222556	rs3213567	T	C	4	3	7	0	0	7	0	0
12	121222578	rs3213566	T	C	6	3	9	0	0	9	0	0
12	121229958	rs11833706	T	C	2	9	11	0	0	11	0	0
12	121230034	rs73229114	C	G	1	8	9	0	0	9	0	0
12	121301732	rs73413868	T	C	10	5	15	0	0	15	0	0
12	121338231	rs56161401	G	T	20	6	26	0	0	26	0	0
12	121441440	rs2178464	T	C	13	23	36	0	0	36	0	0
12	121622304	rs3751143	A	C	1	6	7	0	0	7	0	0
12	121647948	.	T	C	13	4	17	0	0	17	0	0
12	121648290	rs2567994	A	G	5	3	8	0	0	8	0	0
12	121648586	rs59304889	A	C	6	8	14	0	0	14	0	0
12	121648870	rs2686387	C	G	5	5	10	0	0	10	0	0
12	121651373	rs10849855	C	T	2	4	6	0	0	6	0	0
12	121651820	rs6489799	G	A	7	2	9	0	0	9	0	0
12	121652277	rs930187	G	A	7	6	13	0	0	13	0	0
12	121652473	rs10849856	A	T	7	6	13	0	0	13	0	0
12	121652541	rs10774588	G	A	10	7	17	0	1	18	0	0
12	121654011	rs1169727	A	G	8	9	17	0	0	17	0	0
12	121658895	rs2686388	C	T	30	31	61	0	0	61	0	0
12	121659999	rs1629287	G	A	13	11	24	0	0	24	0	0
12	121660260	rs3794213	A	G	9	1	10	0	0	10	0	0
12	121660261	rs3794212	A	G	9	1	10	0	0	10	0	0
12	121660272	rs3794211	A	C	5	1	6	0	1	7	0	0
12	121660277	rs3794210	A	G	8	1	9	0	0	9	0	0
12	121660302	rs3794209	A	C	10	1	11	0	0	11	0	0
12	121660787	rs25643	T	C	93	97	190	0	0	190	0	0
12	121661365	rs58232824	C	G	8	4	12	0	0	12	0	0
12	121661516	rs61216528	G	A	9	8	17	0	0	17	0	0
12	121661700	rs10849858	A	G	7	1	8	0	0	8	0	0
12	121665011	rs2942063	A	G	6	2	8	0	0	8	0	0
12	121665334	rs2668235	C	T	5	8	13	0	0	13	0	0
12	121665720	rs2393850	G	C	5	4	9	0	1	10	0	0
12	121665898	rs2393849	A	G	7	4	11	0	0	11	0	0
12	121666476	rs3815989	C	T	9	26	35	0	0	35	0	0
12	121666646	rs25644	A	G	114	120	234	0	2	236	0	0
12	121667427	rs10849859	C	T	9	25	34	0	0	34	0	0
12	121667524	rs115880722	G	T	11	31	42	0	0	42	0	0
12	121667651	rs1151880	T	C	11	42	53	0	0	53	0	0
12	121668013	rs12298365	T	C	4	7	11	0	0	11	0	0
12	121668474	rs2668252	A	C	14	27	41	0	0	41	0	0
12	121668684	rs1169717	C	T	6	18	24	0	0	24	0	0
12	121669145	rs1180051	A	G	16	25	41	0	0	41	0	0
12	121669182	rs4980998	C	T	14	26	40	0	0	40	0	0
12	121669611	rs1169718	A	G	27	25	52	0	0	52	0	0
12	121670064	rs2071271	C	T	21	54	75	0	0	75	0	0
12	121685394	rs7975910	G	A	3	4	7	0	0	7	0	0
12	121687412	rs2288692	T	C	5	1	6	0	0	6	0	0
12	121691096	rs1132780	G	A	92	61	153	0	18	171	0	0
12	121860896	.	A	T	3	3	6	0	0	6	0	0
12	122028691	rs4981001	T	C	2	6	8	0	0	8	0	0
12	122066988	rs6486787	G	C	24	12	36	0	0	36	0	0
12	122067972	rs6486789	T	C	5	1	6	0	0	6	0	0
12	122079189	rs3741595	C	T	208	155	363	0	5	368	0	0
12	122079441	rs3825175	T	C	407	251	658	0	5	663	0	0
12	122186268	rs28651018	C	T	20	33	53	0	0	53	0	0
12	122186317	rs28655666	G	A	18	31	49	0	0	49	0	0
12	122233495	rs712852	G	C	118	88	206	0	1	207	0	0
12	122234574	rs1060104	C	G	13	14	27	0	0	27	0	0
12	122234676	rs1168664	G	A	13	15	28	0	0	28	0	0
12	122234813	rs1168665	A	G	12	14	26	0	0	26	0	0
12	122237115	rs895951	A	G	11	13	24	0	0	24	0	0
12	122238300	rs1795966	G	A	2	5	7	0	1	8	0	0
12	122238380	rs1667578	T	G	4	4	8	0	0	8	0	0
12	122239074	rs1667579	C	A	5	5	10	0	0	10	0	0
12	122239608	rs1795965	A	G	5	2	7	0	0	7	0	0
12	122243905	rs1168666	C	T	77	44	121	0	0	121	0	0
12	122248582	rs895952	C	G	93	67	160	0	0	160	0	0
12	122261456	rs3741593	G	A	95	58	153	0	1	154	0	0
12	122263815	rs2122266	C	G	7	9	16	0	0	16	0	0
12	122264647	rs7138525	C	T	6	3	9	0	0	9	0	0
12	122265106	rs2242259	T	C	5	4	9	0	0	9	0	0
12	122265163	rs2242260	A	G	4	3	7	0	0	7	0	0
12	122268696	rs11043207	C	G	82	122	204	0	0	204	0	0
12	122269182	rs11614326	G	A	123	63	186	0	8	194	0	0
12	122353796	rs14259	A	G	204	149	353	0	2	355	0	0
12	122354848	rs876934	C	T	29	16	45	0	0	45	0	0
12	122458245	rs10840640	T	C	3	3	6	0	0	6	0	0
12	122462486	rs1169091	C	T	4	3	7	0	0	7	0	0
12	122462877	rs1523261	C	A	4	3	7	0	0	7	0	0
12	122468756	rs59397548	A	G	4	2	6	0	0	6	0	0
12	122474000	rs11043294	G	A	5	4	9	0	0	9	0	0
12	122482004	rs145838970	C	T	5	1	6	0	0	6	0	0
12	122523850	rs143116451	C	A	5	4	9	0	0	9	0	0
12	122614060	rs7487608	G	T	10	13	23	0	0	23	0	0
12	122614387	rs7487292	T	G	35	65	100	0	0	102	2	0
12	122620725	rs148985509	A	T	13	15	28	0	0	29	1	0
12	122692820	rs12870	T	C	111	143	254	0	1	255	0	0
12	122693700	rs7298397	A	G	18	9	27	0	0	27	0	0
12	122693898	.	C	T	8	9	17	0	3	20	0	0
12	122701674	rs60995900	T	A	5	4	9	0	0	9	0	0
12	122703014	rs7963565	C	T	3	5	8	0	0	8	0	0
12	122704029	rs11836373	T	C	12	4	16	0	0	16	0	0
12	122704407	rs11061609	T	C	4	2	6	0	0	6	0	0
12	122756342	rs10270	G	A	23	30	53	0	0	53	0	0
12	122756438	rs80213338	A	G	36	59	95	0	2	97	0	0
12	122761710	rs7311354	G	T	5	6	11	0	0	11	0	0
12	122812503	rs1129167	G	C	64	32	96	0	0	96	0	0
12	122852292	rs9788228	G	A	8	6	14	0	0	14	0	0
12	122853197	rs4758695	G	A	5	3	8	0	1	9	0	0
12	122853860	rs4758694	C	T	6	2	8	0	0	8	0	0
12	122854788	rs10846714	T	G	3	3	6	0	0	6	0	0
12	122856158	rs12818177	G	A	5	4	9	0	0	9	0	0
12	122856249	rs4758661	T	C	6	4	10	0	0	10	0	0
12	122959902	rs10846968	T	C	6	4	10	0	0	10	0	0
12	122960886	rs61956097	G	A	4	3	7	0	0	7	0	0
12	122963011	rs6416295	T	C	10	3	13	0	0	13	0	0
12	122963180	rs6489014	A	G	18	28	46	0	0	46	0	0
12	122968450	rs12817342	T	C	20	6	26	0	0	26	0	0
12	122969042	rs11058362	T	C	8	1	9	0	0	9	0	0
12	122969716	rs10846993	C	T	6	5	11	0	0	11	0	0
12	122972252	rs4758657	G	C	3	3	6	0	0	6	0	0
12	122973666	rs4758658	C	T	10	8	18	0	0	18	0	0
12	122990369	rs2133557	C	A	31	11	42	0	0	42	0	0
12	122990671	rs61956119	G	A	26	34	60	0	1	61	0	0
12	122991201	.	G	C	41	29	70	0	1	71	0	0
12	122991279	rs11058480	C	T	40	30	70	0	0	70	0	0
12	122993011	rs10773230	C	T	1	7	8	0	0	8	0	0
12	122993879	rs7298839	C	T	12	109	121	0	0	121	0	0
12	122993932	rs11610303	G	T	10	100	110	0	0	110	0	0
12	122994609	rs7967928	C	T	8	10	18	0	0	18	0	0
12	122995047	rs7136564	G	C	3	8	11	0	0	11	0	0
12	122995372	rs6489051	C	T	5	13	18	0	1	19	0	0
12	122996221	rs1532578	C	G	6	2	8	0	0	8	0	0
12	122996613	rs10847090	G	A	33	25	58	0	0	58	0	0
12	122998817	rs71444559	G	T	37	22	59	0	3	62	0	0
12	122998903	rs186317606	A	G	30	13	43	0	1	44	0	0
12	122999080	rs7297866	C	T	29	27	56	0	0	56	0	0
12	122999535	rs6489056	C	T	7	6	13	0	0	13	0	0
12	122999891	rs61956121	T	C	9	14	23	0	0	23	0	0
12	123000055	rs61453559	T	C	14	10	24	0	1	25	0	0
12	123001193	rs1599749	A	T	9	7	16	0	0	16	0	0
12	123001737	rs1599748	G	A	7	11	18	0	0	18	0	0
12	123004306	rs7134381	C	T	70	64	134	0	3	137	0	0
12	123105143	rs2270775	C	T	22	25	47	0	0	48	1	0
12	123186381	rs492699	T	C	146	93	239	0	1	241	1	0
12	123186458	rs582856	T	C	187	135	322	0	1	323	0	0
12	123186539	rs582452	A	G	181	130	311	0	1	312	0	0
12	123186596	.	C	A	135	24	159	0	0	159	0	0
12	123186610	rs579877	G	A	127	30	157	0	1	158	0	0
12	123186611	rs579876	C	G	129	30	159	0	0	159	0	0
12	123199327	rs631256	A	G	19	0	19	0	0	19	0	0
12	123199477	rs2550	T	C	105	273	378	0	3	381	0	0
12	123199745	.	T	C	193	147	340	0	2	342	0	0
12	123199755	rs493623	A	G	189	143	332	0	4	336	0	0
12	123199826	.	C	G	148	178	326	0	4	330	0	0
12	123199842	rs61955033	T	C	149	257	406	0	5	411	0	0
12	123200099	rs579194	T	C	171	614	785	0	4	789	0	0
12	123200334	.	T	C	130	151	281	0	2	283	0	0
12	123200527	.	T	C	84	10	94	0	2	96	0	0
12	123200693	rs17884481	A	G	103	335	438	0	2	440	0	0
12	123200768	rs1798192	T	G	108	512	620	0	5	625	0	0
12	123200937	rs1696352	T	G	155	561	716	0	2	718	0	0
12	123248255	rs111933537	A	C	9	4	13	0	0	13	0	0
12	123335488	rs2271049	G	A	3	3	6	0	0	6	0	0
12	123379193	rs11060623	C	T	15	9	24	0	0	24	0	0
12	123464279	rs3759115	T	C	17	19	36	0	0	36	0	0
12	123466111	rs55742290	C	T	31	29	60	0	0	60	0	0
12	123469647	rs3741530	G	T	37	21	58	0	0	58	0	0
12	123470586	rs12828755	C	T	4	4	8	0	0	8	0	0
12	123471094	rs12811109	G	A	15	15	30	0	0	30	0	0
12	123637509	rs1716184	G	C	4	4	8	0	0	8	0	0
12	123637752	rs1790109	C	G	1	7	8	0	0	8	0	0
12	123638070	rs1716185	A	T	3	12	15	0	0	15	0	0
12	123638580	rs1627724	T	A	5	6	11	0	0	11	0	0
12	123638930	rs1727315	G	A	40	37	77	0	0	77	0	0
12	123640664	rs1727314	C	A	31	24	55	0	0	55	0	0
12	123640853	rs1727313	C	G	7	2	9	0	0	9	0	0
12	123641200	rs1051434	C	T	2	4	6	0	0	6	0	0
12	123644056	rs1047158	C	A	7	1	8	0	0	8	0	0
12	123645803	rs1051431	G	A	53	40	93	0	1	94	0	0
12	123650335	rs1615350	C	T	9	11	20	0	0	20	0	0
12	123650714	rs1618679	A	G	9	7	16	0	0	16	0	0
12	123651018	rs1621194	T	C	2	6	8	0	0	8	0	0
12	123710835	rs1626703	A	C	0	6	6	0	0	6	0	0
12	123733621	rs11057209	A	G	7	6	13	0	0	13	0	0
12	123738678	rs1568427	A	G	5	3	8	0	0	8	0	0
12	123741776	rs1969354	T	C	7	0	7	0	0	7	0	0
12	123742061	rs1969355	G	A	8	10	18	0	0	18	0	0
12	123742093	rs1533703	T	G	9	9	18	0	0	18	0	0
12	123744955	rs1980251	G	A	3	5	8	0	0	8	0	0
12	123745809	rs6633	G	T	376	193	569	0	3	572	0	0
12	123782866	rs12582153	C	T	5	1	6	0	0	6	0	0
12	123787730	rs550728528	T	A	2	8	10	0	0	10	0	0
12	123791165	rs11608305	C	G	4	2	6	0	0	6	0	0
12	123791227	rs11057251	C	T	4	4	8	0	0	8	0	0
12	123799974	rs6488868	A	G	275	249	524	0	5	529	0	0
12	123806219	rs1060105	C	T	214	202	416	0	13	429	0	0
12	123808073	rs11057270	T	C	21	27	48	0	1	49	0	0
12	123809282	rs183484614	G	A	19	22	41	0	1	42	0	0
12	123810425	rs12304248	C	T	5	1	6	0	0	6	0	0
12	123810873	rs61388686	G	A	203	185	388	0	2	390	0	0
12	123812629	rs28419092	G	C	5	1	6	0	0	6	0	0
12	123825559	rs12322888	C	T	113	121	234	0	6	240	0	0
12	123829028	rs12298826	A	G	10	10	20	0	0	20	0	0
12	123829116	rs34997336	G	A	14	12	26	0	0	26	0	0
12	123891107	rs61955125	C	T	3	3	6	0	0	6	0	0
12	123892934	rs6576	G	T	150	76	226	0	1	227	0	0
12	123893020	.	A	G	47	32	79	0	11	90	0	0
12	123893830	rs16917496	C	T	26	24	50	0	0	50	0	0
12	123900136	rs1662	G	A	620	559	1179	0	8	1187	0	0
12	123901143	rs28410896	T	C	8	6	14	0	0	14	0	0
12	123901480	rs28713448	C	T	40	18	58	0	0	58	0	0
12	123902361	rs28481863	G	A	22	17	39	0	0	39	0	0
12	123903626	rs28715490	C	T	21	13	34	0	1	35	0	0
12	123905628	rs28404303	T	C	19	22	41	0	3	44	0	0
12	123906307	rs28676499	C	T	16	8	24	0	1	25	0	0
12	123907563	rs28625019	G	A	11	23	34	0	0	34	0	0
12	123908126	rs28706696	C	T	16	11	27	0	0	27	0	0
12	123908290	rs28376121	T	C	13	6	19	0	0	19	0	0
12	123908948	rs4930719	G	A	11	10	21	0	0	21	0	0
12	123909610	rs28520455	T	C	9	4	13	0	0	13	0	0
12	123911153	rs76992239	T	C	15	16	31	0	0	31	0	0
12	123913433	rs4930718	A	G	13	10	23	0	0	23	0	0
12	123913697	rs1706477	T	G	14	9	23	0	0	23	0	0
12	123916989	rs951328	A	G	5	6	11	0	0	11	0	0
12	123917593	rs28531860	A	G	11	2	13	0	0	13	0	0
12	123921264	rs28434767	G	T	10	4	14	0	1	15	0	0
12	123943673	rs7975636	C	T	8	5	13	0	0	13	0	0
12	123947750	rs7306670	G	C	1	8	9	0	0	9	0	0
12	123949011	rs35090528	G	C	0	6	6	0	0	6	0	0
12	123949588	rs6606747	C	T	7	2	9	0	1	10	0	0
12	124069614	rs11610013	T	A	19	15	34	0	0	34	0	0
12	124069667	rs786447	A	G	19	12	31	0	0	31	0	0
12	124070013	rs11057302	G	A	16	15	31	0	1	32	0	0
12	124070214	rs786448	A	G	20	12	32	0	0	32	0	0
12	124071144	rs146539578	G	T	14	12	26	0	0	26	0	0
12	124082240	rs6551	C	A	462	434	896	0	17	914	1	0
12	124090814	rs786437	G	A	5	2	7	0	0	7	0	0
12	124097766	rs11057306	A	G	30	21	51	0	0	51	0	0
12	124105296	rs118095783	G	A	32	17	49	0	1	50	0	0
12	124107015	rs7313628	G	A	7	11	18	0	0	18	0	0
12	124109988	rs1060639	G	A	6	8	14	0	0	14	0	0
12	124110122	rs1060637	A	T	3	4	7	0	0	7	0	0
12	124144395	rs1051793	A	G	16	10	26	0	0	26	0	0
12	124145697	rs4930708	T	C	6	7	13	0	0	13	0	0
12	124192415	rs12811354	G	A	10	20	30	0	0	30	0	0
12	124192728	rs7398298	C	T	15	11	26	0	0	26	0	0
12	124197099	rs1139320	C	T	9	8	17	0	1	18	0	0
12	124197280	rs66647364	A	C	2	5	7	0	0	7	0	0
12	124209332	rs1139789	T	C	64	47	111	0	0	111	0	0
12	124210782	rs1399961	T	C	58	33	91	0	1	92	0	0
12	124214510	rs7974331	T	C	15	20	35	0	0	35	0	0
12	124214526	rs7956751	C	G	14	12	26	0	0	26	0	0
12	124214671	rs7956045	G	A	10	4	14	0	0	14	0	0
12	124214694	rs7974462	T	C	10	6	16	0	0	16	0	0
12	124214894	rs7398606	A	G	32	10	42	0	0	42	0	0
12	124215004	rs7398851	A	G	15	11	26	0	0	26	0	0
12	124216283	.	C	T	5	3	8	0	1	9	0	0
12	124216852	rs2333839	T	C	5	2	7	0	0	7	0	0
12	124218026	rs7397745	T	C	8	1	9	0	0	9	0	0
12	124218044	rs7397746	T	C	9	0	9	0	0	9	0	0
12	124218102	rs7398641	C	A	10	2	12	0	0	12	0	0
12	124219121	rs10732574	A	G	1	6	7	0	0	7	0	0
12	124219910	rs2271661	T	C	1	5	6	0	1	7	0	0
12	124220055	rs2271660	T	C	2	4	6	0	0	6	0	0
12	124220522	rs2333837	C	T	0	9	9	0	0	9	0	0
12	124220543	rs2333836	C	G	0	10	10	0	0	10	0	0
12	124220879	rs2333835	T	C	2	10	12	0	0	12	0	0
12	124229429	rs7135542	T	C	55	31	86	0	0	86	0	0
12	124234040	rs2176152	T	C	4	11	15	0	0	15	0	0
12	124234253	rs10773034	A	G	7	11	18	0	0	18	0	0
12	124240645	rs12827680	A	C	5	4	9	0	0	9	0	0
12	124241506	rs17883456	C	T	30	27	57	0	0	57	0	0
12	124243707	rs10744162	T	C	31	21	52	0	0	52	0	0
12	124244272	rs10846553	C	G	35	64	99	0	0	99	0	0
12	124246004	rs2333834	G	A	24	17	41	0	0	41	0	0
12	124844432	.	G	C	2	5	7	0	0	7	0	0
12	124856618	rs7961196	A	G	70	84	154	0	0	154	0	0
12	124856660	rs3741513	T	A	64	46	110	0	2	112	0	0
12	124857033	rs7978237	C	T	75	64	139	0	10	149	0	0
12	124940108	rs1243883	A	C	5	4	9	0	0	9	0	0
12	124979833	rs872224	C	G	67	84	151	0	0	151	0	0
12	125043791	rs11057671	G	A	3	3	6	0	0	6	0	0
12	125264287	rs838886	T	G	0	7	7	0	1	8	0	0
12	125264293	rs3741521	G	A	0	7	7	0	1	8	0	0
12	125265201	rs921919	G	A	6	6	12	0	0	12	0	0
12	125284748	rs5888	A	G	54	101	155	0	0	155	0	0
12	125396488	.	T	C	1374	140	1514	0	77	1594	3	0
12	125397061	rs17840844	G	A	469	274	743	0	7	750	0	0
12	125397364	rs8963	A	G	2072	1073	3145	0	83	3230	2	0
12	125398039	rs1071862	G	C	1548	1475	3023	0	100	3146	23	0
12	125398417	rs185128713	G	A	12	43	55	0	0	55	0	0
12	125398911	rs112043091	C	T	9	49	58	0	0	58	0	0
12	125399133	rs41276688	C	T	1674	1111	2785	0	8	2793	0	0
12	125399167	rs13624	T	C	753	867	1620	0	8	1628	0	0
12	125434716	rs4078216	G	A	78	75	153	0	0	153	0	0
12	125437619	rs7296250	C	T	3	4	7	0	0	7	0	0
12	125437636	rs11057928	T	C	6	5	11	0	0	11	0	0
12	125440228	rs7297166	T	C	4	5	9	0	0	9	0	0
12	125440950	rs12299970	T	C	4	5	9	0	0	9	0	0
12	125441002	rs12298562	A	G	5	4	9	0	0	9	0	0
12	125441159	rs7973725	T	C	15	11	26	0	0	26	0	0
12	125441182	rs12298675	A	G	14	11	25	0	0	25	0	0
12	125441347	rs12300199	T	C	67	59	126	0	1	127	0	0
12	125441359	rs10773127	T	C	63	56	119	0	2	121	0	0
12	125448960	rs4076777	C	T	58	81	139	0	1	140	0	0
12	125451487	rs35364982	C	T	15	15	30	0	0	30	0	0
12	125451532	rs35177301	G	C	16	17	33	0	0	33	0	0
12	125451561	rs17879868	T	C	10	14	24	0	0	24	0	0
12	125451589	rs35874447	A	G	6	10	16	0	0	16	0	0
12	125510104	rs1055472	G	A	21	29	50	0	0	50	0	0
12	125513870	rs1134368	G	A	2	4	6	0	0	6	0	0
12	125515001	rs14143	G	A	2	4	6	0	0	6	0	0
12	125627332	rs11058047	A	G	30	21	51	0	0	51	0	0
12	129278310	rs3765107	A	G	38	53	91	0	2	93	0	0
12	129278864	rs1059312	A	G	108	170	278	0	1	280	1	0
12	129279099	rs35545884	C	T	13	17	30	0	0	30	0	0
12	129279242	rs3825180	C	T	14	11	25	0	0	25	0	0
12	129279931	rs7302634	C	T	30	24	54	0	1	55	0	0
12	129279988	rs7135854	G	C	19	15	34	0	0	34	0	0
12	129280066	rs7135968	G	A	22	17	39	0	0	39	0	0
12	129280117	rs7135987	G	A	29	23	52	0	0	52	0	0
12	129280164	rs7136092	G	C	32	22	54	0	1	55	0	0
12	129280786	rs12814773	C	T	20	12	32	0	0	32	0	0
12	129280949	rs12830361	G	A	10	4	14	0	0	14	0	0
12	129281690	rs36003513	C	T	19	24	43	0	0	43	0	0
12	129281788	rs9738216	C	T	22	18	40	0	0	40	0	0
12	129282180	rs35907548	T	C	13	14	27	0	0	27	0	0
12	129283149	rs7960920	T	C	42	45	87	0	2	89	0	0
12	129283711	rs2291350	G	A	51	47	98	0	0	98	0	0
12	129284248	rs2291349	T	C	7	5	12	0	0	12	0	0
12	129284382	rs4760589	T	C	7	5	12	0	1	13	0	0
12	129284791	rs12321679	G	A	10	5	15	0	0	15	0	0
12	129285007	rs11059915	G	T	10	8	18	0	0	18	0	0
12	129286756	rs12298615	G	A	19	26	45	0	0	45	0	0
12	129287149	rs4760592	G	C	18	17	35	0	0	35	0	0
12	129287220	rs4760593	A	G	11	12	23	0	0	23	0	0
12	129287449	rs10847691	G	A	8	15	23	0	0	23	0	0
12	129287609	rs11059916	C	A	16	17	33	0	0	33	0	0
12	129287925	rs11059917	T	A	13	11	24	0	0	24	0	0
12	129288366	rs7970815	G	A	16	10	26	0	0	26	0	0
12	129288534	rs7962918	T	C	20	11	31	0	0	31	0	0
12	129289190	rs11059919	G	A	9	1	10	0	0	10	0	0
12	129289232	rs12813317	G	A	4	7	11	0	0	11	0	0
12	129289679	rs10847692	A	T	7	5	12	0	0	12	0	0
12	129290026	rs10773578	G	C	4	2	6	0	0	6	0	0
12	129290418	rs11059922	C	T	10	9	19	0	0	19	0	0
12	129291317	rs2170989	T	C	9	9	18	0	0	18	0	0
12	129292006	rs10847693	G	A	13	7	20	0	0	20	0	0
12	129292457	rs10847694	C	A	3	3	6	0	0	6	0	0
12	129292708	rs959989	A	T	6	8	14	0	0	14	0	0
12	129293057	rs11059923	G	A	4	5	9	0	1	10	0	0
12	129293267	rs7311875	A	G	9	4	13	0	0	13	0	0
12	129293346	rs11059924	C	T	159	141	300	0	0	300	0	0
12	129294244	rs11059926	A	T	11	9	20	0	0	20	0	0
12	129294252	rs4482069	G	C	8	10	18	0	0	18	0	0
12	129294333	rs11059927	T	C	8	8	16	0	0	16	0	0
12	129294905	rs12831705	G	A	13	11	24	0	0	24	0	0
12	129295616	rs12816551	T	C	6	7	13	0	0	13	0	0
12	129296103	rs11059928	A	T	4	8	12	0	0	12	0	0
12	129296536	rs34888374	G	A	1	15	16	0	0	16	0	0
12	129296588	rs7974764	G	C	17	5	22	0	0	22	0	0
12	129296865	rs4760594	T	A	6	3	9	0	0	9	0	0
12	129297025	rs4760532	C	T	6	4	10	0	0	10	0	0
12	129297096	rs10847695	C	T	8	4	12	0	0	12	0	0
12	129297153	rs10847696	G	A	10	2	12	0	0	12	0	0
12	129297651	rs4760533	C	T	9	4	13	0	0	13	0	0
12	129297860	rs11059930	T	C	7	2	9	0	0	9	0	0
12	129298735	.	C	G	1	13	14	0	0	14	0	0
12	129298848	rs3741615	G	A	9	4	13	0	0	13	0	0
12	129299385	rs10847697	G	A	148	157	305	0	0	305	0	0
12	129299446	rs33990080	A	G	138	137	275	0	2	277	0	0
12	129300059	rs11059931	C	T	3	6	9	0	0	9	0	0
12	129300202	rs11609637	T	G	4	5	9	0	0	9	0	0
12	129300694	rs1385374	C	T	6	5	11	0	0	11	0	0
12	129301299	rs4760537	C	A	6	5	11	0	0	11	0	0
12	129302867	rs12321643	A	T	8	5	13	0	0	13	0	0
12	129303033	rs10847699	T	C	2	7	9	0	0	9	0	0
12	131305119	rs4759796	A	G	5	4	9	0	0	9	0	0
12	132200006	rs7301281	C	G	2	8	10	0	0	10	0	0
12	132200162	rs10794423	C	T	5	2	7	0	0	7	0	0
12	132237750	rs1051219	C	T	117	108	225	0	2	227	0	0
12	132240341	rs3741526	C	T	4	2	6	0	0	6	0	0
12	132240659	rs1107871	A	G	4	3	7	0	0	7	0	0
12	132242259	rs10902445	G	A	10	10	20	0	0	20	0	0
12	132243928	rs10751692	T	C	4	9	13	0	1	14	0	0
12	132244398	rs78292397	A	G	7	3	10	0	0	10	0	0
12	132245981	rs10794425	G	C	11	10	21	0	0	21	0	0
12	132246500	rs11612242	T	A	10	7	17	0	0	17	0	0
12	132247768	rs7488468	C	T	12	5	17	0	0	17	0	0
12	132249488	rs6598153	T	C	5	12	17	0	0	17	0	0
12	132250213	rs2895143	C	G	50	55	105	0	3	108	0	0
12	132250712	rs1051233	G	C	92	116	208	0	2	210	0	0
12	132262911	rs75324057	A	T	7	9	16	0	0	16	0	0
12	132264053	rs11246803	C	T	11	14	25	0	0	25	0	0
12	132264110	rs11246804	G	A	14	13	27	0	0	27	0	0
12	132265166	rs35769880	G	A	7	1	8	0	0	8	0	0
12	132265716	rs12227258	T	A	4	4	8	0	0	8	0	0
12	132265784	.	T	A	8	1	9	0	0	9	0	0
12	132265787	.	T	A	8	1	9	0	0	9	0	0
12	132266763	rs12824836	T	C	13	28	41	0	0	41	0	0
12	132268844	rs73160793	A	C	3	4	7	0	0	7	0	0
12	132325239	rs6598163	G	A	4	9	13	0	0	13	0	0
12	132326298	rs35466884	G	A	13	1	14	0	0	14	0	0
12	132387229	rs7488085	T	C	2	4	6	0	0	6	0	0
12	132396603	rs11616018	C	T	36	33	69	0	1	70	0	0
12	132396679	rs12317065	G	A	2	4	6	0	0	6	0	0
12	132397958	rs7956070	C	T	5	5	10	0	0	10	0	0
12	132399065	rs12303764	T	G	5	5	10	0	0	10	0	0
12	132399375	rs12301033	C	T	8	0	8	0	0	8	0	0
12	132405198	rs4964917	A	G	25	25	50	0	1	51	0	0
12	132405210	rs4964916	C	A	24	30	54	0	0	54	0	0
12	132405433	rs12297124	G	T	36	26	62	0	0	62	0	0
12	132406666	rs7138581	G	C	124	116	240	0	0	240	0	0
12	132562126	rs73164912	G	A	78	59	137	0	1	138	0	0
12	132631855	rs11543305	C	T	46	22	68	0	1	69	0	0
12	132635989	rs11246947	A	G	4	8	12	0	0	12	0	0
12	132636400	rs11246948	G	A	3	3	6	0	0	6	0	0
12	132671737	rs11246974	T	C	2	7	9	0	0	9	0	0
12	132674034	rs7307636	G	C	6	8	14	0	0	14	0	0
12	132674116	rs7298968	T	C	6	2	8	0	0	8	0	0
12	132674118	rs7307766	G	T	6	2	8	0	0	8	0	0
12	133067979	rs12314600	C	T	6	8	14	0	0	14	0	0
12	133068484	rs35318451	G	A	9	14	23	0	0	23	0	0
12	133068709	rs11147221	C	T	8	15	23	0	0	23	0	0
12	133068820	.	C	T	16	9	25	0	0	25	0	0
12	133069134	rs1882297	G	A	5	10	15	0	0	15	0	0
12	133069139	rs11147223	G	T	10	5	15	0	0	15	0	0
12	133069698	rs12811407	G	A	6	7	13	0	0	13	0	0
12	133070294	rs11614914	C	T	2	4	6	0	0	6	0	0
12	133072363	rs7315900	C	G	4	3	7	0	1	8	0	0
12	133072460	rs11147230	G	C	3	4	7	0	0	7	0	0
12	133073066	rs10870579	G	C	7	4	11	0	1	12	0	0
12	133074030	rs12815264	G	A	5	5	10	0	0	10	0	0
12	133079987	rs11147271	G	A	6	1	7	0	0	7	0	0
12	133080449	rs36098511	A	T	8	8	16	0	0	16	0	0
12	133081636	rs11610623	C	T	5	4	9	0	0	9	0	0
12	133081895	rs11610659	C	T	5	5	10	0	0	10	0	0
12	133086708	.	A	T	11	15	26	0	0	26	0	0
12	133088255	rs3751298	T	C	0	78	78	0	0	78	0	0
12	133088290	rs3751300	G	T	36	36	72	0	1	73	0	0
12	133088370	rs11778	C	T	26	22	48	0	0	48	0	0
12	133125450	rs11146926	G	A	5	5	10	0	0	10	0	0
12	133130487	rs35363025	A	G	9	19	28	0	1	29	0	0
12	133132982	rs12823391	C	T	4	2	6	0	0	6	0	0
12	133138716	rs9738068	C	G	3	9	12	0	0	12	0	0
12	133140013	.	A	G	8	2	10	0	0	10	0	0
12	133140140	rs73155029	G	A	8	10	18	0	0	18	0	0
12	133140193	rs66709032	A	G	2	6	8	0	0	8	0	0
12	133140237	rs4992763	A	G	3	5	8	0	0	8	0	0
12	133140262	rs67435543	T	C	3	4	7	0	1	8	0	0
12	133140840	rs12809318	T	C	9	3	12	0	0	12	0	0
12	133140853	rs12826964	A	G	10	2	12	0	0	12	0	0
12	133141238	rs35336325	C	T	6	0	6	0	0	6	0	0
12	133141461	rs7961696	G	C	6	4	10	0	0	10	0	0
12	133141973	rs5023077	T	C	13	2	15	0	0	15	0	0
12	133142118	rs5023078	T	C	11	8	19	0	0	19	0	0
12	133143504	rs80269627	T	C	9	7	16	0	1	17	0	0
12	133143532	rs11146938	G	A	10	8	18	0	0	18	0	0
12	133143867	rs7134889	C	T	6	14	20	0	0	20	0	0
12	133145318	rs12831027	A	G	17	15	32	0	0	32	0	0
12	133145359	rs34033598	C	T	16	10	26	0	0	26	0	0
12	133145764	rs4883549	G	C	10	3	13	0	0	13	0	0
12	133146416	rs7312710	A	G	18	18	36	0	1	37	0	0
12	133146457	rs3751316	G	A	16	10	26	0	0	26	0	0
12	133148259	rs12311310	A	G	18	7	25	0	0	25	0	0
12	133148519	rs12811683	G	A	21	22	43	0	0	43	0	0
12	133148887	.	C	T	191	138	329	0	4	333	0	0
12	133151607	rs11146943	C	T	8	5	13	0	0	13	0	0
12	133151680	rs12823302	T	G	11	8	19	0	0	19	0	0
12	133152109	rs11146944	G	A	22	7	29	0	0	29	0	0
12	133152192	rs11146945	G	A	10	10	20	0	0	20	0	0
12	133152581	rs10870472	A	G	14	2	16	0	0	16	0	0
12	133153281	rs10870473	A	T	13	8	21	0	0	21	0	0
12	133154142	rs12322739	A	G	14	8	22	0	0	22	0	0
12	133154167	rs12314709	G	A	16	9	25	0	0	25	0	0
12	133154186	rs11146948	C	G	10	13	23	0	0	23	0	0
12	133154461	rs35826119	A	T	24	22	46	0	1	47	0	0
12	133154929	.	T	A	19	8	27	0	0	27	0	0
12	133154983	rs11146950	G	A	9	17	26	0	1	27	0	0
12	133155312	rs75471611	C	G	23	23	46	0	3	49	0	0
12	133155424	rs10870474	G	A	26	19	45	0	1	46	0	0
12	133155879	rs12308215	G	A	17	20	37	0	1	38	0	0
12	133156451	rs4883513	T	C	22	32	54	0	0	54	0	0
12	133156497	rs12308589	G	A	30	20	50	0	0	50	0	0
12	133156697	rs4883547	C	G	16	8	24	0	1	25	0	0
12	133157469	rs4883546	A	G	39	40	79	0	2	81	0	0
12	133157640	rs3751309	G	C	40	42	82	0	0	82	0	0
12	133157851	rs3751307	G	A	51	30	81	0	2	83	0	0
12	133158280	rs3751306	G	T	11	19	30	0	0	30	0	0
12	133158561	rs3751305	C	A	21	20	41	0	4	45	0	0
12	133158632	rs3751304	C	T	12	19	31	0	0	31	0	0
12	133159330	rs10870475	A	T	2	7	9	0	0	9	0	0
12	133159662	rs12831275	G	A	20	14	34	0	0	34	0	0
12	133160398	rs75550494	G	A	156	186	342	0	2	344	0	0
12	133161346	rs11208	T	C	80	86	166	0	0	166	0	0
12	133200748	rs14302	T	C	127	91	218	0	0	218	0	0
12	133201947	rs4883544	T	C	6	4	10	0	0	10	0	0
12	133202004	rs4883543	C	T	9	3	12	0	0	12	0	0
12	133202215	rs5745075	G	A	1	5	6	0	0	6	0	0
12	133202428	rs5745073	G	A	3	6	9	0	0	9	0	0
12	133203158	rs5745065	A	G	4	5	9	0	0	9	0	0
12	133204412	rs4883542	A	T	5	4	9	0	0	9	0	0
12	133208979	rs5745022	T	C	77	67	144	0	2	146	0	0
12	133216248	rs5744960	C	T	18	17	35	0	1	36	0	0
12	133216617	rs4883617	A	G	9	8	17	0	0	17	0	0
12	133217245	rs4883616	G	A	18	13	31	0	0	31	0	0
12	133217346	rs10870482	T	C	9	9	18	0	0	18	0	0
12	133217851	rs34262516	C	T	19	9	28	0	0	28	0	0
12	133217872	rs4883615	G	A	15	8	23	0	1	24	0	0
12	133219831	rs5744944	T	C	25	20	45	0	2	47	0	0
12	133222644	rs10781626	A	G	3	3	6	0	1	7	0	0
12	133222747	rs11146989	G	A	6	2	8	0	0	8	0	0
12	133222861	rs7958381	G	C	5	2	7	0	0	7	0	0
12	133225446	rs4883538	G	T	5	2	7	0	0	7	0	0
12	133236000	rs5744857	C	T	37	27	64	0	0	64	0	0
12	133243226	rs5744811	C	T	4	16	20	0	0	20	0	0
12	133243288	rs59762387	A	G	9	16	25	0	1	26	0	0
12	133243347	rs5744808	C	G	14	13	27	0	0	27	0	0
12	133243650	rs5744805	T	C	13	12	25	0	0	25	0	0
12	133243788	rs4883577	T	A	5	6	11	0	0	11	0	0
12	133243817	rs4883576	C	T	5	5	10	0	1	11	0	0
12	133249017	rs5744783	G	A	9	4	13	0	0	13	0	0
12	133249139	rs5744780	T	A	4	2	6	0	0	6	0	0
12	133252796	rs4077170	C	G	2	5	7	0	0	7	0	0
12	133256904	rs5744738	C	T	5	7	12	0	0	12	0	0
12	133260288	rs9630293	T	A	4	3	7	0	0	7	0	0
12	133260381	rs11147003	G	A	5	4	9	0	0	9	0	0
12	133260417	rs11147004	G	A	6	2	8	0	0	8	0	0
12	133267828	rs10870486	G	A	6	0	6	0	0	6	0	0
12	133281462	rs10007	G	A	21	11	32	0	0	32	0	0
12	133298215	rs11147017	C	A	23	23	46	0	0	46	0	0
12	133298217	rs11147018	C	G	26	23	49	0	0	49	0	0
12	133298773	rs4883606	A	G	28	20	48	0	0	48	0	0
12	133306589	rs10781634	C	T	146	96	242	0	0	242	0	0
12	133307404	rs10747080	C	G	11	18	29	0	0	29	0	0
12	133307747	rs11147026	G	A	7	4	11	0	0	11	0	0
12	133308454	rs11147027	T	C	7	12	19	0	0	19	0	0
12	133309419	rs10870502	C	T	4	8	12	0	0	12	0	0
12	133310168	rs11147034	G	A	8	7	15	0	0	15	0	0
12	133310177	rs10781635	A	G	5	7	12	0	2	14	0	0
12	133311888	rs10781636	C	G	32	13	45	0	1	46	0	0
12	133311944	rs10747081	T	C	30	19	49	0	0	49	0	0
12	133312191	rs10781637	T	C	11	4	15	0	0	15	0	0
12	133312853	rs7313293	C	T	18	2	20	0	1	21	0	0
12	133313237	rs7138235	T	C	13	7	20	0	0	20	0	0
12	133313789	rs7132253	C	G	8	3	11	0	0	11	0	0
12	133314927	rs6560900	C	T	6	6	12	0	0	12	0	0
12	133316515	rs11147037	C	G	6	2	8	0	0	8	0	0
12	133316563	rs11147038	G	A	4	3	7	0	0	7	0	0
12	133317234	rs74730754	C	T	3	9	12	0	0	12	0	0
12	133318989	rs11613456	T	C	11	10	21	0	0	21	0	0
12	133319214	rs61951281	G	C	12	16	28	0	0	28	0	0
12	133331537	rs1132375	G	A	767	460	1227	0	4	1231	0	0
12	133332507	rs12367588	T	C	3	5	8	0	1	9	0	0
12	133332583	rs12366873	C	T	5	3	8	0	0	8	0	0
12	133333059	rs11147049	C	T	26	18	44	0	1	45	0	0
12	133336032	rs10781643	T	G	16	7	23	0	0	23	0	0
12	133336384	rs75348182	C	T	18	26	44	0	0	44	0	0
12	133336395	rs78742682	G	C	18	28	46	0	0	46	0	0
12	133336878	rs7959269	A	G	44	27	71	0	1	72	0	0
12	133337352	rs7971299	G	A	39	19	58	0	0	58	0	0
12	133337691	rs7397425	C	T	40	36	76	0	1	77	0	0
12	133337805	rs6560901	A	G	24	19	43	0	1	44	0	0
12	133346212	rs13254	A	G	35	30	65	0	1	66	0	0
12	133348573	rs11147071	C	T	36	35	71	0	0	71	0	0
12	133349260	.	G	A	12	9	21	0	0	21	0	0
12	133359914	rs77055232	C	T	8	6	14	0	0	14	0	0
12	133360063	rs4554924	T	C	4	3	7	0	0	7	0	0
12	133378440	rs2291258	C	T	26	15	41	0	1	42	0	0
12	133384864	rs3741486	G	A	13	16	29	0	0	29	0	0
12	133389998	rs7134809	T	C	53	45	98	0	0	98	0	0
12	133405069	rs3816760	G	A	5	2	7	0	0	7	0	0
12	133409584	rs1564648	G	A	2	4	6	0	0	6	0	0
12	133418069	rs1045979	C	T	115	91	206	0	0	206	0	0
12	133419040	rs76060528	A	G	5	3	8	0	0	8	0	0
12	133420909	rs11147106	C	T	6	2	8	0	0	8	0	0
12	133421402	rs111364734	A	G	5	1	6	0	0	6	0	0
12	133422157	rs77719222	G	A	6	1	7	0	0	7	0	0
12	133423662	rs2306536	C	T	108	111	219	0	2	221	0	0
12	133423695	rs2306537	A	G	85	89	174	0	7	184	3	0
12	133426945	rs6560907	C	T	1	8	9	0	0	9	0	0
12	133428131	rs2306540	C	T	4	2	6	0	0	6	0	0
12	133429278	rs11615963	T	C	8	12	20	0	0	20	0	0
12	133430216	.	C	T	13	16	29	0	0	29	0	0
12	133430417	rs11147109	G	C	7	4	11	0	0	11	0	0
12	133430537	rs7966176	G	A	4	8	12	0	0	12	0	0
12	133430596	rs7977432	C	T	8	13	21	0	0	21	0	0
12	133431568	rs10870525	C	T	8	13	21	0	1	22	0	0
12	133432992	rs2306539	G	A	7	1	8	0	0	8	0	0
12	133435716	rs35011845	T	G	82	87	169	0	1	170	0	0
12	133439002	rs9943856	G	A	3	3	6	0	0	6	0	0
12	133448391	rs77936594	G	A	8	5	13	0	0	13	0	0
12	133448553	rs2291253	G	C	6	4	10	0	0	10	0	0
12	133498344	rs13273	G	A	6	4	10	0	0	10	0	0
12	133498660	rs1278603	G	T	10	6	16	0	0	16	0	0
12	133498938	rs1278602	G	A	6	3	9	0	0	9	0	0
12	133499481	rs1278601	C	T	3	6	9	0	0	9	0	0
12	133501738	rs11833667	T	C	2	4	6	0	0	6	0	0
12	133732236	.	A	T	12	16	28	0	2	30	0	0
12	133735680	.	G	A	17	9	26	0	0	26	0	0
13	20208232	rs2298004	C	T	4	5	9	0	0	9	0	0
13	20208880	rs75796524	G	C	5	10	15	0	1	16	0	0
13	20221516	rs35424555	A	G	62	67	129	0	1	130	0	0
13	20223333	rs4769837	A	G	5	3	8	0	1	9	0	0
13	20224202	rs75390100	G	T	21	19	40	0	0	40	0	0
13	20249421	rs2290812	C	T	13	21	34	0	0	34	0	0
13	20275309	.	G	A	12	0	12	0	0	12	0	0
13	20275381	.	C	T	6	0	6	0	0	6	0	0
13	20277685	.	T	A	3	4	7	0	0	7	0	0
13	20277686	rs3864980	A	T	4	2	6	0	0	6	0	0
13	20278242	.	T	C	27	0	27	0	0	27	0	0
13	20278276	.	A	C	25	0	25	0	0	25	0	0
13	20278520	rs17241375	T	G	26	18	44	0	1	45	0	0
13	20282946	rs17241417	G	A	4	4	8	0	0	8	0	0
13	20285268	rs9508857	G	A	1	5	6	0	0	6	0	0
13	20356941	rs9508887	T	A	86	76	162	0	0	162	0	0
13	20397908	rs9552009	A	C	6	3	9	0	0	9	0	0
13	20398669	rs9508907	T	C	5	5	10	0	0	10	0	0
13	20398742	rs9508908	C	T	5	2	7	0	1	8	0	0
13	20419029	rs4343122	C	T	6	2	8	0	0	8	0	0
13	20425150	rs35634189	A	T	28	51	79	0	0	79	0	0
13	20436598	rs3783037	T	G	111	152	263	0	5	268	0	0
13	20593977	rs9315282	T	A	6	3	9	0	0	9	0	0
13	20595498	rs9579766	G	A	8	12	20	0	1	21	0	0
13	20596565	rs15639	A	G	17	23	40	0	1	41	0	0
13	20598284	rs9579769	A	G	10	3	13	0	0	13	0	0
13	20599182	rs9578251	T	G	3	4	7	0	0	7	0	0
13	20602148	rs7318279	C	T	2	5	7	0	0	7	0	0
13	20608465	rs79833154	T	C	65	56	121	0	0	121	0	0
13	20617075	rs259798	A	G	5	2	7	0	0	7	0	0
13	20638490	rs259785	T	C	4	4	8	0	0	8	0	0
13	20645318	rs9509024	G	A	11	8	19	0	0	19	0	0
13	20645490	rs259783	G	A	11	10	21	0	0	21	0	0
13	20645798	rs259782	A	G	2	8	10	0	0	10	0	0
13	20648377	rs4066783	T	A	4	7	11	0	0	11	0	0
13	20978006	rs7165	A	G	39	34	73	0	1	74	0	0
13	21416736	.	T	G	7	6	13	0	0	13	0	0
13	21550065	rs628621	A	C	6	6	12	0	0	12	0	0
13	21550843	rs61950150	A	T	5	4	9	0	0	9	0	0
13	21553098	rs9506591	G	A	8	5	13	0	0	13	0	0
13	21554217	rs688663	A	T	29	20	49	0	1	50	0	0
13	21555060	rs594669	C	T	346	257	603	0	2	605	0	0
13	21555544	rs870846	C	G	260	223	483	0	1	484	0	0
13	21555545	rs870847	T	A	259	223	482	0	1	483	0	0
13	21555554	rs870848	G	A	271	202	473	0	2	475	0	0
13	21557087	rs2480170	C	T	2	9	11	0	0	11	0	0
13	21558264	rs501811	C	T	7	1	8	0	0	8	0	0
13	21558454	rs663599	T	G	3	3	6	0	0	6	0	0
13	21558810	rs651670	A	G	4	2	6	0	0	6	0	0
13	21559287	rs649363	A	G	7	13	20	0	1	21	0	0
13	21559858	rs2480171	T	C	12	14	26	0	1	27	0	0
13	21559887	rs9509478	T	A	15	10	25	0	1	26	0	0
13	21560051	rs1753891	T	C	32	14	46	0	0	46	0	0
13	21562832	rs2770928	C	T	80	94	174	0	1	175	0	0
13	21562948	rs558614	G	A	80	106	186	0	1	187	0	0
13	21563715	rs685167	C	T	5	5	10	0	0	10	0	0
13	21566464	rs9579997	G	A	5	2	7	0	0	7	0	0
13	21566923	rs2003291	C	T	2	4	6	0	0	6	0	0
13	21569227	rs12323117	T	C	4	2	6	0	0	6	0	0
13	21569589	rs1550633	T	G	5	8	13	0	0	13	0	0
13	21570668	rs673314	C	T	6	0	6	0	0	6	0	0
13	21598722	rs9509490	A	T	6	5	11	0	0	11	0	0
13	21617112	rs112991009	G	A	8	13	21	0	1	22	0	0
13	21717522	rs17344661	T	C	13	22	35	0	0	35	0	0
13	21719504	rs75250240	A	G	4	8	12	0	0	12	0	0
13	21719859	rs149884953	C	T	15	13	28	0	0	28	0	0
13	21720868	rs11147974	C	G	8	5	13	0	0	13	0	0
13	21720956	rs4620	C	T	1583	1386	2969	0	19	2988	0	0
13	21722190	rs1046530	C	G	190	207	397	0	4	401	0	0
13	21722557	rs3088071	A	G	5	3	8	0	0	8	0	0
13	21728483	rs1327178	C	T	3	3	6	0	0	6	0	0
13	21728687	rs1409833	T	A	3	4	7	0	0	7	0	0
13	21751005	rs9550717	G	C	15	12	27	0	0	27	0	0
13	21752914	rs149724370	G	A	8	7	15	0	0	15	0	0
13	21861385	rs7327731	T	G	5	2	7	0	0	7	0	0
13	21861866	rs55973830	G	A	5	1	6	0	0	6	0	0
13	21867727	rs3814798	A	G	1	5	6	0	0	6	0	0
13	21904752	rs261729	T	C	2	8	10	0	0	10	0	0
13	21918844	rs7336525	G	A	3	10	13	0	0	13	0	0
13	21962207	rs9316337	G	A	6	3	9	0	0	9	0	0
13	21966640	rs184423087	C	G	6	3	9	0	0	9	0	0
13	21967590	rs9550732	G	T	2	7	9	0	0	9	0	0
13	21968268	rs117282188	C	A	4	6	10	0	0	10	0	0
13	21970107	rs7320749	C	T	3	7	10	0	0	10	0	0
13	21979673	rs34361511	T	C	6	6	12	0	0	12	0	0
13	21981582	rs36107889	C	A	8	11	19	0	0	19	0	0
13	21985288	rs9506672	C	T	7	6	13	0	0	13	0	0
13	22066934	rs1044069	G	A	22	22	44	0	1	45	0	0
13	22067072	rs1044045	T	C	101	90	191	0	1	192	0	0
13	22067236	rs1044021	A	C	18	18	36	0	0	36	0	0
13	22067681	rs3818314	T	C	4	8	12	0	0	12	0	0
13	22068225	rs1199938	T	C	5	2	7	0	0	7	0	0
13	22069820	rs1199942	G	A	20	21	41	0	0	41	0	0
13	22071698	rs2025243	A	G	4	6	10	0	0	10	0	0
13	22074572	.	T	G	5	1	6	0	0	6	0	0
13	22075143	rs34507694	C	G	2	4	6	0	0	6	0	0
13	22076091	rs1199949	T	C	4	6	10	0	0	10	0	0
13	22076930	rs3843680	G	C	13	7	20	0	0	20	0	0
13	22093824	rs17622791	T	A	5	2	7	0	0	7	0	0
13	22108134	rs7322862	C	T	12	7	19	0	0	19	0	0
13	23903791	rs4770433	A	G	14	11	25	0	0	25	0	0
13	23905711	rs2737699	A	G	36	25	61	0	1	62	0	0
13	23907909	rs17078605	A	G	28	19	47	0	1	48	0	0
13	23908034	rs2737700	A	G	18	27	45	0	0	45	0	0
13	23909162	rs9552929	A	G	30	39	69	0	0	69	0	0
13	23911820	rs4143768	A	G	23	15	38	0	1	39	0	0
13	23935173	rs7987902	C	T	7	0	7	0	0	7	0	0
13	23935396	rs7988272	C	T	5	3	8	0	0	8	0	0
13	23943018	rs9552935	T	G	1	5	6	0	0	6	0	0
13	23943059	rs7987914	T	C	3	3	6	0	0	6	0	0
13	23943076	rs9670978	G	C	4	3	7	0	0	7	0	0
13	24734996	rs2244601	A	G	5	5	10	0	0	10	0	0
13	24846225	rs114258825	C	A	8	4	12	0	0	12	0	0
13	24846848	rs4770641	C	T	6	2	8	0	0	8	0	0
13	24848826	rs73168733	G	A	4	3	7	0	0	7	0	0
13	24849105	rs12870498	A	C	3	3	6	0	0	6	0	0
13	24849151	rs7338464	A	G	3	4	7	0	0	7	0	0
13	24859190	rs9507299	G	A	12	23	35	0	0	35	0	0
13	24861596	rs112173202	C	T	6	2	8	0	0	8	0	0
13	24864489	rs12875385	A	G	4	5	9	0	0	9	0	0
13	24865895	rs7997126	T	A	5	2	7	0	0	7	0	0
13	24867571	rs9511181	C	T	8	7	15	0	0	15	0	0
13	24873651	rs9511182	C	T	12	18	30	0	0	30	0	0
13	24878466	rs3803218	A	G	47	60	107	0	1	108	0	0
13	24879703	rs1129021	G	A	103	99	202	0	2	204	0	0
13	24880292	rs9511184	C	T	112	96	208	0	0	208	0	0
13	24881184	rs6583	G	A	4	2	6	0	0	6	0	0
13	24997699	rs11843470	A	C	4	2	6	0	0	6	0	0
13	24998557	rs9318530	C	T	4	7	11	0	0	11	0	0
13	24998895	rs112981511	T	C	5	1	6	0	0	6	0	0
13	25000617	rs7571	C	G	69	60	129	0	1	130	0	0
13	25005720	rs7996670	C	G	7	1	8	0	0	8	0	0
13	25005774	rs61947015	G	A	8	1	9	0	0	9	0	0
13	25008588	rs1372085	A	G	38	36	74	0	0	74	0	0
13	25008630	rs1822135	A	G	36	28	64	0	0	64	0	0
13	25008903	rs9318536	G	T	29	32	61	0	1	62	0	0
13	25009099	rs9511259	A	C	38	48	86	0	0	86	0	0
13	25009297	rs1050112	G	T	46	32	78	0	0	78	0	0
13	25009441	rs13428	C	G	32	44	76	0	1	77	0	0
13	25009485	rs1050110	C	G	32	42	74	0	1	75	0	0
13	25009769	rs7999554	C	A	5	3	8	0	0	8	0	0
13	25009786	rs8000215	A	G	6	3	9	0	0	9	0	0
13	25012130	rs9511263	A	G	3	3	6	0	0	6	0	0
13	25016008	.	C	T	38	50	88	0	1	89	0	0
13	25016092	rs55888616	C	T	24	32	56	0	0	56	0	0
13	25020863	rs9318554	G	A	30	39	69	0	0	70	1	0
13	25021200	rs9318558	A	C	27	24	51	0	2	53	0	0
13	25021211	rs7333856	C	T	29	20	49	0	1	50	0	0
13	25021245	.	A	G	34	20	54	0	0	54	0	0
13	25027744	rs4770684	A	G	28	31	59	0	0	59	0	0
13	25029218	rs2275660	C	T	22	30	52	0	1	53	0	0
13	25860762	rs143620423	A	G	4	6	10	0	0	10	0	0
13	26625047	rs4770911	G	A	15	4	19	0	0	19	0	0
13	27647030	rs4771069	A	T	12	4	16	0	0	16	0	0
13	27647667	rs7993700	G	C	8	9	17	0	1	18	0	0
13	27648313	rs11149468	A	G	5	3	8	0	0	8	0	0
13	27729370	rs2497971	C	T	3	3	6	0	0	6	0	0
13	28121707	rs17085749	G	A	4	5	9	0	2	11	0	0
13	28196011	rs2232677	C	A	56	80	136	0	1	137	0	0
13	28196321	rs73432869	A	G	6	5	11	0	0	11	0	0
13	28224258	rs1218951	G	A	32	19	51	0	0	51	0	0
13	28224448	rs11841409	A	G	24	18	42	0	0	42	0	0
13	28224988	rs6491221	C	A	10	5	15	0	0	15	0	0
13	28226678	rs655885	G	A	6	5	11	0	0	11	0	0
13	28240828	rs14144	A	G	11	13	24	0	1	25	0	0
13	28561276	rs9512955	G	A	0	6	6	0	0	6	0	0
13	28577688	rs3829382	G	T	158	188	346	0	1	347	0	0
13	28583581	rs2481955	A	G	4	11	15	0	0	15	0	0
13	28583657	rs9579141	G	A	7	2	9	0	0	9	0	0
13	28586220	rs7317159	T	C	5	6	11	0	0	11	0	0
13	28586414	rs17086214	G	A	3	5	8	0	0	8	0	0
13	28587839	rs4435098	C	A	4	4	8	0	0	8	0	0
13	28589267	rs4073630	C	T	10	1	11	0	0	11	0	0
13	28589495	rs9579142	C	G	7	9	16	0	1	17	0	0
13	28589509	rs9579143	C	T	8	7	15	0	0	15	0	0
13	28590258	rs4432111	T	C	17	14	31	0	0	31	0	0
13	28590437	rs4074542	C	T	7	3	10	0	0	10	0	0
13	28590462	rs145798174	C	T	4	8	12	0	0	12	0	0
13	28591773	rs9512977	A	G	3	6	9	0	1	10	0	0
13	28591805	.	T	G	5	5	10	0	0	10	0	0
13	28591808	rs142251311	T	G	5	5	10	0	0	10	0	0
13	28593208	rs2504225	A	G	6	2	8	0	1	9	0	0
13	28593295	rs2504226	C	G	8	4	12	0	0	12	0	0
13	28593300	rs4265672	C	T	4	7	11	0	0	11	0	0
13	28594587	rs112095409	C	T	6	7	13	0	0	13	0	0
13	28594639	rs9581958	C	T	6	5	11	0	0	11	0	0
13	28594996	rs2491242	G	A	10	6	16	0	0	16	0	0
13	28594999	rs2504228	A	G	10	6	16	0	0	16	0	0
13	28595203	rs9512979	A	G	7	5	12	0	0	12	0	0
13	28599914	rs2491244	G	A	4	5	9	0	0	9	0	0
13	28601621	rs9512985	C	T	50	91	141	0	0	141	0	0
13	28612886	rs2504235	A	G	5	4	9	0	0	9	0	0
13	28613279	rs2491241	G	A	5	1	6	0	0	6	0	0
13	28613993	rs7316962	A	G	6	3	9	0	0	9	0	0
13	28614740	rs9551427	A	G	9	1	10	0	0	10	0	0
13	28616629	rs2387346	T	A	7	4	11	0	0	11	0	0
13	28618941	rs9512996	A	G	4	5	9	0	0	9	0	0
13	28624294	rs1933437	G	A	308	258	566	0	7	573	0	0
13	28627492	rs4769590	C	T	3	6	9	0	0	9	0	0
13	28627672	rs4769591	C	T	14	10	24	0	0	24	0	0
13	28627824	rs4771208	A	G	4	6	10	0	0	10	0	0
13	28629327	rs9581967	C	G	11	8	19	0	0	19	0	0
13	28630540	rs9579149	T	G	8	18	26	0	0	26	0	0
13	28630543	rs9579150	C	G	8	17	25	0	1	26	0	0
13	28630691	rs9513011	G	C	11	15	26	0	0	26	0	0
13	28630797	rs9513012	G	A	6	11	17	0	0	17	0	0
13	28630829	rs9513013	A	G	7	11	18	0	0	18	0	0
13	28650549	rs8001973	G	T	12	36	48	0	0	48	0	0
13	28650823	rs11617968	G	C	14	35	49	0	0	49	0	0
13	28651809	rs9513035	A	G	6	7	13	0	1	14	0	0
13	28652376	rs2387352	A	G	3	3	6	0	0	6	0	0
13	28653242	rs9551435	T	C	2	4	6	0	0	6	0	0
13	28665187	rs7333646	C	T	6	6	12	0	0	12	0	0
13	28712689	rs138028125	C	G	11	12	23	0	0	23	0	0
13	28849762	rs76806311	G	A	11	11	22	0	0	22	0	0
13	30097417	rs117900613	G	A	18	22	40	0	0	40	0	0
13	30399594	rs9508562	T	C	5	3	8	0	0	8	0	0
13	30399740	rs143378305	C	A	3	4	7	0	0	7	0	0
13	30401088	rs9508563	T	G	6	4	10	0	0	10	0	0
13	30413888	rs2388245	C	G	3	9	12	0	0	12	0	0
13	30424627	rs278037	C	T	18	18	36	0	0	36	0	0
13	30777202	rs10478	T	C	7	15	22	0	0	22	0	0
13	30777301	rs1023104	C	T	16	7	23	0	0	23	0	0
13	30779819	rs11620056	C	T	14	11	25	0	0	25	0	0
13	30779895	.	G	C	16	3	19	0	0	19	0	0
13	30780602	rs17074420	C	T	10	4	14	0	0	14	0	0
13	30940248	rs7328796	T	C	4	2	6	0	0	6	0	0
13	30941805	rs1275183	A	G	17	7	24	0	0	24	0	0
13	31197565	rs4394933	A	G	5	4	9	0	1	10	0	0
13	31200751	rs2031278	C	T	5	4	9	0	0	9	0	0
13	31202076	rs2031279	A	G	6	4	10	0	0	10	0	0
13	31203339	rs7318091	C	T	12	8	20	0	0	20	0	0
13	31203763	rs7318713	A	C	14	10	24	0	0	24	0	0
13	31224485	rs112192927	G	A	4	3	7	0	0	7	0	0
13	31229758	rs9508813	T	G	3	3	6	0	0	6	0	0
13	31230278	rs6490476	A	G	6	3	9	0	0	9	0	0
13	31231513	rs7983138	C	T	7	7	14	0	0	14	0	0
13	31231806	rs7984952	T	C	141	143	284	0	2	286	0	0
13	31233063	rs3742302	G	A	219	206	425	0	1	426	0	0
13	31712572	.	C	T	19	21	40	0	1	41	0	0
13	32606069	rs424118	A	G	2	4	6	0	0	6	0	0
13	32616969	rs467241	A	G	2	5	7	0	0	7	0	0
13	32617091	rs465023	T	A	5	8	13	0	0	13	0	0
13	32623719	rs463450	T	C	2	4	6	0	0	6	0	0
13	32811607	rs2806639	G	A	7	13	20	0	0	20	0	0
13	32973276	rs7334543	A	G	4	2	6	0	1	7	0	0
13	32986745	rs627926	A	G	3	4	7	0	1	8	0	0
13	33097483	rs798269	G	C	4	9	13	0	0	13	0	0
13	33160705	rs7994229	C	A	9	17	26	0	0	26	0	0
13	33206651	rs9591189	T	G	8	2	10	0	0	10	0	0
13	33207314	rs208412	T	C	5	2	7	0	0	7	0	0
13	33232435	rs2301393	A	G	17	18	35	0	0	35	0	0
13	33272542	rs9596081	G	A	3	3	6	0	0	6	0	0
13	33320855	rs35653099	A	C	3	3	6	0	0	6	0	0
13	33347688	rs3213532	G	A	8	5	13	0	0	13	0	0
13	33348027	rs9315179	T	C	9	8	17	0	0	17	0	0
13	33348568	rs7327412	G	A	14	9	23	0	0	23	0	0
13	33349341	rs3492	A	G	15	37	52	0	0	52	0	0
13	33349845	rs7336793	A	G	49	65	114	0	2	116	0	0
13	33351016	rs9596233	C	T	4	10	14	0	0	14	0	0
13	36904371	rs7327507	T	C	3	4	7	0	0	7	0	0
13	36919939	rs4941833	T	C	14	7	21	0	0	21	0	0
13	36944274	rs4287440	C	T	3	4	7	0	0	7	0	0
13	37014366	rs2282411	G	A	2	5	7	0	0	7	0	0
13	37402440	rs9547679	T	C	12	17	29	0	1	30	0	0
13	37574708	rs9603126	G	A	1	7	8	0	0	8	0	0
13	37579869	.	C	T	6	5	11	0	0	11	0	0
13	37580139	rs1127446	G	A	73	43	116	0	0	116	0	0
13	37583831	rs9469	G	A	31	33	64	0	0	64	0	0
13	39584916	rs17226809	A	T	29	32	61	0	0	61	0	0
13	39585178	rs2274385	C	T	27	22	49	0	0	49	0	0
13	39586343	rs9576697	G	C	92	76	168	0	1	169	0	0
13	39587166	rs11147745	A	G	110	78	188	0	1	189	0	0
13	39587677	rs3751379	A	G	58	57	115	0	0	115	0	0
13	39587865	rs3751378	A	C	92	70	162	0	0	162	0	0
13	39587889	rs3751377	T	C	88	73	161	0	1	162	0	0
13	39589293	rs9576700	C	T	5	3	8	0	0	8	0	0
13	39599884	rs1409441	G	A	4	3	7	0	0	7	0	0
13	39599903	rs1409442	A	G	4	3	7	0	0	7	0	0
13	39608900	rs9888511	T	C	5	4	9	0	0	9	0	0
13	39611211	rs7318688	A	G	4	3	7	0	0	7	0	0
13	39622075	rs9532318	T	C	2	5	7	0	0	7	0	0
13	41133080	rs3751437	A	G	45	32	77	0	6	83	0	0
13	41188292	rs3900833	A	G	4	2	6	0	0	6	0	0
13	41224442	rs9549249	C	T	2	5	7	0	0	7	0	0
13	41229905	rs7328677	A	G	4	4	8	0	0	8	0	0
13	41373254	rs41396747	G	A	4	5	9	0	0	9	0	0
13	41379272	rs9577152	C	T	3	5	8	0	0	8	0	0
13	41439055	.	T	C	3	4	7	0	0	7	0	0
13	41439157	.	C	T	7	0	7	0	0	7	0	0
13	41439161	.	G	A	7	0	7	0	0	7	0	0
13	41446912	rs7982421	T	C	4	2	6	0	0	6	0	0
13	41447409	rs7982346	G	A	2	5	7	0	0	7	0	0
13	41448222	rs4356344	T	G	1	5	6	0	0	6	0	0
13	41448345	rs4389021	C	T	4	9	13	0	0	13	0	0
13	41448505	rs4628828	A	G	4	14	18	0	0	18	0	0
13	41448560	rs34354179	G	A	3	15	18	0	1	19	0	0
13	41448947	rs9532627	A	G	4	6	10	0	0	10	0	0
13	41448995	rs9594445	C	G	5	13	18	0	0	18	0	0
13	41448999	rs9594446	G	A	5	13	18	0	0	18	0	0
13	41449146	rs4402423	T	C	3	17	20	0	0	20	0	0
13	41449308	rs9532628	G	A	6	12	18	0	0	18	0	0
13	41449329	rs9532629	G	A	7	13	20	0	0	20	0	0
13	41449352	rs7491149	A	G	4	14	18	0	0	18	0	0
13	41449777	rs4306385	G	A	3	3	6	0	0	6	0	0
13	41451166	rs4941390	T	C	3	3	6	0	0	6	0	0
13	41451873	rs4334153	C	T	6	7	13	0	0	13	0	0
13	41451963	rs4309270	C	T	3	7	10	0	0	10	0	0
13	41452059	rs4270044	T	G	1	6	7	0	0	7	0	0
13	41454764	rs9532640	G	A	2	12	14	0	0	14	0	0
13	41454784	rs9532641	C	G	2	10	12	0	0	12	0	0
13	41454936	rs9532643	C	T	2	5	7	0	0	7	0	0
13	41454996	rs9532644	A	G	3	5	8	0	0	8	0	0
13	41455034	rs9532645	G	A	3	6	9	0	0	9	0	0
13	41455125	rs9532646	A	G	5	11	16	0	0	16	0	0
13	41455183	rs9525419	C	T	4	3	7	0	0	7	0	0
13	41493588	rs9594455	G	C	2	6	8	0	0	8	0	0
13	41493669	rs11839431	T	C	4	5	9	0	0	9	0	0
13	41493695	rs11843633	G	A	6	2	8	0	0	8	0	0
13	41494245	rs9532658	A	C	4	2	6	0	0	6	0	0
13	41494575	rs9594457	T	G	4	4	8	0	0	8	0	0
13	41494584	rs9594458	T	C	3	3	6	0	0	6	0	0
13	41494639	rs9590562	C	T	7	3	10	0	0	10	0	0
13	41506721	rs1056835	C	T	431	350	781	0	7	788	0	0
13	41506884	rs1056824	A	G	636	656	1292	0	0	1292	0	0
13	41509762	rs9532676	G	C	19	14	33	0	0	33	0	0
13	41509872	rs9525432	T	C	4	2	6	0	0	6	0	0
13	41510672	rs2875421	A	G	7	14	21	0	0	21	0	0
13	41510813	rs7319410	C	T	4	4	8	0	0	8	0	0
13	41511856	rs7989531	C	T	11	20	31	0	1	32	0	0
13	41512112	rs7326520	C	T	10	6	16	0	0	16	0	0
13	41512154	rs7327836	T	C	7	9	16	0	0	16	0	0
13	41513248	rs4942012	T	C	30	25	55	0	0	55	0	0
13	41513625	rs9315794	C	T	33	33	66	0	2	68	0	0
13	41513923	rs4941391	G	A	31	16	47	0	0	47	0	0
13	41514554	rs4584694	A	C	12	73	85	0	1	86	0	0
13	41514633	rs4343141	A	T	78	115	193	0	0	193	0	0
13	41514696	rs3887418	A	G	62	96	158	0	1	159	0	0
13	41515286	rs1056820	T	A	975	946	1921	0	8	1929	0	0
13	41515998	rs9532678	T	C	4	6	10	0	0	10	0	0
13	41517518	rs9315795	A	G	23	32	55	0	0	55	0	0
13	41517985	rs3764056	A	G	946	926	1872	0	22	1894	0	0
13	41518832	rs8000575	G	C	72	57	129	0	1	130	0	0
13	41520172	rs12868769	T	C	50	50	100	0	1	101	0	0
13	41520675	.	C	T	76	68	144	0	4	148	0	0
13	41523205	rs9525434	T	G	30	38	68	0	0	68	0	0
13	41524223	rs7989303	T	C	26	13	39	0	0	39	0	0
13	41579113	rs9532696	A	G	9	6	15	0	0	15	0	0
13	41579938	rs7334701	G	A	3	4	7	0	0	7	0	0
13	41586960	rs9525442	C	T	8	19	27	0	0	27	0	0
13	41587375	rs9532700	T	C	6	9	15	0	0	15	0	0
13	41588462	rs9532701	T	C	1	6	7	0	0	7	0	0
13	41591723	rs11147833	C	G	11	20	31	0	3	34	0	0
13	41635042	.	G	A	16	15	31	0	0	31	0	0
13	41635301	rs17532371	C	G	34	32	66	0	0	66	0	0
13	41644722	rs9532718	A	C	6	4	10	0	0	10	0	0
13	41644956	rs17532413	A	C	6	5	11	0	0	11	0	0
13	41653179	rs60223575	T	C	4	5	9	0	0	9	0	0
13	41654883	.	A	G	36	22	58	0	0	58	0	0
13	41814538	rs139410221	G	A	7	4	11	0	0	11	0	0
13	41891172	rs2483103	A	G	8	2	10	0	0	10	0	0
13	41891654	rs2483104	C	T	6	2	8	0	0	8	0	0
13	41893756	rs112317237	G	A	6	7	13	0	0	13	0	0
13	41893813	rs2483106	T	C	7	8	15	0	0	15	0	0
13	41902939	rs3812896	T	C	153	123	276	0	0	276	0	0
13	41905902	rs6560978	A	G	17	10	27	0	0	27	0	0
13	41907638	rs9532791	G	C	25	19	44	0	0	44	0	0
13	41916203	rs9315832	C	T	2	6	8	0	0	8	0	0
13	41922367	rs7989646	A	G	1	6	7	0	1	8	0	0
13	41928475	rs4277223	T	G	4	3	7	0	0	7	0	0
13	41930310	rs7350697	T	C	1	6	7	0	0	7	0	0
13	41931686	rs7358853	A	G	4	3	7	0	0	7	0	0
13	41948051	rs9525478	G	C	7	12	19	0	0	19	0	0
13	41948151	rs9525479	T	G	5	8	13	0	0	13	0	0
13	41948177	rs9525480	C	T	7	9	16	0	0	16	0	0
13	41948593	rs9285147	C	T	3	14	17	0	0	17	0	0
13	41949804	rs6560982	G	T	10	10	20	0	1	21	0	0
13	41950538	rs9532797	G	C	17	26	43	0	3	46	0	0
13	41950562	rs9315836	A	G	13	30	43	0	0	43	0	0
13	41950643	rs9315837	A	C	25	37	62	0	0	62	0	0
13	42037935	rs7326471	C	T	129	112	241	0	0	241	0	0
13	42038086	rs993695	C	A	139	131	270	0	1	271	0	0
13	42038638	rs872357	A	G	156	135	291	0	5	296	0	0
13	42039288	rs3783196	C	A	106	99	205	0	1	206	0	0
13	42040242	rs9525489	G	A	211	193	404	0	7	411	0	0
13	42040844	rs995845	G	T	107	78	185	0	2	187	0	0
13	42041939	rs1333558	A	G	24	35	59	0	0	59	0	0
13	42043670	rs3783197	G	A	13	13	26	0	0	26	0	0
13	42044363	rs7320113	A	G	13	20	33	0	1	34	0	0
13	42442546	rs3742262	A	G	4	7	11	0	1	12	0	0
13	42465713	rs9562362	C	T	8	8	16	0	0	16	0	0
13	42872719	rs2273952	A	G	7	10	17	0	0	17	0	0
13	42872779	rs2273951	C	T	8	8	16	0	0	16	0	0
13	42877265	rs9315906	G	C	13	13	26	0	0	26	0	0
13	42882620	rs17521586	C	T	22	15	37	0	0	37	0	0
13	42893986	rs9533063	C	T	9	6	15	0	0	15	0	0
13	42896099	rs1065235	T	C	5	6	11	0	0	11	0	0
13	43461229	rs2281813	A	G	15	16	31	0	0	31	0	0
13	43461419	rs2281812	C	T	10	13	23	0	0	23	0	0
13	43461643	rs2281810	A	G	16	7	23	0	0	23	0	0
13	43462352	rs45505295	T	C	11	6	17	0	0	17	0	0
13	43462422	rs1044856	A	T	5	11	16	0	0	16	0	0
13	43469157	rs1128105	G	A	12	8	20	0	0	20	0	0
13	43469211	rs1359184	G	A	11	5	16	0	0	16	0	0
13	43597706	rs17553284	C	T	8	8	16	0	1	17	0	0
13	43597865	rs12015	A	G	118	53	171	0	0	171	0	0
13	43656443	rs9315986	C	A	10	0	10	0	0	10	0	0
13	43656817	rs9315988	G	A	7	2	9	0	0	9	0	0
13	43657640	rs73188002	T	C	6	2	8	0	0	8	0	0
13	43657676	rs9567108	A	G	9	3	12	0	0	12	0	0
13	43658125	rs2057529	A	G	7	6	13	0	0	13	0	0
13	43658209	rs9533381	G	A	11	8	19	0	1	20	0	0
13	43659200	rs912441	C	G	16	3	19	0	0	19	0	0
13	43659274	rs9525733	T	C	10	4	14	0	0	14	0	0
13	43679540	rs9533390	A	G	4	2	6	0	0	6	0	0
13	43680261	rs9533393	A	G	5	3	8	0	0	8	0	0
13	43681427	rs1047775	G	A	42	32	74	0	7	81	0	0
13	43682841	rs9533394	A	G	22	5	27	0	1	28	0	0
13	43683008	rs11728	G	A	8	5	13	0	0	13	0	0
13	43683020	rs11346	A	G	8	4	12	0	1	13	0	0
13	44453783	rs3816311	G	A	4	3	7	0	1	8	0	0
13	44466797	.	A	G	2	5	7	0	0	7	0	0
13	44543526	rs3829400	C	A	7	0	7	0	0	7	0	0
13	45008147	rs41288339	T	C	691	662	1353	0	10	1363	0	0
13	45008333	rs1053948	G	C	603	647	1250	0	5	1255	0	0
13	45010616	rs7997320	G	A	10	11	21	0	0	21	0	0
13	45010867	rs11552414	C	T	522	514	1036	0	9	1045	0	0
13	45011384	rs9533849	T	C	6	11	17	0	1	18	0	0
13	45148257	rs9525983	G	A	24	29	53	0	0	53	0	0
13	45149662	rs9525984	G	A	19	13	32	0	0	32	0	0
13	45911932	rs2147503	T	C	80	63	143	0	1	144	0	0
13	45912634	rs9595305	T	C	36	52	88	0	0	88	0	0
13	45914957	rs2234216	T	C	97	51	148	0	0	148	0	0
13	45953797	rs3934512	A	G	3	4	7	0	0	7	0	0
13	45957288	rs9526063	C	G	21	25	46	0	5	51	0	0
13	45964416	rs9534138	C	G	7	0	7	0	0	7	0	0
13	45968140	rs3210286	A	G	5	4	9	0	0	9	0	0
13	45970433	.	A	G	2	12	14	0	0	14	0	0
13	46039407	rs11619408	G	T	14	16	30	0	0	30	0	0
13	46067593	rs2985959	G	A	18	14	32	0	0	32	0	0
13	46700062	rs12583876	G	A	25	7	32	0	1	33	0	0
13	46701174	rs4391952	G	C	1074	877	1951	0	7	1958	0	0
13	46701371	rs1409429	T	A	536	535	1071	0	8	1079	0	0
13	46702401	rs6561296	T	C	5	5	10	0	1	11	0	0
13	46702791	rs9590944	A	T	2	5	7	0	0	7	0	0
13	46703125	rs11618380	G	C	5	8	13	0	0	13	0	0
13	46705068	rs11558762	C	A	747	621	1368	0	4	1372	0	0
13	46712767	rs9316184	G	A	7	3	10	0	0	10	0	0
13	46713639	rs9316186	T	G	10	7	17	0	0	17	0	0
13	46713702	rs9316187	G	A	9	10	19	0	0	19	0	0
13	46713825	rs9316188	T	C	4	2	6	0	0	6	0	0
13	46713995	rs9316189	G	C	4	4	8	0	1	9	0	0
13	46714039	rs4547245	C	A	1	6	7	0	0	7	0	0
13	46719291	rs17523219	A	G	10	6	16	0	0	16	0	0
13	46720477	rs1028824	T	A	4	6	10	0	0	10	0	0
13	46724113	rs2146878	A	G	27	19	46	0	0	46	0	0
13	46755852	rs7338001	A	G	4	7	11	0	0	11	0	0
13	46755880	rs10492449	T	G	4	7	11	0	0	11	0	0
13	46831271	rs2765615	A	T	9	0	9	0	0	9	0	0
13	47281751	rs17281886	A	G	3	3	6	0	0	6	0	0
13	47284683	rs17347719	G	A	2	4	6	0	0	6	0	0
13	47284766	rs17347740	G	A	2	4	6	0	0	6	0	0
13	47285257	rs9590983	C	T	8	1	9	0	0	9	0	0
13	47286455	rs9534472	G	A	8	4	12	0	0	12	0	0
13	47286523	rs2275679	G	A	7	6	13	0	0	13	0	0
13	47286938	rs2762130	C	G	2	6	8	0	0	8	0	0
13	47287942	rs9534474	C	T	6	1	7	0	0	7	0	0
13	47289958	rs9526223	C	T	3	4	7	0	0	7	0	0
13	47293612	rs9526225	A	C	5	5	10	0	0	10	0	0
13	47295916	rs2236592	C	T	3	5	8	0	0	8	0	0
13	47325380	rs1045945	G	A	25	10	35	0	0	35	0	0
13	47327160	rs912124	T	C	4	2	6	0	0	6	0	0
13	47350561	rs9595531	G	A	4	3	7	0	0	7	0	0
13	48889973	.	C	T	6	6	12	0	0	12	0	0
13	48987032	rs2227311	A	G	793	8	801	0	1	802	0	0
13	49072852	.	G	A	6	2	8	0	0	8	0	0
13	49281763	rs150160388	C	T	3	3	6	0	0	6	0	0
13	50018842	rs61959991	T	G	15	18	33	0	1	34	0	0
13	50019376	rs4942830	T	A	3	3	6	0	0	6	0	0
13	50057633	rs11619265	A	G	23	21	44	0	0	44	0	0
13	50063325	rs3764088	C	T	6	7	13	0	0	13	0	0
13	50066524	rs6561526	G	A	14	9	23	0	0	23	0	0
13	50067443	rs7326345	G	A	9	16	25	0	0	25	0	0
13	50068387	rs4941643	G	A	7	7	14	0	0	14	0	0
13	50092847	rs9526565	G	A	8	7	15	0	0	15	0	0
13	50094004	rs73190705	A	G	6	15	21	0	0	21	0	0
13	50094090	rs17381926	T	C	9	17	26	0	0	26	0	0
13	50095127	rs3765526	A	G	4	4	8	0	0	8	0	0
13	50095443	rs9526568	A	G	22	26	48	0	0	48	0	0
13	50096127	rs2274277	C	G	4	4	8	0	0	8	0	0
13	50097890	rs7331182	C	T	14	9	23	0	0	23	0	0
13	50097979	rs942870	T	C	6	5	11	0	0	11	0	0
13	50102810	rs1046295	G	A	114	148	262	0	2	264	0	0
13	50102992	rs3033	T	C	104	116	220	0	4	224	0	0
13	50106561	rs9568240	T	G	15	16	31	0	0	31	0	0
13	50106584	rs3186024	G	A	23	37	60	0	0	60	0	0
13	50106955	rs7995684	A	G	33	78	111	0	1	112	0	0
13	50107231	rs1128767	C	A	10	23	33	0	2	35	0	0
13	50107289	rs1046028	T	C	19	42	61	0	1	62	0	0
13	50107323	rs1046027	C	T	22	45	67	0	0	67	0	0
13	50107375	rs1062979	G	C	15	32	47	0	0	47	0	0
13	50107904	rs3186013	G	A	26	66	92	0	3	95	0	0
13	50107918	rs9568241	T	A	63	27	90	0	1	91	0	0
13	50107973	rs3186012	G	C	12	51	63	0	12	75	0	0
13	50108252	rs7317982	T	C	15	58	73	0	0	73	0	0
13	50109929	rs1977352	T	G	2	4	6	0	0	6	0	0
13	50121511	rs1570884	A	G	0	6	6	0	0	6	0	0
13	50123622	rs3751384	G	C	24	56	80	0	0	80	0	0
13	50123649	rs3751383	G	A	70	27	97	0	0	97	0	0
13	50123688	rs3751382	G	T	64	25	89	0	1	90	0	0
13	50123832	rs3751381	C	G	4	3	7	0	0	7	0	0
13	50124621	rs942871	G	A	2	10	12	0	0	12	0	0
13	50125165	rs3764082	C	G	18	2	20	0	0	20	0	0
13	50125194	rs2002407	G	A	17	1	18	0	0	18	0	0
13	50134099	rs17073145	T	C	25	23	48	0	0	48	0	0
13	50134150	rs17073150	A	G	25	27	52	0	0	52	0	0
13	50141345	rs4942848	G	A	14	21	35	0	0	35	0	0
13	50141362	rs9562900	G	A	27	12	39	0	0	39	0	0
13	50241792	rs9568300	G	A	3	4	7	0	0	7	0	0
13	50253488	rs942031	G	A	13	7	20	0	0	20	0	0
13	50253644	rs9562910	T	C	14	5	19	0	1	20	0	0
13	50253838	rs942030	G	A	11	6	17	0	0	17	0	0
13	50258449	rs6561551	A	G	3	3	6	0	0	6	0	0
13	50259773	rs1969739	G	A	1	5	6	0	1	7	0	0
13	50273603	rs3720	A	G	11	7	18	0	0	18	0	0
13	50273831	rs1043729	T	C	76	71	147	0	2	149	0	0
13	50273970	rs1819191	C	T	109	115	224	0	3	227	0	0
13	50275349	.	T	A	45	35	80	0	2	82	0	0
13	50283819	rs17073322	T	C	99	102	201	0	1	202	0	0
13	50285529	rs575951671	C	T	10	7	17	0	0	17	0	0
13	50285551	rs2236326	G	A	8	5	13	0	0	13	0	0
13	50285985	rs57118905	T	C	4	7	11	0	0	11	0	0
13	50287894	rs7984711	T	C	8	5	13	0	0	13	0	0
13	50287966	rs9535304	T	C	5	5	10	0	0	10	0	0
13	50289877	rs9596175	A	G	5	5	10	0	0	10	0	0
13	50290675	rs9596176	A	C	3	5	8	0	0	8	0	0
13	50290817	rs9535306	A	G	4	7	11	0	0	11	0	0
13	50291611	rs9568313	A	T	5	6	11	0	0	11	0	0
13	50489083	rs1063183	A	G	3	3	6	0	0	6	0	0
13	50510401	rs1063181	C	G	7	7	14	0	0	14	0	0
13	50571301	rs28411370	C	G	61	44	105	0	0	105	0	0
13	50573576	rs60583460	T	C	4	3	7	0	0	7	0	0
13	50584343	rs117181727	G	A	5	6	11	0	0	11	0	0
13	50590838	rs66756338	C	G	6	7	13	0	0	13	0	0
13	50591342	rs60828549	T	A	3	4	7	0	0	7	0	0
13	50592060	rs61961301	T	G	6	2	8	0	0	8	0	0
13	50614098	rs9568371	C	T	6	5	11	0	1	12	0	0
13	50614281	rs2066562	C	T	4	2	6	0	0	6	0	0
13	50616330	rs73196740	C	A	7	4	11	0	0	11	0	0
13	50617515	rs35456235	T	G	4	3	7	0	0	7	0	0
13	50620476	rs61961304	T	G	9	5	14	0	2	16	0	0
13	50621454	rs61961305	G	A	2	4	6	0	0	6	0	0
13	50622473	rs61961306	A	G	3	6	9	0	0	9	0	0
13	50637787	rs790943	G	T	2	7	9	0	0	9	0	0
13	50641176	rs7339181	T	G	7	8	15	0	0	15	0	0
13	50656797	rs7325993	C	A	15	19	34	0	0	34	0	0
13	50657362	rs12100048	G	T	3	4	7	0	0	7	0	0
13	50693769	rs7325091	A	G	5	2	7	0	0	7	0	0
13	50696448	rs7991744	C	T	3	3	6	0	0	6	0	0
13	50698153	rs7981648	A	C	3	5	8	0	0	8	0	0
13	50700431	rs76067960	C	T	2	6	8	0	0	8	0	0
13	51939017	rs117986217	T	C	8	7	15	0	0	15	0	0
13	52036017	rs9535678	T	G	3	3	6	0	0	6	0	0
13	52178945	rs9535715	T	A	3	5	8	0	0	8	0	0
13	52179214	rs75306857	G	A	3	3	6	0	0	6	0	0
13	52269607	rs189882032	C	G	3	5	8	0	0	8	0	0
13	52276787	rs12428478	G	A	3	7	10	0	0	10	0	0
13	52277018	rs2408491	T	G	3	3	6	0	0	6	0	0
13	52277054	rs12428713	G	T	3	4	7	0	0	7	0	0
13	52277067	rs12428714	G	T	2	4	6	0	0	6	0	0
13	52313195	rs1885854	C	T	25	23	48	0	0	48	0	0
13	52327020	rs9526793	G	A	19	28	47	0	0	47	0	0
13	52328844	rs9535749	T	A	6	3	9	0	0	9	0	0
13	52329758	rs12430600	C	T	4	5	9	0	0	9	0	0
13	52332329	rs35409673	C	T	59	63	122	0	0	122	0	0
13	52332745	rs17532936	A	G	7	7	14	0	0	14	0	0
13	52333057	rs9535751	C	T	7	5	12	0	0	12	0	0
13	52333283	rs9535752	C	A	5	5	10	0	0	10	0	0
13	52335201	rs9535753	T	C	20	18	38	0	0	38	0	0
13	52335765	rs2296029	C	T	29	24	53	0	0	53	0	0
13	52335860	rs73199750	A	G	14	25	39	0	1	40	0	0
13	52342546	rs1058141	A	G	3	4	7	0	0	7	0	0
13	52343004	rs41292776	A	G	2	5	7	0	0	7	0	0
13	52597888	rs6561656	A	G	5	1	6	0	0	6	0	0
13	52602919	rs3825528	A	C	4	6	10	0	0	10	0	0
13	52603194	rs3742289	G	T	4	5	9	0	0	9	0	0
13	52603775	rs3742291	C	T	6	5	11	0	0	11	0	0
13	52603896	rs17402034	G	A	6	6	12	0	0	12	0	0
13	52605675	rs2897964	A	G	6	3	9	0	0	9	0	0
13	52707196	.	T	A	22	21	43	0	0	43	0	0
13	52707240	rs3368	C	G	28	18	46	0	0	46	0	0
13	52709938	rs2296351	A	C	13	22	35	0	0	36	1	0
13	52765847	rs9535895	G	A	6	1	7	0	1	8	0	0
13	52987477	rs13431	G	C	4	3	7	0	0	7	0	0
13	52989863	rs1056335	C	T	20	25	45	0	0	45	0	0
13	52993412	rs9568732	G	A	3	4	7	0	0	7	0	0
13	52998697	rs4886077	G	T	4	4	8	0	0	8	0	0
13	53006058	rs7323666	T	C	5	3	8	0	0	8	0	0
13	53213028	rs9536208	T	C	5	4	9	0	0	9	0	0
13	53217035	rs9536211	C	A	50	52	102	0	0	102	0	0
13	53217270	rs9536212	A	G	67	74	141	0	0	141	0	0
13	53227301	rs9536219	C	T	5	1	6	0	0	6	0	0
13	53265123	rs7337021	C	T	6	4	10	0	0	10	0	0
13	64577497	rs9598695	A	T	12	0	12	0	0	12	0	0
13	64577532	rs9592311	A	G	15	0	15	0	0	15	0	0
13	64608552	rs269583	G	T	9	0	9	0	0	9	0	0
13	73284411	rs7931	A	T	57	43	100	0	0	100	0	0
13	73328533	rs7139790	T	G	4	2	6	0	1	7	0	0
13	73329086	rs8002668	G	A	3	4	7	0	0	7	0	0
13	73329358	rs10887	G	A	17	13	30	0	0	30	0	0
13	73331854	rs55686035	C	T	4	3	7	0	0	7	0	0
13	73331944	rs2165390	T	C	3	4	7	0	0	7	0	0
13	73338175	rs4885043	G	A	16	11	27	0	0	27	0	0
13	73338848	rs7988394	T	C	6	10	16	0	0	16	0	0
13	73339232	rs2325495	A	G	3	3	6	0	0	6	0	0
13	73343039	rs2196979	C	T	83	69	152	0	0	152	0	0
13	73349359	rs7332388	G	C	79	87	166	0	1	168	1	0
13	73369642	rs1372000	A	G	11	7	18	0	0	18	0	0
13	76141721	rs73223968	C	A	5	1	6	0	0	6	0	0
13	77567347	.	C	T	4	3	7	0	0	7	0	0
13	77583590	.	G	C	5	2	7	0	0	7	0	0
13	77597480	.	A	T	26	19	45	0	0	45	0	0
13	77674459	rs78187980	C	T	6	6	12	0	0	12	0	0
13	78273671	rs7339291	T	G	4	4	8	0	0	8	0	0
13	78273690	rs7337726	A	G	3	3	6	0	0	6	0	0
13	78273878	rs117125834	C	G	5	2	7	0	0	7	0	0
13	78280930	rs118182699	A	T	5	4	9	0	0	9	0	0
13	78337961	rs55937311	C	G	10	7	17	0	0	17	0	0
13	78338016	rs9600927	A	G	12	11	23	0	0	23	0	0
13	80910792	rs700397	T	G	15	6	21	0	0	21	0	0
13	82264343	rs7326041	A	G	14	3	17	0	0	17	0	0
13	82264468	rs9574945	G	A	26	0	26	0	3	29	0	0
13	96396605	rs9590321	C	A	5	2	7	0	0	7	0	0
13	96407088	rs16951334	A	G	2	4	6	0	0	6	0	0
13	96407242	rs7321625	A	G	4	4	8	0	0	8	0	0
13	96408119	rs9561948	C	T	7	7	14	0	0	14	0	0
13	97930890	rs6491347	A	G	30	21	51	0	0	51	0	0
13	97931564	rs9516887	G	A	21	16	37	0	0	37	0	0
13	97931709	rs9516888	A	G	19	25	44	0	1	45	0	0
13	97938717	rs9513226	C	T	3	3	6	0	0	6	0	0
13	98117164	rs2389910	A	G	3	4	7	0	0	7	0	0
13	99101869	rs4584	G	C	4	2	6	0	0	6	0	0
13	99102607	rs3742136	C	T	4	2	6	0	0	6	0	0
13	99103317	rs7983438	T	C	1	10	11	0	0	11	0	0
13	99104004	rs7988959	T	C	8	15	23	0	0	23	0	0
13	99105302	rs12463	G	A	220	278	498	0	1	499	0	0
13	99105395	rs8481	G	A	184	221	405	0	5	410	0	0
13	99106979	rs9630321	C	G	1	7	8	0	0	8	0	0
13	99109319	rs2031237	C	A	5	2	7	0	1	8	0	0
13	99111209	rs3783006	G	C	6	2	8	0	0	8	0	0
13	99116384	rs17574378	T	C	3	7	10	0	0	10	0	0
13	99117149	rs3803253	G	A	4	4	8	0	0	8	0	0
13	99117685	rs7988345	A	G	8	9	17	0	0	17	0	0
13	99118590	rs9584854	C	T	17	13	30	0	0	30	0	0
13	99138057	rs17574433	G	A	6	7	13	0	0	13	0	0
13	99141272	rs912337	C	T	5	2	7	0	0	7	0	0
13	99142745	rs7338549	C	T	3	3	6	0	0	6	0	0
13	99155593	rs7983408	G	C	1	5	6	0	1	7	0	0
13	99157398	rs10508036	C	G	12	17	29	0	0	29	0	0
13	99157529	rs3742133	G	A	13	8	21	0	0	21	0	0
13	99158924	rs9513433	C	T	7	6	13	0	0	13	0	0
13	99168721	rs17471079	C	T	4	3	7	0	0	7	0	0
13	99170232	rs61969454	T	C	5	21	26	0	0	26	0	0
13	99170520	rs4772093	G	A	29	73	102	0	1	103	0	0
13	99171040	rs17574536	G	A	6	8	14	0	0	14	0	0
13	99944235	rs9517673	A	T	2	5	7	0	0	7	0	0
13	99946371	rs9284183	G	A	1	9	10	0	0	10	0	0
13	99949983	rs1887703	C	T	5	5	10	0	0	10	0	0
13	99955437	rs12859788	G	A	10	4	14	0	0	14	0	0
13	99955533	rs1927728	T	C	1	7	8	0	0	8	0	0
13	99957987	rs4772186	G	A	6	7	13	0	0	13	0	0
13	99958565	rs1927730	T	C	8	7	15	0	0	15	0	0
13	100011671	rs2146677	A	T	4	2	6	0	0	6	0	0
13	100012764	rs9517697	T	C	3	3	6	0	0	6	0	0
13	100017105	rs723090	A	G	4	4	8	0	0	8	0	0
13	100029555	rs12861519	A	C	4	4	8	0	0	8	0	0
13	100190504	rs9585118	A	G	11	9	20	0	0	20	0	0
13	100191427	rs4433672	G	A	5	5	10	0	0	10	0	0
13	100192140	rs17472806	G	A	5	11	16	0	0	16	0	0
13	100194838	rs34656004	C	T	6	5	11	0	0	11	0	0
13	100196608	rs9585122	C	A	7	3	10	0	0	10	0	0
13	100198071	rs28574951	G	A	4	17	21	0	0	21	0	0
13	100199224	rs3751373	C	T	17	10	27	0	0	27	0	0
13	100200172	rs4771335	T	C	10	6	16	0	1	17	0	0
13	100201026	rs4586288	C	T	12	19	31	0	0	31	0	0
13	100203573	rs7321735	C	T	5	3	8	0	0	8	0	0
13	100204167	rs9888453	A	G	5	8	13	0	0	13	0	0
13	100205332	rs9585127	C	T	6	6	12	0	0	12	0	0
13	100205523	rs71439609	G	A	8	6	14	0	0	14	0	0
13	100213186	rs9513628	C	G	16	14	30	0	0	30	0	0
13	100518580	rs3783185	A	G	3	9	12	0	0	12	0	0
13	100962156	rs35719359	A	G	6	10	16	0	0	16	0	0
13	101277414	rs9513774	G	A	10	6	16	0	0	16	0	0
13	101287340	rs946837	C	T	18	25	43	0	0	43	0	0
13	101287404	rs2297943	G	A	20	20	40	0	0	40	0	0
13	101322622	rs1283201	G	C	10	8	18	0	0	18	0	0
13	103262159	rs9518795	C	T	3	7	10	0	0	10	0	0
13	103262879	rs9518797	T	C	5	3	8	0	0	8	0	0
13	103266896	rs4307812	A	G	6	3	9	0	0	9	0	0
13	103269466	rs2148763	G	A	8	4	12	0	0	12	0	0
13	103270897	.	G	T	4	4	8	0	0	8	0	0
13	103275495	rs17507043	C	T	33	14	47	0	0	47	0	0
13	103276153	rs7336551	G	A	14	9	23	0	0	23	0	0
13	103306094	rs8000233	T	G	3	7	10	0	0	10	0	0
13	103331096	.	C	T	20	26	46	0	0	46	0	0
13	103498375	rs2296147	T	C	13	13	26	0	0	26	0	0
13	103500087	rs7326943	C	G	1	6	7	0	0	7	0	0
13	103503791	rs4150258	C	T	0	6	6	0	0	6	0	0
13	103504517	rs1047768	T	C	39	39	78	0	1	79	0	0
13	103515992	rs4150324	C	T	12	11	23	0	0	23	0	0
13	107206874	rs111699780	G	C	3	4	7	0	0	7	0	0
13	108870855	.	C	G	17	17	34	0	0	34	0	0
13	108960057	rs41305244	G	A	4	2	6	0	0	6	0	0
13	108960188	rs4145212	T	A	7	5	12	0	1	13	0	0
13	110407815	rs2289047	C	A	312	223	535	0	3	538	0	0
13	110407906	rs2289046	T	C	155	121	276	0	3	279	0	0
13	110409336	.	A	C	15	13	28	0	1	29	0	0
13	110411568	rs754204	C	T	10	14	24	0	0	24	0	0
13	110411642	rs754205	A	C	13	14	27	0	0	27	0	0
13	110413514	rs58120907	G	A	11	17	28	0	0	28	0	0
13	110413540	rs8001323	G	A	17	13	30	0	0	30	0	0
13	110413817	rs4771644	G	A	7	12	19	0	0	19	0	0
13	110415132	rs147790135	C	T	5	9	14	0	0	14	0	0
13	110416393	rs874016	G	A	10	11	21	0	1	22	0	0
13	110419404	rs9559646	C	T	16	13	29	0	0	29	0	0
13	110420133	rs1967911	G	A	4	3	7	0	0	7	0	0
13	110420832	rs9521508	A	T	4	11	15	0	0	15	0	0
13	110421451	rs9521509	C	T	3	4	7	0	1	8	0	0
13	110421674	rs4773087	G	A	5	5	10	0	0	10	0	0
13	110422391	rs9515120	C	T	2	7	9	0	0	9	0	0
13	110424498	rs4547213	G	A	84	51	135	0	1	136	0	0
13	110424972	rs60925199	A	T	27	45	72	0	0	72	0	0
13	110425076	rs12584130	G	C	16	12	28	0	0	28	0	0
13	110425082	rs59962460	C	T	15	11	26	0	2	28	0	0
13	110426000	rs7999797	G	A	7	4	11	0	0	11	0	0
13	110426871	rs9521510	T	C	3	6	9	0	0	9	0	0
13	110431574	rs7981170	C	T	23	27	50	0	0	50	0	0
13	110431626	rs4771648	G	A	27	20	47	0	0	47	0	0
13	110431891	rs7981705	C	T	27	24	51	0	0	51	0	0
13	110434310	rs11618950	G	A	5	9	14	0	0	14	0	0
13	110435231	rs1805097	C	T	145	120	265	0	1	266	0	0
13	110435302	rs9583424	T	C	25	15	40	0	0	40	0	0
13	111176393	rs419244	A	G	78	53	131	0	0	131	0	0
13	111176519	rs375814	G	T	62	53	115	0	1	116	0	0
13	111176616	rs1062004	G	T	2	5	7	0	0	7	0	0
13	111176718	rs393961	A	G	8	9	17	0	0	17	0	0
13	111176764	rs417402	G	C	5	5	10	0	0	10	0	0
13	111176773	rs364979	C	T	5	5	10	0	0	10	0	0
13	111210520	rs9521841	C	T	3	6	9	0	0	9	0	0
13	111280002	rs3742193	T	C	5	7	12	0	0	12	0	0
13	111280078	rs3742194	G	C	4	6	10	0	0	10	0	0
13	111280712	rs1041143	G	T	5	6	11	0	0	11	0	0
13	111280738	rs2011692	C	T	4	4	8	0	0	8	0	0
13	111281252	rs7995119	C	T	5	2	7	0	0	7	0	0
13	111281516	rs9588209	G	T	4	3	7	0	1	8	0	0
13	111281600	rs2148081	C	T	3	8	11	0	0	11	0	0
13	111281614	rs1041173	G	T	3	8	11	0	0	11	0	0
13	111282749	rs7322067	T	A	2	8	10	0	0	10	0	0
13	111283497	rs72661645	G	A	4	4	8	0	0	8	0	0
13	111283708	rs3825466	A	G	3	8	11	0	0	11	0	0
13	111283809	rs3783097	A	C	6	13	19	0	0	19	0	0
13	111284367	rs78587540	G	A	10	4	14	0	0	14	0	0
13	111284368	rs9583518	G	C	4	10	14	0	0	14	0	0
13	111284759	rs113942509	C	T	4	7	11	0	0	11	0	0
13	111284812	rs144684178	G	A	4	6	10	0	0	10	0	0
13	111284941	rs55794132	C	G	13	1	14	0	0	14	0	0
13	111285098	rs111281134	C	G	3	7	10	0	0	10	0	0
13	111285326	rs371162	C	T	7	6	13	0	0	13	0	0
13	111285509	rs113257991	C	T	4	2	6	0	0	6	0	0
13	111285807	rs2986320	G	T	6	1	7	0	0	7	0	0
13	111285837	rs11620520	T	C	1	7	8	0	0	8	0	0
13	111286546	rs7323602	G	T	1	8	9	0	0	9	0	0
13	111286592	rs3759463	C	T	11	2	13	0	1	14	0	0
13	111286607	rs179356	G	A	12	3	15	0	0	15	0	0
13	111287304	rs3742196	T	C	4	16	20	0	0	20	0	0
13	111287344	rs72661656	C	T	7	18	25	0	0	25	0	0
13	111287552	rs72661657	C	T	9	19	28	0	0	28	0	0
13	111288461	rs330572	A	G	9	14	23	0	0	23	0	0
13	111288716	rs79481071	G	A	12	11	23	0	0	23	0	0
13	111289698	rs3825467	A	G	11	15	26	0	0	26	0	0
13	111290220	rs9588214	A	G	9	20	29	0	0	29	0	0
13	111290258	rs77982490	C	T	10	17	27	0	2	29	0	0
13	111290364	rs191322	C	A	23	11	34	0	0	34	0	0
13	111290630	rs41275126	T	C	19	12	31	0	0	31	0	0
13	111290967	rs41275128	T	C	48	25	73	0	0	73	0	0
13	111291538	rs16940507	T	C	67	45	112	0	1	113	0	0
13	111291622	rs11551105	G	A	70	53	123	0	1	124	0	0
13	111291818	rs2274411	C	T	52	41	93	0	1	94	0	0
13	111293847	rs330570	G	A	73	50	123	0	0	124	1	0
13	111293915	rs1043886	T	G	102	86	188	0	0	188	0	0
13	111296024	rs4771702	G	A	5	13	18	0	0	18	0	0
13	111296124	rs4771703	A	G	6	13	19	0	1	20	0	0
13	111296170	rs4771704	C	T	4	11	15	0	0	15	0	0
13	111298906	rs413235	T	C	4	3	7	0	0	7	0	0
13	111299061	rs450565	C	T	4	2	6	0	0	6	0	0
13	111299813	rs410049	G	A	5	3	8	0	0	8	0	0
13	111300897	rs451270	C	T	1	5	6	0	0	6	0	0
13	111300977	rs3742201	G	A	5	1	6	0	0	6	0	0
13	111301543	rs451575	C	G	4	5	9	0	0	9	0	0
13	111318836	rs12584848	G	A	4	4	8	0	0	8	0	0
13	111365589	rs1441042	T	G	4	2	6	0	1	7	0	0
13	111368316	rs9555726	C	T	23	22	45	0	0	45	0	0
13	111372460	rs9588246	G	A	77	50	127	0	0	127	0	0
13	111537997	.	G	C	7	3	10	0	0	10	0	0
13	111538047	rs7332528	A	G	5	2	7	0	0	7	0	0
13	111538096	rs9588291	C	T	9	2	11	0	1	12	0	0
13	111540010	rs9588292	T	C	3	5	8	0	0	8	0	0
13	111543277	rs72665842	G	A	9	7	16	0	0	16	0	0
13	111549315	rs9559902	C	T	25	16	41	0	1	42	0	0
13	111549982	rs9521984	G	C	73	68	141	0	0	141	0	0
13	111550037	rs75301542	G	A	74	53	127	0	0	127	0	0
13	111550388	rs9559903	C	T	29	22	51	0	2	53	0	0
13	111551171	rs143847622	C	T	14	26	40	0	0	40	0	0
13	111553839	rs9521986	A	G	11	10	21	0	0	21	0	0
13	111556343	rs2391876	A	T	25	20	45	0	0	45	0	0
13	111564228	rs9515311	C	T	20	15	35	0	0	35	0	0
13	111566207	rs9588297	G	C	10	15	25	0	0	25	0	0
13	111566253	rs78000479	C	T	12	15	27	0	0	27	0	0
13	111566412	rs9583546	G	C	12	6	18	0	0	18	0	0
13	111566432	rs9583547	A	G	12	7	19	0	0	19	0	0
13	111567039	rs56924528	G	C	4	3	7	0	0	7	0	0
13	111766981	rs7321389	A	C	5	3	8	0	0	8	0	0
13	111767056	rs9555770	G	T	4	5	9	0	0	9	0	0
13	111806245	rs61966721	A	G	14	13	27	0	0	27	0	0
13	111807304	rs7330975	T	C	3	5	8	0	0	8	0	0
13	111808969	rs4771733	A	G	6	9	15	0	0	15	0	0
13	111809092	rs78575102	G	A	3	4	7	0	0	7	0	0
13	111843571	rs4773332	A	G	2	6	8	0	0	8	0	0
13	111845342	rs56253113	A	G	4	4	8	0	0	8	0	0
13	111849733	rs72653503	G	T	2	4	6	0	0	6	0	0
13	111854193	rs1164270	C	T	3	4	7	0	0	7	0	0
13	111855227	.	C	A	4	3	7	0	0	7	0	0
13	111858940	rs9515390	T	A	9	5	14	0	0	14	0	0
13	111859810	rs3783094	T	C	13	6	19	0	0	19	0	0
13	111859862	rs9515391	C	T	7	4	11	0	0	11	0	0
13	111860639	rs12865137	T	C	12	5	17	0	0	17	0	0
13	111861523	rs3783092	T	G	3	6	9	0	0	9	0	0
13	111861607	rs4771735	G	A	3	7	10	0	0	10	0	0
13	111861627	rs3783090	A	G	3	7	10	0	0	10	0	0
13	111866073	.	A	G	5	1	6	0	0	6	0	0
13	111867900	rs72653522	C	T	4	2	6	0	0	6	0	0
13	111869055	rs7995910	A	G	4	3	7	0	0	7	0	0
13	111870530	rs9515394	T	A	11	6	17	0	0	17	0	0
13	111870925	rs9522159	A	G	11	6	17	0	0	17	0	0
13	111871757	rs9522160	C	T	4	11	15	0	0	15	0	0
13	111872386	rs9515396	G	A	12	6	18	0	0	18	0	0
13	111873001	rs61967969	C	T	9	5	14	0	0	14	0	0
13	111873296	rs536591663	G	T	5	5	10	0	1	11	0	0
13	111874268	rs56383703	G	A	7	14	21	0	0	21	0	0
13	111874440	rs56047737	C	T	6	11	17	0	0	17	0	0
13	111875790	rs72653524	T	C	6	5	11	0	0	11	0	0
13	111876267	rs9522162	A	G	3	4	7	0	0	7	0	0
13	111876298	rs9522163	G	A	3	6	9	0	0	9	0	0
13	111876420	rs7989545	C	T	8	10	18	0	0	18	0	0
13	111876753	rs7990085	A	G	7	7	14	0	0	14	0	0
13	111877000	rs9522165	T	A	3	8	11	0	1	12	0	0
13	111877428	rs9522166	T	C	13	9	22	0	1	23	0	0
13	111878531	rs12874510	A	G	12	18	30	0	0	30	0	0
13	111879543	rs75446493	G	T	8	13	21	0	1	22	0	0
13	111879689	rs4771738	C	T	16	9	25	0	1	26	0	0
13	111879786	rs4773337	C	T	12	11	23	0	0	23	0	0
13	111880815	rs7982732	G	A	12	13	25	0	0	25	0	0
13	111881051	rs72653526	G	C	24	26	50	0	0	50	0	0
13	111881742	rs72653527	A	G	15	17	32	0	0	32	0	0
13	111882203	rs61967972	C	T	11	5	16	0	0	16	0	0
13	111883067	rs7331778	A	G	24	12	36	0	0	36	0	0
13	111883089	rs72653529	C	T	14	23	37	0	0	37	0	0
13	111884546	rs9522168	T	C	16	10	26	0	1	27	0	0
13	111884732	rs55721098	G	A	14	19	33	0	1	34	0	0
13	111885219	rs72653532	C	T	14	21	35	0	0	35	0	0
13	111886867	rs72653534	C	T	5	2	7	0	0	7	0	0
13	111892237	rs56090602	G	C	14	5	19	0	0	19	0	0
13	111892394	rs11619224	C	T	8	5	13	0	0	13	0	0
13	111892621	rs55746920	G	A	7	4	11	0	0	11	0	0
13	111892888	rs143824499	C	T	12	4	16	0	0	16	0	0
13	111904199	rs7994267	C	T	2	5	7	0	0	7	0	0
13	111924667	rs147207815	G	A	5	5	10	0	0	10	0	0
13	111931676	rs117857244	G	A	16	11	27	0	0	27	0	0
13	111932913	rs41275846	G	A	66	69	135	0	0	135	0	0
13	111933290	rs2951	G	A	23	25	48	0	0	48	0	0
13	111933998	rs7983485	C	T	25	17	42	0	0	42	0	0
13	111935077	rs55850030	C	T	19	22	41	0	0	41	0	0
13	111937016	rs150911920	C	T	23	31	54	0	0	54	0	0
13	111937652	rs7985658	C	T	13	14	27	0	0	27	0	0
13	111937709	rs75596282	G	A	12	14	26	0	0	26	0	0
13	111941817	rs144847075	G	A	8	13	21	0	0	21	0	0
13	111943932	rs9515399	G	A	9	16	25	0	1	26	0	0
13	111944866	rs4145274	A	G	19	38	57	0	0	57	0	0
13	111946651	rs41275852	C	T	33	32	65	0	1	66	0	0
13	111947173	rs45617435	T	G	28	17	45	0	0	45	0	0
13	111947494	rs182200658	A	T	3	5	8	0	0	8	0	0
13	111949022	rs151000955	T	C	5	2	7	0	0	7	0	0
13	111949253	rs4773340	G	A	6	11	17	0	0	17	0	0
13	111951269	rs146195222	A	C	5	10	15	0	0	15	0	0
13	111951817	rs192383114	G	A	4	2	6	0	0	6	0	0
13	111952240	rs9522177	T	C	3	4	7	0	0	7	0	0
13	111952852	rs150487845	G	A	14	10	24	0	0	24	0	0
13	111954634	rs4773341	G	A	8	10	18	0	1	19	0	0
13	111956781	rs145101446	A	G	80	82	162	0	1	163	0	0
13	113140196	rs182262883	G	A	32	24	56	0	0	56	0	0
13	113153114	rs9549532	T	C	8	9	17	0	0	17	0	0
13	113174003	rs112509508	A	C	2	5	7	0	0	7	0	0
13	113186474	rs7983260	C	T	2	4	6	0	0	6	0	0
13	113188574	rs9324309	A	C	4	2	6	0	0	6	0	0
13	113191777	rs9604342	T	C	5	1	6	0	0	6	0	0
13	113195412	rs75114025	T	A	0	6	6	0	0	6	0	0
13	113198451	rs9604351	C	T	2	8	10	0	0	10	0	0
13	113198493	rs9603906	C	T	5	5	10	0	0	10	0	0
13	113198496	rs9549539	A	G	5	5	10	0	0	10	0	0
13	113198538	rs9604352	C	A	5	5	10	0	0	10	0	0
13	113198563	rs9604353	C	G	6	3	9	0	0	9	0	0
13	113199732	rs8001880	T	C	12	11	23	0	0	23	0	0
13	113200460	rs17121253	C	T	4	5	9	0	0	9	0	0
13	113201467	rs9604354	A	G	12	12	24	0	0	24	0	0
13	113201471	rs9604355	A	C	11	16	27	0	1	28	0	0
13	113201819	rs41288616	C	T	22	20	42	0	0	42	0	0
13	113201879	rs41288620	C	T	27	11	38	0	1	39	0	0
13	113203686	rs59124062	T	A	5	3	8	0	0	8	0	0
13	113204768	rs114718007	A	C	4	7	11	0	0	11	0	0
13	113205463	rs9604356	C	T	2	4	6	0	0	6	0	0
13	113206738	rs9604358	G	A	2	7	9	0	0	9	0	0
13	113208083	rs9603908	G	A	8	3	11	0	0	11	0	0
13	113212352	rs2296535	T	C	16	9	25	0	0	25	0	0
13	113346107	rs423117	C	T	2	4	6	0	0	6	0	0
13	113346317	rs420431	C	G	6	3	9	0	0	9	0	0
13	113355498	rs188166	T	C	3	4	7	0	0	7	0	0
13	113359336	rs99126	G	C	6	2	8	0	0	8	0	0
13	113362105	rs282573	G	A	3	6	9	0	0	9	0	0
13	113363300	rs695163	G	A	2	7	9	0	0	9	0	0
13	113370140	rs410948	C	T	4	3	7	0	1	8	0	0
13	113370228	rs394369	A	G	3	5	8	0	0	8	0	0
13	113370627	rs7989810	C	T	4	3	7	0	0	7	0	0
13	113370892	rs7982570	T	C	4	9	13	0	0	13	0	0
13	113370966	rs10874477	C	G	2	8	10	0	0	10	0	0
13	113371507	rs282569	T	C	4	2	6	0	0	6	0	0
13	113373490	rs282565	C	T	3	6	9	0	0	9	0	0
13	113491286	rs653459	A	T	2	6	8	0	0	8	0	0
13	113493317	rs415159	T	G	3	3	6	0	0	6	0	0
13	113493508	rs365659	T	C	1	7	8	0	0	8	0	0
13	113496002	rs2013434	T	C	5	5	10	0	0	10	0	0
13	113496221	rs7335174	T	C	3	7	10	0	0	10	0	0
13	113497586	rs6577116	T	C	2	4	6	0	0	6	0	0
13	113499169	.	C	T	4	3	7	0	0	7	0	0
13	113508839	rs9549573	G	C	11	27	38	0	0	38	0	0
13	113509919	rs3742230	A	G	1	10	11	0	0	11	0	0
13	113532990	rs1278761	T	C	19	10	29	0	0	29	0	0
13	113533365	rs1278762	A	G	11	11	22	0	1	23	0	0
13	113533594	rs1278763	G	C	5	3	8	0	0	8	0	0
13	113533651	rs1765871	C	A	4	4	8	0	0	8	0	0
13	113533653	rs1765762	G	T	3	4	7	0	0	7	0	0
13	113533876	rs1278764	G	A	11	15	26	0	0	26	0	0
13	113534043	rs1278765	C	T	9	8	17	0	1	18	0	0
13	113534382	rs1278766	T	C	8	4	12	0	0	12	0	0
13	113535949	rs1278768	G	C	6	7	13	0	1	14	0	0
13	113536132	rs1290177	T	C	19	14	33	0	0	33	0	0
13	113536627	rs1278769	A	G	34	31	65	0	0	65	0	0
13	113537267	rs7985702	T	C	23	38	61	0	0	61	0	0
13	113537311	rs3742232	C	T	23	33	56	0	1	57	0	0
13	113537452	rs1278770	T	C	39	27	66	0	0	66	0	0
13	113539523	rs1063098	G	A	37	27	64	0	0	64	0	0
13	113539894	rs1046793	C	T	51	39	90	0	0	90	0	0
13	113540004	rs1046790	T	C	39	33	72	0	1	73	0	0
13	113875080	rs56129102	C	T	17	18	35	0	0	35	0	0
13	113883210	rs182041340	G	A	5	6	11	0	0	11	0	0
13	113918770	rs11552924	A	C	32	51	83	0	0	83	0	0
13	113951698	rs188339460	C	A	4	2	6	0	0	6	0	0
13	113951722	rs7983578	C	T	9	11	20	0	0	20	0	0
13	113951729	rs144852732	C	T	15	11	26	0	1	27	0	0
13	113975828	rs9604066	G	C	21	22	43	0	7	50	0	0
13	114110660	rs14067	A	G	20	21	41	0	0	41	0	0
13	114112008	rs3814255	G	A	12	6	18	0	0	18	0	0
13	114112287	rs3814254	C	A	20	17	37	0	0	37	0	0
13	114122345	rs112551784	C	T	3	3	6	0	0	6	0	0
13	114128382	rs74378879	G	A	4	2	6	0	0	6	0	0
13	114138733	rs2260803	A	G	4	7	11	0	0	11	0	0
13	114141136	rs2260892	T	C	5	3	8	0	0	8	0	0
13	114141447	rs2260897	C	A	3	3	6	0	0	6	0	0
13	114142061	rs12428611	T	C	4	3	7	0	0	7	0	0
13	114147997	rs2261163	T	C	10	18	28	0	0	28	0	0
13	114148720	rs11617768	T	C	28	44	72	0	1	73	0	0
13	114150107	rs11164135	C	T	454	506	960	0	8	968	0	0
13	114153588	rs2265153	C	T	2	4	6	0	0	6	0	0
13	114156473	rs3829403	A	G	2	4	6	0	0	6	0	0
13	114157650	rs2248742	C	T	3	3	6	0	0	6	0	0
13	114158900	rs2265152	C	T	18	21	39	0	0	39	0	0
13	114175038	rs7319493	G	A	182	241	423	0	5	428	0	0
13	114189122	rs8000521	T	C	9	19	28	0	4	32	0	0
13	114204255	rs11699	A	G	57	60	117	0	4	121	0	0
13	114204369	rs1046518	G	A	53	34	87	0	1	88	0	0
13	114462263	rs137968415	G	A	3	7	10	0	0	10	0	0
13	114502416	rs7400029	T	C	1	6	7	0	0	7	0	0
13	114514918	rs34217684	T	A	2	4	6	0	0	6	0	0
13	114747391	rs11672	C	T	108	95	203	0	2	205	0	0
13	114748709	rs11147333	G	A	79	92	171	0	0	171	0	0
13	114752572	rs61967984	C	T	5	2	7	0	0	7	0	0
13	114757361	rs867438	C	T	5	2	7	0	0	7	0	0
13	114757368	rs61967987	G	A	2	5	7	0	0	7	0	0
13	114762566	rs7321908	C	G	2	4	6	0	0	6	0	0
13	114762917	rs7317997	G	A	9	8	17	0	0	17	0	0
13	114763348	rs61968018	G	A	3	7	10	0	0	10	0	0
13	114763969	rs9562061	C	T	1	5	6	0	0	6	0	0
13	114764062	rs74629485	A	G	3	5	8	0	0	8	0	0
13	114764473	rs61968019	T	A	4	5	9	0	0	9	0	0
13	114773126	rs9562086	C	T	9	4	13	0	0	13	0	0
13	114773188	rs61971856	A	G	8	6	14	0	0	14	0	0
13	114774582	rs6560940	C	T	4	5	9	0	1	10	0	0
13	114774952	rs41291211	C	T	16	9	25	0	0	25	0	0
13	114774991	rs41291213	C	T	14	9	23	0	0	23	0	0
13	114775345	rs2297098	C	T	8	14	22	0	0	22	0	0
13	114775816	rs2297103	G	T	10	6	16	0	0	16	0	0
13	114821075	rs4393438	T	C	5	9	14	0	0	14	0	0
13	114821567	rs9525360	C	T	9	17	26	0	2	28	0	0
13	114825147	rs4883647	T	C	3	3	6	0	0	6	0	0
13	114825392	rs8001669	A	G	4	4	8	0	0	8	0	0
13	114848707	rs7329987	C	A	3	3	6	0	0	6	0	0
13	114848948	rs9525387	C	T	5	5	10	0	0	10	0	0
13	114848963	rs9525388	G	A	4	3	7	0	0	7	0	0
13	114891196	rs9525277	T	C	9	14	23	0	1	24	0	0
13	114892219	rs12100141	C	T	6	3	9	0	0	9	0	0
13	114893318	rs72659587	A	G	6	4	10	0	0	10	0	0
13	114895511	rs4883651	G	A	5	3	8	0	0	8	0	0
13	114895565	rs4883652	G	A	5	2	7	0	0	7	0	0
13	114896754	rs12866241	C	T	0	6	6	0	0	6	0	0
13	115010254	rs3211416	C	T	17	5	22	0	0	22	0	0
13	115052933	rs1135496	G	T	52	62	114	0	0	114	0	0
13	115052938	rs1135498	T	C	50	61	111	0	0	111	0	0
14	20733977	rs78595546	C	T	4	3	7	0	0	7	0	0
14	20762066	rs11623837	A	G	2	4	6	0	0	6	0	0
14	20764585	rs1953552	A	C	32	26	58	0	0	58	0	0
14	20770036	rs3742945	T	C	15	19	34	0	0	34	0	0
14	20784718	rs1132644	G	T	207	174	381	0	2	385	2	0
14	20786432	rs76311431	C	G	1	11	12	0	0	12	0	0
14	20834548	rs1713419	A	G	13	15	28	0	0	28	0	0
14	20834809	rs1713418	A	G	9	15	24	0	0	24	0	0
14	20837033	rs2104978	T	C	28	28	56	0	2	58	0	0
14	20844383	rs2228042	C	T	14	20	34	0	0	34	0	0
14	20845521	rs2229101	A	C	13	19	32	0	0	32	0	0
14	20846950	rs8022805	C	T	14	6	20	0	0	20	0	0
14	20849169	rs2228039	G	A	8	7	15	0	0	15	0	0
14	20850093	rs1713456	C	T	10	8	18	0	0	18	0	0
14	20852029	rs1760904	A	G	4	6	10	0	0	10	0	0
14	20852267	rs2228041	C	T	8	9	17	0	0	17	0	0
14	20852817	rs1760903	G	A	7	2	9	0	0	9	0	0
14	20859205	rs872074	C	T	4	5	9	0	0	9	0	0
14	20864049	rs2228026	A	G	4	6	10	0	1	11	0	0
14	20872863	rs6413437	A	G	6	6	12	0	0	12	0	0
14	20872881	rs1760898	G	T	6	4	10	0	0	10	0	0
14	20874411	rs61734876	T	C	2	8	10	0	0	10	0	0
14	20875789	rs112477401	C	T	5	2	7	0	0	7	0	0
14	20875973	rs1713438	A	G	2	4	6	0	0	6	0	0
14	20876189	rs10083536	G	A	3	3	6	0	0	6	0	0
14	20876253	rs1760897	A	G	4	3	7	0	0	7	0	0
14	20916958	rs938883	T	C	27	35	62	0	0	62	0	0
14	20917442	rs938881	A	T	7	19	26	0	0	26	0	0
14	20917665	rs999692	T	C	4	13	17	0	0	17	0	0
14	20917744	rs883037	C	T	5	10	15	0	0	15	0	0
14	20918113	rs8015086	A	G	7	7	14	0	0	14	0	0
14	20919551	rs3120068	C	T	4	3	7	0	0	7	0	0
14	20919712	rs3120065	C	T	5	1	6	0	0	6	0	0
14	20920043	rs1320150	C	T	6	4	10	0	0	10	0	0
14	20920250	rs2275007	T	C	21	12	33	0	0	33	0	0
14	20920340	rs2275006	A	G	6	1	7	0	0	7	0	0
14	20920749	rs1878703	C	G	5	2	7	0	0	7	0	0
14	21360216	rs2073342	C	G	7	10	17	0	0	17	0	0
14	21461502	rs2783779	A	G	12	4	16	0	0	16	0	0
14	21542753	rs1243472	G	A	8	9	17	0	0	17	0	0
14	21546354	rs61744857	C	T	7	11	18	0	0	18	0	0
14	21549893	rs7143633	G	C	4	5	9	0	0	9	0	0
14	21558558	rs6571653	G	C	8	5	13	0	0	13	0	0
14	21560086	.	C	A	12	15	27	0	0	27	0	0
14	21560706	rs1065496	C	G	4	3	7	0	0	7	0	0
14	21669028	rs56012312	C	T	9	1	10	0	0	10	0	0
14	21673133	rs199902517	A	G	8	8	16	0	0	18	2	0
14	21673369	rs72673100	C	A	7	7	14	0	0	14	0	0
14	21674392	rs1243371	C	T	6	6	12	0	1	13	0	0
14	21674544	rs55890853	A	T	8	9	17	0	0	17	0	0
14	21929010	rs143498328	G	T	18	23	41	0	0	41	0	0
14	22850761	rs12431642	A	G	4	3	7	0	0	7	0	0
14	22886992	rs2301200	C	T	1	5	6	0	0	6	0	0
14	22931940	.	C	A	1	5	6	0	0	6	0	0
14	22934658	rs11997	C	A	2	6	8	0	0	8	0	0
14	22942890	rs2254272	G	T	4	4	8	0	0	8	0	0
14	23020638	rs15795	T	C	24	16	40	0	0	40	0	0
14	23020921	rs3701	G	C	12	18	30	0	0	30	0	0
14	23021039	rs9125	G	A	5	6	11	0	0	11	0	0
14	23073195	rs7146001	G	A	2	7	9	0	0	9	0	0
14	23073552	rs1242921	G	A	4	2	6	0	0	6	0	0
14	23073608	rs1242922	T	C	3	6	9	0	0	9	0	0
14	23074509	rs1242923	C	T	4	5	9	0	0	9	0	0
14	23074899	rs1242924	C	T	6	12	18	0	0	18	0	0
14	23075075	rs1242925	C	T	11	9	20	0	0	20	0	0
14	23075116	rs1242926	C	T	17	10	27	0	0	27	0	0
14	23079120	rs1242931	C	T	5	1	6	0	0	6	0	0
14	23080679	rs3751480	A	G	81	51	132	0	3	135	0	0
14	23081223	rs9339	T	C	31	33	64	0	0	64	0	0
14	23240238	rs143046719	G	T	444	315	759	0	4	763	0	0
14	23282110	rs8018462	A	G	3	4	7	0	0	7	0	0
14	23299286	rs4982685	T	C	71	69	140	0	0	140	0	0
14	23303641	rs4982686	A	C	11	6	17	0	0	17	0	0
14	23304051	rs1957371	C	T	6	3	9	0	0	9	0	0
14	23306048	rs1042703	C	T	8	3	11	0	2	13	0	0
14	23315331	rs743257	T	C	16	15	31	0	0	31	0	0
14	23348194	rs11623552	T	C	6	4	10	0	0	10	0	0
14	23348388	.	A	T	1	5	6	0	0	6	0	0
14	23348952	rs2295905	G	A	13	5	18	0	0	18	0	0
14	23349953	rs35956093	A	G	5	8	13	0	0	13	0	0
14	23350028	rs1142013	C	G	8	3	11	0	1	12	0	0
14	23371055	rs1127066	G	C	56	57	113	0	2	115	0	0
14	23375155	.	C	T	3	4	7	0	0	7	0	0
14	23391763	.	T	C	60	56	116	0	1	117	0	0
14	23426182	rs2273626	C	A	41	55	96	0	0	96	0	0
14	23530908	rs56402910	C	T	4	4	8	0	0	8	0	0
14	23532251	.	T	C	213	217	430	0	3	433	0	0
14	23532865	rs57315948	A	G	1	5	6	0	0	6	0	0
14	23533923	rs56066925	T	C	6	9	15	0	0	15	0	0
14	23541441	rs55833875	C	A	16	14	30	0	0	30	0	0
14	23542399	rs75568395	T	C	17	13	30	0	0	30	0	0
14	23546870	rs76260171	G	A	15	16	31	0	1	32	0	0
14	23549319	rs1885097	A	G	76	93	169	0	1	170	0	0
14	23549380	rs1885098	G	A	82	78	160	0	0	160	0	0
14	23549785	rs3811182	T	C	78	84	162	0	0	162	0	0
14	23565012	rs8003631	C	T	5	1	6	0	0	6	0	0
14	23746269	rs1057119	C	G	1	6	7	0	0	7	0	0
14	23754580	rs17256211	A	G	8	17	25	0	0	25	0	0
14	23779877	rs3210043	C	A	14	9	23	0	0	23	0	0
14	23792416	rs45508899	A	C	11	11	22	0	1	23	0	0
14	23793305	rs45528934	C	T	28	18	46	0	0	46	0	0
14	23940359	rs1028589	A	G	5	11	16	0	0	16	0	0
14	23942077	rs8007185	A	T	4	4	8	0	0	8	0	0
14	23942104	rs116868473	C	T	5	3	8	0	0	8	0	0
14	23943469	rs7151139	A	G	10	5	15	0	0	15	0	0
14	23943918	rs7154379	G	A	7	0	7	0	0	7	0	0
14	23944020	rs6573195	A	G	8	5	13	0	0	13	0	0
14	23944505	rs2236260	G	A	124	245	369	0	3	372	0	0
14	23944514	rs2236261	C	A	122	259	381	0	0	381	0	0
14	23945366	rs2295706	A	G	16	4	20	0	0	20	0	0
14	24033027	rs12897422	G	A	96	116	212	0	0	212	0	0
14	24456535	rs58058506	T	G	6	1	7	0	0	7	0	0
14	24457130	rs10144527	G	A	5	1	6	0	0	6	0	0
14	24458162	rs2273946	G	C	13	23	36	0	0	36	0	0
14	24460163	rs143973522	T	C	5	1	6	0	0	6	0	0
14	24461668	rs12434703	C	A	4	2	6	0	0	6	0	0
14	24627066	.	A	G	11	16	27	0	0	27	0	0
14	24643296	rs553765803	A	G	9	6	15	0	0	16	1	0
14	24643393	rs6573596	T	A	12	15	27	0	1	28	0	0
14	24647522	rs3736840	G	T	3	3	6	0	0	6	0	0
14	24735130	rs6573651	A	G	0	7	7	0	0	7	0	0
14	24735624	rs2877612	A	G	2	4	6	0	0	6	0	0
14	24740763	rs3818161	C	T	5	7	12	0	0	12	0	0
14	24760009	rs4568	G	A	21	18	39	0	0	39	0	0
14	24760808	rs1131941	C	T	14	11	25	0	0	25	0	0
14	24769663	rs11158632	T	G	5	6	11	0	1	12	0	0
14	24771080	rs4374085	T	C	3	4	7	0	0	7	0	0
14	24771101	rs4366641	C	T	3	4	7	0	0	7	0	0
14	24771285	rs4280164	G	A	14	20	34	0	0	34	0	0
14	24773387	rs2144494	T	C	23	27	50	0	1	51	0	0
14	24775846	rs2281472	C	T	35	27	62	0	1	63	0	0
14	24776457	rs11158634	C	G	10	15	25	0	0	25	0	0
14	24776769	rs11158635	G	T	18	15	33	0	0	33	0	0
14	24778643	rs2516564	C	T	5	4	9	0	0	9	0	0
14	24778674	rs2748543	C	A	4	3	7	0	0	7	0	0
14	24782958	rs2224123	T	A	3	6	9	0	0	9	0	0
14	24783414	rs2224122	G	C	12	5	17	0	0	17	0	0
14	24786293	rs4981503	T	G	4	6	10	0	0	10	0	0
14	24786976	rs3181384	T	C	3	11	14	0	0	14	0	0
14	24791571	rs12886362	A	C	2	4	6	0	0	6	0	0
14	24878485	rs12897153	G	A	9	11	20	0	1	21	0	0
14	24883887	rs8017377	G	A	15	6	21	0	0	21	0	0
14	24901249	rs3742520	A	C	28	23	51	0	1	52	0	0
14	24902050	.	A	G	70	58	128	0	1	129	0	0
14	24904154	rs10134603	A	G	16	17	33	0	0	33	0	0
14	24904240	rs112958656	G	A	13	14	27	0	0	27	0	0
14	31188832	rs2273519	G	A	2	4	6	0	0	6	0	0
14	31381351	rs2273171	T	C	15	15	30	0	1	31	0	0
14	31915673	rs13176	G	A	5	8	13	0	0	13	0	0
14	31915905	rs7153450	A	T	3	7	10	0	0	10	0	0
14	32329381	rs10136892	T	C	2	4	6	0	0	6	0	0
14	35242828	rs2275145	G	A	22	27	49	0	0	49	0	0
14	35257381	rs2184621	G	A	4	5	9	0	0	9	0	0
14	35259438	rs7157311	G	A	4	3	7	0	0	7	0	0
14	35260347	.	G	T	3	3	6	0	0	6	0	0
14	35332058	rs1200415	T	C	2	4	6	0	0	6	0	0
14	35334328	rs35265117	C	T	2	4	6	0	0	6	0	0
14	35336678	rs61988044	C	T	2	4	6	0	0	6	0	0
14	35337365	rs3783315	T	G	2	5	7	0	0	7	0	0
14	35343629	rs2145031	A	C	52	42	94	0	2	96	0	0
14	35345352	rs1950770	G	A	17	8	25	0	0	25	0	0
14	35396937	rs799453	A	T	8	0	8	0	0	8	0	0
14	35452257	rs12891473	T	C	8	15	23	0	0	23	0	0
14	35452302	rs799489	G	A	17	10	27	0	0	27	0	0
14	35495637	rs1955437	C	G	8	3	11	0	0	11	0	0
14	35495734	rs77262907	C	G	7	4	11	0	0	11	0	0
14	35496717	rs12892114	A	C	1	7	8	0	0	8	0	0
14	35497011	rs11625046	T	G	2	4	6	0	0	6	0	0
14	35497285	rs78609489	T	C	10	4	14	0	0	14	0	0
14	35498443	rs28577270	G	A	27	23	50	0	0	50	0	0
14	35498485	rs11540758	C	T	19	22	41	0	0	41	0	0
14	35515920	rs2295103	C	G	24	31	55	0	0	55	0	0
14	35565856	rs17091786	A	T	3	3	6	0	0	6	0	0
14	35567236	rs61989495	G	A	4	2	6	0	0	6	0	0
14	35569658	rs2415257	C	T	6	1	7	0	0	7	0	0
14	35570250	rs113590838	C	T	6	1	7	0	0	7	0	0
14	35570257	rs55805245	C	T	1	5	6	0	1	7	0	0
14	35570606	rs78124218	G	A	6	2	8	0	0	8	0	0
14	35581432	rs8020370	G	A	7	1	8	0	0	8	0	0
14	35581480	rs8021414	T	A	7	2	9	0	0	9	0	0
14	35735967	rs11156878	A	G	37	48	85	0	2	87	0	0
14	35745022	rs7158151	C	T	2	4	6	0	0	6	0	0
14	35746750	rs61988271	A	G	5	2	7	0	0	7	0	0
14	35747817	rs61988272	T	C	4	7	11	0	0	11	0	0
14	35857405	rs61988300	A	G	13	7	20	0	0	20	0	0
14	35872792	rs2233415	A	G	173	171	344	0	4	348	0	0
14	35873770	rs1957106	G	A	1720	1747	3467	0	10	3477	0	0
14	36768276	rs4900833	T	C	126	107	233	0	2	235	0	0
14	36770813	rs2025603	C	G	5	3	8	0	0	8	0	0
14	36772184	rs7140630	C	A	6	4	10	0	0	10	0	0
14	36772564	rs7141354	C	T	3	5	8	0	0	8	0	0
14	36775143	rs10139030	A	T	2	4	6	0	0	6	0	0
14	36778379	rs3850259	C	G	4	4	8	0	0	8	0	0
14	36781037	rs7154340	C	T	5	3	8	0	0	8	0	0
14	36781650	rs7155498	C	T	4	2	6	0	0	6	0	0
14	36781859	rs4900924	C	T	9	9	18	0	0	18	0	0
14	36782888	rs7141786	T	C	16	11	27	0	1	28	0	0
14	36782984	rs3805355	G	A	13	7	20	0	1	21	0	0
14	36783468	rs11156909	A	C	15	14	29	0	0	29	0	0
14	36783738	.	T	C	89	103	192	0	0	192	0	0
14	36789729	rs3168891	T	G	107	72	179	0	1	180	0	0
14	36789775	rs2899849	A	T	69	49	118	0	0	118	0	0
14	36789795	rs11558802	G	A	47	32	79	0	0	79	0	0
14	39553959	rs10140341	C	T	6	0	6	0	1	7	0	0
14	39617103	rs2869	T	C	4	9	13	0	0	13	0	0
14	39617711	rs28379470	G	A	4	6	10	0	1	11	0	0
14	39618412	rs12437405	T	C	7	4	11	0	1	12	0	0
14	39644498	rs1061583	G	A	134	120	254	0	3	257	0	0
14	39816401	rs7143942	A	T	1	5	6	0	0	6	0	0
14	39816781	rs12882375	C	T	4	2	6	0	0	6	0	0
14	39818145	rs1060878	G	A	94	91	185	0	1	186	0	0
14	39819734	rs8177	T	G	13	21	34	0	0	34	0	0
14	39869879	rs9322999	C	G	6	5	11	0	0	11	0	0
14	39870296	rs10146622	T	C	9	11	20	0	0	20	0	0
14	39871017	rs7156962	T	C	130	116	246	0	1	247	0	0
14	39871168	rs7157316	T	C	4	5	9	0	0	9	0	0
14	39872693	rs7142748	T	C	0	6	6	0	0	6	0	0
14	39898946	rs1998885	G	A	5	3	8	0	0	8	0	0
14	39901157	rs61999077	C	A	10	10	20	0	0	20	0	0
14	45394978	rs79030011	C	T	2	4	6	0	0	6	0	0
14	45468761	rs17115735	C	T	3	3	6	0	0	6	0	0
14	45469287	rs28690844	T	C	3	6	9	0	0	9	0	0
14	45681570	rs62000281	T	C	14	17	31	0	2	33	0	0
14	50051572	rs78522441	C	T	7	4	11	0	1	12	0	0
14	50051819	rs11629047	G	C	26	23	49	0	0	49	0	0
14	50052097	rs11621094	A	C	13	13	26	0	0	26	0	0
14	50066316	rs8015132	C	T	4	6	10	0	0	10	0	0
14	50066796	rs28405032	T	A	3	6	9	0	0	9	0	0
14	50067605	rs4127814	C	T	4	4	8	0	0	8	0	0
14	50074122	rs17121605	T	A	8	4	12	0	0	12	0	0
14	50074502	rs61754305	A	G	16	16	32	0	0	32	0	0
14	50074520	rs7148147	C	T	18	19	37	0	0	37	0	0
14	50085411	rs2985698	G	T	25	8	33	0	0	33	0	0
14	50085571	rs1054427	G	A	1093	988	2081	0	14	2095	0	0
14	50086276	rs3007040	G	A	5	33	38	0	0	38	0	0
14	50086640	rs12887767	G	A	8	15	23	0	0	23	0	0
14	50087753	rs7519	T	C	27	29	56	0	2	58	0	0
14	50089696	rs1011373	C	G	9	16	25	0	1	26	0	0
14	50092471	rs9989177	T	C	7	5	12	0	0	12	0	0
14	50131846	rs3218791	G	T	4	3	7	0	0	7	0	0
14	50234577	rs4391967	C	T	7	9	16	0	1	17	0	0
14	50234633	rs8012683	C	G	6	8	14	0	0	14	0	0
14	50236408	rs55928543	A	G	3	7	10	0	0	10	0	0
14	50250089	rs373088672	T	G	5	1	6	0	1	7	0	0
14	50254090	rs35343889	T	C	9	10	19	0	0	19	0	0
14	50267852	rs4900959	T	C	8	9	17	0	0	17	0	0
14	50575411	rs1044754	A	G	23	26	49	0	0	49	0	0
14	50575821	rs13950	G	A	22	19	41	0	0	41	0	0
14	50575839	rs10150798	T	C	21	12	33	0	0	33	0	0
14	50577237	rs1955928	T	C	6	3	9	0	0	9	0	0
14	50577310	rs1955929	A	G	8	3	11	0	0	11	0	0
14	50577617	rs2355667	T	G	6	1	7	0	0	7	0	0
14	50578441	rs11850720	A	C	5	7	12	0	0	12	0	0
14	50579651	rs12896684	A	C	24	11	35	0	1	36	0	0
14	50580135	rs2883739	C	T	24	14	38	0	2	40	0	0
14	50580213	rs4243566	T	A	26	13	39	0	0	39	0	0
14	50580485	rs11849389	A	T	8	2	10	0	0	10	0	0
14	50581716	rs2144577	C	T	13	4	17	0	0	17	0	0
14	50582118	rs4536369	C	T	10	11	21	0	0	21	0	0
14	50585865	rs7156414	A	G	1	5	6	0	0	6	0	0
14	50585996	rs72681826	A	G	3	4	7	0	1	8	0	0
14	50586415	rs9806016	G	A	4	5	9	0	0	9	0	0
14	50607143	rs2024809	G	A	2	4	6	0	0	6	0	0
14	50608084	rs4900990	A	T	2	4	6	0	0	6	0	0
14	50608207	rs117691084	C	A	6	2	8	0	0	8	0	0
14	50616878	rs2229869	G	A	74	53	127	0	0	127	0	0
14	50623657	rs3736759	G	A	7	1	8	0	0	8	0	0
14	50623679	rs3736760	G	A	5	3	8	0	0	8	0	0
14	50623683	rs3736761	A	G	6	3	9	0	0	9	0	0
14	50623685	rs553167605	A	G	6	3	9	0	0	9	0	0
14	50643932	rs4900994	A	T	6	2	8	0	0	8	0	0
14	50664402	rs10141570	A	T	3	3	6	0	0	6	0	0
14	50664458	rs8004524	A	G	4	2	6	0	0	6	0	0
14	50666263	rs1955924	C	T	6	4	10	0	0	10	0	0
14	50712569	rs7157035	A	G	3	10	13	0	0	13	0	0
14	50793384	rs10133342	T	A	16	13	29	0	0	29	0	0
14	50795068	rs6572658	A	C	3	3	6	0	0	6	0	0
14	50897643	rs11157744	T	C	5	4	9	0	0	9	0	0
14	50910675	rs35768475	C	G	44	50	94	0	2	97	1	0
14	50951356	rs80132397	G	A	3	3	6	0	0	6	0	0
14	50999181	rs118189385	C	T	8	7	15	0	0	15	0	0
14	51101641	rs2934693	G	A	2	4	6	0	0	6	0	0
14	51129534	rs8016337	A	G	6	11	17	0	0	17	0	0
14	51129996	rs10873037	T	C	3	4	7	0	0	7	0	0
14	51130492	rs12432920	T	C	14	10	24	0	0	24	0	0
14	51188341	rs10140023	A	G	23	15	38	0	0	38	0	0
14	51189057	rs75313789	T	G	16	11	27	0	0	27	0	0
14	51191413	rs149085237	G	T	57	37	94	0	0	94	0	0
14	51191676	rs2984270	C	T	56	31	87	0	3	90	0	0
14	51191734	rs1599969	C	T	42	26	68	0	0	68	0	0
14	51192659	rs1983764	G	A	77	84	161	0	0	161	0	0
14	51193213	rs2984272	A	T	23	23	46	0	0	46	0	0
14	51204996	rs11376	C	T	149	156	305	0	1	306	0	0
14	51207036	rs55744809	C	T	4	2	6	0	0	6	0	0
14	51208143	rs12891224	T	G	3	3	6	0	0	6	0	0
14	51210853	rs1547078	T	C	6	2	8	0	0	8	0	0
14	51224417	rs2236316	G	C	23	14	37	0	0	37	0	0
14	51225097	rs41299191	T	C	17	8	25	0	1	26	0	0
14	51227000	rs4901055	A	G	45	44	89	0	0	89	0	0
14	51237701	rs17793018	A	G	161	138	299	0	1	300	0	0
14	51245666	rs7143959	T	C	4	8	12	0	0	12	0	0
14	51259801	rs6572697	G	A	25	20	45	0	0	45	0	0
14	51259999	rs17122896	A	G	16	16	32	0	0	32	0	0
14	51262092	rs3783280	T	C	24	11	35	0	0	35	0	0
14	51262151	rs17122909	T	C	12	7	19	0	0	19	0	0
14	51262180	rs3783279	T	C	18	11	29	0	0	29	0	0
14	51262497	rs11157766	A	G	19	16	35	0	0	35	0	0
14	51263301	rs12881609	C	T	11	11	22	0	0	22	0	0
14	51263413	rs7145411	T	A	11	9	20	0	0	20	0	0
14	51269210	rs58424267	T	C	3	5	8	0	0	8	0	0
14	51270904	rs10137363	C	T	5	8	13	0	0	13	0	0
14	51276009	rs10145182	T	A	5	5	10	0	0	10	0	0
14	51276564	rs34845905	A	T	6	4	10	0	0	10	0	0
14	51279108	rs4901059	T	C	4	2	6	0	0	6	0	0
14	51279435	rs56839549	A	G	4	3	7	0	0	7	0	0
14	51279981	rs72683644	T	C	4	3	7	0	0	7	0	0
14	51283148	rs7149295	C	T	6	1	7	0	0	7	0	0
14	51352608	rs2297893	T	C	0	7	7	0	0	7	0	0
14	51390082	rs56120861	T	G	4	13	17	0	0	17	0	0
14	51410178	rs8014291	T	G	3	3	6	0	0	6	0	0
14	51710597	.	G	C	27	40	67	0	1	68	0	0
14	51714723	rs116823329	C	T	19	7	26	0	0	26	0	0
14	51716188	rs7161242	T	G	57	51	108	0	2	110	0	0
14	51716467	rs7160810	G	A	53	36	89	0	0	89	0	0
14	52349774	rs10131301	A	T	2	4	6	0	0	6	0	0
14	52365774	rs1316298	A	G	10	2	12	0	0	12	0	0
14	52371313	rs11157866	T	C	5	4	9	0	0	9	0	0
14	52379453	rs7143789	G	A	5	1	6	0	0	6	0	0
14	52470678	rs17831507	A	G	10	10	20	0	0	20	0	0
14	52794007	rs2229187	A	G	136	126	262	0	1	263	0	0
14	53175731	rs62005431	A	G	5	7	12	0	0	12	0	0
14	53175753	rs62005432	A	G	8	6	14	0	1	15	0	0
14	53177401	rs138870187	T	C	12	13	25	0	0	25	0	0
14	53240050	.	G	T	3	7	10	0	0	10	0	0
14	53784854	rs7148241	C	G	7	9	16	0	0	16	0	0
14	54894792	rs3783635	C	T	4	4	8	0	0	8	0	0
14	54897265	rs10400770	T	G	4	2	6	0	0	6	0	0
14	54900521	rs7157721	A	C	2	4	6	0	0	6	0	0
14	54947501	rs59955412	T	C	11	11	22	0	0	22	0	0
14	55323450	rs1952437	C	T	3	3	6	0	0	6	0	0
14	55510110	rs17128136	G	A	16	17	33	0	0	33	0	0
14	55512847	rs146621006	T	C	6	12	18	0	0	18	0	0
14	55531458	rs181217024	A	G	233	224	457	0	1	458	0	0
14	55533691	.	C	G	10	6	16	0	0	16	0	0
14	55835536	.	A	G	94	115	209	0	0	209	0	0
14	56103882	rs10483647	A	G	5	4	9	0	0	9	0	0
14	56584625	rs1046597	G	A	5	1	6	0	0	6	0	0
14	56648956	rs2281826	G	T	2	4	6	0	0	6	0	0
14	56654705	rs4901642	A	T	4	3	7	0	0	7	0	0
14	56760325	rs77212578	G	T	7	4	11	0	0	11	0	0
14	56760329	rs1152463	G	A	5	4	9	0	0	9	0	0
14	56761765	rs1152464	G	C	11	7	18	0	0	18	0	0
14	56763886	rs1152466	G	A	83	49	132	0	1	133	0	0
14	57115583	.	G	A	20	9	29	0	0	29	0	0
14	57858194	rs45583845	C	G	43	46	89	0	0	89	0	0
14	58728679	rs28567753	C	T	3	4	7	0	0	7	0	0
14	58729762	rs2004312	G	A	4	7	11	0	0	11	0	0
14	58729996	rs111364917	C	G	8	10	18	0	0	18	0	0
14	58732748	rs12892257	G	A	110	112	222	0	3	225	0	0
14	58733854	rs7161678	G	A	49	50	99	0	0	99	0	0
14	58740480	rs10145652	C	A	8	8	16	0	0	16	0	0
14	58762413	rs28637941	C	A	62	51	113	0	1	114	0	0
14	58794001	rs2145598	G	A	4	2	6	0	0	6	0	0
14	58816206	rs12879717	T	C	4	4	8	0	0	8	0	0
14	58816210	rs35107244	A	C	4	4	8	0	0	8	0	0
14	58816212	rs12878359	A	C	4	4	8	0	0	8	0	0
14	58830582	rs8004706	T	C	18	18	36	0	1	37	0	0
14	58838668	rs1051860	A	G	141	143	284	0	2	286	0	0
14	58838701	rs1051861	C	T	139	138	277	0	1	278	0	0
14	58839339	rs8014077	A	C	37	37	74	0	0	74	0	0
14	59797235	rs941884	A	G	4	3	7	0	0	7	0	0
14	59950417	rs1268584	T	G	4	3	7	0	0	7	0	0
14	59951278	rs10140007	T	C	14	10	24	0	0	24	0	0
14	59971039	rs7560	T	G	31	25	56	0	1	57	0	0
14	60737876	rs10150441	G	C	10	5	15	0	0	15	0	0
14	60737981	rs10129773	G	A	7	3	10	0	1	11	0	0
14	60740326	rs1887104	T	G	6	6	12	0	0	12	0	0
14	60740853	rs4899007	A	G	9	9	18	0	0	18	0	0
14	60741827	rs8012441	A	G	4	3	7	0	0	7	0	0
14	60743219	rs1887103	A	G	5	8	13	0	0	13	0	0
14	60743352	rs6573301	C	G	4	8	12	0	0	12	0	0
14	60744634	rs7146234	A	G	13	11	24	0	0	24	0	0
14	60745330	rs61992495	T	C	68	140	208	0	3	211	0	0
14	60746756	rs6573302	A	G	6	4	10	0	0	10	0	0
14	60749118	rs7154773	G	C	17	19	36	0	1	37	0	0
14	60754693	rs8017100	T	C	19	19	38	0	0	38	0	0
14	60757001	rs6573304	C	A	16	6	22	0	1	23	0	0
14	60762929	rs6573305	G	T	3	4	7	0	0	7	0	0
14	60764099	rs1956870	G	C	11	5	16	0	0	16	0	0
14	60765245	rs2273623	A	G	5	8	13	0	0	13	0	0
14	61435292	.	A	G	3	6	9	0	0	9	0	0
14	61857969	rs2230499	A	G	21	30	51	0	0	51	0	0
14	61999519	rs1091678	G	A	1	5	6	0	0	6	0	0
14	62124514	rs698026	G	T	6	1	7	0	0	7	0	0
14	62172880	rs2301107	G	A	5	8	13	0	0	13	0	0
14	62174686	rs10139578	G	C	1	5	6	0	0	6	0	0
14	62175273	rs12882000	T	C	6	3	9	0	0	9	0	0
14	62180485	rs10459450	A	G	4	5	9	0	1	10	0	0
14	62181954	rs10129270	G	A	4	6	10	0	1	11	0	0
14	62184478	rs150515287	G	A	6	3	9	0	0	9	0	0
14	62186478	rs2284999	C	T	6	1	7	0	0	7	0	0
14	62187821	rs10148514	C	T	3	3	6	0	0	6	0	0
14	62199955	rs2301110	C	A	4	4	8	0	0	8	0	0
14	62200201	rs2301111	G	C	4	6	10	0	0	10	0	0
14	62200208	rs56946275	C	T	6	5	11	0	0	11	0	0
14	62200518	rs966824	T	C	4	2	6	0	0	6	0	0
14	62201500	rs7153817	G	A	2	8	10	0	0	10	0	0
14	62202799	rs7161527	T	C	3	16	19	0	0	19	0	0
14	62202942	rs4899057	G	A	3	11	14	0	1	15	0	0
14	62203056	rs11621525	T	A	12	3	15	0	0	15	0	0
14	62203462	rs10873142	C	T	10	10	20	0	0	20	0	0
14	62206548	rs2301113	C	A	331	369	700	0	3	703	0	0
14	62206847	rs1555585	T	C	122	18	140	0	0	141	1	0
14	62206913	rs2301115	T	G	195	82	277	0	0	277	0	0
14	62208005	rs4902080	T	C	9	10	19	0	1	20	0	0
14	62208169	rs1967773	T	C	29	16	45	0	0	45	0	0
14	62208474	rs4902081	C	G	9	23	32	0	0	32	0	0
14	62209094	rs8020184	C	T	43	70	113	0	0	113	0	0
14	62209342	rs3783751	C	G	32	31	63	0	0	63	0	0
14	62209658	rs12896279	G	A	41	20	61	0	4	65	0	0
14	62210505	rs10137529	T	C	22	23	45	0	0	45	0	0
14	62210967	rs79865957	G	T	22	18	40	0	0	40	0	0
14	62211111	rs35244739	C	T	23	15	38	0	0	38	0	0
14	62212675	rs4902082	C	T	25	34	59	0	1	60	0	0
14	62213060	rs74481028	A	G	10	8	18	0	0	18	0	0
14	62213369	.	T	C	40	27	67	0	0	67	0	0
14	62213553	rs10147275	T	G	7	9	16	0	2	18	0	0
14	62213848	rs2057482	T	C	455	522	977	0	8	986	1	0
14	63839740	rs11541026	T	A	7	6	13	0	0	13	0	0
14	63840086	rs140524863	G	T	4	5	9	0	0	9	0	0
14	63919115	rs7152839	G	T	4	6	10	0	1	11	0	0
14	64612858	rs10151658	C	A	3	5	8	0	0	8	0	0
14	64628873	rs147173048	C	T	4	5	9	0	0	9	0	0
14	64691206	.	G	A	18	8	26	0	0	27	1	0
14	64908845	rs2236225	G	A	29	42	71	0	0	71	0	0
14	64937412	rs144453086	G	A	3	3	6	0	0	6	0	0
14	65241228	rs229592	A	G	3	4	7	0	0	7	0	0
14	65469649	rs72625657	A	G	14	8	22	0	0	22	0	0
14	65470831	rs12587546	A	G	11	24	35	0	0	35	0	0
14	65545251	.	G	T	19	25	44	0	1	45	0	0
14	65560663	.	G	C	5	2	7	0	0	7	0	0
14	67746721	rs764039	T	A	5	2	7	0	0	7	0	0
14	67770676	rs138509637	G	A	20	11	31	0	0	31	0	0
14	67770957	rs72717381	G	A	5	2	7	0	0	7	0	0
14	67794657	rs115350346	T	G	3	4	7	0	0	7	0	0
14	67799725	rs72717392	A	G	18	23	41	0	0	41	0	0
14	67800316	rs960797	G	A	9	9	18	0	0	18	0	0
14	67800815	rs1044745	G	A	4	6	10	0	0	10	0	0
14	67804849	rs11539356	C	T	26	17	43	0	0	43	0	0
14	67819602	rs8020850	T	C	4	4	8	0	1	9	0	0
14	67851754	rs45479091	T	C	11	10	21	0	0	21	0	0
14	67852265	rs72719125	A	G	1	7	8	0	0	8	0	0
14	68115001	rs3742879	A	G	4	8	12	0	1	13	0	0
14	68159269	rs80140987	C	T	6	12	18	0	0	18	0	0
14	68196264	rs141369687	C	T	5	2	7	0	0	7	0	0
14	68213792	rs1044126	A	G	15	17	32	0	0	32	0	0
14	68214788	rs12879105	T	C	10	21	31	0	0	31	0	0
14	68223366	rs35103502	T	C	2	6	8	0	0	8	0	0
14	68236320	rs61746722	C	T	10	11	21	0	0	21	0	0
14	68257485	rs7143196	C	T	16	10	26	0	0	26	0	0
14	68265135	rs117228915	G	A	7	5	12	0	0	12	0	0
14	69255644	.	A	C	6	35	41	0	0	41	0	0
14	69255652	.	G	T	11	36	47	0	1	48	0	0
14	69255660	.	G	C	10	26	36	0	4	40	0	0
14	69261472	rs2236262	A	G	5	5	10	0	0	10	0	0
14	69262441	rs3742887	A	G	3	6	9	0	0	9	0	0
14	69345647	rs12586591	C	T	4	7	11	0	0	11	0	0
14	69346014	rs77149924	G	A	1	5	6	0	0	6	0	0
14	69347632	rs36039812	C	T	46	38	84	0	0	84	0	0
14	69352230	rs15993	G	A	36	42	78	0	0	78	0	0
14	69354660	rs181476	T	G	6	7	13	0	0	13	0	0
14	69354701	rs140998374	G	A	7	7	14	0	0	14	0	0
14	69354871	rs181478	T	G	8	2	10	0	0	10	0	0
14	69355193	rs147533250	G	A	4	3	7	0	0	7	0	0
14	69355447	rs1475033	C	G	2	5	7	0	0	7	0	0
14	69518959	rs117591245	C	G	53	85	138	0	1	139	0	0
14	69519003	rs142929985	C	T	82	103	185	0	3	188	0	0
14	69521345	rs61741172	G	A	131	117	248	0	1	249	0	0
14	69581898	rs7158145	C	G	3	18	21	0	0	21	0	0
14	69704553	rs8007859	G	T	4	9	13	0	0	13	0	0
14	69708241	rs1043254	G	A	6	7	13	0	0	13	0	0
14	69709373	rs3173	G	A	8	6	14	0	1	15	0	0
14	69848675	rs12891351	T	C	2	4	6	0	0	6	0	0
14	69848927	rs76442470	G	C	7	5	12	0	0	12	0	0
14	69864394	.	G	A	8	19	27	0	0	27	0	0
14	70793004	rs4749	A	G	59	59	118	0	9	127	0	0
14	70819870	rs7152898	C	A	19	11	30	0	1	31	0	0
14	70819939	rs7152945	C	T	20	13	33	0	0	33	0	0
14	70833819	rs1044527	C	G	2	4	6	0	0	6	0	0
14	71051806	rs191004510	A	C	8	8	16	0	0	16	0	0
14	71057558	rs11158869	T	C	18	10	28	0	0	28	0	0
14	71138716	rs1076265	A	C	16	10	26	0	0	26	0	0
14	71138730	rs13738	C	T	17	10	27	0	0	27	0	0
14	71374702	rs2526882	G	A	57	67	124	0	0	124	0	0
14	71375338	rs2526880	C	T	1	5	6	0	0	6	0	0
14	71383848	rs2810073	T	C	61	40	101	0	1	102	0	0
14	71409614	rs2526862	T	C	1	8	9	0	0	9	0	0
14	71441385	rs7154437	A	G	13	0	13	0	1	14	0	0
14	71444788	rs3814871	G	A	47	25	72	0	0	72	0	0
14	71498656	rs4467005	C	T	5	1	6	0	0	6	0	0
14	71503103	rs77614866	C	T	4	2	6	0	0	6	0	0
14	71551988	rs58984901	C	T	4	3	7	0	0	7	0	0
14	71560352	rs8003227	T	C	8	5	13	0	0	13	0	0
14	71577480	rs116016	G	A	28	56	84	0	2	86	0	0
14	71578741	rs221927	G	A	10	10	20	0	0	20	0	0
14	71579135	rs221926	A	C	4	5	9	0	0	9	0	0
14	71579629	rs221925	T	G	5	6	11	0	0	11	0	0
14	71580778	rs221924	G	A	16	14	30	0	0	30	0	0
14	72169130	rs79937396	T	C	8	6	14	0	1	15	0	0
14	73404680	rs3815500	A	C	46	30	76	0	1	77	0	0
14	73407894	rs4903079	G	A	1	5	6	0	0	6	0	0
14	73409683	rs2240980	C	G	21	32	53	0	0	53	0	0
14	73425462	rs12882409	G	A	22	39	61	0	0	61	0	0
14	73425681	rs7144738	A	C	22	38	60	0	0	60	0	0
14	73428660	rs2243596	G	A	7	10	17	0	0	17	0	0
14	73440864	rs12931	C	T	59	71	130	0	2	132	0	0
14	73446277	rs10130581	A	G	7	8	15	0	0	15	0	0
14	73447110	rs2333014	A	G	12	8	20	0	0	20	0	0
14	73447239	rs76629590	T	G	5	3	8	0	0	8	0	0
14	73447244	rs4272968	A	T	2	4	6	0	0	6	0	0
14	73447840	rs12887074	A	G	7	10	17	0	0	17	0	0
14	73447924	rs4899452	C	G	8	9	17	0	0	17	0	0
14	73459917	rs2333016	C	T	43	43	86	0	2	88	0	0
14	73462313	rs4903086	A	C	6	3	9	0	0	9	0	0
14	73462337	rs34158414	A	T	6	2	8	0	0	8	0	0
14	73462343	rs9888613	A	T	6	3	9	0	0	9	0	0
14	73462862	rs9888617	A	G	3	7	10	0	0	10	0	0
14	73463750	rs11625299	T	C	14	9	23	0	1	24	0	0
14	73464143	rs9888558	G	A	4	8	12	0	0	12	0	0
14	73465003	rs997667	A	G	26	38	64	0	1	65	0	0
14	73531799	rs78354522	C	G	12	3	15	0	0	15	0	0
14	73570700	rs35159604	A	T	25	16	41	0	3	44	0	0
14	73579381	rs165936	C	G	9	3	12	0	0	12	0	0
14	73611893	rs35891140	G	A	4	3	7	0	0	7	0	0
14	73686361	rs362385	T	C	45	46	91	0	0	91	0	0
14	73686944	rs7523	G	A	28	53	81	0	1	82	0	0
14	73689719	rs362344	C	T	37	41	78	0	1	79	0	0
14	73742281	rs7202	G	A	54	51	105	0	2	107	0	0
14	73743205	rs11625196	G	C	91	89	180	0	3	183	0	0
14	73957772	.	A	G	9	6	15	0	0	15	0	0
14	73958375	rs758109	T	C	7	15	22	0	0	22	0	0
14	73958812	rs3813563	T	C	27	26	53	0	0	53	0	0
14	74036370	rs60568739	G	T	15	21	36	0	0	36	0	0
14	74036500	rs146968042	C	T	15	17	32	0	1	33	0	0
14	74041748	.	A	G	119	24	143	0	0	143	0	0
14	74165940	rs12147465	T	C	3	4	7	0	0	7	0	0
14	74168431	rs6830	G	A	10	9	19	0	1	20	0	0
14	74178729	rs8949	G	T	31	32	63	0	1	64	0	0
14	74178800	rs7182	C	T	34	20	54	0	1	55	0	0
14	74182810	rs45445698	G	A	255	197	452	0	1	453	0	0
14	74182890	rs3742818	C	G	172	248	420	0	4	424	0	0
14	74183279	rs4903143	A	G	139	99	238	0	4	242	0	0
14	74184889	rs4903144	G	C	128	200	328	0	4	332	0	0
14	74184939	rs4899476	A	G	111	197	308	0	12	320	0	0
14	74187423	rs7153989	A	G	15	21	36	0	0	36	0	0
14	74190147	rs8023053	G	C	6	10	16	0	0	16	0	0
14	74192247	rs11627457	A	T	6	4	10	0	0	10	0	0
14	74196686	rs2075025	T	C	87	96	183	0	1	184	0	0
14	74196792	rs8019058	T	C	11	2	13	0	0	13	0	0
14	74206855	rs17182544	C	G	93	66	159	0	2	161	0	0
14	74222284	rs12889360	G	C	4	2	6	0	0	6	0	0
14	74253818	rs35499409	C	T	23	14	37	0	1	38	0	0
14	74351488	rs8007148	G	C	2	7	9	0	0	9	0	0
14	74362767	rs62003715	A	G	3	6	9	0	0	9	0	0
14	74369901	rs7157998	G	A	2	4	6	0	0	6	0	0
14	74373246	rs6574152	C	G	4	2	6	0	0	6	0	0
14	74375861	rs2302137	C	G	4	5	9	0	0	9	0	0
14	74375956	rs2302136	A	C	6	3	9	0	0	9	0	0
14	74385283	rs11624713	G	T	5	3	8	0	0	8	0	0
14	74385417	.	T	C	3	3	6	0	0	7	1	0
14	74385511	rs55940654	T	C	6	7	13	0	0	13	0	0
14	74385622	rs56334127	T	C	10	4	14	0	0	14	0	0
14	74385664	rs55772384	G	A	10	1	11	0	0	11	0	0
14	74387375	rs2302121	A	T	14	22	36	0	0	36	0	0
14	74388167	rs758244	A	G	2	6	8	0	0	8	0	0
14	74388908	rs1127392	T	C	97	184	281	0	2	283	0	0
14	74389218	rs11620776	G	A	2	4	6	0	0	6	0	0
14	74391363	rs17782281	C	T	4	2	6	0	0	6	0	0
14	74391853	rs55692390	T	C	7	1	8	0	0	8	0	0
14	74391890	rs17782286	A	C	5	2	7	0	0	7	0	0
14	74393251	rs11159046	C	T	6	8	14	0	0	14	0	0
14	74394674	rs55748911	G	A	5	5	10	0	0	10	0	0
14	74395128	rs12432077	G	C	8	7	15	0	0	15	0	0
14	74396431	rs8013946	G	C	5	8	13	0	0	13	0	0
14	74396488	rs6574153	G	C	6	9	15	0	0	15	0	0
14	74396820	rs6574154	C	A	6	2	8	0	0	8	0	0
14	74397333	rs11624247	G	C	5	7	12	0	0	12	0	0
14	74397351	rs11624140	A	G	4	7	11	0	0	11	0	0
14	74399422	rs2336548	C	G	7	6	13	0	0	13	0	0
14	74402693	rs17182699	C	T	5	4	9	0	0	9	0	0
14	74404756	rs28927675	T	C	4	2	6	0	0	6	0	0
14	74413129	rs7146634	C	G	3	5	8	0	0	8	0	0
14	74424265	rs62006131	T	C	2	7	9	0	0	9	0	0
14	74424491	rs17782310	T	C	4	3	7	0	0	7	0	0
14	74424938	rs3180946	T	C	7	13	20	0	0	20	0	0
14	74425056	rs3764859	C	A	4	4	8	0	0	8	0	0
14	74428445	rs8500	G	A	21	26	47	0	1	48	0	0
14	74429133	rs7147088	A	G	1	5	6	0	0	6	0	0
14	74429137	rs7147229	C	G	1	5	6	0	0	6	0	0
14	74430447	rs1029704	C	T	11	7	18	0	0	18	0	0
14	74431191	rs3742815	A	G	6	8	14	0	0	14	0	0
14	74432265	rs7155210	C	A	4	3	7	0	0	7	0	0
14	74432430	rs4140924	A	G	4	3	7	0	0	7	0	0
14	74433129	rs7161037	C	A	3	3	6	0	0	6	0	0
14	74433138	rs11624946	C	T	4	3	7	0	0	7	0	0
14	74433552	rs13743	A	T	1	5	6	0	0	6	0	0
14	74441684	rs2074932	G	A	4	4	8	0	0	8	0	0
14	74454813	rs2302117	C	A	1	5	6	0	0	6	0	0
14	74454819	rs12434581	T	A	5	1	6	0	0	6	0	0
14	74514674	rs3784038	A	T	2	5	7	0	0	7	0	0
14	74523869	rs3742809	A	G	7	8	15	0	0	15	0	0
14	74523949	rs3742808	G	A	9	10	19	0	0	19	0	0
14	74526188	rs4646866	C	G	7	3	10	0	0	10	0	0
14	74526197	rs4646865	G	A	7	3	10	0	0	10	0	0
14	74527190	rs8204	A	G	4	5	9	0	0	9	0	0
14	74531485	rs3815330	T	G	4	3	7	0	0	7	0	0
14	74666225	rs45569432	T	C	9	9	18	0	0	18	0	0
14	74666641	rs887595	A	G	6	3	9	0	0	9	0	0
14	74666800	rs62006794	A	G	1	10	11	0	0	11	0	0
14	74666824	.	A	G	8	2	10	0	1	11	0	0
14	74756539	rs3213499	A	G	3	3	6	0	0	6	0	0
14	74759006	rs3742801	C	T	29	32	61	0	0	61	0	0
14	74759301	rs4148078	G	T	30	19	49	0	0	49	0	0
14	74759477	rs4148077	C	T	27	23	50	0	0	50	0	0
14	74761584	rs3742800	A	G	8	3	11	0	0	11	0	0
14	74766080	rs2301346	T	C	6	0	6	0	0	6	0	0
14	74766352	rs2301345	A	G	12	12	24	0	0	24	0	0
14	74954643	rs28378078	A	G	2	5	7	0	0	7	0	0
14	75120628	rs11621186	C	T	5	2	7	0	0	7	0	0
14	75128316	rs16661	A	C	71	53	124	0	1	125	0	0
14	75128425	rs9441	G	A	78	52	130	0	1	131	0	0
14	75129864	rs17101802	A	G	34	37	71	0	1	72	0	0
14	75130235	rs1045430	T	G	44	43	87	0	0	87	0	0
14	75130944	rs752857	C	T	7	2	9	0	0	9	0	0
14	75132176	rs79070663	A	G	1	6	7	0	0	7	0	0
14	75133277	.	G	A	5	4	9	0	0	9	0	0
14	75135369	rs188966721	C	T	5	1	6	0	0	6	0	0
14	75163055	rs115536512	C	T	2	4	6	0	0	6	0	0
14	75164008	rs7152804	T	C	3	5	8	0	0	8	0	0
14	75179734	rs2270425	C	G	6	3	9	0	0	9	0	0
14	75251440	rs2241275	A	G	2	8	10	0	0	10	0	0
14	75252587	rs7154256	T	C	3	8	11	0	0	11	0	0
14	75253296	rs80230324	G	A	7	3	10	0	0	10	0	0
14	75254167	rs34956813	G	A	2	4	6	0	0	6	0	0
14	75279461	rs2302835	G	A	84	90	174	0	0	174	0	0
14	75288499	rs76422049	C	T	4	10	14	0	0	14	0	0
14	75289593	rs17102680	T	C	3	3	6	0	1	7	0	0
14	75290018	rs8021280	C	G	9	7	16	0	0	16	0	0
14	75293374	rs11159104	A	G	10	9	19	0	0	19	0	0
14	75293386	rs10138360	G	A	10	11	21	0	0	21	0	0
14	75296831	rs10148293	A	G	11	6	17	0	0	17	0	0
14	75297727	rs973879	T	C	3	9	12	0	0	12	0	0
14	75298052	rs11159105	C	T	5	5	10	0	0	10	0	0
14	75299101	rs7150254	G	A	6	5	11	0	0	11	0	0
14	75307600	rs8008785	G	A	5	5	10	0	0	10	0	0
14	75308309	rs111879555	C	T	5	3	8	0	0	8	0	0
14	75351106	rs59159639	A	G	11	9	20	0	0	20	0	0
14	75353855	rs2300596	T	C	8	12	20	0	0	20	0	0
14	75354600	rs10141438	A	G	9	9	18	0	1	19	0	0
14	75355203	rs8010840	T	C	7	9	16	0	0	16	0	0
14	75356103	rs6574199	T	C	26	16	42	0	2	44	0	0
14	75359204	rs2300597	A	T	20	25	45	0	1	46	0	0
14	75359670	rs2230237	G	A	259	297	556	0	3	559	0	0
14	75360419	rs4903267	G	T	6	0	6	0	0	6	0	0
14	75361177	rs2070599	C	G	7	6	13	0	0	13	0	0
14	75362471	rs11851534	C	T	10	5	15	0	0	15	0	0
14	75364082	rs59875101	A	T	5	7	12	0	0	12	0	0
14	75364180	rs116830699	A	G	5	10	15	0	2	17	0	0
14	75364451	rs6574200	C	T	17	7	24	0	0	24	0	0
14	75365062	rs2080087	A	G	15	6	21	0	0	21	0	0
14	75365729	rs732765	A	G	7	9	16	0	0	16	0	0
14	75368508	rs2853779	G	A	13	9	22	0	0	22	0	0
14	75368691	rs7151764	C	T	12	8	20	0	0	20	0	0
14	75369346	rs709888	T	C	250	208	458	0	3	461	0	0
14	75369379	rs709887	T	C	225	168	393	0	4	398	1	0
14	75370123	rs13391	C	T	413	394	807	0	5	812	0	0
14	75476071	rs4556	G	C	22	28	50	0	0	50	0	0
14	75483812	rs13712	T	C	6	8	14	0	0	14	0	0
14	75551321	rs61745420	T	G	31	45	76	0	0	76	0	0
14	75561857	rs45599237	C	T	1	5	6	0	0	6	0	0
14	75570293	rs11845639	C	T	9	10	19	0	0	19	0	0
14	75590822	rs8017642	G	A	25	31	56	0	1	57	0	0
14	75601737	rs12435391	A	G	4	6	10	0	0	10	0	0
14	75601771	rs150682373	T	C	8	3	11	0	0	11	0	0
14	75608268	rs74925284	A	G	3	6	9	0	0	9	0	0
14	75608728	rs2268617	G	A	8	3	11	0	0	11	0	0
14	75609310	rs77564360	T	G	7	6	13	0	0	13	0	0
14	75612027	rs115582479	A	G	13	14	27	0	0	27	0	0
14	75613091	rs12881035	C	G	11	9	20	0	0	20	0	0
14	75614134	rs142374189	C	T	5	9	14	0	0	14	0	0
14	75642677	rs116412878	C	T	7	9	16	0	1	17	0	0
14	75724345	rs72719935	C	T	26	17	43	0	0	43	0	0
14	75724661	rs150499263	C	T	16	21	37	0	0	37	0	0
14	75724677	rs140615147	T	G	18	17	35	0	0	35	0	0
14	75745894	rs4645853	G	A	92	149	241	0	3	244	0	0
14	75746144	rs4645854	C	T	274	247	521	0	0	521	0	0
14	75746869	rs4645855	G	A	333	353	686	0	5	691	0	0
14	75747118	rs1063169	G	T	597	504	1101	0	16	1117	0	0
14	75747258	rs4645856	T	C	316	364	680	0	5	685	0	0
14	75901136	rs2242618	G	A	11	7	18	0	0	18	0	0
14	75906436	rs1125772	A	T	8	8	16	0	1	17	0	0
14	75908549	rs17103272	A	C	10	7	17	0	0	17	0	0
14	75914435	rs175640	A	G	3	3	6	0	0	6	0	0
14	75921596	rs11159145	T	A	1	5	6	0	0	6	0	0
14	75922352	rs34936647	A	G	4	3	7	0	0	7	0	0
14	75923728	rs175647	A	C	4	4	8	0	0	8	0	0
14	75923891	rs17103321	T	C	4	2	6	0	1	7	0	0
14	75924211	rs3784015	T	C	3	3	6	0	0	6	0	0
14	75925394	rs28698696	A	G	4	2	6	0	0	6	0	0
14	75926285	rs10130710	T	C	6	5	11	0	0	11	0	0
14	75926297	rs10141767	G	A	6	4	10	0	0	10	0	0
14	75927317	rs1477461	T	C	5	3	8	0	0	8	0	0
14	75931672	rs3784011	G	A	3	3	6	0	0	6	0	0
14	75932497	rs17183622	C	T	3	4	7	0	0	7	0	0
14	75934736	rs61978939	C	T	3	5	8	0	0	8	0	0
14	75936517	rs8215	T	C	541	510	1051	0	12	1063	0	0
14	75937022	rs10057	G	A	113	85	198	0	5	203	0	0
14	76156609	rs2303345	C	T	15	19	34	0	0	34	0	0
14	76175565	rs1981898	C	A	2	5	7	0	0	7	0	0
14	76232222	rs759871	G	A	7	8	15	0	0	15	0	0
14	76232469	rs61741261	C	T	20	15	35	0	0	35	0	0
14	76330181	rs3742764	G	A	32	30	62	0	0	62	0	0
14	76368544	rs1133834	T	C	50	30	80	0	0	80	0	0
14	76618440	rs2289834	C	T	6	4	10	0	0	10	0	0
14	76619167	rs3813547	A	C	16	24	40	0	0	40	0	0
14	76619292	rs555329227	T	C	31	14	45	0	1	46	0	0
14	76619746	rs2543380	T	C	12	43	55	0	0	55	0	0
14	76619961	rs3813546	A	G	47	10	57	0	1	58	0	0
14	76626703	rs2543383	T	C	1	5	6	0	0	6	0	0
14	76633810	rs11624689	C	T	2	5	7	0	0	7	0	0
14	76633956	rs11624793	G	A	1	5	6	0	0	6	0	0
14	76633957	rs11629333	T	C	1	5	6	0	0	6	0	0
14	76633967	rs8005686	G	A	1	5	6	0	0	6	0	0
14	76635834	rs2166320	A	G	5	4	9	0	0	9	0	0
14	76636362	rs7156865	T	G	3	4	7	0	0	7	0	0
14	76636471	rs7155651	A	G	3	6	9	0	0	9	0	0
14	76637637	rs8003207	A	G	3	6	9	0	0	9	0	0
14	76637709	rs12878758	G	A	5	5	10	0	0	10	0	0
14	76640125	rs2289836	A	C	61	25	86	0	0	86	0	0
14	76640510	rs35949653	A	T	5	23	28	0	1	29	0	0
14	76657756	rs1900126	G	A	4	2	6	0	0	6	0	0
14	76660221	rs2360979	A	G	2	7	9	0	0	9	0	0
14	76662446	rs1900127	C	T	5	8	13	0	0	13	0	0
14	76662902	rs11159183	A	G	4	12	16	0	0	16	0	0
14	76663351	rs7158562	C	T	4	11	15	0	0	15	0	0
14	76663551	rs7158766	A	T	8	15	23	0	0	23	0	0
14	76663838	rs6574278	T	C	4	14	18	0	1	19	0	0
14	76663938	rs6574279	A	T	6	14	20	0	0	20	0	0
14	76666272	rs11159185	T	C	8	10	18	0	0	18	0	0
14	76668356	rs2166322	A	G	34	40	74	0	1	75	0	0
14	76669309	rs4903385	C	A	27	52	79	0	2	81	0	0
14	76669658	rs4903386	A	G	32	31	63	0	1	64	0	0
14	76670781	rs10873287	C	T	50	57	107	0	1	108	0	0
14	76671951	rs749074	A	G	44	45	89	0	2	91	0	0
14	76674617	rs12587317	C	T	9	7	16	0	0	16	0	0
14	76674773	rs12589946	T	C	12	19	31	0	0	31	0	0
14	76675452	rs2121074	A	G	22	20	42	0	0	42	0	0
14	76675540	rs2121075	G	C	24	20	44	0	0	44	0	0
14	76676355	rs2121077	A	G	23	19	42	0	0	42	0	0
14	76676827	rs8005754	T	C	22	20	42	0	0	42	0	0
14	76679059	rs17104265	T	G	22	17	39	0	0	39	0	0
14	77236380	rs3815550	C	T	4	2	6	0	0	6	0	0
14	77252777	rs149979933	T	C	8	4	12	0	0	12	0	0
14	77254836	rs2242624	A	C	16	12	28	0	0	28	0	0
14	77272992	rs45499197	C	G	10	9	19	0	0	19	0	0
14	77494722	rs78010105	C	T	34	36	70	0	0	70	0	0
14	77580980	.	C	T	6	2	8	0	0	8	0	0
14	77582337	rs17811712	C	A	10	4	14	0	0	14	0	0
14	77582362	rs17105353	C	T	4	9	13	0	0	13	0	0
14	77582643	rs3185777	T	C	4	6	10	0	0	10	0	0
14	77741394	rs11547793	T	C	9	6	15	0	0	15	0	0
14	77741745	rs11159254	C	T	14	8	22	0	1	23	0	0
14	77741752	rs11547794	G	A	14	9	23	0	0	23	0	0
14	77742582	rs7158951	C	T	7	6	13	0	0	13	0	0
14	77742661	rs11624564	C	T	12	4	16	0	0	16	0	0
14	77742929	rs7159558	C	T	5	7	12	0	0	12	0	0
14	77743644	rs1055592	G	A	18	29	47	0	1	48	0	0
14	77746112	rs11625197	T	C	3	6	9	0	0	9	0	0
14	77746847	rs71413457	C	G	3	4	7	0	0	7	0	0
14	77794283	rs1046428	T	C	2	4	6	0	0	6	0	0
14	77801431	rs6637	T	C	15	16	31	0	0	31	0	0
14	77801654	rs6636	G	C	29	47	76	0	1	77	0	0
14	77802056	.	C	T	65	67	132	0	0	132	0	0
14	77803615	rs3759731	C	G	36	27	63	0	0	63	0	0
14	77804405	rs2160838	C	T	34	35	69	0	2	71	0	0
14	77804580	rs2160839	A	G	40	38	78	0	1	79	0	0
14	77804842	rs9671248	C	T	49	34	83	0	1	84	0	0
14	77805376	rs10132619	G	A	27	31	58	0	0	58	0	0
14	77806486	rs11850771	T	C	36	21	57	0	0	57	0	0
14	77843353	rs10141317	G	T	8	8	16	0	0	16	0	0
14	77843363	rs10141114	A	G	8	8	16	0	0	16	0	0
14	77843384	rs3742737	G	T	4	6	10	0	0	10	0	0
14	77931223	rs17824322	C	T	2	5	7	0	0	7	0	0
14	77932619	rs8010520	C	T	4	6	10	0	0	10	0	0
14	77934587	rs3825694	T	C	5	1	6	0	0	6	0	0
14	77935659	rs11539461	G	A	66	50	116	0	0	116	0	0
14	77974990	rs1063271	C	T	48	17	65	0	0	65	0	0
14	77975103	rs1063270	T	G	31	11	42	0	0	42	0	0
14	77975925	rs10147023	C	T	23	48	71	0	1	72	0	0
14	77976325	rs11159269	T	C	22	8	30	0	0	30	0	0
14	77976450	rs17824567	T	G	31	15	46	0	0	46	0	0
14	77976468	rs45493395	T	C	37	15	52	0	1	53	0	0
14	77976972	rs45480297	C	G	43	17	60	0	0	60	0	0
14	77985352	rs28419564	A	C	6	18	24	0	0	24	0	0
14	77985397	rs28516852	T	G	8	14	22	0	1	23	0	0
14	77987958	rs2072672	C	A	6	32	38	0	0	38	0	0
14	77988648	rs2299910	G	A	22	10	32	0	0	32	0	0
14	77990612	rs149177874	G	A	5	29	34	0	0	34	0	0
14	77991591	rs7154342	A	C	3	11	14	0	0	14	0	0
14	77991672	rs28771140	C	T	18	7	25	0	0	25	0	0
14	77993590	rs10131773	C	T	12	5	17	0	0	17	0	0
14	77993620	rs138284086	T	C	13	5	18	0	0	18	0	0
14	77994283	rs73319095	A	C	7	9	16	0	0	16	0	0
14	77994375	rs55732483	C	A	4	6	10	0	1	11	0	0
14	77994447	rs79842708	C	G	13	6	19	0	0	19	0	0
14	77994873	rs28393685	C	G	10	5	15	0	0	15	0	0
14	77995020	rs28584839	A	G	1	5	6	0	0	6	0	0
14	77995174	rs8019658	T	C	6	15	21	0	1	22	0	0
14	77996115	rs28417590	G	A	7	6	13	0	0	13	0	0
14	77997058	rs28677959	T	C	5	14	19	0	0	19	0	0
14	77997204	rs28719093	T	C	2	15	17	0	0	17	0	0
14	77999604	rs35817034	T	C	7	2	9	0	0	9	0	0
14	77999781	rs9323645	C	T	2	11	13	0	0	13	0	0
14	78000278	rs56192928	G	A	3	12	15	0	0	15	0	0
14	78000772	rs4903594	T	G	10	6	16	0	0	16	0	0
14	78000889	rs8018049	C	T	0	6	6	0	1	7	0	0
14	78001357	rs4903600	G	A	23	11	34	0	0	34	0	0
14	78002223	rs28628767	G	A	13	77	90	0	0	90	0	0
14	78039541	rs7145619	G	T	3	3	6	0	0	6	0	0
14	78039959	rs60778316	C	T	3	3	6	0	1	7	0	0
14	78040095	rs12148048	C	A	11	14	25	0	0	25	0	0
14	78040898	rs117456964	C	A	5	13	18	0	0	18	0	0
14	78042713	rs57804672	C	T	1	7	8	0	0	8	0	0
14	78061171	rs75549216	G	A	10	9	19	0	0	19	0	0
14	78062644	rs113271346	T	C	11	25	36	0	1	37	0	0
14	78062994	rs34278364	C	T	60	18	78	0	1	79	0	0
14	78080746	rs2267751	A	G	6	3	9	0	0	9	0	0
14	78080783	rs8021660	G	A	10	1	11	0	0	11	0	0
14	78080832	rs8021376	C	A	6	0	6	0	0	6	0	0
14	78080845	rs2267754	A	C	6	1	7	0	0	7	0	0
14	78082254	rs77681008	C	A	3	4	7	0	0	7	0	0
14	78390880	rs2302944	T	C	4	4	8	0	0	8	0	0
14	81727242	.	C	T	17	9	26	0	0	26	0	0
14	81727516	rs7148747	G	A	13	6	19	0	0	19	0	0
14	81727624	rs7149917	T	C	26	6	32	0	1	33	0	0
14	81727979	rs7153668	C	A	8	7	15	0	0	15	0	0
14	81729526	rs17111624	A	T	6	3	9	0	1	10	0	0
14	81732315	rs17111629	A	G	6	1	7	0	0	7	0	0
14	81941413	rs3208229	A	G	17	10	27	0	0	27	0	0
14	88399488	rs17198	A	C	3	13	16	0	0	16	0	0
14	88399623	rs405567	T	C	22	23	45	0	1	46	0	0
14	88399801	rs1042042	C	T	12	8	20	0	0	20	0	0
14	88400353	rs412915	C	T	15	10	25	0	0	25	0	0
14	88400450	rs432946	G	A	7	3	10	0	0	10	0	0
14	88400486	rs1042029	A	G	6	6	12	0	0	12	0	0
14	88401443	rs434541	G	A	3	5	8	0	0	8	0	0
14	88401708	rs2301118	T	C	6	1	7	0	0	7	0	0
14	88406120	rs45626938	C	T	4	2	6	0	0	6	0	0
14	88406127	rs45567441	G	C	4	2	6	0	0	6	0	0
14	88407888	rs398607	A	G	10	22	32	0	0	32	0	0
14	88414211	rs398076	G	A	18	13	31	0	0	31	0	0
14	88430294	rs11621530	G	A	3	3	6	0	0	6	0	0
14	88431898	rs12888666	C	T	35	21	56	0	0	56	0	0
14	88471562	rs10139328	T	C	11	13	24	0	0	24	0	0
14	88477413	rs6574978	C	T	6	8	14	0	0	14	0	0
14	88862529	rs3179969	G	A	12	11	23	0	0	23	0	0
14	89074044	rs67254673	C	T	41	34	75	0	8	83	0	0
14	89622899	.	G	A	146	92	238	0	2	240	0	0
14	89626459	rs8011758	C	A	41	35	76	0	0	76	0	0
14	89626554	rs11159889	T	G	3	5	8	0	0	8	0	0
14	89629665	rs942313	A	G	1	5	6	0	0	6	0	0
14	89631591	rs74960029	T	C	3	5	8	0	0	8	0	0
14	89633420	rs4899970	G	A	3	6	9	0	0	9	0	0
14	89640137	rs61985196	T	C	1	5	6	0	0	6	0	0
14	89728824	rs3759711	G	A	1	5	6	0	0	6	0	0
14	89792104	rs11844345	A	T	6	2	8	0	0	8	0	0
14	89919487	rs2401824	G	A	2	4	6	0	0	6	0	0
14	90398907	rs8778	G	A	5	8	13	0	0	13	0	0
14	90420298	rs3736860	C	T	10	7	17	0	0	17	0	0
14	90422928	rs35439694	A	G	5	2	7	0	0	7	0	0
14	90429749	rs3825663	A	G	20	15	35	0	0	35	0	0
14	90509564	rs9488	C	T	11	21	32	0	0	32	0	0
14	90509880	rs7150480	T	C	7	5	12	0	0	12	0	0
14	90510935	rs34004710	G	A	12	15	27	0	0	27	0	0
14	90510939	rs34923595	C	T	13	18	31	0	0	31	0	0
14	90510947	rs35944390	C	G	12	18	30	0	0	30	0	0
14	90723000	rs2277515	A	G	2	6	8	0	0	8	0	0
14	90723059	rs2277514	T	C	3	3	6	0	1	7	0	0
14	90723152	rs3825662	A	G	5	2	7	0	0	7	0	0
14	90723172	rs8005870	A	C	5	3	8	0	0	8	0	0
14	90724177	rs2151749	G	A	1	6	7	0	0	7	0	0
14	90724399	rs60548738	G	A	9	9	18	0	0	18	0	0
14	90726676	rs11844225	G	A	1	5	6	0	0	6	0	0
14	90729931	rs8022531	T	C	15	23	38	0	0	38	0	0
14	90729984	rs8015510	C	T	16	19	35	0	0	35	0	0
14	90730071	rs4811	C	T	117	119	236	0	1	237	0	0
14	90730265	rs2282030	G	A	7	10	17	0	0	17	0	0
14	90732150	rs7145398	T	C	26	8	34	0	0	34	0	0
14	90732280	rs7144335	A	G	26	18	44	0	1	45	0	0
14	90732554	rs943989	G	T	22	16	38	0	0	38	0	0
14	90732703	rs17260827	G	A	34	23	57	0	0	57	0	0
14	90733012	rs3783838	A	G	15	21	36	0	0	36	0	0
14	90733656	rs11159959	C	T	5	6	11	0	0	11	0	0
14	90733890	rs115667214	A	G	17	11	28	0	0	28	0	0
14	90734826	rs11624246	A	G	11	6	17	0	0	17	0	0
14	90734953	rs11628952	T	C	6	7	13	0	0	13	0	0
14	90735707	rs3742673	A	G	9	2	11	0	1	12	0	0
14	90736325	rs2236403	C	T	17	12	29	0	0	29	0	0
14	90736477	rs114316342	C	T	24	46	70	0	0	70	0	0
14	90738002	rs11628906	C	T	7	7	14	0	0	14	0	0
14	90738165	rs11624890	T	A	4	4	8	0	0	8	0	0
14	90744546	rs45471798	C	T	8	9	17	0	0	17	0	0
14	90744672	rs10184	G	A	35	25	60	0	0	60	0	0
14	90744981	rs79334826	G	A	13	10	23	0	0	23	0	0
14	90745422	rs3737035	T	C	24	29	53	0	0	53	0	0
14	90746112	rs74485471	G	A	9	12	21	0	0	21	0	0
14	90746462	rs76139392	G	T	8	4	12	0	0	12	0	0
14	90746471	rs11623736	G	T	4	9	13	0	0	13	0	0
14	90747728	rs115026813	A	G	6	5	11	0	0	11	0	0
14	90751804	rs531414913	C	T	5	2	7	0	0	7	0	0
14	90756760	rs3742671	A	T	19	19	38	0	1	39	0	0
14	90760040	rs17799244	C	T	2	4	6	0	0	6	0	0
14	90768183	rs8020828	C	T	3	3	6	0	0	6	0	0
14	90770393	.	G	A	23	19	42	0	0	42	0	0
14	90777846	rs8023212	G	C	5	2	7	0	0	7	0	0
14	90865627	rs41304357	T	C	10	5	15	0	0	15	0	0
14	90869110	rs9646173	C	T	19	21	40	0	0	40	0	0
14	90869913	rs3213718	C	T	21	13	34	0	0	34	0	0
14	90871478	rs5871	T	C	271	315	586	0	10	596	0	0
14	90872143	rs1059296	A	G	35	27	62	0	3	66	1	0
14	90873798	rs1058903	C	T	52	65	117	0	0	117	0	0
14	91084338	rs754247	C	T	31	37	68	0	0	68	0	0
14	91106141	rs80184980	G	A	5	1	6	0	0	6	0	0
14	91404688	rs1286119	T	C	3	8	11	0	0	11	0	0
14	91407912	rs73324683	A	G	5	2	7	0	0	7	0	0
14	91642395	rs34302825	G	A	18	30	48	0	1	49	0	0
14	91737987	rs147815575	A	T	97	78	175	0	0	175	0	0
14	91738490	.	G	A	129	92	221	0	1	222	0	0
14	91738696	rs12878426	T	G	92	149	241	0	1	242	0	0
14	91738852	rs45608740	A	G	116	98	214	0	1	215	0	0
14	91739108	rs45542736	C	G	87	82	169	0	0	169	0	0
14	91744658	rs117169601	A	G	6	1	7	0	0	7	0	0
14	91744829	rs17802145	G	A	6	1	7	0	0	7	0	0
14	91747832	rs139544500	C	T	101	66	167	0	3	170	0	0
14	91748070	rs112307142	T	C	0	8	8	0	0	8	0	0
14	91752622	rs78270437	T	C	8	6	14	0	0	14	0	0
14	91753033	rs7143715	G	T	4	9	13	0	1	14	0	0
14	91753799	rs10131794	G	T	5	2	7	0	0	7	0	0
14	91755172	rs193123800	T	C	2	5	7	0	0	7	0	0
14	91755195	rs184269209	T	C	1	5	6	0	0	6	0	0
14	91755881	rs76070867	T	C	18	9	27	0	0	27	0	0
14	91756953	rs118180720	G	A	5	7	12	0	0	12	0	0
14	91756962	rs142610090	T	C	5	7	12	0	0	12	0	0
14	91757108	rs78704118	A	G	8	7	15	0	0	15	0	0
14	91757131	rs77176196	T	C	7	7	14	0	0	14	0	0
14	91763956	rs140497678	C	A	5	3	8	0	0	8	0	0
14	91764949	rs8021214	T	C	5	4	9	0	0	9	0	0
14	91764987	rs141411817	G	A	7	5	12	0	0	12	0	0
14	91765400	rs145684514	T	C	2	5	7	0	0	7	0	0
14	91780387	rs7160325	C	T	43	30	73	0	1	74	0	0
14	91810466	rs185015703	T	C	2	4	6	0	0	6	0	0
14	91845143	rs45490092	A	G	16	30	46	0	0	46	0	0
14	91847234	rs12437041	A	G	19	7	26	0	1	27	0	0
14	91847354	.	T	A	21	7	28	0	0	28	0	0
14	91847489	rs375162247	T	C	12	13	25	0	0	25	0	0
14	91847559	rs75059313	T	A	8	11	19	0	1	20	0	0
14	91848149	rs79190905	C	T	10	8	18	0	0	18	0	0
14	91872560	rs1285832	C	T	9	13	22	0	0	22	0	0
14	91873107	rs1285833	T	C	4	10	14	0	1	15	0	0
14	91873553	rs1285834	C	A	4	9	13	0	0	13	0	0
14	91873575	rs61988439	G	A	7	4	11	0	0	11	0	0
14	91877512	rs1285838	A	G	1	5	6	0	0	6	0	0
14	91923988	rs10329	C	A	10	6	16	0	0	16	0	0
14	91925027	rs10135595	G	T	360	348	708	0	6	714	0	0
14	91925822	rs17261197	T	C	2	9	11	0	0	11	0	0
14	91925906	rs36109547	T	C	7	4	11	0	0	11	0	0
14	91927243	.	G	T	5	4	9	0	0	9	0	0
14	91927521	rs8006485	G	T	4	3	7	0	1	8	0	0
14	91927717	rs8006817	G	A	4	9	13	0	0	13	0	0
14	91928812	rs3818259	G	T	5	6	11	0	0	11	0	0
14	91928992	rs5020186	T	G	6	11	17	0	0	17	0	0
14	91931139	rs2064963	C	A	6	0	6	0	0	6	0	0
14	91935587	rs12437182	A	G	5	3	8	0	0	8	0	0
14	91936044	rs1957081	T	C	4	9	13	0	0	13	0	0
14	91936697	rs10873408	A	C	6	9	15	0	0	15	0	0
14	91937143	rs10873409	G	A	6	5	11	0	0	11	0	0
14	91941141	rs11625753	T	C	18	22	40	0	0	40	0	0
14	91944911	rs876561	G	A	17	27	44	0	0	44	0	0
14	91945502	rs11626225	G	T	27	55	82	0	0	82	0	0
14	91945678	rs11626297	G	A	21	26	47	0	2	49	0	0
14	91946132	rs10146333	C	T	23	31	54	0	1	55	0	0
14	91946662	rs12589936	G	A	25	35	60	0	1	61	0	0
14	91946995	rs11628439	C	T	24	19	43	0	0	43	0	0
14	91947140	rs11628461	A	G	23	30	53	0	0	53	0	0
14	91947508	rs12050230	T	G	20	14	34	0	0	38	4	0
14	92436176	rs3742719	C	T	7	10	17	0	0	17	0	0
14	92441066	rs1051340	C	T	6	6	12	0	0	12	0	0
14	92471653	.	A	G	3	4	7	0	0	7	0	0
14	92506360	rs1955683	G	C	22	13	35	0	0	35	0	0
14	92515996	rs60107842	C	T	11	10	21	0	0	21	0	0
14	92516685	rs28628431	A	C	4	8	12	0	0	13	1	0
14	92525145	rs1047795	A	G	39	43	82	0	2	84	0	0
14	92526157	rs112733683	G	A	14	6	20	0	0	20	0	0
14	92526240	rs67089639	A	C	19	17	36	0	0	36	0	0
14	92526429	rs8009456	T	G	9	7	16	0	0	16	0	0
14	92526630	rs8008405	A	G	9	8	17	0	0	17	0	0
14	92526723	rs75002598	C	T	21	28	49	0	0	49	0	0
14	92527145	rs1134378	T	C	23	32	55	0	2	57	0	0
14	92527164	rs1134377	T	C	26	29	55	0	0	55	0	0
14	92527399	rs1055996	A	G	21	19	40	0	1	41	0	0
14	92528429	rs8019545	C	T	22	21	43	0	1	44	0	0
14	92529558	rs55966267	T	C	15	10	25	0	0	25	0	0
14	92530282	rs910369	C	A	9	14	23	0	0	23	0	0
14	92530513	rs709930	C	T	30	31	61	0	1	62	0	0
14	92534341	rs10140666	A	G	1	5	6	0	0	6	0	0
14	92534347	rs10129909	T	C	1	5	6	0	0	6	0	0
14	92546566	rs17127928	T	C	3	3	6	0	0	6	0	0
14	92547145	rs761551	G	T	7	6	13	0	0	13	0	0
14	92547176	rs761552	G	A	6	5	11	0	0	11	0	0
14	92548785	rs1048755	C	T	44	48	92	0	1	93	0	0
14	92550114	rs8013582	A	G	5	6	11	0	0	11	0	0
14	92550396	rs8014509	G	T	12	8	20	0	0	20	0	0
14	92550501	rs8014385	C	T	7	2	9	0	0	9	0	0
14	92551085	rs10138296	A	G	8	0	8	0	0	8	0	0
14	92551144	rs10138566	G	T	4	2	6	0	0	6	0	0
14	92552062	rs1072958	A	G	4	4	8	0	0	8	0	0
14	92552072	rs1072957	T	C	3	4	7	0	0	7	0	0
14	92552260	rs17127939	A	G	5	6	11	0	0	11	0	0
14	92553412	rs2402104	C	T	11	2	13	0	0	13	0	0
14	92553462	rs2402105	A	G	9	2	11	0	0	11	0	0
14	92553523	rs2896195	G	A	7	1	8	0	0	8	0	0
14	92553584	rs4410011	A	G	5	3	8	0	0	8	0	0
14	92553706	rs12435687	A	G	5	2	7	0	0	7	0	0
14	92553922	rs7149775	G	T	4	4	8	0	0	8	0	0
14	92554077	rs7154147	C	T	3	4	7	0	0	7	0	0
14	92555463	rs8003520	T	C	4	6	10	0	0	10	0	0
14	92555514	rs8022601	C	T	4	3	7	0	0	7	0	0
14	92556535	rs1884774	C	T	4	4	8	0	0	8	0	0
14	92556559	rs4420459	G	A	7	7	14	0	0	14	0	0
14	92557345	rs8013669	C	G	5	2	7	0	0	7	0	0
14	92557444	rs10135173	C	T	4	2	6	0	0	6	0	0
14	92559768	rs1997917	T	C	5	1	6	0	0	6	0	0
14	92559862	rs1997919	C	T	2	9	11	0	0	11	0	0
14	92584215	rs12883370	G	A	7	8	15	0	0	15	0	0
14	92585205	rs7152991	T	C	6	5	11	0	1	12	0	0
14	92587588	rs7143401	G	A	7	0	7	0	0	7	0	0
14	92587733	rs7143608	G	C	5	3	8	0	0	8	0	0
14	92588002	rs3818263	T	G	118	75	193	0	2	195	0	0
14	92628952	rs3088123	T	G	7	5	12	0	0	12	0	0
14	92630326	rs1126949	G	A	6	8	14	0	1	15	0	0
14	92981606	rs55930890	C	G	11	8	19	0	0	19	0	0
14	93117429	rs942064	T	C	3	3	6	0	0	6	0	0
14	93118198	rs3814830	C	T	32	31	63	0	1	64	0	0
14	93118668	rs3742717	C	T	126	106	232	0	0	232	0	0
14	93118669	rs3742716	G	A	109	119	228	0	6	234	0	0
14	93119725	rs61992600	G	A	11	5	16	0	0	16	0	0
14	93120683	rs34141236	A	G	5	3	8	0	0	8	0	0
14	93120719	rs11629324	C	T	7	6	13	0	1	14	0	0
14	93121370	rs11849307	T	C	15	5	20	0	1	21	0	0
14	93121725	rs61992602	A	G	8	9	17	0	2	19	0	0
14	93123142	rs11624035	A	G	9	11	20	0	0	20	0	0
14	93123534	rs35291284	C	T	8	10	18	0	1	19	0	0
14	93123549	rs2402174	G	A	10	8	18	0	1	19	0	0
14	93124994	rs56019622	C	G	12	14	26	0	0	26	0	0
14	93125282	rs12885166	G	T	4	7	11	0	0	11	0	0
14	93126557	rs7155457	T	C	8	7	15	0	0	15	0	0
14	93127184	rs12896481	G	A	8	4	12	0	0	12	0	0
14	93127411	rs12896830	G	A	16	10	26	0	0	26	0	0
14	93129982	rs11160087	G	A	6	15	21	0	0	21	0	0
14	93130227	rs4900140	A	G	22	11	33	0	0	33	0	0
14	93130778	rs12885278	T	A	6	5	11	0	0	11	0	0
14	93130840	rs12884371	G	C	4	7	11	0	0	11	0	0
14	93131107	rs188823420	G	A	6	3	9	0	0	9	0	0
14	93131547	rs8014880	G	A	10	7	17	0	0	17	0	0
14	93131849	rs12890220	G	C	6	4	10	0	0	10	0	0
14	93132299	rs12895078	G	C	13	8	21	0	0	21	0	0
14	93132938	rs4904971	T	G	16	10	26	0	0	26	0	0
14	93133120	rs59124998	C	T	17	8	25	0	2	27	0	0
14	93152184	rs12888973	T	C	46	28	74	0	1	75	0	0
14	93152220	rs4900141	A	G	47	30	77	0	0	77	0	0
14	93153538	rs2402184	A	G	9	21	30	0	1	31	0	0
14	93170993	rs9791	C	T	5	4	9	0	0	9	0	0
14	93407481	rs11160096	T	C	129	192	321	0	2	323	0	0
14	93407486	rs12588550	C	T	139	202	341	0	2	343	0	0
14	93684814	rs10132640	T	C	8	1	9	0	0	9	0	0
14	93693604	rs10144530	T	G	31	16	47	0	0	47	0	0
14	93707635	rs10873433	A	G	5	5	10	0	0	10	0	0
14	93707741	rs1129092	T	C	8	7	15	0	0	15	0	0
14	93707752	rs73340064	G	A	6	10	16	0	0	16	0	0
14	93707909	rs17749087	G	C	5	12	17	0	0	17	0	0
14	93708224	rs17128958	G	A	5	3	8	0	0	8	0	0
14	93754214	.	G	A	38	19	57	0	1	58	0	0
14	93755425	rs57538363	G	A	8	2	10	0	0	10	0	0
14	93755562	rs12433927	C	T	5	2	7	0	0	7	0	0
14	93755782	rs35015760	G	C	4	4	8	0	0	8	0	0
14	93757815	rs67685471	C	T	11	10	21	0	0	21	0	0
14	93787935	rs72708588	T	A	6	6	12	0	0	12	0	0
14	93787981	rs17129005	G	A	9	11	20	0	0	20	0	0
14	93796785	rs11160114	A	G	3	3	6	0	0	6	0	0
14	93796800	rs11160115	A	C	4	3	7	0	0	7	0	0
14	94400906	rs12370	G	A	4	3	7	0	1	8	0	0
14	94564542	rs2092788	C	A	1	5	6	0	0	6	0	0
14	94564710	rs2402409	G	A	4	2	6	0	0	6	0	0
14	94564718	rs2092789	C	G	5	2	7	0	0	7	0	0
14	94564919	rs748763	C	T	2	6	8	0	0	8	0	0
14	94567032	rs3818119	C	T	3	3	6	0	0	6	0	0
14	94567033	rs12590755	C	T	4	3	7	0	0	7	0	0
14	94567395	rs12437160	C	T	4	9	13	0	0	13	0	0
14	94567767	rs11852002	C	T	2	5	7	0	0	7	0	0
14	94568083	rs12881245	A	T	3	3	6	0	0	6	0	0
14	94582926	rs2799	C	G	33	32	65	0	1	66	0	0
14	94667278	rs1243125	A	G	5	1	6	0	0	6	0	0
14	94676919	rs66954835	A	G	3	6	9	0	0	9	0	0
14	94677805	rs35220388	A	G	6	11	17	0	0	17	0	0
14	94677873	rs10132066	T	G	4	11	15	0	0	15	0	0
14	94680587	rs11625726	G	T	6	12	18	0	0	18	0	0
14	94680656	rs7144141	T	C	7	10	17	0	0	17	0	0
14	94681174	rs10134125	T	C	2	7	9	0	0	9	0	0
14	94682047	rs12890827	A	G	3	3	6	0	0	6	0	0
14	94844843	rs1303	T	G	29	22	51	0	0	51	0	0
14	94856914	rs8004738	G	A	11	4	15	0	0	15	0	0
14	95556747	rs13078	A	T	21	10	31	0	0	31	0	0
14	95562015	.	T	C	32	33	65	0	0	65	0	0
14	95563712	rs1209904	T	C	4	3	7	0	0	7	0	0
14	95565556	rs1187655	T	C	2	8	10	0	0	10	0	0
14	95624926	rs11851369	T	G	2	7	9	0	0	9	0	0
14	95645872	rs3742332	T	C	9	3	12	0	0	12	0	0
14	95646020	rs14042	G	T	8	5	13	0	0	13	0	0
14	95648657	rs1054195	C	A	17	5	22	0	0	22	0	0
14	95648783	rs17091868	G	A	13	5	18	0	0	18	0	0
14	95651047	rs61217816	T	C	3	3	6	0	0	6	0	0
14	95651765	rs3814816	G	A	5	1	6	0	0	6	0	0
14	95652928	rs11844624	C	G	4	2	6	0	0	6	0	0
14	95659747	rs3180753	C	T	2	6	8	0	0	8	0	0
14	95660242	rs1128468	A	G	32	10	42	0	0	42	0	0
14	95873652	rs17111964	A	C	9	12	21	0	0	21	0	0
14	95874508	rs1047403	C	G	71	59	130	0	0	130	0	0
14	95883921	rs17755477	T	C	39	27	66	0	1	67	0	0
14	95906321	rs9671369	G	A	76	54	130	0	0	130	0	0
14	95906441	rs910791	A	G	4	6	10	0	0	10	0	0
14	95906476	rs910790	C	T	5	10	15	0	0	15	0	0
14	95907063	rs6575511	G	A	15	8	23	0	2	25	0	0
14	95908019	rs8020404	G	T	7	5	12	0	0	12	0	0
14	95908113	rs4905307	A	T	5	4	9	0	0	9	0	0
14	95908187	rs4905308	A	G	18	12	30	0	0	30	0	0
14	95908492	rs11624688	G	T	11	25	36	0	0	36	0	0
14	95908833	rs11160248	A	G	13	13	26	0	0	26	0	0
14	95910933	rs9919918	T	C	77	77	154	0	0	154	0	0
14	95912388	rs61749972	G	A	78	60	138	0	0	138	0	0
14	95917923	rs4905317	C	T	4	8	12	0	0	12	0	0
14	95918466	rs7144636	A	G	8	3	11	0	0	11	0	0
14	95918473	rs7144641	A	G	8	4	12	0	0	12	0	0
14	95918513	rs6575514	G	A	4	7	11	0	0	11	0	0
14	95918625	rs4905318	T	C	60	58	118	0	0	118	0	0
14	95983898	rs179146	A	T	4	2	6	0	0	6	0	0
14	96001440	rs573438674	T	C	2	7	9	0	0	9	0	0
14	96787747	rs8005907	T	C	4	3	7	0	0	7	0	0
14	99876216	rs2943	G	A	4	8	12	0	0	12	0	0
14	99876505	rs1047351	A	G	15	11	26	0	0	26	0	0
14	99887304	.	G	T	11	0	11	0	6	17	0	0
14	99887310	.	G	T	7	0	7	0	10	17	0	0
14	99932341	rs2144798	A	C	5	6	11	0	0	11	0	0
14	99933825	rs3809412	C	T	8	1	9	0	0	9	0	0
14	99934161	rs1884526	T	C	2	7	9	0	0	9	0	0
14	99935261	rs11621155	A	G	7	6	13	0	0	13	0	0
14	99936258	rs8011670	G	A	5	5	10	0	0	10	0	0
14	99936321	rs8011858	G	A	6	2	8	0	0	8	0	0
14	99936947	rs11622717	C	G	5	2	7	0	0	7	0	0
14	99948357	rs3918038	C	G	8	9	17	0	1	18	0	0
14	99948585	rs1950598	A	G	6	5	11	0	0	11	0	0
14	99949522	rs8015304	A	G	4	6	10	0	0	10	0	0
14	99954084	rs3918051	A	G	6	6	12	0	0	12	0	0
14	99954792	rs61984133	T	A	5	4	9	0	0	9	0	0
14	99957703	rs2400677	T	C	30	16	46	0	0	46	0	0
14	99957927	rs2400678	T	A	16	10	26	0	0	26	0	0
14	99961242	rs3783319	C	T	6	3	9	0	0	9	0	0
14	99961830	rs2069492	T	C	9	7	16	0	0	16	0	0
14	99963515	rs3918074	T	G	4	2	6	0	0	6	0	0
14	99964503	rs7158915	G	C	7	1	8	0	0	8	0	0
14	99968377	rs2069496	C	T	4	4	8	0	0	8	0	0
14	99971294	rs3918094	C	T	43	31	74	0	0	74	0	0
14	99980087	rs1998050	C	G	7	21	28	0	0	28	0	0
14	99981105	rs3742374	G	C	15	11	26	0	0	26	0	0
14	100600803	rs10148930	A	G	5	1	6	0	0	6	0	0
14	100604334	rs10138425	A	G	9	9	18	0	0	18	0	0
14	100604822	rs3783338	C	T	6	7	13	0	0	13	0	0
14	100604976	rs12879635	G	A	9	6	15	0	0	15	0	0
14	100607360	rs1951486	T	C	5	2	7	0	0	7	0	0
14	100740229	rs2146103	C	A	14	9	23	0	0	23	0	0
14	100758502	rs11557208	G	A	112	132	244	0	4	248	0	0
14	100847707	rs2273800	A	G	3	8	11	0	0	11	0	0
14	100996312	rs13065	T	C	3	8	11	0	0	11	0	0
14	102279972	.	T	G	7	8	15	0	0	15	0	0
14	102318428	rs72715678	A	G	4	4	8	0	0	8	0	0
14	102414825	rs2093025	T	C	2	4	6	0	0	6	0	0
14	102482399	rs17541158	C	T	84	76	160	0	3	163	0	0
14	102509953	rs1190605	G	C	11	12	23	0	0	23	0	0
14	102513098	.	G	C	14	16	30	0	0	30	0	0
14	102515171	rs1004904	A	G	8	3	11	0	0	11	0	0
14	102679193	rs45511198	A	C	5	4	9	0	0	9	0	0
14	102695693	rs2236493	T	C	5	2	7	0	0	7	0	0
14	102814111	.	A	G	5	6	11	0	0	11	0	0
14	103060465	rs3825565	G	A	12	6	18	0	0	18	0	0
14	103191471	rs941727	A	G	9	5	14	0	1	15	0	0
14	103195365	rs11548118	G	C	73	65	138	0	0	138	0	0
14	103343321	rs150769386	C	T	29	19	48	0	1	49	0	0
14	103343474	rs147157314	T	A	20	18	38	0	1	39	0	0
14	103344008	rs11627090	A	G	16	22	38	0	3	41	0	0
14	103353101	rs72704726	A	G	2	4	6	0	0	6	0	0
14	103361691	rs11626584	C	T	2	4	6	0	0	6	0	0
14	103362017	rs4906269	A	C	2	6	8	0	0	8	0	0
14	103362724	rs11627771	A	G	4	2	6	0	0	6	0	0
14	103364737	rs4906270	G	T	2	5	7	0	0	7	0	0
14	103366698	rs7156339	C	T	5	3	8	0	0	8	0	0
14	103370119	rs10132977	C	T	5	8	13	0	0	13	0	0
14	103373434	rs72704737	C	G	9	4	13	0	0	13	0	0
14	103374160	rs117897999	C	A	4	2	6	0	0	6	0	0
14	103376031	rs4906272	C	T	14	8	22	0	0	22	0	0
14	103377321	rs10133111	G	A	21	9	30	0	1	31	0	0
14	103377354	rs11552464	T	G	18	7	25	0	0	25	0	0
14	103397055	rs1190233	G	C	20	18	38	0	0	38	0	0
14	103399448	rs4708	T	C	7	4	11	0	0	11	0	0
14	103447292	rs56158661	G	A	5	10	15	0	0	15	0	0
14	103589842	rs3759571	A	G	8	6	14	0	0	14	0	0
14	103593950	rs1132339	C	G	29	11	40	0	0	40	0	0
14	103596488	rs2234131	G	A	4	3	7	0	0	7	0	0
14	103596609	rs2234133	T	A	7	2	9	0	0	9	0	0
14	103602278	rs710100	A	G	75	54	129	0	0	129	0	0
14	103603495	rs4283165	G	A	97	92	189	0	0	189	0	0
14	103603496	rs4369588	A	T	96	92	188	0	0	188	0	0
14	103603569	rs8126	C	T	141	104	245	0	2	247	0	0
14	103603694	rs1803188	T	A	27	45	72	0	1	73	0	0
14	104145933	.	C	T	7	11	18	0	0	18	0	0
14	105173831	rs3809455	G	T	15	22	37	0	0	37	0	0
14	105642983	.	C	T	31	20	51	0	0	51	0	0
14	105691474	rs2816644	T	C	6	7	13	0	2	15	0	0
14	105694870	rs4983594	G	A	2	4	6	0	0	6	0	0
14	105695446	rs2018404	C	T	4	2	6	0	0	6	0	0
14	105715515	rs2816605	C	T	28	15	43	0	0	43	0	0
14	105716034	rs2816606	C	T	75	35	110	0	0	110	0	0
14	105717279	rs4677	T	C	59	46	105	0	0	105	0	0
14	105717448	rs1882846	G	C	4	3	7	0	0	7	0	0
14	105717796	rs2735817	G	A	4	2	6	0	0	6	0	0
14	105722726	rs1008628	T	C	6	16	22	0	0	22	0	0
14	105858022	rs147461490	C	T	45	61	106	0	4	110	0	0
14	105921454	rs146637875	G	C	2	5	7	0	0	7	0	0
14	106134672	.	G	C	7	0	7	0	0	7	0	0
14	106173790	.	A	G	49	573	622	0	3	625	0	0
14	106173808	.	G	A	618	44	662	0	2	664	0	0
14	106207822	.	A	G	24	31	55	0	1	56	0	0
14	106207843	rs8011686	T	C	6	33	39	0	0	39	0	0
14	106208090	.	C	T	48	1	49	0	0	49	0	0
14	106303114	rs10136401	C	T	10	7	17	0	0	17	0	0
14	106303222	rs1055855	G	C	49	71	120	0	6	126	0	0
14	106303232	rs1055854	C	T	52	75	127	0	10	137	0	0
14	106303325	rs3764172	A	G	56	113	169	0	2	171	0	0
14	106303699	rs10139433	G	A	1	9	10	0	0	10	0	0
14	106304899	rs762807	G	T	9	8	17	0	0	17	0	0
14	106305038	rs762806	T	C	8	14	22	0	0	22	0	0
14	106305039	rs762805	G	A	8	14	22	0	0	22	0	0
14	106305260	rs2753488	A	G	6	10	16	0	2	18	0	0
14	106305461	rs11622796	T	G	12	9	21	0	0	21	0	0
14	106305816	rs2856953	T	C	7	9	16	0	6	22	0	0
14	106306394	rs2753490	C	T	6	4	10	0	0	10	0	0
14	106306841	rs709589	C	T	101	121	222	0	6	228	0	0
14	106307150	rs142240002	G	A	17	17	34	0	0	34	0	0
14	106307151	rs146778126	C	A	19	16	35	0	0	35	0	0
14	106307418	rs2753492	G	A	85	127	212	0	0	212	0	0
14	106309780	rs72637118	T	C	6	5	11	0	0	11	0	0
14	106310058	rs2856944	C	T	1	5	6	0	0	6	0	0
14	106310652	rs2856942	C	T	3	3	6	0	0	6	0	0
14	106310868	rs2753496	A	G	5	1	6	0	0	6	0	0
14	106310962	rs3751509	C	T	2	6	8	0	0	8	0	0
14	106311030	rs12589570	G	A	4	4	8	0	0	8	0	0
14	106311031	rs3751510	T	C	4	4	8	0	0	8	0	0
14	106321663	rs1059216	T	C	2679	3124	5803	0	28	5832	1	0
14	106321913	rs1136534	G	A	2333	2892	5225	0	22	5248	1	0
14	106323734	.	C	T	60	76	136	0	2	138	0	0
14	106324349	rs62651104	C	T	48	55	103	0	0	103	0	0
14	106325983	rs72637120	T	C	61	42	103	0	6	109	0	0
14	106329435	.	T	G	346	275	621	0	5	628	2	0
14	106359495	rs34536736	C	G	5	5	10	0	0	10	0	0
14	106362241	rs2753534	G	A	11	4	15	0	0	15	0	0
14	106384722	rs2006166	T	C	17	12	29	0	0	29	0	0
14	106384914	rs1808152	C	A	11	10	21	0	0	21	0	0
14	106385198	rs79497195	G	A	13	7	20	0	0	20	0	0
14	106385245	rs2857332	C	G	20	8	28	0	0	28	0	0
14	106385332	rs2250700	G	C	13	9	22	0	0	22	0	0
14	106386417	rs2257146	C	G	7	5	12	0	0	12	0	0
14	106387308	rs11845744	C	A	10	8	18	0	0	18	0	0
14	106387586	rs11846767	G	A	8	15	23	0	1	24	0	0
14	106387668	rs11846802	G	A	10	7	17	0	0	17	0	0
14	106387741	rs11846772	C	T	12	8	20	0	0	20	0	0
14	106391339	rs2516995	A	G	34	14	48	0	0	48	0	0
14	106391368	rs2106010	C	T	26	12	38	0	0	38	0	0
14	106391628	rs2262125	T	C	28	26	54	0	1	55	0	0
14	106391675	rs1811101	C	G	33	20	53	0	0	53	0	0
14	106405858	.	G	A	6	4	10	0	0	10	0	0
14	106452766	rs112806369	T	A	10	2	12	0	1	15	2	0
14	106471689	rs56372013	A	C	1	5	6	0	0	6	0	0
14	106518418	rs113047412	A	G	6	3	9	0	0	9	0	0
14	106518848	rs2073679	T	C	16	24	40	0	5	49	4	0
14	106573311	rs75474934	C	T	12	0	12	0	0	12	0	0
14	106573352	.	A	T	8	1	9	0	0	9	0	0
14	106573357	.	G	T	6	1	7	0	0	7	0	0
14	106573358	.	T	A	6	1	7	0	0	7	0	0
14	106573364	.	C	T	5	1	6	0	0	6	0	0
14	106641761	rs72695948	A	G	16	3	19	0	1	20	0	0
14	106926649	rs61999678	C	A	7	5	12	0	0	12	0	0
14	106993845	rs7148408	T	G	11	0	11	0	0	11	0	0
14	106993886	rs7146990	A	G	8	1	9	0	0	9	0	0
14	107013201	rs2073673	G	T	2	4	6	0	0	6	0	0
14	107048702	.	G	A	6	0	6	0	0	6	0	0
14	107170005	rs1141720	T	C	12	7	19	0	0	19	0	0
14	107170055	.	G	A	19	3	22	0	0	23	1	0
14	107170062	rs55891010	A	G	22	5	27	0	0	27	0	0
14	107170077	rs11845244	C	T	32	3	35	0	0	35	0	0
14	107170207	rs11845287	C	T	49	13	62	0	0	62	0	0
14	107170398	rs4448834	C	T	7	14	21	0	0	21	0	0
14	107211211	rs2073668	G	A	7	1	8	0	0	8	0	0
15	20588021	.	A	G	0	34	34	0	0	34	0	0
15	20588177	.	G	A	55	0	55	0	0	55	0	0
15	20588230	rs1846767	T	A	0	81	81	0	0	81	0	0
15	20588292	.	T	G	88	0	88	0	0	88	0	0
15	20588345	.	C	T	74	0	74	0	2	76	0	0
15	20588458	.	G	C	82	0	82	0	0	82	0	0
15	20588474	rs111409649	C	T	88	0	88	0	0	88	0	0
15	20588554	rs112526901	C	G	118	0	118	0	1	119	0	0
15	20588563	.	A	G	110	0	110	0	1	111	0	0
15	20588571	rs113432051	T	G	109	0	109	0	0	109	0	0
15	20588693	.	C	T	92	0	92	0	0	92	0	0
15	20591955	rs8028480	G	A	6	0	6	0	0	6	0	0
15	20617019	.	T	C	7	2	9	0	0	9	0	0
15	20617536	.	C	T	11	0	11	0	0	11	0	0
15	20618316	.	T	C	3	3	6	0	0	6	0	0
15	20642621	.	G	C	72	0	72	0	2	74	0	0
15	20644221	.	G	A	115	37	152	0	0	152	0	0
15	20644688	.	C	T	3	3	6	0	0	6	0	0
15	20662617	.	G	T	19	0	19	0	0	19	0	0
15	20662679	.	A	G	18	6	24	0	0	24	0	0
15	20874897	.	A	G	0	16	16	0	0	16	0	0
15	20874927	.	T	A	8	5	13	0	0	13	0	0
15	20876515	.	A	G	0	7	7	0	0	7	0	0
15	21936714	.	C	T	7	0	7	0	0	7	0	0
15	22546441	rs8033825	G	C	42	0	42	0	1	43	0	0
15	22840279	rs61744212	G	T	8	3	11	0	0	11	0	0
15	22873325	rs1046860	A	G	7	5	12	0	0	12	0	0
15	22929906	rs2305093	A	G	1	8	9	0	0	9	0	0
15	22930572	rs17137227	G	A	3	3	6	0	0	6	0	0
15	22930588	rs12909217	C	T	4	3	7	0	0	7	0	0
15	22960868	rs2289818	G	C	34	33	67	0	1	68	0	0
15	22964754	rs8037655	A	G	1	5	6	0	0	6	0	0
15	22998972	rs12438474	A	G	6	4	10	0	0	10	0	0
15	23003570	rs11636154	C	T	7	10	17	0	0	17	0	0
15	23007107	rs11263678	G	A	1	5	6	0	0	6	0	0
15	23021113	rs7170784	G	A	5	7	12	0	0	12	0	0
15	23024001	rs8028189	G	C	5	2	7	0	0	7	0	0
15	23032922	rs7172332	A	G	5	1	6	0	0	6	0	0
15	23033076	rs34460553	G	C	4	4	8	0	0	8	0	0
15	23033105	rs34674561	A	T	4	4	8	0	0	8	0	0
15	23046902	rs17807140	T	C	8	17	25	0	1	26	0	0
15	23047857	rs8025849	G	A	119	162	281	0	1	282	0	0
15	23048542	rs3812924	A	G	58	51	109	0	1	110	0	0
15	23052632	rs11263683	T	C	64	79	143	0	1	144	0	0
15	23053725	rs11638565	G	A	12	3	15	0	0	15	0	0
15	23054440	rs6606824	G	A	2	5	7	0	0	7	0	0
15	23058564	rs8026280	T	C	13	17	30	0	0	30	0	0
15	23085322	rs56401292	A	T	5	3	8	0	0	8	0	0
15	23095125	rs28523810	G	A	11	7	18	0	0	18	0	0
15	23098401	.	C	T	9	0	9	0	0	9	0	0
15	23098449	.	C	T	7	0	7	0	0	7	0	0
15	23098783	.	C	T	14	0	14	0	0	14	0	0
15	23098811	.	A	C	22	0	22	0	0	22	0	0
15	23108625	rs12324507	C	T	10	5	15	0	0	15	0	0
15	23114440	rs7180794	C	G	7	4	11	0	1	12	0	0
15	23114634	rs78924150	C	T	8	8	16	0	0	16	0	0
15	23129335	.	C	T	3	3	6	0	0	6	0	0
15	23130075	rs7165169	C	G	6	4	10	0	0	10	0	0
15	23133128	rs28379064	G	T	5	5	10	0	0	10	0	0
15	23133583	rs138956856	A	T	12	7	19	0	3	22	0	0
15	23136587	rs28513478	T	C	4	3	7	0	0	7	0	0
15	23137884	rs4778449	C	T	2	6	8	0	0	8	0	0
15	23189701	rs55687917	C	T	27	12	39	0	0	39	0	0
15	23191502	rs7167486	C	T	64	84	148	0	0	148	0	0
15	23191759	rs7402466	C	G	4	7	11	0	0	11	0	0
15	23193283	rs200466654	G	A	3	9	12	0	0	12	0	0
15	23193339	rs366539	G	C	9	7	16	0	0	16	0	0
15	23196410	rs78143759	T	C	7	5	12	0	0	12	0	0
15	23200080	rs376544	A	G	2	6	8	0	0	8	0	0
15	23200088	rs6606848	A	G	2	7	9	0	0	9	0	0
15	23200095	rs142526030	G	A	7	2	9	0	0	9	0	0
15	23200294	.	T	C	106	52	158	0	3	161	0	0
15	23200323	.	T	G	105	53	158	0	0	158	0	0
15	23201566	rs389677	C	A	48	39	87	0	1	88	0	0
15	23264983	rs74732485	G	A	11	0	11	0	0	11	0	0
15	23264985	rs62000634	G	T	12	0	12	0	0	12	0	0
15	23282589	rs11557517	A	G	159	63	222	0	0	222	0	0
15	23282925	.	G	T	140	24	164	0	1	165	0	0
15	23283157	.	T	C	103	35	138	0	2	140	0	0
15	23283671	.	G	T	18	14	32	0	0	32	0	0
15	23283711	rs295729	A	G	14	5	19	0	1	20	0	0
15	23283942	.	C	T	17	17	34	0	0	34	0	0
15	23285379	rs201281463	T	C	8	12	20	0	0	20	0	0
15	23300033	rs1058831	T	C	72	45	117	0	2	119	0	0
15	23931507	rs2192206	G	A	34	0	34	0	1	35	0	0
15	25211613	rs2855523	T	C	37	0	37	0	0	37	0	0
15	25211810	rs2732025	G	T	38	0	38	0	0	38	0	0
15	25215797	rs2554429	C	T	13	0	13	0	0	13	0	0
15	25216158	rs2554428	C	T	9	0	9	0	1	10	0	0
15	25216488	rs2732026	C	A	9	0	9	0	1	10	0	0
15	25219512	rs705	T	C	313	0	313	0	1	314	0	0
15	25229948	.	C	G	2	5	7	0	1	8	0	0
15	25229950	.	C	G	2	5	7	0	1	8	0	0
15	25231641	rs117581267	T	A	0	13	13	0	0	13	0	0
15	25232016	.	C	T	17	0	17	0	0	17	0	0
15	25362160	rs6576405	C	T	0	6	6	0	0	6	0	0
15	25362564	rs2356294	A	G	0	75	75	0	0	75	0	0
15	25926179	rs2076744	C	T	66	25	91	0	0	91	0	0
15	25926186	rs2076743	G	A	64	25	89	0	1	90	0	0
15	25952889	rs2291354	G	A	12	10	22	0	0	22	0	0
15	25953068	rs2291355	G	A	5	10	15	0	0	15	0	0
15	25953198	rs17555920	C	T	39	17	56	0	1	57	0	0
15	25955104	rs77977867	A	G	7	6	13	0	0	13	0	0
15	25955806	rs7179472	C	T	3	5	8	0	0	8	0	0
15	25956359	rs17637002	C	T	11	2	13	0	0	13	0	0
15	25956384	rs79085985	C	T	9	3	12	0	0	12	0	0
15	25956604	rs17555995	G	C	6	2	8	0	0	8	0	0
15	25962731	rs74003872	G	T	6	1	7	0	0	7	0	0
15	25963803	rs8024828	A	G	5	1	6	0	0	6	0	0
15	25963917	rs8025007	A	G	7	1	8	0	0	8	0	0
15	25964045	rs2014053	T	C	2	11	13	0	0	13	0	0
15	25964380	rs17556078	C	T	14	8	22	0	1	23	0	0
15	25964626	rs2014016	C	T	7	8	15	0	1	16	0	0
15	25964780	rs8029898	C	T	12	5	17	0	1	18	0	0
15	25965221	rs4534811	T	C	4	13	17	0	0	17	0	0
15	25965280	rs141094026	G	A	3	6	9	0	0	9	0	0
15	25969090	rs17116056	G	T	58	17	75	0	1	76	0	0
15	25970377	rs72703774	A	G	4	3	7	0	0	7	0	0
15	25973211	rs72703778	G	C	1	7	8	0	0	8	0	0
15	25973698	rs34825924	G	A	5	3	8	0	0	8	0	0
15	25978540	rs12915279	C	A	6	0	6	0	0	6	0	0
15	25978712	rs12914474	G	A	6	2	8	0	0	8	0	0
15	25978804	rs56075622	G	A	5	7	12	0	0	12	0	0
15	26025991	rs8036650	G	A	2	4	6	0	0	6	0	0
15	26026249	rs78266472	C	T	53	24	77	0	3	80	0	0
15	26087297	rs34894346	C	T	5	1	6	0	0	6	0	0
15	26102935	rs35031491	C	G	5	2	7	0	0	7	0	0
15	26102948	rs35773224	A	G	5	2	7	0	0	7	0	0
15	26890898	rs56383525	T	C	8	0	8	0	0	8	0	0
15	28211921	rs1800411	G	A	7	0	7	0	0	7	0	0
15	28356859	rs1129038	C	T	113	101	214	0	1	215	0	0
15	28386626	rs11636232	C	T	46	54	100	0	0	100	0	0
15	28412872	rs61756152	G	A	44	41	85	0	0	85	0	0
15	28467246	rs7163444	T	C	22	6	28	0	0	28	0	0
15	28475625	rs201872292	G	A	16	12	28	0	0	28	0	0
15	28502279	rs11631797	A	G	14	15	29	0	0	29	0	0
15	28916947	.	C	T	5	3	8	0	0	8	0	0
15	28947721	rs62009579	G	A	30	0	30	0	0	30	0	0
15	28949023	.	G	A	4	16	20	0	0	20	0	0
15	28955705	.	C	T	13	0	13	0	0	13	0	0
15	28960597	rs558569067	T	A	0	14	14	0	0	14	0	0
15	28991609	rs28703004	G	C	9	1	10	0	0	10	0	0
15	28991629	.	T	C	1	5	6	0	0	6	0	0
15	28994090	.	G	T	9	1	10	0	0	10	0	0
15	29034546	rs371464531	G	C	11	0	11	0	0	11	0	0
15	29034720	rs12101582	G	C	76	0	76	0	0	76	0	0
15	29042034	rs4966238	A	G	6	0	6	0	0	6	0	0
15	29043486	rs11630596	C	T	7	0	7	0	1	8	0	0
15	29043511	rs1877706	T	G	7	0	7	0	0	7	0	0
15	29054286	rs6606924	T	A	62	0	62	0	0	62	0	0
15	30653922	.	G	A	8	1	9	0	0	9	0	0
15	30777143	rs7174800	A	T	4	7	11	0	0	11	0	0
15	30778351	rs11635528	T	C	24	14	38	0	0	38	0	0
15	30781310	.	G	A	11	7	18	0	1	19	0	0
15	30781885	rs62017513	C	T	96	132	228	0	2	230	0	0
15	30836792	.	A	G	8	1	9	0	0	9	0	0
15	30846509	.	A	G	4	5	9	0	0	9	0	0
15	30851899	.	A	T	6	0	6	0	0	6	0	0
15	30899336	.	G	C	3	6	9	0	1	10	0	0
15	30900873	.	T	C	9	2	11	0	0	11	0	0
15	30900895	rs80198225	G	A	9	4	13	0	0	13	0	0
15	30909443	rs3910034	A	G	5	12	17	0	0	17	0	0
15	30909446	.	T	G	17	0	17	0	0	17	0	0
15	30909487	.	A	G	15	0	15	0	0	15	0	0
15	30917889	.	A	G	3	8	11	0	0	11	0	0
15	30939463	rs2128873	G	A	0	6	6	0	0	6	0	0
15	30941233	rs11070493	C	G	2	5	7	0	0	7	0	0
15	31060115	rs4779494	T	C	27	41	68	0	0	68	0	0
15	31060886	rs1071932	C	G	15	4	19	0	0	19	0	0
15	31061844	rs2339019	A	C	4	10	14	0	0	14	0	0
15	31062380	rs12915931	T	C	10	7	17	0	1	18	0	0
15	31062406	rs145448013	C	T	10	8	18	0	0	18	0	0
15	31063058	rs4779777	A	G	5	13	18	0	0	18	0	0
15	31093425	rs798093	A	C	1	12	13	0	0	13	0	0
15	31115853	rs798123	G	T	5	13	18	0	0	18	0	0
15	31117210	rs798126	G	A	5	9	14	0	1	15	0	0
15	31117842	rs7171983	C	T	6	2	8	0	0	8	0	0
15	31118207	rs798128	C	T	16	13	29	0	1	30	0	0
15	31125348	rs798083	T	C	6	5	11	0	0	11	0	0
15	31125545	rs2339043	C	T	5	5	10	0	0	10	0	0
15	31126401	rs146353869	C	A	4	5	9	0	0	9	0	0
15	31127411	.	G	A	13	29	42	0	0	42	0	0
15	31127554	rs739831	C	T	4	2	6	0	0	6	0	0
15	31129037	rs11070624	G	A	19	2	21	0	0	21	0	0
15	31133420	rs58844471	A	G	5	1	6	0	0	6	0	0
15	31174519	rs8035438	A	G	11	3	14	0	0	14	0	0
15	31175269	rs8036176	C	T	12	2	14	0	0	14	0	0
15	31191687	rs28708881	C	T	20	4	24	0	1	25	0	0
15	31197564	rs4779794	G	A	24	9	33	0	0	33	0	0
15	31211323	rs2955798	C	T	14	17	31	0	0	31	0	0
15	31211886	rs2959038	T	C	14	6	20	0	0	20	0	0
15	31216225	rs61997076	C	T	4	3	7	0	0	7	0	0
15	31218164	rs2959037	T	C	20	10	30	0	0	30	0	0
15	31219568	.	T	C	30	37	67	0	1	68	0	0
15	31219742	rs2959036	T	G	44	26	70	0	0	70	0	0
15	31219788	rs2955777	A	C	38	28	66	0	1	67	0	0
15	31229420	rs2955795	T	C	50	28	78	0	1	79	0	0
15	31230078	rs2949567	T	C	10	2	12	0	0	12	0	0
15	31230611	rs34017474	T	C	3	19	22	0	0	22	0	0
15	31231255	rs2873	A	G	141	112	253	0	1	254	0	0
15	31232581	rs1043742	A	C	64	69	133	0	2	135	0	0
15	31234981	rs11293	G	A	44	50	94	0	1	95	0	0
15	31235005	rs3512	G	C	36	56	92	0	0	92	0	0
15	31235452	rs7168641	G	A	8	4	12	0	0	12	0	0
15	31236788	.	T	A	19	9	28	0	1	29	0	0
15	31237776	rs35256769	G	A	31	39	70	0	1	71	0	0
15	31238094	.	C	T	33	22	55	0	0	55	0	0
15	31238271	rs61997079	G	C	31	37	68	0	1	69	0	0
15	31238423	rs11629793	G	A	40	25	65	0	0	65	0	0
15	31238572	rs2949569	A	G	24	47	71	0	0	71	0	0
15	31238783	rs11637469	T	C	57	52	109	0	1	110	0	0
15	31240957	rs8034856	T	C	13	8	21	0	0	21	0	0
15	31241346	rs35811129	G	A	14	2	16	0	2	18	0	0
15	31242540	rs2949570	T	C	6	3	9	0	0	9	0	0
15	31243173	rs11634761	A	C	2	5	7	0	0	7	0	0
15	31243259	rs2949571	G	C	5	11	16	0	0	16	0	0
15	31243792	rs2140734	T	G	5	4	9	0	1	10	0	0
15	31244083	rs2955790	T	G	6	7	13	0	0	13	0	0
15	31244495	rs7176569	T	G	4	2	6	0	0	6	0	0
15	31251366	rs2949573	G	A	3	6	9	0	0	9	0	0
15	31251648	rs2959054	G	C	1	5	6	0	0	6	0	0
15	31251781	rs2949574	T	C	5	7	12	0	1	13	0	0
15	31253984	rs34693097	A	G	5	8	13	0	2	15	0	0
15	31254588	rs35784593	G	A	11	4	15	0	0	15	0	0
15	31255438	rs11639169	C	T	1	8	9	0	0	9	0	0
15	31255957	rs2955783	G	A	7	3	10	0	0	10	0	0
15	31260396	rs182750033	T	C	18	13	31	0	0	31	0	0
15	31262808	rs2949577	C	T	5	7	12	0	0	12	0	0
15	31263057	rs35396566	T	C	9	12	21	0	0	21	0	0
15	31263272	rs1524876	C	T	16	13	29	0	1	30	0	0
15	31263728	rs1404469	G	A	18	12	30	0	1	31	0	0
15	31263872	rs1404470	T	C	11	10	21	0	0	21	0	0
15	31267147	rs1133642	C	T	101	88	189	0	1	190	0	0
15	31619607	rs11537749	G	A	3	4	7	0	0	7	0	0
15	31651025	rs7168479	C	T	3	4	7	0	0	7	0	0
15	31651095	rs12905107	G	A	4	3	7	0	0	7	0	0
15	31652783	rs4779867	G	C	5	1	6	0	0	6	0	0
15	31656554	rs11070980	T	C	4	3	7	0	0	7	0	0
15	31660238	rs4081975	G	C	3	3	6	0	0	6	0	0
15	31663368	rs8027784	C	G	3	6	9	0	0	9	0	0
15	31665443	rs4779520	C	T	261	239	500	0	1	501	0	0
15	31667796	rs6493629	C	T	279	259	538	0	5	543	0	0
15	31668706	rs12595641	G	A	386	332	718	0	3	721	0	0
15	32450704	.	G	A	0	18	18	0	0	18	0	0
15	32697800	rs62005485	G	A	19	9	28	0	0	28	0	0
15	32743663	.	G	T	25	10	35	0	0	35	0	0
15	32783757	.	G	A	15	6	21	0	0	21	0	0
15	32787187	.	T	C	15	30	45	0	0	45	0	0
15	32792079	rs201154822	C	T	1	12	13	0	0	13	0	0
15	32792157	.	G	A	1	5	6	0	0	6	0	0
15	32812854	rs10444845	T	C	36	20	56	0	1	57	0	0
15	32813842	rs12439558	G	A	13	11	24	0	0	24	0	0
15	32815321	rs61620792	C	T	162	154	316	0	4	320	0	0
15	32872955	.	G	C	38	18	56	0	0	56	0	0
15	32872978	.	A	G	41	16	57	0	1	58	0	0
15	32878247	rs78957894	A	G	26	9	35	0	0	35	0	0
15	32878248	rs77294960	G	A	26	9	35	0	0	35	0	0
15	32878265	rs79517917	A	G	23	14	37	0	0	37	0	0
15	32879149	.	T	G	64	12	76	0	1	77	0	0
15	32898648	rs4517757	A	G	144	40	184	0	1	185	0	0
15	32898811	rs62000954	G	C	157	82	239	0	1	240	0	0
15	32907384	rs4991470	A	G	5	7	12	0	0	12	0	0
15	32907712	rs73369102	C	T	3	8	11	0	1	12	0	0
15	32912511	rs62001760	C	A	3	5	8	0	0	8	0	0
15	32914444	.	T	C	6	0	6	0	0	6	0	0
15	32930351	rs140316283	T	C	26	69	95	0	0	95	0	0
15	32930505	rs4779582	G	C	64	39	103	0	3	106	0	0
15	32931904	rs4544214	T	A	12	3	15	0	0	15	0	0
15	33023486	rs12915554	C	A	60	67	127	0	0	127	0	0
15	33023670	rs33963919	C	T	24	50	74	0	0	74	0	0
15	33023685	rs17816260	A	C	24	49	73	0	2	75	0	0
15	33023951	rs3743105	T	C	39	79	118	0	0	118	0	0
15	33023985	rs3743104	A	G	40	68	108	0	1	109	0	0
15	33024455	rs7162202	T	G	86	60	146	0	1	147	0	0
15	33025627	rs3743103	C	T	73	96	169	0	1	170	0	0
15	34532109	.	T	C	3	3	6	0	0	6	0	0
15	34542606	rs17236791	T	C	3	7	10	0	0	10	0	0
15	34634020	rs7173	C	T	240	191	431	0	2	433	0	0
15	35160436	rs7165835	T	G	5	6	11	0	0	11	0	0
15	35190383	rs12901028	A	G	4	2	6	0	0	6	0	0
15	35232179	rs4924370	A	T	3	3	6	0	0	6	0	0
15	35256126	rs9920236	G	A	11	1	12	0	0	12	0	0
15	35272702	rs10438394	G	A	9	5	14	0	1	15	0	0
15	35273620	rs4923849	C	T	9	14	23	0	0	23	0	0
15	38777833	rs61047925	A	C	37	25	62	0	1	63	0	0
15	38790885	rs4467032	T	C	4	3	7	0	0	7	0	0
15	38799369	rs7177101	G	A	5	1	6	0	0	6	0	0
15	38802755	rs12595767	T	C	8	3	11	0	0	11	0	0
15	39889481	.	G	T	4	9	13	0	3	16	0	0
15	40313083	rs12916520	G	T	13	0	13	0	0	13	0	0
15	40313141	rs3207297	C	T	95	111	206	0	0	206	0	0
15	40327690	.	A	T	59	43	102	0	1	103	0	0
15	40328575	rs7535	G	C	1331	1099	2430	0	15	2447	2	0
15	40328665	rs8208	G	A	1410	1117	2527	0	13	2540	0	0
15	40328973	rs2291620	A	G	10	6	16	0	0	16	0	0
15	40329033	rs2291619	A	G	11	9	20	0	0	20	0	0
15	40329817	.	C	G	12	0	12	0	0	12	0	0
15	40330564	rs7321	C	T	1253	989	2242	0	11	2253	0	0
15	40330629	rs8041057	C	T	19	24	43	0	0	43	0	0
15	40330693	rs937215	C	T	14	23	37	0	0	37	0	0
15	40380207	rs8116	T	A	261	253	514	0	1	515	0	0
15	40380818	rs1540686	A	G	550	548	1098	0	2	1101	1	0
15	40380933	rs648289	T	C	511	541	1052	0	6	1058	0	0
15	40381272	rs34500961	C	T	230	252	482	0	8	491	1	0
15	40385227	rs1106508	A	G	11	16	27	0	0	27	0	0
15	40387728	rs11637595	C	T	18	11	29	0	0	29	0	0
15	40387971	rs11637681	A	G	28	16	44	0	0	44	0	0
15	40388067	rs543399	C	T	8	22	30	0	0	30	0	0
15	40388492	rs11634257	T	A	18	13	31	0	1	32	0	0
15	40389658	rs770470	C	T	12	7	19	0	0	19	0	0
15	40389794	rs569539	G	A	15	7	22	0	0	22	0	0
15	40389870	rs568652	C	A	9	13	22	0	0	22	0	0
15	40391965	rs35603048	C	T	3	3	6	0	0	6	0	0
15	40393262	rs500804	G	A	7	4	11	0	0	11	0	0
15	40394730	rs495654	C	G	6	4	10	0	0	10	0	0
15	40394859	rs675173	G	A	10	5	15	0	1	16	0	0
15	40395604	rs11631335	A	G	4	4	8	0	0	8	0	0
15	40396001	rs34231574	C	T	11	3	14	0	0	14	0	0
15	40398754	rs484943	T	C	38	74	112	0	4	116	0	0
15	40400195	rs35477346	T	C	41	38	79	0	2	81	0	0
15	40453307	rs2277559	A	G	3	3	6	0	0	6	0	0
15	40545438	rs11636097	A	G	4	7	11	0	0	11	0	0
15	40565817	rs35644942	G	T	18	12	30	0	0	30	0	0
15	40568823	rs2242119	C	A	19	9	28	0	1	29	0	0
15	40583560	rs62021888	G	T	26	28	54	0	0	54	0	0
15	40589002	rs2229691	A	G	125	166	291	0	10	301	0	0
15	40589830	rs2305649	G	A	17	11	28	0	0	28	0	0
15	40590134	rs2229690	G	A	204	193	397	0	1	398	0	0
15	40595565	rs2305645	C	T	10	8	18	0	0	18	0	0
15	40595627	rs1869901	G	A	4	7	11	0	0	11	0	0
15	40675443	rs7169404	G	T	6	11	17	0	0	17	0	0
15	40675493	rs7169262	C	T	5	12	17	0	0	17	0	0
15	40683702	rs11541642	A	G	7	18	25	0	1	26	0	0
15	40708644	rs112366697	C	T	5	1	6	0	0	6	0	0
15	40710108	rs11638033	A	T	2	5	7	0	0	7	0	0
15	40710723	rs2075624	G	A	10	30	40	0	0	40	0	0
15	40713374	rs11557072	G	A	27	24	51	0	0	51	0	0
15	40728036	rs12368	C	T	32	39	71	0	0	71	0	0
15	40760116	rs8826	G	C	146	169	315	0	2	317	0	0
15	40764549	rs582736	G	A	21	14	35	0	1	36	0	0
15	40827030	rs12916323	C	G	1	7	8	0	0	8	0	0
15	40842275	rs921624	T	C	8	6	14	0	0	14	0	0
15	40842299	rs8025458	G	A	7	5	12	0	0	12	0	0
15	40845838	.	T	A	54	52	106	0	1	107	0	0
15	40847008	rs2278887	C	T	4	2	6	0	0	6	0	0
15	40847404	rs2278889	G	A	7	2	9	0	0	9	0	0
15	40849326	rs76717634	G	T	2	5	7	0	0	7	0	0
15	41038082	rs12372947	C	G	4	2	6	0	0	6	0	0
15	41099349	rs11070297	C	T	8	2	10	0	0	10	0	0
15	41101124	rs3743033	C	G	4	5	9	0	0	9	0	0
15	41101145	rs3743034	C	T	6	8	14	0	0	14	0	0
15	41106485	rs7915	A	C	16	32	48	0	0	48	0	0
15	41773881	.	A	G	264	219	483	0	3	486	0	0
15	41774423	rs1942	A	G	252	271	523	0	9	532	0	0
15	41775033	.	G	C	143	129	272	0	4	276	0	0
15	41857303	rs2277536	T	C	2	6	8	0	0	8	0	0
15	42003316	rs61736063	G	A	31	23	54	0	1	55	0	0
15	42235316	rs11549015	C	T	33	30	63	0	0	63	0	0
15	42705713	rs28364555	C	T	89	91	180	0	12	192	0	0
15	42860551	rs141958762	A	T	40	48	88	0	0	88	0	0
15	43170793	rs6493068	A	G	16	22	38	0	2	40	0	0
15	43212818	rs12437637	C	G	10	16	26	0	1	27	0	0
15	43252764	rs3759792	A	G	4	2	6	0	0	6	0	0
15	44045062	rs188286242	G	A	9	4	13	0	0	13	0	0
15	44599632	rs138107329	T	G	1	6	7	0	0	7	0	0
15	44819513	rs2259359	A	T	10	4	14	0	0	14	0	0
15	44943757	rs3759871	A	G	31	23	54	0	0	54	0	0
15	45008790	rs117487508	C	T	266	285	551	0	2	553	0	0
15	45459873	rs144637171	C	T	5	23	28	0	3	31	0	0
15	45654327	rs1145086	A	G	7	5	12	0	0	12	0	0
15	45661678	rs1288775	T	A	6	3	9	0	0	9	0	0
15	45695695	rs1153849	G	A	15	19	34	0	1	35	0	0
15	45707861	.	C	T	26	35	61	0	0	61	0	0
15	49281624	rs1054307	A	C	30	39	69	0	0	69	0	0
15	49282165	rs11542124	T	G	114	149	263	0	3	267	1	0
15	49284065	rs8033060	T	C	104	96	200	0	1	201	0	0
15	49293873	rs9920868	C	T	4	8	12	0	0	12	0	0
15	49296722	rs4435198	A	G	5	2	7	0	0	7	0	0
15	49298089	rs4774536	G	A	2	4	6	0	0	6	0	0
15	49301293	rs7167402	A	C	6	13	19	0	0	19	0	0
15	49302264	rs4775796	G	A	8	8	16	0	0	16	0	0
15	49302682	rs4775797	C	T	13	9	22	0	0	22	0	0
15	49303451	rs12900819	C	G	10	4	14	0	0	14	0	0
15	49304651	rs8029914	C	T	13	9	22	0	0	22	0	0
15	49310150	rs2305195	G	A	13	7	20	0	0	20	0	0
15	49310279	rs34825252	T	A	4	3	7	0	0	7	0	0
15	49310300	rs35212550	G	A	5	2	7	0	0	7	0	0
15	49310713	rs7166261	T	C	15	15	30	0	0	30	0	0
15	49310869	rs11635777	C	T	11	24	35	0	1	36	0	0
15	49314476	rs6493346	G	T	9	18	27	0	0	27	0	0
15	49318289	rs12441272	A	T	8	7	15	0	0	15	0	0
15	49322437	rs11858917	T	C	2	4	6	0	0	6	0	0
15	49325289	rs11638215	A	C	108	52	160	0	1	161	0	0
15	49328222	rs12909616	A	G	4	3	7	0	0	7	0	0
15	49417546	rs1048975	T	G	4	23	27	0	1	28	0	0
15	49421868	rs507054	T	G	3	3	6	0	1	7	0	0
15	49423357	rs2246995	A	C	6	9	15	0	0	15	0	0
15	49423370	rs8043493	C	T	12	7	19	0	0	19	0	0
15	49423408	rs2247003	C	T	7	12	19	0	0	19	0	0
15	49423723	rs600863	G	T	17	15	32	0	1	33	0	0
15	49424044	rs12905094	A	G	3	6	9	0	0	9	0	0
15	49427487	rs3105866	A	C	5	3	8	0	0	8	0	0
15	49427607	rs12438777	C	T	9	10	19	0	0	19	0	0
15	49454018	rs7167338	C	T	2	6	8	0	0	8	0	0
15	49917341	rs3210227	G	A	4	5	9	0	0	9	0	0
15	49922325	rs56057624	A	G	4	2	6	0	0	6	0	0
15	49936238	rs1048348	T	C	6	3	9	0	0	9	0	0
15	50151140	rs12915207	A	G	56	2	58	0	3	61	0	0
15	50151263	rs1059852	G	A	53	1	54	0	1	55	0	0
15	50151433	rs1059851	T	A	20	1	21	0	0	21	0	0
15	50151529	rs1059850	G	A	41	0	41	0	0	41	0	0
15	50152166	rs4494482	T	A	63	0	63	0	1	64	0	0
15	50152190	rs4544192	C	T	77	0	77	0	0	77	0	0
15	50152274	rs4494483	T	A	91	1	92	0	0	92	0	0
15	50158695	rs11630021	C	A	15	0	15	0	0	15	0	0
15	50159659	rs16962999	T	C	14	1	15	0	0	15	0	0
15	50161355	rs11070733	C	T	6	0	6	0	0	6	0	0
15	50163181	rs61618346	G	A	16	0	16	0	0	16	0	0
15	50163808	rs17487348	G	A	0	9	9	0	0	9	0	0
15	50163854	rs8041979	A	G	6	0	6	0	0	6	0	0
15	50164149	rs8042458	A	G	11	0	11	0	0	11	0	0
15	50178422	rs4775845	C	T	6	0	6	0	0	6	0	0
15	50179371	rs12914231	A	G	20	3	23	0	0	23	0	0
15	50180635	rs35996890	A	T	14	0	14	0	0	14	0	0
15	50181309	rs2413974	A	T	16	1	17	0	0	17	0	0
15	50181491	rs76216655	G	A	16	0	16	0	0	16	0	0
15	50184767	rs17487811	A	G	22	2	24	0	1	25	0	0
15	50401876	rs56123457	G	A	0	6	6	0	0	6	0	0
15	50411840	rs11853852	C	T	2	4	6	0	0	6	0	0
15	50570036	rs12923	A	G	80	58	138	0	0	138	0	0
15	50570369	rs1050571	T	C	23	36	59	0	1	60	0	0
15	50571444	rs4775872	T	C	12	2	14	0	0	14	0	0
15	50572398	rs12906304	C	T	10	3	13	0	0	13	0	0
15	50572477	rs35033384	G	A	12	2	14	0	0	14	0	0
15	50572601	rs12910368	A	G	11	7	18	0	0	18	0	0
15	50573523	rs144841065	A	C	4	3	7	0	0	7	0	0
15	50573557	rs7179756	C	T	5	2	7	0	0	7	0	0
15	50574621	rs11635546	G	A	5	2	7	0	0	7	0	0
15	50577160	rs11633903	T	A	3	4	7	0	0	7	0	0
15	50577794	rs12440811	T	C	18	8	26	0	1	27	0	0
15	50598176	rs11638564	T	A	4	3	7	0	0	7	0	0
15	50598474	rs28690939	T	C	6	1	7	0	0	7	0	0
15	50609905	rs62022571	C	G	0	6	6	0	0	6	0	0
15	50626787	rs8043257	T	C	3	3	6	0	0	6	0	0
15	50626829	rs8042451	G	C	5	3	8	0	0	8	0	0
15	50640584	rs28408662	C	T	7	6	13	0	0	13	0	0
15	50640880	rs11629603	G	A	3	3	6	0	0	6	0	0
15	50641385	rs28534445	T	C	5	3	8	0	0	8	0	0
15	50642916	rs6493430	T	C	20	18	38	0	0	38	0	0
15	50645530	rs526045	G	T	9	3	12	0	0	12	0	0
15	50645617	rs526952	G	A	10	7	17	0	0	17	0	0
15	55483890	rs17238164	A	G	3	6	9	0	0	9	0	0
15	55496313	rs12907749	T	G	15	17	32	0	0	32	0	0
15	55581774	rs35720996	G	C	3	3	6	0	0	6	0	0
15	55609565	rs34473609	T	G	38	28	66	0	0	66	0	0
15	55609692	rs28685005	C	T	40	40	80	0	0	80	0	0
15	55611126	rs12902710	T	C	14	31	45	0	1	46	0	0
15	55632859	rs678892	G	T	6	8	14	0	0	14	0	0
15	56120721	rs2899593	C	T	29	14	43	0	0	43	0	0
15	56120962	rs16976592	T	C	4	5	9	0	0	9	0	0
15	56121354	rs12899701	A	C	3	8	11	0	0	11	0	0
15	56121886	rs1042477	C	A	15	10	25	0	0	25	0	0
15	56152729	rs2303579	T	C	26	12	38	0	0	38	0	0
15	56152872	rs2303580	C	T	25	12	37	0	0	37	0	0
15	56243766	rs61732704	C	T	19	19	38	0	0	38	0	0
15	56427215	.	T	G	8	4	12	0	0	12	0	0
15	56990974	rs28526288	T	C	3	3	6	0	0	6	0	0
15	56990983	rs7172110	C	A	3	3	6	0	0	6	0	0
15	57022710	rs8035474	A	C	5	3	8	0	0	8	0	0
15	57023417	rs7182346	T	G	3	5	8	0	0	8	0	0
15	57210562	rs213150	C	A	10	6	16	0	0	16	0	0
15	57211998	rs114409025	C	G	5	2	7	0	0	7	0	0
15	57243924	rs114816213	T	G	3	3	6	0	0	6	0	0
15	57246459	rs12903733	T	G	7	5	12	0	0	12	0	0
15	57254842	rs1642929	T	A	6	9	15	0	0	15	0	0
15	57288378	rs8039899	G	C	1	5	6	0	0	6	0	0
15	57288766	rs8023816	A	G	2	5	7	0	0	7	0	0
15	57356428	rs8030618	C	G	8	12	20	0	0	20	0	0
15	57360536	rs28718703	T	A	3	3	6	0	0	6	0	0
15	57422019	rs1462155	T	C	9	16	25	0	0	25	0	0
15	57423845	rs16977249	C	A	14	6	20	0	0	20	0	0
15	57424988	rs12102210	C	T	2	5	7	0	0	7	0	0
15	57581309	rs8034843	G	A	39	25	64	0	0	64	0	0
15	57596350	rs2414500	G	A	4	2	6	0	0	6	0	0
15	57597280	rs2243504	T	G	6	11	17	0	0	17	0	0
15	57598354	rs78901203	A	G	6	6	12	0	1	13	0	0
15	57598471	rs734101	A	G	3	12	15	0	0	15	0	0
15	59199578	rs78733923	T	C	2	5	7	0	0	7	0	0
15	59931131	rs4232	A	G	48	19	67	0	0	67	0	0
15	59945107	rs34894301	C	A	3	4	7	0	0	7	0	0
15	59949625	rs7164756	T	G	86	59	145	0	0	145	0	0
15	59951573	rs7882	A	G	23	13	36	0	0	36	0	0
15	59952124	rs6494133	G	T	14	3	17	0	0	17	0	0
15	59952253	rs4775195	C	G	18	12	30	0	1	31	0	0
15	59952341	rs11071467	T	C	16	6	22	0	0	22	0	0
15	59952905	rs11854063	A	G	4	16	20	0	0	20	0	0
15	59953314	rs8033161	C	T	6	14	20	0	0	20	0	0
15	59953908	rs6151592	A	G	4	3	7	0	0	7	0	0
15	59954569	rs6151586	T	A	6	10	16	0	0	16	0	0
15	59954723	rs1871499	T	A	6	5	11	0	0	11	0	0
15	59955651	rs2306355	A	G	163	106	269	0	4	273	0	0
15	59955668	rs1057059	A	C	104	138	242	0	1	243	0	0
15	59956730	rs6151581	G	A	7	8	15	0	0	15	0	0
15	59957585	rs8040114	C	T	13	2	15	0	0	15	0	0
15	59958771	rs6151576	C	T	11	8	19	0	0	19	0	0
15	59958811	rs6151574	A	G	6	13	19	0	0	19	0	0
15	59958984	rs4775197	T	C	5	1	6	0	0	6	0	0
15	59960155	rs6151570	G	C	15	9	24	0	0	24	0	0
15	59960261	rs6151568	T	C	6	16	22	0	0	22	0	0
15	59960719	rs62015289	T	A	3	3	6	0	0	6	0	0
15	59960980	rs6151565	C	T	3	4	7	0	0	7	0	0
15	59961752	rs6151561	C	T	5	1	6	0	0	6	0	0
15	59963477	.	T	C	232	146	378	0	3	381	0	0
15	59963488	rs1135148	A	G	161	221	382	0	1	383	0	0
15	59965441	rs12907554	A	T	8	14	22	0	0	22	0	0
15	59966020	rs12912652	C	T	24	10	34	0	0	34	0	0
15	59966221	rs67820349	G	A	11	7	18	0	0	18	0	0
15	59966553	rs12593480	G	A	8	3	11	0	0	11	0	0
15	59966649	rs7497974	T	A	14	13	27	0	0	27	0	0
15	59966920	rs11071468	A	T	23	27	50	0	0	50	0	0
15	59967047	rs11071469	C	T	15	12	27	0	2	29	0	0
15	59967117	rs10162629	G	C	7	12	19	0	0	19	0	0
15	59967505	rs2899649	A	T	14	9	23	0	0	23	0	0
15	59967774	rs12903647	C	G	12	20	32	0	0	32	0	0
15	59968148	rs6151533	C	G	15	20	35	0	0	35	0	0
15	59968213	rs6151532	T	C	8	13	21	0	0	21	0	0
15	59968414	rs6151529	A	C	14	12	26	0	1	27	0	0
15	59968486	rs6151528	C	A	6	12	18	0	1	19	0	0
15	59968888	rs6151525	A	G	27	50	77	0	1	78	0	0
15	59970298	rs2307272	C	A	8	16	24	0	0	24	0	0
15	59970420	rs6151514	A	G	7	15	22	0	0	22	0	0
15	59971532	rs1552031	A	G	9	14	23	0	0	23	0	0
15	59971615	rs1002181	G	C	6	12	18	0	4	22	0	0
15	59971635	rs1552032	T	C	18	10	28	0	0	28	0	0
15	59972784	rs6151506	G	C	4	8	12	0	0	12	0	0
15	59972920	rs6151504	T	C	2	8	10	0	0	10	0	0
15	59973002	rs6151503	A	G	3	4	7	0	0	7	0	0
15	59973047	rs6151501	C	T	2	4	6	0	0	6	0	0
15	59974458	rs6151487	G	A	16	3	19	0	0	19	0	0
15	59974481	rs6151486	G	T	3	12	15	0	0	15	0	0
15	59974566	rs2307275	C	G	6	11	17	0	0	17	0	0
15	59974777	rs6151483	A	G	6	3	9	0	0	9	0	0
15	59975082	rs4533213	T	C	3	3	6	0	0	6	0	0
15	59975445	rs6151479	A	T	6	7	13	0	0	13	0	0
15	59975650	rs6151477	T	C	6	4	10	0	0	10	0	0
15	59975785	rs6151474	G	A	10	6	16	0	0	16	0	0
15	59975937	rs6151472	G	A	7	14	21	0	0	21	0	0
15	59976351	rs6151467	A	G	6	7	13	0	1	14	0	0
15	59976380	rs6151465	C	T	6	7	13	0	0	13	0	0
15	59976381	rs6151464	C	A	6	7	13	0	0	13	0	0
15	59976805	rs6151461	G	C	3	4	7	0	0	7	0	0
15	59976965	rs722163	C	A	5	2	7	0	0	7	0	0
15	59977631	rs6151460	T	C	12	8	20	0	1	21	0	0
15	59977668	rs6151459	A	C	11	8	19	0	2	21	0	0
15	59977901	rs6151458	A	G	8	3	11	0	0	11	0	0
15	59978909	rs3825870	C	G	9	2	11	0	0	11	0	0
15	59978920	rs3784389	G	C	9	5	14	0	0	14	0	0
15	59979522	rs728037	C	T	3	6	9	0	1	10	0	0
15	59979920	rs6151451	T	C	4	9	13	0	0	13	0	0
15	59980039	rs6151450	T	C	5	5	10	0	0	10	0	0
15	59980049	rs6151449	G	A	5	5	10	0	0	10	0	0
15	59980064	rs6151448	T	C	2	5	7	0	0	7	0	0
15	59980110	rs6151447	T	C	2	7	9	0	0	9	0	0
15	59980169	rs6151446	G	T	3	5	8	0	0	8	0	0
15	59980193	rs6151445	C	T	4	3	7	0	0	7	0	0
15	59980333	rs6151444	A	T	5	6	11	0	0	11	0	0
15	59980389	rs6151442	A	T	2	6	8	0	0	8	0	0
15	59980635	rs6151440	A	T	3	5	8	0	0	8	0	0
15	59981154	rs2306357	A	T	11	5	16	0	0	16	0	0
15	59981242	rs2306358	C	T	13	6	19	0	0	19	0	0
15	59981515	rs3087328	A	G	9	8	17	0	0	17	0	0
15	60060987	rs112561932	G	A	18	0	18	0	6	24	0	0
15	60061020	rs35908036	A	C	57	0	57	0	0	57	0	0
15	60061068	rs4114297	T	C	1	74	75	0	6	81	0	0
15	60061183	rs57599466	C	T	453	0	453	0	25	480	2	0
15	60640228	rs7163836	C	T	3	5	8	0	0	8	0	0
15	60640812	rs10851678	C	T	5	2	7	0	0	7	0	0
15	60640854	rs10851679	A	G	5	1	6	0	0	6	0	0
15	60683609	rs62004988	G	A	6	2	8	0	0	8	0	0
15	60686631	rs62004990	C	T	7	9	16	0	0	16	0	0
15	60687152	rs16942555	T	G	6	5	11	0	0	11	0	0
15	60687844	rs2100432	A	G	4	2	6	0	0	6	0	0
15	60734697	rs1063100	A	G	19	18	37	0	1	38	0	0
15	60806185	rs4775276	A	G	5	1	6	0	0	6	0	0
15	62145399	rs11555593	A	G	53	33	86	0	0	86	0	0
15	62145955	rs11555596	C	T	75	88	163	0	2	165	0	0
15	62146598	rs17238096	C	T	74	50	124	0	2	126	0	0
15	62149045	rs1052306	T	C	8	20	28	0	1	29	0	0
15	62149657	rs35764401	C	T	7	9	16	0	0	16	0	0
15	62149784	rs3743297	T	C	4	4	8	0	0	8	0	0
15	62156042	rs11635880	A	C	3	5	8	0	0	8	0	0
15	62158337	rs11638951	G	A	7	5	12	0	0	12	0	0
15	62165553	rs17303887	T	C	90	73	163	0	1	164	0	0
15	62165577	rs17303894	G	A	81	66	147	0	1	148	0	0
15	62172907	rs12901055	T	C	55	58	113	0	0	113	0	0
15	62174894	rs17303915	A	G	41	42	83	0	2	85	0	0
15	62212770	rs139993005	T	C	25	15	40	0	0	40	0	0
15	62214607	rs12907567	C	T	38	31	69	0	1	70	0	0
15	62243197	rs11629598	T	C	27	25	52	0	0	52	0	0
15	62253791	rs2303405	T	C	27	23	50	0	0	50	0	0
15	62259637	rs3784634	C	T	20	17	37	0	0	37	0	0
15	63351840	rs1071646	C	A	5	5	10	0	0	10	0	0
15	63363654	rs8519	A	G	8	6	14	0	0	14	0	0
15	63363901	rs6738	C	T	6	5	11	0	0	11	0	0
15	63597857	rs1047552	T	G	8	12	20	0	0	20	0	0
15	63843194	rs79730824	A	T	4	4	8	0	0	8	0	0
15	63844745	rs17766277	A	G	6	3	9	0	0	9	0	0
15	63864433	rs4556742	C	T	3	4	7	0	0	7	0	0
15	63865544	rs4326997	G	A	4	5	9	0	0	9	0	0
15	63865946	rs74018127	C	A	4	5	9	0	0	9	0	0
15	63867602	rs78690656	T	G	5	1	6	0	0	6	0	0
15	63867683	rs74018129	C	G	7	4	11	0	0	11	0	0
15	63868397	rs7171367	G	A	10	3	13	0	0	13	0	0
15	63868409	rs7171068	C	T	11	4	15	0	0	15	0	0
15	63868761	rs62012773	A	G	14	3	17	0	0	17	0	0
15	63868811	rs62012774	C	T	11	4	15	0	0	15	0	0
15	63870840	rs113785423	A	G	6	9	15	0	0	15	0	0
15	63871274	rs62012775	A	T	5	2	7	0	0	7	0	0
15	63872318	rs74018133	G	T	5	2	7	0	0	7	0	0
15	63873268	rs7168903	A	G	7	4	11	0	1	12	0	0
15	63873443	rs62012778	A	C	6	4	10	0	0	10	0	0
15	63873658	rs12907106	C	G	3	3	6	0	0	6	0	0
15	63874864	rs77290236	G	C	10	5	15	0	1	16	0	0
15	63874881	rs7180729	A	T	6	9	15	0	0	15	0	0
15	63878889	rs7162745	T	A	21	22	43	0	2	45	0	0
15	63879235	rs28531781	T	C	23	20	43	0	0	43	0	0
15	63880305	rs80275182	A	G	29	34	63	0	0	63	0	0
15	63883430	rs62012781	C	G	276	285	561	0	3	564	0	0
15	63884275	rs8043465	T	C	10	11	21	0	0	21	0	0
15	63884462	rs8023506	T	C	14	8	22	0	0	22	0	0
15	63884564	rs76115381	G	A	10	12	22	0	0	22	0	0
15	63886593	rs2649	C	T	26	21	47	0	1	48	0	0
15	63901113	rs1131647	A	G	15	23	38	0	1	39	0	0
15	63901776	rs77075313	A	G	3	7	10	0	0	10	0	0
15	63904110	rs73441919	G	A	9	3	12	0	0	12	0	0
15	63904280	rs62012818	C	G	5	2	7	0	0	7	0	0
15	63905610	rs4412925	T	G	7	6	13	0	0	13	0	0
15	63907452	rs60618359	T	G	6	8	14	0	0	14	0	0
15	63907940	rs7178853	T	C	2	4	6	0	0	6	0	0
15	63909577	rs8023851	A	T	14	11	25	0	1	26	0	0
15	63910433	rs75663391	G	T	8	3	11	0	0	11	0	0
15	63913699	rs112593021	C	T	6	3	9	0	0	9	0	0
15	63929232	rs8030077	T	A	9	15	24	0	0	24	0	0
15	63950887	rs2228513	G	A	26	14	40	0	0	40	0	0
15	64418221	rs2290119	C	G	3	5	8	0	0	8	0	0
15	64418397	rs1130603	G	A	91	98	189	0	2	191	0	0
15	64423506	rs3848143	G	A	9	13	22	0	0	22	0	0
15	64428602	.	G	A	121	93	214	0	2	216	0	0
15	64428657	rs2290122	G	A	6	4	10	0	0	10	0	0
15	64430607	rs749504	T	C	4	5	9	0	0	9	0	0
15	64431988	.	C	T	5	8	13	0	0	13	0	0
15	64432598	rs58171107	G	A	12	16	28	0	2	30	0	0
15	64433180	.	G	T	10	8	18	0	1	19	0	0
15	64434537	rs17201990	G	A	18	14	32	0	0	32	0	0
15	64450688	.	C	T	4	3	7	0	0	7	0	0
15	64452322	rs2307247	G	A	1221	999	2220	0	30	2250	0	0
15	64496654	rs55699712	C	T	29	20	49	0	1	50	0	0
15	64508763	rs6494466	G	A	25	31	56	0	0	56	0	0
15	64658156	rs149871089	C	T	16	11	27	0	0	27	0	0
15	64710827	rs4776494	T	C	41	42	83	0	1	84	0	0
15	64962630	rs11633399	A	C	30	32	62	0	1	63	0	0
15	64984111	rs117373615	C	T	8	6	14	0	0	14	0	0
15	64987225	rs11858605	T	C	13	5	18	0	1	19	0	0
15	64991404	rs57615894	A	C	4	5	9	0	0	9	0	0
15	65147561	rs62014262	A	G	4	5	9	0	1	10	0	0
15	65148279	rs138357074	G	T	5	2	7	0	0	7	0	0
15	65255421	.	C	T	90	75	165	0	1	166	0	0
15	65442479	rs2946667	A	C	10	12	22	0	0	22	0	0
15	65442523	rs12909981	G	A	6	7	13	0	0	13	0	0
15	65527098	rs8025296	A	C	2	4	6	0	0	6	0	0
15	65579033	rs1057254	G	A	7	8	15	0	1	16	0	0
15	65592507	rs7163101	G	A	3	7	10	0	0	10	0	0
15	65592944	rs12905996	G	A	6	0	6	0	0	6	0	0
15	65592947	rs12906876	T	A	6	0	6	0	0	6	0	0
15	65736605	rs77141518	T	C	3	4	7	0	0	7	0	0
15	65949717	rs4993807	T	C	1	5	6	0	0	6	0	0
15	65994733	rs17810074	C	T	29	25	54	0	0	54	0	0
15	66049885	rs117359251	A	G	1	8	9	0	0	9	0	0
15	66050234	rs112528384	G	T	2	4	6	0	1	7	0	0
15	66178317	rs75317775	C	T	6	7	13	0	0	13	0	0
15	66179587	rs11634240	C	T	2	6	8	0	1	9	0	0
15	66181143	rs117150201	T	G	39	57	96	0	2	98	0	0
15	66181154	rs77317331	C	T	55	35	90	0	0	90	0	0
15	66183436	rs117568432	G	T	15	25	40	0	0	40	0	0
15	66183451	rs1469184	C	T	23	14	37	0	0	37	0	0
15	66612965	rs17851970	T	C	25	26	51	0	0	51	0	0
15	66626223	.	G	A	4	2	6	0	0	6	0	0
15	66641732	rs2063690	G	C	13	8	21	0	0	21	0	0
15	66679601	rs112542693	G	C	11	10	21	0	1	22	0	0
15	66741387	rs11629783	C	G	4	2	6	0	0	6	0	0
15	66766547	rs57583621	G	T	4	2	6	0	0	6	0	0
15	66772918	rs78793850	T	A	3	3	6	0	0	6	0	0
15	66773975	rs41277720	G	A	10	4	14	0	1	15	0	0
15	66776246	rs4287513	C	T	5	2	7	0	0	7	0	0
15	66783261	rs14303	C	A	153	135	288	0	1	289	0	0
15	66791258	rs4432220	T	C	12	10	22	0	0	22	0	0
15	66792087	rs112095287	C	T	9	8	17	0	0	17	0	0
15	66821250	rs11071896	A	G	3	5	8	0	0	8	0	0
15	67385469	rs1465841	C	G	4	3	7	0	0	7	0	0
15	67385491	rs1465840	C	T	4	3	7	0	0	7	0	0
15	67385697	rs881862	C	G	5	6	11	0	0	11	0	0
15	67386084	rs79826987	G	A	1	6	7	0	0	7	0	0
15	67386861	rs7169183	G	C	3	3	6	0	0	6	0	0
15	67387313	rs7169630	C	T	3	8	11	0	0	11	0	0
15	67388553	rs7176870	G	A	7	10	17	0	0	17	0	0
15	67388684	rs28417316	A	G	3	8	11	0	0	11	0	0
15	67391739	rs2053295	G	A	27	21	48	0	0	48	0	0
15	67392656	rs1530061	G	A	29	25	54	0	0	54	0	0
15	67399084	rs2053294	G	A	2	4	6	0	0	6	0	0
15	67417800	rs11631254	T	C	0	6	6	0	0	6	0	0
15	67418937	rs1992215	G	A	1	5	6	0	0	6	0	0
15	67421609	rs4776897	T	G	1	5	6	0	0	6	0	0
15	67444747	rs10152544	C	T	2	5	7	0	0	7	0	0
15	67467830	rs11634560	T	G	2	5	7	0	0	7	0	0
15	67470070	rs28447655	T	G	7	1	8	0	0	8	0	0
15	67479051	rs7173811	T	C	4	6	10	0	0	10	0	0
15	67482003	rs2028762	C	T	1	6	7	0	1	8	0	0
15	67482368	rs11629568	T	G	7	0	7	0	0	7	0	0
15	67485101	rs11638476	G	A	45	15	60	0	0	60	0	0
15	67486383	rs11556090	A	G	48	56	104	0	0	104	0	0
15	67486775	rs3743343	T	C	27	36	63	0	0	63	0	0
15	67486847	rs1052488	T	C	15	27	42	0	0	42	0	0
15	67493586	rs15974	G	C	37	24	61	0	1	62	0	0
15	67494304	rs8991	T	G	53	42	95	0	0	95	0	0
15	67494494	rs1050285	T	C	73	70	143	0	1	144	0	0
15	67499411	rs7165503	C	T	17	10	27	0	0	27	0	0
15	67500049	rs7171475	G	C	5	6	11	0	0	11	0	0
15	67501782	rs28693872	T	C	3	6	9	0	0	9	0	0
15	67506779	rs11855544	C	T	5	1	6	0	0	6	0	0
15	67807378	rs8036967	G	A	9	8	17	0	0	17	0	0
15	67811407	rs8041782	G	A	17	14	31	0	0	31	0	0
15	67813162	rs2589993	A	G	2	4	6	0	0	6	0	0
15	67815384	rs3743359	G	A	14	13	27	0	0	27	0	0
15	67835319	rs11550176	A	G	49	49	98	0	2	100	0	0
15	67889924	rs12232316	G	T	2	4	6	0	0	6	0	0
15	67889974	rs10518734	G	A	5	2	7	0	0	7	0	0
15	67890453	rs35733169	G	C	11	11	22	0	0	22	0	0
15	67890980	rs72749351	G	A	6	24	30	0	1	31	0	0
15	67891753	rs72749353	T	G	19	21	40	0	0	40	0	0
15	67892792	rs17241808	A	G	11	11	22	0	0	22	0	0
15	68120981	rs74418394	G	T	3	7	10	0	1	11	0	0
15	68379622	rs8036154	A	G	16	14	30	0	0	30	0	0
15	68482966	rs16951657	G	T	96	82	178	0	2	180	0	0
15	68571631	rs80224911	G	A	3	6	9	0	0	9	0	0
15	68577132	rs117515767	C	G	10	8	18	0	0	18	0	0
15	69085757	rs1551343	T	C	4	6	10	0	0	10	0	0
15	69747556	rs78395337	C	T	6228	5912	12140	0	46	12186	0	0
15	70341166	rs3195776	C	G	271	269	540	0	2	543	1	0
15	70344616	rs3743310	A	G	8	4	12	0	0	12	0	0
15	70345079	rs4777224	A	C	8	9	17	0	0	17	0	0
15	70345281	rs7167790	T	C	14	22	36	0	0	36	0	0
15	70345356	rs4777225	G	T	17	10	27	0	1	28	0	0
15	70345360	rs4777226	G	A	17	11	28	0	0	28	0	0
15	70345626	rs1057865	C	T	268	295	563	0	7	570	0	0
15	70345871	rs3743312	G	A	5	1	6	0	0	6	0	0
15	70346169	rs8032946	A	G	4	4	8	0	0	8	0	0
15	70346923	rs2228178	C	T	180	200	380	0	1	381	0	0
15	70348304	rs17759112	C	T	2	6	8	0	0	8	0	0
15	70348468	rs3817045	G	A	5	1	6	0	0	6	0	0
15	70350287	rs7175702	C	T	37	27	64	0	2	66	0	0
15	70350293	rs7175541	A	C	33	28	61	0	1	62	0	0
15	70351788	rs2133977	T	C	286	263	549	0	3	552	0	0
15	70354381	rs181158085	A	G	3	3	6	0	0	6	0	0
15	70355763	rs1566539	C	T	3	6	9	0	0	9	0	0
15	70360947	rs34687476	G	T	8	10	18	0	1	19	0	0
15	70362539	rs7163010	G	T	10	8	18	0	0	18	0	0
15	70362560	rs7162712	C	T	7	8	15	0	0	15	0	0
15	72114747	rs8178	G	A	14	7	21	0	0	21	0	0
15	72115230	rs2246225	T	C	31	19	50	0	0	50	0	0
15	72115541	rs8747	C	A	23	21	44	0	1	45	0	0
15	72115733	rs8557	T	C	23	17	40	0	0	40	0	0
15	72115763	rs9120	G	A	24	16	40	0	0	40	0	0
15	72116778	rs2742323	T	A	15	7	22	0	0	22	0	0
15	72117102	rs16956273	G	A	9	13	22	0	0	22	0	0
15	72118341	.	T	G	8	2	10	0	0	10	0	0
15	72118777	rs2625529	G	C	12	8	20	0	0	20	0	0
15	72191073	rs2415128	T	C	9	3	12	0	0	12	0	0
15	72496011	rs2607090	C	A	6	0	6	0	0	6	0	0
15	72496762	rs2856929	T	C	13	1	14	0	0	14	0	0
15	72536695	rs16956623	T	C	10	14	24	0	0	24	0	0
15	72540180	rs55763892	C	T	2	5	7	0	0	7	0	0
15	72540296	rs7169264	G	C	5	5	10	0	0	10	0	0
15	72543084	rs713048	G	A	3	3	6	0	0	6	0	0
15	72557730	.	T	C	18	7	25	0	0	25	0	0
15	72564492	rs62022789	C	T	8	7	15	0	0	15	0	0
15	72798178	rs2415140	G	A	19	7	26	0	0	26	0	0
15	72868861	.	A	C	3	8	11	0	0	11	0	0
15	73027478	rs2277598	T	C	10	5	15	0	0	15	0	0
15	73028873	rs7167076	G	A	5	6	11	0	0	11	0	0
15	73044575	rs9460	G	A	253	189	442	0	1	443	0	0
15	73044863	rs34149613	G	A	205	223	428	0	2	430	0	0
15	73047053	rs77474591	A	C	14	17	31	0	0	31	0	0
15	73051093	rs8033073	G	A	41	23	64	0	0	64	0	0
15	73051219	rs9806742	G	A	24	14	38	0	0	38	0	0
15	73052431	rs2304597	A	G	20	20	40	0	0	40	0	0
15	73054057	.	T	G	12	4	16	0	0	16	0	0
15	73054648	rs74730841	G	A	11	13	24	0	0	24	0	0
15	73069064	rs76136312	C	T	1	5	6	0	0	6	0	0
15	73069621	rs80135500	C	A	5	4	9	0	0	9	0	0
15	73072212	rs76543663	T	C	3	7	10	0	0	10	0	0
15	73072236	rs62017600	T	A	6	3	9	0	0	9	0	0
15	73072344	rs75552570	C	A	7	10	17	0	0	17	0	0
15	73072806	rs11072388	T	C	4	2	6	0	0	6	0	0
15	73077102	rs151163193	C	G	3	4	7	0	0	7	0	0
15	73415367	rs2010793	A	G	6	5	11	0	0	11	0	0
15	73541513	rs3736510	A	G	10	7	17	0	0	17	0	0
15	73564881	rs1131854	C	T	10	15	25	0	0	25	0	0
15	73858415	rs17185294	A	G	4	2	6	0	0	6	0	0
15	74005600	rs3816661	C	T	23	30	53	0	0	53	0	0
15	74244278	rs8818	C	G	7	8	15	0	0	15	0	0
15	74275676	rs2507	A	G	14	4	18	0	0	18	0	0
15	74275788	rs2289411	T	C	12	7	19	0	0	19	0	0
15	74276092	rs2289412	G	A	20	12	32	0	0	32	0	0
15	74276228	rs2289413	A	G	15	21	36	0	0	36	0	0
15	74277795	rs10851866	T	C	14	9	23	0	0	23	0	0
15	74291891	rs79862065	G	A	6	3	9	0	0	9	0	0
15	74317043	rs2277599	T	C	4	2	6	0	0	6	0	0
15	74317707	rs12902945	G	T	11	12	23	0	0	23	0	0
15	74317871	rs12902857	C	G	27	13	40	0	0	40	0	0
15	74318311	rs80150002	G	A	45	56	101	0	0	101	0	0
15	74318482	rs139551006	A	G	49	44	93	0	1	94	0	0
15	74319970	rs11636065	A	G	77	70	147	0	1	148	0	0
15	74320149	rs11636150	A	G	120	137	257	0	1	258	0	0
15	74320478	rs1052242	T	C	59	51	110	0	0	110	0	0
15	74328116	rs743580	A	G	181	149	330	0	3	333	0	0
15	74328206	rs743582	G	C	205	198	403	0	2	405	0	0
15	74328576	rs9479	A	G	232	245	477	0	4	481	0	0
15	74338462	rs1036673	C	T	6	13	19	0	0	19	0	0
15	74338939	rs6772	C	T	16	10	26	0	1	27	0	0
15	74711769	rs8025655	C	G	4	6	10	0	0	10	0	0
15	74715205	rs11852686	T	C	6	4	10	0	0	10	0	0
15	74716174	rs11856835	G	A	4	11	15	0	0	15	0	0
15	74716609	rs8036030	A	G	8	5	13	0	1	14	0	0
15	74716690	rs8036474	G	T	9	4	13	0	0	13	0	0
15	74718699	rs11852760	A	G	5	2	7	0	0	7	0	0
15	74721270	rs12903353	C	G	2	4	6	0	0	6	0	0
15	74723644	rs1992145	G	A	4	3	7	0	0	7	0	0
15	74881041	rs184810614	G	A	5	4	9	0	0	9	0	0
15	74889298	rs7496380	C	T	38	33	71	0	1	72	0	0
15	74889356	rs4887165	T	C	48	35	83	0	0	83	0	0
15	74915747	rs72728884	C	T	13	7	20	0	0	20	0	0
15	75080150	rs1378941	C	A	6	1	7	0	0	7	0	0
15	75080685	rs8033381	G	A	3	3	6	0	0	6	0	0
15	75080872	rs2168519	T	C	4	2	6	0	0	6	0	0
15	75083494	rs1378940	C	A	3	4	7	0	0	7	0	0
15	75083912	rs12442901	A	G	4	3	7	0	0	7	0	0
15	75084281	rs1350193	G	C	9	3	12	0	0	12	0	0
15	75088962	.	G	T	5	1	6	0	0	6	0	0
15	75090349	rs12898997	C	T	4	6	10	0	0	10	0	0
15	75092384	rs2301249	T	C	3	4	7	0	0	7	0	0
15	75095483	rs7085	T	C	63	47	110	0	0	110	0	0
15	75128501	rs9210	T	C	32	27	59	0	0	59	0	0
15	75131567	rs8039777	C	T	3	18	21	0	0	21	0	0
15	75131661	rs4886615	A	G	110	116	226	0	0	226	0	0
15	75135447	rs2290574	T	C	13	4	17	0	0	17	0	0
15	75136257	rs6939	A	C	220	227	447	0	2	449	0	0
15	75136261	rs6938	C	G	245	243	488	0	3	491	0	0
15	75136444	rs872263	C	T	247	253	500	0	3	503	0	0
15	75137064	rs1044355	G	A	212	225	437	0	0	437	0	0
15	75137252	rs11017	C	T	221	254	475	0	9	484	0	0
15	75139280	rs80023218	C	G	6	14	20	0	0	20	0	0
15	75139696	rs12902690	A	G	3	9	12	0	1	13	0	0
15	75140854	rs3765066	G	A	8	13	21	0	0	21	0	0
15	75145098	rs936230	T	C	10	10	20	0	0	20	0	0
15	75194490	rs6495127	C	T	41	43	84	0	0	84	0	0
15	75213523	rs150131093	C	A	3	3	6	0	0	6	0	0
15	75312953	rs71401671	T	C	4	5	9	0	0	9	0	0
15	75338890	rs1108059	A	C	22	21	43	0	1	44	0	0
15	75339054	rs71434254	A	G	16	14	30	0	0	30	0	0
15	75340640	rs2304900	G	A	20	29	49	0	0	49	0	0
15	75340722	rs2304901	G	A	32	28	60	0	1	61	0	0
15	75499995	rs28509789	T	G	929	733	1662	0	6	1669	1	0
15	75650836	rs1128933	G	A	46	35	81	0	0	81	0	0
15	75669044	rs7184009	A	T	44	18	62	0	0	62	0	0
15	75670512	rs74391430	A	G	11	7	18	0	0	18	0	0
15	75674896	rs113082196	C	A	13	10	23	0	0	24	1	0
15	75675274	rs4886442	C	A	22	31	53	0	0	53	0	0
15	75676392	rs190143676	T	G	7	2	9	0	0	9	0	0
15	75686082	rs4526985	T	G	3	9	12	0	0	12	0	0
15	75711883	rs11856344	A	G	70	82	152	0	0	152	0	0
15	75712481	rs6495174	C	T	91	92	183	0	1	184	0	0
15	75712933	rs7173220	T	G	47	48	95	0	0	96	1	0
15	75714310	rs76005098	T	C	74	94	168	0	2	170	0	0
15	75715897	rs7170660	C	T	4	5	9	0	0	9	0	0
15	75721148	rs75443303	G	A	2	5	7	0	0	7	0	0
15	75736039	rs7163783	G	T	40	28	68	0	1	70	1	0
15	75890612	rs3210683	G	A	85	67	152	0	1	153	0	0
15	75890689	rs1128585	G	T	78	50	128	0	1	129	0	0
15	75892249	rs113860312	C	T	5	6	11	0	0	11	0	0
15	75893088	rs11072552	A	C	19	7	26	0	1	27	0	0
15	76017452	rs55905564	C	T	2	8	10	0	0	10	0	0
15	76167485	rs34701345	T	C	1	6	7	0	0	7	0	0
15	76171807	rs2455899	G	A	5	7	12	0	0	12	0	0
15	76173120	rs2441929	G	A	3	5	8	0	0	8	0	0
15	76175210	rs17427165	C	T	5	5	10	0	0	10	0	0
15	76176128	rs2460798	T	C	10	13	23	0	0	23	0	0
15	76179382	rs12915152	C	A	5	2	7	0	0	7	0	0
15	76180546	rs1695378	G	A	14	17	31	0	0	31	0	0
15	76181538	rs17427298	C	T	12	11	23	0	0	23	0	0
15	76182406	rs335715	A	T	34	23	57	0	1	58	0	0
15	76183191	rs62028936	T	A	8	8	16	0	0	16	0	0
15	76186345	rs189197	T	A	4	5	9	0	0	9	0	0
15	76221664	rs35364874	T	A	12	13	25	0	0	25	0	0
15	76232575	rs35031760	C	G	4	2	6	0	0	6	0	0
15	76240707	rs12905847	C	T	4	3	7	0	0	7	0	0
15	76251452	rs12913434	A	G	25	25	50	0	0	50	0	0
15	77338784	rs8032	G	C	163	151	314	0	2	317	1	0
15	77344793	rs11737	T	A	94	133	227	0	0	227	0	0
15	77359514	rs34443712	T	G	4	4	8	0	0	8	0	0
15	77400607	rs14726	A	G	9	6	15	0	0	15	0	0
15	77403750	rs12901370	C	T	3	6	9	0	0	9	0	0
15	77407114	rs1867780	C	G	4	4	8	0	0	8	0	0
15	77472871	rs10519162	G	A	11	5	16	0	0	16	0	0
15	77578168	rs35704799	T	G	3	3	6	0	0	6	0	0
15	77649340	rs34158220	G	A	4	2	6	0	0	6	0	0
15	77681010	rs3784787	T	C	2	4	6	0	0	6	0	0
15	77775058	.	C	T	6	7	13	0	0	13	0	0
15	77777632	rs7119	C	T	14	11	25	0	0	25	0	0
15	78288490	rs139941936	G	A	0	7	7	0	0	7	0	0
15	78288778	rs56367308	G	T	30	28	58	0	0	58	0	0
15	78291289	rs116928199	G	T	21	19	40	0	0	40	0	0
15	78295155	rs77678087	G	A	4	8	12	0	0	12	0	0
15	78295562	rs117946329	G	T	14	24	38	0	0	38	0	0
15	78309553	rs2241885	C	T	8	5	13	0	0	13	0	0
15	78331789	.	G	A	2	5	7	0	0	7	0	0
15	78441769	rs11555541	T	C	31	17	48	0	1	49	0	0
15	78462258	rs117706925	G	A	58	71	129	0	1	130	0	0
15	78565478	rs7163689	C	T	9	3	12	0	0	12	0	0
15	78573745	rs3743082	G	C	7	16	23	0	0	23	0	0
15	78578451	.	C	T	36	37	73	0	1	74	0	0
15	78731149	rs17405217	C	T	5	8	13	0	0	13	0	0
15	78765462	rs181258981	A	G	34	42	76	0	0	76	0	0
15	78766208	rs76384106	A	T	5	2	7	0	0	7	0	0
15	78767346	rs12592111	G	A	2	5	7	0	0	7	0	0
15	79188655	.	T	C	14	5	19	0	4	23	0	0
15	79189155	rs10519218	T	C	14	20	34	0	0	34	0	0
15	79603510	rs67268531	G	A	26	30	56	0	0	56	0	0
15	79616047	rs7167868	A	C	3	5	8	0	0	8	0	0
15	80189533	rs2865825	G	A	6	2	8	0	0	8	0	0
15	80212826	rs1055947	T	C	18	14	32	0	1	33	0	0
15	80212912	rs1134264	A	C	22	12	34	0	0	34	0	0
15	80212956	rs3178647	T	C	18	6	24	0	0	24	0	0
15	80213023	rs3178646	T	C	12	3	15	0	0	15	0	0
15	80213031	rs12951	C	T	11	2	13	0	0	13	0	0
15	80213049	rs7179584	G	A	11	2	13	0	0	13	0	0
15	80213658	rs57826228	T	A	11	7	18	0	2	20	0	0
15	80214230	rs57972189	A	G	27	23	50	0	0	50	0	0
15	80214242	rs28434359	C	T	26	22	48	0	0	48	0	0
15	80214259	rs60250355	C	T	28	17	45	0	1	46	0	0
15	80214285	rs57425739	A	G	25	16	41	0	0	41	0	0
15	80214291	rs57141546	C	T	24	17	41	0	0	41	0	0
15	80214476	rs34284386	G	C	23	13	36	0	0	36	0	0
15	80214565	rs72736547	A	G	6	10	16	0	1	17	0	0
15	80214566	rs67481680	T	C	6	10	16	0	1	17	0	0
15	80214612	rs34468549	G	A	8	9	17	0	0	17	0	0
15	80214662	rs34589265	A	G	8	8	16	0	0	16	0	0
15	80214677	rs34397803	T	G	8	10	18	0	2	20	0	0
15	80214708	rs16971581	T	G	13	13	26	0	0	26	0	0
15	80215597	rs2303824	G	T	12	15	27	0	1	28	0	0
15	80215601	rs17286886	C	T	15	14	29	0	0	29	0	0
15	80216015	rs3803540	C	A	12	15	27	0	0	27	0	0
15	80216325	rs12442408	A	G	7	3	10	0	0	10	0	0
15	80256087	rs76582486	G	C	5	1	6	0	0	6	0	0
15	80257355	rs6495460	T	C	6	4	10	0	0	10	0	0
15	80257747	rs8033923	A	G	6	2	8	0	0	8	0	0
15	80259074	rs7180804	G	A	4	4	8	0	0	8	0	0
15	80260014	rs8026803	T	C	5	7	12	0	0	12	0	0
15	80260554	rs8026767	G	A	5	6	11	0	0	11	0	0
15	80260872	rs67760360	G	A	3	3	6	0	0	6	0	0
15	80263217	rs3826007	C	T	260	266	526	0	4	530	0	0
15	80263345	rs1138358	A	C	235	232	467	0	1	468	0	0
15	80263406	rs1138357	C	T	227	204	431	0	1	432	0	0
15	80424475	rs72738490	T	C	4	5	9	0	0	9	0	0
15	80428729	rs55770809	C	T	12	7	19	0	0	19	0	0
15	80454745	rs2114716	T	C	5	5	10	0	0	10	0	0
15	80455521	rs4778583	A	T	6	7	13	0	0	13	0	0
15	80455827	rs2162552	C	T	4	7	11	0	0	11	0	0
15	80999895	.	G	C	22	27	49	0	2	51	0	0
15	81007679	rs2759316	C	A	29	20	49	0	1	50	0	0
15	81009047	rs56246032	T	C	19	9	28	0	0	28	0	0
15	81080180	rs4778855	G	A	1	6	7	0	0	7	0	0
15	81080488	rs12324196	A	G	6	2	8	0	0	8	0	0
15	81080925	rs12324314	A	G	6	11	17	0	0	17	0	0
15	81081610	rs74420622	G	A	3	4	7	0	0	7	0	0
15	81081617	rs1982754	G	A	4	2	6	0	0	6	0	0
15	81082912	rs62006873	G	A	11	16	27	0	1	28	0	0
15	81083215	rs1385087	T	C	17	5	22	0	0	22	0	0
15	81083990	.	T	C	3	6	9	0	0	9	0	0
15	81084584	rs7179631	T	C	5	7	12	0	0	12	0	0
15	81085483	rs925111	T	C	3	8	11	0	1	12	0	0
15	81239712	rs10519305	A	G	4	2	6	0	0	6	0	0
15	81294774	rs11541231	G	C	29	23	52	0	0	52	0	0
15	81605844	.	T	C	5	8	13	0	0	13	0	0
15	82443939	rs4725	G	A	3	10	13	0	0	13	0	0
15	82444437	rs905450	A	G	9	7	16	0	0	16	0	0
15	82544393	rs62013462	T	C	5	1	6	0	0	6	0	0
15	83490339	.	G	T	30	48	78	0	1	79	0	0
15	83495011	rs113597176	C	T	27	24	51	0	0	51	0	0
15	83495214	rs113378787	T	A	226	271	497	0	2	499	0	0
15	83497594	.	G	C	9	13	22	0	0	22	0	0
15	83511804	rs150799032	C	T	5	2	7	0	1	8	0	0
15	83588703	rs11259960	G	A	3	3	6	0	0	6	0	0
15	83620774	rs67634629	T	C	9	1	10	0	0	10	0	0
15	83655845	.	A	G	8	4	12	0	1	13	0	0
15	83680329	rs17361375	G	A	12	13	25	0	0	25	0	0
15	83685314	rs1045742	A	T	140	96	236	0	0	236	0	0
15	83685440	rs7757	A	G	75	89	164	0	0	164	0	0
15	83685469	rs55933526	T	C	76	68	144	0	1	145	0	0
15	83686759	rs17158127	T	C	22	21	43	0	0	43	0	0
15	83689914	rs62010165	T	G	2	4	6	0	0	6	0	0
15	83711468	rs9646239	A	C	6	3	9	0	0	9	0	0
15	83712603	rs12903066	T	C	5	5	10	0	0	10	0	0
15	83719057	rs12437558	C	G	10	2	12	0	1	13	0	0
15	83720896	rs62010173	A	G	8	8	16	0	0	16	0	0
15	83722059	rs17507300	A	G	12	21	33	0	0	33	0	0
15	83723047	rs12441006	C	A	9	3	12	0	0	12	0	0
15	83723061	rs12438575	G	C	9	4	13	0	0	13	0	0
15	83723341	rs62010174	G	C	7	6	13	0	3	16	0	0
15	83723559	rs67482297	G	A	6	13	19	0	0	19	0	0
15	83781631	rs1989	C	T	24	8	32	0	0	32	0	0
15	83781859	rs71412295	C	A	8	5	13	0	0	13	0	0
15	83782248	rs6603047	A	G	6	6	12	0	0	12	0	0
15	83783337	rs62010208	C	T	10	5	15	0	0	15	0	0
15	83803546	rs41326445	G	A	11	11	22	0	0	22	0	0
15	83804477	rs36070450	G	A	4	3	7	0	0	7	0	0
15	83804830	rs2034617	G	A	4	8	12	0	0	12	0	0
15	83804861	rs12440386	C	T	5	8	13	0	0	13	0	0
15	83813330	rs138992554	G	T	3	5	8	0	0	8	0	0
15	85073374	.	C	A	3	5	8	0	0	8	0	0
15	85081832	rs150964	A	G	20	18	38	0	1	39	0	0
15	85113429	rs8032964	C	A	3	5	8	0	0	8	0	0
15	85147910	rs7169769	G	C	4	2	6	0	0	6	0	0
15	85148725	.	G	A	10	4	14	0	0	14	0	0
15	85149771	rs2271433	G	T	14	18	32	0	0	32	0	0
15	85174755	rs3825878	C	T	1	6	7	0	0	7	0	0
15	85175102	rs2121452	G	A	3	8	11	0	0	11	0	0
15	85187555	rs2137270	A	G	4	3	7	0	0	7	0	0
15	85188994	rs2271432	T	C	16	26	42	0	1	43	0	0
15	85190470	rs4842981	G	T	7	4	11	0	0	11	0	0
15	85191274	rs7169629	C	G	5	3	8	0	0	8	0	0
15	85197253	rs4842978	T	C	3	3	6	0	0	6	0	0
15	85200754	rs2292462	G	T	3	4	7	0	0	7	0	0
15	85227407	rs17533573	A	G	5	3	8	0	0	8	0	0
15	85259454	rs149297329	A	T	14	9	23	0	0	23	0	0
15	85334332	rs2241644	G	A	19	13	32	0	1	33	0	0
15	85335080	rs68007905	T	C	5	11	16	0	0	16	0	0
15	85335828	rs3851678	T	C	4	5	9	0	0	9	0	0
15	85336157	rs117463830	C	T	4	4	8	0	0	8	0	0
15	85336806	rs41492149	G	A	3	5	8	0	0	8	0	0
15	85336949	rs56194751	C	T	3	12	15	0	0	15	0	0
15	85341072	rs56410875	A	G	6	7	13	0	0	13	0	0
15	85344290	rs68097191	G	A	1	6	7	0	0	7	0	0
15	85347114	rs9806315	T	C	30	43	73	0	0	73	0	0
15	85348172	rs1719	G	T	39	50	89	0	0	89	0	0
15	85956628	rs6497117	C	T	3	4	7	0	0	7	0	0
15	85957736	rs7170370	T	A	7	8	15	0	0	15	0	0
15	85958438	rs11638454	C	G	158	79	237	0	0	237	0	0
15	85958673	rs35451550	G	T	189	101	290	0	4	295	1	0
15	85959986	rs17552700	C	T	6	3	9	0	0	9	0	0
15	85981943	.	T	A	3	4	7	0	0	7	0	0
15	85984183	rs4842882	G	A	3	5	8	0	0	8	0	0
15	86065560	rs35316253	T	C	7	3	10	0	0	10	0	0
15	86066403	rs11855789	G	A	6	7	13	0	0	13	0	0
15	86066471	rs12900989	A	G	6	6	12	0	0	12	0	0
15	86067306	rs6496044	G	A	8	4	12	0	0	12	0	0
15	86067398	rs7176291	T	C	7	2	9	0	0	9	0	0
15	86068152	rs181999801	A	T	7	4	11	0	0	11	0	0
15	86069118	rs8026938	T	G	4	9	13	0	0	13	0	0
15	86069205	rs6496049	C	G	2	4	6	0	0	6	0	0
15	86070069	rs7165300	G	C	4	3	7	0	0	7	0	0
15	86070688	rs6496055	A	G	7	6	13	0	0	13	0	0
15	86071035	rs62023882	T	C	17	7	24	0	0	24	0	0
15	86072419	rs7163032	T	A	4	2	6	0	0	6	0	0
15	86072434	rs7180022	C	T	5	1	6	0	0	6	0	0
15	86072466	rs7163068	T	C	8	1	9	0	0	9	0	0
15	86073035	rs35184622	A	G	11	13	24	0	0	24	0	0
15	86073424	rs10468112	G	C	27	19	46	0	0	46	0	0
15	86074297	rs12708554	C	G	7	12	19	0	0	19	0	0
15	86074351	rs12905350	C	G	13	13	26	0	0	26	0	0
15	86074906	rs2344436	C	T	10	8	18	0	0	18	0	0
15	86075156	rs11073401	C	T	17	15	32	0	0	32	0	0
15	86075372	rs6496065	C	T	20	9	29	0	1	30	0	0
15	86075417	rs1483578	A	G	18	14	32	0	0	32	0	0
15	86075462	rs6496066	A	C	18	17	35	0	0	35	0	0
15	86076009	rs11073403	C	T	19	32	51	0	1	52	0	0
15	86077404	rs1351196	T	C	51	30	81	0	0	81	0	0
15	86079115	rs35343117	C	G	52	53	105	0	2	107	0	0
15	86079751	rs11636764	G	A	95	80	175	0	1	176	0	0
15	86079834	rs11632326	A	C	120	80	200	0	0	200	0	0
15	86103060	rs12164925	G	A	4	2	6	0	0	6	0	0
15	86103176	rs16941432	A	G	5	3	8	0	0	8	0	0
15	86123170	rs745191	G	T	19	22	41	0	1	42	0	0
15	86124616	rs61731243	A	G	39	39	78	0	0	78	0	0
15	86146551	rs36044792	A	G	1	5	6	0	0	6	0	0
15	86162874	rs4843086	G	A	3	3	6	0	0	6	0	0
15	86227843	rs72748147	A	G	10	0	10	0	0	10	0	0
15	86227952	rs2306225	A	G	1	6	7	0	0	7	0	0
15	86228369	rs2306224	C	G	8	4	12	0	0	12	0	0
15	86229273	rs11638720	C	T	12	10	22	0	0	22	0	0
15	86229606	rs1961601	T	C	4	3	7	0	0	7	0	0
15	86229618	rs2016517	C	T	4	5	9	0	0	9	0	0
15	86230839	rs12594932	T	C	8	7	15	0	0	15	0	0
15	86230958	rs11073492	A	G	5	5	10	0	1	11	0	0
15	86233180	rs4843092	G	A	2	9	11	0	0	11	0	0
15	86233351	rs16943236	C	T	5	1	6	0	0	6	0	0
15	86233370	rs17574774	A	G	1	6	7	0	0	7	0	0
15	86234589	rs17636864	A	C	3	3	6	0	0	6	0	0
15	86261128	rs79813743	C	G	7	6	13	0	0	13	0	0
15	86268397	.	C	T	2	4	6	0	0	6	0	0
15	86278309	rs2241268	G	A	128	175	303	0	2	305	0	0
15	86279928	rs11635956	G	A	3	8	11	0	0	11	0	0
15	86284009	rs184019539	C	G	7	17	24	0	4	28	0	0
15	86284072	rs11632034	C	T	23	20	43	0	0	43	0	0
15	86285824	rs56141817	A	C	21	7	28	0	0	28	0	0
15	86287547	rs11636138	T	A	7	4	11	0	0	11	0	0
15	86287724	rs11629690	G	A	13	5	18	0	1	19	0	0
15	86287910	rs11073517	C	T	154	145	299	0	2	301	0	0
15	86288387	rs11630274	C	T	138	167	305	0	1	306	0	0
15	86288596	rs16943854	T	G	191	176	367	0	1	368	0	0
15	86289363	rs12905492	G	A	110	111	221	0	3	224	0	0
15	86289879	rs3743326	G	C	201	169	370	0	7	377	0	0
15	86290060	rs3743327	T	C	211	200	411	0	4	415	0	0
15	86290212	rs34121119	G	T	195	195	390	0	2	392	0	0
15	86290940	rs3803506	A	C	203	230	433	0	3	436	0	0
15	86291455	rs3169120	T	C	192	150	342	0	1	343	0	0
15	86291548	rs3169121	T	G	229	195	424	0	3	427	0	0
15	86291882	.	C	T	77	57	134	0	2	136	0	0
15	86292114	rs13225	C	G	359	326	685	0	3	688	0	0
15	86292324	rs8110	G	C	116	138	254	0	3	257	0	0
15	86302765	rs8040517	C	T	11	14	25	0	0	25	0	0
15	86303180	rs11556865	C	G	12	17	29	0	0	29	0	0
15	86303751	rs3743332	T	C	4	8	12	0	0	12	0	0
15	86304002	rs12901134	C	T	4	10	14	0	0	14	0	0
15	86311695	rs1978391	G	A	3	3	6	0	0	6	0	0
15	86312681	rs11073537	G	A	6	4	10	0	0	10	0	0
15	89056040	rs13835	C	A	7	8	15	0	0	15	0	0
15	89169484	rs3743477	C	T	13	8	21	0	0	21	0	0
15	89169653	rs34649587	G	A	22	11	33	0	1	34	0	0
15	89172739	rs12903425	T	C	1	5	6	0	0	6	0	0
15	89173292	rs372899718	G	A	13	18	31	0	0	31	0	0
15	89173480	rs369014614	C	T	31	26	57	0	0	57	0	0
15	89173556	rs17777460	C	T	14	15	29	0	0	29	0	0
15	89173938	rs67426590	G	A	18	24	42	0	0	42	0	0
15	89174287	rs16942129	C	T	26	17	43	0	1	44	0	0
15	89175173	rs1047276	A	G	28	23	51	0	0	51	0	0
15	89175174	rs1047278	C	G	28	23	51	0	0	51	0	0
15	89175474	rs371284839	A	C	6	5	11	0	0	11	0	0
15	89180687	rs372567988	A	G	4	3	7	0	0	7	0	0
15	89182839	rs10152473	C	A	10	13	23	0	0	23	0	0
15	89184325	rs35277189	G	A	22	10	32	0	0	32	0	0
15	89185054	rs12050581	G	A	7	6	13	0	0	13	0	0
15	89185086	rs28836000	C	T	5	7	12	0	0	12	0	0
15	89185905	rs374989526	C	T	14	16	30	0	0	30	0	0
15	89186087	rs28479644	T	C	8	7	15	0	0	15	0	0
15	89186222	rs71408891	G	A	4	6	10	0	0	10	0	0
15	89186241	rs186938198	G	A	11	5	16	0	0	16	0	0
15	89188825	rs539340386	G	A	9	6	15	0	0	15	0	0
15	89189551	rs78486627	G	A	8	4	12	0	0	12	0	0
15	89189874	rs73465639	G	A	6	9	15	0	0	15	0	0
15	89189879	rs367768348	C	T	6	9	15	0	0	15	0	0
15	89190473	rs191099449	C	T	7	3	10	0	0	10	0	0
15	89190585	.	A	G	7	3	10	0	0	10	0	0
15	89192656	rs10852109	G	A	11	14	25	0	0	25	0	0
15	89192873	rs4932187	T	C	9	8	17	0	0	17	0	0
15	89193021	rs4932188	C	G	5	8	13	0	0	13	0	0
15	89193375	.	C	T	10	9	19	0	0	19	0	0
15	89193497	rs12595827	A	T	9	11	20	0	0	20	0	0
15	89193584	rs8041679	G	C	6	5	11	0	0	11	0	0
15	89194350	rs4932189	G	C	16	6	22	0	0	22	0	0
15	89194782	rs8023533	T	G	14	22	36	0	0	36	0	0
15	89196184	rs35540464	G	C	16	3	19	0	0	19	0	0
15	89196406	rs35698763	G	A	8	6	14	0	0	14	0	0
15	89196741	rs11853186	G	A	13	3	16	0	0	16	0	0
15	89197254	rs4932190	G	A	6	5	11	0	0	11	0	0
15	89197509	rs4932399	G	A	13	3	16	0	0	16	0	0
15	89198257	rs28552715	C	G	5	5	10	0	0	10	0	0
15	89430544	rs62620238	G	A	40	49	89	0	0	89	0	0
15	89637418	rs293375	C	A	14	5	19	0	0	19	0	0
15	89720832	rs147001317	G	A	6	5	11	0	0	11	0	0
15	89726136	rs10152665	G	A	6	1	7	0	0	7	0	0
15	89734466	rs2239287	G	A	1	5	6	0	0	6	0	0
15	89739259	rs2283435	G	C	67	51	118	0	3	121	0	0
15	89740616	rs4932214	G	A	61	70	131	0	0	131	0	0
15	89743043	rs729707	C	T	63	60	123	0	12	135	0	0
15	89743080	rs6496565	C	A	53	42	95	0	5	100	0	0
15	89743668	rs9550	C	G	72	79	151	0	1	152	0	0
15	89744004	rs7179900	C	T	95	97	192	0	0	192	0	0
15	89744476	rs6416547	G	T	111	137	248	0	2	250	0	0
15	89836515	rs75529282	A	G	5	2	7	0	1	8	0	0
15	90333851	rs17239917	G	A	0	7	7	0	0	7	0	0
15	90334240	rs25654	A	G	316	305	621	0	1	622	0	0
15	90334345	rs7168329	C	G	28	21	49	0	0	49	0	0
15	90334415	rs7169161	A	G	22	38	60	0	0	60	0	0
15	90334554	rs79149569	T	C	2	6	8	0	0	8	0	0
15	90334742	rs28459313	T	C	2	5	7	0	0	7	0	0
15	90334927	rs28454285	A	G	4	3	7	0	0	7	0	0
15	90334936	rs28462367	A	G	3	5	8	0	0	8	0	0
15	90335243	rs28569158	A	G	6	3	9	0	0	9	0	0
15	90335251	rs16943590	C	T	6	3	9	0	0	9	0	0
15	90335379	rs8179197	G	C	8	8	16	0	0	16	0	0
15	90335534	rs25652	G	A	369	294	663	0	7	670	0	0
15	90335788	rs25651	C	T	321	222	543	0	4	547	0	0
15	90335973	rs28591352	T	C	3	4	7	0	0	7	0	0
15	90335988	rs28512252	C	T	2	5	7	0	0	7	0	0
15	90336026	rs16943599	C	A	2	6	8	0	0	8	0	0
15	90336049	.	G	A	1	5	6	0	0	6	0	0
15	90336373	rs16943605	T	C	12	7	19	0	0	19	0	0
15	90338029	rs28638060	T	C	12	4	16	0	0	16	0	0
15	90338062	rs28626435	T	G	10	3	13	0	0	13	0	0
15	90338071	rs28639834	T	G	10	2	12	0	0	12	0	0
15	90338072	rs28545693	T	C	10	2	12	0	0	12	0	0
15	90338093	rs28422990	T	G	8	3	11	0	0	11	0	0
15	90338193	rs1439120	A	G	8	7	15	0	0	15	0	0
15	90338246	rs1439119	C	T	6	7	13	0	0	13	0	0
15	90338609	rs1439117	A	C	5	7	12	0	1	13	0	0
15	90338756	rs28463231	T	A	4	4	8	0	0	8	0	0
15	90339015	rs28404753	A	G	6	5	11	0	0	11	0	0
15	90339188	rs28546242	A	G	5	4	9	0	0	9	0	0
15	90344266	rs55653418	C	G	12	7	19	0	0	19	0	0
15	90345335	rs2007084	G	A	7	2	9	0	0	9	0	0
15	90346227	rs7168849	A	G	4	3	7	0	0	7	0	0
15	90347331	rs55977698	G	A	9	11	20	0	3	23	0	0
15	90347338	rs41276914	T	C	9	15	24	0	0	24	0	0
15	90347783	rs17240240	C	T	200	178	378	0	4	382	0	0
15	90347792	rs41276916	C	A	205	179	384	0	2	386	0	0
15	90347814	rs17240268	G	A	185	176	361	0	3	364	0	0
15	90347920	rs41276920	G	A	25	33	58	0	0	58	0	0
15	90348979	rs72754570	G	A	19	10	29	0	1	30	0	0
15	90349461	rs41276922	G	A	148	159	307	0	3	310	0	0
15	90349960	rs41276924	A	G	97	119	216	0	2	218	0	0
15	90350619	rs35408448	C	G	12	14	26	0	0	26	0	0
15	90350888	rs72754571	C	A	16	5	21	0	1	22	0	0
15	90350889	rs72754572	A	C	16	6	22	0	0	22	0	0
15	90351574	rs10152918	G	A	6	15	21	0	0	21	0	0
15	90353853	rs36107278	A	G	7	10	17	0	0	17	0	0
15	90354031	rs28461916	A	G	12	5	17	0	0	17	0	0
15	90354480	rs12441282	C	T	7	2	9	0	0	9	0	0
15	90355027	rs66740215	A	G	8	5	13	0	0	13	0	0
15	90355652	.	G	A	5	4	9	0	0	9	0	0
15	90356002	rs28409374	C	T	3	10	13	0	0	13	0	0
15	90356101	rs72754574	G	A	4	7	11	0	0	11	0	0
15	90356511	rs71405666	C	A	10	6	16	0	0	16	0	0
15	90357223	.	T	C	3	3	6	0	2	8	0	0
15	90357228	rs564738766	G	T	7	3	10	0	0	10	0	0
15	90374257	rs2028299	C	A	8	5	13	0	0	13	0	0
15	90376800	rs12197	G	A	9	5	14	0	0	14	0	0
15	90381258	rs748508	G	T	2	4	6	0	0	6	0	0
15	90381278	rs893617	C	T	2	5	7	0	0	7	0	0
15	90622504	rs2970358	C	T	7	9	16	0	0	16	0	0
15	90623052	rs2970357	T	C	8	17	25	0	0	25	0	0
15	90623540	rs2970356	C	G	12	12	24	0	0	24	0	0
15	90631596	.	C	T	276	285	561	0	7	568	0	0
15	90768959	rs908044	A	C	3	3	6	0	0	6	0	0
15	90771704	rs3751656	G	A	9	9	18	0	0	18	0	0
15	90771750	rs3751655	T	G	11	12	23	0	0	23	0	0
15	90772005	rs11547962	G	A	7	13	20	0	0	20	0	0
15	90772156	rs11547961	A	G	3	7	10	0	0	10	0	0
15	90772831	rs7024	C	T	1	6	7	0	0	7	0	0
15	90773782	rs2073706	C	T	3	4	7	0	0	7	0	0
15	90774987	rs2073704	G	A	54	68	122	0	4	126	0	0
15	90775397	rs2073703	G	A	40	60	100	0	3	103	0	0
15	90775700	rs4628940	G	A	36	68	104	0	0	104	0	0
15	90775913	rs8041338	C	T	28	48	76	0	1	77	0	0
15	90775919	rs8025875	T	A	29	49	78	0	0	78	0	0
15	90776154	rs9745131	G	T	24	25	49	0	0	49	0	0
15	90776375	rs9744242	T	C	32	69	101	0	2	103	0	0
15	90819641	rs12904877	A	C	3	3	6	0	0	6	0	0
15	90933683	rs62019353	T	C	6	2	8	0	0	8	0	0
15	90934331	rs3743418	A	G	15	13	28	0	1	30	1	0
15	91010776	rs1505936	T	C	21	23	44	0	0	44	0	0
15	91043765	rs11609	C	G	58	49	107	0	1	108	0	0
15	91045408	rs3540	G	A	35	52	87	0	0	87	0	0
15	91045419	rs3539	G	T	45	30	75	0	0	75	0	0
15	91083353	rs8033595	G	A	33	26	59	0	1	60	0	0
15	91382995	rs7402445	C	T	9	8	17	0	0	17	0	0
15	91416550	rs17514846	C	A	32	29	61	0	0	61	0	0
15	91418297	rs8032315	T	A	5	10	15	0	0	15	0	0
15	91418394	rs8027450	C	T	16	18	34	0	0	34	0	0
15	91420940	rs2071410	C	G	67	86	153	0	1	154	0	0
15	91420973	rs1573643	T	C	78	75	153	0	0	154	1	0
15	91421283	rs1573644	T	C	41	63	104	0	2	106	0	0
15	91422543	rs8039305	T	C	14	19	33	0	1	34	0	0
15	91423543	rs6224	G	T	15	12	27	0	2	29	0	0
15	91424574	rs6226	G	C	583	619	1202	0	6	1208	0	0
15	91425232	rs6227	C	T	607	537	1144	0	15	1160	1	0
15	91426560	rs4702	G	A	492	596	1088	0	3	1091	0	0
15	91428197	rs2071382	T	C	1	9	10	0	0	10	0	0
15	91428290	rs11539637	C	T	89	100	189	0	1	190	0	0
15	91428589	rs7183988	T	G	5	15	20	0	0	20	0	0
15	91428636	rs7177338	G	A	9	15	24	0	0	24	0	0
15	91428955	rs1894400	C	T	2	6	8	0	0	8	0	0
15	91430647	rs28438927	A	C	5	26	31	0	1	32	0	0
15	91431856	rs76792278	A	C	12	30	42	0	0	42	0	0
15	91437388	rs2521501	A	T	12	9	21	0	0	21	0	0
15	91446472	rs734252	T	C	33	35	68	0	0	68	0	0
15	91447867	rs7184022	T	G	5	2	7	0	0	7	0	0
15	91449015	rs2072078	A	G	3	5	8	0	0	8	0	0
15	91450441	rs2677744	G	A	7	6	13	0	0	13	0	0
15	91452106	rs2002739	C	T	12	6	18	0	0	18	0	0
15	91452204	rs877285	A	G	11	12	23	0	1	24	0	0
15	91452294	rs7183098	A	G	10	13	23	0	0	23	0	0
15	91452595	rs2106673	A	G	144	115	259	0	0	259	0	0
15	91455618	rs6496737	C	T	39	30	69	0	0	69	0	0
15	91456102	rs1266492	T	C	5	6	11	0	0	11	0	0
15	91457220	rs1266490	G	C	8	15	23	0	0	23	0	0
15	91458485	rs1266489	G	A	15	13	28	0	0	28	0	0
15	91462406	rs1266483	A	G	5	3	8	0	0	8	0	0
15	91463842	rs4773	G	A	358	331	689	0	10	699	0	0
15	91464975	rs10048033	C	G	45	55	100	0	1	101	0	0
15	91474236	rs1052532	T	C	6	4	10	0	0	10	0	0
15	91478544	rs17635974	A	C	11	17	28	0	0	28	0	0
15	91497239	rs11207	C	T	38	39	77	0	0	77	0	0
15	91509592	rs7601	T	C	54	54	108	0	0	108	0	0
15	91511260	rs12910825	A	G	9	16	25	0	1	26	0	0
15	91542337	rs3743449	C	T	14	12	26	0	0	26	0	0
15	91543761	rs11073964	C	T	57	44	101	0	0	101	0	0
15	91544076	rs12899811	A	G	3	5	8	0	0	8	0	0
15	91544417	rs72759321	A	G	6	2	8	0	0	8	0	0
15	91549822	rs3826032	G	C	5	5	10	0	0	10	0	0
15	92397670	rs7173207	C	A	2	4	6	0	0	6	0	0
15	92415355	rs12904318	G	A	19	10	29	0	0	29	0	0
15	92415914	rs62010892	G	A	13	15	28	0	0	28	0	0
15	92416421	rs4537992	C	G	24	19	43	0	0	43	0	0
15	92416560	rs28624137	G	A	17	21	38	0	0	38	0	0
15	92638193	rs2286355	G	A	37	23	60	0	0	60	0	0
15	92647645	rs1517618	G	C	43	40	83	0	0	83	0	0
15	92685366	rs2238357	G	C	4	2	6	0	0	6	0	0
15	92687326	rs7175816	G	A	4	2	6	0	1	7	0	0
15	92687395	rs2238352	C	G	3	4	7	0	0	7	0	0
15	92687556	rs2238351	T	C	4	7	11	0	0	11	0	0
15	92687783	rs55956389	G	A	3	3	6	0	0	6	0	0
15	92688127	rs2283459	A	T	1	7	8	0	1	9	0	0
15	92688911	rs12441878	T	G	3	3	6	0	0	6	0	0
15	92689695	rs2074886	C	G	7	8	15	0	0	15	0	0
15	92706594	rs8174	T	C	32	16	48	0	1	49	0	0
15	92707295	rs3743370	C	T	5	7	12	0	0	12	0	0
15	92707569	rs3743369	G	A	3	3	6	0	0	6	0	0
15	92707909	rs9302356	T	C	12	4	16	0	0	16	0	0
15	92707970	rs3169130	G	A	8	3	11	0	0	11	0	0
15	92708063	rs7497640	T	C	5	6	11	0	1	12	0	0
15	92708303	rs7496880	C	T	7	4	11	0	0	11	0	0
15	92708528	rs1060205	G	A	5	5	10	0	0	10	0	0
15	92714246	rs77509558	T	C	3	5	8	0	0	8	0	0
15	92714296	rs1165	G	T	7	3	10	0	0	10	0	0
15	92715131	rs2270061	A	T	59	37	96	0	0	96	0	0
15	92715167	rs2270060	C	T	57	39	96	0	0	96	0	0
15	92715168	rs11074043	G	A	38	57	95	0	1	96	0	0
15	93161501	rs11552662	G	T	4	3	7	0	0	7	0	0
15	93255827	rs1808818	G	A	35	0	35	0	1	36	0	0
15	93255929	rs8039403	A	C	32	0	32	0	1	33	0	0
15	93441625	rs111737111	T	G	12	17	29	0	0	29	0	0
15	93587102	rs13167	C	T	0	6	6	0	1	7	0	0
15	94406399	rs11857050	A	G	6	9	15	0	0	15	0	0
15	94407036	rs9920649	C	G	0	6	6	0	0	6	0	0
15	94408827	rs28417566	C	T	2	5	7	0	0	7	0	0
15	94408850	rs35966742	A	C	2	5	7	0	0	7	0	0
15	94430963	rs55882077	T	G	3	3	6	0	0	6	0	0
15	94776950	rs28732672	T	G	4	8	12	0	0	12	0	0
15	94778339	rs8034374	G	A	7	16	23	0	0	23	0	0
15	94780486	rs12904339	G	A	6	8	14	0	0	14	0	0
15	94887332	rs7179839	T	A	8	0	8	0	0	8	0	0
15	94887534	rs7179169	C	T	7	0	7	0	0	7	0	0
15	94918650	rs7163806	A	T	3	3	6	0	0	6	0	0
15	94919347	rs8025603	C	T	4	2	6	0	0	6	0	0
15	94945719	rs7178698	G	T	7	5	12	0	0	12	0	0
15	94946216	rs11633971	A	G	5	4	9	0	0	9	0	0
15	94946231	rs11633973	A	C	6	2	8	0	0	8	0	0
15	95014655	rs1424695	T	C	2	6	8	0	0	8	0	0
15	95019387	rs3784637	G	A	18	12	30	0	0	30	0	0
15	95024344	rs2839734	G	A	8	2	10	0	0	10	0	0
15	95024760	rs1048048	T	C	21	13	34	0	0	34	0	0
15	95026435	rs17730448	C	G	10	3	13	0	0	13	0	0
15	95399496	rs371745997	T	G	7	0	7	0	0	7	0	0
15	98507248	rs34475919	A	G	6	6	12	0	0	12	0	0
15	98508017	rs8026910	G	T	4	4	8	0	0	8	0	0
15	98509513	rs76209521	T	G	2	7	9	0	0	9	0	0
15	98515040	rs3169160	C	T	40	45	85	0	1	86	0	0
15	98515221	rs9652498	A	C	46	78	124	0	0	124	0	0
15	98516752	rs1043382	T	G	42	61	103	0	1	104	0	0
15	99504437	rs2684788	C	T	5	2	7	0	0	7	0	0
15	99504671	rs1815009	C	T	6	5	11	0	0	11	0	0
15	99504843	rs2654980	C	T	4	5	9	0	0	9	0	0
15	99505062	rs2684787	C	T	5	6	11	0	0	11	0	0
15	99505423	rs3743249	G	T	3	3	6	0	0	6	0	0
15	99505485	rs2684786	C	T	4	7	11	0	0	11	0	0
15	99505822	rs28393861	T	C	7	1	8	0	0	8	0	0
15	99505828	rs28674628	A	G	6	1	7	0	0	7	0	0
15	99505980	rs2684785	C	T	3	10	13	0	0	13	0	0
15	99791695	rs3743238	T	C	8	4	12	0	0	12	0	0
15	99798503	rs6598229	A	C	4	4	8	0	0	8	0	0
15	99799474	rs62023769	C	T	3	3	6	0	0	6	0	0
15	99894459	rs75390830	T	C	3	5	8	0	0	8	0	0
15	99897748	rs62023852	A	G	15	19	34	0	0	34	0	0
15	99898229	rs28736849	T	C	5	10	15	0	0	15	0	0
15	99898283	rs28651946	T	C	12	4	16	0	0	16	0	0
15	99899583	rs62023854	A	G	12	12	24	0	1	25	0	0
15	99925021	rs1472986	T	C	4	3	7	0	0	7	0	0
15	99925274	rs62025383	T	A	3	4	7	0	0	7	0	0
15	99926440	rs2289558	T	C	47	22	69	0	2	71	0	0
15	99927272	rs7171173	T	G	8	7	15	0	0	15	0	0
15	99927296	rs62025385	C	G	7	6	13	0	0	13	0	0
15	99927321	rs28513885	A	G	7	5	12	0	0	12	0	0
15	99927346	rs112872395	A	G	4	5	9	0	0	9	0	0
15	99927365	rs190325234	A	G	5	5	10	0	0	10	0	0
15	99927391	rs7166659	A	G	7	4	11	0	1	12	0	0
15	99927404	rs7165962	C	T	6	3	9	0	1	10	0	0
15	99927422	rs7165974	C	T	8	2	10	0	0	10	0	0
15	99928815	rs74033479	C	G	3	4	7	0	0	7	0	0
15	99929429	rs28360908	C	T	11	4	15	0	0	15	0	0
15	100156665	rs35655388	A	G	29	4	33	0	0	33	0	0
15	100158009	rs8024784	A	T	7	1	8	0	0	8	0	0
15	100160564	rs12900424	A	G	7	4	11	0	0	11	0	0
15	100199027	rs78378522	A	G	5	10	15	0	0	15	0	0
15	100199430	rs3743180	A	G	9	5	14	0	0	14	0	0
15	100199721	rs2570817	C	T	6	7	13	0	0	13	0	0
15	100204531	.	G	C	2	5	7	0	0	7	0	0
15	100204679	.	T	A	4	6	10	0	0	10	0	0
15	100220441	rs2570799	G	A	4	2	6	0	0	6	0	0
15	100234675	rs4965533	A	G	9	7	16	0	0	16	0	0
15	100234906	rs12913830	T	A	12	13	25	0	0	25	0	0
15	100236251	rs4965534	G	C	3	3	6	0	0	6	0	0
15	100240910	rs4965536	G	A	2	4	6	0	0	6	0	0
15	100253502	rs72760574	G	A	42	45	87	0	0	87	0	0
15	100255034	rs1059759	G	C	15	12	27	0	0	27	0	0
15	100268095	rs78284811	C	A	5	3	8	0	0	8	0	0
15	100269613	rs11852387	C	T	11	3	14	0	0	14	0	0
15	100270081	rs1470923	A	C	5	1	6	0	0	6	0	0
15	100270400	rs713613	C	T	3	8	11	0	0	11	0	0
15	100271253	rs12185079	C	T	1	6	7	0	0	7	0	0
15	100346577	rs142215148	G	A	6	1	7	0	0	7	0	0
15	100360336	rs10152218	T	C	1	5	6	0	0	6	0	0
15	100379080	rs12148499	G	C	5	2	7	0	0	7	0	0
15	100982958	.	A	G	6	0	6	0	0	6	0	0
15	100982979	.	G	C	0	8	8	0	0	8	0	0
15	101109677	rs8451	C	A	12	20	32	0	0	32	0	0
15	101109794	rs12157	C	G	17	19	36	0	0	36	0	0
15	101109818	rs12460	G	A	17	19	36	0	0	36	0	0
15	101109893	rs6598356	C	A	15	18	33	0	1	34	0	0
15	101110265	rs2411836	T	A	4	7	11	0	0	11	0	0
15	101110302	rs2411837	C	G	8	9	17	0	0	17	0	0
15	101113950	rs12592868	A	G	9	10	19	0	0	19	0	0
15	101120963	rs11247226	T	C	9	2	11	0	0	11	0	0
15	101189896	rs2279594	C	T	22	21	43	0	0	43	0	0
15	101598200	rs11857803	G	A	84	69	153	0	1	154	0	0
15	101610669	rs2278953	C	T	20	21	41	0	0	41	0	0
15	101615860	.	A	T	2	4	6	0	0	6	0	0
15	101616113	.	C	T	6	12	18	0	0	18	0	0
15	101616135	.	A	T	9	3	12	0	1	13	0	0
15	101616154	.	T	C	10	1	11	0	0	11	0	0
15	101616159	.	C	T	9	2	11	0	0	11	0	0
15	101616176	.	C	T	8	3	11	0	0	11	0	0
15	101616218	rs2959202	C	A	5	8	13	0	0	13	0	0
15	101616219	rs2959203	A	G	5	7	12	0	1	13	0	0
15	101616468	rs2924840	A	C	5	6	11	0	0	11	0	0
15	101617105	rs2959204	A	G	15	9	24	0	0	24	0	0
15	101617196	rs2924842	C	T	12	7	19	0	0	19	0	0
15	101617201	rs8043509	A	G	7	12	19	0	0	19	0	0
15	101617202	rs8041708	G	C	6	13	19	0	0	19	0	0
15	101617231	rs28827888	A	G	4	7	11	0	0	11	0	0
15	101617366	rs2995900	T	C	6	1	7	0	0	7	0	0
15	101617367	rs2925198	G	A	6	1	7	0	0	7	0	0
15	101617538	rs2925197	G	A	13	10	23	0	0	23	0	0
15	101617813	rs12905195	A	G	11	6	17	0	0	17	0	0
15	101617864	rs2959205	C	T	12	14	26	0	0	26	0	0
15	101617943	rs2959206	G	A	13	19	32	0	0	32	0	0
15	101618095	rs60066289	G	A	19	12	31	0	0	31	0	0
15	101618151	rs58660333	T	C	15	11	26	0	0	26	0	0
15	101618157	rs2925196	G	A	11	14	25	0	0	25	0	0
15	101716583	rs11433	A	G	125	178	303	0	0	303	0	0
15	101717065	rs3784523	A	G	131	191	322	0	3	325	0	0
15	101717680	rs8024370	G	T	115	166	281	0	2	283	0	0
15	101718097	rs28364839	C	G	145	209	354	0	5	359	0	0
15	101728381	rs7166488	C	T	25	22	47	0	0	47	0	0
15	101738199	rs2045163	C	T	4	4	8	0	0	8	0	0
15	101739533	rs1809462	T	C	1	5	6	0	0	6	0	0
15	101740199	rs10751717	A	G	2	5	7	0	0	7	0	0
15	101758227	rs12324684	G	C	17	10	27	0	0	27	0	0
15	101760081	rs28393606	C	T	3	6	9	0	0	9	0	0
15	101761003	rs67228299	G	A	6	3	9	0	0	9	0	0
15	101766002	rs28635705	C	T	2	5	7	0	0	7	0	0
15	101773563	rs12442366	G	A	3	4	7	0	0	7	0	0
15	101774889	rs8025591	T	A	2	6	8	0	0	9	1	0
15	101775905	rs7165356	C	T	1	5	6	0	0	6	0	0
15	101775920	rs7165361	C	T	1	5	6	0	0	6	0	0
15	101776416	rs11631804	G	A	1	5	6	0	0	6	0	0
15	101777602	rs28570030	C	T	2	4	6	0	0	6	0	0
15	101778710	rs8033360	C	A	8	3	11	0	0	11	0	0
15	101779863	rs11858464	G	A	8	13	21	0	0	21	0	0
15	101780094	rs11634283	A	G	3	5	8	0	0	8	0	0
15	101780691	rs58136452	C	T	13	12	25	0	0	25	0	0
15	101781125	rs11856403	A	C	1	5	6	0	0	6	0	0
15	101781934	rs752092	A	G	15	9	24	0	0	24	0	0
15	101782089	rs8029617	G	A	7	12	19	0	0	19	0	0
15	101782175	rs8031074	C	T	1	15	16	0	0	16	0	0
15	101782187	rs8036047	T	C	1	15	16	0	0	16	0	0
15	101782262	rs8031113	C	G	5	8	13	0	0	13	0	0
15	101782759	rs11639408	T	C	8	15	23	0	0	23	0	0
15	101783234	rs12324313	C	G	7	5	12	0	0	12	0	0
15	101783292	rs12324414	C	T	10	8	18	0	0	18	0	0
15	101784223	rs7182945	C	T	8	12	20	0	1	21	0	0
15	101784281	rs28465510	A	T	9	8	17	0	0	17	0	0
15	101784546	rs12324545	G	A	7	7	14	0	0	14	0	0
15	101784664	rs11247277	A	G	2	7	9	0	0	9	0	0
15	101784799	.	G	A	0	6	6	0	0	6	0	0
15	101785970	rs8038272	T	C	6	6	12	0	0	12	0	0
15	101786253	rs8032573	G	A	6	4	10	0	0	10	0	0
15	101786733	rs28445340	T	C	7	9	16	0	0	16	0	0
15	101786747	rs9672951	G	T	8	8	16	0	0	16	0	0
15	101787269	rs9672295	A	G	3	4	7	0	0	7	0	0
15	101788054	rs11630071	G	A	7	7	14	0	0	14	0	0
15	101788149	rs11636628	T	A	7	8	15	0	0	15	0	0
15	101788211	rs11630455	C	T	2	5	7	0	0	7	0	0
15	101789044	rs28498458	C	T	4	4	8	0	0	8	0	0
15	101789281	rs8023451	G	T	2	4	6	0	0	6	0	0
15	101789505	rs8023810	G	A	2	4	6	0	0	6	0	0
15	101789567	rs8025126	C	T	1	6	7	0	0	7	0	0
15	101789868	rs8024450	G	T	2	4	6	0	0	6	0	0
15	101790381	rs8031268	A	C	5	4	9	0	0	9	0	0
15	101790817	rs8032007	A	G	7	12	19	0	0	19	0	0
15	101791359	rs7176149	C	G	54	84	138	0	0	138	0	0
15	101824070	rs28622909	G	A	9	7	16	0	1	17	0	0
15	102182183	rs708394	A	G	32	30	62	0	0	62	0	0
15	102186103	rs2956846	A	C	5	1	6	0	0	6	0	0
15	102186319	rs62027583	G	A	3	3	6	0	0	6	0	0
15	102188545	rs616410	C	T	5	1	6	0	0	6	0	0
15	102191247	rs62027586	T	C	3	5	8	0	0	8	0	0
15	102191540	.	G	T	11	4	15	0	0	15	0	0
15	102192034	rs507903	A	G	9	8	17	0	0	17	0	0
15	102192540	rs675436	T	G	13	11	24	0	0	24	0	0
15	102277480	rs1052887	G	C	26	11	37	0	1	38	0	0
15	102282802	rs11630648	G	A	3	7	10	0	0	10	0	0
15	102282835	rs11637152	T	C	2	10	12	0	0	12	0	0
15	102503167	.	A	G	6	0	6	0	0	6	0	0
15	102503280	rs71411197	G	C	8	0	8	0	0	8	0	0
15	102506049	rs10736921	G	T	4	2	6	0	0	6	0	0
15	102506092	.	G	A	4	6	10	0	0	10	0	0
15	102506099	.	C	T	4	6	10	0	0	10	0	0
15	102506120	.	C	G	6	5	11	0	0	11	0	0
15	102506525	.	C	T	4	2	6	0	0	6	0	0
15	102507050	.	T	A	8	5	13	0	0	13	0	0
15	102513555	.	T	C	17	0	17	0	0	17	0	0
15	102514724	.	G	A	28	38	66	0	0	66	0	0
15	102514957	.	A	T	4	10	14	0	0	14	0	0
15	102516492	.	C	G	298	429	727	0	0	727	0	0
15	102516652	.	C	T	335	27	362	0	3	365	0	0
16	66646	.	G	A	10	11	21	0	0	21	0	0
16	66660	.	G	A	11	13	24	0	0	24	0	0
16	67299	.	G	A	25	5	30	0	0	30	0	0
16	1291622	rs149113013	A	G	1895	17	1912	0	7	1919	0	0
16	1367650	rs7198283	C	A	41	2	43	0	1	44	0	0
16	2607730	.	C	T	7	0	7	0	0	7	0	0
16	2608001	.	G	A	0	8	8	0	0	8	0	0
16	2649668	.	G	T	18	0	18	0	0	18	0	0
16	2649988	.	A	G	60	0	60	0	0	60	0	0
16	2650146	.	G	C	44	0	44	0	0	44	0	0
16	5135380	rs6775	A	G	1	10	11	0	0	11	0	0
16	14969016	.	T	A	71	26	97	0	0	97	0	0
16	14972670	.	C	A	86	43	129	0	0	129	0	0
16	14972694	.	A	G	1	9	10	0	0	10	0	0
16	14972973	.	A	G	3	5	8	0	0	8	0	0
16	14972980	.	C	T	4	7	11	0	0	11	0	0
16	14973205	.	G	A	2	21	23	0	0	23	0	0
16	14988657	.	C	T	2	7	9	0	0	9	0	0
16	14988868	.	A	G	78	0	78	0	1	79	0	0
16	15012703	.	T	C	24	1	25	0	0	25	0	0
16	15024568	.	A	G	27	3	30	0	0	30	0	0
16	15069483	.	C	T	3	5	8	0	0	8	0	0
16	15069663	.	G	C	2	5	7	0	0	7	0	0
16	15069867	.	C	T	5	5	10	0	0	10	0	0
16	15069911	.	A	T	4	5	9	0	0	9	0	0
16	15070610	.	A	G	1	7	8	0	0	8	0	0
16	15070699	.	G	A	3	8	11	0	0	11	0	0
16	15070916	rs113583208	G	C	3	10	13	0	0	13	0	0
16	15071117	.	T	C	2	4	6	0	0	6	0	0
16	15100295	.	G	A	18	35	53	0	1	54	0	0
16	15118211	rs7194585	T	C	4	2	6	0	0	6	0	0
16	15122195	.	A	G	4	5	9	0	0	9	0	0
16	15123280	.	A	G	1	5	6	0	0	6	0	0
16	15221657	.	C	T	129	3	132	0	0	132	0	0
16	16415224	.	C	T	3	9	12	0	0	12	0	0
16	16462271	.	C	T	0	6	6	0	0	6	0	0
16	16465097	rs76641987	G	A	84	0	84	0	0	84	0	0
16	16465228	.	A	G	1	98	99	0	1	100	0	0
16	16465246	.	A	G	1	90	91	0	1	92	0	0
16	18433014	.	G	C	0	31	31	0	1	32	0	0
16	18433025	.	C	T	0	38	38	0	1	39	0	0
16	18433230	.	A	C	0	85	85	0	2	87	0	0
16	18441762	.	A	G	54	21	75	0	1	76	0	0
16	18441781	.	G	A	26	59	85	0	0	85	0	0
16	18442553	.	C	T	10	0	10	0	0	10	0	0
16	18448507	.	A	C	7	0	7	0	0	7	0	0
16	21420079	.	G	A	3	15	18	0	0	18	0	0
16	21886176	.	G	A	12	0	12	0	0	12	0	0
16	21886231	.	C	T	0	13	13	0	0	13	0	0
16	22545897	.	G	T	159	18	177	0	2	179	0	0
16	69735108	.	G	A	20	42	62	0	0	62	0	0
16	70161263	.	T	C	15	7	22	0	0	22	0	0
16	70164334	.	A	G	10	3	13	0	0	13	0	0
16	70182249	.	C	T	6	1	7	0	0	7	0	0
16	70182375	.	T	C	17	12	29	0	1	30	0	0
16	70182390	.	T	G	21	15	36	0	0	36	0	0
16	70190401	.	C	T	19	22	41	0	2	43	0	0
16	70191029	rs4985509	T	G	27	14	41	0	2	43	0	0
16	70191161	.	C	T	9	21	30	0	0	30	0	0
16	70191333	rs2287983	T	C	17	18	35	0	0	35	0	0
16	70191566	rs2287985	A	G	21	27	48	0	1	49	0	0
16	70192000	.	A	C	18	19	37	0	0	37	0	0
16	70192013	rs12448586	C	T	15	24	39	0	0	39	0	0
16	70192464	rs55679539	A	C	17	27	44	0	0	44	0	0
16	70193405	.	G	A	36	35	71	0	1	72	0	0
16	70193614	.	C	T	29	26	55	0	0	55	0	0
16	70194891	.	A	C	26	29	55	0	1	56	0	0
16	70195967	rs1044867	T	G	41	46	87	0	0	87	0	0
16	70196184	rs7269	A	G	60	53	113	0	0	113	0	0
16	70196186	rs1044876	T	G	60	53	113	0	0	113	0	0
16	74394671	rs62055171	T	C	6	12	18	0	0	18	0	0
16	74396147	.	T	C	4	2	6	0	0	6	0	0
16	89967853	.	C	G	5	3	8	0	0	8	0	0
16	89975004	.	C	T	9	7	16	0	0	16	0	0
16	90232648	.	A	T	0	7	7	0	0	7	0	0
16	90232872	.	C	T	20	1	21	0	1	22	0	0
16	90232893	.	C	A	1	10	11	0	0	11	0	0
17	11880844	rs148876757	G	A	27	22	49	0	1	50	0	0
17	11945223	rs62060970	C	T	4	2	6	0	0	6	0	0
17	12898295	rs17552022	T	C	45	38	83	0	1	84	0	0
17	12899902	rs5030739	C	T	36	52	88	0	1	89	0	0
17	12907023	rs77703211	G	A	3	4	7	0	0	7	0	0
17	12907909	rs58608011	C	T	4	4	8	0	0	8	0	0
17	12908247	rs17639379	T	A	4	3	7	0	0	7	0	0
17	14005439	rs2159132	G	A	18	11	29	0	0	29	0	0
17	14095309	rs2230354	A	G	11	16	27	0	0	27	0	0
17	14111915	rs1050223	C	T	11	4	15	0	0	15	0	0
17	14205812	rs886864	G	C	2	10	12	0	0	12	0	0
17	14206362	rs719470	T	C	4	13	17	0	0	17	0	0
17	14208985	rs2190625	T	C	10	2	12	0	0	12	0	0
17	14251948	rs11552190	G	A	18	4	22	0	0	22	0	0
17	15133657	rs7538	A	G	4	3	7	0	0	7	0	0
17	15931693	rs72821769	G	A	157	140	297	0	2	299	0	0
17	16203290	rs115958467	C	A	3	3	6	0	0	6	0	0
17	16321032	rs3813768	G	C	43	41	84	0	0	85	1	0
17	16325968	rs8121	A	G	52	47	99	0	0	99	0	0
17	16326005	rs1129235	A	C	67	46	113	0	1	114	0	0
17	16329815	rs7223205	G	A	4	3	7	0	0	7	0	0
17	16524929	rs9906261	C	A	4	4	8	0	0	8	0	0
17	16527795	rs8065506	C	A	4	4	8	0	0	8	0	0
17	16744626	.	A	G	18	1	19	0	0	19	0	0
17	16744678	.	C	T	16	2	18	0	0	18	0	0
17	16744793	.	A	T	23	0	23	0	0	23	0	0
17	16744892	.	C	G	1	8	9	0	0	9	0	0
17	16744899	.	A	C	1	7	8	0	0	8	0	0
17	16950883	rs11078366	C	G	7	2	9	0	0	9	0	0
17	16953846	rs76235061	C	T	2	7	9	0	0	9	0	0
17	16954103	rs7222311	A	G	6	4	10	0	1	11	0	0
17	17089785	rs59061797	A	C	23	32	55	0	0	55	0	0
17	17090267	rs7207485	G	A	20	17	37	0	1	38	0	0
17	17095198	rs80292501	G	A	25	19	44	0	1	45	0	0
17	17104714	rs14003	C	T	9	6	15	0	1	16	0	0
17	17105615	rs9908205	G	C	7	2	9	0	0	9	0	0
17	17105682	rs4985749	G	A	5	7	12	0	0	12	0	0
17	17116412	rs3803761	A	G	25	45	70	0	1	71	0	0
17	17132618	rs1708617	A	G	0	6	6	0	0	6	0	0
17	17133121	rs1613416	G	A	1	6	7	0	0	7	0	0
17	17135422	rs1736211	A	G	5	2	7	0	0	7	0	0
17	17140297	rs1708629	G	A	4	8	12	0	2	14	0	0
17	17151141	rs1736204	T	C	11	16	27	0	0	27	0	0
17	17151664	rs1736203	G	C	10	21	31	0	0	31	0	0
17	17151938	rs1736202	G	A	9	23	32	0	0	32	0	0
17	17158694	rs2458529	A	C	9	5	14	0	0	14	0	0
17	17158969	rs9894884	C	T	9	5	14	0	0	14	0	0
17	17159069	rs9901894	G	A	4	8	12	0	0	12	0	0
17	17159424	rs1708625	T	C	3	9	12	0	0	12	0	0
17	17160614	rs2472689	T	G	8	7	15	0	0	15	0	0
17	17162851	rs78042359	T	C	8	2	10	0	0	10	0	0
17	17165136	rs1736210	C	A	45	75	120	0	1	121	0	0
17	17168164	rs3182911	G	A	289	351	640	0	12	652	0	0
17	17168610	rs9890657	G	A	2	7	9	0	0	9	0	0
17	17168633	rs7220827	T	C	2	6	8	0	0	8	0	0
17	17169362	rs12453455	A	G	0	8	8	0	0	8	0	0
17	17179481	rs4985761	G	A	18	19	37	0	0	38	1	0
17	17394611	rs1242489	G	A	22	18	40	0	0	40	0	0
17	17397818	rs711352	G	C	107	97	204	0	2	206	0	0
17	17409560	rs7946	C	T	84	77	161	0	1	162	0	0
17	17411211	rs4646408	C	T	5	1	6	0	0	6	0	0
17	17422354	rs1108579	C	T	5	7	12	0	0	12	0	0
17	17425631	rs897453	C	T	77	81	158	0	1	159	0	0
17	17928193	rs575052205	G	A	8	10	18	0	0	18	0	0
17	18111868	rs1378602	G	A	104	136	240	0	3	243	0	0
17	18142740	rs2746029	C	G	5	1	6	0	0	6	0	0
17	18144683	rs2605138	T	C	3	5	8	0	0	8	0	0
17	18144720	rs2245737	C	T	3	3	6	0	0	6	0	0
17	18147679	rs113978084	C	A	20	46	66	0	1	67	0	0
17	18153301	rs2473657	A	G	5	2	7	0	0	7	0	0
17	18153892	rs67826234	C	T	4	5	9	0	0	9	0	0
17	18157160	rs68165736	C	T	11	12	23	0	0	23	0	0
17	18167397	rs3889402	G	T	4	3	7	0	0	7	0	0
17	18167400	rs202127880	G	A	4	4	8	0	0	8	0	0
17	18167505	rs2605143	T	C	7	9	16	0	1	17	0	0
17	18167684	rs12603700	G	A	6	18	24	0	0	24	0	0
17	18175656	rs73289931	G	T	10	14	24	0	0	24	0	0
17	18176292	rs56360702	A	C	9	10	19	0	0	19	0	0
17	18176423	rs12946752	C	T	22	18	40	0	0	40	0	0
17	18177578	rs3088175	T	G	13	18	31	0	0	31	0	0
17	18177661	rs17732686	C	T	16	22	38	0	0	38	0	0
17	18177945	rs11555081	C	G	24	13	37	0	0	37	0	0
17	18218804	rs1563634	T	C	31	46	77	0	0	77	0	0
17	18220770	rs1563632	G	A	41	47	88	0	2	90	0	0
17	18221799	rs7221807	T	C	2	7	9	0	1	10	0	0
17	18221811	rs112192098	G	A	3	6	9	0	0	9	0	0
17	18222339	rs55940735	C	T	12	11	23	0	1	24	0	0
17	18222647	rs4924846	T	G	16	11	27	0	0	27	0	0
17	18223106	rs12601400	C	T	7	4	11	0	0	11	0	0
17	18225527	rs56074845	G	A	5	2	7	0	0	7	0	0
17	18333075	.	C	T	4	3	7	0	0	7	0	0
17	18441714	rs201778900	C	T	5	2	7	0	0	7	0	0
17	18456679	rs533754008	T	G	6	4	10	0	0	10	0	0
17	18571133	rs3813033	C	T	8	3	11	0	0	11	0	0
17	18571366	rs9889937	A	G	1	8	9	0	0	9	0	0
17	18571565	rs9890990	G	A	4	3	7	0	0	7	0	0
17	18574009	rs3813032	A	G	6	1	7	0	0	7	0	0
17	18574872	rs9635700	G	T	5	5	10	0	0	10	0	0
17	18574941	rs116821563	G	A	7	10	17	0	0	17	0	0
17	18574998	rs9635701	A	T	8	7	15	0	1	16	0	0
17	18575127	rs9635680	G	A	4	5	9	0	0	9	0	0
17	18575140	rs9635681	A	G	4	4	8	0	0	8	0	0
17	18575675	rs55797270	T	G	3	4	7	0	0	7	0	0
17	18684487	rs59588820	A	G	5	1	6	0	0	6	0	0
17	18694277	rs61075345	G	A	38	11	49	0	0	49	0	0
17	18702220	rs8080471	T	C	72	33	105	0	1	106	0	0
17	18708991	rs373765497	C	T	16	18	34	0	0	34	0	0
17	18709492	rs3865258	T	C	46	25	71	0	0	71	0	0
17	18709578	rs10886	A	G	49	24	73	0	0	73	0	0
17	18872337	rs8415	T	C	11	18	29	0	0	29	0	0
17	18872521	rs2074273	A	G	11	7	18	0	0	18	0	0
17	18872581	rs2074272	C	T	11	7	18	0	0	18	0	0
17	18873849	rs3751970	G	C	15	8	23	0	0	23	0	0
17	18873905	rs3751969	A	G	12	6	18	0	1	19	0	0
17	18926153	rs144628398	T	G	5	1	6	0	0	6	0	0
17	18967152	rs62068862	C	T	3	16	19	0	0	19	0	0
17	18967183	rs577577062	C	G	14	0	14	0	0	14	0	0
17	19808345	rs11657354	T	A	6	3	9	0	0	9	0	0
17	20108239	rs2703806	A	T	19	9	28	0	0	28	0	0
17	20140541	rs6587060	A	G	12	7	19	0	0	19	0	0
17	20140785	rs2703779	A	G	8	7	15	0	0	15	0	0
17	20163529	rs2703791	A	G	18	15	33	0	0	33	0	0
17	20215905	rs11871827	G	C	5	2	7	0	0	7	0	0
17	20221050	rs7222647	A	C	2	4	6	0	0	6	0	0
17	20902959	rs1045215	G	C	74	98	172	0	2	174	0	0
17	20903068	rs6618	C	A	139	82	221	0	1	223	1	0
17	20903080	rs1045162	C	A	134	82	216	0	4	220	0	0
17	20904292	rs1127814	G	A	223	159	382	0	6	388	0	0
17	20906251	rs4985956	C	T	144	67	211	0	10	221	0	0
17	20909045	rs9911289	G	A	50	42	92	0	2	94	0	0
17	20909709	rs36086904	C	G	25	33	58	0	4	62	0	0
17	20909841	rs7216921	C	A	22	20	42	0	1	43	0	0
17	20909990	rs75568568	G	T	20	16	36	0	1	37	0	0
17	20910834	rs4985959	G	A	18	9	27	0	0	27	0	0
17	20910869	rs8079468	A	T	9	22	31	0	0	31	0	0
17	20910984	rs16962375	G	T	11	24	35	0	0	35	0	0
17	20911173	rs2291034	G	T	9	3	12	0	0	12	0	0
17	20911204	rs11541311	G	T	213	227	440	0	4	444	0	0
17	20912848	rs899340	C	T	8	3	11	0	0	11	0	0
17	20914635	rs2291035	G	A	6	8	14	0	0	14	0	0
17	20915515	rs3785544	C	T	9	13	22	0	0	22	0	0
17	20916022	rs17770614	A	C	11	9	20	0	0	20	0	0
17	20916362	rs719093	G	A	2	7	9	0	0	9	0	0
17	20916590	rs716959	A	G	6	6	12	0	0	12	0	0
17	21105669	rs17698188	G	C	4	2	6	0	0	6	0	0
17	21142572	rs6902	A	C	22	32	54	0	2	56	0	0
17	21144074	rs732928	G	A	14	19	33	0	1	34	0	0
17	21194769	rs72840055	C	T	11	0	11	0	0	11	0	0
17	21194771	rs114473529	A	T	11	0	11	0	0	11	0	0
17	21194785	.	T	C	11	0	11	0	0	11	0	0
17	21194820	.	G	A	13	0	13	0	0	13	0	0
17	21194843	.	T	C	8	0	8	0	0	8	0	0
17	21194852	.	G	A	9	0	9	0	0	9	0	0
17	21194859	.	G	A	9	0	9	0	0	9	0	0
17	21195039	.	G	A	9	0	9	0	0	9	0	0
17	21195080	.	A	C	0	12	12	0	0	12	0	0
17	21195111	rs73309660	T	C	11	0	11	0	0	11	0	0
17	21195119	.	T	C	11	0	11	0	0	11	0	0
17	21195128	.	G	A	12	0	12	0	0	12	0	0
17	21195139	.	C	T	13	0	13	0	0	13	0	0
17	21195180	.	C	T	16	0	16	0	0	16	0	0
17	21195225	rs77307626	G	A	15	0	15	0	0	15	0	0
17	21195229	rs78947202	A	G	15	0	15	0	0	15	0	0
17	21195233	rs79162051	G	A	14	0	14	0	0	14	0	0
17	21195236	rs80052421	G	A	14	0	14	0	0	14	0	0
17	21195241	.	A	G	14	0	14	0	0	14	0	0
17	21195296	.	C	T	7	0	7	0	0	7	0	0
17	21195301	.	C	T	6	0	6	0	0	6	0	0
17	21195317	rs7211106	T	G	6	0	6	0	0	6	0	0
17	21195324	.	T	A	0	7	7	0	0	7	0	0
17	21195332	rs7224594	G	A	8	0	8	0	0	8	0	0
17	21195335	rs7224596	G	A	9	0	9	0	0	9	0	0
17	21195478	.	G	A	10	0	10	0	0	10	0	0
17	21195525	.	G	C	7	0	7	0	0	7	0	0
17	21195670	.	C	G	8	0	8	0	0	8	0	0
17	21195995	.	C	T	8	0	8	0	0	8	0	0
17	21196032	.	C	T	8	0	8	0	0	8	0	0
17	21196037	.	A	G	7	0	7	0	1	8	0	0
17	21202400	.	C	T	4	5	9	0	0	9	0	0
17	21202784	rs4986016	C	A	7	3	10	0	0	10	0	0
17	21203338	rs12451239	C	G	7	4	11	0	0	11	0	0
17	21203567	rs6587135	A	G	3	5	8	0	1	9	0	0
17	21204266	rs2230435	T	C	593	464	1057	0	12	1069	0	0
17	21204877	rs9899521	C	A	4	5	9	0	0	9	0	0
17	21205606	rs2305871	G	C	28	58	86	0	1	87	0	0
17	21206556	rs736103	C	T	8	24	32	0	0	32	0	0
17	21207276	rs6587136	T	C	50	3	53	0	2	55	0	0
17	21207277	rs6587137	A	G	52	3	55	0	1	56	0	0
17	21207916	rs7209761	A	G	10	14	24	0	0	24	0	0
17	21208221	.	G	A	10	9	19	0	1	20	0	0
17	21211531	rs113454801	T	G	20	14	34	0	0	34	0	0
17	21212721	rs8069013	T	C	21	19	40	0	0	40	0	0
17	21213024	rs8064878	C	T	24	21	45	0	0	45	0	0
17	21213050	rs62058925	C	T	27	22	49	0	0	49	0	0
17	21213782	rs9901404	A	G	52	49	101	0	1	102	0	0
17	21214022	rs61059691	G	A	37	36	73	0	0	73	0	0
17	21214253	rs6587138	G	A	52	48	100	0	0	100	0	0
17	21214616	rs4021717	A	G	44	25	69	0	1	70	0	0
17	21214906	rs1824232	G	A	72	56	128	0	4	132	0	0
17	21214922	rs4986019	G	C	72	52	124	0	5	129	0	0
17	21215204	rs9909362	C	T	42	50	92	0	0	92	0	0
17	21216294	rs4985838	A	C	6	5	11	0	1	12	0	0
17	21216964	rs1657686	T	C	18	7	25	0	0	25	0	0
17	25638921	.	G	A	21	29	50	0	1	51	0	0
17	25910099	.	G	T	13	12	25	0	0	25	0	0
17	25974258	rs4239242	T	C	4	6	10	0	0	10	0	0
17	25976524	rs8368	A	G	152	72	224	0	0	224	0	0
17	26206414	rs3751972	C	A	10	12	22	0	0	22	0	0
17	26220355	rs4063521	G	T	4	3	7	0	0	7	0	0
17	26519204	rs3182380	C	T	15	7	22	0	0	22	0	0
17	26671196	rs733914	C	G	10	10	20	0	0	20	0	0
17	26676135	rs13469	C	T	139	135	274	0	1	275	0	0
17	26794816	rs56216739	G	A	45	0	45	0	13	58	0	0
17	26794935	rs36032016;rs75899298	G	A	154	0	154	0	3	157	0	0
17	26794938	rs62065339;rs75529047	C	T	158	0	158	0	7	165	0	0
17	26794939	rs62065340	T	G	159	0	159	0	5	165	1	0
17	26795081	rs11080065	G	A	449	0	449	0	17	466	0	0
17	26795115	rs11080066	C	G	540	0	540	0	77	617	0	0
17	26795156	rs12449751	G	A	277	0	277	0	310	594	7	0
17	26795313	rs7501666	G	T	36	0	36	0	1	37	0	0
17	26883313	rs631905	A	G	3	5	8	0	0	8	0	0
17	26888563	rs143746801	G	A	71	56	127	0	0	127	0	0
17	26890950	rs3764865	A	G	5	3	8	0	0	8	0	0
17	27044004	rs11545699	C	T	291	238	529	0	1	530	0	0
17	27044237	rs143463372	C	T	273	309	582	0	5	587	0	0
17	27411083	rs183513552	A	G	2	4	6	0	0	6	0	0
17	27590146	rs117954678	T	C	275	290	565	0	3	568	0	0
17	27617820	.	G	A	4	6	10	0	0	10	0	0
17	27778834	rs4795510	G	A	2	6	8	0	0	8	0	0
17	27835138	rs508706	C	T	21	12	33	0	0	33	0	0
17	27869968	rs507577	G	A	16	14	30	0	0	30	0	0
17	27871025	rs17766675	A	G	14	17	31	0	0	31	0	0
17	27872147	rs602056	C	T	19	18	37	0	0	37	0	0
17	27873192	.	G	A	13	4	17	0	1	18	0	0
17	27875213	rs11868320	G	A	7	7	14	0	0	14	0	0
17	27889986	rs542939	T	C	134	124	258	0	2	260	0	0
17	27891864	rs636000	A	G	17	20	37	0	0	37	0	0
17	27895528	rs497993	T	C	19	79	98	0	1	99	0	0
17	27897585	rs771251	T	C	18	8	26	0	2	28	0	0
17	27898828	rs565977	T	C	42	36	78	0	1	79	0	0
17	27901975	rs550818	A	G	1	9	10	0	0	10	0	0
17	28087442	rs35674319	A	G	9	8	17	0	0	17	0	0
17	28505174	rs11544945	A	C	19	12	31	0	0	31	0	0
17	28576076	rs1050565	T	C	94	59	153	0	2	155	0	0
17	28612448	rs7342921	G	C	81	52	133	0	2	135	0	0
17	28791872	.	A	G	94	78	172	0	0	172	0	0
17	28792444	rs116917123	C	A	114	84	198	0	0	198	0	0
17	28829675	rs140499217	A	G	2	5	7	0	2	9	0	0
17	29061033	.	A	G	4	4	8	0	1	9	0	0
17	29350682	.	T	C	5	5	10	0	0	10	0	0
17	29423119	rs2940184	T	C	8	12	20	0	0	20	0	0
17	29508775	rs1801052	G	A	30	14	44	0	1	45	0	0
17	29546175	rs2905880	T	C	2	4	6	0	0	6	0	0
17	29553485	rs2285892	G	A	21	31	52	0	0	52	0	0
17	29578360	rs9303642	T	C	15	10	25	0	1	26	0	0
17	29578724	rs11080146	C	T	3	9	12	0	1	13	0	0
17	29630970	rs3087591	A	G	84	92	176	0	0	176	0	0
17	29633816	.	A	T	4	3	7	0	0	7	0	0
17	29703374	rs7406983	G	A	7	10	17	0	0	17	0	0
17	29703438	rs1800845	C	G	6	11	17	0	0	17	0	0
17	29857460	rs61731602	G	A	14	28	42	0	0	42	0	0
17	29860652	rs4795615	C	A	4	3	7	0	0	7	0	0
17	29863370	rs8080134	G	C	3	3	6	0	0	6	0	0
17	29863879	rs1551359	C	T	5	5	10	0	0	10	0	0
17	29863955	rs1551358	G	T	2	6	8	0	0	8	0	0
17	29863956	rs1551357	T	C	2	6	8	0	0	8	0	0
17	29864006	rs1551356	A	G	5	7	12	0	0	12	0	0
17	30283627	.	C	T	16	1	17	0	0	17	0	0
17	30372739	.	C	T	97	3	100	0	0	100	0	0
17	30373438	.	T	C	8	0	8	0	0	8	0	0
17	30689181	rs66960710	G	A	11	6	17	0	1	18	0	0
17	30819778	rs3187325	G	A	7	5	12	0	0	12	0	0
17	33269648	rs2230553	C	G	4	2	6	0	0	6	0	0
17	33289937	rs8249	A	T	22	19	41	0	0	41	0	0
17	33308221	rs3135958	G	T	4	4	8	0	0	8	0	0
17	33318312	rs3135983	T	G	7	2	9	0	0	9	0	0
17	33322322	rs3135998	A	G	6	4	10	0	0	10	0	0
17	33326780	rs2066505	G	A	8	4	12	0	0	12	0	0
17	33330150	rs4796030	A	C	5	3	8	0	0	8	0	0
17	33332655	rs60014690	A	G	7	6	13	0	1	14	0	0
17	33337411	rs1859248	G	A	176	153	329	0	1	330	0	0
17	33338447	rs16970540	C	T	168	108	276	0	1	277	0	0
17	33338570	.	G	A	192	153	345	0	4	349	0	0
17	33339283	rs2074520	G	C	5	5	10	0	0	10	0	0
17	33341834	rs2074519	T	C	13	5	18	0	0	18	0	0
17	33342022	rs2269857	C	G	9	4	13	0	0	13	0	0
17	33342781	rs62062371	T	C	6	8	14	0	0	14	0	0
17	33347512	rs6505438	G	A	5	5	10	0	0	10	0	0
17	33353332	rs3926358	T	C	3	3	6	0	0	6	0	0
17	33433487	rs4796033	C	T	10	5	15	0	1	16	0	0
17	33593024	rs2291190	T	C	4	7	11	0	0	11	0	0
17	33690466	rs12453150	C	A	6	7	13	0	0	13	0	0
17	33769034	rs62078110	G	A	4	2	6	0	0	6	0	0
17	34051124	rs11653803	T	G	52	74	126	0	0	126	0	0
17	34171827	rs4251786	C	T	215	111	326	0	19	345	0	0
17	34415720	rs8951	T	C	430	504	934	0	5	939	0	0
17	34415763	rs1063340	G	C	419	507	926	0	3	929	0	0
17	34416246	rs1719130	T	C	69	99	168	0	3	171	0	0
17	34416537	rs1130371	G	A	652	792	1444	0	11	1455	0	0
17	34416946	rs1719134	G	A	107	144	251	0	1	252	0	0
17	34431211	rs1049746	G	C	16	21	37	0	0	37	0	0
17	34431403	rs1719144	G	A	18	19	37	0	3	40	0	0
17	34432237	rs72833526	G	A	23	7	30	0	0	30	0	0
17	34432242	rs1634516	G	C	9	22	31	0	0	31	0	0
17	34432297	rs1719148	A	G	11	23	34	0	1	35	0	0
17	34432403	rs1634517	C	A	18	32	50	0	0	50	0	0
17	34432581	rs1719149	T	C	21	6	27	0	0	27	0	0
17	34432586	rs1719150	A	G	20	7	27	0	0	27	0	0
17	34432663	rs1049807	A	G	156	295	451	0	4	455	0	0
17	34432664	rs1719152	T	A	157	294	451	0	4	455	0	0
17	34522609	.	T	C	797	278	1075	0	5	1080	0	0
17	34539235	rs200975376	G	A	14	2	16	0	2	18	0	0
17	34842521	rs4796224	A	G	6	1	7	0	0	7	0	0
17	34848874	rs2306589	T	C	3	6	9	0	0	9	0	0
17	34849697	rs2277662	C	G	8	7	15	0	0	15	0	0
17	34853574	.	G	A	11	8	19	0	0	19	0	0
17	34855069	rs2005488	C	G	5	3	8	0	0	8	0	0
17	34856518	rs72818340	G	A	11	4	15	0	0	15	0	0
17	34864245	rs72818344	C	T	3	4	7	0	0	7	0	0
17	34869155	rs8882	G	A	14	35	49	0	0	49	0	0
17	34871721	rs2306595	T	C	51	15	66	0	1	67	0	0
17	34890718	.	G	A	2	6	8	0	0	8	0	0
17	34893326	rs72818370	A	G	3	3	6	0	0	6	0	0
17	34900836	rs3736166	G	C	168	102	270	0	1	271	0	0
17	34905408	rs9906189	A	G	8	2	10	0	0	10	0	0
17	34929982	rs55654069	A	G	3	4	7	0	1	8	0	0
17	34934820	.	C	T	6	5	11	0	0	11	0	0
17	34938050	rs72818385	C	A	3	3	6	0	0	6	0	0
17	34941427	.	T	C	9	2	11	0	1	12	0	0
17	34942750	rs1076184	T	A	23	23	46	0	0	46	0	0
17	35330836	rs1564796	A	G	4	3	7	0	0	7	0	0
17	35337106	rs79042009	G	A	18	19	37	0	0	37	0	0
17	35346641	rs1045056	T	C	74	73	147	0	1	148	0	0
17	35370737	rs77026185	A	G	3	3	6	0	0	6	0	0
17	35374466	rs17620949	G	A	1	5	6	0	0	6	0	0
17	35377928	rs873950	T	C	3	3	6	0	0	6	0	0
17	35378121	rs2301685	G	A	1	6	7	0	0	7	0	0
17	35766475	rs72828246	A	G	6	0	6	0	0	6	0	0
17	35899141	rs1034686	T	A	6	2	8	0	0	8	0	0
17	35902225	rs3110623	C	G	11	13	24	0	0	24	0	0
17	35913442	.	C	T	9	4	13	0	1	14	0	0
17	35971195	rs116425961	G	C	27	21	48	0	0	48	0	0
17	35971548	rs12939622	A	G	9	6	15	0	0	15	0	0
17	35972254	rs57962176	C	T	9	4	13	0	0	13	0	0
17	35975176	rs9892460	G	A	6	5	11	0	0	11	0	0
17	35975298	rs148629484	G	A	5	2	7	0	0	7	0	0
17	35976384	rs116365341	C	A	6	2	8	0	1	9	0	0
17	35988672	rs7224513	C	T	11	11	22	0	0	22	0	0
17	36348713	.	C	T	0	6	6	0	0	6	0	0
17	36348950	.	C	T	0	6	6	0	0	6	0	0
17	36351203	.	C	T	8	0	8	0	0	8	0	0
17	36353452	.	C	T	0	6	6	0	0	6	0	0
17	36358657	.	T	A	9	0	9	0	0	9	0	0
17	36361992	.	C	T	0	9	9	0	0	9	0	0
17	36393117	.	A	G	11	0	11	0	0	11	0	0
17	36628477	rs9916392	A	G	5	3	8	0	0	8	0	0
17	36629890	rs56013503	A	C	4	3	7	0	0	7	0	0
17	36630452	rs56319003	G	A	7	2	9	0	2	11	0	0
17	36630915	rs11649863	T	A	4	5	9	0	0	9	0	0
17	36633110	rs34711568	T	G	14	4	18	0	0	18	0	0
17	36860927	rs3760148	G	T	6	8	14	0	0	14	0	0
17	36873149	rs9892493	C	T	48	34	82	0	0	82	0	0
17	36882021	rs113919478	G	C	82	65	147	0	1	148	0	0
17	36883953	rs1139109	C	T	65	60	125	0	1	126	0	0
17	36886828	rs11658500	G	A	4	6	10	0	0	10	0	0
17	36889559	rs2879097	C	T	47	47	94	0	0	94	0	0
17	36889979	rs34857493	C	T	6	4	10	0	0	10	0	0
17	36890949	rs708692	T	C	7	4	11	0	0	11	0	0
17	36915540	rs35246838	T	C	4	4	8	0	0	8	0	0
17	37004785	rs1239175	C	T	7	4	11	0	0	11	0	0
17	37006131	rs1239176	T	C	26	19	45	0	0	45	0	0
17	37009072	rs1239179	C	T	13	15	28	0	2	30	0	0
17	37054772	rs1130638	C	T	103	54	157	0	2	159	0	0
17	37070658	rs525989	A	G	93	77	170	0	0	170	0	0
17	37071189	rs2241009	C	T	2	4	6	0	0	6	0	0
17	37071995	rs569502	T	C	9	8	17	0	0	17	0	0
17	37073182	rs600158	G	A	3	6	9	0	0	9	0	0
17	37073532	rs598751	G	A	12	8	20	0	0	20	0	0
17	37075506	rs660413	G	A	98	91	189	0	1	190	0	0
17	37076331	rs646097	G	A	146	154	300	0	4	304	0	0
17	37082081	rs573556	A	C	4	4	8	0	0	8	0	0
17	37357034	rs16530	C	T	26	13	39	0	0	39	0	0
17	37359216	rs72823347	C	T	20	29	49	0	0	49	0	0
17	37359952	rs76704154	T	C	4	2	6	0	0	6	0	0
17	37409625	rs1046632	A	G	87	84	171	0	1	172	0	0
17	37409801	rs755499	G	A	69	89	158	0	1	159	0	0
17	37409865	rs755500	G	A	91	73	164	0	1	165	0	0
17	37415544	rs11078896	C	T	16	15	31	0	0	31	0	0
17	37415870	rs11078897	C	T	32	32	64	0	0	64	0	0
17	37417575	rs3744348	C	G	15	19	34	0	0	34	0	0
17	37503204	rs7359658	T	C	4	4	8	0	0	8	0	0
17	37682657	rs4404103	A	G	54	41	95	0	3	98	0	0
17	37683153	rs4541107	T	C	23	14	37	0	0	37	0	0
17	37683231	rs3889368	C	T	18	16	34	0	0	34	0	0
17	37683548	rs1077715	A	T	26	32	58	0	1	59	0	0
17	37684407	rs7405770	T	A	18	26	44	0	0	44	0	0
17	37684990	rs55660616	C	A	14	6	20	0	0	20	0	0
17	37706578	rs6503519	A	G	10	6	16	0	0	16	0	0
17	37813856	rs11869286	G	C	5	1	6	0	0	6	0	0
17	37814080	rs1877031	G	A	113	97	210	0	0	210	0	0
17	37815899	rs11658786	G	A	5	5	10	0	0	10	0	0
17	37817482	rs2271308	T	C	3	7	10	0	0	10	0	0
17	37822311	rs1053651	A	C	9	10	19	0	1	20	0	0
17	37828072	rs14050	C	T	19	20	39	0	0	39	0	0
17	37828496	rs2952151	T	C	19	13	32	0	0	32	0	0
17	37828745	rs2941503	A	G	18	23	41	0	0	41	0	0
17	37828787	rs907087	G	A	18	16	34	0	0	34	0	0
17	37830900	rs2941504	A	G	11	9	20	0	0	20	0	0
17	37921742	rs907091	C	T	3	4	7	0	0	7	0	0
17	38062196	rs2305480	G	A	10	3	13	0	0	13	0	0
17	38062217	rs2305479	C	T	7	3	10	0	0	10	0	0
17	38137364	rs3087852	G	A	71	77	148	0	0	148	0	0
17	38137623	rs8075668	C	T	30	17	47	0	0	47	0	0
17	38138624	rs2305481	G	A	9	7	16	0	0	16	0	0
17	38146154	rs9916279	T	C	144	177	321	0	1	322	0	0
17	38147293	rs11654706	A	G	6	4	10	0	0	10	0	0
17	38147294	rs11078931	C	T	4	6	10	0	0	10	0	0
17	38148210	rs11078932	C	T	2	6	8	0	0	8	0	0
17	38149258	rs58212353	T	G	3	4	7	0	0	7	0	0
17	38154084	rs2012	G	C	106	122	228	0	2	230	0	0
17	38175462	rs12309	C	T	66	42	108	0	3	111	0	0
17	38175866	rs11555254	G	A	55	82	137	0	1	138	0	0
17	38177839	rs12453732	A	C	10	5	15	0	0	15	0	0
17	38179492	rs2302777	A	G	54	42	96	0	1	97	0	0
17	38179667	rs2302778	A	G	5	6	11	0	0	11	0	0
17	38181133	rs12453341	C	T	3	3	6	0	0	6	0	0
17	38181134	rs143199581	G	A	3	3	6	0	0	6	0	0
17	38181168	rs12451547	T	C	1	5	6	0	0	6	0	0
17	38181176	rs12453343	C	A	2	6	8	0	0	8	0	0
17	38182081	rs7503939	A	G	4	6	10	0	0	10	0	0
17	38182229	rs9916158	G	T	5	5	10	0	0	10	0	0
17	38182844	rs2302775	T	C	8	8	16	0	0	16	0	0
17	38183090	rs2302774	G	T	4	2	6	0	1	7	0	0
17	38186106	rs11555255	C	T	34	57	91	0	0	91	0	0
17	38188419	rs3935281	C	T	1	5	6	0	0	6	0	0
17	38328364	.	G	A	104	82	186	0	1	187	0	0
17	38720972	rs78279284	G	A	5	7	12	0	0	12	0	0
17	38788348	rs11654834	C	T	11	5	16	0	0	16	0	0
17	38791075	rs9915135	A	T	3	3	6	0	0	6	0	0
17	38791481	rs1474454	T	C	3	4	7	0	0	7	0	0
17	38797202	rs1048573	T	A	1	5	6	0	0	6	0	0
17	38804561	rs3752026	A	C	9	14	23	0	0	23	0	0
17	39846184	.	G	A	4601	3822	8423	0	61	8485	1	0
17	39910531	rs9902034	C	A	3	5	8	0	0	8	0	0
17	39910685	rs9903101	A	G	3	4	7	0	0	7	0	0
17	39911771	rs4627408	A	G	195	255	450	0	2	452	0	0
17	39912145	rs1126821	T	A	564	684	1248	0	9	1258	1	0
17	39912581	rs9890858	A	G	7	12	19	0	0	19	0	0
17	39912880	rs11079012	G	C	7	11	18	0	0	18	0	0
17	39913256	rs11869903	A	G	13	8	21	0	0	21	0	0
17	39913645	rs7216034	T	C	9	12	21	0	0	21	0	0
17	39914070	rs8067890	G	T	89	44	133	0	2	135	0	0
17	39915764	rs4293437	C	G	4	4	8	0	0	8	0	0
17	39915866	rs35169582	C	T	7	9	16	0	0	16	0	0
17	39918786	rs4313852	C	T	5	4	9	0	0	9	0	0
17	39920257	rs7406225	A	G	10	10	20	0	0	20	0	0
17	39920621	rs8081732	T	C	2	8	10	0	0	10	0	0
17	39939430	rs74871137	A	G	5	4	9	0	0	9	0	0
17	40125864	rs2070106	G	A	42	46	88	0	0	88	0	0
17	40126022	.	A	T	13	7	20	0	2	22	0	0
17	40424255	rs8064638	G	A	4	3	7	0	0	7	0	0
17	40427147	rs8080122	G	A	4	3	7	0	0	7	0	0
17	40446422	rs16967637	C	A	4	5	9	0	0	9	0	0
17	40659900	.	C	T	5	2	7	0	0	7	0	0
17	40660205	.	C	T	5	5	10	0	0	10	0	0
17	40845373	.	C	T	5	1	6	0	0	6	0	0
17	41131645	rs35444712	C	A	6	3	9	0	0	9	0	0
17	41145527	rs1043284	C	T	5	4	9	0	0	9	0	0
17	41150021	rs35164264	A	G	6	1	7	0	0	7	0	0
17	41150949	rs2271539	G	A	14	24	38	0	0	38	0	0
17	41151190	rs12451424	T	C	5	7	12	0	0	12	0	0
17	41165632	rs150695787	G	A	28	22	50	0	1	51	0	0
17	41166417	rs10840	G	A	8	10	18	0	0	18	0	0
17	41167957	rs455055	C	A	66	55	121	0	2	123	0	0
17	41597259	rs72833134	A	C	2	7	9	0	0	9	0	0
17	41601911	rs3179927	A	G	25	25	50	0	0	50	0	0
17	41602858	rs9907813	T	G	40	30	70	0	0	70	0	0
17	41602865	rs9907819	T	C	41	29	70	0	1	71	0	0
17	41603161	rs9908559	T	C	37	34	71	0	0	71	0	0
17	41603882	rs9915640	T	C	45	48	93	0	2	95	0	0
17	41843979	rs15359	C	G	39	49	88	0	0	88	0	0
17	41844689	rs1230397	C	T	33	42	75	0	1	76	0	0
17	41845403	rs1230399	C	T	21	25	46	0	0	46	0	0
17	41845451	rs1230400	G	A	20	18	38	0	0	38	0	0
17	41845824	rs11713	G	A	112	74	186	0	0	186	0	0
17	41846468	rs17742347	C	T	85	69	154	0	3	157	0	0
17	41848713	rs61608877	A	C	4	3	7	0	0	7	0	0
17	41849105	rs116979403	G	A	1	5	6	0	0	6	0	0
17	41850508	rs4793026	A	G	4	4	8	0	0	8	0	0
17	41891437	rs17742929	G	A	3	3	6	0	1	7	0	0
17	42154470	rs375171	A	G	12	9	21	0	0	21	0	0
17	42156471	rs376816	A	C	5	3	8	0	0	8	0	0
17	42157739	rs850856	C	T	33	40	73	0	2	75	0	0
17	42158310	rs377963	T	G	32	22	54	0	0	54	0	0
17	42158613	rs479044	A	G	26	19	45	0	0	45	0	0
17	42173252	rs189050	G	C	3	4	7	0	0	7	0	0
17	42188494	rs143813580	A	T	5	6	11	0	0	11	0	0
17	42234330	rs227582	C	T	2	4	6	0	0	6	0	0
17	42266224	rs8073555	G	C	10	12	22	0	0	22	0	0
17	42268274	rs757430	C	T	72	96	168	0	3	171	0	0
17	42326105	rs62078947	C	T	43	44	87	0	1	88	0	0
17	42430244	rs5848	C	T	682	776	1458	0	4	1462	0	0
17	42449789	rs5910	G	A	15	21	36	0	0	36	0	0
17	42453065	rs5911	A	C	19	24	43	0	0	43	0	0
17	42800414	rs17682536	C	T	0	6	6	0	0	6	0	0
17	42927628	rs2231647	A	G	3	3	6	0	0	6	0	0
17	42929970	rs2289673	T	C	4	3	7	0	0	7	0	0
17	42945296	rs2120276	A	G	8	9	17	0	0	17	0	0
17	42945867	rs3785890	A	G	6	9	15	0	0	15	0	0
17	42953409	rs2289674	A	G	53	63	116	0	0	116	0	0
17	42954017	rs1899649	G	A	4	2	6	0	0	6	0	0
17	42954517	rs74815784	T	C	3	5	8	0	0	8	0	0
17	42957139	rs2289676	C	T	2	6	8	0	0	8	0	0
17	42959642	rs12452911	T	C	5	3	8	0	0	8	0	0
17	42961009	rs2289677	C	T	7	4	11	0	0	11	0	0
17	43037191	rs1055646	G	C	10	2	12	0	0	12	0	0
17	43101281	rs7225735	A	C	11	28	39	0	0	39	0	0
17	43101382	rs7225329	C	T	34	38	72	0	2	74	0	0
17	43111688	rs9900173	G	A	27	27	54	0	0	54	0	0
17	43175906	rs2239922	C	T	32	32	64	0	0	64	0	0
17	43183108	rs1053739	G	A	37	35	72	0	1	73	0	0
17	43189267	rs11870501	T	G	29	45	74	0	0	74	0	0
17	43190846	rs734921	G	A	75	65	140	0	0	140	0	0
17	43192821	rs713101	A	G	23	36	59	0	1	60	0	0
17	43216472	rs16939879	A	G	8	6	14	0	0	14	0	0
17	43226478	rs7216041	C	T	112	125	237	0	25	262	0	0
17	43228491	rs901753	C	T	109	105	214	0	2	216	0	0
17	43229299	rs8070447	A	C	113	101	214	0	6	220	0	0
17	43294324	rs8068730	G	A	8	15	23	0	0	23	0	0
17	43294588	rs139098453	T	C	6	5	11	0	0	11	0	0
17	43294811	rs117920061	G	A	2	4	6	0	0	6	0	0
17	43295879	rs141249601	T	C	3	4	7	0	0	7	0	0
17	43305520	rs9891541	C	T	3	6	9	0	0	9	0	0
17	43306649	rs12453698	C	T	2	4	6	0	0	6	0	0
17	43306685	rs57344356	G	A	3	4	7	0	0	7	0	0
17	43307719	rs4792892	G	T	1	5	6	0	0	6	0	0
17	43309171	rs9908320	C	T	6	4	10	0	0	10	0	0
17	43309466	rs9907333	G	A	5	1	6	0	0	6	0	0
17	43309942	rs9913962	G	A	33	13	46	0	0	46	0	0
17	43310143	rs79181461	G	A	22	17	39	0	1	40	0	0
17	43310182	rs75239108	T	C	33	21	54	0	1	55	0	0
17	43310840	rs12103702	C	T	5	6	11	0	0	11	0	0
17	43311620	rs9898221	A	G	126	74	200	0	4	204	0	0
17	43311968	rs9910393	T	A	54	30	84	0	1	86	1	0
17	43312507	rs9905657	A	T	60	45	105	0	0	105	0	0
17	43312700	rs9903656	G	A	122	68	190	0	0	190	0	0
17	43312800	rs9906359	A	G	103	72	175	0	0	175	0	0
17	43312831	rs1989230	G	A	68	84	152	0	4	156	0	0
17	43313404	rs9891552	T	A	92	100	192	0	2	194	0	0
17	43313989	.	T	A	58	46	104	0	0	104	0	0
17	43314544	rs77766814	A	G	67	59	126	0	0	126	0	0
17	43315547	rs1133458	G	A	6	3	9	0	0	9	0	0
17	43317574	rs7212404	G	A	26	14	40	0	0	40	0	0
17	43317817	.	C	A	7	18	25	0	1	26	0	0
17	43340631	rs1047841	C	T	91	80	171	0	0	171	0	0
17	43340936	rs708563	G	A	140	132	272	0	2	274	0	0
17	43342306	rs2285674	C	A	8	9	17	0	0	17	0	0
17	43351127	rs2072090	G	C	4	4	8	0	0	8	0	0
17	43365392	rs11574815	G	A	6	8	14	0	0	14	0	0
17	43365441	rs35518221	A	G	5	5	10	0	0	10	0	0
17	43367152	rs4792846	G	A	6	3	9	0	0	9	0	0
17	43471481	rs7613	G	A	69	80	149	0	3	152	0	0
17	43471489	rs4763	G	A	84	71	155	0	0	155	0	0
17	43472321	rs1059504	A	G	77	60	137	0	1	138	0	0
17	43514589	rs3186976	G	C	109	115	224	0	1	225	0	0
17	43519325	rs143827834	G	A	3	4	7	0	0	7	0	0
17	43543830	rs2521819	T	C	3	8	11	0	1	12	0	0
17	43546853	rs9903522	G	A	7	2	9	0	0	9	0	0
17	43547855	.	C	T	5	6	11	0	1	12	0	0
17	43548671	rs9893586	A	C	3	3	6	0	0	6	0	0
17	43548778	rs7224890	G	C	7	0	7	0	0	7	0	0
17	43551672	rs2037442	C	T	11	8	19	0	0	19	0	0
17	43552106	rs4792859	C	T	11	10	21	0	0	21	0	0
17	44109474	rs7220988	G	A	82	92	174	0	2	176	0	0
17	44109843	rs1078997	A	G	10	5	15	0	0	15	0	0
17	44116843	rs16940845	C	A	4	4	8	0	0	8	0	0
17	44120994	rs67682367	A	T	4	5	9	0	0	9	0	0
17	44125098	rs114516555	G	A	7	1	8	0	0	8	0	0
17	44125466	rs8078067	G	A	5	4	9	0	1	10	0	0
17	44247017	rs7206949	C	A	5	5	10	0	1	11	0	0
17	44626660	rs1969205	C	G	8	4	12	0	0	12	0	0
17	44799216	rs199455	C	T	20	0	20	0	24	44	0	0
17	45017188	rs16941324	A	T	15	28	43	0	0	43	0	0
17	45017645	rs4968286	T	C	21	25	46	0	1	47	0	0
17	45018822	.	C	T	13	16	29	0	0	29	0	0
17	45019243	rs1047779	T	G	16	23	39	0	1	40	0	0
17	45026366	rs9889762	G	A	4	6	10	0	0	10	0	0
17	45044147	rs11079745	C	A	5	2	7	0	1	8	0	0
17	45094576	rs548201739	C	T	3	4	7	0	0	7	0	0
17	45127218	rs114929602	A	G	5	2	7	0	0	7	0	0
17	45134012	rs35721448	C	T	8	20	28	0	1	29	0	0
17	45210873	rs9747171	A	G	4	3	7	0	0	7	0	0
17	45217273	rs147769898	T	C	5	2	7	0	0	7	0	0
17	45236199	rs114808103	G	A	3	3	6	0	0	6	0	0
17	45236201	rs4968254	G	A	3	3	6	0	0	6	0	0
17	45237204	rs1634265	C	T	4	4	8	0	0	8	0	0
17	45239339	rs116340610	A	C	5	1	6	0	0	6	0	0
17	45368337	rs15908	A	C	6	0	6	0	0	6	0	0
17	45388241	rs16941864	C	T	4	3	7	0	0	7	0	0
17	45388283	rs2317676	A	G	3	4	7	0	0	7	0	0
17	45390449	rs140661797	C	T	8	0	8	0	0	8	0	0
17	45390951	rs12600603	G	C	3	5	8	0	0	8	0	0
17	45608885	rs201212390	C	T	39	49	88	0	0	88	0	0
17	45669878	rs148379754	T	C	62	78	140	0	1	141	0	0
17	45680609	rs138748282	C	A	2	4	6	0	0	6	0	0
17	45695832	rs3760370	C	T	11	11	22	0	0	22	0	0
17	45697549	rs7207542	C	G	2	11	13	0	0	13	0	0
17	45698175	rs4793978	G	A	12	10	22	0	0	22	0	0
17	45737701	rs7219303	A	G	6	9	15	0	0	15	0	0
17	45738008	rs74737283	G	C	4	4	8	0	0	8	0	0
17	45746683	rs115736925	C	T	4	3	7	0	0	7	0	0
17	45755954	rs4239163	C	T	4	2	6	0	0	6	0	0
17	45789316	rs76004009	G	A	21	28	49	0	2	51	0	0
17	45822901	rs11657479	T	C	11	7	18	0	0	18	0	0
17	45823227	rs7502875	A	C	6	7	13	0	0	13	0	0
17	45885756	rs9911983	C	T	27	23	50	0	1	51	0	0
17	45887738	rs16948401	G	A	6	4	10	0	0	10	0	0
17	45901480	rs701984	C	T	117	87	204	0	0	204	0	0
17	45915086	rs10428	G	A	16	15	31	0	0	31	0	0
17	45915395	rs6503875	T	C	20	23	43	0	0	43	0	0
17	45994154	rs2229358	G	A	44	44	88	0	0	88	0	0
17	46002744	rs1130932	G	T	29	48	77	0	0	77	0	0
17	46025816	rs7208554	G	A	1	5	6	0	0	6	0	0
17	46051911	rs886444	G	A	15	14	29	0	0	29	0	0
17	46059071	rs2737	T	C	56	27	83	0	0	83	0	0
17	46130449	rs142702434	C	T	1	5	6	0	1	7	0	0
17	46135645	rs76434554	C	T	12	7	19	0	0	19	0	0
17	46137546	rs187479826	G	T	23	3	26	0	0	26	0	0
17	46178674	rs3744347	G	A	2	6	8	0	1	9	0	0
17	46185056	rs114472350	G	T	38	66	104	0	2	106	0	0
17	46197980	rs193273785	C	T	3	5	8	0	0	8	0	0
17	46620288	rs1042815	G	A	348	407	755	0	5	760	0	0
17	46622106	rs149018490	G	A	58	71	129	0	0	129	0	0
17	46622159	rs142964858	C	T	32	40	72	0	2	74	0	0
17	46625519	rs999493	G	A	5	3	8	0	0	8	0	0
17	46627394	rs4793578	T	C	186	351	537	0	9	546	0	0
17	46629006	rs3826542	G	A	60	38	98	0	0	98	0	0
17	46629232	rs890432	G	A	50	34	84	0	1	85	0	0
17	46629593	rs2229304	G	T	122	101	223	0	1	224	0	0
17	46632164	rs143698851	C	T	35	32	67	0	1	68	0	0
17	46632679	rs11652860	G	C	7	12	19	0	0	19	0	0
17	46632721	.	A	G	1	5	6	0	0	6	0	0
17	46633643	rs114630684	A	T	19	10	29	0	0	29	0	0
17	46633924	rs9896431	A	C	15	8	23	0	0	23	0	0
17	46635019	rs4793927	C	T	23	10	33	0	0	33	0	0
17	46635861	rs79132454	T	C	25	15	40	0	0	40	0	0
17	46636258	rs4793579	A	G	27	23	50	0	0	50	0	0
17	46636560	rs4793580	A	G	19	13	32	0	1	33	0	0
17	46636943	rs9905165	C	T	14	11	25	0	0	25	0	0
17	46639703	rs733920	A	C	6	5	11	0	0	11	0	0
17	46640290	rs7503053	C	T	10	12	22	0	0	22	0	0
17	46640731	rs7503235	A	G	10	12	22	0	0	22	0	0
17	46641131	rs6504380	C	G	6	2	8	0	0	8	0	0
17	46643364	rs6504389	C	G	5	17	22	0	1	23	0	0
17	46643389	rs2740760	A	G	5	17	22	0	2	24	0	0
17	46644161	rs11652148	G	A	9	9	18	0	0	18	0	0
17	46645325	rs7225635	G	A	10	9	19	0	1	20	0	0
17	46646014	.	G	C	9	10	19	0	0	19	0	0
17	46648899	rs2555111	C	T	11	10	21	0	0	21	0	0
17	46650231	rs2555110	A	G	5	8	13	0	0	13	0	0
17	46650395	rs114776346	T	C	6	5	11	0	0	11	0	0
17	46653602	rs114420588	G	A	185	297	482	0	3	485	0	0
17	46653872	rs183958025	G	A	76	109	185	0	0	185	0	0
17	46655145	rs180762674	C	T	16	16	32	0	0	32	0	0
17	46661100	rs115478187	C	T	4	3	7	0	0	7	0	0
17	46669430	rs9299	C	T	113	84	197	0	0	197	0	0
17	46673152	rs187860086	A	G	13	21	34	0	0	34	0	0
17	46675240	rs34438598	G	T	28	9	37	0	0	37	0	0
17	46921187	rs471975	A	G	7	5	12	0	0	12	0	0
17	46923384	rs533842	G	A	9	3	12	0	1	13	0	0
17	46925236	rs648335	C	G	6	2	8	0	0	8	0	0
17	46926615	rs550510	G	A	368	308	676	0	2	678	0	0
17	46939658	.	C	G	409	404	813	0	1	814	0	0
17	46941419	rs6504584	G	T	32	23	55	0	1	56	0	0
17	46941903	rs117327540	C	T	72	81	153	0	1	154	0	0
17	46986616	rs28528789	C	T	3	6	9	0	0	9	0	0
17	46986679	rs62075824	A	G	10	10	20	0	0	20	0	0
17	46987665	rs999474	G	A	6	5	11	0	0	11	0	0
17	46988529	rs46521	A	G	6	3	9	0	0	9	0	0
17	46988597	rs46522	C	T	4	4	8	0	0	8	0	0
17	46989154	rs9894220	A	G	6	4	10	0	0	10	0	0
17	46989354	rs318093	A	G	8	11	19	0	0	19	0	0
17	46991531	rs170319	T	C	5	7	12	0	0	12	0	0
17	46991556	rs318091	A	G	5	6	11	0	0	11	0	0
17	46991752	rs318090	G	A	10	2	12	0	0	12	0	0
17	46993233	rs3744608	C	G	5	6	11	0	0	11	0	0
17	46993370	rs4378658	G	A	3	9	12	0	0	12	0	0
17	46998118	rs28409394	T	C	4	6	10	0	0	10	0	0
17	47000251	rs1058018	C	T	99	94	193	0	1	194	0	0
17	47003221	rs957557	G	T	6	1	7	0	0	7	0	0
17	47004723	rs2088138	G	A	138	138	276	0	2	278	0	0
17	47005193	rs15563	A	G	125	101	226	0	0	226	0	0
17	47005509	rs1057897	T	G	125	110	235	0	1	236	0	0
17	47005588	rs1057902	C	T	108	91	199	0	2	201	0	0
17	47007013	rs12941604	G	A	2	4	6	0	0	6	0	0
17	47008207	rs4793992	A	G	6	9	15	0	0	15	0	0
17	47008757	rs56046215	A	T	7	4	11	0	0	11	0	0
17	47009569	rs55980913	C	T	5	3	8	0	0	8	0	0
17	47010003	rs7214832	T	C	5	4	9	0	0	9	0	0
17	47010034	rs12602179	G	T	3	3	6	0	0	6	0	0
17	47011090	rs3785953	C	A	6	4	10	0	1	11	0	0
17	47011620	rs17708633	C	G	5	6	11	0	0	11	0	0
17	47011897	rs57901004	C	T	6	15	21	0	0	21	0	0
17	47012504	rs62075850	A	G	5	8	13	0	0	13	0	0
17	47015688	rs8074792	G	A	1	5	6	0	0	6	0	0
17	47301268	rs9889994	T	A	15	11	26	0	0	26	0	0
17	47367996	rs114803378	C	T	27	28	55	0	0	55	0	0
17	47370092	rs75128743	G	A	3	5	8	0	0	8	0	0
17	47370561	rs145149232	A	G	4	3	7	0	0	7	0	0
17	47484228	rs2233667	G	C	2	5	7	0	0	7	0	0
17	47591542	.	C	T	7	10	17	0	0	17	0	0
17	47591690	rs741071	T	C	7	5	12	0	0	12	0	0
17	47591703	rs741072	T	C	8	4	12	0	0	12	0	0
17	48174908	rs9839	C	T	40	26	66	0	0	66	0	0
17	48187884	rs1063647	C	T	26	27	53	0	0	53	0	0
17	48188492	rs117918744	C	T	3	3	6	0	0	6	0	0
17	48211533	rs11365	T	G	474	330	804	0	4	808	0	0
17	48219563	rs62060038	T	C	4	5	9	0	0	9	0	0
17	48220584	rs4794103	G	A	5	4	9	0	0	9	0	0
17	48431308	.	C	T	4	8	12	0	0	12	0	0
17	48433958	rs4794136	T	C	10	3	13	0	0	13	0	0
17	48437456	rs6504649	C	G	2	6	8	0	0	8	0	0
17	48437860	rs140413577	G	A	11	6	17	0	0	17	0	0
17	48438055	rs2526537	G	T	6	4	10	0	0	10	0	0
17	48438148	rs78035001	G	A	10	9	19	0	0	19	0	0
17	48445699	rs2586438	C	T	4	2	6	0	0	6	0	0
17	48770959	rs8196	A	G	37	45	82	0	0	82	0	0
17	48771257	rs150424904	C	A	38	33	71	0	0	71	0	0
17	48814353	.	T	C	68	57	125	0	2	127	0	0
17	48819493	rs74476404	T	C	2	4	6	0	0	6	0	0
17	48824922	rs12452333	T	C	4	3	7	0	0	7	0	0
17	48827894	.	G	A	199	181	380	0	6	386	0	0
17	48830483	rs74328601	A	C	3	3	6	0	0	6	0	0
17	48832008	rs12603677	T	G	3	7	10	0	0	10	0	0
17	48832415	.	A	G	4	3	7	0	1	8	0	0
17	48942586	rs76008726	A	G	7	10	17	0	0	17	0	0
17	49050672	rs56041952	G	A	5	5	10	0	0	10	0	0
17	49051279	rs11652633	T	C	4	3	7	0	0	7	0	0
17	49051851	rs10491150	T	A	4	5	9	0	0	9	0	0
17	49053894	rs72842240	T	C	10	6	16	0	1	17	0	0
17	49054439	rs9332407	T	C	18	45	63	0	1	64	0	0
17	49056318	rs35641981	G	C	1	6	7	0	0	7	0	0
17	49069394	rs12935957	A	G	6	4	10	0	0	10	0	0
17	49069417	rs72842243	T	C	8	6	14	0	0	14	0	0
17	49073531	rs3786004	A	G	11	11	22	0	0	22	0	0
17	49073719	rs3786005	C	T	12	16	28	0	0	28	0	0
17	49074216	rs11658656	A	T	7	4	11	0	0	11	0	0
17	49075038	rs10491151	C	T	14	4	18	0	0	18	0	0
17	49076164	rs11079941	A	T	10	11	21	0	0	21	0	0
17	49107442	rs2058252	A	G	8	7	15	0	0	15	0	0
17	49107525	rs2058253	C	T	5	5	10	0	0	10	0	0
17	49114861	rs72826420	C	G	6	4	10	0	1	11	0	0
17	49158779	rs75123667	T	G	3	3	6	0	0	6	0	0
17	49249068	rs3515	A	G	335	383	718	0	4	722	0	0
17	49256694	rs9907636	A	G	22	23	45	0	1	46	0	0
17	49259277	rs78680145	C	T	3	3	6	0	0	6	0	0
17	49260907	rs929482	C	T	4	2	6	0	0	6	0	0
17	49263061	rs11079946	C	G	3	3	6	0	0	6	0	0
17	49333926	rs2191443	A	C	6	1	7	0	0	7	0	0
17	49335781	rs12600745	A	G	4	2	6	0	0	6	0	0
17	49338275	rs8907	G	A	52	45	97	0	0	97	0	0
17	49345544	rs62060088	G	A	9	14	23	0	0	23	0	0
17	49345675	rs8076318	T	C	35	28	63	0	2	65	0	0
17	49345677	rs8070746	G	A	36	29	65	0	0	65	0	0
17	49347834	rs4448992	G	A	2	5	7	0	0	7	0	0
17	49359157	rs74927806	G	A	5	2	7	0	0	7	0	0
17	49360387	rs6504703	A	G	6	10	16	0	0	16	0	0
17	49360391	rs6504704	A	G	6	9	15	0	0	15	0	0
17	49361977	rs7210107	C	G	9	5	14	0	0	14	0	0
17	49363600	rs72826501	G	A	4	4	8	0	0	8	0	0
17	49369110	rs9893020	A	G	14	4	18	0	0	18	0	0
17	49370495	rs17575641	A	G	6	5	11	0	0	11	0	0
17	49371786	rs113942216	C	T	15	11	26	0	0	26	0	0
17	53497765	rs4630612	A	G	10	9	19	0	0	19	0	0
17	54908250	rs116946289	A	C	5	6	11	0	0	11	0	0
17	54908901	rs79899681	T	C	5	6	11	0	1	12	0	0
17	54910578	rs189829242	G	A	7	14	21	0	0	21	0	0
17	54913410	rs56380338	G	A	27	42	69	0	1	70	0	0
17	54941967	rs33932456	T	A	20	18	38	0	0	38	0	0
17	54943998	rs117022995	G	A	13	19	32	0	0	32	0	0
17	54945011	rs113604757	C	G	14	7	21	0	2	23	0	0
17	54965932	rs7615	A	G	35	33	68	0	0	68	0	0
17	54967404	rs205500	T	C	80	82	162	0	1	163	0	0
17	54967528	rs2525998	A	G	65	56	121	0	0	121	0	0
17	54970181	rs169529	G	T	8	4	12	0	0	12	0	0
17	54973541	rs58489644	A	G	10	10	20	0	1	21	0	0
17	54982803	rs9909750	G	A	4	3	7	0	1	8	0	0
17	55024326	rs72842331	G	C	4	9	13	0	0	13	0	0
17	55026912	rs12942251	A	G	4	4	8	0	0	8	0	0
17	55075582	rs1811258	A	G	2	8	10	0	0	10	0	0
17	55083933	rs11559131	C	A	105	166	271	0	2	273	0	0
17	55183203	rs2230772	T	C	27	9	36	0	0	36	0	0
17	55183716	rs1050515	T	C	17	18	35	0	0	35	0	0
17	55197914	rs3095505	G	C	16	14	30	0	1	31	0	0
17	55198230	.	T	A	19	31	50	0	1	51	0	0
17	55357716	rs7223877	G	A	6	6	12	0	0	12	0	0
17	55358728	rs6503803	G	T	4	2	6	0	0	6	0	0
17	55708267	rs72834944	A	G	3	5	8	0	0	8	0	0
17	55708429	rs28706339	G	A	5	4	9	0	0	9	0	0
17	55708632	rs3853827	A	C	3	6	9	0	0	9	0	0
17	55709699	rs3760162	G	A	30	22	52	0	0	52	0	0
17	55710048	rs75705656	C	T	43	26	69	0	0	69	0	0
17	55755412	rs17730996	A	G	25	26	51	0	0	51	0	0
17	55755726	rs17731013	A	G	27	28	55	0	1	56	0	0
17	55756013	rs11658228	C	T	1	5	6	0	0	6	0	0
17	55951037	rs17762338	C	T	4	5	9	0	1	10	0	0
17	56057565	rs72839922	G	A	6	4	10	0	0	10	0	0
17	56083934	rs2233911	G	A	8	7	15	0	0	15	0	0
17	56282968	rs17174788	G	C	5	1	6	0	0	6	0	0
17	56419026	rs12936976	A	G	5	4	9	0	0	9	0	0
17	56420163	rs2680690	A	G	8	3	11	0	0	11	0	0
17	56421097	rs35258348	T	G	4	3	7	0	0	7	0	0
17	56421270	rs12602408	G	A	7	4	11	0	0	11	0	0
17	56423114	rs8263	C	T	147	191	338	0	5	343	0	0
17	56423750	rs11658873	G	C	10	8	18	0	0	18	0	0
17	56424710	rs757485	T	C	10	10	20	0	0	20	0	0
17	56425704	rs113180452	G	A	10	13	23	0	0	23	0	0
17	56426027	rs12938538	T	C	13	16	29	0	0	29	0	0
17	56426789	rs7207531	G	A	14	9	23	0	0	23	0	0
17	56427077	rs111572871	G	A	12	8	20	0	0	20	0	0
17	56427128	rs56058331	G	A	18	4	22	0	0	22	0	0
17	56427142	rs2526376	A	C	18	6	24	0	0	24	0	0
17	56427318	rs7222143	G	A	8	16	24	0	0	24	0	0
17	56427552	rs7223452	T	C	10	13	23	0	1	24	0	0
17	56428283	rs78522389	T	A	6	4	10	0	0	10	0	0
17	56429585	rs75924914	C	G	8	8	16	0	0	16	0	0
17	56584205	rs2302189	A	C	7	12	19	0	1	20	0	0
17	56584508	rs2302190	T	C	17	8	25	0	0	25	0	0
17	56585872	rs3744108	G	C	19	17	36	0	0	36	0	0
17	56697444	rs302862	G	T	1	5	6	0	0	6	0	0
17	56709034	rs411988	G	A	9	3	12	0	1	13	0	0
17	56709058	rs412000	G	C	15	7	22	0	0	22	0	0
17	56709077	rs420878	A	G	15	7	22	0	0	22	0	0
17	56709086	rs369184	C	T	15	7	22	0	0	22	0	0
17	56709175	rs77620896	A	G	7	5	12	0	0	12	0	0
17	56736473	rs654778	A	C	12	7	19	0	0	19	0	0
17	56736490	rs654743	T	C	13	11	24	0	1	25	0	0
17	56736598	rs71372848	G	C	18	5	23	0	0	23	0	0
17	56756977	rs302865	A	G	1	15	16	0	1	17	0	0
17	57076104	rs28475409	T	A	26	19	45	0	0	45	0	0
17	57187729	rs7208505	G	A	21	6	27	0	0	27	0	0
17	57187795	rs7208282	C	T	14	7	21	0	0	21	0	0
17	57280100	rs9908279	G	A	11	9	20	0	0	20	0	0
17	57280952	rs67659260	A	G	13	10	23	0	0	23	0	0
17	57281310	rs2877946	G	T	5	7	12	0	0	12	0	0
17	57281461	rs74470483	A	G	27	23	50	0	0	50	0	0
17	57281629	rs2333462	T	C	34	24	58	0	0	58	0	0
17	57282093	rs6503904	G	A	21	10	31	0	3	34	0	0
17	57282625	rs62081944	G	A	25	0	25	0	0	25	0	0
17	57287454	rs6503905	A	G	12	11	23	0	0	23	0	0
17	57290383	rs3744383	G	A	20	34	54	0	1	55	0	0
17	57474923	rs10599	G	A	20	31	51	0	1	52	0	0
17	57475896	rs9905500	G	A	55	52	107	0	1	108	0	0
17	57476653	rs7221185	T	C	70	71	141	0	0	141	0	0
17	57476699	rs58079959	T	C	71	82	153	0	1	154	0	0
17	57477235	rs1451508	T	G	40	12	52	0	1	53	0	0
17	57477273	rs1451507	T	G	33	4	37	0	1	38	0	0
17	57477616	rs758379	G	A	44	61	105	0	0	105	0	0
17	57478069	rs7220373	C	G	42	50	92	0	2	94	0	0
17	57478253	rs1046037	A	C	108	87	195	0	1	196	0	0
17	57680480	rs7209369	G	A	4	5	9	0	1	10	0	0
17	57680872	rs8066828	C	T	4	8	12	0	0	12	0	0
17	57721985	rs1973842	C	T	3	6	9	0	0	9	0	0
17	57725043	rs8071749	T	G	5	3	8	0	0	8	0	0
17	57726691	rs7220146	C	T	5	1	6	0	0	6	0	0
17	57739007	rs80264443	A	T	4	5	9	0	0	9	0	0
17	57739267	rs11872004	C	T	4	3	7	0	0	7	0	0
17	57740075	rs907066	C	T	10	5	15	0	0	15	0	0
17	57740263	rs907065	T	C	4	2	6	0	0	6	0	0
17	57741811	rs2063354	C	T	19	21	40	0	0	40	0	0
17	57744674	rs1528489	C	T	6	4	10	0	1	11	0	0
17	57748587	rs1510286	C	T	4	3	7	0	1	8	0	0
17	57762162	rs8079440	C	T	5	3	8	0	0	8	0	0
17	57762177	rs11867363	G	A	5	4	9	0	0	9	0	0
17	57765708	rs7220933	C	T	4	2	6	0	0	6	0	0
17	57766975	rs1554846	T	C	4	6	10	0	0	10	0	0
17	57767285	rs1358535	C	A	5	4	9	0	0	9	0	0
17	57767650	rs8078623	A	G	7	8	15	0	0	15	0	0
17	57776475	rs4968335	T	C	4	6	10	0	0	10	0	0
17	57776597	rs9652857	T	G	12	9	21	0	0	21	0	0
17	57778128	rs8070773	A	C	2	4	6	0	0	6	0	0
17	57778339	rs10853015	A	C	3	3	6	0	0	6	0	0
17	57915424	rs17681660	T	G	118	108	226	0	15	241	0	0
17	58068901	rs373283071	A	G	6	0	6	0	0	6	0	0
17	58121453	rs16943991	G	A	25	52	77	0	0	77	0	0
17	58156064	rs3744376	G	A	12	18	30	0	0	30	0	0
17	58755262	rs117023868	C	A	9	2	11	0	0	11	0	0
17	59760174	rs7213430	G	A	5	1	6	0	0	6	0	0
17	59760996	rs4986763	A	G	5	1	6	0	0	6	0	0
17	60553530	rs7406820	G	A	12	3	15	0	0	15	0	0
17	60554275	rs9898829	T	G	8	3	11	0	0	11	0	0
17	60555375	rs113301871	C	T	7	11	18	0	0	18	0	0
17	60644370	rs8077650	G	A	4	5	9	0	0	9	0	0
17	60662222	rs4968766	G	T	2	4	6	0	0	6	0	0
17	60666082	rs9891289	C	G	5	5	10	0	0	10	0	0
17	60666425	rs7225068	A	G	5	1	6	0	1	7	0	0
17	60667965	rs34372896	A	C	63	66	129	0	2	131	0	0
17	60683503	rs8078132	A	G	72	82	154	0	0	154	0	0
17	60691224	rs2460292	C	T	4	6	10	0	0	10	0	0
17	60767135	rs56288724	A	G	9	10	19	0	1	20	0	0
17	60767151	rs740698	C	T	10	11	21	0	0	21	0	0
17	60769803	rs3826537	A	G	37	38	75	0	1	76	0	0
17	61561853	.	C	T	5	7	12	0	0	12	0	0
17	61574527	.	G	A	2	6	8	0	0	8	0	0
17	61629692	rs9896476	G	C	2	11	13	0	0	13	0	0
17	61630076	rs6504165	T	C	2	4	6	0	0	6	0	0
17	61669684	rs1136324	G	A	3	4	7	0	0	7	0	0
17	61712964	rs7209435	T	C	2	5	7	0	0	7	0	0
17	61715461	rs113134232	G	A	16	1	17	0	0	17	0	0
17	61744040	rs8070650	A	G	2	7	9	0	0	9	0	0
17	61762148	rs11079509	G	T	4	3	7	0	0	7	0	0
17	61763031	rs11658329	G	C	13	6	19	0	0	19	0	0
17	61763208	rs9912201	A	G	5	3	8	0	1	9	0	0
17	61763534	rs9912904	A	C	13	13	26	0	1	27	0	0
17	61764921	rs9894090	A	G	11	8	19	0	0	19	0	0
17	61765524	rs9901507	G	A	6	13	19	0	0	19	0	0
17	61766457	rs16947042	T	G	12	6	18	0	0	18	0	0
17	61766880	rs1877316	C	A	8	7	15	0	0	15	0	0
17	61769456	rs7211213	T	C	5	1	6	0	0	6	0	0
17	61772050	rs15637	C	G	143	115	258	0	0	258	0	0
17	61776479	rs1877317	T	C	42	41	83	0	0	83	0	0
17	61776538	rs3817181	G	C	39	25	64	0	1	65	0	0
17	61780793	rs13380863	G	A	68	51	119	0	1	120	0	0
17	61782325	rs9897229	T	C	11	7	18	0	0	18	0	0
17	61783908	rs3817182	A	G	4	2	6	0	0	6	0	0
17	61788634	rs4264456	G	A	2	4	6	0	1	7	0	0
17	61792339	rs11657081	C	T	7	2	9	0	0	9	0	0
17	61793818	rs1982400	T	C	3	3	6	0	0	6	0	0
17	61794195	rs55674647	T	C	2	4	6	0	0	6	0	0
17	61796306	rs4968661	T	C	1	7	8	0	0	8	0	0
17	61799840	rs1470697	T	C	6	3	9	0	0	9	0	0
17	61805607	rs2137144	G	A	2	4	6	0	0	6	0	0
17	61805747	rs4968597	G	A	16	24	40	0	0	40	0	0
17	61823672	rs6504182	T	C	23	38	61	0	1	62	0	0
17	61823899	rs9207	C	T	20	13	33	0	1	34	0	0
17	61824667	rs8079818	C	G	6	2	8	0	0	8	0	0
17	61825764	rs8066719	C	T	4	3	7	0	0	7	0	0
17	61834537	rs4968662	A	G	2	4	6	0	0	6	0	0
17	61834629	rs11870815	G	T	4	3	7	0	0	7	0	0
17	61834981	rs7212196	T	C	1	5	6	0	0	6	0	0
17	61837568	rs35844156	G	A	2	6	8	0	0	8	0	0
17	61838060	rs7208397	G	A	1	5	6	0	0	6	0	0
17	61841236	rs67905415	G	A	4	3	7	0	0	7	0	0
17	61847105	rs113140273	C	T	6	3	9	0	0	9	0	0
17	61847114	rs78172786	A	C	7	3	10	0	0	10	0	0
17	61848779	rs8067102	C	G	4	7	11	0	0	11	0	0
17	61848792	rs6504185	A	G	4	8	12	0	0	12	0	0
17	61850301	rs8076717	A	G	5	6	11	0	0	11	0	0
17	61850392	rs8077013	C	T	6	3	9	0	0	9	0	0
17	61851686	rs55868506	T	G	31	37	68	0	0	68	0	0
17	61876010	rs2597636	A	G	9	14	23	0	0	23	0	0
17	61876023	rs2727333	G	A	10	11	21	0	1	22	0	0
17	61883023	rs8069687	A	G	10	14	24	0	0	24	0	0
17	61883101	.	A	G	12	9	21	0	0	21	0	0
17	61885917	rs2665823	G	A	7	6	13	0	0	13	0	0
17	61886094	.	C	T	3	6	9	0	1	10	0	0
17	61894728	rs2727290	G	T	1	5	6	0	0	6	0	0
17	61896004	rs1062787	T	C	220	233	453	0	5	458	0	0
17	61896127	rs1062788	C	G	157	172	329	0	2	331	0	0
17	61896455	rs1062790	A	G	110	123	233	0	6	239	0	0
17	61896487	rs1062791	C	T	67	74	141	0	2	143	0	0
17	61901197	rs2727288	T	A	6	20	26	0	0	26	0	0
17	61903445	rs2584625	G	C	10	10	20	0	0	20	0	0
17	61904546	rs2584624	A	G	1	5	6	0	0	6	0	0
17	61906846	rs2665833	T	C	4	11	15	0	0	15	0	0
17	61908271	rs968719	C	T	143	118	261	0	2	263	0	0
17	61909485	rs6919	T	A	39	45	84	0	0	84	0	0
17	61912261	rs2665832	C	T	16	8	24	0	1	25	0	0
17	61912392	rs2665831	C	T	11	5	16	0	0	16	0	0
17	61913621	rs7209758	C	T	18	6	24	0	0	24	0	0
17	61915326	rs2028567	G	A	15	15	30	0	1	31	0	0
17	61916347	rs894413	A	G	27	20	47	0	0	47	0	0
17	61916384	rs894414	T	C	23	23	46	0	0	46	0	0
17	61917099	rs6504187	G	A	10	7	17	0	0	17	0	0
17	61917502	.	T	A	5	2	7	0	1	8	0	0
17	61917686	rs2859619	T	C	6	10	16	0	0	16	0	0
17	62006259	rs7921	G	A	54	68	122	0	1	123	0	0
17	62006432	rs12603821	G	A	88	76	164	0	1	165	0	0
17	62006433	rs1051688	G	C	86	76	162	0	1	163	0	0
17	62080714	rs3764868	G	A	17	17	34	0	0	34	0	0
17	62117262	rs1985961	C	T	17	7	24	0	1	25	0	0
17	62117733	rs3803813	T	C	7	8	15	0	1	16	0	0
17	62118301	rs148538224	C	T	12	11	23	0	0	23	0	0
17	62119555	rs196904	C	T	6	6	12	0	0	12	0	0
17	62120344	rs12150216	C	T	12	10	22	0	0	22	0	0
17	62120569	rs16947383	C	T	10	7	17	0	0	17	0	0
17	62121480	rs196912	T	C	6	5	11	0	1	12	0	0
17	62121954	rs196914	C	T	2	4	6	0	0	6	0	0
17	62204149	rs61659349	T	C	28	17	45	0	1	46	0	0
17	62206607	rs61044233	T	A	147	168	315	0	0	315	0	0
17	62270391	rs1550794	T	C	5	1	6	0	0	6	0	0
17	62279139	rs16947561	C	G	2	8	10	0	0	10	0	0
17	62279166	rs16947564	T	C	2	8	10	0	0	10	0	0
17	62282242	rs4968703	T	C	3	3	6	0	0	6	0	0
17	62288446	rs142894763	A	G	1	5	6	0	0	6	0	0
17	62288520	rs3863512	C	T	6	4	10	0	0	10	0	0
17	62288583	rs3863513	A	G	4	4	8	0	0	8	0	0
17	62290699	rs115209976	G	A	19	29	48	0	0	48	0	0
17	62496670	rs1140409	A	C	1718	1476	3194	0	6	3202	2	0
17	62502435	rs1991401	A	G	2	5	7	0	0	7	0	0
17	62504048	rs183300621	A	G	10	11	21	0	0	21	0	0
17	62540690	rs17651039	A	G	3	7	10	0	0	10	0	0
17	62777974	rs73994204	C	T	11	11	22	0	3	25	0	0
17	62779790	rs4791270	T	C	10	16	26	0	0	26	0	0
17	62779859	rs4791269	G	A	11	11	22	0	0	22	0	0
17	62779869	rs4791268	A	G	12	9	21	0	1	22	0	0
17	62782820	rs112045286	C	A	120	117	237	0	1	238	0	0
17	62784028	rs1808191	A	C	4	2	6	0	0	6	0	0
17	62789019	rs9901569	T	C	7	7	14	0	0	14	0	0
17	62789500	rs2903882	T	G	11	8	19	0	0	19	0	0
17	62790430	rs4791265	G	A	19	8	27	0	0	27	0	0
17	62792239	.	C	T	7	3	10	0	0	10	0	0
17	62796759	rs2074182	A	C	75	51	126	0	1	127	0	0
17	62798720	rs117252753	C	T	8	8	16	0	0	16	0	0
17	64800898	rs74199615	G	A	5	1	6	0	0	6	0	0
17	65066879	rs11193	A	G	38	35	73	0	0	73	0	0
17	65067124	rs16960539	T	C	22	11	33	0	1	34	0	0
17	65067211	rs16960542	A	T	38	32	70	0	0	70	0	0
17	65068131	rs2363845	A	C	7	9	16	0	2	18	0	0
17	65069309	rs7213914	T	C	17	15	32	0	0	32	0	0
17	65069318	rs7212626	A	C	17	13	30	0	0	30	0	0
17	65070304	rs9902312	T	C	25	13	38	0	0	38	0	0
17	65091556	rs7212076	G	C	4	4	8	0	0	8	0	0
17	65091645	rs9902775	C	T	2	4	6	0	0	6	0	0
17	65100938	rs11079682	A	T	2	4	6	0	0	6	0	0
17	65104666	rs11657929	T	G	50	55	105	0	0	105	0	0
17	65192484	rs12942297	G	A	21	19	40	0	0	40	0	0
17	65196235	rs12601506	T	C	6	6	12	0	0	12	0	0
17	65211876	rs10512514	A	C	5	1	6	0	0	6	0	0
17	65233180	rs11079684	G	A	7	4	11	0	0	11	0	0
17	65336473	rs62085998	C	T	17	12	29	0	0	29	0	0
17	65339155	rs6504498	C	T	17	12	29	0	1	30	0	0
17	65339156	rs6504499	A	C	18	12	30	0	0	30	0	0
17	65340085	rs75147046	G	A	5	3	8	0	0	8	0	0
17	65341770	rs62086001	T	C	22	30	52	0	1	53	0	0
17	65341976	rs62086002	A	G	8	4	12	0	0	12	0	0
17	65342242	rs9303517	T	C	6	3	9	0	0	9	0	0
17	65348377	rs7212453	A	T	6	1	7	0	0	7	0	0
17	65350151	.	C	T	5	5	10	0	0	10	0	0
17	65352064	rs6504500	T	C	7	5	12	0	1	13	0	0
17	65352181	rs7221926	T	A	9	5	14	0	0	14	0	0
17	65353898	rs76010652	T	C	13	5	18	0	0	18	0	0
17	65357692	rs62085808	G	A	3	12	15	0	0	15	0	0
17	65358349	rs11079690	G	T	6	4	10	0	0	10	0	0
17	65360338	rs79341117	C	T	4	3	7	0	0	7	0	0
17	65361086	rs34339814	G	C	2	8	10	0	1	11	0	0
17	65362552	rs11079691	T	A	99	81	180	0	0	180	0	0
17	65373979	rs8866	C	G	29	14	43	0	0	43	0	0
17	65716503	rs2110111	C	T	4	8	12	0	0	12	0	0
17	65716531	rs2365405	C	A	5	4	9	0	0	9	0	0
17	65727714	rs9905088	C	T	9	4	13	0	0	13	0	0
17	65732413	.	C	A	3	7	10	0	0	10	0	0
17	65732485	rs6504528	G	A	3	6	9	0	0	9	0	0
17	65733119	rs3752647	T	C	3	4	7	0	0	7	0	0
17	65734514	rs1542610	A	G	6	6	12	0	0	12	0	0
17	65734828	rs7215206	A	G	9	9	18	0	0	18	0	0
17	65739627	rs10127	A	G	50	46	96	0	1	97	0	0
17	65940727	rs6504555	A	G	17	9	26	0	1	27	0	0
17	65988049	rs9891146	T	C	12	8	20	0	0	20	0	0
17	66031900	rs12752	T	C	115	118	233	0	0	233	0	0
17	66032257	rs7214869	T	C	4	3	7	0	0	7	0	0
17	66038597	rs113615404	A	C	7	4	11	0	0	11	0	0
17	66039350	rs4638	A	G	217	210	427	0	3	430	0	0
17	66098979	rs35230316	T	C	4	6	10	0	0	10	0	0
17	66123432	rs8064704	T	G	25	10	35	0	1	36	0	0
17	66124885	rs34714600	C	G	43	46	89	0	0	89	0	0
17	66126413	rs71382164	A	G	6	6	12	0	0	12	0	0
17	66126843	rs8066305	T	C	11	4	15	0	0	15	0	0
17	66126889	rs8075265	A	G	8	6	14	0	0	14	0	0
17	66127338	rs6501362	A	T	3	4	7	0	0	7	0	0
17	66127358	rs4968876	T	C	3	5	8	0	0	8	0	0
17	66128565	rs17737798	C	T	0	6	6	0	0	6	0	0
17	66130644	rs8077300	G	A	8	3	11	0	0	11	0	0
17	66131701	rs7222953	T	C	11	10	21	0	0	21	0	0
17	66244578	rs3764855	T	C	29	29	58	0	0	58	0	0
17	66244989	rs3764854	T	C	1	5	6	0	0	6	0	0
17	66245441	rs2190761	G	A	3	3	6	0	0	6	0	0
17	66246416	rs3213690	A	G	48	49	97	0	1	98	0	0
17	66249029	rs55800047	G	A	5	1	6	0	0	6	0	0
17	66249495	rs61103052	C	T	7	5	12	0	0	12	0	0
17	70642742	rs1126967	T	C	16	7	23	0	0	23	0	0
17	70642923	rs17780256	A	C	9	5	14	0	0	14	0	0
17	71192663	rs1052706	G	A	6	6	12	0	0	12	0	0
17	71192873	rs11544800	A	G	23	22	45	0	0	45	0	0
17	71196809	rs1026128	A	G	26	28	54	0	1	55	0	0
17	71197748	rs1037256	G	A	23	31	54	0	1	55	0	0
17	71200948	rs8072987	G	A	4	3	7	0	0	7	0	0
17	71204306	.	G	A	129	135	264	0	0	264	0	0
17	71205036	rs4969023	T	C	79	68	147	0	0	147	0	0
17	71205854	rs8387	A	G	71	52	123	0	1	124	0	0
17	71223501	rs17184168	T	C	2	6	8	0	0	8	0	0
17	71223837	rs9904267	C	T	9	11	20	0	0	20	0	0
17	71223967	rs8076745	A	T	7	4	11	0	0	11	0	0
17	71224018	rs7218307	G	A	6	2	8	0	0	8	0	0
17	71224163	rs6501615	C	T	6	5	11	0	0	11	0	0
17	71224313	.	C	T	5	7	12	0	0	12	0	0
17	71226434	rs9900024	A	G	3	9	12	0	0	12	0	0
17	71226691	rs9898280	G	C	5	4	9	0	0	9	0	0
17	71227551	rs1466114	C	G	6	4	10	0	0	10	0	0
17	71227671	rs1123169	T	C	8	4	12	0	0	12	0	0
17	71227953	rs3764361	A	G	4	2	6	0	0	6	0	0
17	71232687	rs745143	T	C	9	11	20	0	0	20	0	0
17	71232807	rs904383	T	C	8	17	25	0	0	25	0	0
17	71232881	rs745142	G	C	11	15	26	0	1	27	0	0
17	71233130	rs11869253	A	G	10	15	25	0	0	25	0	0
17	71233736	rs966939	A	G	4	2	6	0	0	6	0	0
17	71233783	rs2345424	G	A	3	4	7	0	0	7	0	0
17	71238433	rs1566286	G	A	1	9	10	0	0	10	0	0
17	71239087	rs1566290	G	T	13	5	18	0	0	18	0	0
17	71244166	rs1472454	C	G	7	8	15	0	0	15	0	0
17	71244630	rs8915	C	T	5	19	24	0	0	24	0	0
17	71333186	rs1105587	A	G	60	82	142	0	3	146	1	0
17	71334254	rs3195419	C	T	68	73	141	0	1	142	0	0
17	71334473	rs3195414	G	A	66	58	124	0	1	125	0	0
17	71347027	rs12449590	G	A	6	5	11	0	0	11	0	0
17	71347252	.	T	C	18	1	19	0	0	19	0	0
17	71347545	rs117138288	G	A	3	3	6	0	0	6	0	0
17	71350459	rs12452921	C	T	4	4	8	0	0	8	0	0
17	71352637	rs6501626	T	G	1	6	7	0	0	7	0	0
17	71353790	rs2279729	G	A	4	2	6	0	0	6	0	0
17	71353985	rs2279730	T	C	4	3	7	0	0	7	0	0
17	71379589	rs12945929	C	A	2	5	7	0	0	7	0	0
17	71380878	rs67818535	C	T	10	8	18	0	0	18	0	0
17	71404331	rs8067289	G	C	3	5	8	0	0	8	0	0
17	71410891	rs12386051	C	T	60	51	111	0	1	112	0	0
17	71426656	rs1105353	G	T	64	25	89	0	0	89	0	0
17	71426670	rs1105354	G	A	66	23	89	0	0	89	0	0
17	71548670	rs76940148	A	G	9	3	12	0	1	13	0	0
17	72205217	rs117429853	T	C	7	5	12	0	0	12	0	0
17	72206412	.	C	T	29	17	46	0	1	47	0	0
17	72248482	rs9892705	C	A	22	18	40	0	0	40	0	0
17	72667020	rs9904078	G	A	3	5	8	0	0	8	0	0
17	72690829	rs9906320	G	A	139	161	300	0	1	301	0	0
17	72690918	rs9913698	C	T	81	90	171	0	1	172	0	0
17	72691928	rs2034310	T	C	131	129	260	0	0	260	0	0
17	72693127	rs144299912	C	T	17	9	26	0	0	26	0	0
17	72695211	rs2084312	C	T	4	2	6	0	0	6	0	0
17	72699384	rs749780	C	A	13	19	32	0	0	32	0	0
17	72699833	rs10512597	T	C	23	17	40	0	0	40	0	0
17	72700943	rs35489971	A	G	124	137	261	0	1	262	0	0
17	72740769	rs58713971	T	G	5	2	7	0	0	7	0	0
17	72742484	rs7212178	G	C	228	279	507	0	2	509	0	0
17	72761242	rs16978176	T	C	17	43	60	0	0	60	0	0
17	72762646	rs8064299	C	A	10	16	26	0	0	26	0	0
17	72762901	rs4788849	A	T	20	18	38	0	1	39	0	0
17	72763798	rs745318	C	T	32	33	65	0	0	65	0	0
17	72765215	rs7420	C	T	405	713	1118	0	6	1124	0	0
17	72766993	rs12797	G	A	91	45	136	0	1	137	0	0
17	72767435	rs880827	T	C	93	75	168	0	0	168	0	0
17	72767565	rs3744208	A	G	69	56	125	0	0	125	0	0
17	72768970	rs2305214	G	A	5	4	9	0	0	9	0	0
17	72769334	rs878906	T	C	4	3	7	0	0	7	0	0
17	72769411	rs878905	G	A	5	5	10	0	0	10	0	0
17	72769694	rs878907	A	G	5	5	10	0	1	11	0	0
17	72772698	rs4789096	G	C	36	20	56	0	1	57	0	0
17	72773794	rs9910691	C	A	8	3	11	0	0	11	0	0
17	72774013	rs12950946	G	A	11	1	12	0	0	12	0	0
17	72774128	rs12452204	T	C	20	9	29	0	0	29	0	0
17	72774175	rs10512602	G	A	23	7	30	0	0	30	0	0
17	72774558	rs7223232	G	A	19	21	40	0	0	40	0	0
17	72774677	rs12937498	C	G	17	9	26	0	0	26	0	0
17	72774738	rs1879455	C	G	14	5	19	0	0	19	0	0
17	72775099	rs3785539	A	G	9	2	11	0	0	11	0	0
17	72775340	rs6501735	C	G	14	19	33	0	1	34	0	0
17	72775358	rs6501736	G	A	17	19	36	0	1	37	0	0
17	72775911	rs2053748	A	G	19	18	37	0	1	38	0	0
17	72780491	rs10775365	G	A	22	9	31	0	1	32	0	0
17	72780830	rs6501737	T	C	4	6	10	0	0	10	0	0
17	72781208	rs4789097	A	G	12	10	22	0	0	22	0	0
17	72781292	rs4789098	C	G	20	13	33	0	0	33	0	0
17	72781812	rs2166703	G	A	27	23	50	0	1	51	0	0
17	72782216	rs12449322	T	C	27	21	48	0	0	48	0	0
17	72782476	rs12449384	T	A	48	16	64	0	2	66	0	0
17	72782501	rs57802405	C	T	45	25	70	0	0	70	0	0
17	72782726	rs9944506	C	G	13	8	21	0	0	21	0	0
17	72783267	rs139307938	C	A	54	35	89	0	0	89	0	0
17	72783385	rs7210318	T	C	40	35	75	0	0	75	0	0
17	72783500	rs7225759	A	G	12	23	35	0	1	36	0	0
17	72783533	rs7225777	A	G	4	19	23	0	0	23	0	0
17	72783798	rs9893035	A	C	17	23	40	0	1	41	0	0
17	72784630	rs2384957	A	G	45	44	89	0	1	90	0	0
17	72784649	rs895690	C	T	55	43	98	0	2	100	0	0
17	72784932	rs2016126	G	A	97	64	161	0	1	162	0	0
17	72786611	rs2290038	G	T	5	2	7	0	0	7	0	0
17	72814576	rs11869620	A	G	4	2	6	0	0	6	0	0
17	72834158	rs60487483	C	G	121	178	299	0	2	301	0	0
17	72860109	.	C	T	5	7	12	0	0	12	0	0
17	73016621	rs1044228	C	T	17	11	28	0	1	29	0	0
17	73061389	rs76245783	T	G	77	78	155	0	1	156	0	0
17	73089706	rs4789134	G	A	7	15	22	0	2	24	0	0
17	73089852	rs4788863	T	C	14	24	38	0	0	38	0	0
17	73095224	rs4538044	G	A	3	3	6	0	0	6	0	0
17	73101204	rs4789140	C	A	27	20	47	0	1	48	0	0
17	73127217	rs3736075	G	C	2	6	8	0	0	8	0	0
17	73127683	rs4788867	T	C	11	12	23	0	0	23	0	0
17	73162124	rs11653062	A	C	17	19	36	0	0	36	0	0
17	73162402	rs189529489	C	T	13	20	33	0	1	34	0	0
17	73163277	rs11077777	G	A	10	14	24	0	0	24	0	0
17	73205976	rs34126097	T	C	14	11	25	0	1	26	0	0
17	73220824	rs149028451	G	T	3	4	7	0	0	7	0	0
17	73222865	rs1478785	G	A	3	3	6	0	0	6	0	0
17	73228144	rs2291030	T	C	2	8	10	0	1	11	0	0
17	73228173	rs2291031	C	T	5	10	15	0	0	15	0	0
17	73230856	rs9988	C	T	39	40	79	0	0	79	0	0
17	73236605	rs11077781	C	A	5	2	7	0	0	7	0	0
17	73257830	rs2279161	C	T	3	8	11	0	0	11	0	0
17	73257986	rs8075276	C	T	11	21	32	0	0	32	0	0
17	73258479	rs6501772	C	T	10	14	24	0	0	24	0	0
17	73260298	rs4788878	A	G	14	14	28	0	0	28	0	0
17	73374357	rs111598470	G	C	6	0	6	0	0	6	0	0
17	73374396	rs4789180	G	T	6	5	11	0	0	11	0	0
17	73391145	rs4788891	A	G	3	3	6	0	0	6	0	0
17	73467897	rs58039730	A	T	23	13	36	0	1	37	0	0
17	73482060	.	G	A	15	14	29	0	0	29	0	0
17	73488794	rs4078259	C	T	45	32	77	0	0	77	0	0
17	73489524	rs72851929	G	T	9	6	15	0	0	15	0	0
17	73489567	rs4078474	C	G	5	9	14	0	0	14	0	0
17	73495692	rs13357	C	G	82	83	165	0	2	167	0	0
17	73498623	rs7502835	A	G	4	2	6	0	0	6	0	0
17	73510030	rs117424037	G	A	5	4	9	0	0	9	0	0
17	73512884	rs8079373	T	G	12	10	22	0	1	23	0	0
17	73513289	rs6501818	C	G	54	48	102	0	0	102	0	0
17	73515237	rs55786842	A	G	4	4	8	0	0	8	0	0
17	73516008	rs59476633	G	A	4	3	7	0	0	7	0	0
17	73518284	rs6501820	G	C	28	36	64	0	1	65	0	0
17	73518563	rs67746118	G	C	10	5	15	0	0	15	0	0
17	73519137	rs62088468	A	C	3	7	10	0	1	11	0	0
17	73552185	rs1671036	G	A	5	9	14	0	0	14	0	0
17	73561809	rs74477521	C	T	2	4	6	0	0	6	0	0
17	73562591	rs75202808	A	G	7	3	10	0	0	10	0	0
17	73563210	rs76242740	C	T	3	7	10	0	0	10	0	0
17	73563413	rs35093418	T	C	5	3	8	0	0	8	0	0
17	73565171	rs1671021	T	C	11	15	26	0	0	26	0	0
17	73570814	rs75864371	G	A	2	5	7	0	0	7	0	0
17	73570842	rs35199943	T	C	1	7	8	0	0	8	0	0
17	73570888	rs77828821	G	T	1	5	6	0	0	6	0	0
17	73571030	rs1042861	A	G	23	26	49	0	0	49	0	0
17	73571155	rs75515900	T	C	20	18	38	0	0	38	0	0
17	73584665	rs62089219	C	G	2	21	23	0	1	24	0	0
17	73584669	rs62089220	C	A	2	22	24	0	1	25	0	0
17	73584825	rs62089221	C	T	10	24	34	0	0	34	0	0
17	73585678	rs62089222	T	C	4	15	19	0	0	19	0	0
17	73585686	rs62089223	T	C	4	19	23	0	0	23	0	0
17	73585980	rs62089224	C	G	3	9	12	0	0	12	0	0
17	73585996	rs80017587	T	C	5	8	13	0	0	13	0	0
17	73585997	rs79599625	C	A	5	8	13	0	0	13	0	0
17	73586028	rs72854924	T	C	6	10	16	0	0	16	0	0
17	73586045	rs80175090	G	A	6	14	20	0	0	20	0	0
17	73586233	rs62089225	C	G	6	29	35	0	0	35	0	0
17	73586327	rs62089226	T	G	11	2	13	0	0	13	0	0
17	73586524	rs4789218	C	G	12	5	17	0	1	18	0	0
17	73586560	rs4789219	G	C	11	9	20	0	0	20	0	0
17	73586764	rs4788901	T	C	7	45	52	0	0	52	0	0
17	73590830	rs820256	T	G	47	15	62	0	1	63	0	0
17	73602081	rs8068464	G	A	39	12	51	0	0	51	0	0
17	73603017	rs11653724	G	A	35	5	40	0	0	40	0	0
17	73603086	rs1670993	T	C	9	4	13	0	0	13	0	0
17	73606310	rs11657863	G	A	51	18	69	0	0	69	0	0
17	73609112	rs820142	G	A	61	17	78	0	1	79	0	0
17	73609516	rs113730899	C	T	10	31	41	0	0	41	0	0
17	73611823	rs820144	T	C	95	13	108	0	1	109	0	0
17	73613975	rs820145	G	A	184	40	224	0	2	227	1	0
17	73615644	rs820147	C	T	33	4	37	0	0	37	0	0
17	73615887	rs820148	A	G	8	0	8	0	0	8	0	0
17	73615933	rs820149	T	C	8	0	8	0	0	8	0	0
17	73615962	rs820150	T	C	177	43	220	0	2	222	0	0
17	73615983	rs820151	G	A	186	35	221	0	4	225	0	0
17	73616088	rs820152	T	C	231	46	277	0	0	277	0	0
17	73616446	rs820154	A	T	22	7	29	0	1	30	0	0
17	73616853	rs10808	G	C	133	37	170	0	0	170	0	0
17	73616864	rs11470	C	A	135	33	168	0	0	168	0	0
17	73616920	rs10814	A	G	95	18	113	0	1	114	0	0
17	73619920	rs820186	G	A	104	17	121	0	0	121	0	0
17	73625286	rs820190	G	A	5	2	7	0	0	7	0	0
17	73625430	rs4788902	G	A	4	9	13	0	0	13	0	0
17	73663077	rs79225822	T	C	5	6	11	0	0	11	0	0
17	73687495	rs820218	G	A	36	43	79	0	0	79	0	0
17	73688294	rs820217	G	A	11	11	22	0	0	22	0	0
17	73696596	rs77813398	C	T	8	11	19	0	0	19	0	0
17	73697391	rs820233	C	T	12	11	23	0	1	24	0	0
17	73697627	rs11652623	G	C	19	15	34	0	1	35	0	0
17	73702135	rs56144802	G	A	372	368	740	0	3	743	0	0
17	73702253	rs2305529	G	A	6	7	13	0	0	13	0	0
17	73753503	rs871443	T	C	7	5	12	0	0	12	0	0
17	73772856	rs7342	G	C	808	598	1406	0	9	1415	0	0
17	73773000	rs1060120	C	T	605	612	1217	0	10	1227	0	0
17	73773106	rs10338	G	A	666	558	1224	0	6	1230	0	0
17	73774877	rs9895763	G	A	240	409	649	0	4	653	0	0
17	73782191	rs2125345	T	C	1	5	6	0	0	6	0	0
17	73790093	rs1047743	C	G	32	36	68	0	2	70	0	0
17	73803913	rs55869641	G	A	4	2	6	0	1	7	0	0
17	73816844	rs878371	G	A	1	5	6	0	0	6	0	0
17	73819525	rs8078208	C	T	18	21	39	0	0	39	0	0
17	73823720	rs9916685	G	A	316	280	596	0	3	599	0	0
17	73824121	rs7210574	T	C	228	169	397	0	7	404	0	0
17	73826120	rs35628234	C	T	281	254	535	0	4	539	0	0
17	73827205	rs1135688	T	C	323	294	617	0	10	627	0	0
17	73827911	rs7208575	A	G	14	41	55	0	1	56	0	0
17	73828174	rs11077797	G	T	8	20	28	0	1	29	0	0
17	73831900	rs3744026	T	C	6	2	8	0	0	8	0	0
17	73876673	.	G	A	4	2	6	0	0	6	0	0
17	73915853	rs61741708	C	T	5	2	7	0	1	8	0	0
17	74037950	.	T	A	4	11	15	0	0	15	0	0
17	74042637	rs12325726	C	T	5	1	6	0	0	6	0	0
17	74046684	rs148891102	G	A	6	3	9	0	0	9	0	0
17	74047208	rs142543980	G	A	4	3	7	0	1	8	0	0
17	74085029	.	G	C	2	6	8	0	0	8	0	0
17	74085326	.	C	G	113	114	227	0	3	230	0	0
17	74381555	rs2247856	G	A	4	10	14	0	0	14	0	0
17	74383475	rs3744037	T	C	33	24	57	0	0	57	0	0
17	74387284	rs3803739	C	T	32	25	57	0	0	57	0	0
17	74413885	rs7207108	A	G	8	19	27	0	0	27	0	0
17	74467017	rs8150	G	C	27	31	58	0	1	60	1	0
17	74477691	rs11870168	C	T	4	3	7	0	0	7	0	0
17	74478973	rs7209575	T	C	4	2	6	0	0	6	0	0
17	74478992	rs7223138	G	C	4	2	6	0	0	6	0	0
17	74479814	rs885140	C	T	4	4	8	0	0	8	0	0
17	74479889	rs8067774	A	G	2	5	7	0	0	7	0	0
17	74480715	rs4789302	T	C	5	4	9	0	0	9	0	0
17	74481803	rs9911568	G	A	2	6	8	0	0	8	0	0
17	74482057	rs9892550	A	G	6	3	9	0	0	9	0	0
17	74484547	rs12450964	A	G	7	4	11	0	0	11	0	0
17	74484578	rs12453241	C	T	10	0	10	0	0	10	0	0
17	74484676	rs35833474	G	A	5	2	7	0	0	7	0	0
17	74484687	rs35787914	C	A	5	2	7	0	0	7	0	0
17	74485156	rs59485060	C	T	13	3	16	0	0	16	0	0
17	74485162	rs57351189	C	T	9	6	15	0	0	15	0	0
17	74485208	rs60764842	G	A	6	4	10	0	0	10	0	0
17	74485304	rs61088918	T	G	3	3	6	0	0	6	0	0
17	74485809	rs36002835	C	T	9	5	14	0	0	14	0	0
17	74486343	rs7207683	G	A	8	11	19	0	0	19	0	0
17	74487002	rs9902916	C	G	6	3	9	0	0	9	0	0
17	74487129	rs4395101	G	T	1	6	7	0	1	8	0	0
17	74487666	rs59467367	T	C	4	5	9	0	0	9	0	0
17	74487735	rs4788926	T	C	3	4	7	0	0	7	0	0
17	74488518	rs77254335	A	G	4	9	13	0	1	14	0	0
17	74492229	rs1992666	C	T	5	6	11	0	0	11	0	0
17	74493737	rs56367703	C	A	4	4	8	0	0	8	0	0
17	74493752	rs56339449	T	C	2	4	6	0	0	6	0	0
17	74494492	rs62086562	A	G	7	4	11	0	0	11	0	0
17	74554739	rs4648343	C	G	2	9	11	0	0	11	0	0
17	74555106	rs4647885	T	C	93	175	268	0	0	268	0	0
17	74557777	rs137955606	C	T	13	17	30	0	0	30	0	0
17	74557976	rs3744050	G	A	13	15	28	0	0	28	0	0
17	74558010	rs3744051	T	A	10	13	23	0	0	23	0	0
17	74558640	rs6501907	T	G	6	3	9	0	0	9	0	0
17	74558806	rs4647887	A	G	13	16	29	0	0	29	0	0
17	74559287	.	T	C	223	283	506	0	3	509	0	0
17	74560487	rs12944474	G	A	165	215	380	0	7	387	0	0
17	74560560	rs1132648	C	T	214	353	567	0	4	571	0	0
17	74560569	rs3180348	G	A	221	361	582	0	5	587	0	0
17	74560888	rs9399	C	A	234	275	509	0	5	514	0	0
17	74560953	rs11181	G	A	213	293	506	0	0	506	0	0
17	74561213	rs7352	A	G	377	259	636	0	7	643	0	0
17	74561266	rs12434	C	T	228	314	542	0	61	603	0	0
17	74561300	rs13022	T	C	191	327	518	0	9	527	0	0
17	74720153	rs150373659	G	A	22	9	31	0	0	31	0	0
17	74732531	.	G	A	258	274	532	0	0	532	0	0
17	75085015	rs8082404	G	A	48	19	67	0	0	67	0	0
17	75085035	rs482929	G	A	5	1	6	0	0	6	0	0
17	75087863	rs55633074	A	G	9	1	10	0	0	10	0	0
17	75095164	rs2292853	G	A	4	6	10	0	0	10	0	0
17	75137642	rs3785445	C	T	9	2	11	0	0	11	0	0
17	75137882	rs34047282	G	A	11	5	16	0	1	17	0	0
17	75144393	rs58069837	A	G	12	8	20	0	0	20	0	0
17	75144835	rs62078297	C	T	8	14	22	0	0	22	0	0
17	75146909	rs55994155	C	G	8	11	19	0	1	20	0	0
17	75148741	rs10163481	G	A	9	23	32	0	0	32	0	0
17	75192153	rs12944803	A	G	9	2	11	0	0	11	0	0
17	75192164	rs9675109	C	T	9	2	11	0	0	11	0	0
17	75192898	rs3785447	T	C	4	6	10	0	0	10	0	0
17	75193963	rs62078338	C	T	4	4	8	0	0	8	0	0
17	75194503	rs4789418	G	C	1	5	6	0	0	6	0	0
17	75194696	rs9896985	G	A	6	2	8	0	0	8	0	0
17	75197632	rs62078339	A	G	7	11	18	0	0	18	0	0
17	75198940	rs9892908	G	T	9	2	11	0	0	11	0	0
17	75199580	rs12602668	A	G	44	37	81	0	0	81	0	0
17	75200605	.	T	C	29	7	36	0	2	38	0	0
17	75203092	rs7226135	C	T	11	5	16	0	0	16	0	0
17	75204887	rs8078674	T	C	7	7	14	0	1	15	0	0
17	75206179	rs11650585	C	T	6	12	18	0	0	18	0	0
17	75207545	rs77291632	G	A	29	31	60	0	0	60	0	0
17	75207586	rs77932036	T	G	26	30	56	0	0	56	0	0
17	75207853	rs78493457	A	C	21	27	48	0	0	48	0	0
17	75208580	rs35528126	C	T	39	28	67	0	1	68	0	0
17	75208601	rs35300000	G	A	30	22	52	0	1	53	0	0
17	75208638	rs9912398	G	A	36	31	67	0	1	68	0	0
17	75208766	rs1983158	C	T	54	41	95	0	1	96	0	0
17	75210574	rs3744063	A	C	158	165	323	0	7	330	0	0
17	75211608	rs12942219	G	A	179	166	345	0	39	385	1	0
17	75211868	rs62078341	T	C	38	1	39	0	10	50	1	0
17	75211907	rs71384149	T	C	33	4	37	0	6	43	0	0
17	75211935	rs71384150	A	C	72	2	74	0	15	89	0	0
17	75369578	rs7217986	T	C	15	19	34	0	1	35	0	0
17	75399552	rs747147	A	G	4	6	10	0	0	10	0	0
17	75447586	rs11650934	C	G	29	18	47	0	0	47	0	0
17	75489216	rs312797	C	T	9	9	18	0	0	18	0	0
17	75489244	rs167498	A	G	9	3	12	0	0	12	0	0
17	75489542	rs312798	C	A	7	7	14	0	0	14	0	0
17	75489548	rs220035	A	G	7	7	14	0	0	14	0	0
17	75489643	rs312799	G	C	4	10	14	0	0	14	0	0
17	75489940	rs312800	T	C	5	3	8	0	0	8	0	0
17	75491256	rs12943240	A	G	8	4	12	0	0	12	0	0
17	75491872	rs2574852	A	G	6	6	12	0	0	12	0	0
17	75492041	rs61382841	A	G	7	4	11	0	1	12	0	0
17	75492547	rs62077404	C	T	10	9	19	0	0	19	0	0
17	75492693	rs9901430	G	A	8	4	12	0	0	12	0	0
17	75492785	rs11652286	A	G	8	8	16	0	1	17	0	0
17	75494705	rs2627223	A	G	337	319	656	0	4	660	0	0
17	75494746	rs1059485	A	G	182	158	340	0	26	367	1	0
17	75495397	rs9038	T	C	341	316	657	0	4	661	0	0
17	75495695	rs116655270	C	T	518	519	1037	0	1	1039	1	0
17	75496460	rs445507	T	C	42	42	84	0	12	99	3	0
17	76103684	rs1048591	G	C	8	6	14	0	0	14	0	0
17	76106308	rs67686854	C	T	13	9	22	0	0	22	0	0
17	76107393	rs16970842	A	G	7	10	17	0	0	17	0	0
17	76111203	rs7218589	C	G	5	1	6	0	0	6	0	0
17	76112253	rs77304758	T	C	2	4	6	0	0	6	0	0
17	76113954	rs2613516	G	A	53	52	105	0	1	106	0	0
17	76117517	rs4789014	G	A	4	6	10	0	0	10	0	0
17	76117570	rs2613520	G	C	6	7	13	0	0	13	0	0
17	76119930	rs55677349	T	C	3	4	7	0	0	7	0	0
17	76129636	rs417780	T	C	5	2	7	0	0	7	0	0
17	76130575	rs7208422	A	T	153	201	354	0	4	358	0	0
17	76131070	rs12452890	G	A	167	240	407	0	5	412	0	0
17	76132141	rs11658379	G	C	2	4	6	0	0	6	0	0
17	76132826	rs8067323	A	G	8	3	11	0	0	11	0	0
17	76133693	rs55694641	C	T	10	2	12	0	0	12	0	0
17	76133746	rs12449680	A	G	9	2	11	0	0	11	0	0
17	76134828	rs7221365	C	A	20	16	36	0	1	37	0	0
17	76135412	rs17773854	G	T	31	22	53	0	0	53	0	0
17	76137337	rs454138	C	G	107	128	235	0	2	237	0	0
17	76137477	rs2871647	T	G	67	62	129	0	1	130	0	0
17	76138178	rs192379033	A	C	116	94	210	0	7	217	0	0
17	76138577	rs4789015	A	G	211	170	381	0	11	393	1	0
17	76165548	rs3794742	G	A	12	15	27	0	1	28	0	0
17	76165863	rs3829575	C	T	26	24	50	0	1	51	0	0
17	76166196	rs870355	A	G	23	18	41	0	0	41	0	0
17	76166491	rs1810063	G	A	26	18	44	0	0	44	0	0
17	76166689	rs4583318	C	A	30	31	61	0	0	61	0	0
17	76167047	rs1062668	C	T	400	591	991	0	5	996	0	0
17	76168219	rs10358	C	T	652	487	1139	0	4	1143	0	0
17	76168422	rs560098818	A	G	478	478	956	0	12	968	0	0
17	76168971	rs9897765	G	A	7	3	10	0	0	10	0	0
17	76170735	rs1065769	C	T	47	38	85	0	0	85	0	0
17	76178748	rs1143697	T	C	44	34	78	0	1	79	0	0
17	76183043	rs1071664	A	G	38	45	83	0	0	83	0	0
17	76354380	rs2280148	T	G	459	913	1372	0	5	1377	0	0
17	76415330	rs73380018	G	A	3	5	8	0	0	8	0	0
17	76670233	rs6728	C	G	26	24	50	0	1	51	0	0
17	76670749	rs1126615	A	G	176	208	384	0	3	387	0	0
17	76670811	rs9894449	A	C	213	202	415	0	1	416	0	0
17	76671997	rs71385973	A	G	182	150	332	0	0	332	0	0
17	76672322	rs12943069	A	T	124	109	233	0	0	233	0	0
17	76672700	rs11658223	T	A	91	69	160	0	0	160	0	0
17	76674023	rs113667813	G	A	99	84	183	0	1	184	0	0
17	76674257	rs3936118	T	C	84	67	151	0	1	152	0	0
17	76675661	rs11657360	G	C	88	81	169	0	2	171	0	0
17	76675803	rs11657403	G	A	93	89	182	0	0	182	0	0
17	76677382	rs62075562	T	C	6	8	14	0	0	14	0	0
17	76677481	rs7215260	A	G	8	9	17	0	0	17	0	0
17	76677744	rs11650504	C	T	3	7	10	0	1	11	0	0
17	76677761	rs11650480	A	G	2	8	10	0	0	10	0	0
17	76678940	rs9895721	T	C	4	3	7	0	0	7	0	0
17	76680086	rs11656626	A	G	5	3	8	0	0	8	0	0
17	76680258	.	C	T	4	3	7	0	0	7	0	0
17	76680260	rs11656741	C	G	3	4	7	0	0	7	0	0
17	76680261	rs11656742	C	T	3	4	7	0	0	7	0	0
17	76681826	rs9911523	C	T	6	6	12	0	0	12	0	0
17	76683515	rs62075563	C	T	14	7	21	0	0	21	0	0
17	76684970	rs7225707	G	A	4	8	12	0	0	12	0	0
17	76685106	rs7225601	A	G	8	6	14	0	1	15	0	0
17	76691258	rs12449669	T	C	10	8	18	0	0	18	0	0
17	76691564	rs55779573	T	C	9	11	20	0	0	20	0	0
17	76691840	rs7215100	A	G	10	8	18	0	0	18	0	0
17	76692298	rs922838	G	C	26	21	47	0	0	47	0	0
17	76693551	rs10512617	C	G	8	11	19	0	0	19	0	0
17	76693697	rs59428334	A	G	12	4	16	0	2	18	0	0
17	76693711	rs11077394	A	G	10	7	17	0	1	18	0	0
17	76698950	rs62075567	C	A	8	6	14	0	0	14	0	0
17	76700063	rs7220955	G	A	9	4	13	0	0	13	0	0
17	76704065	rs111585196	G	A	3	3	6	0	0	6	0	0
17	76737118	rs17736589	A	G	2	5	7	0	1	8	0	0
17	76737847	rs9903760	T	C	1	5	6	0	0	6	0	0
17	76738386	rs9903134	A	G	2	5	7	0	1	8	0	0
17	76783642	rs6501249	A	G	67	128	195	0	2	197	0	0
17	76784198	rs2889479	T	C	4	6	10	0	1	11	0	0
17	76787000	rs8072569	G	A	8	9	17	0	1	18	0	0
17	76787885	rs62075586	T	C	4	12	16	0	0	16	0	0
17	76789886	rs62075587	C	T	3	5	8	0	0	8	0	0
17	76789991	rs8182269	A	T	3	8	11	0	0	11	0	0
17	76790279	rs8073626	C	T	2	8	10	0	1	11	0	0
17	76791217	rs867596	G	A	4	6	10	0	0	10	0	0
17	76792179	rs1044486	G	A	531	283	814	0	6	820	0	0
17	76793600	rs3744802	G	A	318	141	459	0	2	461	0	0
17	76793728	rs3744801	G	A	292	145	437	0	1	438	0	0
17	76793825	rs3744800	G	A	356	191	547	0	8	555	0	0
17	76793885	rs3826552	G	A	304	164	468	0	0	468	0	0
17	76794774	rs3744799	T	C	85	52	137	0	0	137	0	0
17	76794981	rs2279308	A	G	99	72	171	0	1	172	0	0
17	76796463	rs11077397	C	T	48	24	72	0	0	72	0	0
17	76796854	rs8079153	T	C	40	31	71	0	1	72	0	0
17	76798155	rs2306527	C	T	3	4	7	0	0	7	0	0
17	76799795	rs1057040	G	A	156	78	234	0	1	235	0	0
17	76799860	rs3088040	T	C	157	74	231	0	2	236	3	0
17	76799898	rs9302885	A	G	175	82	257	0	0	257	0	0
17	76800182	rs11649964	G	C	23	12	35	0	1	36	0	0
17	76802648	rs4796817	T	C	4	8	12	0	0	12	0	0
17	76803956	rs7211645	C	T	2	6	8	0	0	8	0	0
17	76804547	rs4796800	A	G	4	5	9	0	0	9	0	0
17	76805399	rs58951893	A	G	3	3	6	0	0	6	0	0
17	76810284	rs1110274	C	A	15	18	33	0	0	33	0	0
17	76812840	rs2376828	T	C	5	4	9	0	0	9	0	0
17	76813125	rs2376829	C	T	8	1	9	0	0	9	0	0
17	76814400	rs62075626	A	G	8	6	14	0	0	14	0	0
17	76814782	rs35273233	G	A	255	186	441	0	5	446	0	0
17	76817090	rs3744793	C	T	127	186	313	0	5	318	0	0
17	76822131	rs1531798	A	G	34	31	65	0	0	65	0	0
17	76822168	rs1531797	T	C	35	29	64	0	1	65	0	0
17	76831800	rs7213204	T	C	6	2	8	0	0	8	0	0
17	76832133	rs900349	T	C	27	5	32	0	0	32	0	0
17	76833916	rs4352096	T	C	4	3	7	0	1	8	0	0
17	76867017	rs2277698	C	T	180	181	361	0	0	361	0	0
17	76870106	rs55955357	C	G	3	3	6	0	0	6	0	0
17	76870693	rs2009186	G	T	4	2	6	0	0	6	0	0
17	77084274	rs10073	C	T	32	26	58	0	0	58	0	0
17	77758484	rs3751956	G	A	3	5	8	0	0	8	0	0
17	77906576	rs15776	A	G	2	4	6	0	0	6	0	0
17	77906736	rs12453969	G	A	6	3	9	0	0	9	0	0
17	77906799	rs71387956	C	T	2	5	7	0	0	7	0	0
17	77906892	rs4243247	A	G	10	1	11	0	0	11	0	0
17	77907009	rs4476208	T	C	4	4	8	0	0	8	0	0
17	77907128	rs71387957	C	G	5	3	8	0	0	8	0	0
17	77907477	rs71387958	T	C	2	7	9	0	0	9	0	0
17	77907491	rs71387959	T	C	2	9	11	0	0	11	0	0
17	77907843	rs71389720	G	A	4	5	9	0	0	9	0	0
17	77908321	rs12450069	G	A	4	4	8	0	0	8	0	0
17	77908532	rs72847429	C	T	8	4	12	0	1	13	0	0
17	77909438	rs3169601	T	C	8	1	9	0	0	9	0	0
17	77909626	rs3743	G	A	4	9	13	0	0	13	0	0
17	77910046	rs3169598	G	A	4	9	13	0	0	13	0	0
17	77910156	rs9799	C	T	8	14	22	0	0	22	0	0
17	77910295	rs1131935	T	C	8	8	16	0	0	16	0	0
17	77910297	rs3206576	A	G	8	7	15	0	0	15	0	0
17	77910313	rs3206575	T	C	9	14	23	0	0	23	0	0
17	77910740	rs56014161	C	T	6	6	12	0	0	12	0	0
17	77910932	rs894871	A	G	1	5	6	0	0	6	0	0
17	77910974	rs894872	T	G	3	9	12	0	0	12	0	0
17	77911717	rs935201	A	G	2	9	11	0	0	11	0	0
17	77912011	rs1047623	C	G	54	21	75	0	0	75	0	0
17	77912761	rs1124736	C	A	44	17	61	0	1	62	0	0
17	77913812	rs71389722	C	T	31	7	38	0	0	38	0	0
17	77914112	rs3751947	G	A	66	25	91	0	1	92	0	0
17	77914561	rs2241950	C	T	1	8	9	0	0	9	0	0
17	77916273	rs72847461	G	A	4	9	13	0	0	13	0	0
17	77987144	rs140228131	A	C	9	8	17	0	0	17	0	0
17	77987239	rs34603877	C	T	15	12	27	0	0	27	0	0
17	78079643	rs1800301	C	T	5	25	30	0	0	30	0	0
17	78081661	rs1800303	A	T	35	14	49	0	0	49	0	0
17	78083791	rs1800305	C	T	27	6	33	0	0	33	0	0
17	78087109	rs1800310	A	G	7	46	53	0	2	55	0	0
17	78093221	rs2229221	G	A	57	19	76	0	0	76	0	0
17	78093353	rs8132	C	T	15	59	74	0	2	76	0	0
17	78110345	rs117136018	G	A	10	7	17	0	0	17	0	0
17	78110507	rs72850881	G	A	6	8	14	0	0	14	0	0
17	78110917	rs77319086	C	A	10	14	24	0	0	24	0	0
17	78111877	rs2361710	T	C	8	1	9	0	0	9	0	0
17	78112610	rs4243251	T	A	4	2	6	0	0	6	0	0
17	78114033	rs74003638	G	A	2	9	11	0	0	11	0	0
17	78114224	rs59274369	C	T	3	4	7	0	0	7	0	0
17	78114653	rs4889831	C	T	3	3	6	0	0	6	0	0
17	78115484	rs935117	A	C	10	8	18	0	0	18	0	0
17	78184679	rs9894254	C	T	17	25	42	0	0	42	0	0
17	78210776	rs3924207	C	T	9	0	9	0	0	9	0	0
17	78221887	rs113361368	C	T	5	1	6	0	0	6	0	0
17	78222064	rs11871932	T	G	2	5	7	0	0	7	0	0
17	78222661	rs9904116	C	T	1	5	6	0	0	6	0	0
17	78223103	rs8064518	C	A	3	10	13	0	0	13	0	0
17	78223170	rs9895606	T	C	5	3	8	0	0	8	0	0
17	78275440	rs72849849	A	G	4	3	7	0	0	7	0	0
17	78291701	rs12603671	G	A	5	1	6	0	0	6	0	0
17	78355176	rs7224239	A	G	7	2	9	0	0	9	0	0
17	78392061	rs78496039	T	C	2	4	6	0	0	6	0	0
17	78756492	rs12325875	C	T	8	3	11	0	0	11	0	0
17	78786586	rs72853745	C	T	2	4	6	0	0	6	0	0
17	78854223	rs2289759	A	G	86	50	136	0	2	138	0	0
17	78854316	rs2289760	C	T	6	5	11	0	0	11	0	0
17	78893671	rs7215994	A	G	3	3	6	0	0	6	0	0
17	78894022	rs12938300	G	C	5	1	6	0	0	6	0	0
17	78895735	rs11653064	A	G	3	5	8	0	0	8	0	0
17	78895788	rs11657655	C	T	2	4	6	0	0	6	0	0
17	78895889	rs9908270	C	A	1	5	6	0	0	6	0	0
17	78896529	rs2271603	C	T	55	43	98	0	0	98	0	0
17	78897547	rs7217786	C	T	16	33	49	0	0	49	0	0
17	78897732	rs72859694	C	T	51	24	75	0	2	77	0	0
17	78897733	rs72859699	T	A	50	24	74	0	3	77	0	0
17	78900598	rs4969227	C	T	24	29	53	0	0	53	0	0
17	78900811	rs4969228	A	G	17	33	50	0	0	50	0	0
17	78901443	rs36171362	T	G	72	22	94	0	2	96	0	0
17	78901669	rs56072626	G	A	41	85	126	0	1	127	0	0
17	78904680	rs9899051	A	G	3	4	7	0	0	7	0	0
17	78906360	rs4969311	C	G	7	7	14	0	0	14	0	0
17	78906976	rs2090203	A	G	10	8	18	0	0	18	0	0
17	78907809	rs35071447	C	A	9	5	14	0	0	14	0	0
17	78908258	rs73357804	G	A	13	13	26	0	0	26	0	0
17	78908322	rs62068529	C	T	13	10	23	0	0	23	0	0
17	78909803	rs117176153	A	G	8	9	17	0	1	18	0	0
17	78910439	rs12602601	G	T	5	15	20	0	0	20	0	0
17	78910440	rs12602731	C	T	5	15	20	0	0	20	0	0
17	78910499	rs35635776	C	A	18	9	27	0	0	27	0	0
17	78910748	rs2333885	T	C	27	16	43	0	0	43	0	0
17	78911041	rs1877926	C	T	12	7	19	0	1	20	0	0
17	78912010	rs7210742	A	G	7	8	15	0	0	15	0	0
17	78912271	rs9911223	G	A	6	2	8	0	0	8	0	0
17	78912354	rs7219318	T	C	4	9	13	0	0	13	0	0
17	78912633	rs6565497	A	T	4	3	7	0	0	7	0	0
17	78919558	rs1567962	C	T	85	51	136	0	1	137	0	0
17	78921117	rs4969231	C	T	54	76	130	0	0	130	0	0
17	78935197	rs9899178	C	T	74	62	136	0	0	136	0	0
17	78938204	rs3751936	G	C	58	54	112	0	1	113	0	0
17	78938498	rs3751934	C	A	85	58	143	0	1	144	0	0
17	78939414	rs3751932	C	T	130	85	215	0	1	216	0	0
17	78939857	rs1062935	T	C	69	31	100	0	2	102	0	0
17	78939964	rs1045626	C	T	27	9	36	0	0	36	0	0
17	78940347	rs7221717	G	A	5	1	6	0	0	6	0	0
17	78967019	rs4969332	T	C	3	3	6	0	0	6	0	0
17	78967259	rs6565517	G	T	4	2	6	0	0	6	0	0
17	78967289	rs6565518	A	G	4	2	6	0	2	8	0	0
17	78972421	rs11653865	A	G	9	3	12	0	0	12	0	0
17	78972485	rs11655877	T	C	16	6	22	0	0	22	0	0
17	78972669	rs11650034	C	T	10	5	15	0	1	16	0	0
17	78972864	rs11870458	T	C	8	5	13	0	1	14	0	0
17	78973474	rs1128687	T	C	132	119	251	0	1	252	0	0
17	78973768	rs13507	T	C	71	76	147	0	0	147	0	0
17	78973901	rs1128705	C	G	10	8	18	0	0	18	0	0
17	78975480	rs9915041	A	G	4	2	6	0	0	6	0	0
17	79003257	rs187165098	G	A	6	8	14	0	0	14	0	0
17	79003661	rs59124503	A	T	1	10	11	0	0	11	0	0
17	79004271	rs12449867	T	C	11	4	15	0	0	15	0	0
17	79004616	rs12452150	C	T	2	5	7	0	1	8	0	0
17	79004781	rs12452029	G	A	3	3	6	0	0	6	0	0
17	79005292	rs55762738	G	A	9	11	20	0	0	20	0	0
17	79006850	rs11870986	T	C	7	4	11	0	0	11	0	0
17	79007075	rs11150764	C	A	6	6	12	0	0	12	0	0
17	79084072	rs4072588	T	G	6	4	10	0	0	10	0	0
17	79089590	rs4969391	A	G	19	15	34	0	0	34	0	0
17	79163649	rs2292182	G	A	9	1	10	0	0	10	0	0
17	79170576	rs1542961	C	T	7	17	24	0	0	24	0	0
17	79182770	.	T	C	13	10	23	0	0	23	0	0
17	79182778	rs62075318	T	C	12	10	22	0	0	22	0	0
17	79202329	rs1048775	G	C	123	100	223	0	6	229	0	0
17	79202956	rs2048057	T	C	76	62	138	0	0	138	0	0
17	79204661	rs12937612	C	G	4	4	8	0	0	8	0	0
17	79205736	rs11655759	G	A	85	58	143	0	1	144	0	0
17	79206789	rs11150777	G	A	6	5	11	0	0	11	0	0
17	79207061	rs2292183	C	T	7	7	14	0	0	14	0	0
17	79208535	rs11150778	G	A	16	6	22	0	0	22	0	0
17	79208604	rs11652662	G	A	11	8	19	0	0	19	0	0
17	79213562	rs2255166	T	C	6	2	8	0	0	8	0	0
17	79214262	.	G	T	4	4	8	0	0	8	0	0
17	79215019	rs112417848	C	T	58	59	117	0	0	117	0	0
17	79220224	rs2725405	G	C	148	116	264	0	0	264	0	0
17	79221478	.	C	T	2	4	6	0	0	6	0	0
17	79222331	rs6565548	A	G	3	4	7	0	0	7	0	0
17	79222771	rs9900367	T	C	7	1	8	0	1	9	0	0
17	79222834	rs4969423	C	T	4	6	10	0	0	10	0	0
17	79223558	rs11656141	G	A	11	9	20	0	0	20	0	0
17	79223847	rs9902277	A	G	5	5	10	0	0	10	0	0
17	79224127	rs9900526	G	A	5	8	13	0	0	13	0	0
17	79225851	rs9915417	G	A	13	8	21	0	1	22	0	0
17	79234503	rs9915999	G	A	3	3	6	0	0	6	0	0
17	79238003	rs9899287	G	T	2	5	7	0	0	7	0	0
17	79244802	rs2292184	T	C	127	134	261	0	9	270	0	0
17	79285137	rs9910348	A	G	4	8	12	0	0	12	0	0
17	79285448	rs9911063	A	G	2	12	14	0	1	15	0	0
17	79285991	rs6565550	T	C	0	19	19	0	0	19	0	0
17	79287063	rs8076437	A	G	3	8	11	0	0	11	0	0
17	79287079	rs8075897	C	T	3	8	11	0	0	11	0	0
17	79301204	rs11871629	G	A	2	6	8	0	0	8	0	0
17	79301539	rs35502511	G	A	6	1	7	0	0	7	0	0
17	79301565	rs34568054	G	A	6	1	7	0	0	7	0	0
17	79362222	rs1811556	G	A	4	3	7	0	1	8	0	0
17	79363728	rs3744146	C	T	5	3	8	0	0	8	0	0
17	79373115	rs148091224	C	T	10	22	32	0	0	32	0	0
17	79377586	rs3816662	C	T	6	8	14	0	0	14	0	0
17	79377747	rs150492264	C	T	3	4	7	0	0	7	0	0
17	79409189	rs12952981	G	A	13	18	31	0	0	31	0	0
17	79409434	rs12939225	A	G	18	13	31	0	0	31	0	0
17	79409710	rs12943867	G	A	42	40	82	0	0	82	0	0
17	79411662	rs11655860	G	A	7	12	19	0	0	19	0	0
17	79414897	rs11650750	C	A	12	13	25	0	1	26	0	0
17	79415766	rs9901265	G	A	4	4	8	0	0	8	0	0
17	79415884	.	G	A	3	4	7	0	0	7	0	0
17	79415973	rs9903387	C	G	5	5	10	0	0	10	0	0
17	79416656	rs1478608	T	C	6	5	11	0	0	11	0	0
17	79417400	rs899286	G	A	10	8	18	0	1	19	0	0
17	79418599	rs28576195	C	T	4	11	15	0	0	15	0	0
17	79418770	rs61746096	C	T	59	60	119	0	1	120	0	0
17	79419025	rs35572189	G	A	36	56	92	0	2	94	0	0
17	79419797	rs141666839	G	A	67	74	141	0	5	146	0	0
17	79424537	rs34224936	C	T	87	108	195	0	4	199	0	0
17	79427794	rs3744147	C	G	4	3	7	0	0	7	0	0
17	79429358	rs9902119	T	C	29	20	49	0	0	49	0	0
17	79429575	rs77093479	C	G	37	29	66	0	0	66	0	0
17	79429711	rs3736072	C	T	49	31	80	0	0	80	0	0
17	79429852	rs8746	C	T	158	167	325	0	2	327	0	0
17	79431843	rs12952209	G	A	188	221	409	0	2	411	0	0
17	79432202	rs2291018	T	C	186	269	455	0	0	455	0	0
17	79432429	rs2291021	G	A	241	318	559	0	3	562	0	0
17	79432671	rs7406823	T	C	209	222	431	0	2	433	0	0
17	79433106	rs14640	C	T	257	250	507	0	3	510	0	0
17	79478007	rs1135989	G	A	4695	3980	8675	0	20	8695	0	0
17	79478019	rs1139405	G	A	4789	4067	8856	0	21	8877	0	0
17	79478242	rs61997068	C	T	3422	3729	7151	0	29	7180	0	0
17	79479469	rs8064532	A	C	14	28	42	0	1	43	0	0
17	79479808	rs7503278	C	T	568	595	1163	0	2	1165	0	0
17	79514129	rs11552304	G	A	85	59	144	0	0	144	0	0
17	79514832	rs7224579	G	A	9	5	14	0	1	15	0	0
17	79515075	rs6565593	A	G	13	8	21	0	0	21	0	0
17	79515509	rs56737642	A	G	5	7	12	0	0	12	0	0
17	79515636	rs7405588	G	T	10	13	23	0	0	23	0	0
17	79515660	rs7405590	A	G	12	8	20	0	0	20	0	0
17	79524790	rs8068511	T	A	152	156	308	0	11	319	0	0
17	79525118	rs6565596	T	G	137	90	227	0	4	231	0	0
17	79525862	rs3087664	A	G	115	133	248	0	1	249	0	0
17	79527538	rs7502153	T	C	8	5	13	0	0	13	0	0
17	79527649	rs7501521	C	T	8	9	17	0	0	17	0	0
17	79527953	rs12449763	A	T	8	10	18	0	0	18	0	0
17	79529187	rs62073394	C	T	4	4	8	0	0	8	0	0
17	79530967	rs62073395	T	G	11	34	45	0	0	45	0	0
17	79530993	rs8070929	G	T	37	11	48	0	0	48	0	0
17	79531183	rs72855627	G	T	11	6	17	0	0	17	0	0
17	79531572	rs9905026	C	T	2	6	8	0	1	9	0	0
17	79531888	rs9912074	A	G	4	5	9	0	0	9	0	0
17	79532109	rs9911739	C	G	6	2	8	0	1	9	0	0
17	79535171	rs7406704	T	C	3	4	7	0	0	7	0	0
17	79564304	rs62074671	G	T	100	98	198	0	3	201	0	0
17	79589242	rs6565604	G	A	72	55	127	0	2	129	0	0
17	79596811	rs9894429	C	T	39	38	77	0	0	77	0	0
17	79617705	rs13372	G	A	48	1	49	0	0	49	0	0
17	79617830	rs1126818	G	A	48	3	51	0	0	51	0	0
17	79634774	rs61742303	A	T	15	11	26	0	0	26	0	0
17	79634813	rs11546632	T	C	20	7	27	0	0	27	0	0
17	79637367	rs7226091	C	G	18	14	32	0	0	32	0	0
17	79638568	rs34034499	G	C	5	3	8	0	0	8	0	0
17	79638805	rs11150805	C	T	29	19	48	0	1	49	0	0
17	79639198	rs7502870	C	T	5	1	6	0	0	6	0	0
17	79639983	rs59853503	C	T	22	29	51	0	1	52	0	0
17	79640049	rs3088016	A	C	28	40	68	0	1	69	0	0
17	79640219	rs1137360	A	G	26	25	51	0	2	53	0	0
17	79648366	rs1134381	A	G	34	32	66	0	0	66	0	0
17	79648527	rs8076090	A	G	30	20	50	0	3	53	0	0
17	79651490	rs79193599	C	A	4	4	8	0	0	8	0	0
17	79655046	rs11867543	C	T	7	1	8	0	0	8	0	0
17	79655805	.	C	T	83	70	153	0	2	155	0	0
17	79658940	rs62077183	C	A	5	1	6	0	2	8	0	0
17	79659627	rs7214125	G	A	12	3	15	0	0	15	0	0
17	79659847	rs7215738	C	T	8	4	12	0	0	12	0	0
17	79660187	rs7216239	C	T	7	10	17	0	0	17	0	0
17	79663931	rs8070488	T	C	54	54	108	0	0	108	0	0
17	79668226	rs55837949	A	G	8	7	15	0	0	15	0	0
17	79668897	rs7189	C	T	230	178	408	0	3	411	0	0
17	79669313	rs73354139	A	G	12	11	23	0	0	23	0	0
17	79670122	rs8077959	G	A	10	3	13	0	0	13	0	0
17	79670273	rs1132802	T	C	3	11	14	0	0	14	0	0
17	79682051	rs3204270	C	T	3	6	9	0	0	9	0	0
17	79682558	rs2072700	T	C	5	15	20	0	0	20	0	0
17	79687218	rs11150813	G	A	14	11	25	0	1	26	0	0
17	79687687	rs62077221	G	A	15	9	24	0	0	24	0	0
17	79687736	rs62077222	G	T	15	10	25	0	0	25	0	0
17	79687860	rs1129921	G	A	7	11	18	0	1	19	0	0
17	79687893	rs13912	C	T	9	7	16	0	0	16	0	0
17	79802400	.	G	C	19	19	38	0	0	38	0	0
17	79828416	.	G	A	58	71	129	0	0	129	0	0
17	79838239	rs2139883	G	A	4	3	7	0	0	7	0	0
17	79872929	rs35278165	C	T	10	11	21	0	0	21	0	0
17	79878742	rs3744810	G	A	73	65	138	0	1	139	0	0
17	79890613	.	G	A	23	27	50	0	0	50	0	0
17	80007307	rs11653935	A	G	4	5	9	0	0	9	0	0
17	80007324	rs56148859	C	T	5	4	9	0	0	9	0	0
17	80011975	rs34809889	G	A	2	4	6	0	0	6	0	0
17	80012449	rs11077966	G	A	114	128	242	0	2	244	0	0
17	80012769	rs11655185	G	A	8	5	13	0	0	13	0	0
17	80012997	rs35085155	A	G	10	5	15	0	0	15	0	0
17	80019207	rs11542331	G	C	108	90	198	0	0	198	0	0
17	80039481	rs1140616	G	A	55	64	119	0	0	119	0	0
17	80040639	rs17848942	G	A	3	4	7	0	0	7	0	0
17	80042792	rs2228305	C	T	57	41	98	0	1	99	0	0
17	80051183	rs2228309	A	G	38	30	68	0	3	71	0	0
17	80059532	rs142239773	T	G	78	77	155	0	1	156	0	0
17	80085633	rs11077969	A	G	5	8	13	0	0	13	0	0
17	80085703	rs7213172	G	T	5	9	14	0	0	14	0	0
17	80086386	rs7406162	C	T	4	12	16	0	0	16	0	0
17	80086389	rs7406163	C	T	5	12	17	0	0	17	0	0
17	80086395	rs4625783	T	C	4	12	16	0	0	16	0	0
17	80109778	rs7502533	A	G	4	5	9	0	0	9	0	0
17	80109806	rs7501461	C	T	2	5	7	0	0	7	0	0
17	80110394	rs10163482	C	A	4	2	6	0	0	6	0	0
17	80110396	rs10163483	C	A	4	2	6	0	0	6	0	0
17	80112010	rs79940760	G	C	8	5	13	0	0	13	0	0
17	80112223	rs6502068	C	T	4	4	8	0	0	8	0	0
17	80113322	rs8078087	T	G	5	4	9	0	0	9	0	0
17	80113381	rs3935129	G	C	4	3	7	0	0	7	0	0
17	80114360	rs9900072	C	G	4	3	7	0	0	7	0	0
17	80114529	rs9911379	A	G	4	3	7	0	0	7	0	0
17	80114814	rs12051747	T	C	1	6	7	0	0	7	0	0
17	80115247	rs8070014	T	G	4	2	6	0	0	6	0	0
17	80136418	rs7209474	C	T	2	4	6	0	0	6	0	0
17	80146185	rs7406116	T	C	1	7	8	0	0	8	0	0
17	80151881	rs4789722	G	A	4	4	8	0	0	8	0	0
17	80187608	rs6502090	G	A	4	2	6	0	0	6	0	0
17	80190329	rs12453290	G	A	3	4	7	0	0	7	0	0
17	80208933	rs11653735	C	T	6	9	15	0	0	15	0	0
17	80212643	rs9675319	G	C	7	3	10	0	1	11	0	0
17	80218800	rs35693344	G	A	8	12	20	0	1	21	0	0
17	80225545	rs4789846	T	C	6	4	10	0	0	10	0	0
17	80228176	rs71375096	C	T	6	6	12	0	0	12	0	0
17	80230633	rs7209167	G	C	9	10	19	0	0	19	0	0
17	80280865	rs11077986	G	A	18	7	25	0	0	25	0	0
17	80350331	rs11903	G	A	73	57	130	0	1	131	0	0
17	80351104	rs7208956	T	C	9	7	16	0	1	17	0	0
17	80351428	rs4077609	G	C	6	2	8	0	0	8	0	0
17	80351639	rs7503819	A	G	1	5	6	0	0	6	0	0
17	80354859	rs72857427	G	T	5	5	10	0	0	10	0	0
17	80354870	rs66842398	C	T	5	4	9	0	0	9	0	0
17	80354937	rs59719801	G	C	4	6	10	0	0	10	0	0
17	80358862	rs8071761	A	G	1	6	7	0	0	7	0	0
17	80391684	rs4789773	A	G	32	22	54	0	1	55	0	0
17	80400755	rs8008	C	T	49	38	87	0	1	88	0	0
17	80401946	rs2306758	A	G	39	21	60	0	0	60	0	0
17	80403894	rs2291394	G	A	3	4	7	0	0	7	0	0
17	80403912	rs79154093	C	T	4	3	7	0	0	7	0	0
17	80407480	rs60529510	C	T	5	4	9	0	0	9	0	0
17	80407883	rs12449726	C	T	4	4	8	0	0	8	0	0
17	80415914	rs7209788	A	G	2	4	6	0	0	6	0	0
17	80415981	rs7218534	T	C	2	4	6	0	0	6	0	0
17	80416377	rs28365944	C	G	4	2	6	0	0	6	0	0
17	80419492	rs7211620	A	C	5	10	15	0	0	15	0	0
17	80419724	rs11077995	C	T	2	8	10	0	0	10	0	0
17	80421110	rs72859120	C	T	6	7	13	0	0	13	0	0
17	80423712	rs12450240	G	T	11	20	31	0	0	31	0	0
17	80424386	rs9891900	T	G	15	13	28	0	0	28	0	0
17	80426990	rs2306753	G	A	3	11	14	0	0	14	0	0
17	80427975	rs72859125	G	A	2	4	6	0	0	6	0	0
17	80439733	rs9909476	C	T	17	35	52	0	1	53	0	0
17	80439907	rs9898723	A	G	29	26	55	0	1	56	0	0
17	80439925	rs9905527	T	C	34	25	59	0	0	59	0	0
17	80441870	rs78454185	G	A	41	46	87	0	0	87	0	0
17	80443309	rs9890316	G	A	3	3	6	0	0	6	0	0
17	80478403	rs76235422	C	T	13	15	28	0	0	28	0	0
17	80523315	rs78072821	G	A	9	12	21	0	0	21	0	0
17	80524546	rs11652501	G	C	2	4	6	0	0	6	0	0
17	80524951	rs78737878	T	C	4	6	10	0	0	10	0	0
17	80526390	rs878822	C	T	11	5	16	0	0	16	0	0
17	80527356	rs12452440	T	C	5	5	10	0	0	10	0	0
17	80527430	rs72862345	T	G	5	5	10	0	0	10	0	0
17	80527881	rs112974026	G	A	8	3	11	0	0	11	0	0
17	80527895	rs4789797	G	A	7	3	10	0	0	10	0	0
17	80527909	rs111510017	T	C	7	3	10	0	0	10	0	0
17	80527967	rs111720645	A	G	6	4	10	0	0	10	0	0
17	80529826	rs3751909	G	C	12	15	27	0	0	27	0	0
17	80529972	rs3751908	A	G	17	6	23	0	0	23	0	0
17	80530134	rs3751907	A	G	23	12	35	0	0	35	0	0
17	80530429	rs3736206	T	C	9	7	16	0	0	16	0	0
17	80532116	rs11653286	T	C	5	5	10	0	0	10	0	0
17	80532122	rs72862366	G	C	4	5	9	0	0	9	0	0
17	80532339	rs78823728	G	A	5	1	6	0	0	6	0	0
17	80533079	rs4789799	T	C	4	7	11	0	1	12	0	0
17	80533844	rs112268660	G	A	5	2	7	0	3	10	0	0
17	80534883	rs55775285	A	G	2	5	7	0	0	7	0	0
17	80534991	rs12602034	C	T	7	10	17	0	0	17	0	0
17	80535141	rs12453001	T	A	11	12	23	0	1	24	0	0
17	80536908	rs2279396	A	C	36	46	82	0	1	83	0	0
17	80537010	rs9895615	G	A	42	35	77	0	0	77	0	0
17	80537265	rs72490490	T	C	4	2	6	0	0	6	0	0
17	80537742	rs34326642	T	C	2	5	7	0	0	7	0	0
17	80539824	rs3794721	G	A	5	7	12	0	0	12	0	0
17	80540585	rs2306759	A	G	8	4	12	0	0	12	0	0
17	80541401	rs3794720	G	A	4	8	12	0	0	12	0	0
17	80543010	rs59259701	C	T	14	18	32	0	0	32	0	0
17	80543465	rs3794718	T	C	6	10	16	0	0	16	0	0
17	80546376	rs144665282	C	T	4	3	7	0	0	7	0	0
17	80546929	rs72863724	G	A	6	4	10	0	0	10	0	0
17	80560618	rs191763615	G	A	14	12	26	0	3	29	0	0
17	80582653	rs150276240	C	T	8	4	12	0	0	12	0	0
17	80587375	.	T	G	14	21	35	0	0	35	0	0
17	80588575	rs2306755	C	A	15	12	27	0	0	27	0	0
17	80613061	rs2011631	T	G	2	5	7	0	0	7	0	0
17	80613417	rs744991	G	C	3	7	10	0	0	10	0	0
17	80615290	rs11105	C	T	21	10	31	0	0	31	0	0
17	80615643	rs3751911	G	A	20	20	40	0	0	40	0	0
17	80615648	.	G	A	19	20	39	0	2	41	0	0
17	80618029	rs2279394	G	A	3	3	6	0	0	6	0	0
17	80622290	rs2279393	A	G	6	0	6	0	0	6	0	0
17	80622344	rs2279392	G	A	0	6	6	0	0	6	0	0
17	80685375	rs11551832	G	A	54	30	84	0	0	84	0	0
17	80685426	rs1046875	A	G	52	37	89	0	1	90	0	0
17	80685511	rs1046889	C	T	44	41	85	0	0	85	0	0
17	80685533	rs1046896	C	T	44	47	91	0	1	92	0	0
17	80685655	rs1046917	A	G	41	36	77	0	0	77	0	0
17	80710097	rs11550062	G	T	8	6	14	0	0	14	0	0
17	80869706	rs12601746	C	G	2	4	6	0	0	6	0	0
17	80869775	rs12600371	T	C	3	4	7	0	0	7	0	0
17	80905987	rs34143788	C	T	15	12	27	0	0	27	0	0
17	80920842	rs78604106	C	T	4	2	6	0	0	6	0	0
17	80924707	rs9303016	C	A	3	6	9	0	0	9	0	0
17	80928674	rs35355170	G	C	2	6	8	0	0	8	0	0
17	80970401	rs142033551	G	T	48	37	85	0	0	85	0	0
17	80970470	.	C	T	32	41	73	0	0	73	0	0
17	80993917	.	G	C	8	7	15	0	1	16	0	0
17	81039544	rs8069795	A	C	31	21	52	0	1	53	0	0
17	81045660	rs111604027	A	T	10	11	21	0	0	21	0	0
17	81046832	.	C	T	11	12	23	0	2	25	0	0
17	81047572	rs7405511	C	T	18	18	36	0	0	36	0	0
17	81047829	rs4072523	G	A	13	14	27	0	0	27	0	0
17	81047967	rs141259872	A	G	7	5	12	0	0	12	0	0
17	81048424	rs79859911	T	C	12	7	19	0	0	19	0	0
17	81048659	rs7502145	G	C	17	19	36	0	0	36	0	0
17	81050982	rs7501742	G	C	11	3	14	0	0	14	0	0
17	81051007	rs7502442	G	T	9	6	15	0	1	16	0	0
17	81051887	rs7223467	T	G	20	25	45	0	0	45	0	0
17	81052423	rs8269	G	A	121	234	355	0	1	356	0	0
17	81061241	rs9894465	A	G	10	6	16	0	0	16	0	0
17	81061697	rs9898245	C	T	13	8	21	0	0	21	0	0
17	81062985	rs28627461	A	G	10	3	13	0	0	13	0	0
17	81063244	rs28450305	G	T	5	9	14	0	0	14	0	0
17	81063323	rs28626243	G	A	7	6	13	0	0	13	0	0
17	81063675	rs4056	G	A	7	4	11	0	0	11	0	0
17	81099138	rs9330544	C	T	3	5	8	0	0	8	0	0
17	81099275	rs9330545	A	G	6	3	9	0	0	9	0	0
17	81100179	rs9675209	T	G	3	7	10	0	0	10	0	0
17	81100806	rs9709128	C	T	3	4	7	0	0	7	0	0
18	47315616	rs644897	G	A	7	0	7	0	0	7	0	0
19	537454	.	G	A	10	9	19	0	1	20	0	0
19	573205	rs2072308	T	C	6	11	17	0	0	17	0	0
19	574545	rs151237303	C	T	5	2	7	0	0	7	0	0
19	574547	rs140499328	C	T	5	2	7	0	0	7	0	0
19	574573	rs111791696	T	A	7	5	12	0	0	12	0	0
19	574927	rs12609912	C	T	4	6	10	0	0	10	0	0
19	575083	rs12609053	G	C	8	3	11	0	0	11	0	0
19	575159	rs12609063	G	A	2	6	8	0	0	8	0	0
19	575805	rs2238540	G	T	4	7	11	0	0	11	0	0
19	575964	rs2238542	C	T	3	9	12	0	2	14	0	0
19	576932	rs2238545	T	C	3	11	14	0	0	14	0	0
19	577321	rs12611131	C	T	9	16	25	0	0	25	0	0
19	577347	rs8110980	C	T	12	11	23	0	0	23	0	0
19	577760	rs2283569	T	C	4	7	11	0	0	11	0	0
19	578208	rs2283570	C	T	2	9	11	0	0	11	0	0
19	578239	rs2283571	C	T	8	2	10	0	1	11	0	0
19	578785	rs1138150	T	C	5	3	8	0	1	9	0	0
19	579035	rs2283572	C	T	3	3	6	0	0	6	0	0
19	579100	rs2283573	C	T	3	8	11	0	1	12	0	0
19	579157	rs28921990	T	C	6	8	14	0	0	14	0	0
19	579450	rs2283574	G	A	6	14	20	0	0	20	0	0
19	579627	rs1803202	C	T	514	535	1049	0	2	1051	0	0
19	579699	rs12608994	C	T	4	10	14	0	0	14	0	0
19	579713	rs12609013	C	T	5	10	15	0	0	15	0	0
19	580012	rs28992471	C	A	6	14	20	0	1	21	0	0
19	580268	rs2108832	G	C	6	2	8	0	0	8	0	0
19	580333	rs11879069	G	A	7	2	9	0	1	10	0	0
19	580388	rs2229664	C	G	559	564	1123	0	7	1130	0	0
19	580575	rs28992474	C	T	9	8	17	0	0	17	0	0
19	580665	rs4682	T	C	654	656	1310	0	12	1322	0	0
19	581633	rs3764937	G	A	12	17	29	0	0	29	0	0
19	581815	rs3764938	C	T	9	12	21	0	0	21	0	0
19	581944	rs28992483	C	T	5	20	25	0	0	25	0	0
19	581956	rs28992484	C	T	6	21	27	0	0	27	0	0
19	581974	rs28992485	C	T	6	23	29	0	0	29	0	0
19	582505	rs2072309	G	A	11	2	13	0	0	13	0	0
19	583418	rs6757	T	C	346	325	671	0	4	675	0	0
19	583460	rs6758	G	A	127	100	227	0	3	230	0	0
19	618159	rs11672829	A	G	3	3	6	0	1	7	0	0
19	619021	rs14155	G	C	68	43	111	0	1	112	0	0
19	621712	rs2238547	A	G	22	17	39	0	0	39	0	0
19	622336	rs2238549	T	G	9	10	19	0	0	19	0	0
19	625198	.	A	G	27	21	48	0	0	48	0	0
19	630130	rs140649984	C	T	23	26	49	0	0	49	0	0
19	652238	rs11554788	A	G	182	163	345	0	5	350	0	0
19	652739	rs12973146	C	G	15	15	30	0	0	30	0	0
19	653830	rs4919880	C	T	3	3	6	0	0	6	0	0
19	747847	rs75867151	C	A	118	64	182	0	3	185	0	0
19	748083	rs7927	C	T	60	104	164	0	0	164	0	0
19	798921	rs8103323	T	C	2	5	7	0	0	7	0	0
19	799342	rs8100561	G	C	12	8	20	0	0	20	0	0
19	799770	rs11085226	A	G	26	14	40	0	0	40	0	0
19	801751	.	G	A	14	13	27	0	1	28	0	0
19	803220	rs351984	T	C	12	10	22	0	0	22	0	0
19	803945	rs10420407	G	A	19	17	36	0	1	37	0	0
19	804327	rs10420953	C	T	400	458	858	0	8	866	0	0
19	804612	rs4986235	C	T	276	362	638	0	2	640	0	0
19	804959	rs10422347	C	T	16	16	32	0	0	32	0	0
19	805786	rs187304742	C	T	33	31	64	0	0	64	0	0
19	806634	rs351977	G	T	48	39	87	0	1	88	0	0
19	806673	rs351976	T	C	59	48	107	0	0	107	0	0
19	807442	rs123698	G	C	58	53	111	0	0	111	0	0
19	808824	rs62131353	C	T	2	5	7	0	1	8	0	0
19	808920	rs62131354	C	T	5	6	11	0	0	11	0	0
19	809541	rs8102405	C	T	5	2	7	0	0	7	0	0
19	809732	rs351995	C	A	7	3	10	0	0	10	0	0
19	810445	rs10426392	C	T	12	6	18	0	0	18	0	0
19	810460	rs117696745	C	G	11	6	17	0	0	17	0	0
19	810573	rs11549883	C	A	732	702	1434	0	15	1449	0	0
19	829568	rs12460890	C	T	36	54	90	0	1	91	0	0
19	830854	rs595844	T	C	35	44	79	0	0	79	0	0
19	844020	rs351111	G	A	12	18	30	0	0	30	0	0
19	863356	rs10506	C	T	148	69	217	0	1	218	0	0
19	868115	rs13090	C	T	35	81	116	0	6	122	0	0
19	868620	rs1651891	G	A	1	7	8	0	0	8	0	0
19	869037	rs1683591	A	G	1	5	6	0	0	6	0	0
19	869082	.	G	A	6	3	9	0	0	9	0	0
19	871135	rs1683569	A	G	29	40	69	0	0	69	0	0
19	871987	rs78047294	G	A	67	86	153	0	2	155	0	0
19	872255	rs891206	G	A	9	1	10	0	0	10	0	0
19	875389	rs11546307	G	A	45	63	108	0	1	109	0	0
19	875902	rs1651887	G	A	10	12	22	0	1	23	0	0
19	876641	rs1651886	T	C	3	3	6	0	0	6	0	0
19	876882	rs111469573	C	A	2	4	6	0	0	6	0	0
19	876910	rs112523035	C	T	2	4	6	0	0	6	0	0
19	880066	rs34799086	G	A	22	14	36	0	0	36	0	0
19	886082	rs35542830	G	A	22	20	42	0	0	42	0	0
19	890165	rs6678	G	A	35	29	64	0	0	64	0	0
19	897571	rs3746149	G	C	37	50	87	0	1	88	0	0
19	897855	rs111607343	G	A	39	38	77	0	1	78	0	0
19	898288	rs12985393	C	T	11	22	33	0	1	34	0	0
19	898392	rs12976746	G	A	19	16	35	0	2	37	0	0
19	898657	rs2062422	G	A	18	16	34	0	0	34	0	0
19	899123	rs11881841	T	A	33	37	70	0	1	71	0	0
19	899567	rs2930885	C	G	10	4	14	0	0	14	0	0
19	899978	rs2306718	G	A	25	13	38	0	0	38	0	0
19	901955	rs4343405	C	T	5	10	15	0	1	16	0	0
19	902247	rs1471815	C	T	74	80	154	0	1	155	0	0
19	902874	rs2365701	A	G	5	3	8	0	0	8	0	0
19	903025	rs2965299	G	A	1	8	9	0	0	9	0	0
19	903723	rs2965298	G	A	5	4	9	0	0	9	0	0
19	910742	rs168405	G	T	3	4	7	0	0	7	0	0
19	955197	rs192804633	G	A	2	4	6	0	0	6	0	0
19	984533	rs2301810	T	C	25	20	45	0	0	45	0	0
19	984554	rs4806884	C	G	29	17	46	0	0	46	0	0
19	990702	rs10854001	C	T	6	6	12	0	0	12	0	0
19	990819	rs2240149	G	A	6	9	15	0	0	15	0	0
19	1009883	rs1058603	A	G	158	122	280	0	2	282	0	0
19	1010691	rs2240159	A	G	57	49	106	0	2	108	0	0
19	1011823	rs2240161	A	G	3	8	11	0	0	11	0	0
19	1011846	rs10420656	T	C	3	9	12	0	0	12	0	0
19	1011856	rs113138803	C	A	4	8	12	0	0	12	0	0
19	1012379	rs2240162	C	G	63	66	129	0	1	130	0	0
19	1012381	rs2240163	T	C	64	66	130	0	1	131	0	0
19	1012416	rs112926823	G	A	85	66	151	0	0	151	0	0
19	1013021	rs970101	A	G	3	3	6	0	0	6	0	0
19	1013560	rs6510989	A	G	4	4	8	0	0	8	0	0
19	1014398	rs7146	A	G	165	155	320	0	0	320	0	0
19	1014712	rs2240164	G	A	8	4	12	0	0	12	0	0
19	1015908	rs73920542	C	T	13	6	19	0	0	19	0	0
19	1015909	rs3815172	A	G	13	6	19	0	0	19	0	0
19	1015961	rs8108847	A	G	9	6	15	0	0	15	0	0
19	1016718	rs56126437	C	T	7	6	13	0	1	14	0	0
19	1017782	rs737692	C	G	6	8	14	0	0	14	0	0
19	1018318	rs739884	G	A	6	1	7	0	0	7	0	0
19	1018541	rs2240167	A	G	3	7	10	0	0	10	0	0
19	1018673	rs2240168	A	G	6	3	9	0	0	9	0	0
19	1019105	rs2240170	C	G	6	7	13	0	0	13	0	0
19	1020086	rs10413761	A	G	6	6	12	0	0	12	0	0
19	1020287	rs10414196	A	C	5	9	14	0	0	14	0	0
19	1020673	rs1005504	C	G	6	17	23	0	1	24	0	0
19	1032702	rs4315451	C	T	34	25	59	0	0	59	0	0
19	1032756	rs55784632	C	T	20	17	37	0	0	37	0	0
19	1033360	rs55725239	A	T	8	5	13	0	0	13	0	0
19	1035252	rs7252752	T	C	10	11	21	0	0	21	0	0
19	1035455	rs10407915	A	C	13	21	34	0	0	34	0	0
19	1086787	rs1109555	C	T	47	47	94	0	0	94	0	0
19	1087644	rs142063568	T	G	46	25	71	0	1	73	1	0
19	1091931	.	T	G	11	12	23	0	0	23	0	0
19	1092530	rs10426326	T	C	5	4	9	0	0	9	0	0
19	1095336	rs1046041	C	T	63	60	123	0	2	125	0	0
19	1104078	rs4807542	G	A	142	202	344	0	3	347	0	0
19	1106615	rs713041	T	C	1078	1184	2262	0	7	2269	0	0
19	1109213	rs2159133	A	G	12	23	35	0	0	35	0	0
19	1109215	rs11669443	G	A	13	23	36	0	0	36	0	0
19	1110829	rs2302109	G	A	160	147	307	0	4	311	0	0
19	1113610	.	C	T	89	71	160	0	1	161	0	0
19	1119019	rs2074920	C	T	85	65	150	0	0	150	0	0
19	1119699	rs7249751	A	G	2	5	7	0	0	7	0	0
19	1119876	rs8107205	T	G	3	4	7	0	0	7	0	0
19	1119963	rs2074921	A	G	87	88	175	0	1	176	0	0
19	1120329	rs8100067	C	T	4	3	7	0	0	7	0	0
19	1121171	rs4807562	A	T	6	3	9	0	0	9	0	0
19	1121780	rs3787014	G	C	3	5	8	0	0	8	0	0
19	1121890	rs35126999	A	G	5	4	9	0	1	10	0	0
19	1121902	rs34530878	G	A	5	4	9	0	0	9	0	0
19	1122147	rs2072280	G	A	75	69	144	0	2	146	0	0
19	1127615	rs2074915	G	C	127	117	244	0	1	245	0	0
19	1127720	rs2074916	G	A	88	72	160	0	0	160	0	0
19	1207238	rs3764640	G	T	5	8	13	0	1	14	0	0
19	1212795	rs145817908	G	A	2	4	6	0	0	6	0	0
19	1219129	rs35113943	G	A	8	7	15	0	0	15	0	0
19	1219702	rs11084890	G	A	13	8	21	0	1	22	0	0
19	1220004	rs35369365	A	G	17	21	38	0	0	38	0	0
19	1220321	rs2075606	T	C	26	9	35	0	0	35	0	0
19	1222316	rs2075608	C	T	4	2	6	0	0	6	0	0
19	1222537	rs56119352	G	C	4	2	6	0	0	6	0	0
19	1224286	rs35004890	G	T	5	2	7	0	0	7	0	0
19	1224935	rs12985504	T	C	3	5	8	0	0	8	0	0
19	1224999	rs7247576	A	G	4	5	9	0	0	9	0	0
19	1225028	rs36078268	T	C	5	2	7	0	0	7	0	0
19	1225547	rs59436472	C	T	8	8	16	0	0	16	0	0
19	1250109	rs3746106	C	A	85	101	186	0	0	186	0	0
19	1251781	rs2285811	A	G	24	20	44	0	0	44	0	0
19	1252311	rs10416809	C	T	8	10	18	0	0	18	0	0
19	1252451	rs10423391	T	C	12	6	18	0	0	18	0	0
19	1254122	rs2301761	G	A	4	5	9	0	0	9	0	0
19	1255253	rs10412640	C	T	9	1	10	0	0	10	0	0
19	1256368	rs113350795	G	A	6	7	13	0	0	13	0	0
19	1256998	rs9823	C	T	235	197	432	0	11	443	0	0
19	1271274	rs12609287	C	T	41	34	75	0	0	75	0	0
19	1271529	rs4807050	C	T	13	10	23	0	0	23	0	0
19	1272040	rs12488	T	C	1258	1194	2452	0	11	2463	0	0
19	1274539	rs8108009	T	C	14	18	32	0	1	33	0	0
19	1274601	rs1054695	C	T	17	22	39	0	0	39	0	0
19	1277275	rs757292	G	C	105	149	254	0	1	255	0	0
19	1369296	.	C	T	29	23	52	0	0	52	0	0
19	1370675	rs12608765	C	G	25	17	42	0	0	42	0	0
19	1377158	rs11084893	C	T	13	9	22	0	0	22	0	0
19	1384690	rs2332496	G	A	3	4	7	0	0	7	0	0
19	1386889	rs34885619	C	T	5	1	6	0	0	6	0	0
19	1387299	rs502121	T	C	5	3	8	0	0	8	0	0
19	1388320	rs7254913	G	A	3	4	7	0	0	7	0	0
19	1388538	rs1142530	C	T	69	79	148	0	0	148	0	0
19	1390757	rs2074895	C	A	3	4	7	0	0	7	0	0
19	1424888	rs698748	A	G	7	7	14	0	0	14	0	0
19	1460473	rs11668593	G	A	5	2	7	0	0	7	0	0
19	1473829	rs45468999	C	G	5	5	10	0	0	10	0	0
19	1577208	rs1053151	G	A	115	107	222	0	1	223	0	0
19	1625622	.	G	A	110	104	214	0	2	216	0	0
19	1827197	rs78977406	C	T	24	19	43	0	0	43	0	0
19	1854122	rs148718674	C	A	100	112	212	0	3	216	1	0
19	1924653	rs3810415	C	A	70	95	165	0	1	166	0	0
19	1925942	rs8730	C	T	8	5	13	0	0	13	0	0
19	1950566	rs36101713	C	T	4	3	7	0	0	7	0	0
19	1952090	rs4534977	G	A	3	3	6	0	0	6	0	0
19	1953637	rs35628322	C	T	3	5	8	0	0	8	0	0
19	1955888	rs12980373	G	A	2	5	7	0	0	7	0	0
19	1955931	rs12980569	G	C	2	4	6	0	0	6	0	0
19	1956524	rs8100279	A	G	2	4	6	0	0	6	0	0
19	1956532	rs11084922	C	T	3	3	6	0	0	6	0	0
19	1959860	.	G	A	7	0	7	0	1	8	0	0
19	1959868	rs12984320	G	C	6	0	6	0	0	6	0	0
19	1959905	rs56224852	C	G	6	2	8	0	0	8	0	0
19	1962789	rs62129495	T	C	5	5	10	0	0	10	0	0
19	1970668	rs56187939	A	G	4	2	6	0	0	6	0	0
19	1972732	rs7507732	T	C	4	2	6	0	0	6	0	0
19	1977428	rs740051	G	T	2	4	6	0	1	7	0	0
19	1979386	rs11550450	C	T	223	209	432	0	5	437	0	0
19	1981197	rs1059684	G	A	195	186	381	0	0	381	0	0
19	1985918	rs117804972	A	G	201	184	385	0	3	388	0	0
19	1997363	rs1610045	A	G	207	238	445	0	4	449	0	0
19	2013713	rs35825959	T	A	28	18	46	0	1	47	0	0
19	2037846	.	A	C	359	236	595	0	6	601	0	0
19	2038137	rs72981418	T	C	272	243	515	0	3	518	0	0
19	2038459	.	G	A	179	223	402	0	8	411	1	0
19	2038819	rs2287002	G	A	331	323	654	0	1	655	0	0
19	2039330	rs3746098	G	A	173	162	335	0	10	348	3	0
19	2040650	rs1861152	C	T	26	22	48	0	0	48	0	0
19	2043271	rs2302585	G	A	10	12	22	0	1	23	0	0
19	2045291	rs7248631	G	C	5	7	12	0	0	12	0	0
19	2045805	rs8103466	G	A	5	11	16	0	0	16	0	0
19	2046925	rs78029818	G	A	2	4	6	0	0	6	0	0
19	2047688	rs11665732	A	C	3	3	6	0	0	6	0	0
19	2049314	rs880183	G	A	5	3	8	0	0	8	0	0
19	2099012	.	A	G	7	9	16	0	0	16	0	0
19	2099111	rs12984606	T	G	1	5	6	0	0	6	0	0
19	2099362	rs1051767	C	T	11	9	20	0	0	20	0	0
19	2131148	rs12979965	A	G	3	10	13	0	0	13	0	0
19	2131846	rs74176381	A	G	4	3	7	0	0	7	0	0
19	2133332	rs12981497	C	G	5	2	7	0	0	7	0	0
19	2133465	rs12981780	C	T	7	4	11	0	0	11	0	0
19	2136515	rs2108825	T	C	2	4	6	0	0	6	0	0
19	2138654	rs25672	T	G	38	40	78	0	0	78	0	0
19	2176798	.	G	A	3	3	6	0	0	6	0	0
19	2181607	rs12980348	T	G	2	4	6	0	0	6	0	0
19	2183000	rs12609327	A	C	5	2	7	0	0	7	0	0
19	2183175	rs2864419	G	T	7	3	10	0	0	10	0	0
19	2184005	rs12974139	T	C	2	9	11	0	0	11	0	0
19	2184652	rs4806832	C	T	4	5	9	0	0	9	0	0
19	2186237	rs886449	G	A	2	10	12	0	0	12	0	0
19	2186757	rs8108461	T	C	7	4	11	0	1	12	0	0
19	2187271	rs2240127	A	G	4	7	11	0	0	11	0	0
19	2187360	rs538858704	C	T	7	10	17	0	1	18	0	0
19	2190690	rs7248941	T	C	18	12	30	0	0	30	0	0
19	2190774	.	T	A	10	11	21	0	1	22	0	0
19	2191685	rs34982309	G	A	51	34	85	0	1	86	0	0
19	2191980	rs3815145	T	C	122	75	197	0	1	198	0	0
19	2192015	rs3815146	C	T	89	136	225	0	0	225	0	0
19	2192323	rs3815147	T	C	7	11	18	0	1	19	0	0
19	2194769	rs4807213	A	G	4	2	6	0	0	6	0	0
19	2195065	rs12983546	G	T	6	1	7	0	0	7	0	0
19	2195611	rs2269880	T	C	8	8	16	0	0	16	0	0
19	2195799	.	A	G	4	3	7	0	0	7	0	0
19	2196783	rs2269882	A	G	3	3	6	0	0	6	0	0
19	2197734	rs2240129	G	A	5	4	9	0	0	9	0	0
19	2198056	rs72985463	G	C	4	2	6	0	0	6	0	0
19	2198619	rs12982279	C	T	5	4	9	0	0	9	0	0
19	2198744	rs12983491	A	G	3	6	9	0	0	9	0	0
19	2198845	rs2269883	C	T	5	6	11	0	1	12	0	0
19	2200547	rs12982300	G	A	8	17	25	0	0	25	0	0
19	2201186	.	C	G	15	3	18	0	2	20	0	0
19	2201898	rs2240130	G	A	7	14	21	0	0	21	0	0
19	2202245	rs12985448	C	T	8	8	16	0	1	17	0	0
19	2205668	rs12981806	C	G	15	11	26	0	0	26	0	0
19	2206163	rs35792872	G	A	7	10	17	0	0	17	0	0
19	2206575	rs1003531	G	T	14	12	26	0	1	27	0	0
19	2208859	rs2301799	T	C	3	3	6	0	0	6	0	0
19	2215100	rs7246186	A	G	6	6	12	0	0	12	0	0
19	2217203	rs72985483	G	A	6	2	8	0	1	9	0	0
19	2217528	rs538761117	C	T	6	1	7	0	0	7	0	0
19	2221190	rs12981430	C	A	3	4	7	0	0	7	0	0
19	2226676	rs3815308	G	A	30	46	76	0	1	77	0	0
19	2227681	rs191587469	C	T	8	6	14	0	0	14	0	0
19	2230580	rs138828181	G	A	35	31	66	0	0	66	0	0
19	2270368	rs2523172	C	T	15	12	27	0	0	27	0	0
19	2272309	rs2523176	C	T	48	58	106	0	2	108	0	0
19	2292293	rs145366197	A	G	5	3	8	0	0	8	0	0
19	2294260	rs8113792	C	G	15	18	33	0	0	33	0	0
19	2294552	rs11084929	G	T	6	8	14	0	0	14	0	0
19	2295629	rs11879876	T	G	10	8	18	0	0	18	0	0
19	2353996	.	G	A	18	30	48	0	0	48	0	0
19	2512606	rs7258864	G	A	20	30	50	0	1	51	0	0
19	2714666	rs14713	G	A	1	8	9	0	0	9	0	0
19	2714720	rs8737	A	G	1	8	9	0	0	9	0	0
19	2714771	rs2014626	T	C	1	5	6	0	0	6	0	0
19	2715287	rs12461076	T	C	1	22	23	0	0	23	0	0
19	2715556	rs28435794	G	C	0	13	13	0	0	13	0	0
19	2715741	rs62121111	G	C	0	15	15	0	0	15	0	0
19	2717256	rs3745812	C	G	0	6	6	0	0	6	0	0
19	2732741	rs9160	G	A	9	10	19	0	0	19	0	0
19	2735363	rs62121118	C	T	22	19	41	0	0	41	0	0
19	2735891	rs61386578	G	C	17	21	38	0	0	38	0	0
19	2756571	rs112518228	C	G	20	26	46	0	0	46	0	0
19	2790394	rs1736176	G	A	6	3	9	0	0	9	0	0
19	2809672	rs1736183	A	G	3	4	7	0	0	7	0	0
19	2813000	rs1736185	A	G	3	5	8	0	1	9	0	0
19	2917287	rs2288958	C	A	8	8	16	0	0	16	0	0
19	3053802	rs425485	T	C	64	43	107	0	11	119	1	0
19	3054567	rs4807391	C	T	8	3	11	0	0	11	0	0
19	3055177	rs62125453	C	T	4	4	8	0	0	8	0	0
19	3055307	rs2277741	G	A	4	2	6	0	0	6	0	0
19	3057220	rs4806901	T	C	11	11	22	0	0	22	0	0
19	3057228	rs307716	A	C	11	11	22	0	0	22	0	0
19	3058541	rs62125455	C	T	7	7	14	0	0	14	0	0
19	3059594	rs307718	G	A	6	3	9	0	0	9	0	0
19	3061344	rs62125457	G	A	7	7	14	0	0	14	0	0
19	3061768	rs307719	A	G	8	7	15	0	0	15	0	0
19	3117490	rs45455400	C	T	1	7	8	0	0	8	0	0
19	3118207	rs308048	G	C	10	0	10	0	0	10	0	0
19	3118389	rs308047	C	A	8	2	10	0	0	10	0	0
19	3118514	rs55849164	C	T	12	1	13	0	0	13	0	0
19	3121908	rs308040	C	G	4	3	7	0	0	7	0	0
19	3122655	rs16989608	A	G	1	7	8	0	0	8	0	0
19	3122941	rs2240564	T	C	0	9	9	0	0	9	0	0
19	3122945	rs2240565	C	G	10	0	10	0	0	10	0	0
19	3123113	rs415647	C	T	6	2	8	0	0	8	0	0
19	3123635	rs8092	C	T	5	9	14	0	0	14	0	0
19	3136967	rs368333	T	C	4	10	14	0	0	14	0	0
19	3138331	rs8112632	T	C	5	1	6	0	1	7	0	0
19	3138487	rs11880040	G	T	7	6	13	0	0	13	0	0
19	3138568	rs73527865	T	A	3	6	9	0	0	9	0	0
19	3138651	rs112755363	C	T	2	4	6	0	0	6	0	0
19	3138896	rs12979326	G	A	3	3	6	0	0	6	0	0
19	3139178	rs145429773	A	G	3	10	13	0	0	13	0	0
19	3139364	rs11878928	T	C	1	7	8	0	0	8	0	0
19	3139759	rs543453	T	C	0	6	6	0	0	6	0	0
19	3139771	rs11881083	C	T	1	6	7	0	0	7	0	0
19	3139847	rs12981864	T	C	1	6	7	0	0	7	0	0
19	3140417	rs11880497	A	C	3	9	12	0	0	12	0	0
19	3140786	rs12975183	T	C	5	8	13	0	0	13	0	0
19	3140909	rs389238	A	T	3	10	13	0	0	13	0	0
19	3141550	rs2283599	T	C	3	9	12	0	0	12	0	0
19	3142005	rs12983007	C	A	5	5	10	0	0	10	0	0
19	3142233	rs399799	A	C	8	4	12	0	0	12	0	0
19	3142273	rs78589526	G	A	6	7	13	0	0	13	0	0
19	3142495	rs8104565	A	G	2	13	15	0	0	15	0	0
19	3142502	rs8104661	A	C	2	12	14	0	0	14	0	0
19	3143031	rs2315994	T	C	5	7	12	0	0	12	0	0
19	3143044	rs4997583	G	A	5	6	11	0	0	11	0	0
19	3143069	rs1688124	G	T	4	8	12	0	0	12	0	0
19	3143154	rs114337880	A	G	6	8	14	0	0	14	0	0
19	3143155	rs115079618	T	G	6	8	14	0	0	14	0	0
19	3143156	rs4997584	T	C	6	8	14	0	0	14	0	0
19	3143182	rs432893	T	C	6	4	10	0	0	10	0	0
19	3143262	rs415011	G	A	9	5	14	0	0	14	0	0
19	3143320	rs373658	C	T	9	3	12	0	0	12	0	0
19	3149541	rs310682	T	C	10	11	21	0	0	21	0	0
19	3154978	rs35047169	G	A	132	102	234	0	0	234	0	0
19	3176274	rs3760959	A	G	12	10	22	0	0	22	0	0
19	3185563	rs507905	C	T	4	9	13	0	0	13	0	0
19	3185636	rs556075	T	C	4	8	12	0	0	12	0	0
19	3186085	rs11551095	G	T	24	12	36	0	0	36	0	0
19	3193484	rs499877	A	G	11	12	23	0	0	23	0	0
19	3194243	rs527453	C	T	9	5	14	0	0	14	0	0
19	3194595	rs482740	T	A	12	16	28	0	1	29	0	0
19	3195135	rs56971413	T	G	9	10	19	0	0	19	0	0
19	3195243	rs311614	G	T	7	4	11	0	0	11	0	0
19	3196122	rs311615	T	C	16	14	30	0	0	30	0	0
19	3196439	rs3826932	C	G	4	4	8	0	0	8	0	0
19	3196533	rs311616	A	G	10	2	12	0	0	12	0	0
19	3196999	rs186339	G	C	5	5	10	0	0	10	0	0
19	3197121	rs75754783	T	C	4	4	8	0	0	8	0	0
19	3198695	rs311620	C	G	5	3	8	0	0	8	0	0
19	3198755	rs2304247	C	T	5	3	8	0	0	8	0	0
19	3198777	rs311621	A	G	5	3	8	0	0	8	0	0
19	3199940	rs519266	T	C	3	5	8	0	0	8	0	0
19	3199945	rs519271	T	A	4	5	9	0	0	9	0	0
19	3200637	rs2873039	A	G	4	5	9	0	0	9	0	0
19	3200799	rs892221	G	A	8	7	15	0	0	15	0	0
19	3202106	rs733502	C	T	4	5	9	0	0	9	0	0
19	3208234	rs11551092	C	T	68	58	126	0	0	126	0	0
19	3208350	rs312070	A	G	91	75	166	0	0	166	0	0
19	3208418	rs312071	T	C	103	79	182	0	29	211	0	0
19	3209483	rs4594	T	G	113	66	179	0	1	180	0	0
19	3366610	.	C	T	3	8	11	0	0	11	0	0
19	3464320	rs3746298	G	C	21	27	48	0	0	48	0	0
19	3464321	rs3746299	G	C	21	27	48	0	0	48	0	0
19	3468503	rs4807475	T	C	23	27	50	0	1	51	0	0
19	3478646	rs10413312	C	G	5	1	6	0	0	6	0	0
19	3490908	rs1051803	T	C	8	12	20	0	0	20	0	0
19	3491368	rs10126	A	G	13	37	50	0	0	50	0	0
19	3500641	rs4807481	C	T	7	7	14	0	0	14	0	0
19	3579000	rs1443	C	T	140	140	280	0	2	282	0	0
19	3590334	rs17348907	A	G	4	10	14	0	0	14	0	0
19	3592171	rs8105780	T	C	9	9	18	0	0	18	0	0
19	3592855	rs10411250	A	C	16	9	25	0	1	26	0	0
19	3593004	rs17433775	A	G	10	10	20	0	1	21	0	0
19	3612819	rs62130601	G	A	4	3	7	0	0	7	0	0
19	3615306	rs56295971	C	A	4	4	8	0	0	8	0	0
19	3617460	rs56298926	A	G	8	5	13	0	0	13	0	0
19	3624005	rs55862054	G	A	10	14	24	0	0	24	0	0
19	3631694	rs4806946	G	A	19	26	45	0	1	46	0	0
19	3633623	rs17606167	G	A	2	5	7	0	0	7	0	0
19	3653525	rs2074957	C	T	14	11	25	0	0	25	0	0
19	3660619	rs757454	A	G	6	0	6	0	0	6	0	0
19	3663425	rs16991985	C	G	2	6	8	0	0	8	0	0
19	3663641	rs57428569	T	C	5	3	8	0	0	8	0	0
19	3664016	rs11880224	A	G	5	10	15	0	0	15	0	0
19	3664094	rs8109485	A	G	3	6	9	0	1	10	0	0
19	3664491	rs79025514	G	A	2	5	7	0	0	7	0	0
19	3781557	rs12610731	C	T	3	3	6	0	0	6	0	0
19	3783585	rs74541557	G	T	7	12	19	0	0	19	0	0
19	3958708	rs10419272	G	C	33	27	60	0	0	60	0	0
19	3958890	rs3745981	G	A	35	29	64	0	0	64	0	0
19	3958895	rs3745982	C	A	28	32	60	0	1	61	0	0
19	3960020	rs2304193	C	T	3	6	9	0	0	9	0	0
19	4051740	rs73534132	T	C	20	17	37	0	0	37	0	0
19	4094775	rs350916	G	A	36	45	81	0	0	81	0	0
19	4101062	rs10250	G	T	355	345	700	0	0	700	0	0
19	4120467	rs10405472	G	A	4	3	7	0	0	7	0	0
19	4120846	rs10407945	C	T	5	3	8	0	0	8	0	0
19	4229635	rs400089	A	G	1	5	6	0	0	6	0	0
19	4236996	rs4740	G	A	16	23	39	0	0	39	0	0
19	4237067	rs4905	A	G	17	23	40	0	0	40	0	0
19	4237425	rs6613	A	T	10	5	15	0	0	15	0	0
19	4251069	rs1045750	T	C	265	273	538	0	2	540	0	0
19	4254375	rs11085068	C	T	288	267	555	0	12	567	0	0
19	4259400	rs4807560	G	A	10	3	13	0	0	13	0	0
19	4259506	rs4806976	A	G	12	8	20	0	0	20	0	0
19	4259514	rs4807561	C	T	12	8	20	0	0	20	0	0
19	4262696	rs10416511	G	A	9	1	10	0	0	10	0	0
19	4265942	rs1972635	G	A	6	2	8	0	0	8	0	0
19	4352959	rs11882587	A	G	33	25	58	0	0	58	0	0
19	4362691	rs243261	G	C	143	200	343	0	1	344	0	0
19	4363170	rs243260	G	T	3	6	9	0	0	9	0	0
19	4364147	.	C	T	152	142	294	0	0	294	0	0
19	4369516	.	T	A	5	1	6	0	1	7	0	0
19	4396177	rs531934260	C	T	6	5	11	0	1	12	0	0
19	4396251	rs243411	C	T	4	4	8	0	0	8	0	0
19	4411442	rs243350	A	G	3	4	7	0	0	7	0	0
19	4412106	rs243352	T	G	4	4	8	0	0	8	0	0
19	4412496	rs243353	G	A	6	2	8	0	1	9	0	0
19	4412713	rs243354	A	G	13	5	18	0	0	18	0	0
19	4413735	rs2267943	C	T	9	11	20	0	0	20	0	0
19	4442336	rs9352	C	T	35	42	77	0	1	78	0	0
19	4442529	rs243382	T	C	4	5	9	0	0	9	0	0
19	4443046	rs2992	T	C	31	42	73	0	0	74	1	0
19	4445073	rs2705	A	G	69	42	111	0	0	111	0	0
19	4445156	rs243387	A	G	123	91	214	0	0	214	0	0
19	4446995	rs243389	C	T	6	9	15	0	0	15	0	0
19	4448843	rs741923	G	A	7	5	12	0	0	12	0	0
19	4449252	rs243390	C	T	10	6	16	0	1	17	0	0
19	4449410	rs2077444	T	C	7	17	24	0	0	24	0	0
19	4450022	.	C	T	11	12	23	0	0	23	0	0
19	4450179	rs243392	A	G	5	4	9	0	0	9	0	0
19	4450325	rs62130984	T	C	4	12	16	0	0	16	0	0
19	4450330	rs62130985	C	A	5	12	17	0	0	17	0	0
19	4451560	rs243394	A	T	5	4	9	0	0	10	1	0
19	4452183	rs59121637	G	A	8	3	11	0	0	11	0	0
19	4452497	rs243395	G	A	8	4	12	0	0	12	0	0
19	4453229	rs243396	C	T	5	4	9	0	0	9	0	0
19	4453235	rs72990638	C	T	5	5	10	0	0	10	0	0
19	4453325	rs411833	G	C	6	5	11	0	0	11	0	0
19	4454000	rs11909	G	A	153	223	376	0	0	376	0	0
19	4457650	rs1044510	C	T	75	51	126	0	1	127	0	0
19	4493708	rs892161	A	G	80	69	149	0	3	152	0	0
19	4496321	.	C	T	85	68	153	0	0	153	0	0
19	4499976	rs10419571	T	C	2	4	6	0	0	6	0	0
19	4502201	rs8887	T	C	7	3	10	0	0	10	0	0
19	4543507	rs80073958	G	A	2	4	6	0	0	6	0	0
19	4545670	rs74328968	T	C	4	2	6	0	0	6	0	0
19	4553153	rs143798361	G	T	6	0	6	0	0	6	0	0
19	4676140	rs10425839	T	G	82	112	194	0	4	198	0	0
19	4678396	rs6510820	G	A	9	10	19	0	0	19	0	0
19	4679754	rs10415374	G	A	3	5	8	0	0	8	0	0
19	4685276	rs10421782	A	C	5	5	10	0	0	10	0	0
19	4687075	rs10415651	T	C	7	8	15	0	0	15	0	0
19	4794257	rs11085099	T	G	92	85	177	0	2	179	0	0
19	4842723	rs10423263	C	T	2	5	7	0	0	7	0	0
19	4845663	rs11672233	G	C	4	4	8	0	0	8	0	0
19	4845795	rs10417784	G	A	2	4	6	0	0	6	0	0
19	4846100	rs9304914	A	G	5	6	11	0	0	11	0	0
19	4846186	rs10405662	T	C	4	4	8	0	1	9	0	0
19	4846349	rs10425773	C	G	4	5	9	0	0	9	0	0
19	4846734	rs12985820	C	T	10	6	16	0	0	16	0	0
19	4846774	rs10401379	A	G	10	6	16	0	0	16	0	0
19	4847713	rs9973235	A	G	423	426	849	0	0	849	0	0
19	4847868	rs10406652	G	A	364	357	721	0	2	723	0	0
19	4847874	rs9304915	A	G	357	352	709	0	2	711	0	0
19	4848396	rs10415336	A	C	5	1	6	0	0	6	0	0
19	4849170	rs10419838	G	A	6	1	7	0	0	7	0	0
19	4851108	rs12979855	G	T	3	3	6	0	0	6	0	0
19	4852106	rs2271058	A	G	374	392	766	0	7	774	1	0
19	4867701	rs262558	G	T	12	18	30	0	2	32	0	0
19	4908307	.	C	T	6	6	12	0	0	12	0	0
19	4910889	rs2261988	G	T	15	9	24	0	0	24	0	0
19	4910924	rs2261986	C	T	18	9	27	0	1	28	0	0
19	4911796	rs17884312	C	T	6	6	12	0	0	12	0	0
19	4913071	rs3786941	G	A	5	5	10	0	0	10	0	0
19	4913648	rs2602709	A	T	4	7	11	0	0	11	0	0
19	4914117	rs4544355	T	C	3	3	6	0	0	6	0	0
19	4914819	rs62112535	T	C	3	3	6	0	0	6	0	0
19	4915447	rs2779165	G	C	15	11	26	0	0	26	0	0
19	4929413	rs2251520	T	C	10	9	19	0	3	22	0	0
19	4929473	rs2123731	A	G	15	13	28	0	0	28	0	0
19	4950770	rs2307213	C	T	24	19	43	0	0	43	0	0
19	4961790	rs403399	A	T	26	12	38	0	0	38	0	0
19	4961791	rs16992727	A	T	25	12	37	0	1	38	0	0
19	4978203	rs388022	T	C	2	8	10	0	0	10	0	0
19	5041178	rs2240678	T	C	49	61	110	0	1	111	0	0
19	5077583	rs2291148	G	A	12	10	22	0	0	22	0	0
19	5077709	rs56772573	C	T	10	8	18	0	0	18	0	0
19	5079078	rs35469100	C	T	10	14	24	0	0	24	0	0
19	5080647	rs11673509	C	T	3	3	6	0	0	6	0	0
19	5110794	rs2613739	A	G	23	20	43	0	0	43	0	0
19	5146582	rs10418208	A	G	3	3	6	0	0	6	0	0
19	5148252	rs10403727	G	A	3	4	7	0	0	7	0	0
19	5152125	.	G	T	42	37	79	0	0	79	0	0
19	5152387	rs2620828	T	C	64	71	135	0	3	138	0	0
19	5152445	rs2613804	T	C	73	67	140	0	2	142	0	0
19	5205718	rs1129626	C	T	4	6	10	0	0	10	0	0
19	5559116	rs12983488	C	T	0	6	6	0	0	6	0	0
19	5588401	.	C	G	54	54	108	0	0	109	1	0
19	5591006	rs4807794	T	C	34	32	66	0	0	66	0	0
19	5591282	rs12971910	G	A	12	11	23	0	0	23	0	0
19	5591735	rs2285963	G	A	26	30	56	0	0	56	0	0
19	5857756	rs55677519	G	A	4	2	6	0	0	6	0	0
19	5866073	rs8101625	A	C	18	10	28	0	0	28	0	0
19	5866585	rs778982	C	T	16	12	28	0	1	29	0	0
19	5866654	rs778983	A	G	18	6	24	0	0	24	0	0
19	5866816	rs28541500	G	A	6	5	11	0	0	11	0	0
19	5866840	rs702065	T	C	6	4	10	0	0	10	0	0
19	5867154	rs140776824	G	A	9	8	17	0	0	17	0	0
19	5867177	rs778970	G	A	10	8	18	0	0	18	0	0
19	5893058	rs12980262	G	A	4	2	6	0	0	6	0	0
19	5895358	rs72989070	C	T	12	2	14	0	0	14	0	0
19	5895561	rs72989073	C	T	7	4	11	0	0	11	0	0
19	5909780	rs420458	T	C	14	10	24	0	0	24	0	0
19	5912464	rs274788	C	T	5	2	7	0	0	7	0	0
19	5912812	rs274786	G	T	7	4	11	0	0	11	0	0
19	5913826	rs274784	C	T	10	1	11	0	0	11	0	0
19	5915151	rs74174355	C	T	14	15	29	0	0	29	0	0
19	5921352	rs274795	G	A	8	2	10	0	0	10	0	0
19	5927096	rs274794	C	T	7	6	13	0	0	13	0	0
19	5932848	rs121742	G	A	2	5	7	0	0	7	0	0
19	5933920	rs274792	C	T	12	15	27	0	0	27	0	0
19	5934233	rs274791	A	G	12	13	25	0	1	26	0	0
19	5936422	rs274790	T	C	8	13	21	0	0	21	0	0
19	5937680	rs6510863	G	C	6	12	18	0	0	18	0	0
19	5949158	rs4807825	C	T	5	5	10	0	0	10	0	0
19	5950384	rs59174308	T	C	3	3	6	0	0	6	0	0
19	6014632	rs12977353	G	A	5	2	7	0	0	7	0	0
19	6042059	rs2288846	C	T	29	23	52	0	1	53	0	0
19	6211876	rs11085164	C	T	23	59	82	0	0	82	0	0
19	6212282	rs11553930	T	G	38	83	121	0	3	124	0	0
19	6214291	rs11669692	A	G	6	11	17	0	0	17	0	0
19	6215448	rs79585949	C	T	15	1	16	0	1	17	0	0
19	6217362	rs117952340	G	A	9	4	13	0	0	13	0	0
19	6220103	rs13346047	T	C	9	4	13	0	0	13	0	0
19	6221751	rs3787070	A	G	3	4	7	0	1	8	0	0
19	6221887	rs3787069	A	G	4	9	13	0	0	13	0	0
19	6222552	rs139655596	C	T	55	36	91	0	0	91	0	0
19	6223974	rs3787066	T	C	5	2	7	0	0	7	0	0
19	6224041	rs117585913	A	G	4	3	7	0	0	7	0	0
19	6224046	rs10415151	T	C	4	3	7	0	0	7	0	0
19	6224780	rs12980100	G	A	5	2	7	0	0	7	0	0
19	6224801	rs142720851	T	C	4	2	6	0	0	6	0	0
19	6224841	rs56787791	T	C	6	0	6	0	0	6	0	0
19	6225896	rs4807064	A	G	6	4	10	0	0	10	0	0
19	6226006	rs4807065	T	A	6	0	6	0	0	6	0	0
19	6226234	rs145815043	A	G	6	5	11	0	0	11	0	0
19	6226262	rs148993445	C	A	6	4	10	0	0	10	0	0
19	6415795	rs8103311	T	C	5	2	7	0	0	7	0	0
19	6416123	rs2305058	A	G	12	5	17	0	0	17	0	0
19	6417350	rs3786689	T	A	4	5	9	0	0	9	0	0
19	6419275	rs2305059	A	G	9	10	19	0	0	19	0	0
19	6441821	rs348340	A	G	6	14	20	0	0	20	0	0
19	6468907	rs35001260	G	A	128	100	228	0	0	228	0	0
19	6535078	.	C	T	81	102	183	0	0	183	0	0
19	6535080	rs2234182	T	C	108	78	186	0	0	186	0	0
19	6535498	rs3865469	T	C	72	70	142	0	1	143	0	0
19	6731057	rs2279624	T	C	95	102	197	0	0	197	0	0
19	6731766	rs1702375	C	A	2	5	7	0	0	7	0	0
19	6737516	rs11539591	C	T	20	19	39	0	1	40	0	0
19	6847035	rs813430	T	C	1	7	8	0	0	8	0	0
19	6849906	rs331677	A	T	5	1	6	0	0	6	0	0
19	6896483	rs330877	G	A	10	14	24	0	0	24	0	0
19	6897464	rs330880	C	G	10	18	28	0	0	28	0	0
19	6901891	rs897738	G	A	7	21	28	0	0	28	0	0
19	6903920	rs443658	A	G	13	21	34	0	2	36	0	0
19	6904137	rs370094	C	T	11	14	25	0	0	25	0	0
19	6913811	rs457857	A	G	15	33	48	0	0	48	0	0
19	6919624	rs373533	A	C	7	25	32	0	1	33	0	0
19	6919753	rs461645	A	G	9	32	41	0	1	42	0	0
19	6921868	rs7256147	G	A	16	5	21	0	0	21	0	0
19	6940189	rs464849	G	C	17	24	41	0	0	41	0	0
19	6940379	rs464056	A	G	9	18	27	0	0	27	0	0
19	6940391	rs457749	A	C	9	15	24	0	0	24	0	0
19	6940409	rs465241	T	C	6	10	16	0	0	16	0	0
19	7083629	rs966591	A	G	7	11	18	0	0	18	0	0
19	7083761	rs8110740	A	G	14	14	28	0	0	28	0	0
19	7084083	rs1541831	G	C	11	10	21	0	0	21	0	0
19	7084307	rs6510944	T	C	13	7	20	0	0	20	0	0
19	7084747	rs2352958	C	T	11	15	26	0	1	27	0	0
19	7085282	rs768488	T	C	5	9	14	0	0	14	0	0
19	7085480	rs768489	T	G	7	13	20	0	0	20	0	0
19	7086971	rs8108545	C	T	5	6	11	0	0	11	0	0
19	7087710	.	A	T	24	13	37	0	3	40	0	0
19	7087712	.	A	T	24	14	38	0	2	40	0	0
19	7087789	rs72986681	G	A	13	10	23	0	0	23	0	0
19	7112593	rs1052371	G	A	18	23	41	0	0	41	0	0
19	7113444	rs77859571	T	C	10	20	30	0	0	30	0	0
19	7115197	rs41315072	G	C	33	34	67	0	1	68	0	0
19	7115493	.	C	T	26	40	66	0	0	66	0	0
19	7115573	rs3745550	C	T	28	38	66	0	0	66	0	0
19	7125900	rs7258944	T	C	5	3	8	0	1	9	0	0
19	7125915	rs10419597	G	A	4	7	11	0	0	11	0	0
19	7141775	rs2229431	G	A	15	23	38	0	0	38	0	0
19	7166376	rs2059806	C	T	22	30	52	0	0	52	0	0
19	7166388	rs2229429	G	A	33	22	55	0	0	55	0	0
19	7184238	rs6510959	G	A	5	3	8	0	1	9	0	0
19	7184243	rs41315074	C	G	6	3	9	0	1	10	0	0
19	7497818	rs76451352	G	A	3	3	6	0	0	6	0	0
19	7504669	rs11668829	C	T	9	1	10	0	0	10	0	0
19	7524846	rs2287914	C	T	60	73	133	0	1	134	0	0
19	7524855	rs2287915	C	T	59	75	134	0	0	134	0	0
19	7532252	rs2303142	G	C	13	18	31	0	0	31	0	0
19	7534075	rs2241396	C	T	9	4	13	0	0	13	0	0
19	7534135	rs2241397	G	A	4	9	13	0	0	13	0	0
19	7534177	rs9677011	G	A	6	7	13	0	0	13	0	0
19	7534192	rs2241398	C	T	7	7	14	0	0	14	0	0
19	7534329	rs35388554	G	A	8	6	14	0	0	14	0	0
19	7534382	rs9677021	G	A	7	5	12	0	0	12	0	0
19	7535249	rs12972299	C	A	35	35	70	0	3	73	0	0
19	7536988	rs3745357	G	A	211	135	346	0	8	354	0	0
19	7537107	rs1043412	G	A	128	110	238	0	5	243	0	0
19	7584223	rs11555037	A	G	46	50	96	0	2	98	0	0
19	7593571	rs61736600	A	C	19	15	34	0	1	35	0	0
19	7593589	rs612862	C	T	17	18	35	0	1	36	0	0
19	7606908	rs17854645	G	C	56	63	119	0	0	119	0	0
19	7615903	rs8107538	G	A	28	42	70	0	0	70	0	0
19	7622360	rs8110625	C	T	4	5	9	0	0	9	0	0
19	7622967	rs11878263	G	A	6	4	10	0	0	10	0	0
19	7623011	rs507814	C	T	4	8	12	0	0	12	0	0
19	7623039	rs11880908	C	T	6	3	9	0	0	9	0	0
19	7685843	rs794078	G	A	163	174	337	0	3	341	1	0
19	7688614	rs2335521	T	C	0	22	22	0	0	22	0	0
19	7691001	rs4134838	G	C	24	21	45	0	0	45	0	0
19	7691465	rs1035465	G	A	26	16	42	0	1	43	0	0
19	7691793	rs794082	C	T	10	10	20	0	0	20	0	0
19	7691949	rs4134831	A	G	23	20	43	0	0	43	0	0
19	7692076	rs4134826	T	C	27	16	43	0	1	44	0	0
19	7692083	rs4134825	G	A	30	13	43	0	0	43	0	0
19	7693751	rs4134816	A	G	9	3	12	0	0	12	0	0
19	7693814	rs4134815	G	A	9	3	12	0	0	12	0	0
19	7694021	rs4134813	A	C	7	5	12	0	0	12	0	0
19	7694393	rs4134809	G	A	70	52	122	0	0	122	0	0
19	7695336	rs3760676	A	G	35	31	66	0	1	67	0	0
19	7695620	rs11260004	T	C	21	17	38	0	0	38	0	0
19	7695977	rs3760677	C	G	21	38	59	0	2	61	0	0
19	7696138	rs11882197	G	A	34	45	79	0	1	80	0	0
19	7698320	rs1862514	C	T	7	0	7	0	0	7	0	0
19	7698653	rs1862515	A	G	5	3	8	0	0	8	0	0
19	7701748	rs7359905	T	C	4	3	7	0	0	7	0	0
19	7702575	rs8103237	G	A	18	8	26	0	0	26	0	0
19	7703605	rs8104339	C	T	11	4	15	0	0	15	0	0
19	7709271	rs3815754	A	G	27	22	49	0	0	49	0	0
19	7709323	.	A	C	40	42	82	0	0	82	0	0
19	7710040	rs929807	T	C	14	7	21	0	0	21	0	0
19	7710210	rs889187	A	G	50	23	73	0	2	75	0	0
19	7710343	rs889185	G	A	27	17	44	0	0	44	0	0
19	7710603	rs889184	C	G	53	26	79	0	0	79	0	0
19	7711221	rs10001	T	C	608	596	1204	0	11	1215	0	0
19	7711629	rs794075	G	A	28	59	87	0	0	87	0	0
19	7712161	rs55954306	C	T	56	36	92	0	1	93	0	0
19	7712193	rs809916	G	A	37	56	93	0	2	95	0	0
19	7712425	rs34976997	G	C	40	24	64	0	0	64	0	0
19	7747293	rs6952	T	G	23	13	36	0	0	36	0	0
19	7747445	rs1053363	G	A	221	252	473	0	0	473	0	0
19	7913974	rs555609	T	C	13	3	16	0	0	16	0	0
19	7969486	rs3810211	C	T	8	19	27	0	0	27	0	0
19	7970082	rs74515633	C	T	14	19	33	0	0	33	0	0
19	7972433	rs11667165	G	A	21	30	51	0	1	52	0	0
19	7972615	rs8107967	A	G	16	20	36	0	1	37	0	0
19	7973396	rs73501919	A	C	16	16	32	0	1	33	0	0
19	7973730	rs73501921	G	A	21	20	41	0	0	41	0	0
19	7973757	rs138358199	C	T	22	19	41	0	0	41	0	0
19	7974555	rs12462788	C	T	13	7	20	0	0	20	0	0
19	7975464	rs11879199	A	C	7	10	17	0	0	17	0	0
19	7986638	rs475002	C	G	20	18	38	0	0	38	0	0
19	7991679	rs7899	T	A	19	26	45	0	0	45	0	0
19	7994169	rs8104881	C	T	10	10	20	0	0	20	0	0
19	7994802	rs34013452	C	T	3	3	6	0	0	6	0	0
19	7995024	rs144875688	G	A	5	2	7	0	0	7	0	0
19	7995031	rs115171526	A	G	6	3	9	0	0	9	0	0
19	7995906	rs4804240	G	A	8	7	15	0	0	15	0	0
19	7995918	rs4804241	C	A	8	5	13	0	0	13	0	0
19	7996789	rs4804242	A	G	2	10	12	0	0	12	0	0
19	7998587	rs78845055	C	T	7	6	13	0	0	13	0	0
19	8024684	rs2042920	A	C	8	6	14	0	0	14	0	0
19	8025491	rs12983784	T	C	5	10	15	0	0	15	0	0
19	8025931	rs77312432	C	T	8	6	14	0	1	15	0	0
19	8026549	rs12985234	A	G	8	6	14	0	0	14	0	0
19	8028544	rs14394	A	G	166	192	358	0	3	361	0	0
19	8032432	rs3826740	G	A	4	2	6	0	0	6	0	0
19	8032680	rs1077340	C	T	7	3	10	0	0	10	0	0
19	8032972	rs1077341	G	A	3	4	7	0	0	7	0	0
19	8033348	rs731604	A	G	4	5	9	0	0	9	0	0
19	8033896	rs17261137	A	G	5	7	12	0	0	12	0	0
19	8039167	rs8105661	G	A	2	4	6	0	0	6	0	0
19	8041373	rs2336091	T	G	4	6	10	0	0	10	0	0
19	8042770	rs79558900	G	T	3	6	9	0	0	9	0	0
19	8043577	rs74662365	G	C	4	2	6	0	0	6	0	0
19	8044610	rs80228866	C	T	3	5	8	0	0	8	0	0
19	8045862	rs75461160	G	A	3	5	8	0	0	8	0	0
19	8047924	rs12978895	G	A	15	5	20	0	0	20	0	0
19	8051646	rs114364310	G	A	6	5	11	0	0	11	0	0
19	8052309	rs11880220	A	G	9	6	15	0	0	15	0	0
19	8053732	rs192471285	G	A	5	4	9	0	0	9	0	0
19	8321937	rs1127912	C	T	80	103	183	0	1	184	0	0
19	8321946	rs36247	T	C	114	73	187	0	4	191	0	0
19	8325616	rs36255	T	A	3	3	6	0	0	6	0	0
19	8326067	rs60517522	C	T	5	2	7	0	1	8	0	0
19	8326866	rs17160348	C	T	81	118	199	0	0	199	0	0
19	8326904	rs36259	G	A	108	82	190	0	5	195	0	0
19	8326944	rs17160349	G	A	90	100	190	0	2	192	0	0
19	8326999	rs1044547	C	T	77	83	160	0	4	164	0	0
19	8384229	rs3097182	A	G	6	3	9	0	0	9	0	0
19	8386701	rs2241590	G	A	43	45	88	0	1	89	0	0
19	8387207	rs1057232	G	A	2339	1013	3352	0	16	3368	0	0
19	8456234	rs3786624	T	G	3	5	8	0	0	8	0	0
19	8457154	rs4267458	C	T	2	8	10	0	0	10	0	0
19	8457347	rs2913975	G	C	4	2	6	0	0	6	0	0
19	8457375	rs2967615	C	T	6	4	10	0	0	10	0	0
19	8458261	rs62117515	G	T	7	1	8	0	0	8	0	0
19	8462639	rs3097188	A	C	3	5	8	0	0	8	0	0
19	8462773	rs2967609	C	A	8	6	14	0	0	14	0	0
19	8463316	rs141903508	G	A	5	3	8	0	0	8	0	0
19	8463460	rs2913971	C	T	5	4	9	0	0	9	0	0
19	8463631	rs7409035	C	T	4	4	8	0	0	8	0	0
19	8463704	.	T	C	3	6	9	0	0	9	0	0
19	8463705	.	G	A	3	6	9	0	0	9	0	0
19	8463708	.	T	C	3	6	9	0	0	9	0	0
19	8464653	rs2913970	G	A	4	3	7	0	0	7	0	0
19	8465991	rs112225432	G	A	3	5	8	0	0	8	0	0
19	8466254	rs10404380	C	A	5	4	9	0	1	10	0	0
19	8467768	rs2967606	A	G	35	33	68	0	0	68	0	0
19	8478250	rs890849	G	C	11	5	16	0	0	16	0	0
19	8529764	rs72998796	G	T	8	9	17	0	0	17	0	0
19	8530049	rs628532	C	G	4	7	11	0	0	11	0	0
19	8531801	rs67296634	T	G	23	17	40	0	1	41	0	0
19	8532219	rs12610448	G	A	14	11	25	0	0	25	0	0
19	8546920	rs1812467	G	A	6	4	10	0	0	10	0	0
19	8548185	.	C	G	15	9	24	0	0	24	0	0
19	8548738	rs34356342	T	C	17	19	36	0	0	36	0	0
19	8552453	rs143973988	C	T	90	59	149	0	3	152	0	0
19	8556363	rs7408912	C	T	6	5	11	0	0	11	0	0
19	8557139	rs2396106	T	G	3	5	8	0	0	8	0	0
19	8557754	rs751180	G	A	7	1	8	0	0	8	0	0
19	8559763	rs34755496	C	T	3	5	8	0	0	8	0	0
19	8565043	rs28527176	A	T	26	2	28	0	0	28	0	0
19	8565119	rs28553436	G	A	30	3	33	0	0	33	0	0
19	8565131	rs60318332	A	G	25	3	28	0	0	28	0	0
19	8567475	rs968502	T	C	29	46	75	0	0	75	0	0
19	8567500	rs968501	G	A	6	16	22	0	0	22	0	0
19	8576307	rs2910443	A	G	14	30	44	0	0	44	0	0
19	8576670	rs7175	C	T	22	30	52	0	2	54	0	0
19	8578000	rs1064010	G	A	70	88	158	0	2	160	0	0
19	8578118	rs1064009	A	G	51	74	125	0	2	127	0	0
19	8578199	rs1141019	T	C	73	81	154	0	1	155	0	0
19	8578388	rs2967580	A	G	11	15	26	0	0	26	0	0
19	8578498	rs2910444	C	T	10	18	28	0	1	29	0	0
19	8579011	rs2287863	T	C	39	39	78	0	0	78	0	0
19	8607949	rs11881473	G	A	8	3	11	0	0	11	0	0
19	8614690	rs59506897	A	G	2	4	6	0	0	6	0	0
19	8614817	rs58706590	C	T	3	3	6	0	0	6	0	0
19	8615609	rs73501537	G	A	7	30	37	0	0	37	0	0
19	8615920	rs2013882	T	C	20	6	26	0	0	26	0	0
19	8616380	rs10409059	C	T	8	16	24	0	0	24	0	0
19	8616383	rs10409874	A	G	8	15	23	0	1	24	0	0
19	8616813	rs56935925	A	T	1	5	6	0	0	6	0	0
19	8618110	rs35778736	G	A	191	81	272	0	3	275	0	0
19	8639817	rs11670066	T	G	2	8	10	0	0	10	0	0
19	8645349	rs116024095	T	C	8	6	14	0	3	17	0	0
19	8920629	rs11787	A	G	14	12	26	0	0	26	0	0
19	8920984	rs2910344	T	C	25	20	45	0	0	45	0	0
19	8921033	rs250316	C	T	22	17	39	0	2	41	0	0
19	8921486	rs1582532	T	C	11	14	25	0	0	25	0	0
19	8932388	rs2967727	G	A	6	4	10	0	0	10	0	0
19	8932524	rs12978839	T	C	5	7	12	0	0	12	0	0
19	8934907	rs2967749	C	T	4	7	11	0	1	12	0	0
19	8942045	rs2972587	C	T	6	1	7	0	0	7	0	0
19	9297874	rs7246654	G	A	0	7	7	0	0	7	0	0
19	9298364	rs6511918	C	T	0	7	7	0	0	7	0	0
19	9402877	rs10422910	T	C	16	16	32	0	0	32	0	0
19	9405068	rs10412061	T	C	10	12	22	0	0	22	0	0
19	9454173	rs13535	A	G	13	12	25	0	1	26	0	0
19	9492141	rs3826783	C	T	3	3	6	0	0	6	0	0
19	9523724	rs10515	A	G	110	138	248	0	0	248	0	0
19	9524185	rs2241356	A	G	94	108	202	0	0	202	0	0
19	9529783	rs1978713	G	C	14	36	50	0	0	50	0	0
19	9530070	rs1978712	T	C	18	19	37	0	0	37	0	0
19	9530081	rs1978711	G	C	19	23	42	0	0	42	0	0
19	9530342	rs2277931	G	A	15	23	38	0	0	38	0	0
19	9530597	rs8109853	G	A	3	5	8	0	1	9	0	0
19	9531116	rs1978435	C	T	12	14	26	0	0	26	0	0
19	9531245	rs1978436	T	C	7	18	25	0	0	25	0	0
19	9531342	rs1978437	A	G	5	14	19	0	0	19	0	0
19	9531393	rs1978438	G	T	4	8	12	0	0	12	0	0
19	9531425	rs28711703	C	G	4	3	7	0	1	8	0	0
19	9531446	rs34450188	A	G	7	5	12	0	0	12	0	0
19	9531541	rs58900528	C	T	7	13	20	0	1	21	0	0
19	9531693	rs11880207	C	T	5	5	10	0	0	10	0	0
19	9532083	rs2112528	G	A	4	5	9	0	0	9	0	0
19	9532156	rs2112529	A	G	5	9	14	0	0	14	0	0
19	9532258	rs8100415	C	T	6	13	19	0	0	19	0	0
19	9532813	rs9783952	A	C	3	5	8	0	0	8	0	0
19	9533805	rs6512121	G	T	8	9	17	0	0	17	0	0
19	9534301	rs7254750	C	T	2	8	10	0	0	10	0	0
19	9534790	rs2335939	T	C	4	10	14	0	0	14	0	0
19	9534804	rs2878569	C	T	4	10	14	0	0	14	0	0
19	9534967	rs7258744	G	A	8	12	20	0	0	20	0	0
19	9534981	rs7246415	A	G	8	12	20	0	0	20	0	0
19	9535016	rs7258874	G	A	7	10	17	0	0	17	0	0
19	9535127	rs56046222	T	G	6	11	17	0	0	17	0	0
19	9535130	rs56221935	T	C	6	12	18	0	0	18	0	0
19	9535242	rs55697133	G	C	5	4	9	0	0	9	0	0
19	9536203	rs10411141	G	A	5	8	13	0	0	13	0	0
19	9536418	rs10406056	C	T	5	7	12	0	1	13	0	0
19	9539522	rs8107606	A	G	3	5	8	0	0	8	0	0
19	9539691	rs8102069	C	T	4	2	6	0	0	6	0	0
19	9541012	rs60618235	C	T	5	10	15	0	0	15	0	0
19	9541161	rs58185583	T	C	3	6	9	0	0	9	0	0
19	9541406	rs58359623	C	G	3	5	8	0	0	8	0	0
19	9541640	rs10404268	A	G	3	6	9	0	0	9	0	0
19	9541833	rs10404721	A	C	6	6	12	0	0	12	0	0
19	9542007	rs11673601	G	T	7	3	10	0	0	10	0	0
19	9545030	rs8108483	C	T	3	3	6	0	0	6	0	0
19	9695008	rs7253981	A	G	3	4	7	0	0	7	0	0
19	9718272	rs10417098	G	A	8	6	14	0	0	14	0	0
19	9718587	rs8100797	T	C	13	9	22	0	0	22	0	0
19	9718692	rs8100913	T	C	5	7	12	0	0	12	0	0
19	9718757	rs8101008	T	C	11	6	17	0	0	17	0	0
19	9720557	rs28750324	G	A	14	5	19	0	0	19	0	0
19	9721401	rs28445940	A	T	25	25	50	0	0	50	0	0
19	9728350	rs10420371	C	T	5	1	6	0	0	6	0	0
19	9731850	rs10401707	A	G	9	6	15	0	0	15	0	0
19	9760075	rs4416136	T	C	35	29	64	0	2	66	0	0
19	9760094	rs12460391	A	G	37	23	60	0	0	60	0	0
19	9760342	rs11880397	A	T	33	43	76	0	0	76	0	0
19	9761410	rs7343078	A	G	17	13	30	0	1	31	0	0
19	9768925	rs10418705	A	G	0	7	7	0	0	7	0	0
19	9924303	rs113328226	A	G	1	6	7	0	1	8	0	0
19	9929038	rs10416236	A	G	13	9	22	0	2	24	0	0
19	9946655	rs4804460	G	A	2	4	6	0	0	6	0	0
19	9959635	rs3745577	G	A	5	2	7	0	0	7	0	0
19	10218524	rs2305791	C	G	50	54	104	0	5	109	0	0
19	10221151	rs2305792	C	G	5	9	14	0	0	14	0	0
19	10222195	rs12460842	A	G	23	37	60	0	1	61	0	0
19	10222558	rs2010353	G	T	11	10	21	0	0	21	0	0
19	10222835	rs1037686	T	A	19	31	50	0	2	52	0	0
19	10223427	rs34484805	A	G	17	23	40	0	1	41	0	0
19	10224526	rs3745600	C	T	26	29	55	0	1	56	0	0
19	10225682	rs3816556	G	C	64	37	101	0	1	102	0	0
19	10225777	rs7401	A	G	559	570	1129	0	9	1138	0	0
19	10226052	rs2305795	G	A	7	15	22	0	0	22	0	0
19	10226256	rs7710	A	G	589	572	1161	0	3	1164	0	0
19	10227010	rs3826784	A	G	34	31	65	0	1	66	0	0
19	10227204	rs3826786	T	C	36	32	68	0	3	71	0	0
19	10229297	rs11667630	C	A	18	17	35	0	0	35	0	0
19	10230032	rs112407609	C	T	5	10	15	0	0	15	0	0
19	10246029	rs8101626	G	A	7	5	12	0	0	12	0	0
19	10249962	rs79772680	C	T	8	5	13	0	0	13	0	0
19	10251747	rs2290684	A	G	19	10	29	0	0	29	0	0
19	10267077	rs2228611	T	C	27	44	71	0	0	71	0	0
19	10284778	rs759920	A	G	4	4	8	0	0	8	0	0
19	10332547	rs55818584	T	A	7	3	10	0	0	10	0	0
19	10367852	rs73015182	T	G	6	5	11	0	0	11	0	0
19	10368050	rs8111930	A	G	7	7	14	0	0	14	0	0
19	10368105	rs76560514	C	A	9	10	19	0	0	19	0	0
19	10370639	rs45504492	G	A	89	88	177	0	2	179	0	0
19	10370654	rs1059849	A	G	69	64	133	0	1	134	0	0
19	10654705	rs10423320	C	T	10	7	17	0	1	18	0	0
19	10658257	rs62128796	T	C	4	4	8	0	0	8	0	0
19	10659316	.	A	G	21	17	38	0	1	39	0	0
19	10659659	rs2304165	C	T	171	157	328	0	3	332	1	0
19	10659737	rs12979378	C	T	11	8	19	0	1	20	0	0
19	10660058	rs34479588	C	A	13	12	25	0	0	25	0	0
19	10663165	rs7255312	C	T	1	6	7	0	0	7	0	0
19	10669163	rs62128801	G	C	14	6	20	0	0	20	0	0
19	10669475	rs62128850	G	A	8	15	23	0	1	24	0	0
19	10671894	rs11545166	T	G	64	53	117	0	1	118	0	0
19	10673340	rs12977138	C	T	5	6	11	0	0	11	0	0
19	10675412	rs3826708	G	A	5	5	10	0	0	10	0	0
19	10675564	rs3745247	C	T	11	7	18	0	0	18	0	0
19	10754400	rs1053007	A	G	127	70	197	0	0	197	0	0
19	10754905	rs10948	G	T	84	47	131	0	0	131	0	0
19	10764203	rs4804514	G	T	30	25	55	0	0	55	0	0
19	10788813	rs6511708	T	C	11	16	27	0	0	27	0	0
19	10793749	rs2738039	A	G	106	103	209	0	3	212	0	0
19	10794630	rs2229383	G	T	565	521	1086	0	0	1087	1	0
19	10794793	rs892087	C	T	11	20	31	0	0	31	0	0
19	10798904	rs2569507	G	A	15	15	30	0	0	30	0	0
19	10799750	rs2742313	T	C	10	13	23	0	0	23	0	0
19	10801185	rs8102380	G	A	128	113	241	0	0	241	0	0
19	10907286	rs34516961	A	G	26	31	57	0	0	57	0	0
19	11163562	rs1529729	C	T	4	3	7	0	0	7	0	0
19	11218226	rs13306513	G	A	2	4	6	0	0	6	0	0
19	11224181	rs1003723	C	T	10	7	17	0	0	17	0	0
19	11227602	rs688	C	T	213	218	431	0	16	447	0	0
19	11228139	rs17248889	C	A	7	3	10	0	0	10	0	0
19	11228159	rs57337419	A	G	5	1	6	0	0	6	0	0
19	11229218	rs2738452	A	G	7	18	25	0	0	25	0	0
19	11229577	rs2915967	T	C	6	2	8	0	0	8	0	0
19	11229968	rs9789302	C	T	6	7	13	0	0	13	0	0
19	11230002	rs9789303	C	T	5	5	10	0	0	10	0	0
19	11230214	rs34554139	T	C	7	3	10	0	0	10	0	0
19	11230645	rs2569549	T	C	3	8	11	0	0	11	0	0
19	11230881	rs5925	T	C	234	228	462	0	3	465	0	0
19	11233605	rs146533684	G	A	4	4	8	0	0	8	0	0
19	11238877	rs2304182	G	A	1	5	6	0	0	6	0	0
19	11238975	rs2304181	C	T	4	4	8	0	0	8	0	0
19	11239439	rs68141833	T	C	5	2	7	0	0	7	0	0
19	11242133	rs3826810	G	A	180	188	368	0	0	368	0	0
19	11242496	rs2738465	G	A	298	283	581	0	9	590	0	0
19	11243735	rs2738467	C	T	249	245	494	0	10	504	0	0
19	11256887	rs10402592	T	C	7	9	16	0	0	16	0	0
19	11257018	rs11557092	T	C	7	13	20	0	0	20	0	0
19	11285277	.	G	A	5	4	9	0	0	9	0	0
19	11303943	rs3745681	A	G	3	4	7	0	0	7	0	0
19	11306265	rs7250778	G	A	1	6	7	0	0	7	0	0
19	11411462	rs12327600	A	G	13	2	15	0	0	15	0	0
19	11411652	rs12327783	C	T	103	14	117	0	0	117	0	0
19	11411744	rs397707	G	A	118	17	135	0	0	135	0	0
19	11411868	rs420703	C	A	104	12	116	0	0	116	0	0
19	11444131	rs896412	C	G	4	5	9	0	0	9	0	0
19	11465316	rs6887	G	C	37	34	71	0	2	73	0	0
19	11559158	rs160841	A	G	8	14	22	0	0	22	0	0
19	11560347	rs755000	T	G	93	98	191	0	4	195	0	0
19	11560753	rs8101357	G	T	102	35	137	0	1	138	0	0
19	11561629	rs8616	T	C	582	682	1264	0	3	1267	0	0
19	11664068	rs8606	A	G	116	98	214	0	3	217	0	0
19	11666492	rs3810313	G	A	8	6	14	0	0	14	0	0
19	11687195	rs2229531	C	T	38	29	67	0	0	67	0	0
19	11687351	rs2305799	C	T	32	32	64	0	3	68	1	0
19	11687908	rs62638747	G	A	28	31	59	0	0	59	0	0
19	11688460	rs2071484	T	C	13	19	32	0	0	32	0	0
19	11709151	rs9807866	T	C	4	8	12	0	0	12	0	0
19	11894535	rs286219	C	G	5	4	9	0	0	9	0	0
19	11925712	rs186218262	G	A	17	12	29	0	0	29	0	0
19	11925715	rs2685675	T	C	17	13	30	0	0	30	0	0
19	11925871	rs2545816	G	A	20	14	34	0	1	35	0	0
19	11927751	rs286249	G	A	3	4	7	0	0	7	0	0
19	11928425	rs286250	A	G	2	6	8	0	0	8	0	0
19	11930059	rs286252	G	C	3	3	6	0	0	6	0	0
19	11932538	rs602574	G	T	4	6	10	0	0	10	0	0
19	11933038	rs386584	A	G	5	3	8	0	0	8	0	0
19	11936962	rs587859	C	A	4	2	6	0	0	6	0	0
19	11937118	rs378030	C	A	6	4	10	0	0	10	0	0
19	11937419	rs2545813	T	C	6	4	10	0	0	10	0	0
19	11937442	rs2685666	G	A	4	4	8	0	0	8	0	0
19	11937769	rs384590	C	T	6	6	12	0	0	12	0	0
19	11938125	rs2685664	G	A	1	5	6	0	0	6	0	0
19	11938141	rs375534	G	A	2	5	7	0	0	7	0	0
19	11938658	rs418266	G	A	6	7	13	0	0	13	0	0
19	11939149	rs432939	G	A	5	3	8	0	0	8	0	0
19	11939779	rs445012	A	G	10	7	17	0	0	17	0	0
19	11939808	rs417093	T	A	8	8	16	0	0	16	0	0
19	11939906	rs406262	A	G	4	8	12	0	0	12	0	0
19	11940234	rs416491	G	A	12	5	17	0	0	17	0	0
19	11940270	rs413333	A	G	13	10	23	0	0	23	0	0
19	11940761	rs406130	G	A	17	14	31	0	0	31	0	0
19	11940863	rs406386	G	A	13	8	21	0	0	21	0	0
19	11941221	rs424132	T	A	23	31	54	0	2	56	0	0
19	11942254	rs448446	C	G	30	42	72	0	0	72	0	0
19	11942362	rs427880	A	G	33	34	67	0	1	68	0	0
19	11942615	rs394416	A	C	28	27	55	0	0	55	0	0
19	11942771	rs436411	G	A	28	33	61	0	0	61	0	0
19	11943823	rs375049	G	A	32	40	72	0	2	74	0	0
19	11944066	rs430965	A	G	50	48	98	0	0	98	0	0
19	11944070	rs381973	A	G	46	45	91	0	3	94	0	0
19	11944322	rs434048	G	A	43	25	68	0	1	69	0	0
19	11944906	rs598006	C	A	1	6	7	0	1	8	0	0
19	11945466	rs2545808	C	T	6	19	25	0	0	25	0	0
19	11945487	rs600636	A	G	8	16	24	0	0	24	0	0
19	11960480	rs10439165	C	T	8	9	17	0	0	17	0	0
19	11960588	rs74181617	T	A	15	1	16	0	0	16	0	0
19	11960619	rs2545820	A	G	14	1	15	0	0	15	0	0
19	11960676	rs74181618	G	C	16	8	24	0	0	24	0	0
19	11972499	rs279211	G	A	4	4	8	0	0	8	0	0
19	12022449	rs11085799	G	C	2	5	7	0	0	7	0	0
19	12055759	rs139155461	A	T	5	3	8	0	0	8	0	0
19	12136032	rs175751	T	G	3	3	6	0	0	6	0	0
19	12189379	rs11670621	C	T	13	15	28	0	0	28	0	0
19	12189707	rs7253123	T	C	51	54	105	0	0	105	0	0
19	12222381	rs1866382	C	G	4	4	8	0	0	8	0	0
19	12355506	rs1047138	C	T	2	4	6	0	0	6	0	0
19	12383090	rs112612717	T	C	18	17	35	0	1	36	0	0
19	12383540	rs56056044	G	C	14	19	33	0	0	33	0	0
19	12384580	rs11879168	T	C	15	23	38	0	0	38	0	0
19	12385848	rs11882046	C	G	24	16	40	0	0	40	0	0
19	12387257	rs73505884	C	T	4	2	6	0	0	6	0	0
19	12387309	rs2438529	A	G	5	3	8	0	0	8	0	0
19	12388942	rs11880121	G	A	6	4	10	0	0	10	0	0
19	12502457	rs4804669	A	G	6	7	13	0	0	13	0	0
19	12562294	rs6511809	A	G	3	20	23	0	0	23	0	0
19	12562319	rs6511810	G	A	3	20	23	0	0	23	0	0
19	12568344	rs2862169	G	T	2	14	16	0	0	16	0	0
19	12572300	rs4804194	G	A	20	18	38	0	1	39	0	0
19	12576049	rs7259240	G	A	12	11	23	0	0	23	0	0
19	12786370	.	G	A	26	25	51	0	0	51	0	0
19	12986350	.	C	T	27	38	65	0	0	65	0	0
19	12989560	rs2293682	G	A	48	39	87	0	1	88	0	0
19	13002400	rs1799918	G	C	3	8	11	0	0	11	0	0
19	13008607	rs1060218	G	T	55	44	99	0	0	99	0	0
19	13010643	rs9384	G	T	18	29	47	0	3	50	0	0
19	13015530	rs17706531	A	G	8	3	11	0	1	12	0	0
19	13017876	rs10451496	C	T	6	1	7	0	0	7	0	0
19	13053034	rs2974751	A	C	22	11	33	0	0	33	0	0
19	13053125	rs2965220	T	C	55	35	90	0	0	90	0	0
19	13054781	rs1049481	G	T	895	1166	2061	0	5	2066	0	0
19	13061569	rs62109870	A	G	7	0	7	0	0	7	0	0
19	13062427	rs45495792	A	G	1	5	6	0	0	6	0	0
19	13062663	rs2974755	C	T	5	3	8	0	0	8	0	0
19	13207146	rs11555273	G	C	108	96	204	0	1	205	0	0
19	13212124	rs1003391	A	G	5	2	7	0	0	7	0	0
19	13248856	rs12981904	T	C	28	24	52	0	0	52	0	0
19	13249244	rs8112067	A	G	55	52	107	0	1	108	0	0
19	13250340	rs8105087	T	A	16	16	32	0	1	33	0	0
19	13263338	rs3760912	C	T	2	4	6	0	0	6	0	0
19	13878063	rs346150	A	G	5	4	9	0	0	9	0	0
19	13883099	rs1469071	A	G	81	82	163	0	0	163	0	0
19	13884312	rs1559153	A	G	36	31	67	0	0	67	0	0
19	13884321	rs1559152	C	T	34	23	57	0	0	57	0	0
19	13884655	rs1128028	G	A	44	30	74	0	0	74	0	0
19	13884724	rs1128030	G	C	68	41	109	0	0	109	0	0
19	13884800	rs1044733	T	C	74	55	129	0	0	129	0	0
19	13885024	rs1044747	T	C	7	20	27	0	0	27	0	0
19	13885127	rs346155	A	G	2	7	9	0	0	9	0	0
19	13885309	rs1128749	C	T	108	103	211	0	0	211	0	0
19	13885437	rs1559149	C	A	2	4	6	0	0	6	0	0
19	13885484	rs10104	A	G	196	186	382	0	6	388	0	0
19	13913706	rs2607273	A	G	6	5	11	0	0	11	0	0
19	13942221	rs3745453	A	G	12	35	47	0	0	47	0	0
19	13942587	rs12610873	G	A	27	73	100	0	2	102	0	0
19	13947292	rs895819	T	C	20	17	37	0	0	37	0	0
19	14038791	rs2305777	C	T	30	24	54	0	0	54	0	0
19	14198730	.	G	A	69	63	132	0	3	135	0	0
19	14200109	rs8062	T	C	35	34	69	0	0	69	0	0
19	14203792	.	A	T	24	3	27	0	20	47	0	0
19	14231243	rs3745464	C	T	9	6	15	0	0	15	0	0
19	14231325	rs8102267	C	G	8	4	12	0	0	12	0	0
19	14231330	rs8102698	A	G	8	4	12	0	0	12	0	0
19	14259125	rs144853952	G	A	32	20	52	0	0	52	0	0
19	14259846	rs3810256	G	A	26	24	50	0	1	51	0	0
19	14260076	rs73509753	C	T	12	9	21	0	0	21	0	0
19	14268799	rs2242222	G	A	14	19	33	0	0	33	0	0
19	14273641	rs3745462	A	G	23	22	45	0	0	45	0	0
19	14274633	rs12463215	G	C	2	4	6	0	0	6	0	0
19	14281976	rs7251822	G	A	16	7	23	0	0	23	0	0
19	14492219	rs28366013	C	A	31	42	73	0	2	75	0	0
19	14500268	rs67426584	G	T	6	4	10	0	0	10	0	0
19	14500303	rs67173128	A	G	11	8	19	0	0	19	0	0
19	14500318	rs67334436	A	G	14	7	21	0	0	21	0	0
19	14500714	rs28672314	C	G	9	11	20	0	0	20	0	0
19	14501544	rs7260110	A	G	11	19	30	0	0	30	0	0
19	14504025	rs35133209	A	G	8	3	11	0	1	12	0	0
19	14504661	rs59179632	T	C	7	6	13	0	1	14	0	0
19	14505748	rs12973667	C	G	20	12	32	0	0	32	0	0
19	14506126	rs10404878	A	C	7	6	13	0	0	13	0	0
19	14506991	rs7251607	A	C	11	14	25	0	0	25	0	0
19	14507307	.	C	T	24	4	28	0	0	28	0	0
19	14508223	rs10412108	A	G	16	12	28	0	0	28	0	0
19	14508385	rs10410071	G	A	16	16	32	0	0	32	0	0
19	14508964	rs7508244	T	C	10	13	23	0	0	23	0	0
19	14509187	rs4517893	A	G	8	12	20	0	0	20	0	0
19	14509397	rs4468742	C	G	4	4	8	0	0	8	0	0
19	14509770	rs7255389	G	C	9	6	15	0	0	15	0	0
19	14522705	.	T	C	30	20	50	0	1	51	0	0
19	14524651	rs8109605	T	C	62	49	111	0	1	112	0	0
19	14582468	rs10846	G	A	311	399	710	0	3	713	0	0
19	14590236	rs3815715	C	T	41	48	89	0	1	90	0	0
19	14600305	rs4926220	C	T	10	0	10	0	0	10	0	0
19	14627050	rs4926222	G	A	4	5	9	0	0	9	0	0
19	14628524	rs743511	C	T	4	4	8	0	0	8	0	0
19	14629150	rs3962158	G	A	94	93	187	0	3	190	0	0
19	14800922	rs4808304	T	C	5	4	9	0	0	9	0	0
19	14811834	rs12982955	G	A	4	3	7	0	0	7	0	0
19	14813060	rs6511960	C	G	2	5	7	0	0	7	0	0
19	14817062	rs4808319	G	A	16	14	30	0	0	30	0	0
19	14817145	rs4809215	G	T	16	17	33	0	0	33	0	0
19	14817548	rs6511961	T	A	42	40	82	0	0	82	0	0
19	14817988	rs10403628	G	A	17	5	22	0	0	22	0	0
19	14818905	rs4807959	T	C	6	11	17	0	1	18	0	0
19	14820112	rs9305047	G	A	5	2	7	0	0	7	0	0
19	14823979	rs71334737	G	C	7	2	9	0	0	9	0	0
19	14825265	rs73014710	G	A	3	3	6	0	0	6	0	0
19	14830553	.	C	T	9	10	19	0	0	19	0	0
19	14830568	rs11666622	G	T	11	10	21	0	0	21	0	0
19	14830749	rs11085909	G	A	10	5	15	0	1	16	0	0
19	14830913	rs10409953	C	G	7	10	17	0	0	17	0	0
19	14834842	rs8106309	C	G	23	9	32	0	0	32	0	0
19	14835078	rs4807988	T	C	6	4	10	0	0	10	0	0
19	14836559	rs11670658	T	C	4	2	6	0	0	6	0	0
19	14837737	rs2335210	T	C	3	4	7	0	0	7	0	0
19	14838131	rs62122560	A	C	7	2	9	0	0	9	0	0
19	14841156	rs79600842	C	T	4	6	10	0	0	10	0	0
19	14841262	rs75046365	C	T	3	3	6	0	1	7	0	0
19	14841392	rs2524367	A	T	6	1	7	0	0	7	0	0
19	14842376	rs2524368	C	T	19	12	31	0	2	33	0	0
19	14842742	rs757295	T	A	13	7	20	0	0	20	0	0
19	14842756	rs2732799	C	T	13	9	22	0	0	22	0	0
19	14843036	rs757296	A	T	10	5	15	0	1	16	0	0
19	14843162	rs757297	A	G	4	2	6	0	0	6	0	0
19	14843292	rs757298	G	C	13	7	20	0	1	21	0	0
19	14843922	rs2732798	C	T	92	135	227	0	0	227	0	0
19	14843988	rs2732797	C	T	75	147	222	0	1	223	0	0
19	14844106	rs74514614	T	C	50	80	130	0	1	131	0	0
19	14844183	rs76272714	C	T	70	81	151	0	0	151	0	0
19	14844564	rs2189389	T	C	67	112	179	0	1	180	0	0
19	14844656	rs2214471	A	G	68	126	194	0	1	195	0	0
19	14844705	rs2214472	C	T	71	119	190	0	0	190	0	0
19	14844775	rs2732796	G	A	67	106	173	0	1	174	0	0
19	14845157	rs117889898	C	G	36	24	60	0	2	62	0	0
19	14845186	rs1079542	C	A	41	19	60	0	0	60	0	0
19	14845215	rs2878368	A	G	36	9	45	0	0	45	0	0
19	14845216	rs2335211	A	C	36	9	45	0	0	45	0	0
19	14845220	rs45551241	C	T	40	8	48	0	0	48	0	0
19	14845377	rs2524369	A	G	34	51	85	0	0	85	0	0
19	14845868	rs2524370	G	A	65	73	138	0	1	139	0	0
19	14845978	rs2524371	T	C	46	78	124	0	0	124	0	0
19	14845979	rs2524372	G	A	43	78	121	0	0	121	0	0
19	14845988	rs2524373	T	C	43	82	125	0	1	126	0	0
19	14846081	rs1468264	T	G	50	54	104	0	1	105	0	0
19	14846335	rs2732794	C	T	43	66	109	0	0	109	0	0
19	14846376	rs1468265	C	T	38	62	100	0	2	102	0	0
19	14846692	rs2732793	C	T	45	108	153	0	1	154	0	0
19	14846897	rs1859257	T	A	44	71	115	0	1	116	0	0
19	14847013	rs1859258	G	C	57	68	125	0	0	125	0	0
19	14848437	.	C	T	4	7	11	0	0	11	0	0
19	14848499	rs2524374	T	C	2	4	6	0	0	6	0	0
19	14852673	rs1029473	T	C	5	3	8	0	0	8	0	0
19	14853498	rs79325746	A	T	3	3	6	0	0	6	0	0
19	14853500	rs74646321	G	A	3	3	6	0	0	6	0	0
19	14853754	rs2732790	T	A	2	4	6	0	0	6	0	0
19	14854034	rs2524379	T	C	8	2	10	0	0	10	0	0
19	14856949	rs2732788	C	A	3	5	8	0	0	8	0	0
19	14857673	rs117913748	C	G	12	7	19	0	0	19	0	0
19	14862278	rs3752187	G	A	58	66	124	0	0	124	0	0
19	14862430	rs2524383	C	G	62	85	147	0	1	148	0	0
19	14866220	rs8107029	G	A	7	4	11	0	0	11	0	0
19	14875388	rs35612307	G	A	76	57	133	0	1	134	0	0
19	14877043	rs2074892	C	T	11	14	25	0	0	25	0	0
19	14883049	rs114892797	A	G	9	3	12	0	0	12	0	0
19	14884397	rs181797042	C	T	6	1	7	0	0	7	0	0
19	14884570	rs151047685	C	T	11	1	12	0	0	12	0	0
19	14884642	rs140982443	T	C	9	0	9	0	0	9	0	0
19	14884751	rs78992533	G	A	84	47	131	0	1	132	0	0
19	14884841	rs41360944	G	A	64	66	130	0	1	131	0	0
19	15226970	rs2074262	G	A	44	37	81	0	0	81	0	0
19	15227030	rs2074263	G	A	42	28	70	0	0	71	1	0
19	15227638	rs875803	A	G	4	5	9	0	0	9	0	0
19	15228178	rs1468198	T	C	5	2	7	0	0	7	0	0
19	15228542	rs7507755	A	G	2	6	8	0	0	8	0	0
19	15229993	rs1131177	A	G	33	38	71	0	0	71	0	0
19	15233581	rs2074265	C	A	19	29	48	0	0	48	0	0
19	15233631	rs2074266	G	A	3	4	7	0	0	7	0	0
19	15235137	rs4808212	A	G	5	9	14	0	0	14	0	0
19	15235147	rs4808213	A	G	3	8	11	0	1	12	0	0
19	15235192	rs4808214	A	G	2	6	8	0	0	8	0	0
19	15235932	rs4141356	G	A	6	6	12	0	0	12	0	0
19	15270583	rs1044123	G	A	34	37	71	0	0	71	0	0
19	15270665	rs1044116	C	T	29	27	56	0	1	57	0	0
19	15270805	rs1044055	C	A	24	31	55	0	0	55	0	0
19	15271135	rs7247906	T	G	9	3	12	0	0	12	0	0
19	15271771	rs1044009	G	A	20	14	34	0	0	34	0	0
19	15285052	rs1044006	T	C	3	3	6	0	0	6	0	0
19	15295134	rs1043996	G	A	6	7	13	0	0	13	0	0
19	15303225	rs3815188	G	A	3	12	15	0	0	15	0	0
19	15359259	rs3787030	G	A	24	30	54	0	1	55	0	0
19	15464920	rs10413241	G	C	155	165	320	0	0	320	0	0
19	15469197	rs7248490	A	G	16	17	33	0	0	33	0	0
19	15470336	.	G	A	3	4	7	0	0	7	0	0
19	15471856	rs4809184	T	C	5	4	9	0	0	9	0	0
19	15474444	rs4273162	A	G	2	5	7	0	0	7	0	0
19	15476559	rs8105207	C	T	4	6	10	0	0	10	0	0
19	15479367	rs9305061	G	A	12	14	26	0	0	26	0	0
19	15485350	rs4809185	C	T	3	6	9	0	0	9	0	0
19	15485829	rs8106751	A	G	3	9	12	0	0	12	0	0
19	15486025	rs8105619	G	C	3	7	10	0	0	10	0	0
19	15486059	rs12611023	T	C	3	8	11	0	0	11	0	0
19	15486216	rs12609449	C	T	7	7	14	0	0	14	0	0
19	15492848	rs2366267	T	C	8	9	17	0	0	17	0	0
19	15493685	rs4305200	C	T	5	2	7	0	0	7	0	0
19	15497486	rs7257091	G	A	7	3	10	0	0	10	0	0
19	15504382	rs4809188	G	A	5	2	7	0	0	7	0	0
19	15506863	rs10411669	C	A	4	3	7	0	0	7	0	0
19	15512720	rs10854143	T	C	3	6	9	0	0	9	0	0
19	15512731	rs10775618	A	G	4	7	11	0	0	11	0	0
19	15513054	rs12972998	G	A	3	4	7	0	0	7	0	0
19	15533821	rs7254099	A	G	76	78	154	0	1	155	0	0
19	15574858	rs78677793	C	T	84	94	178	0	0	178	0	0
19	16185188	rs10414221	C	G	6	9	15	0	0	15	0	0
19	16185371	rs10426103	T	C	9	16	25	0	0	25	0	0
19	16185419	rs10418402	G	T	17	16	33	0	0	33	0	0
19	16185757	rs12609899	T	C	16	9	25	0	0	25	0	0
19	16186030	rs11086022	G	A	14	10	24	0	2	26	0	0
19	16186465	rs8113101	G	T	16	14	30	0	0	30	0	0
19	16186466	rs17554874	G	A	14	15	29	0	0	29	0	0
19	16188323	rs79466985	G	A	31	28	59	0	0	59	0	0
19	16190430	.	G	A	24	34	58	0	0	58	0	0
19	16191960	rs17795627	G	A	43	27	70	0	1	71	0	0
19	16211521	rs116895313	G	T	9	7	16	0	0	16	0	0
19	16254422	rs4321304	T	C	7	7	14	0	0	14	0	0
19	16296409	rs58030759	C	G	48	64	112	0	0	112	0	0
19	16302087	rs11086026	C	T	162	129	291	0	3	294	0	0
19	16339069	rs2305937	G	A	3	7	10	0	0	10	0	0
19	16339715	rs3752797	C	T	111	91	202	0	0	202	0	0
19	16339925	rs3752793	G	A	1	5	6	0	0	6	0	0
19	16343847	rs12984337	T	A	4	2	6	0	0	6	0	0
19	16436262	rs3745318	T	C	51	49	100	0	0	100	0	0
19	16438013	rs15336	C	A	1204	1091	2295	0	5	2300	0	0
19	16438661	rs11086029	T	A	106	38	144	0	0	144	0	0
19	16511171	rs10404237	A	C	6	6	12	0	2	14	0	0
19	16533057	rs1017690	A	C	3	3	6	0	0	6	0	0
19	16536832	rs73511134	T	C	8	7	15	0	0	15	0	0
19	16541062	rs73511137	A	G	3	3	6	0	0	6	0	0
19	16546969	rs17642703	G	A	5	4	9	0	0	9	0	0
19	16547778	rs33914440	C	T	82	96	178	0	1	179	0	0
19	16548375	rs10411936	A	G	4	3	7	0	0	7	0	0
19	16582785	rs7252649	G	T	7	1	8	0	0	8	0	0
19	16628850	rs17029	G	A	73	51	124	0	0	124	0	0
19	16629189	rs7783	A	G	123	115	238	0	1	240	1	0
19	16631322	rs2303119	T	C	7	3	10	0	1	11	0	0
19	16631776	rs8111801	G	C	5	2	7	0	0	7	0	0
19	16634358	rs34208765	C	T	5	8	13	0	0	13	0	0
19	16666101	rs2287869	G	C	55	49	104	0	2	106	0	0
19	16670660	rs11667601	G	A	4	5	9	0	0	9	0	0
19	16675959	.	A	G	3	7	10	0	1	11	0	0
19	16741745	rs10425272	T	C	27	28	55	0	1	56	0	0
19	16743209	rs12461484	G	C	2	4	6	0	0	6	0	0
19	16745915	rs10423599	A	G	4	6	10	0	0	10	0	0
19	17163661	rs2305758	C	T	15	12	27	0	0	27	0	0
19	17194911	rs11882867	G	A	5	1	6	0	0	6	0	0
19	17202746	rs7254827	A	T	1	6	7	0	0	7	0	0
19	17206465	rs6512166	A	G	3	6	9	0	0	9	0	0
19	17207011	rs8109466	G	T	5	5	10	0	0	10	0	0
19	17208445	rs35237811	G	A	5	8	13	0	0	13	0	0
19	17211566	rs10423712	T	A	5	5	10	0	0	10	0	0
19	17212101	rs12461009	T	C	8	4	12	0	0	12	0	0
19	17212992	rs3745349	C	T	149	139	288	0	3	291	0	0
19	17213536	rs7251862	T	C	2	11	13	0	1	14	0	0
19	17213558	rs12977780	A	T	6	8	14	0	0	14	0	0
19	17214051	rs4808566	T	G	15	26	41	0	1	42	0	0
19	17214833	rs140048224	T	C	18	16	34	0	0	34	0	0
19	17215381	rs4808567	G	A	20	15	35	0	2	37	0	0
19	17215648	rs12977269	G	T	30	21	51	0	0	51	0	0
19	17216475	rs7249490	T	C	42	32	74	0	0	74	0	0
19	17216624	rs7246553	A	G	41	26	67	0	0	67	0	0
19	17217207	rs8100351	T	C	28	15	43	0	0	43	0	0
19	17217760	rs10421381	G	C	20	4	24	0	0	24	0	0
19	17218551	rs4808568	A	G	18	15	33	0	0	33	0	0
19	17218970	rs4808569	C	A	14	14	28	0	0	28	0	0
19	17220341	rs8108205	G	A	22	25	47	0	0	47	0	0
19	17220720	rs4808570	G	A	26	26	52	0	1	53	0	0
19	17222367	rs12978739	A	G	3	4	7	0	0	7	0	0
19	17222584	rs1077795	A	G	4	5	9	0	0	9	0	0
19	17222753	rs12978850	C	T	8	5	13	0	0	13	0	0
19	17224672	rs8111636	A	G	7	2	9	0	0	9	0	0
19	17294954	rs3786514	T	C	12	14	26	0	0	26	0	0
19	17295023	rs3786515	A	G	17	7	24	0	0	24	0	0
19	17303774	rs1545620	T	G	118	112	230	0	4	234	0	0
19	17305440	rs1064305	T	C	126	125	251	0	0	251	0	0
19	17310998	rs79115756	C	T	6	1	7	0	0	7	0	0
19	17312992	rs2305765	C	T	206	211	417	0	1	418	0	0
19	17313833	rs2305764	G	A	37	24	61	0	2	63	0	0
19	17314189	rs1811525	C	T	4	8	12	0	0	12	0	0
19	17314254	rs1811524	A	T	1	9	10	0	0	10	0	0
19	17314483	rs921939	G	A	5	9	14	0	0	14	0	0
19	17314874	rs8108998	T	C	8	11	19	0	0	19	0	0
19	17315730	rs6512175	G	A	8	13	21	0	0	21	0	0
19	17315895	rs6512176	G	C	4	12	16	0	0	16	0	0
19	17316253	rs2305763	T	C	3	15	18	0	0	18	0	0
19	17316697	rs12327728	C	G	14	2	16	0	0	16	0	0
19	17316782	rs7248508	T	C	202	154	356	0	3	359	0	0
19	17317252	rs2279002	A	G	5	10	15	0	0	15	0	0
19	17317955	rs8110964	A	G	248	250	498	0	3	502	1	0
19	17320053	rs77426712	G	A	3	3	6	0	0	6	0	0
19	17320884	rs2279001	A	T	13	7	20	0	0	20	0	0
19	17321487	rs12982797	A	G	11	14	25	0	0	25	0	0
19	17329552	rs113809670	C	T	2	7	9	0	0	9	0	0
19	17337871	rs891204	A	G	5	3	8	0	0	8	0	0
19	17337882	rs891203	C	G	5	3	8	0	0	8	0	0
19	17339112	rs14129	G	A	8	15	23	0	0	23	0	0
19	17351535	rs2288539	G	A	12	5	17	0	0	17	0	0
19	17392483	rs7246262	C	G	4	2	6	0	0	6	0	0
19	17394124	rs2363956	T	G	6	6	12	0	0	12	0	0
19	17394504	rs891017	A	C	9	8	17	0	1	18	0	0
19	17395003	rs11086065	A	G	8	4	12	0	0	12	0	0
19	17395055	rs11882562	C	G	5	7	12	0	0	12	0	0
19	17396549	rs751599	T	C	1	8	9	0	0	9	0	0
19	17397481	.	G	T	10	12	22	0	1	23	0	0
19	17397501	rs1465582	T	G	3	14	17	0	1	18	0	0
19	17397700	rs10401700	A	C	16	11	27	0	0	27	0	0
19	17398165	rs8100671	A	G	8	12	20	0	0	20	0	0
19	17398269	rs8103523	A	G	12	10	22	0	0	22	0	0
19	17407597	rs34546260	G	A	9	6	15	0	0	15	0	0
19	17409380	rs12982058	C	T	2	6	8	0	0	8	0	0
19	17430946	.	C	T	96	111	207	0	0	207	0	0
19	17601964	rs142546824	C	T	11	3	14	0	0	14	0	0
19	17611490	rs11879407	T	G	6	1	7	0	0	7	0	0
19	17837507	.	C	T	38	32	70	0	0	70	0	0
19	17937429	rs3008	A	G	55	86	141	0	2	143	0	0
19	17947194	rs3212764	T	C	8	3	11	0	0	11	0	0
19	17947409	rs3212762	A	G	20	16	36	0	0	36	0	0
19	17947546	rs3212760	A	G	22	26	48	0	0	48	0	0
19	18113429	rs1108004	T	C	16	12	28	0	0	28	0	0
19	18170384	rs3746190	G	A	6	9	15	0	0	15	0	0
19	18181569	rs845380	A	G	19	11	30	0	1	31	0	0
19	18234441	rs740691	C	T	10	10	20	0	0	20	0	0
19	18245512	rs2270623	C	T	16	13	29	0	0	29	0	0
19	18255359	rs8108738	G	A	17	21	38	0	0	38	0	0
19	18257750	rs2072490	C	T	21	20	41	0	1	42	0	0
19	18260840	rs112170279	G	C	18	6	24	0	1	25	0	0
19	18285944	rs11554159	G	A	132	129	261	0	3	264	0	0
19	18286546	rs200373	T	A	2	4	6	0	0	6	0	0
19	18288069	rs7125	A	G	115	106	221	0	2	223	0	0
19	18304700	rs874628	A	G	3	4	7	0	0	7	0	0
19	18305824	rs2271881	C	T	8	7	15	0	0	15	0	0
19	18306990	rs17683509	G	C	18	9	27	0	0	27	0	0
19	18307108	rs1044821	C	T	13	27	40	0	0	40	0	0
19	18307468	rs1128099	G	A	3	6	9	0	0	9	0	0
19	18384544	rs1469024	C	T	5	2	7	0	0	7	0	0
19	18390864	rs4393694	A	G	2146	1367	3513	0	233	3750	4	0
19	18418044	rs6792	T	C	233	223	456	0	4	460	0	0
19	18472883	.	C	A	3	3	6	0	1	7	0	0
19	18474542	rs3746185	C	T	38	67	105	0	0	105	0	0
19	18474705	rs3746183	C	A	18	19	37	0	0	37	0	0
19	18474937	rs187297347	T	G	6	8	14	0	0	14	0	0
19	18475073	rs73009442	C	A	10	13	23	0	0	23	0	0
19	18475146	rs10854165	A	G	8	14	22	0	1	23	0	0
19	18475285	rs4808787	A	G	11	6	17	0	0	17	0	0
19	18475308	rs4808788	C	T	12	12	24	0	0	24	0	0
19	18477814	rs11881403	G	A	9	4	13	0	0	13	0	0
19	18477854	rs146176851	T	C	6	6	12	0	0	12	0	0
19	18479019	rs28568614	A	G	11	9	20	0	0	20	0	0
19	18479047	rs12610811	C	G	8	7	15	0	0	15	0	0
19	18479647	rs749451	T	C	28	22	50	0	0	50	0	0
19	18480171	rs1043063	C	T	46	23	69	0	0	69	0	0
19	18480609	rs7226	C	T	134	75	209	0	0	209	0	0
19	18502075	rs12461382	C	T	3	6	9	0	0	9	0	0
19	18502217	rs62122433	C	T	5	3	8	0	0	8	0	0
19	18536416	rs8106096	C	G	6	3	9	0	0	9	0	0
19	18537320	rs79986518	G	C	3	3	6	0	0	6	0	0
19	18538742	rs10405636	A	C	164	140	304	0	1	305	0	0
19	18545341	rs10442	A	C	99	104	203	0	1	205	1	0
19	18545540	rs2385088	A	G	5	4	9	0	0	9	0	0
19	18545786	.	G	T	83	61	144	0	0	144	0	0
19	18546678	rs2303697	T	C	83	67	150	0	2	152	0	0
19	18547305	rs4595905	T	A	13	5	18	0	0	18	0	0
19	18554972	rs1043327	A	G	118	123	241	0	0	241	0	0
19	18556749	rs34053595	T	C	2	5	7	0	0	7	0	0
19	18557657	rs2303692	C	T	4	2	6	0	0	6	0	0
19	18562624	rs2303695	C	T	7	7	14	0	0	14	0	0
19	18563880	rs10405479	G	A	14	3	17	0	0	17	0	0
19	18564705	rs8107367	A	G	13	10	23	0	0	23	0	0
19	18565039	rs8107743	A	G	7	2	9	0	0	9	0	0
19	18566804	rs1806980	T	G	8	0	8	0	0	8	0	0
19	18567555	rs2007981	C	A	2	6	8	0	0	8	0	0
19	18650692	rs11086113	C	T	4	5	9	0	0	9	0	0
19	18650967	rs191235067	G	C	4	6	10	0	0	10	0	0
19	18652844	rs10854166	A	G	5	5	10	0	0	10	0	0
19	18669883	rs3803917	T	C	6	5	11	0	0	11	0	0
19	18671055	rs2058077	C	T	17	20	37	0	0	37	0	0
19	18672631	rs181706769	C	A	4	2	6	0	0	6	0	0
19	18679379	rs7648	C	G	144	127	271	0	1	272	0	0
19	18685964	rs6554	G	T	2826	1974	4800	0	18	4818	0	0
19	18686587	rs7258573	T	C	17	26	43	0	0	43	0	0
19	18686621	rs7254004	G	A	17	25	42	0	0	42	0	0
19	18686810	rs11672297	C	T	15	13	28	0	0	28	0	0
19	18687175	rs10425018	T	C	18	20	38	0	0	38	0	0
19	18687533	rs12608925	G	T	15	14	29	0	0	29	0	0
19	18688027	rs12150991	C	T	31	26	57	0	1	58	0	0
19	18699815	rs202026240	C	G	45	82	127	0	1	128	0	0
19	18699990	rs2074174	T	C	27	18	45	0	2	47	0	0
19	18700047	rs2074175	A	G	36	24	60	0	1	61	0	0
19	18703077	rs3170474	T	C	108	63	171	0	0	171	0	0
19	18749727	rs12974161	C	G	7	2	9	0	1	10	0	0
19	18749916	rs4808145	T	C	5	2	7	0	0	7	0	0
19	18750165	rs4808146	C	T	4	2	6	0	0	6	0	0
19	18750442	rs71332133	A	G	7	2	9	0	0	9	0	0
19	18775077	rs1076235	C	T	3	9	12	0	0	12	0	0
19	18778445	rs10421503	C	G	10	2	12	0	0	12	0	0
19	18883593	rs2240012	C	T	4	4	8	0	0	8	0	0
19	18883783	rs2240013	G	A	4	2	6	0	0	6	0	0
19	18888150	rs78830644	C	T	26	16	42	0	0	42	0	0
19	18889702	rs8104411	C	T	2	7	9	0	1	10	0	0
19	18891289	.	G	A	7	9	16	0	1	17	0	0
19	18892728	rs10038	C	A	11	9	20	0	0	20	0	0
19	18959209	rs1024446	G	A	2	5	7	0	0	7	0	0
19	18962061	rs2238654	G	A	5	3	8	0	0	8	0	0
19	18968688	rs112417484	G	T	11	11	22	0	1	23	0	0
19	18970732	rs4808861	A	G	17	15	32	0	0	32	0	0
19	18971322	rs757115	T	C	10	10	20	0	0	20	0	0
19	18974059	rs2238657	G	C	4	2	6	0	0	6	0	0
19	19011244	rs1127821	T	C	407	364	771	0	4	775	0	0
19	19016785	rs73003085	G	A	15	10	25	0	0	25	0	0
19	19017862	rs10330	G	A	336	327	663	0	2	665	0	0
19	19018614	rs73003087	C	T	44	39	83	0	0	83	0	0
19	19018866	rs758032	A	G	27	32	59	0	0	59	0	0
19	19019800	rs73003090	G	A	19	9	28	0	0	28	0	0
19	19020456	rs62138067	T	C	13	26	39	0	0	39	0	0
19	19021002	rs35514173	T	C	22	14	36	0	0	36	0	0
19	19021010	rs78890951	C	T	12	20	32	0	1	33	0	0
19	19022007	rs1468462	C	A	12	7	19	0	0	20	1	0
19	19023853	rs3177137	T	C	324	307	631	0	3	634	0	0
19	19023917	rs369204587	G	C	6	8	14	0	0	14	0	0
19	19030689	rs2231993	C	G	1	5	6	0	0	6	0	0
19	19032219	.	C	T	4	4	8	0	0	8	0	0
19	19033089	rs2158004	G	A	4	2	6	0	0	6	0	0
19	19035811	rs79331030	G	A	34	14	48	0	0	48	0	0
19	19036110	rs111304645	A	G	6	8	14	0	0	14	0	0
19	19038071	rs739577	C	T	9	11	20	0	0	20	0	0
19	19039698	rs16995785	G	C	5	2	7	0	0	7	0	0
19	19120591	rs55722325	A	T	12	7	19	0	0	19	0	0
19	19303802	rs1050483	T	C	69	65	134	0	1	135	0	0
19	19304899	rs34282046	G	C	99	115	214	0	0	214	0	0
19	19366643	rs17216041	G	A	2	5	7	0	0	7	0	0
19	19366927	rs56044734	G	A	0	9	9	0	0	9	0	0
19	19387356	rs2010506	C	T	15	16	31	0	0	31	0	0
19	19390185	rs11555053	G	A	45	34	79	0	0	79	0	0
19	19413092	rs17751061	C	T	29	22	51	0	0	51	0	0
19	19434350	rs7254230	C	T	4	3	7	0	0	7	0	0
19	19440428	rs1009136	A	G	4	2	6	0	0	6	0	0
19	19443986	rs2011503	T	C	5	3	8	0	0	8	0	0
19	19446936	rs769267	G	A	42	32	74	0	1	75	0	0
19	19449686	rs2074090	G	T	58	51	109	0	2	111	0	0
19	19457908	rs2905421	A	C	10	7	17	0	0	17	0	0
19	19467085	rs756997	G	C	74	68	142	0	2	144	0	0
19	19467937	rs2285627	T	C	91	102	193	0	1	194	0	0
19	19468710	rs13964	C	G	39	38	77	0	0	77	0	0
19	19468734	rs15622	G	A	42	38	80	0	0	80	0	0
19	19603692	rs4808964	C	A	5	4	9	0	0	9	0	0
19	19604206	rs11671253	C	T	3	10	13	0	0	13	0	0
19	19605348	rs2288852	T	C	3	12	15	0	0	15	0	0
19	19605763	rs1865034	C	T	9	4	13	0	0	13	0	0
19	19606634	rs1047361	G	A	149	138	287	0	4	291	0	0
19	19616742	rs1063966	G	A	90	111	201	0	3	204	0	0
19	19616953	rs1054284	T	G	164	144	308	0	5	313	0	0
19	19617017	rs34667451	C	T	198	171	369	0	3	372	0	0
19	19617655	rs6626	T	C	163	177	340	0	0	340	0	0
19	19619317	rs10282	T	C	22	15	37	0	0	37	0	0
19	19619542	rs6909	A	G	20	4	24	0	0	24	0	0
19	19637437	rs111406321	G	A	12	7	19	0	0	19	0	0
19	19637781	rs75453386	C	T	7	7	14	0	0	14	0	0
19	19638218	rs75525243	G	A	20	23	43	0	0	43	0	0
19	19638743	rs45631651	A	G	9	12	21	0	0	21	0	0
19	19643636	rs8100927	C	G	2	9	11	0	0	11	0	0
19	19643715	rs8101219	G	A	3	5	8	0	0	8	0	0
19	19644402	rs4808968	C	T	5	1	6	0	0	6	0	0
19	19647460	rs4808969	C	T	5	4	9	0	1	10	0	0
19	19652776	rs77616520	G	A	7	0	7	0	0	7	0	0
19	19652982	rs77427798	T	C	9	0	9	0	0	9	0	0
19	19653524	rs34067609	G	A	7	1	8	0	0	8	0	0
19	19654117	rs7252453	G	C	24	0	24	0	0	24	0	0
19	19654189	rs45556231	G	A	29	2	31	0	0	31	0	0
19	19655670	rs11669558	C	T	13	1	14	0	0	14	0	0
19	19656615	rs61744761	C	T	42	3	45	0	1	46	0	0
19	19657198	rs1036215	C	T	45	4	49	0	1	50	0	0
19	19675087	rs55955356	T	C	1	8	9	0	0	9	0	0
19	19675367	rs8108705	G	T	2	41	43	0	1	44	0	0
19	19677010	rs8113221	C	T	1	10	11	0	0	11	0	0
19	19679266	.	C	A	13	3	16	0	2	18	0	0
19	19679461	rs8103250	A	G	2	12	14	0	0	14	0	0
19	19680650	rs6511041	C	T	0	6	6	0	0	6	0	0
19	19706214	rs76133364	C	A	0	7	7	0	1	8	0	0
19	19734539	rs1054685	C	T	53	264	317	0	0	317	0	0
19	19738554	rs873870	G	A	4	45	49	0	1	50	0	0
19	19740729	rs880090	C	G	163	230	393	0	1	394	0	0
19	19742751	rs11879838	G	C	0	8	8	0	0	8	0	0
19	19743098	rs12609436	C	T	3	8	11	0	1	12	0	0
19	19744452	rs7248200	C	T	3	10	13	0	0	13	0	0
19	19745479	rs12003	C	T	129	190	319	0	5	324	0	0
19	19750822	rs45458192	C	T	2	6	8	0	0	8	0	0
19	19753292	rs7248885	G	A	1	9	10	0	0	10	0	0
19	19754149	rs4808975	G	C	23	14	37	0	0	37	0	0
19	19768474	rs11667828	T	G	5	9	14	0	0	14	0	0
19	19769157	rs10415278	C	A	1	5	6	0	0	6	0	0
19	19769279	rs77441419	G	A	3	3	6	0	0	6	0	0
19	19769688	rs117407941	G	A	4	2	6	0	0	6	0	0
19	19769690	rs28635562	C	T	2	4	6	0	0	6	0	0
19	19784891	rs7253821	G	A	4	3	7	0	0	7	0	0
19	19792050	rs10401926	A	G	9	10	19	0	1	20	0	0
19	19792250	rs11670710	C	A	6	4	10	0	0	10	0	0
19	19820688	rs59067721	C	A	1	5	6	0	0	6	0	0
19	19821825	rs3207975	T	C	176	106	282	0	1	283	0	0
19	19822049	rs7246866	T	C	187	84	271	0	3	274	0	0
19	19826240	rs2013571	C	G	35	16	51	0	0	51	0	0
19	19827724	rs56167115	C	T	27	17	44	0	0	44	0	0
19	19827898	rs73006760	G	A	25	11	36	0	0	36	0	0
19	19827948	rs73006763	C	T	27	10	37	0	0	37	0	0
19	19830928	rs11665940	C	T	8	7	15	0	1	16	0	0
19	19831815	rs55882648	G	A	3	7	10	0	0	10	0	0
19	19843036	rs1979263	T	A	6	5	11	0	0	11	0	0
19	19887427	.	G	A	5	2	7	0	1	8	0	0
19	19887578	rs248945	A	C	4	6	10	0	0	10	0	0
19	19896767	rs11085277	G	C	5	6	11	0	0	11	0	0
19	19900984	rs12710110	A	G	1	5	6	0	0	6	0	0
19	19902916	rs16996360	A	G	5	5	10	0	0	10	0	0
19	19904269	rs3087767	T	A	12	12	24	0	0	24	0	0
19	19905169	rs72620573	A	C	12	14	26	0	0	26	0	0
19	19931466	rs62135269	G	C	8	2	10	0	0	10	0	0
19	19976988	rs60745231	G	A	5	4	9	0	0	9	0	0
19	20003109	rs8106559	A	G	5	5	10	0	0	10	0	0
19	20003576	rs12460570	C	G	6	4	10	0	0	10	0	0
19	20020876	rs8108528	T	C	1	9	10	0	0	10	0	0
19	20021046	rs13344370	C	T	0	10	10	0	0	10	0	0
19	20044041	rs12151060	G	T	2	5	7	0	0	7	0	0
19	20046147	rs1048421	G	A	12	8	20	0	0	20	0	0
19	20150175	rs2286922	G	C	4	9	13	0	0	13	0	0
19	20150247	rs2286923	A	C	4	8	12	0	0	12	0	0
19	20236515	rs141174363	A	C	6	4	10	0	0	10	0	0
19	20726011	rs57449077	G	A	5	1	6	0	0	6	0	0
19	20726622	rs33929	T	C	5	5	10	0	0	10	0	0
19	20726660	rs117333127	G	A	2	5	7	0	0	7	0	0
19	20727144	rs7246874	A	G	8	7	15	0	0	15	0	0
19	20727463	rs10411329	T	C	12	6	18	0	0	18	0	0
19	20727932	rs33926	G	A	5	9	14	0	1	15	0	0
19	20822307	rs73008355	A	G	2	4	6	0	0	6	0	0
19	20823585	rs11879682	T	C	3	3	6	0	0	6	0	0
19	20825552	rs74182981	C	T	4	7	11	0	0	11	0	0
19	20826678	rs959420	A	T	7	7	14	0	0	14	0	0
19	20826692	rs959419	G	T	8	5	13	0	0	13	0	0
19	20826870	rs10425463	G	A	7	5	12	0	0	12	0	0
19	20826976	rs10425311	C	A	6	6	12	0	0	12	0	0
19	20827005	rs10425331	C	T	3	7	10	0	0	10	0	0
19	20990455	rs8112535	C	T	2	4	6	0	0	6	0	0
19	21124229	.	C	T	0	9	9	0	0	9	0	0
19	21125710	rs12983551	T	A	8	0	8	0	0	8	0	0
19	21203552	rs2081054	C	T	30	34	64	0	1	65	0	0
19	21217348	.	T	C	8	5	13	0	0	13	0	0
19	21220003	rs4365405	C	T	5	7	12	0	1	13	0	0
19	21241537	rs10409844	T	A	13	14	27	0	0	27	0	0
19	21300462	rs2884554	A	G	14	8	22	0	2	24	0	0
19	21301211	rs8100289	C	T	11	12	23	0	0	23	0	0
19	21302906	rs7253950	A	G	7	3	10	0	0	10	0	0
19	21302948	rs7254302	G	A	7	3	10	0	0	10	0	0
19	21305337	rs10405406	A	G	3	6	9	0	0	9	0	0
19	21308048	rs8101222	C	G	8	4	12	0	0	12	0	0
19	21474173	rs488125	G	A	8	2	10	0	0	10	0	0
19	21474935	rs28688205	C	T	6	10	16	0	0	16	0	0
19	21477379	rs504280	C	T	20	7	27	0	0	27	0	0
19	21477431	rs1781873	T	C	7	13	20	0	0	20	0	0
19	21503891	rs11882553	A	C	13	8	21	0	0	21	0	0
19	21506719	rs514390	T	C	2	5	7	0	0	7	0	0
19	21541806	rs2012013	T	C	3	4	7	0	0	7	0	0
19	21544571	rs1142653	G	A	26	30	56	0	0	56	0	0
19	21554932	rs2434997	T	C	5	4	9	0	0	9	0	0
19	21556717	rs8103411	A	T	3	3	6	0	0	6	0	0
19	21556721	rs8103417	A	C	5	3	8	0	0	8	0	0
19	21556754	rs7249636	G	A	4	6	10	0	0	10	0	0
19	21580012	rs62110379	T	G	5	6	11	0	0	11	0	0
19	21584998	rs62110417	T	C	4	3	7	0	0	7	0	0
19	21586797	rs7249412	C	T	2	4	6	0	0	6	0	0
19	21587918	rs7254059	G	T	2	5	7	0	0	7	0	0
19	21596327	rs35773446	G	A	6	1	7	0	0	7	0	0
19	21623795	rs7258211	C	T	4	3	7	0	1	8	0	0
19	21626717	rs8102252	A	T	4	2	6	0	0	6	0	0
19	21629709	rs8101077	T	C	12	10	22	0	0	22	0	0
19	21630108	rs35994743	C	T	11	10	21	0	0	21	0	0
19	21630768	rs9973240	C	T	6	3	9	0	0	9	0	0
19	21631409	rs924487	T	G	9	4	13	0	0	13	0	0
19	21637189	rs8107940	G	A	8	5	13	0	0	13	0	0
19	21639247	rs57841525	A	G	4	3	7	0	0	7	0	0
19	21645037	rs7258523	T	C	2	6	8	0	0	8	0	0
19	21908053	rs7252798	C	T	8	5	13	0	0	13	0	0
19	21909948	rs7246400	G	A	11	8	19	0	0	20	1	0
19	21949941	rs113106400	C	T	3	7	10	0	0	10	0	0
19	22033974	rs78138759	A	G	6	8	14	0	0	14	0	0
19	22153495	rs2359812	A	T	0	6	6	0	0	6	0	0
19	22172887	rs80045812	C	T	0	7	7	0	0	7	0	0
19	22187760	rs2359815	C	A	0	7	7	0	0	7	0	0
19	22243422	rs10423881	G	A	4	8	12	0	0	12	0	0
19	22246913	rs8104144	T	C	3	8	11	0	0	11	0	0
19	22246952	rs8103518	G	C	3	6	9	0	0	9	0	0
19	22272397	rs62111028	A	T	6	0	6	0	0	6	0	0
19	22272615	rs10417916	T	C	9	0	9	0	0	9	0	0
19	22846788	rs11672238	C	A	3	7	10	0	0	10	0	0
19	23541472	rs295368	A	G	2	4	6	0	0	6	0	0
19	23541668	rs6511433	G	A	7	8	15	0	0	15	0	0
19	23542697	rs1821845	G	C	7	5	12	0	1	13	0	0
19	23543834	rs7255296	C	T	7	10	17	0	0	17	0	0
19	24219062	rs62117630	G	A	8	2	10	0	0	10	0	0
19	24219150	rs62117631	C	T	10	0	10	0	0	10	0	0
19	24219582	rs62117634	G	A	6	2	8	0	0	8	0	0
19	24219591	rs62117635	A	G	6	2	8	0	0	8	0	0
19	24219702	rs62117636	A	G	11	1	12	0	0	12	0	0
19	24219710	rs62117637	T	C	9	1	10	0	0	10	0	0
19	24219891	rs62117638	C	A	15	2	17	0	0	17	0	0
19	24219911	rs4932937	A	G	15	2	17	0	0	17	0	0
19	24220055	rs62117084	C	G	13	0	13	0	0	13	0	0
19	24220141	rs62117085	C	T	9	0	9	0	0	9	0	0
19	24220662	rs60068057	C	T	8	0	8	0	0	8	0	0
19	24221089	rs56381451	T	A	8	1	9	0	0	9	0	0
19	24221367	rs62113663	T	C	6	1	7	0	0	7	0	0
19	24221600	rs67405910	G	A	13	1	14	0	0	14	0	0
19	24221608	rs76920684	C	G	13	1	14	0	0	14	0	0
19	24221611	rs80169432	C	T	14	1	15	0	0	15	0	0
19	24221728	rs67381910	G	C	14	0	14	0	1	15	0	0
19	24222128	rs11880244	T	G	11	0	11	0	0	11	0	0
19	24222527	rs17712357	G	A	7	0	7	0	0	7	0	0
19	24222941	rs62113664	A	T	13	0	13	0	0	13	0	0
19	24223014	rs11881036	T	C	16	1	17	0	0	17	0	0
19	24223459	rs11878835	G	T	13	0	13	0	0	13	0	0
19	24223677	rs66513379	A	G	6	0	6	0	0	6	0	0
19	24229034	rs60391135	A	G	31	31	62	0	1	63	0	0
19	24229035	rs58473362	A	C	31	31	62	0	1	63	0	0
19	24231784	rs62113757	G	A	3	9	12	0	0	12	0	0
19	24232295	rs62113758	C	T	16	17	33	0	0	33	0	0
19	24238802	rs62114778	C	G	0	10	10	0	0	10	0	0
19	24238842	rs17206060	T	C	0	11	11	0	0	11	0	0
19	24238983	rs61438161	G	A	0	9	9	0	0	9	0	0
19	24238997	rs56171623	C	G	0	8	8	0	0	8	0	0
19	24302289	rs7252482	T	C	5	1	6	0	0	6	0	0
19	28223779	rs10401429	T	C	10	5	15	0	0	15	0	0
19	28284220	rs2286904	G	T	5	6	11	0	0	11	0	0
19	28284257	rs111428230	C	G	5	3	8	0	0	8	0	0
19	30100319	rs3786516	T	A	8	5	13	0	0	13	0	0
19	30506355	rs11555953	A	C	11	25	36	0	1	37	0	0
19	31769763	rs12461253	G	A	4	37	41	0	0	41	0	0
19	31829903	rs924150	A	C	5	1	6	0	0	6	0	0
19	31837703	rs4146210	C	A	3	3	6	0	0	6	0	0
19	32874722	rs7248160	T	A	13	16	29	0	0	29	0	0
19	32877125	rs12596	G	A	25	20	45	0	0	45	0	0
19	32903654	rs61407864	G	A	4	2	6	0	0	6	0	0
19	32930069	rs6510249	G	A	8	3	11	0	0	11	0	0
19	32976532	rs17692367	T	G	1	9	10	0	0	10	0	0
19	33072102	rs75928255	C	G	6	4	10	0	0	10	0	0
19	33072118	rs11084660	C	G	13	33	46	0	0	46	0	0
19	33096786	rs7247420	G	A	9	13	22	0	0	22	0	0
19	33096816	rs7248273	C	T	10	10	20	0	0	20	0	0
19	33098632	rs2302970	G	C	9	5	14	0	0	14	0	0
19	33110204	rs2287669	T	C	14	12	26	0	1	27	0	0
19	33117666	rs6510271	T	C	11	11	22	0	0	22	0	0
19	33182320	rs881273	G	A	10	11	21	0	0	21	0	0
19	33185013	rs4805802	A	G	4	6	10	0	0	10	0	0
19	33185745	rs6510278	A	G	7	9	16	0	0	16	0	0
19	33203675	rs11879169	A	G	21	35	56	0	1	57	0	0
19	33368293	rs11670695	C	T	1	5	6	0	0	6	0	0
19	33370070	rs745961	A	G	8	4	12	0	0	12	0	0
19	33370084	rs745960	T	A	8	8	16	0	0	16	0	0
19	33370161	rs745959	A	C	8	9	17	0	0	17	0	0
19	33414420	rs4805825	A	G	3	7	10	0	0	10	0	0
19	33459996	rs1133771	C	T	7	6	13	0	0	13	0	0
19	33460113	rs9676744	T	G	7	4	11	0	0	11	0	0
19	33460437	rs11084685	A	G	3	9	12	0	0	12	0	0
19	33460476	rs4570989	G	A	8	2	10	0	0	10	0	0
19	33460536	rs2404713	A	G	9	3	12	0	0	12	0	0
19	33460933	rs7258961	T	C	1	9	10	0	0	10	0	0
19	33463245	rs11084686	A	G	5	4	9	0	1	10	0	0
19	33467357	rs2304102	G	A	6	0	6	0	0	6	0	0
19	33467515	rs3816032	T	C	8	8	16	0	0	16	0	0
19	33467576	rs7258185	G	A	8	10	18	0	0	18	0	0
19	33468067	rs4805025	C	T	7	0	7	0	0	7	0	0
19	33868013	rs1469084	A	G	7	7	14	0	0	14	0	0
19	33873435	rs2772	T	G	30	31	61	0	0	61	0	0
19	33882222	rs17569	G	A	37	18	55	0	0	55	0	0
19	34666389	rs580137	A	G	9	3	12	0	0	12	0	0
19	34691449	rs520194	T	C	3	4	7	0	0	7	0	0
19	34695649	rs540367230	A	T	5	4	9	0	1	10	0	0
19	34710817	rs59123546	A	G	1	6	7	0	0	7	0	0
19	34711340	rs612469	G	C	6	9	15	0	0	15	0	0
19	34714464	rs71351753	C	G	7	8	15	0	0	15	0	0
19	34715115	rs12972585	T	C	1	5	6	0	0	6	0	0
19	34715193	rs12978747	G	A	1	6	7	0	0	7	0	0
19	34717674	rs670286	T	G	1	5	6	0	0	6	0	0
19	34717913	rs502810	A	G	5	2	7	0	0	7	0	0
19	34882977	.	G	C	4	12	16	0	0	16	0	0
19	34882985	.	A	C	4	12	16	0	0	16	0	0
19	34883100	.	T	G	12	1	13	0	1	14	0	0
19	34883104	.	T	A	14	1	15	0	1	16	0	0
19	34883110	.	C	A	15	0	15	0	0	15	0	0
19	34883112	.	C	A	15	0	15	0	0	15	0	0
19	34883113	.	C	A	15	0	15	0	0	16	1	0
19	34883114	.	T	G	14	0	14	0	2	16	0	0
19	34883127	.	A	G	17	0	17	0	0	17	0	0
19	34883144	.	A	G	21	0	21	0	0	21	0	0
19	35175592	rs10425561	G	A	13	2	15	0	1	16	0	0
19	35175749	rs10401309	C	G	13	4	17	0	0	17	0	0
19	35176555	rs34929244	C	T	17	7	24	0	0	24	0	0
19	35176752	rs7249792	C	G	22	6	28	0	1	29	0	0
19	35340270	rs1045259	T	C	37	34	71	0	0	71	0	0
19	35351129	rs2546050	A	G	19	10	29	0	0	29	0	0
19	35351132	rs12462218	C	T	18	10	28	0	0	28	0	0
19	35351146	rs12462075	G	C	16	8	24	0	0	24	0	0
19	35351243	rs8107224	A	T	8	6	14	0	0	14	0	0
19	35351253	rs8107230	A	G	8	6	14	0	0	14	0	0
19	35351389	rs36111289	C	T	8	13	21	0	0	21	0	0
19	35449486	rs34687332	T	C	22	30	52	0	0	52	0	0
19	35495400	rs73038362	G	A	5	5	10	0	0	10	0	0
19	35513599	.	A	G	5	4	9	0	0	9	0	0
19	35531222	rs41275828	T	C	132	118	250	0	2	252	0	0
19	35649281	rs1128882	A	G	1287	1211	2498	0	21	2519	0	0
19	35655151	rs1672994	T	C	7	1	8	0	2	10	0	0
19	35657351	rs8106303	A	C	3	3	6	0	0	6	0	0
19	35658188	rs1623779	A	G	6	9	15	0	0	15	0	0
19	35658380	rs12461097	T	G	12	9	21	0	0	21	0	0
19	35658622	rs11084801	C	G	8	9	17	0	0	17	0	0
19	35658628	rs11084802	T	C	9	11	20	0	0	20	0	0
19	35658638	rs142851452	A	G	10	8	18	0	0	18	0	0
19	35658728	rs11084803	C	T	7	10	17	0	0	17	0	0
19	35658759	rs12611051	C	T	10	10	20	0	0	20	0	0
19	35659087	rs1688045	T	A	2	8	10	0	0	10	0	0
19	35659379	rs12978479	T	C	4	7	11	0	0	11	0	0
19	35660508	rs12110	G	A	1141	1147	2288	0	6	2294	0	0
19	35660670	rs3458	G	A	532	496	1028	0	3	1031	0	0
19	35741456	rs2073900	T	C	6	4	10	0	0	10	0	0
19	35757427	rs34259399	G	A	5	9	14	0	0	14	0	0
19	35765041	rs2284147	G	A	26	12	38	0	1	39	0	0
19	35765424	rs2284148	G	C	7	11	18	0	0	18	0	0
19	35768155	rs73030000	G	A	22	16	38	0	1	39	0	0
19	35837694	rs73031792	C	T	16	10	26	0	0	26	0	0
19	36122441	rs2285415	G	A	2	5	7	0	0	7	0	0
19	36218478	rs11670414	C	T	27	37	64	0	0	64	0	0
19	36220430	rs66747537	A	G	11	9	20	0	1	21	0	0
19	36224705	rs231591	A	G	114	87	201	0	1	202	0	0
19	36224973	rs17776911	T	C	4	6	10	0	0	10	0	0
19	36225620	rs3848663	G	A	2	4	6	0	0	6	0	0
19	36225999	rs2280743	T	C	4	5	9	0	0	9	0	0
19	36229643	rs3848664	C	T	72	76	148	0	1	149	0	0
19	36233470	rs3746278	G	A	31	31	62	0	0	62	0	0
19	36234652	rs17638853	T	C	13	7	20	0	0	20	0	0
19	36236000	rs2293687	C	A	36	12	48	0	1	49	0	0
19	36249521	rs231237	G	A	4	5	9	0	0	9	0	0
19	36250259	rs107878	C	T	3	3	6	0	0	6	0	0
19	36379782	rs117757044	T	C	30	26	56	0	1	57	0	0
19	36382850	rs116173337	C	T	19	10	29	0	1	30	0	0
19	36386005	rs117849844	A	G	16	16	32	0	0	32	0	0
19	36397350	rs62109667	A	G	5	9	14	0	0	14	0	0
19	36486509	rs76336581	C	G	10	9	19	0	0	19	0	0
19	36524409	rs79560372	T	A	4	2	6	0	0	6	0	0
19	36549684	rs61742664	G	A	2	4	6	0	0	6	0	0
19	36593915	rs61741470	T	G	7	10	17	0	0	17	0	0
19	36594369	rs45470992	C	T	11	6	17	0	0	17	0	0
19	36594659	rs2074435	A	T	11	8	19	0	1	20	0	0
19	36605552	rs2231566	G	A	9	10	19	0	0	19	0	0
19	36605647	rs2227260	T	C	8	7	15	0	0	15	0	0
19	36605794	rs2231568	C	T	18	10	28	0	0	28	0	0
19	36605875	rs2231569	G	T	10	10	20	0	0	20	0	0
19	36634549	rs13347141	A	G	2	5	7	0	0	7	0	0
19	36807142	.	A	G	3	3	6	0	1	7	0	0
19	36811643	rs2918362	A	G	6	6	12	0	0	12	0	0
19	36812239	rs2972635	T	C	19	14	33	0	0	33	0	0
19	36812910	rs2967488	C	A	13	11	24	0	0	24	0	0
19	36813084	rs2972632	A	G	14	5	19	0	1	20	0	0
19	36815899	rs2918359	T	C	15	12	27	0	0	27	0	0
19	36815901	rs2972629	G	T	15	12	27	0	0	27	0	0
19	36816064	rs1127406	T	G	18	11	29	0	0	29	0	0
19	36816543	rs2967494	C	T	10	15	25	0	0	25	0	0
19	36828217	rs1129376	A	G	12	9	21	0	0	22	1	0
19	36883444	rs2945961	T	C	7	8	15	0	0	15	0	0
19	36940760	rs2967532	G	T	18	1	19	0	0	19	0	0
19	36981816	rs3111551	T	G	1	6	7	0	0	7	0	0
19	37004737	rs17238977	T	A	9	7	16	0	0	16	0	0
19	37019742	rs8108848	G	T	5	1	6	0	0	6	0	0
19	37022471	rs3107238	T	G	4	3	7	0	0	7	0	0
19	37035534	.	T	G	16	7	23	0	0	23	0	0
19	37035923	rs61259689	C	T	45	33	78	0	2	80	0	0
19	37036003	rs61396420	T	G	46	35	81	0	0	81	0	0
19	37036068	rs3096637	T	G	44	32	76	0	0	76	0	0
19	37036345	rs2912443	C	T	59	46	105	0	1	106	0	0
19	37038092	rs2278168	T	C	71	68	139	0	1	140	0	0
19	37039069	rs2912444	A	C	64	86	150	0	1	151	0	0
19	37040013	rs2912446	C	A	34	30	64	0	0	64	0	0
19	37041689	rs2912399	G	T	5	3	8	0	0	8	0	0
19	37047472	rs2967436	G	A	5	5	10	0	0	10	0	0
19	37065732	rs2912406	A	C	22	10	32	0	0	32	0	0
19	37070243	rs3096620	G	A	3	4	7	0	0	7	0	0
19	37085354	rs55634974	T	G	6	2	8	0	0	8	0	0
19	37085469	rs2967427	A	G	7	10	17	0	0	17	0	0
19	37118439	rs61732180	C	T	5	2	7	0	0	7	0	0
19	37210529	rs3108200	A	G	19	15	34	0	0	34	0	0
19	37294557	rs1148387	C	G	1	8	9	0	0	9	0	0
19	37441111	rs571294	C	T	8	2	10	0	0	10	0	0
19	37673733	rs4805207	G	A	6	4	10	0	0	10	0	0
19	37674259	rs4805208	G	A	8	7	15	0	0	15	0	0
19	37677038	rs112014731	T	C	7	3	10	0	0	10	0	0
19	37677040	.	C	T	7	3	10	0	0	10	0	0
19	37728707	rs10402455	G	A	4	2	6	0	0	6	0	0
19	37730074	rs8112011	T	C	2	5	7	0	0	7	0	0
19	37732643	rs320875	T	G	5	1	6	0	0	6	0	0
19	37808863	rs10415358	C	A	14	8	22	0	0	22	0	0
19	37815134	rs6508711	G	T	22	16	38	0	0	38	0	0
19	37819010	rs6508716	T	C	5	2	7	0	0	7	0	0
19	37819631	rs13345148	A	G	4	6	10	0	0	10	0	0
19	37825633	rs10404602	A	T	2	7	9	0	0	9	0	0
19	37854235	rs3745765	G	T	19	30	49	0	2	51	0	0
19	37881556	rs10404920	T	C	3	6	9	0	0	9	0	0
19	38027957	rs45593644	A	G	5	6	11	0	0	11	0	0
19	38028907	rs12972657	G	A	6	0	6	0	0	6	0	0
19	38076955	rs117086839	C	A	4	2	6	0	0	6	0	0
19	38612677	rs113428378	A	G	4	5	9	0	0	9	0	0
19	38697201	.	C	T	30	29	59	0	0	59	0	0
19	38806376	.	G	A	11	2	13	0	0	13	0	0
19	38870027	rs11541757	C	T	404	380	784	0	2	786	0	0
19	38905683	rs10412098	A	G	44	46	90	0	0	90	0	0
19	39196736	rs11553600	G	A	337	364	701	0	2	703	0	0
19	39196745	rs3745859	C	T	375	327	702	0	5	707	0	0
19	39201274	rs77100563	C	G	8	7	15	0	0	15	0	0
19	39201488	rs12462270	C	T	5	12	17	0	0	17	0	0
19	39201781	rs2279144	C	T	10	11	21	0	0	21	0	0
19	39202056	rs73038918	C	T	10	6	16	0	0	16	0	0
19	39202341	rs8103824	G	A	9	7	16	0	0	16	0	0
19	39202888	rs28488032	G	C	11	4	15	0	0	15	0	0
19	39202897	rs28624276	G	A	10	4	14	0	0	14	0	0
19	39204846	rs10403540	G	A	11	8	19	0	0	19	0	0
19	39204961	rs73038924	G	T	15	2	17	0	0	17	0	0
19	39206288	rs883433	C	T	6	5	11	0	0	11	0	0
19	39207234	rs67438539	G	A	1	6	7	0	0	7	0	0
19	39212392	rs77822825	C	T	6	4	10	0	0	10	0	0
19	39219780	rs1136956	T	C	486	441	927	0	2	929	0	0
19	39306425	rs2075588	A	C	21	18	39	0	0	39	0	0
19	39306803	rs2075587	G	C	11	2	13	0	0	13	0	0
19	39322087	rs9419	T	G	174	205	379	0	2	381	0	0
19	39326754	rs2318459	G	C	7	2	9	0	0	9	0	0
19	39326809	rs2318460	G	C	5	5	10	0	0	10	0	0
19	39327856	rs2278009	A	T	13	23	36	0	0	36	0	0
19	39328145	rs2278010	A	C	19	21	40	0	0	40	0	0
19	39330058	rs10403012	A	G	37	33	70	0	0	70	0	0
19	39334811	rs2278011	T	A	29	36	65	0	1	66	0	0
19	39334830	rs2278012	C	T	36	32	68	0	0	68	0	0
19	39335274	rs7255774	T	C	34	30	64	0	0	64	0	0
19	39335744	rs55932233	A	G	18	17	35	0	0	35	0	0
19	39338125	rs862454	G	A	17	11	28	0	0	28	0	0
19	39338142	rs862455	A	G	17	13	30	0	0	30	0	0
19	39338834	rs112962375	G	A	10	10	20	0	0	20	0	0
19	39338865	rs862457	G	C	14	11	25	0	0	25	0	0
19	39369369	rs2015	T	G	99	126	225	0	2	227	0	0
19	39391974	rs57842338	C	T	5	2	7	0	0	7	0	0
19	39392409	.	A	C	4	9	13	0	0	13	0	0
19	39396335	rs2241704	A	T	3	3	6	0	0	6	0	0
19	39398416	rs3136642	A	G	113	112	225	0	2	227	0	0
19	39398649	rs3136645	T	C	89	88	177	0	1	178	0	0
19	39399195	.	A	G	59	36	95	0	7	102	0	0
19	39399277	rs3136646	C	T	110	60	170	0	0	170	0	0
19	39406167	rs9403	C	G	40	44	84	0	2	86	0	0
19	39412445	rs10412886	G	A	5	6	11	0	0	11	0	0
19	39658884	rs45495801	G	A	28	31	59	0	0	59	0	0
19	39663009	rs7257013	C	T	4	3	7	0	0	7	0	0
19	39835169	rs1368442	G	T	10	9	19	0	0	19	0	0
19	39838954	rs62119681	C	G	6	5	11	0	0	11	0	0
19	39888449	rs519575	C	T	26	13	39	0	0	39	0	0
19	39889044	rs10423565	A	T	31	33	64	0	0	64	0	0
19	39889691	rs10425594	G	A	47	38	85	0	0	85	0	0
19	39891161	rs10414216	T	C	5	4	9	0	0	9	0	0
19	39903320	rs62119731	C	T	6	6	12	0	0	12	0	0
19	39906727	rs8110127	A	G	6	1	7	0	0	7	0	0
19	39906985	rs10401595	T	C	4	2	6	0	0	6	0	0
19	39907036	rs2277743	C	T	23	26	49	0	0	49	0	0
19	39907781	rs10402009	G	A	6	6	12	0	0	12	0	0
19	39907852	rs62119733	G	C	10	4	14	0	0	14	0	0
19	39907946	rs62119734	C	G	10	9	19	0	0	19	0	0
19	39907994	rs10407472	C	T	5	5	10	0	0	10	0	0
19	39908574	rs35466645	C	T	37	18	55	0	1	56	0	0
19	39908978	rs62119736	G	A	5	5	10	0	0	10	0	0
19	39912344	rs62119738	T	A	9	11	20	0	0	20	0	0
19	39914308	rs31725	C	T	36	22	58	0	1	59	0	0
19	39914748	rs31726	G	A	159	113	272	0	2	274	0	0
19	39915637	rs31727	G	A	38	52	90	0	0	90	0	0
19	39915758	rs31728	C	G	49	44	93	0	0	93	0	0
19	39917523	rs148439185	A	G	20	19	39	0	0	39	0	0
19	39917761	rs251860	G	A	22	11	33	0	0	33	0	0
19	39917827	rs76128311	G	A	20	4	24	0	0	24	0	0
19	39918729	rs251859	A	G	16	21	37	0	0	37	0	0
19	39918825	rs251858	G	A	8	7	15	0	1	16	0	0
19	39923952	rs17627	G	A	3292	3532	6824	0	20	6844	0	0
19	39924129	rs566130	T	C	50	71	121	0	0	121	0	0
19	39925621	rs73033380	C	T	54	51	105	0	2	107	0	0
19	39926057	rs564577	A	C	56	56	112	0	0	112	0	0
19	39936502	rs1932	G	A	64	55	119	0	1	120	0	0
19	39942569	rs8107194	C	T	6	0	6	0	0	6	0	0
19	39944082	rs1130180	C	T	120	98	218	0	3	221	0	0
19	39963318	rs2304219	T	A	5	2	7	0	1	8	0	0
19	39963828	rs45568533	T	A	10	28	38	0	0	38	0	0
19	39965670	rs76779297	G	T	34	39	73	0	0	73	0	0
19	39965773	rs7245986	A	G	18	11	29	0	0	29	0	0
19	39965785	rs59269050	C	T	19	11	30	0	0	30	0	0
19	39976464	.	C	G	5	6	11	0	0	11	0	0
19	39976684	rs4803246	T	C	12	7	19	0	1	20	0	0
19	39976734	rs4803247	G	A	7	1	8	0	0	8	0	0
19	39982081	rs8111260	G	A	9	1	10	0	0	10	0	0
19	39982446	rs35647910	A	G	2	9	11	0	0	11	0	0
19	39983405	rs74381372	G	A	15	3	18	0	0	18	0	0
19	39983459	rs2060272	T	C	8	3	11	0	0	11	0	0
19	39984233	rs6508865	C	T	17	13	30	0	0	30	0	0
19	40030654	rs76765165	G	C	8	5	13	0	0	13	0	0
19	40224986	rs384138	A	G	6	7	13	0	0	13	0	0
19	40225646	rs17608	G	A	4	3	7	0	0	7	0	0
19	40319227	rs56077108	C	T	11	5	16	0	1	17	0	0
19	40323326	.	G	A	2	5	7	0	0	7	0	0
19	40719076	rs1129156	T	C	12	9	21	0	0	21	0	0
19	40719410	rs3746006	C	T	5	2	7	0	0	7	0	0
19	40739513	rs33933140	A	G	151	162	313	0	14	327	0	0
19	40739721	rs2304186	G	T	169	138	307	0	8	317	2	0
19	40742320	rs2304189	T	C	8	5	13	0	1	14	0	0
19	40743225	rs4803320	A	G	6	4	10	0	0	10	0	0
19	40760188	rs8104727	T	C	2	4	6	0	0	6	0	0
19	40785779	rs7259541	G	A	2	9	11	0	0	11	0	0
19	40786523	rs8102171	A	C	4	7	11	0	0	11	0	0
19	40788893	rs12985477	A	G	6	6	12	0	0	12	0	0
19	40789926	rs12459567	C	T	6	9	15	0	0	15	0	0
19	40790059	rs118098588	G	C	6	5	11	0	0	11	0	0
19	40828730	rs55710016	G	A	4	6	10	0	0	10	0	0
19	40829213	rs4257318	T	C	6	3	9	0	0	9	0	0
19	40829331	rs4337402	G	A	4	3	7	0	1	8	0	0
19	40884160	rs4635	G	A	134	165	299	0	1	300	0	0
19	40929363	rs268687	T	C	45	38	83	0	1	84	0	0
19	40947532	rs147438357	C	T	47	32	79	0	0	79	0	0
19	40949672	rs268691	T	C	0	6	6	0	0	6	0	0
19	41097189	rs191330922	C	T	231	214	445	0	1	446	0	0
19	41332832	rs73048932	A	G	0	11	11	0	0	11	0	0
19	41627868	rs305974	G	A	8	1	9	0	0	9	0	0
19	41627900	rs76594963	T	C	7	1	8	0	0	8	0	0
19	41630709	rs73545063	C	T	7	3	10	0	0	10	0	0
19	41633841	rs146029724	A	C	6	15	21	0	0	21	0	0
19	41770231	rs12975585	A	T	10	6	16	0	0	16	0	0
19	41770890	rs12983339	A	G	2	5	7	0	1	8	0	0
19	41773797	rs3816052	G	A	29	38	67	0	1	68	0	0
19	41774064	rs2304230	T	C	25	38	63	0	0	63	0	0
19	41776257	rs66724427	A	G	6	2	8	0	0	8	0	0
19	41806647	rs7258749	C	T	8	5	13	0	0	13	0	0
19	41807700	rs7248164	G	A	64	53	117	0	0	117	0	0
19	41808249	rs11881953	G	A	41	24	65	0	0	65	0	0
19	41808432	rs11881940	A	T	36	43	79	0	1	80	0	0
19	41809995	rs1056854	A	G	904	758	1662	0	11	1673	0	0
19	41810644	rs7245398	A	G	22	21	43	0	2	45	0	0
19	41810771	rs12972266	G	A	23	30	53	0	0	53	0	0
19	41811107	rs2195950	T	A	25	22	47	0	0	47	0	0
19	41811730	rs12745	T	C	580	497	1077	0	134	1257	46	0
19	41814412	rs1865053	T	C	4	4	8	0	0	8	0	0
19	41829309	rs2241720	C	G	68	95	163	0	1	164	0	0
19	41829581	rs2241719	T	A	51	48	99	0	1	100	0	0
19	41829606	rs2241718	G	A	55	44	99	0	0	99	0	0
19	41830606	rs6957	T	C	62	65	127	0	0	127	0	0
19	41837615	rs11466359	G	A	5	6	11	0	0	11	0	0
19	41839631	rs8105161	T	C	8	5	13	0	0	13	0	0
19	41916549	rs11549936	C	A	56	61	117	0	1	118	0	0
19	41928701	rs284653	C	T	14	12	26	0	0	26	0	0
19	41932063	rs45563938	A	G	28	21	49	0	1	50	0	0
19	42366247	rs3786538	T	G	3	4	7	0	0	7	0	0
19	42368016	rs12972552	G	A	51	7	58	0	1	59	0	0
19	42368738	rs7254214	A	G	6	3	9	0	0	9	0	0
19	42372457	rs3786536	C	A	3	5	8	0	0	8	0	0
19	42374836	rs2075752	T	G	5	3	8	0	0	8	0	0
19	42375244	rs2075754	C	T	9	2	11	0	0	11	0	0
19	42387803	rs891167	G	A	6	7	13	0	6	19	0	0
19	42463447	rs735571	C	T	57	72	129	0	2	131	0	0
19	42471050	rs919390	G	C	6	5	11	0	0	11	0	0
19	42591484	rs1056995	G	A	17	23	40	0	1	41	0	0
19	42593716	rs16975663	A	G	2	7	9	0	0	9	0	0
19	42594894	rs76335122	T	G	26	18	44	0	0	44	0	0
19	42703833	rs2303652	A	G	173	147	320	0	9	329	0	0
19	42703950	rs149135613	G	A	178	175	353	0	0	354	1	0
19	42708154	rs80167532	G	T	1	5	6	0	0	6	0	0
19	42735177	rs74259566	C	G	9	6	15	0	1	16	0	0
19	42735798	rs8108096	T	C	9	7	16	0	0	16	0	0
19	42753034	rs35493131	A	G	43	25	68	0	4	72	0	0
19	42753283	rs61735151	G	A	53	47	100	0	0	100	0	0
19	42753649	rs11557114	G	C	48	38	86	0	0	86	0	0
19	42754403	rs76292187	G	A	6	5	11	0	0	11	0	0
19	42754938	rs111862714	A	G	3	4	7	0	0	7	0	0
19	42755698	rs2267630	G	A	4	6	10	0	0	10	0	0
19	42756345	rs4141062	T	C	2	5	7	0	0	7	0	0
19	42776574	rs10426306	T	C	17	8	25	0	1	26	0	0
19	42776580	rs10426310	T	C	19	8	27	0	0	27	0	0
19	42779057	rs9636121	A	G	6	5	11	0	0	11	0	0
19	42795554	rs10410185	T	C	134	107	241	0	3	244	0	0
19	42797603	rs78756053	C	T	7	2	9	0	0	9	0	0
19	42852480	rs1676211	G	A	11	8	19	0	0	19	0	0
19	42852549	rs34922891	C	T	7	10	17	0	0	17	0	0
19	42853782	rs28621009	T	C	5	9	14	0	0	14	0	0
19	42857179	rs149155949	C	T	4	11	15	0	0	15	0	0
19	42858793	rs61995685	T	C	14	14	28	0	0	28	0	0
19	42882095	rs77151871	G	A	31	28	59	0	0	59	0	0
19	42882853	rs2304210	T	C	37	36	73	0	0	73	0	0
19	43866617	rs36081957	C	T	5	8	13	0	0	13	0	0
19	43979439	rs2599437	T	C	16	22	38	0	1	39	0	0
19	43983740	rs1133929	T	C	4	2	6	0	0	8	2	0
19	44047550	rs3547	T	C	34	40	74	0	1	75	0	0
19	44050966	rs25484	T	C	4	3	7	0	0	7	0	0
19	44055726	rs25487	T	C	32	38	70	0	4	74	0	0
19	44057227	rs915927	T	C	40	34	74	0	1	75	0	0
19	44079611	rs2307187	G	A	32	30	62	0	1	63	0	0
19	44088935	rs113854021	C	T	14	5	19	0	0	19	0	0
19	44089240	rs77595924	C	T	8	4	12	0	0	12	0	0
19	44090195	rs3817	A	C	82	62	144	0	3	148	1	0
19	44098963	rs304725	C	G	18	11	29	0	0	30	1	0
19	44099763	rs304724	C	T	8	6	14	0	0	14	0	0
19	44156472	rs2302524	T	C	201	156	357	0	6	363	0	0
19	44163033	rs2239373	T	G	3	3	6	0	0	6	0	0
19	44163746	rs385780	G	A	7	5	12	0	0	12	0	0
19	44252159	.	T	C	22	15	37	0	2	39	0	0
19	44281492	rs11083720	G	T	4	6	10	0	0	10	0	0
19	44281524	rs541789	G	C	7	2	9	0	0	9	0	0
19	44281898	rs11879798	G	A	4	8	12	0	0	12	0	0
19	44282529	rs56344893	C	A	2	7	9	0	0	9	0	0
19	44283031	rs56681946	T	C	5	3	8	0	0	8	0	0
19	44283216	rs1685192	G	T	9	3	12	0	0	12	0	0
19	44283232	rs1685191	C	T	8	3	11	0	0	11	0	0
19	44283447	rs12609846	C	T	4	3	7	0	0	7	0	0
19	44652954	rs2293587	G	A	8	4	12	0	0	12	0	0
19	44655537	rs7248054	A	G	4	4	8	0	0	8	0	0
19	44669960	rs1105561	T	C	13	19	32	0	0	32	0	0
19	44739303	rs2279073	T	C	8	5	13	0	0	13	0	0
19	44739399	rs2279072	T	C	8	10	18	0	0	18	0	0
19	44980214	rs2293164	C	T	6	5	11	0	0	11	0	0
19	44981318	rs954313	G	A	15	10	25	0	0	25	0	0
19	44981525	rs2020083	G	A	13	11	24	0	0	24	0	0
19	44981883	rs1897820	C	G	9	4	13	0	0	13	0	0
19	44983567	rs2253563	C	G	9	9	18	0	0	18	0	0
19	45001346	rs2571108	G	A	6	11	17	0	0	17	0	0
19	45162955	rs10411273	G	A	1	5	6	0	0	6	0	0
19	45187163	rs62119328	A	G	5	1	6	0	0	6	0	0
19	45252439	rs7257231	T	A	17	13	30	0	0	30	0	0
19	45253104	rs8100239	T	A	68	45	113	0	0	113	0	0
19	45253491	rs10401176	C	T	18	11	29	0	0	29	0	0
19	45253582	rs8100197	G	A	16	10	26	0	0	26	0	0
19	45254983	rs111677968	C	T	96	76	172	0	0	172	0	0
19	45255266	rs62117205	T	C	34	30	64	0	0	64	0	0
19	45255679	rs62117206	G	C	56	60	116	0	2	118	0	0
19	45377467	rs2075642	G	A	8	8	16	0	0	16	0	0
19	45379060	rs387976	A	C	1	5	6	0	0	6	0	0
19	45379309	rs3852859	T	C	5	9	14	0	0	14	0	0
19	45380970	rs11668861	G	T	5	8	13	0	0	13	0	0
19	45476422	rs204481	T	C	115	98	213	0	0	213	0	0
19	45481985	rs73558190	A	G	3	6	9	0	0	9	0	0
19	45482965	rs204476	A	C	4	2	6	0	0	6	0	0
19	45486687	rs143668237	G	C	3	3	6	0	0	6	0	0
19	45487670	rs73558200	A	T	6	9	15	0	0	15	0	0
19	45488434	rs204472	A	G	2	4	6	0	0	6	0	0
19	45489950	rs34112623	C	T	17	16	33	0	1	34	0	0
19	45490192	rs11672748	A	G	10	8	18	0	0	18	0	0
19	45490285	rs204469	A	G	19	13	32	0	0	32	0	0
19	45490428	rs7257610	G	A	23	17	40	0	0	40	0	0
19	45490570	rs3786505	A	G	90	85	175	0	2	177	0	0
19	45491945	rs204466	G	A	22	20	42	0	0	42	0	0
19	45492311	rs204465	T	C	12	20	32	0	0	32	0	0
19	45492618	rs149318580	G	A	30	15	45	0	0	45	0	0
19	45493061	rs909134	T	C	15	14	29	0	0	29	0	0
19	45493635	rs875255	C	G	15	14	29	0	0	29	0	0
19	45495682	rs2075619	A	G	25	9	34	0	1	35	0	0
19	45507671	rs34800911	A	G	2	4	6	0	0	6	0	0
19	45508272	rs10423543	A	C	3	6	9	0	0	9	0	0
19	45513236	rs874743	G	A	18	16	34	0	2	36	0	0
19	45513417	rs874744	C	T	16	15	31	0	0	31	0	0
19	45514472	rs28809016	G	A	7	7	14	0	0	14	0	0
19	45516050	rs35194383	T	C	6	7	13	0	1	14	0	0
19	45516631	rs35205401	T	A	11	9	20	0	0	20	0	0
19	45520959	rs7245887	G	T	14	7	21	0	0	21	0	0
19	45522091	rs57704603	C	T	19	15	34	0	0	34	0	0
19	45522210	rs73049472	C	T	35	29	64	0	0	64	0	0
19	45522289	rs74359223	G	A	23	36	59	0	1	60	0	0
19	45523583	rs4803791	G	A	26	24	50	0	1	51	0	0
19	45524119	rs114248186	C	T	8	6	14	0	1	15	0	0
19	45524862	rs10417743	A	T	14	3	17	0	0	17	0	0
19	45527568	rs1971786	C	T	20	20	40	0	0	40	0	0
19	45534041	rs1076986	C	T	31	24	55	0	0	55	0	0
19	45535310	rs35057129	G	A	5	3	8	0	0	8	0	0
19	45536036	rs10424046	C	G	67	58	125	0	0	125	0	0
19	45540501	rs139126319	T	C	19	13	32	0	1	33	0	0
19	45564915	rs66939386	A	G	7	2	9	0	0	9	0	0
19	45566080	rs7259567	T	G	2	5	7	0	0	7	0	0
19	45568651	.	A	G	8	1	9	0	0	9	0	0
19	45568795	rs7256279	G	A	3	7	10	0	0	10	0	0
19	45569009	rs10419815	C	T	5	10	15	0	0	15	0	0
19	45570051	rs3786509	G	C	4	12	16	0	0	16	0	0
19	45571781	rs10445571	T	C	8	4	12	0	0	12	0	0
19	45571903	rs36097205	G	C	6	7	13	0	0	13	0	0
19	45591344	rs10426398	C	T	8	1	9	0	0	9	0	0
19	45596533	rs114578504	C	T	6	3	9	0	0	9	0	0
19	45629104	rs145903417	A	G	2	6	8	0	0	8	0	0
19	45650099	rs74846209	G	T	21	26	47	0	0	47	0	0
19	45650386	rs1048699	C	T	15	12	27	0	0	27	0	0
19	45756376	rs12981145	G	C	2	5	7	0	0	7	0	0
19	45778941	rs73036569	T	C	1	6	7	0	0	7	0	0
19	45806609	rs2395	A	G	106	153	259	0	5	264	0	0
19	45853413	rs238419	T	C	11	7	18	0	0	18	0	0
19	45865002	rs171140	C	A	8	1	9	0	0	9	0	0
19	45865217	rs238403	T	C	5	3	8	0	0	8	0	0
19	45868309	rs238406	T	G	33	34	67	0	0	67	0	0
19	45882962	rs6966	T	A	3	5	8	0	0	8	0	0
19	45971961	rs2282695	C	G	645	564	1209	0	5	1214	0	0
19	45972039	rs2282696	A	C	147	164	311	0	2	313	0	0
19	45972861	rs11883164	A	G	185	168	353	0	0	353	0	0
19	45972881	rs7259071	A	C	210	159	369	0	1	370	0	0
19	45974593	rs2276469	T	C	48	60	108	0	1	109	0	0
19	45974668	rs2276470	C	T	59	64	123	0	0	123	0	0
19	45974809	rs2276472	A	G	65	58	123	0	0	123	0	0
19	45976636	rs10424098	T	G	15	11	26	0	0	26	0	0
19	45978375	rs1049739	A	G	378	485	863	0	1	864	0	0
19	46025388	rs2301284	G	A	0	7	7	0	0	7	0	0
19	46029819	rs28584568	A	T	159	159	318	0	3	321	0	0
19	46133251	rs7251952	C	T	19	17	36	0	0	36	0	0
19	46133256	rs7252175	G	A	17	16	33	0	0	33	0	0
19	46141845	rs12151009	T	C	16	17	33	0	0	33	0	0
19	46191021	rs2075142	A	G	2	7	9	0	0	9	0	0
19	46197421	rs2110574	C	T	3	4	7	0	0	7	0	0
19	46200103	rs34399924	G	A	1	5	6	0	0	6	0	0
19	46200302	rs10413338	T	C	3	3	6	0	0	6	0	0
19	46206262	rs17850756	G	A	23	32	55	0	0	55	0	0
19	46214291	rs3837965	G	T	29	14	43	0	1	44	0	0
19	46214684	rs34505186	G	A	12	6	18	0	1	19	0	0
19	46287200	rs617988	C	G	3	3	6	0	0	6	0	0
19	46322585	rs4803857	C	T	16	25	41	0	0	41	0	0
19	46322830	rs4802279	T	C	18	12	30	0	0	30	0	0
19	46327933	rs10500292	C	T	3	4	7	0	0	7	0	0
19	46328179	rs4803861	C	T	4	4	8	0	0	8	0	0
19	46358425	rs7250497	A	G	5	6	11	0	0	11	0	0
19	46364297	.	T	C	2	4	6	0	0	6	0	0
19	46404579	rs10423899	A	G	21	23	44	0	0	44	0	0
19	46405246	rs59367852	G	A	7	4	11	0	0	11	0	0
19	46405269	rs60425101	T	C	9	6	15	0	1	16	0	0
19	46405590	rs67709010	T	C	9	8	17	0	0	17	0	0
19	46878989	rs4239538	G	A	53	27	80	0	0	80	0	0
19	46971354	rs11669511	T	A	18	21	39	0	0	39	0	0
19	47110117	rs56264631	G	T	20	18	38	0	0	38	0	0
19	47112648	rs10113	T	C	590	377	967	0	12	979	0	0
19	47113138	rs10405893	A	G	575	355	930	0	9	939	0	0
19	47137459	rs12974613	C	T	3	5	8	0	0	8	0	0
19	47151717	rs45555133	G	A	4	4	8	0	1	9	0	0
19	47183416	rs3859426	T	C	18	10	28	0	1	29	0	0
19	47183840	rs6509290	T	C	8	6	14	0	0	14	0	0
19	47209115	rs62134785	T	G	4	5	9	0	0	9	0	0
19	47210859	rs12609920	C	A	2	4	6	0	0	6	0	0
19	47211778	rs10404836	T	C	5	4	9	0	1	10	0	0
19	47212733	rs12982786	G	A	2	5	7	0	0	7	0	0
19	47217914	rs588712	A	C	5	1	6	0	0	6	0	0
19	47220180	rs12974048	G	A	59	52	111	0	0	111	0	0
19	47223294	rs34705276	C	T	295	346	641	0	4	645	0	0
19	47223543	rs313840	T	C	274	277	551	0	10	561	0	0
19	47224317	rs313842	C	T	20	21	41	0	0	41	0	0
19	47224484	rs313843	A	G	20	20	40	0	0	40	0	0
19	47224590	rs3786704	C	T	15	24	39	0	0	39	0	0
19	47224607	rs3786705	C	T	13	26	39	0	1	40	0	0
19	47227295	rs4803996	C	A	8	6	14	0	0	14	0	0
19	47227327	rs10416300	C	A	7	5	12	0	0	12	0	0
19	47228985	rs313844	G	C	16	30	46	0	0	46	0	0
19	47228990	rs3848529	T	C	18	29	47	0	2	49	0	0
19	47230113	rs10411851	C	T	14	19	33	0	0	33	0	0
19	47242152	rs34301473	G	A	1	8	9	0	0	9	0	0
19	47244530	rs10401422	C	A	2	11	13	0	0	13	0	0
19	47246779	.	T	C	5	8	13	0	0	13	0	0
19	47247786	rs8101130	G	A	5	1	6	0	0	6	0	0
19	47281255	rs1644339	C	A	4	2	6	0	0	6	0	0
19	47282162	rs2070246	G	A	65	60	125	0	1	126	0	0
19	47543774	rs3745615	G	A	9	12	21	0	0	21	0	0
19	47569003	rs3810291	G	A	8	13	21	0	0	21	0	0
19	47585517	rs7250850	G	C	6	7	13	0	0	13	0	0
19	47588325	rs2287842	G	A	3	3	6	0	0	6	0	0
19	47700611	rs11083864	C	T	71	50	121	0	1	122	0	0
19	47761543	rs2302985	T	C	5	3	8	0	0	8	0	0
19	47768128	rs2032811	G	C	16	16	32	0	0	32	0	0
19	47769120	rs7248282	C	T	12	3	15	0	0	15	0	0
19	47769165	rs10407675	T	G	14	3	17	0	0	17	0	0
19	47769839	rs9304666	A	G	6	3	9	0	1	10	0	0
19	47770015	rs10413121	A	C	52	59	111	0	1	112	0	0
19	47770507	rs3786709	C	T	2	5	7	0	0	7	0	0
19	47770524	rs3786710	C	T	3	5	8	0	0	8	0	0
19	47770938	rs883030	C	A	3	3	6	0	0	6	0	0
19	47771499	rs884537	G	A	7	6	13	0	0	13	0	0
19	47772769	rs12610847	G	A	6	3	9	0	0	9	0	0
19	47772932	rs4802336	T	G	12	6	18	0	0	18	0	0
19	47773348	rs60379489	C	T	7	5	12	0	0	12	0	0
19	47774572	rs60930438	C	T	122	117	239	0	6	245	0	0
19	47774772	rs888836	T	C	87	104	191	0	1	192	0	0
19	47778857	rs6612	C	G	27	36	63	0	1	64	0	0
19	47856140	rs1064202	G	C	21	13	34	0	0	34	0	0
19	47885480	rs3745172	T	C	12	17	29	0	0	29	0	0
19	47980153	rs2293424	G	A	30	32	62	0	1	63	0	0
19	47989988	rs830150	A	C	6	13	19	0	0	19	0	0
19	47991441	rs830149	C	G	208	148	356	0	1	357	0	0
19	48017334	rs830137	C	G	6	4	10	0	0	10	0	0
19	48017416	rs861226	T	C	8	2	10	0	0	10	0	0
19	48248834	rs10404034	T	C	586	537	1123	0	3	1126	0	0
19	48250203	rs2334292	T	A	31	50	81	0	0	81	0	0
19	48258717	rs1804994	A	G	464	226	690	0	4	694	0	0
19	48258772	rs11083895	G	A	1128	989	2117	0	6	2123	0	0
19	48259478	rs10414116	T	C	25	33	58	0	1	59	0	0
19	48260079	rs889142	T	C	5	7	12	0	0	12	0	0
19	48261001	rs28501100	G	A	22	9	31	0	0	31	0	0
19	48262569	rs4802386	C	T	1	6	7	0	0	7	0	0
19	48262648	rs111576062	C	T	1	7	8	0	0	8	0	0
19	48621036	rs13436	C	G	46	30	76	0	0	76	0	0
19	48622427	rs20581	A	G	44	27	71	0	0	71	0	0
19	48654553	rs20580	G	T	40	25	65	0	1	66	0	0
19	48706528	rs3014	T	C	1	5	6	0	0	6	0	0
19	48707187	rs3745716	C	G	1	6	7	0	0	7	0	0
19	48711476	rs1062808	T	C	12	4	16	0	0	16	0	0
19	48711789	rs1968441	T	G	14	16	30	0	0	30	0	0
19	48711902	rs1968440	A	G	13	15	28	0	0	28	0	0
19	48711906	rs4597433	T	A	10	16	26	0	1	27	0	0
19	48711960	rs4347733	C	T	10	11	21	0	1	22	0	0
19	48711962	rs4423519	C	T	10	12	22	0	0	22	0	0
19	48712031	rs4433919	A	G	6	17	23	0	0	23	0	0
19	48712219	rs71357807	T	C	6	6	12	0	0	12	0	0
19	48712436	rs11665981	C	T	22	7	29	0	0	29	0	0
19	48712447	rs4802443	T	A	22	7	29	0	0	29	0	0
19	48712614	rs1971785	G	C	9	6	15	0	0	15	0	0
19	48712958	rs1971783	A	G	6	9	15	0	0	15	0	0
19	48713445	rs1062806	G	T	16	10	26	0	0	26	0	0
19	48713950	rs1347170	A	C	8	13	21	0	0	21	0	0
19	48721818	rs10410871	G	A	7	5	12	0	0	12	0	0
19	48732817	rs11083925	A	C	0	6	6	0	0	6	0	0
19	48735287	rs4802448	A	G	3	4	7	0	0	7	0	0
19	48737028	rs10418189	C	T	13	9	22	0	1	23	0	0
19	48737449	rs9304675	G	C	27	25	52	0	1	53	0	0
19	48737706	rs2043211	A	T	117	127	244	0	4	248	0	0
19	48759028	rs7258674	A	G	2	9	11	0	0	11	0	0
19	48759677	rs7259589	C	T	4	6	10	0	0	10	0	0
19	48759727	rs10427120	T	C	8	5	13	0	0	13	0	0
19	48759731	rs7260636	T	C	8	4	12	0	0	12	0	0
19	48759978	rs12459322	C	G	6	7	13	0	0	13	0	0
19	48760005	rs12459359	G	C	7	7	14	0	0	14	0	0
19	48760022	rs12459323	A	G	12	6	18	0	0	18	0	0
19	48760229	rs7248320	G	A	8	12	20	0	0	20	0	0
19	48760771	rs7248766	C	T	2	7	9	0	0	9	0	0
19	48760890	rs10412163	A	G	6	8	14	0	0	14	0	0
19	48761065	rs10412609	A	G	5	6	11	0	0	11	0	0
19	48885918	rs1050671	C	T	92	87	179	0	0	179	0	0
19	48954421	rs2302951	G	A	40	22	62	0	0	62	0	0
19	48969330	rs148924030	T	C	6	2	8	0	0	8	0	0
19	49120434	rs369880	C	T	23	15	38	0	1	39	0	0
19	49129791	rs4801770	A	G	6	2	8	0	0	8	0	0
19	49132634	rs3745733	G	A	7	6	13	0	0	13	0	0
19	49422437	rs12460533	A	T	8	3	11	0	0	11	0	0
19	49459104	rs1805419	A	G	8	1	9	0	0	9	0	0
19	49469087	rs2230267	T	C	3738	3810	7548	0	55	7606	3	0
19	49598203	rs148942360	G	A	3	4	7	0	0	7	0	0
19	49605683	.	G	T	88	69	157	0	2	159	0	0
19	49610389	rs3795055	T	C	62	38	100	0	4	104	0	0
19	49611319	rs1058882	C	T	124	123	247	0	4	251	0	0
19	50154904	rs7251334	A	C	9	1	10	0	0	10	0	0
19	50170370	rs149021967	C	T	21	23	44	0	0	44	0	0
19	50271502	rs1674139	T	C	2	10	12	0	0	12	0	0
19	50276856	rs77220875	A	G	5	1	6	0	0	6	0	0
19	50295708	rs4802626	G	C	11	2	13	0	0	13	0	0
19	50305688	rs2159984	G	C	7	5	12	0	0	12	0	0
19	50307344	rs11879607	C	T	11	6	17	0	0	17	0	0
19	50307401	rs62129184	G	A	7	5	12	0	0	12	0	0
19	50307408	rs11879637	G	A	7	6	13	0	0	13	0	0
19	50308134	rs2241040	G	C	17	15	32	0	0	32	0	0
19	50335510	rs3745480	T	C	3	4	7	0	0	7	0	0
19	50335872	rs1290652	A	G	2	4	6	0	0	6	0	0
19	50339382	rs77029922	T	G	4	3	7	0	0	7	0	0
19	50342111	rs10403127	G	A	24	27	51	0	0	51	0	0
19	50343129	rs921470	T	C	32	37	69	0	1	70	0	0
19	50357189	rs10423897	T	C	4	6	10	0	1	11	0	0
19	50358133	rs75478119	T	G	78	92	170	0	0	170	0	0
19	50359384	rs3786662	A	T	18	15	33	0	0	33	0	0
19	50359404	rs3786663	C	T	16	15	31	0	0	31	0	0
19	50360046	rs10418141	C	A	42	30	72	0	0	73	1	0
19	50360989	rs59595912	A	G	158	137	295	0	2	298	1	0
19	50362201	rs7257463	T	A	43	32	75	0	0	75	0	0
19	50363175	rs1290646	A	G	22	14	36	0	1	37	0	0
19	50379193	rs3810268	C	T	2	4	6	0	0	6	0	0
19	50382865	.	T	G	6	2	8	0	0	8	0	0
19	50383636	rs3745486	T	C	42	46	88	0	1	89	0	0
19	50384882	rs7248498	A	G	4	5	9	0	1	10	0	0
19	50385031	rs7248744	A	G	10	4	14	0	0	14	0	0
19	50385156	rs75874825	T	C	5	2	7	0	0	7	0	0
19	50391299	rs2305917	C	T	31	17	48	0	0	48	0	0
19	50391301	rs2305916	T	G	31	16	47	0	1	48	0	0
19	50396263	rs11673399	T	C	6	2	8	0	0	8	0	0
19	50396546	rs62126286	A	T	5	1	6	0	0	6	0	0
19	50411158	rs1044276	T	C	97	59	156	0	0	156	0	0
19	50411395	rs11547267	C	G	78	51	129	0	0	129	0	0
19	50411742	rs892028	A	G	93	55	148	0	1	149	0	0
19	50412417	rs999583	G	A	91	63	154	0	2	156	0	0
19	50417490	rs17668162	G	A	6	0	6	0	0	6	0	0
19	50419399	rs1299491	A	C	5	6	11	0	0	11	0	0
19	50419405	rs35246621	G	C	5	6	11	0	0	11	0	0
19	50420671	rs1152239	C	A	3	4	7	0	0	7	0	0
19	50431790	rs1273686	C	A	2	4	6	0	0	6	0	0
19	50432427	rs1152232	A	G	5	1	6	0	0	6	0	0
19	50434760	rs34832536	C	T	37	19	56	0	0	56	0	0
19	50435139	rs283524	G	C	11	4	15	0	0	15	0	0
19	50435747	rs283525	T	C	10	8	18	0	0	18	0	0
19	50435862	rs283526	C	T	2	7	9	0	0	9	0	0
19	50436371	rs8667	G	A	16	25	41	0	1	42	0	0
19	50436715	rs3170545	G	A	27	48	75	0	0	75	0	0
19	50436758	rs1044297	G	A	29	55	84	0	0	84	0	0
19	50436980	rs8647	G	A	15	40	55	0	0	55	0	0
19	50880741	rs2695121	T	C	7	8	15	0	0	15	0	0
19	50882169	rs2248949	A	G	7	7	14	0	0	14	0	0
19	50882562	rs78105260	A	G	4	2	6	0	0	6	0	0
19	50883927	rs116926156	G	A	8	6	14	0	1	15	0	0
19	50918229	rs3218775	G	A	39	36	75	0	0	75	0	0
19	50931964	rs1137895	G	C	2	8	10	0	0	10	0	0
19	50983930	rs10409679	C	T	364	322	686	0	5	691	0	0
19	50984853	rs2387112	A	G	4	4	8	0	0	8	0	0
19	50985170	rs144996610	C	T	45	15	60	0	0	60	0	0
19	50986074	rs14031	G	A	415	381	796	0	6	803	1	0
19	51012816	rs1274698	G	A	9	5	14	0	0	14	0	0
19	51166065	rs34189048	G	A	1	6	7	0	0	7	0	0
19	51302716	rs3810284	G	A	5	2	7	0	0	7	0	0
19	51304352	rs12978675	A	G	2	6	8	0	1	9	0	0
19	51304382	rs12979334	G	A	2	6	8	0	1	9	0	0
19	51304404	rs12979351	G	C	2	7	9	0	0	9	0	0
19	51304434	rs2560933	A	G	2	4	6	0	0	6	0	0
19	51305550	rs2659064	G	A	2	4	6	0	0	6	0	0
19	51323473	rs5516	C	G	4	4	8	0	0	8	0	0
19	51323501	rs1054713	A	G	3	3	6	0	0	6	0	0
19	51323881	rs2659103	T	G	3	5	8	0	0	8	0	0
19	51728641	rs2455069	A	G	55	109	164	0	1	165	0	0
19	51874950	rs3009	G	A	253	236	489	0	0	489	0	0
19	51913954	.	G	A	1	8	9	0	0	9	0	0
19	51994746	rs28756785	C	T	70	13	83	0	1	84	0	0
19	51994813	rs16982733	G	T	67	18	85	0	0	85	0	0
19	51994851	rs16982735	C	G	69	21	90	0	2	92	0	0
19	51995046	rs57043266	G	T	58	18	76	0	0	76	0	0
19	51997320	rs73049701	G	A	6	3	9	0	0	9	0	0
19	52000624	rs3752135	T	G	19	6	25	0	0	25	0	0
19	52003331	rs6509544	G	C	30	23	53	0	1	54	0	0
19	52003864	rs1973095	C	T	5	4	9	0	0	9	0	0
19	52004074	rs3826667	C	T	4	2	6	0	0	6	0	0
19	52004551	rs3810109	C	T	3	8	11	0	0	11	0	0
19	52004903	rs16982743	G	A	37	14	51	0	0	51	0	0
19	52025247	rs2124910	T	C	2	11	13	0	0	13	0	0
19	52025473	rs2168643	G	A	3	9	12	0	0	12	0	0
19	52025948	rs7249285	G	A	8	4	12	0	0	12	0	0
19	52026600	rs10410468	T	G	4	6	10	0	0	10	0	0
19	52026801	rs10409713	G	T	7	2	9	0	1	10	0	0
19	52028527	rs113540550	G	A	6	13	19	0	1	20	0	0
19	52028981	rs10853836	A	C	12	3	15	0	0	15	0	0
19	52029018	rs10853837	G	A	10	2	12	0	0	12	0	0
19	52030370	rs2864104	G	A	6	3	9	0	1	10	0	0
19	52030448	rs4802807	A	G	5	3	8	0	0	8	0	0
19	52031148	rs77020082	T	G	2	4	6	0	0	6	0	0
19	52031162	rs897783	A	G	4	2	6	0	0	6	0	0
19	52032339	rs79864857	C	T	6	5	11	0	0	11	0	0
19	52032668	rs4146202	T	C	5	1	6	0	0	6	0	0
19	52032964	rs3976745	C	G	7	2	9	0	0	9	0	0
19	52033108	rs74352887	G	A	63	83	146	0	0	146	0	0
19	52034469	rs1993462	C	T	54	60	114	0	0	114	0	0
19	52034940	rs1551559	C	T	2	5	7	0	1	8	0	0
19	52115461	.	A	G	12	9	21	0	0	21	0	0
19	52115645	rs3829655	G	C	6	7	13	0	0	13	0	0
19	52131328	.	T	C	5	5	10	0	0	10	0	0
19	52215296	rs7252496	A	C	1	6	7	0	1	8	0	0
19	52249947	rs2070745	C	G	12	34	46	0	1	47	0	0
19	52403516	rs1549931	T	C	16	18	34	0	1	35	0	0
19	52452437	rs118048159	G	C	3	3	6	0	0	6	0	0
19	52467822	rs2278414	G	A	27	37	64	0	0	64	0	0
19	52468203	rs2278415	T	A	54	43	97	0	0	97	0	0
19	52468587	rs3764538	G	T	53	49	102	0	0	102	0	0
19	52468998	rs4988334	A	G	33	54	87	0	0	87	0	0
19	52471403	rs7250159	T	A	9	3	12	0	0	12	0	0
19	52471785	rs2278418	T	A	1	5	6	0	0	6	0	0
19	52471872	rs2278420	A	G	95	106	201	0	0	201	0	0
19	52472295	rs4986773	A	G	102	96	198	0	0	198	0	0
19	52472868	rs12461777	C	T	4	4	8	0	0	8	0	0
19	52473823	rs7253957	C	A	9	3	12	0	0	12	0	0
19	52476499	rs75919042	A	G	3	5	8	0	0	8	0	0
19	52476662	rs73934705	T	C	3	3	6	0	0	6	0	0
19	52477980	rs11668463	C	G	24	20	44	0	1	45	0	0
19	52478496	rs4801904	T	C	3	4	7	0	0	7	0	0
19	52479633	rs2082438	A	C	3	7	10	0	0	10	0	0
19	52480037	rs8103682	C	G	5	1	6	0	0	6	0	0
19	52480052	.	G	A	5	2	7	0	0	7	0	0
19	52480825	rs57637334	G	A	5	7	12	0	0	12	0	0
19	52483593	rs12460506	G	C	11	13	24	0	0	24	0	0
19	52484649	rs11669564	G	A	6	6	12	0	0	12	0	0
19	52484742	rs11665781	T	C	9	8	17	0	0	17	0	0
19	52486303	rs11671769	G	A	2	4	6	0	1	7	0	0
19	52486540	rs56335592	T	C	7	6	13	0	0	13	0	0
19	52486626	rs59351632	T	C	4	4	8	0	0	8	0	0
19	52486844	rs8110287	C	T	4	6	10	0	0	10	0	0
19	52487127	rs58116420	G	C	13	19	32	0	0	32	0	0
19	52487161	rs8110542	A	G	17	16	33	0	1	34	0	0
19	52495109	rs1835999	T	C	5	5	10	0	0	10	0	0
19	52495114	rs1836000	T	C	5	4	9	0	0	9	0	0
19	52495312	rs1433090	C	T	2	4	6	0	0	6	0	0
19	52495380	rs11084127	C	T	3	4	7	0	0	7	0	0
19	52495646	rs11084128	A	T	27	36	63	0	0	63	0	0
19	52495648	rs2288885	A	G	27	36	63	0	0	63	0	0
19	52495684	rs2288886	A	T	32	30	62	0	0	62	0	0
19	52495803	rs2288887	A	G	28	25	53	0	0	53	0	0
19	52496149	rs16983353	C	T	37	27	64	0	1	65	0	0
19	52497250	rs1978717	G	A	29	24	53	0	0	53	0	0
19	52497943	rs10500311	G	A	12	10	22	0	0	22	0	0
19	52504920	rs2903709	T	C	2	7	9	0	0	9	0	0
19	52506985	rs1433089	T	C	33	12	45	0	0	45	0	0
19	52507882	rs4516337	C	G	5	1	6	0	0	6	0	0
19	52508965	rs12461141	A	G	3	4	7	0	0	7	0	0
19	52508994	rs12459079	T	C	3	4	7	0	0	7	0	0
19	52517520	rs8111873	T	C	5	7	12	0	0	12	0	0
19	52517894	rs11665783	G	A	6	3	9	0	0	9	0	0
19	52519608	rs8104890	C	T	7	7	14	0	0	14	0	0
19	52520607	rs61574510	C	T	4	7	11	0	0	11	0	0
19	52521296	rs9636139	G	A	6	12	18	0	0	18	0	0
19	52535172	rs58329304	A	G	20	15	35	0	1	36	0	0
19	52535421	rs12462359	T	G	4	4	8	0	0	8	0	0
19	52535803	rs12460118	C	T	20	15	35	0	0	35	0	0
19	52535834	rs12460617	G	A	20	17	37	0	0	37	0	0
19	52536117	rs73053909	C	A	18	7	25	0	0	25	0	0
19	52536692	rs58817690	C	T	34	39	73	0	1	74	0	0
19	52537576	rs11666149	T	G	26	29	55	0	2	57	0	0
19	52550401	rs17779341	G	T	7	3	10	0	1	11	0	0
19	52551486	rs3752118	G	C	5	3	8	0	0	8	0	0
19	52551498	rs3752119	C	T	4	2	6	0	0	6	0	0
19	52552021	rs3752120	C	T	8	7	15	0	0	15	0	0
19	52552669	rs11667001	G	C	4	3	7	0	0	7	0	0
19	52593608	rs60720536	G	C	1	5	6	0	0	6	0	0
19	52593718	rs78369132	C	T	3	3	6	0	0	6	0	0
19	52665989	rs12460375	C	G	6	16	22	0	0	22	0	0
19	52666071	rs35897677	C	T	4	20	24	0	1	25	0	0
19	52666085	rs12460432	G	A	5	18	23	0	0	23	0	0
19	52704224	.	G	A	13	3	16	0	1	17	0	0
19	52711320	rs7251605	G	A	3	5	8	0	0	8	0	0
19	52711348	rs35248573	T	C	5	3	8	0	0	8	0	0
19	52777449	rs2657924	G	A	4	2	6	0	0	6	0	0
19	52919199	rs142156816	G	A	6	3	9	0	0	9	0	0
19	53056953	rs329965	G	A	17	9	26	0	0	26	0	0
19	53064136	rs10417895	A	G	8	0	8	0	0	8	0	0
19	53064296	rs10418186	A	G	5	5	10	0	0	10	0	0
19	53064536	rs28457732	A	G	4	6	10	0	0	10	0	0
19	53064595	rs28556852	T	C	5	8	13	0	0	13	0	0
19	53065814	rs8103262	T	C	8	6	14	0	0	14	0	0
19	53066678	rs58875456	G	A	14	4	18	0	0	18	0	0
19	53066857	rs12327639	G	A	13	8	21	0	0	21	0	0
19	53066893	rs12327640	G	T	14	7	21	0	0	21	0	0
19	53073564	rs75660813	G	T	5	2	7	0	0	7	0	0
19	53077411	rs162832	T	C	14	7	21	0	1	22	0	0
19	53080873	rs6509652	C	T	5	3	8	0	0	8	0	0
19	53080928	rs586746	A	G	4	3	7	0	0	7	0	0
19	53085659	rs366793	C	T	8	8	16	0	0	16	0	0
19	53086124	rs373554	C	A	4	6	10	0	0	10	0	0
19	53086598	rs3745102	G	A	6	2	8	0	0	8	0	0
19	53087622	rs587238	T	C	7	8	15	0	0	15	0	0
19	53088269	rs3810120	G	T	7	3	10	0	0	10	0	0
19	53088274	rs567273	T	C	7	2	9	0	1	10	0	0
19	53088882	rs35429660	C	G	4	2	6	0	0	6	0	0
19	53088935	rs35764467	G	A	5	2	7	0	0	7	0	0
19	53089332	rs329934	C	T	4	4	8	0	0	8	0	0
19	53090078	rs11558050	T	C	5	2	7	0	0	7	0	0
19	53090335	rs3339	A	C	3	7	10	0	0	10	0	0
19	53104580	rs16984003	A	G	4	8	12	0	0	12	0	0
19	53104601	rs10401627	G	C	4	8	12	0	0	12	0	0
19	53317661	rs112164150	T	C	7	6	13	0	0	13	0	0
19	53319489	rs56292969	G	T	32	3	35	0	0	35	0	0
19	53319514	rs8108112	G	A	34	13	47	0	0	47	0	0
19	53319637	rs114425205	G	C	11	51	62	0	0	62	0	0
19	53320037	rs117645972	T	G	11	25	36	0	0	36	0	0
19	53320292	rs28420198	T	G	36	13	49	0	0	49	0	0
19	53320349	rs28712529	G	C	33	20	53	0	0	53	0	0
19	53320363	rs142080525	C	A	18	29	47	0	0	47	0	0
19	53320462	rs28667452	C	T	36	12	48	0	0	48	0	0
19	53320518	rs56008301	G	C	46	9	55	0	0	55	0	0
19	53320557	rs58599955	G	A	44	10	54	0	0	54	0	0
19	53320582	rs55996509	G	A	44	8	52	0	0	52	0	0
19	53320858	rs149345840	C	A	3	4	7	0	0	7	0	0
19	53320936	rs12459194	G	A	6	3	9	0	0	9	0	0
19	53320975	rs12459162	A	C	8	3	11	0	0	11	0	0
19	53321259	rs112424230	G	A	10	38	48	0	0	48	0	0
19	53424548	rs76196156	C	T	6	1	7	0	0	7	0	0
19	53424558	rs10411365	A	T	6	1	7	0	0	7	0	0
19	53424560	rs12462051	G	A	6	1	7	0	0	7	0	0
19	53430896	rs8104434	G	C	11	4	15	0	0	15	0	0
19	53430969	rs8104237	A	G	5	2	7	0	0	7	0	0
19	53431000	rs8104567	G	C	5	2	7	0	0	7	0	0
19	53431048	rs7250641	G	A	8	5	13	0	0	13	0	0
19	53431263	rs7250706	C	T	12	13	25	0	0	25	0	0
19	53431356	rs148484591	G	A	10	4	14	0	1	15	0	0
19	53431458	rs12982323	C	T	5	13	18	0	0	18	0	0
19	53431472	rs12982775	G	T	5	12	17	0	0	17	0	0
19	53431516	rs12984436	T	C	5	16	21	0	0	21	0	0
19	53431977	rs8110693	T	C	18	20	38	0	1	39	0	0
19	53431978	rs79589270	G	A	18	20	38	0	1	39	0	0
19	53431994	rs8109900	C	T	18	16	34	0	1	35	0	0
19	53452769	rs1044467	A	G	6	11	17	0	0	17	0	0
19	53452944	rs1808106	T	G	11	5	16	0	0	16	0	0
19	53452965	rs3745177	C	T	7	3	10	0	0	10	0	0
19	53453777	.	C	T	7	6	13	0	0	13	0	0
19	53454387	rs57088011	G	C	2	10	12	0	0	12	0	0
19	53454789	rs12459008	A	T	4	4	8	0	0	8	0	0
19	53455088	rs12461796	T	A	5	1	6	0	0	6	0	0
19	53482027	.	C	T	6	0	6	0	0	6	0	0
19	53590507	rs329716	G	A	2	4	6	0	0	6	0	0
19	53611473	rs1045764	C	T	7	3	10	0	0	10	0	0
19	53612311	rs4803051	T	C	2	4	6	0	0	6	0	0
19	53612720	rs1560099	T	C	1	5	6	0	0	6	0	0
19	53612989	rs1054484	A	G	2	4	6	0	0	6	0	0
19	53643299	rs117234352	G	A	2	4	6	0	0	6	0	0
19	53700385	rs112715965	C	T	2	4	6	0	0	6	0	0
19	53856349	rs55874600	A	T	24	26	50	0	0	50	0	0
19	53911973	rs10425136	A	G	4	2	6	0	0	6	0	0
19	53912045	.	T	G	4	3	7	0	0	7	0	0
19	53912242	rs10426347	G	A	4	6	10	0	0	10	0	0
19	53912548	rs7246019	T	C	3	5	8	0	0	8	0	0
19	53912770	rs12461238	G	A	4	5	9	0	0	9	0	0
19	53913481	rs55826108	A	G	6	8	14	0	0	14	0	0
19	53913555	rs6509753	C	G	6	10	16	0	0	16	0	0
19	53914108	rs2068630	C	T	8	12	20	0	0	20	0	0
19	53942033	rs11882218	C	T	3	3	6	0	0	6	0	0
19	53942084	rs75739523	A	G	3	3	6	0	0	6	0	0
19	53942953	rs59449128	G	T	2	5	7	0	0	7	0	0
19	53943153	rs6509765	G	A	4	2	6	0	0	6	0	0
19	53945114	rs4803124	G	C	10	8	18	0	0	18	0	0
19	53945215	rs4803125	G	A	13	12	25	0	0	25	0	0
19	53945250	rs4803126	A	T	15	9	24	0	1	25	0	0
19	53945504	rs12983857	C	T	16	10	26	0	0	26	0	0
19	53945679	rs12986193	T	G	11	8	19	0	0	19	0	0
19	53946527	rs6509771	T	C	5	1	6	0	0	6	0	0
19	53947195	rs7245623	T	C	4	2	6	0	0	6	0	0
19	53947775	rs11669685	C	A	6	1	7	0	0	7	0	0
19	53947802	rs112376041	T	C	5	1	6	0	0	6	0	0
19	53950475	rs8111707	G	T	12	9	21	0	0	21	0	0
19	53953333	rs10775559	T	C	10	0	10	0	0	10	0	0
19	53953365	rs10775560	C	T	8	0	8	0	0	8	0	0
19	53958126	rs2708743	T	G	2	4	6	0	0	6	0	0
19	53959804	rs4803129	T	C	8	7	15	0	0	15	0	0
19	53995691	rs2708844	A	T	2	6	8	0	0	8	0	0
19	53995750	rs2708843	C	T	5	5	10	0	0	10	0	0
19	53997179	rs67149430	T	C	6	0	6	0	0	6	0	0
19	53997613	rs2708835	C	G	5	2	7	0	0	7	0	0
19	53997635	rs8109819	T	C	3	4	7	0	0	7	0	0
19	54025918	rs12982082	T	C	2	4	6	0	0	6	0	0
19	54378030	rs200046918	T	C	1011	177	1188	0	144	1332	0	0
19	54561792	rs11669427	G	A	142	149	291	0	0	291	0	0
19	54562317	.	T	C	3	4	7	0	2	9	0	0
19	54600232	rs1657535	A	C	16	57	73	0	1	74	0	0
19	54600913	rs661239	G	C	5	3	8	0	0	8	0	0
19	54601118	rs662133	G	A	3	14	17	0	0	17	0	0
19	54601496	rs663569	G	A	11	10	21	0	0	21	0	0
19	54614270	rs16985367	A	G	5	3	8	0	0	8	0	0
19	54614323	rs73062626	C	G	4	4	8	0	0	8	0	0
19	54614590	rs16985368	A	G	4	2	6	0	0	6	0	0
19	54628940	rs254274	G	A	2	4	6	0	0	6	0	0
19	54631880	rs10417221	T	C	5	5	10	0	0	10	0	0
19	54631911	rs2668840	A	G	3	3	6	0	1	7	0	0
19	54632066	rs8107970	C	T	11	6	17	0	0	17	0	0
19	54632253	rs2576453	G	A	3	7	10	0	0	10	0	0
19	54632352	rs608608	C	G	2	5	7	0	0	7	0	0
19	54632423	rs655240	T	C	7	3	10	0	0	10	0	0
19	54658001	rs1055234	C	G	24	22	46	0	0	46	0	0
19	54677897	rs10416555	G	A	466	572	1038	0	3	1041	0	0
19	54678473	rs75158883	A	G	22	17	39	0	0	39	0	0
19	54678831	rs368545574	G	A	18	16	34	0	0	34	0	0
19	54678862	rs8111894	C	T	17	12	29	0	0	29	0	0
19	54679770	rs686229	C	T	16	14	30	0	0	30	0	0
19	54680136	rs115762818	C	T	28	2	30	0	0	30	0	0
19	54680927	rs78881568	C	T	10	4	14	0	0	14	0	0
19	54681045	rs150722302	T	C	17	15	32	0	1	33	0	0
19	54681762	rs149013103	G	C	25	12	37	0	0	37	0	0
19	54681986	rs77879082	G	T	21	14	35	0	0	36	1	0
19	54682867	rs2278499	T	C	188	195	383	0	1	384	0	0
19	54682975	rs40167	A	G	144	165	309	0	1	310	0	0
19	54683135	rs60800870	T	C	126	203	329	0	1	330	0	0
19	54689323	rs254281	G	C	7	8	15	0	0	15	0	0
19	54691414	rs36631	A	G	3	4	7	0	0	7	0	0
19	54691626	rs36630	A	G	2	5	7	0	0	7	0	0
19	54691727	rs36629	G	A	2	4	6	0	0	6	0	0
19	54695163	rs593073	T	C	23	7	30	0	0	30	0	0
19	54696167	rs11879943	C	A	328	267	595	0	3	598	0	0
19	54696488	rs635608	T	C	22	27	49	0	0	49	0	0
19	54697079	rs7595	C	T	446	352	798	0	7	805	0	0
19	54697246	rs2289145	G	A	441	336	777	0	1	778	0	0
19	54719347	rs255776	A	G	3	3	6	0	0	6	0	0
19	54719768	rs255775	C	T	5	6	11	0	0	11	0	0
19	54723355	rs255774	A	G	2	4	6	0	0	6	0	0
19	54723546	rs255773	C	T	3	4	7	0	0	7	0	0
19	54724407	rs1132608	C	T	7	1	8	0	0	8	0	0
19	54724457	rs1052995	T	C	9	0	9	0	0	9	0	0
19	54724458	rs1052993	A	G	9	0	9	0	0	9	0	0
19	54779101	rs443501	C	T	3	3	6	0	0	6	0	0
19	54780969	rs182896367	C	G	10	1	11	0	0	11	0	0
19	54781010	rs3855678	T	C	11	2	13	0	0	13	0	0
19	54781078	.	G	T	3	5	8	0	0	8	0	0
19	54820663	rs1761464	T	C	1	5	6	0	0	6	0	0
19	54821448	rs1645786	A	G	10	4	14	0	0	14	0	0
19	54821819	rs759818	A	G	9	8	17	0	1	18	0	0
19	54875791	rs73604725	T	C	4	5	9	0	0	9	0	0
19	54877982	rs7250269	A	G	7	1	8	0	0	8	0	0
19	54878191	rs7250548	A	G	7	2	9	0	0	9	0	0
19	54878266	rs7251679	T	G	5	1	6	0	0	6	0	0
19	54878284	rs7251687	T	A	6	1	7	0	0	7	0	0
19	54878414	rs56802430	A	G	5	1	6	0	0	6	0	0
19	54878574	rs57300918	G	A	7	1	8	0	0	8	0	0
19	54879821	rs112333879	T	G	9	0	9	0	0	9	0	0
19	54879851	rs3901365	G	T	0	10	10	0	0	10	0	0
19	54880076	rs1985840	T	C	1	32	33	0	0	33	0	0
19	54880430	rs112439112	G	T	16	0	16	0	0	16	0	0
19	54880456	.	A	G	14	0	14	0	1	15	0	0
19	54956027	rs56853534	G	A	7	2	9	0	0	9	0	0
19	54959349	rs10424856	G	A	12	5	17	0	0	17	0	0
19	54961067	rs2112822	C	T	6	7	13	0	0	13	0	0
19	54961174	rs1559193	A	G	6	3	9	0	0	9	0	0
19	54961762	rs60691883	G	C	6	2	8	0	0	8	0	0
19	54961969	rs57845281	G	C	3	4	7	0	0	7	0	0
19	54964608	rs4806762	G	A	6	1	7	0	0	7	0	0
19	54965860	rs3813148	G	A	233	172	405	0	9	414	0	0
19	54966982	rs55854356	C	T	3	6	9	0	0	9	0	0
19	54966997	rs55884062	C	T	5	6	11	0	0	11	0	0
19	54968038	rs35336528	A	G	208	204	412	0	3	416	1	0
19	54968412	rs6509875	C	T	4	5	9	0	0	9	0	0
19	54969075	rs45605939	C	T	14	6	20	0	0	20	0	0
19	54971495	rs78422130	G	A	126	130	256	0	3	259	0	0
19	55009642	.	G	A	6	0	6	0	0	6	0	0
19	55045042	rs61739186	G	A	6	0	6	0	1	7	0	0
19	55048270	rs17606836	C	T	3	4	7	0	0	7	0	0
19	55053809	rs143660730	G	A	3	5	8	0	0	8	0	0
19	55106177	rs142517538	A	C	3	3	6	0	0	6	0	0
19	55143491	rs1061681	G	T	5	2	7	0	0	7	0	0
19	55175009	rs11540761	G	T	1	9	10	0	0	10	0	0
19	55178162	rs11574576	A	G	7	6	13	0	0	13	0	0
19	55331419	rs2273731	C	T	6	0	6	0	0	6	0	0
19	55485899	rs2217659	G	A	0	8	8	0	0	8	0	0
19	55550807	rs141443125	T	C	4	8	12	0	0	12	0	0
19	55550856	rs12460185	C	T	14	2	16	0	0	16	0	0
19	55551002	rs1671209	C	G	3	5	8	0	0	8	0	0
19	55551162	rs1654435	G	A	2	4	6	0	0	6	0	0
19	55551168	rs1654436	T	C	2	4	6	0	0	6	0	0
19	55551797	rs10417328	A	G	5	2	7	0	0	7	0	0
19	55552217	rs2569514	G	A	6	3	9	0	0	9	0	0
19	55553200	rs13958	C	G	6	8	14	0	1	15	0	0
19	55553206	rs1054796	C	G	7	8	15	0	0	15	0	0
19	55553368	rs10418743	G	A	5	3	8	0	0	8	0	0
19	55554138	rs8113032	G	A	4	6	10	0	0	10	0	0
19	55555845	rs4029	A	G	4	6	10	0	0	10	0	0
19	55556154	rs1189	G	A	10	1	11	0	0	11	0	0
19	55556259	rs10666	A	G	5	1	6	0	0	6	0	0
19	55559715	rs2305543	G	A	6	7	13	0	0	13	0	0
19	55609374	rs2603698	C	T	4	3	7	0	0	7	0	0
19	55614923	rs2532060	T	C	62	45	107	0	0	107	0	0
19	55738181	rs3826884	G	A	37	25	62	0	0	62	0	0
19	55738425	rs3745919	G	A	36	32	68	0	1	69	0	0
19	55738746	rs4374298	G	A	13	10	23	0	1	24	0	0
19	55739605	rs4606850	C	T	24	13	37	0	0	37	0	0
19	55739813	rs10419308	G	A	26	13	39	0	0	39	0	0
19	55741205	rs3826886	G	A	182	181	363	0	2	365	0	0
19	55741961	rs28678477	G	C	17	10	27	0	0	27	0	0
19	55745470	rs11879801	A	G	6	16	22	0	1	23	0	0
19	55745682	rs55734554	A	G	16	13	29	0	0	29	0	0
19	55746777	rs12709948	G	A	23	16	39	0	0	39	0	0
19	55859439	rs1058511	C	A	6	6	12	0	0	12	0	0
19	55897327	rs17700376	A	G	1296	875	2171	0	10	2181	0	0
19	55900417	rs11668142	C	G	15	21	36	0	0	36	0	0
19	55901099	rs10425596	T	C	18	27	45	0	0	45	0	0
19	55913038	rs7608	C	T	130	160	290	0	1	291	0	0
19	55913678	rs12709950	C	A	6	5	11	0	0	11	0	0
19	55914374	rs11672075	C	T	73	23	96	0	0	96	0	0
19	55972950	rs2303088	T	G	10	10	20	0	0	20	0	0
19	55972983	rs117829106	C	A	3	6	9	0	0	9	0	0
19	55998863	rs7479	C	T	10	8	18	0	0	18	0	0
19	56089219	rs1053817	C	T	105	112	217	0	4	221	0	0
19	56091475	rs12610512	A	G	22	25	47	0	1	48	0	0
19	56091768	rs76516526	G	A	4	8	12	0	0	12	0	0
19	56091782	rs78670840	G	A	4	8	12	0	0	12	0	0
19	56110172	rs74490421	C	T	5	2	7	0	0	7	0	0
19	56118243	rs11667786	C	T	4	4	8	0	0	8	0	0
19	56125944	rs2280254	C	T	3	4	7	0	0	7	0	0
19	56127597	rs3852898	G	A	21	23	44	0	2	46	0	0
19	56132487	rs2292811	A	G	43	45	88	0	1	89	0	0
19	56146469	rs8108198	G	A	1	8	9	0	0	9	0	0
19	56146924	rs8111497	G	C	6	9	15	0	1	16	0	0
19	56154339	rs12981222	C	T	11	18	29	0	0	29	0	0
19	56154718	rs11233	G	A	210	175	385	0	2	387	0	0
19	56202754	rs12985023	C	T	1	7	8	0	0	8	0	0
19	56227165	rs11882068	A	G	6	1	7	0	0	7	0	0
19	56274213	.	T	A	18	4	22	0	1	23	0	0
19	56274424	.	C	A	102	12	114	0	1	115	0	0
19	56274453	.	G	A	99	7	106	0	0	106	0	0
19	56274506	rs147984855	G	A	95	0	95	0	0	95	0	0
19	56284197	.	C	G	17	0	17	0	0	17	0	0
19	56297249	rs59238812	C	G	6	1	7	0	0	7	0	0
19	56301501	rs10451453	G	A	11	3	14	0	0	14	0	0
19	56301629	rs2616937	C	T	12	2	14	0	0	14	0	0
19	56301633	rs2616938	A	T	10	3	13	0	0	13	0	0
19	56302500	rs299186	C	G	7	4	11	0	0	11	0	0
19	56302961	rs17635546	C	A	3	3	6	0	0	6	0	0
19	56303291	rs7254593	C	T	15	5	20	0	0	20	0	0
19	56303592	rs75255203	C	T	5	3	8	0	0	8	0	0
19	56307583	rs2616940	A	G	21	5	26	0	0	26	0	0
19	56320663	rs12461110	G	A	3	21	24	0	0	24	0	0
19	56824716	rs34709084	A	G	16	19	35	0	0	35	0	0
19	56880744	rs12972381	G	C	4	2	6	0	0	6	0	0
19	56882697	rs11665972	A	G	4	3	7	0	0	7	0	0
19	56888450	rs2304124	A	G	6	13	19	0	1	20	0	0
19	56888454	rs2304125	A	C	15	7	22	0	0	22	0	0
19	56888650	rs33949495	C	T	14	6	20	0	0	20	0	0
19	56890093	rs35086353	C	T	3	5	8	0	0	8	0	0
19	56951374	rs7248278	C	T	7	10	17	0	0	17	0	0
19	56953585	rs3760849	T	C	3	5	8	0	0	8	0	0
19	56953963	rs35914474	G	A	5	3	8	0	0	8	0	0
19	56954103	rs7253217	C	A	3	3	6	0	0	6	0	0
19	56985396	rs35461173	C	A	4	4	8	0	0	8	0	0
19	57006069	rs3971706	G	A	4	2	6	0	0	6	0	0
19	57006721	rs7253	G	C	10	6	16	0	0	16	0	0
19	57065189	rs145011	T	C	8	6	14	0	0	14	0	0
19	57066013	rs10409531	C	T	5	10	15	0	0	15	0	0
19	57068039	rs7258886	C	T	1	5	6	0	0	6	0	0
19	57068749	rs4801174	C	T	3	4	7	0	0	7	0	0
19	57068986	rs10405702	G	C	5	3	8	0	0	8	0	0
19	57133333	rs8106568	T	C	7	1	8	0	0	8	0	0
19	57134257	rs11672542	G	T	4	8	12	0	0	12	0	0
19	57134574	rs1047063	C	G	6	6	12	0	0	12	0	0
19	57134694	rs1047067	T	A	5	3	8	0	0	8	0	0
19	57135195	rs7260368	G	A	5	7	12	0	0	12	0	0
19	57702887	rs59020892	T	C	8	2	10	0	0	10	0	0
19	57702924	rs59940266	G	A	29	14	43	0	0	43	0	0
19	57704516	rs10417807	T	C	2	8	10	0	0	10	0	0
19	57705801	rs11669189	C	G	6	1	7	0	0	7	0	0
19	57760018	rs2014572	G	A	8	14	22	0	0	22	0	0
19	57760057	rs3746231	G	A	10	7	17	0	0	17	0	0
19	57764770	rs10421632	G	A	15	13	28	0	2	30	0	0
19	57765432	rs8100154	A	G	24	18	42	0	1	43	0	0
19	57791639	rs76289041	G	A	3	3	6	0	0	6	0	0
19	57804524	rs3746227	T	C	6	11	17	0	0	17	0	0
19	57840547	rs10410649	A	G	25	23	48	0	0	48	0	0
19	57841082	rs8108680	G	A	5	6	11	0	0	11	0	0
19	57841132	rs10417105	A	G	9	14	23	0	0	23	0	0
19	57841445	rs10417949	C	T	14	13	27	0	0	27	0	0
19	57864599	rs862702	A	T	2	4	6	0	0	6	0	0
19	57865149	rs862704	C	T	10	14	24	0	0	24	0	0
19	57868879	rs34411126	T	C	13	9	22	0	0	22	0	0
19	57869881	rs35686482	C	G	20	12	32	0	0	32	0	0
19	57871141	rs862710	C	A	6	3	9	0	0	9	0	0
19	57902562	rs35042302	T	G	7	8	15	0	0	15	0	0
19	57903918	rs76608813	C	T	3	10	13	0	0	13	0	0
19	57909297	rs55789053	C	T	9	8	17	0	0	17	0	0
19	57909827	rs17856896	G	T	39	35	74	0	0	74	0	0
19	57913872	rs10407882	C	T	5	2	7	0	0	7	0	0
19	57931553	rs10417533	C	T	5	4	9	0	0	9	0	0
19	57946924	rs56241253	G	C	9	10	19	0	0	19	0	0
19	57981687	rs56278798	C	T	3	5	8	0	0	8	0	0
19	57982851	rs2360765	C	T	4	2	6	0	1	7	0	0
19	57982938	rs2885061	C	G	8	4	12	0	0	12	0	0
19	57982983	rs12985337	T	C	8	3	11	0	0	11	0	0
19	57983078	rs2360764	A	G	10	3	13	0	1	14	0	0
19	57983081	rs73065298	C	A	3	11	14	0	0	14	0	0
19	57983457	rs10153521	A	G	6	8	14	0	0	14	0	0
19	57983794	rs10426249	A	T	11	8	19	0	0	19	0	0
19	57983805	rs10426255	A	G	11	7	18	0	0	18	0	0
19	57983911	rs10405925	C	A	5	9	14	0	0	14	0	0
19	57984037	rs12977532	G	A	5	6	11	0	0	11	0	0
19	57984045	rs10407734	T	A	4	6	10	0	0	10	0	0
19	57984190	rs12977381	C	A	8	8	16	0	0	16	0	0
19	57984254	rs10406621	C	T	4	9	13	0	0	13	0	0
19	57985460	rs2074059	T	A	7	8	15	0	0	15	0	0
19	57985566	rs2074060	G	C	7	9	16	0	0	16	0	0
19	58000624	rs7249705	G	A	3	4	7	0	0	7	0	0
19	58002444	rs6510082	A	G	3	3	6	0	0	6	0	0
19	58002819	rs6510085	T	A	4	2	6	0	0	6	0	0
19	58002964	rs1135692	G	C	6	4	10	0	0	10	0	0
19	58003580	rs2074071	A	G	5	1	6	0	0	6	0	0
19	58003613	rs2074072	C	T	6	1	7	0	0	7	0	0
19	58003728	rs2074073	G	A	9	0	9	0	0	9	0	0
19	58003873	rs2074074	C	T	13	5	18	0	0	18	0	0
19	58004346	rs2074076	G	C	9	5	14	0	0	14	0	0
19	58004931	rs2074077	A	G	14	7	21	0	1	22	0	0
19	58005666	rs7248266	C	G	38	15	53	0	0	53	0	0
19	58005668	rs7248267	C	A	38	14	52	0	1	53	0	0
19	58017603	rs2012431	C	T	2	4	6	0	0	6	0	0
19	58017605	rs2012426	A	G	2	4	6	0	0	6	0	0
19	58017753	rs61731281	C	A	13	19	32	0	0	32	0	0
19	58017754	rs61737910	A	G	13	19	32	0	0	32	0	0
19	58017758	rs55823456	G	C	14	19	33	0	0	33	0	0
19	58018618	rs2074064	A	G	41	21	62	0	0	62	0	0
19	58019159	rs4801492	A	G	22	38	60	0	0	60	0	0
19	58019226	rs4801493	A	C	16	20	36	0	0	36	0	0
19	58019455	rs4801494	G	A	15	10	25	0	0	25	0	0
19	58019482	rs56366060	T	C	11	6	17	0	0	17	0	0
19	58019583	rs55903117	A	G	11	17	28	0	0	28	0	0
19	58019593	rs56011859	C	T	11	20	31	0	0	31	0	0
19	58019762	rs66526919	C	T	6	16	22	0	0	22	0	0
19	58019786	rs67448172	C	G	2	7	9	0	0	9	0	0
19	58024442	rs7253945	G	A	3	4	7	0	0	7	0	0
19	58027471	rs6510087	C	T	5	4	9	0	0	9	0	0
19	58027503	rs6510088	G	A	4	4	8	0	0	8	0	0
19	58027603	rs7507741	A	C	7	7	14	0	0	14	0	0
19	58029383	rs2079035	G	A	4	7	11	0	0	11	0	0
19	58058536	rs1548476	A	G	10	4	14	0	1	15	0	0
19	58058739	rs10410631	T	C	7	8	15	0	0	15	0	0
19	58084930	rs3746222	G	A	9	14	23	0	0	23	0	0
19	58099574	rs79193385	C	G	2	4	6	0	0	6	0	0
19	58104446	rs58449774	G	C	4	11	15	0	2	17	0	0
19	58130008	rs12974692	C	T	4	3	7	0	0	7	0	0
19	58200099	rs3746208	T	C	29	35	64	0	0	64	0	0
19	58200628	rs12608585	G	T	53	59	112	0	0	112	0	0
19	58201360	rs12981782	C	T	64	44	108	0	0	108	0	0
19	58207385	rs1009158	T	C	3	3	6	0	0	6	0	0
19	58209064	rs1052850	G	C	4	3	7	0	0	7	0	0
19	58210746	rs11881954	A	G	2	4	6	0	0	6	0	0
19	58210749	rs34095174	C	T	2	4	6	0	0	6	0	0
19	58211530	rs10419113	A	G	4	2	6	0	0	6	0	0
19	58231541	rs1059397	A	G	18	14	32	0	0	32	0	0
19	58231807	rs2239986	A	G	17	20	37	0	0	37	0	0
19	58266503	rs35919456	G	A	19	19	38	0	1	39	0	0
19	58269173	rs13037	G	C	37	40	77	0	0	77	0	0
19	58291228	rs2158013	A	G	105	118	223	0	2	225	0	0
19	58301946	rs9789253	G	A	5	1	6	0	0	6	0	0
19	58319123	rs7250447	C	A	10	9	19	0	1	20	0	0
19	58352522	rs12981244	G	A	5	7	12	0	0	12	0	0
19	58352806	rs35313547	T	C	6	6	12	0	0	12	0	0
19	58354265	rs34871518	G	A	1	6	7	0	0	7	0	0
19	58354536	rs10424027	A	G	2	5	7	0	0	7	0	0
19	58374953	rs5029044	T	C	8	11	19	0	0	19	0	0
19	58375222	rs66515265	C	A	7	6	13	0	0	13	0	0
19	58375558	rs10422548	A	G	5	4	9	0	0	9	0	0
19	58378516	rs11668314	A	G	5	1	6	0	0	6	0	0
19	58379089	rs4801527	G	A	4	2	6	0	0	6	0	0
19	58383921	rs4801239	C	T	10	16	26	0	0	26	0	0
19	58417415	rs78462426	C	G	11	10	21	0	0	21	0	0
19	58417426	rs6510112	G	A	10	12	22	0	0	22	0	0
19	58417949	rs143993973	T	C	5	6	11	0	0	11	0	0
19	58439306	rs7253514	G	A	4	4	8	0	0	8	0	0
19	58457316	rs3810129	C	G	2	4	6	0	0	6	0	0
19	58459023	rs16988298	C	G	13	15	28	0	0	28	0	0
19	58572959	rs2288274	G	A	9	7	16	0	0	16	0	0
19	58572979	rs1469087	G	A	10	8	18	0	0	18	0	0
19	58579927	rs12461217	A	C	5	5	10	0	0	10	0	0
19	58580277	rs1057402	C	T	4	8	12	0	0	12	0	0
19	58595676	rs10878	G	T	97	97	194	0	0	194	0	0
19	58597405	rs1064267	C	T	5	1	6	0	0	6	0	0
19	58597968	rs3745126	C	G	5	8	13	0	0	13	0	0
19	58599443	rs34114202	G	A	26	13	39	0	0	39	0	0
19	58599760	rs35358425	T	C	12	20	32	0	0	32	0	0
19	58600048	rs1529329	C	T	13	6	19	0	0	19	0	0
19	58604212	rs12981202	C	T	7	2	9	0	0	9	0	0
19	58605521	rs12977251	T	C	4	3	7	0	0	7	0	0
19	58605523	rs12975230	A	G	4	3	7	0	0	7	0	0
19	58606731	rs2547283	C	G	5	1	6	0	0	6	0	0
19	58608592	rs11084533	G	A	4	7	11	0	0	11	0	0
19	58774071	rs260462	A	G	16	13	29	0	0	29	0	0
19	58774581	rs260463	G	C	10	7	17	0	0	17	0	0
19	58774762	rs260464	G	T	11	12	23	0	0	23	0	0
19	58776215	rs260467	A	T	3	3	6	0	0	6	0	0
19	58783857	rs11667248	G	C	4	5	9	0	0	9	0	0
19	58785739	rs379075	G	C	28	25	53	0	0	53	0	0
19	58785900	rs500286	C	T	15	17	32	0	0	32	0	0
19	58790359	rs11666156	C	A	4	10	14	0	0	14	0	0
19	58790675	rs437229	T	C	2	5	7	0	0	7	0	0
19	58790713	rs374431	G	C	5	5	10	0	0	10	0	0
19	58790807	rs260501	T	G	10	4	14	0	0	14	0	0
19	58791213	rs260500	C	A	5	1	6	0	0	6	0	0
19	58792190	rs260498	T	A	4	7	11	0	0	11	0	0
19	58792213	rs260497	T	C	5	4	9	0	0	9	0	0
19	58793064	rs11671486	C	G	3	4	7	0	0	7	0	0
19	58795474	rs112884174	T	C	6	0	6	0	0	6	0	0
19	58929136	rs3764534	G	A	4	4	8	0	0	8	0	0
19	58929305	rs3764531	G	C	2	4	6	0	0	6	0	0
19	58978517	rs4801595	G	A	9	5	14	0	1	15	0	0
19	58983549	rs11673703	G	A	8	3	11	0	0	11	0	0
19	58986799	rs3794968	G	C	13	9	22	0	0	22	0	0
19	58991900	rs882610	G	A	31	24	55	0	1	56	0	0
19	59027967	.	G	A	7	10	17	0	1	18	0	0
19	59058083	rs7249714	G	T	10	10	20	0	0	20	0	0
19	59065952	rs873104	T	C	13	7	20	0	0	20	0	0
19	59069353	rs3794965	T	C	6	0	6	0	0	6	0	0
19	59073871	.	G	A	15	10	25	0	0	25	0	0
19	59082605	rs3752109	C	T	9	9	18	0	0	18	0	0
19	59093239	rs10448	T	C	21	14	35	0	0	35	0	0
19	59093464	rs7910	C	T	18	25	43	0	0	43	0	0
19	59093484	rs3499	G	T	18	22	40	0	0	40	0	0
19	59094453	rs3211055	A	C	24	12	36	0	0	36	0	0
19	59094709	rs3752108	C	G	23	22	45	0	0	45	0	0
19	59095126	rs8110595	G	T	20	17	37	0	0	37	0	0
2	218386	rs9213	G	A	4	2	6	0	0	6	0	0
2	224919	rs2290911	A	G	5	2	7	0	0	7	0	0
2	242800	rs10181051	T	C	6	0	6	0	0	6	0	0
2	260677	rs10188763	G	A	4	3	7	0	0	7	0	0
2	268293	rs55946380	A	G	2	4	6	0	0	6	0	0
2	272203	rs11553746	C	T	144	163	307	0	0	307	0	0
2	274672	rs62114548	C	G	4	13	17	0	0	17	0	0
2	276346	rs4452185	T	C	8	8	16	0	1	17	0	0
2	276942	rs7573495	A	G	9	6	15	0	0	15	0	0
2	277003	rs79716074	A	G	228	248	476	0	8	484	0	0
2	277314	rs77927634	G	A	258	280	538	0	2	540	0	0
2	546410	rs17783026	T	C	5	3	8	0	0	8	0	0
2	3193040	rs17682	G	A	72	65	137	0	2	139	0	0
2	3204203	rs11127385	G	C	7	5	12	0	0	12	0	0
2	3204480	rs7585437	C	T	2	7	9	0	1	10	0	0
2	3204973	rs6548128	C	T	10	6	16	0	1	17	0	0
2	3205769	rs6731883	G	A	1	5	6	0	0	6	0	0
2	3205833	rs6743077	C	T	5	4	9	0	0	9	0	0
2	3205912	rs184068122	G	T	8	3	11	0	0	11	0	0
2	3212247	rs7584823	G	T	1	5	6	0	0	6	0	0
2	3212704	rs7595702	C	A	2	4	6	0	0	6	0	0
2	3212817	rs12467123	C	T	3	5	8	0	0	8	0	0
2	3215904	rs35904035	G	A	6	6	12	0	0	12	0	0
2	3215908	rs62119005	C	T	6	7	13	0	0	13	0	0
2	3216290	rs7599793	G	A	4	4	8	0	0	8	0	0
2	3383538	rs10176767	C	G	1	6	7	0	0	7	0	0
2	3392075	rs10865541	T	C	6	2	8	0	0	8	0	0
2	3392295	rs11686212	A	G	9	3	12	0	0	12	0	0
2	3469463	rs4971514	G	C	19	10	29	0	0	29	0	0
2	3481716	rs4535075	T	C	4	3	7	0	0	7	0	0
2	3483205	rs6767	C	T	21	24	45	0	0	45	0	0
2	3502035	rs1130333	C	T	12	5	17	0	0	17	0	0
2	3502055	rs1130319	T	G	10	9	19	0	0	19	0	0
2	3502198	rs3349	T	A	21	8	29	0	0	29	0	0
2	3502398	rs1130165	C	T	123	162	285	0	1	286	0	0
2	3502625	rs1130127	T	C	63	80	143	0	1	144	0	0
2	3502709	rs10208494	A	G	100	126	226	0	1	227	0	0
2	3504687	rs9950	A	G	93	139	232	0	3	235	0	0
2	3519572	rs6422707	A	C	4	4	8	0	0	8	0	0
2	3519616	rs13012176	A	G	3	4	7	0	0	7	0	0
2	3519839	rs13012839	A	G	1	5	6	0	0	6	0	0
2	7059932	rs10193011	C	T	3	5	8	0	0	8	0	0
2	7060884	rs17606606	G	A	0	6	6	0	1	7	0	0
2	7061691	rs4669119	G	A	2	4	6	0	0	6	0	0
2	7164578	rs376219	A	G	27	30	57	0	0	57	0	0
2	7167153	rs416416	C	G	3	4	7	0	0	7	0	0
2	7181486	rs309304	A	G	37	36	73	0	1	74	0	0
2	7181560	rs309303	G	A	42	52	94	0	2	96	0	0
2	7182177	rs309302	G	A	49	57	106	0	0	106	0	0
2	7188238	rs309295	G	A	2	5	7	0	0	7	0	0
2	7215657	rs1453126	T	C	3	3	6	0	0	6	0	0
2	7216231	rs10445713	T	C	5	8	13	0	0	13	0	0
2	8822307	.	C	T	773	787	1560	0	5	1565	0	0
2	8823553	rs2306067	A	G	78	92	170	0	2	172	0	0
2	8877042	rs61742863	G	A	11	15	26	0	0	26	0	0
2	8890355	.	C	T	11	11	22	0	0	22	0	0
2	8933820	rs73151205	C	T	20	2	22	0	0	22	0	0
2	8938020	rs7602942	C	G	7	8	15	0	0	15	0	0
2	8961158	rs68032361	C	T	6	0	6	0	0	6	0	0
2	8962477	rs73916012	C	T	4	6	10	0	0	10	0	0
2	9348261	rs34463422	T	C	17	41	58	0	0	58	0	0
2	9348667	rs34254156	G	A	5	9	14	0	0	14	0	0
2	9514917	rs33930824	C	T	17	9	26	0	0	26	0	0
2	9528536	rs2715860	G	C	16	18	34	0	0	34	0	0
2	9543852	rs11537589	G	A	12	23	35	0	0	35	0	0
2	9546805	rs4798	C	T	6	1	7	0	0	7	0	0
2	9558614	rs16867025	T	C	6	2	8	0	0	8	0	0
2	9560477	rs147028704	T	A	4	3	7	0	0	7	0	0
2	9561505	rs62118846	T	C	3	3	6	0	0	6	0	0
2	9562294	rs56063038	T	G	2	4	6	0	0	6	0	0
2	9581666	rs7607741	G	A	3	6	9	0	0	9	0	0
2	9618133	rs59018063	T	C	4	4	8	0	0	8	0	0
2	9629731	rs10063	T	C	30	30	60	0	0	60	0	0
2	9632802	rs55855916	T	C	3	7	10	0	0	10	0	0
2	9634381	rs12475630	C	T	2	4	6	0	0	6	0	0
2	9639826	rs66995158	G	A	5	4	9	0	0	9	0	0
2	9667751	rs17525468	T	C	5	2	7	0	0	7	0	0
2	9695888	rs55790676	G	T	10	8	18	0	0	18	0	0
2	9696564	rs2177639	T	G	4	2	6	0	0	6	0	0
2	9726599	rs62119422	A	G	6	4	10	0	0	10	0	0
2	9726601	rs62119423	C	T	6	4	10	0	0	10	0	0
2	9728574	rs67724256	A	G	33	27	60	0	1	61	0	0
2	9729165	rs13024142	C	T	27	27	54	0	2	56	0	0
2	9730208	rs17362734	A	G	40	37	77	0	0	77	0	0
2	9733386	rs13033994	T	G	5	4	9	0	1	10	0	0
2	9734859	rs10495572	G	C	5	9	14	0	0	14	0	0
2	9734891	rs114686226	T	C	5	10	15	0	0	15	0	0
2	9737184	rs13024360	T	C	2	4	6	0	0	6	0	0
2	9746668	rs113937820	A	G	2	4	6	0	0	6	0	0
2	9767441	rs16867083	T	C	11	5	16	0	0	16	0	0
2	9767771	rs1524667	T	C	7	0	7	0	0	7	0	0
2	9767944	rs60319753	A	G	9	0	9	0	0	9	0	0
2	9768564	rs17362902	A	G	4	6	10	0	0	10	0	0
2	9770050	rs13417081	A	G	0	8	8	0	0	8	0	0
2	9770613	rs1130874	G	A	152	68	220	0	0	237	17	0
2	9983686	rs2303914	G	T	17	10	27	0	0	27	0	0
2	10050947	rs1054561	T	C	8	8	16	0	0	16	0	0
2	10050960	rs1054565	A	G	7	9	16	0	1	17	0	0
2	10059770	rs1820965	G	T	13	13	26	0	0	26	0	0
2	10059844	rs16867245	C	T	12	10	22	0	0	22	0	0
2	10078146	rs1044645	C	A	4	3	7	0	0	7	0	0
2	10078151	rs13071	C	T	4	2	6	0	0	6	0	0
2	10186419	rs35927125	A	G	26	5	31	0	0	31	0	0
2	10193178	rs4444493	C	A	41	8	49	0	0	49	0	0
2	10194487	rs7632	T	C	10	48	58	0	0	58	0	0
2	10450398	rs6734475	G	A	3	3	6	0	0	6	0	0
2	10450934	rs79984833	G	A	3	3	6	0	0	6	0	0
2	10451111	rs11695971	G	A	2	4	6	0	0	6	0	0
2	10452145	rs56158659	G	A	7	6	13	0	0	13	0	0
2	10452188	.	A	G	4	5	9	0	0	9	0	0
2	10452623	rs201354875	C	A	5	8	13	0	0	13	0	0
2	10453281	rs11695331	T	A	6	4	10	0	0	10	0	0
2	10453830	rs74899716	A	G	4	5	9	0	0	9	0	0
2	10453849	rs2160189	G	A	6	6	12	0	0	12	0	0
2	10453866	rs16856100	C	T	6	6	12	0	0	12	0	0
2	10454086	rs2884209	G	A	3	7	10	0	0	10	0	0
2	10455287	rs1861230	C	T	4	5	9	0	0	9	0	0
2	10455798	rs116995639	T	G	4	4	8	0	0	8	0	0
2	10456586	rs78417861	G	A	5	9	14	0	0	14	0	0
2	10461828	rs75016093	A	C	4	2	6	0	0	6	0	0
2	10463346	rs79821570	C	T	5	1	6	0	0	6	0	0
2	10537018	rs2270302	A	G	22	38	60	0	0	60	0	0
2	10544452	rs3771140	A	T	4	5	9	0	0	9	0	0
2	10555214	rs3821199	T	C	4	2	6	0	0	6	0	0
2	10556307	rs62130191	A	G	7	4	11	0	0	11	0	0
2	10556956	rs13383055	G	A	3	3	6	0	0	6	0	0
2	10557971	rs6730996	T	C	1	5	6	0	0	6	0	0
2	10566989	rs116688020	C	T	69	64	133	0	0	133	0	0
2	10580967	rs1049500	G	A	355	362	717	0	3	720	0	0
2	10585303	rs11538365	T	C	239	165	404	0	1	406	1	0
2	10585311	rs2302614	A	C	169	216	385	0	1	386	0	0
2	10715777	rs12692410	G	A	1	6	7	0	0	7	0	0
2	10715847	rs9973898	G	A	1	5	6	0	0	6	0	0
2	11318477	rs3911110	C	T	26	41	67	0	1	68	0	0
2	11321880	rs1129976	C	T	9	6	15	0	0	15	0	0
2	11586035	rs11203	G	A	14	3	17	0	0	17	0	0
2	11586219	rs1047392	A	G	10	7	17	0	0	17	0	0
2	11911761	rs11538448	C	T	48	39	87	0	1	88	0	0
2	11924950	rs3795974	T	C	6	9	15	0	0	15	0	0
2	11945533	rs62114965	C	A	3	3	6	0	0	6	0	0
2	11947203	rs62114966	T	C	7	6	13	0	0	13	0	0
2	11947400	rs73917819	T	C	5	8	13	0	0	13	0	0
2	11957809	rs143968310	A	G	3	3	6	0	0	6	0	0
2	11957886	rs2577260	G	C	4	6	10	0	0	10	0	0
2	11958293	rs139711356	G	A	4	7	11	0	0	11	0	0
2	11965541	rs2716639	A	G	43	50	93	0	1	94	0	0
2	15674686	rs13029846	T	C	7	7	14	0	0	14	0	0
2	15747393	rs10929378	C	T	86	86	172	0	0	172	0	0
2	15747875	rs6431718	C	T	4	3	7	0	0	7	0	0
2	15762991	rs4668457	A	G	1	6	7	0	1	8	0	0
2	15763097	rs77552768	A	G	3	3	6	0	1	7	0	0
2	16733016	.	C	T	56	55	111	0	0	111	0	0
2	16738880	rs12710736	C	T	7	9	16	0	0	16	0	0
2	16740367	rs10195641	T	C	20	20	40	0	0	40	0	0
2	16741442	rs7586823	C	T	23	29	52	0	0	52	0	0
2	16744931	rs79531477	C	T	5	2	7	0	0	7	0	0
2	16751119	rs10206736	C	T	3	3	6	0	0	6	0	0
2	16770078	rs10178754	T	C	3	3	6	0	0	6	0	0
2	16770592	rs10171652	C	T	2	4	6	0	0	6	0	0
2	16770723	rs10176532	A	G	6	5	11	0	0	11	0	0
2	16771812	rs78379477	G	A	5	4	9	0	0	9	0	0
2	16783500	rs74809983	T	G	11	17	28	0	0	28	0	0
2	16785169	rs59622496	C	A	3	11	14	0	1	15	0	0
2	16786035	rs73918606	G	C	12	22	34	0	0	34	0	0
2	16786036	rs73918607	G	A	12	21	33	0	1	34	0	0
2	16786486	rs967824	A	G	4	7	11	0	0	11	0	0
2	16788178	rs10200573	A	T	3	12	15	0	0	15	0	0
2	16788905	rs6732559	G	A	3	9	12	0	0	12	0	0
2	16789069	rs6756008	T	C	7	10	17	0	0	17	0	0
2	16790722	rs75830409	T	C	11	4	15	0	0	15	0	0
2	16790749	rs4832469	G	A	9	5	14	0	0	14	0	0
2	16795553	rs17643147	G	A	5	13	18	0	0	18	0	0
2	16795567	rs6720167	A	G	10	4	14	0	0	14	0	0
2	16795666	rs6723770	T	C	7	4	11	0	0	11	0	0
2	16795905	rs6724022	T	A	11	5	16	0	0	16	0	0
2	16796470	rs751192	C	T	7	4	11	0	0	11	0	0
2	16796596	rs888575	G	A	10	4	14	0	0	14	0	0
2	16798505	rs6750902	G	T	2	6	8	0	0	8	0	0
2	16799165	rs56141481	C	T	5	7	12	0	0	12	0	0
2	16799241	rs10167880	C	T	6	6	12	0	0	12	0	0
2	16800656	rs13017624	T	G	4	2	6	0	0	6	0	0
2	16800831	rs112736147	C	T	2	5	7	0	0	7	0	0
2	16803449	rs11681660	C	T	7	2	9	0	0	9	0	0
2	16804684	rs6729627	C	T	2	8	10	0	0	10	0	0
2	16807035	rs6729718	G	A	6	2	8	0	0	8	0	0
2	16813968	.	T	C	4	8	12	0	0	12	0	0
2	16824052	rs72777951	T	C	4	5	9	0	0	9	0	0
2	16841189	rs75172956	T	C	6	2	8	0	0	8	0	0
2	16844105	rs79976934	G	T	6	2	8	0	0	8	0	0
2	20246915	.	C	T	2	4	6	0	0	6	0	0
2	20448521	rs6669	C	T	6	3	9	0	0	9	0	0
2	20464030	rs6750331	G	A	5	5	10	0	0	10	0	0
2	20465218	rs55747711	G	A	17	18	35	0	1	36	0	0
2	20467352	rs72785299	A	C	16	17	33	0	0	33	0	0
2	20467746	rs72787403	G	T	12	14	26	0	0	26	0	0
2	20467929	rs4666299	C	T	15	10	25	0	0	25	0	0
2	20471952	rs7596757	A	G	6	6	12	0	1	13	0	0
2	20472847	rs10164749	G	A	13	13	26	0	0	26	0	0
2	20474283	rs34065896	G	A	8	5	13	0	0	13	0	0
2	20491212	rs11096655	G	A	6	5	11	0	0	11	0	0
2	20491470	.	G	A	11	7	18	0	0	18	0	0
2	20491632	rs16987546	G	A	5	4	9	0	0	9	0	0
2	20647241	rs7043	C	T	96	74	170	0	1	171	0	0
2	20884262	rs2419	G	A	7	5	12	0	0	12	0	0
2	20884368	rs67562647	T	C	11	5	16	0	0	16	0	0
2	20884550	rs11693849	C	A	8	11	19	0	0	19	0	0
2	20885321	rs17663874	C	A	3	7	10	0	0	10	0	0
2	24291080	rs10194004	A	G	5	3	8	0	0	8	0	0
2	24296606	rs3769665	C	T	6	1	7	0	0	7	0	0
2	24300563	rs10209238	T	C	3	4	7	0	0	7	0	0
2	24307250	.	G	A	3	5	8	0	0	8	0	0
2	24308128	rs10170774	T	C	3	4	7	0	0	7	0	0
2	24318236	rs11886838	C	A	6	7	13	0	0	13	0	0
2	24318343	rs6755030	C	T	4	3	7	0	0	7	0	0
2	24318674	rs13406445	T	C	6	6	12	0	0	12	0	0
2	24318768	rs13415402	G	A	5	4	9	0	0	9	0	0
2	24318837	rs13415416	G	A	13	12	25	0	1	26	0	0
2	24318974	.	C	G	15	17	32	0	0	32	0	0
2	24319332	rs7606853	C	T	24	7	31	0	0	31	0	0
2	24319352	rs7567487	A	G	21	9	30	0	2	32	0	0
2	24319450	rs7606989	C	T	14	11	25	0	0	25	0	0
2	24319987	rs12328755	T	C	14	20	34	0	0	34	0	0
2	24320527	rs12472421	A	G	16	12	28	0	0	28	0	0
2	24320649	rs11125422	A	G	25	24	49	0	0	49	0	0
2	24321673	rs13022514	G	A	26	22	48	0	0	48	0	0
2	24321753	rs11897230	A	G	27	14	41	0	0	41	0	0
2	24322033	rs540689115	C	A	23	7	30	0	0	30	0	0
2	24322310	rs12713190	C	T	20	25	45	0	1	46	0	0
2	24322312	rs12713191	G	A	19	26	45	0	0	45	0	0
2	24322341	rs12713192	G	A	25	24	49	0	0	49	0	0
2	24322769	rs12713193	C	T	49	19	68	0	0	68	0	0
2	24322874	rs76995310	T	C	31	18	49	0	0	49	0	0
2	24323106	rs12713195	A	G	38	22	60	0	1	61	0	0
2	24323107	rs12713196	G	A	40	23	63	0	0	63	0	0
2	24323610	rs55816106	T	C	37	47	84	0	0	84	0	0
2	24323885	rs10201331	A	T	47	33	80	0	1	81	0	0
2	24323987	rs10164930	G	A	2	7	9	0	2	11	0	0
2	24358001	rs12329297	G	C	24	12	36	0	1	37	0	0
2	24384424	rs4665667	T	C	19	13	32	0	0	32	0	0
2	24390517	rs2288072	G	A	19	33	52	0	1	53	0	0
2	24426534	rs61754183	A	G	21	22	43	0	0	43	0	0
2	24428859	rs72793980	T	C	4	2	6	0	0	6	0	0
2	24439048	rs3731625	A	G	28	28	56	0	1	57	0	0
2	24462883	rs2551180	C	T	26	22	48	0	1	49	0	0
2	24462915	rs2543673	G	C	25	23	48	0	0	48	0	0
2	24463398	rs4233704	T	G	26	23	49	0	1	50	0	0
2	24463987	rs4665674	A	G	31	23	54	0	1	55	0	0
2	24464495	rs6733351	A	T	49	36	85	0	1	86	0	0
2	24466142	rs6545365	C	G	14	6	20	0	0	20	0	0
2	24467010	rs1986514	T	C	4	4	8	0	0	8	0	0
2	24468191	rs78265103	A	T	1	5	6	0	0	6	0	0
2	24472130	rs6750301	C	T	4	3	7	0	0	7	0	0
2	24475868	rs72855412	A	G	8	5	13	0	0	13	0	0
2	24477840	rs4665677	T	C	8	11	19	0	0	19	0	0
2	24480295	rs6545374	T	C	2	4	6	0	0	6	0	0
2	24482378	rs4665678	A	G	22	29	51	0	0	51	0	0
2	24482528	rs4665679	T	C	33	22	55	0	1	56	0	0
2	24483997	.	G	T	37	31	68	0	1	69	0	0
2	24520497	rs2384005	G	A	4	3	7	0	1	8	0	0
2	24521493	rs7559133	C	T	14	6	20	0	1	21	0	0
2	24524958	rs7603997	C	T	64	41	105	0	3	108	0	0
2	24527640	rs78371521	A	G	6	8	14	0	0	14	0	0
2	24545088	rs2551123	T	C	2	4	6	0	0	6	0	0
2	24547636	rs2702044	T	C	2	5	7	0	0	7	0	0
2	24548771	rs2702045	G	A	3	3	6	0	0	6	0	0
2	24583198	rs4332878	T	A	11	6	17	0	0	17	0	0
2	24746556	.	G	A	3	5	8	0	0	8	0	0
2	24746647	rs6741978	C	T	6	7	13	0	0	13	0	0
2	24905927	rs11125744	G	C	26	39	65	0	1	66	0	0
2	24974945	rs11125763	T	G	51	65	116	0	0	116	0	0
2	25022598	rs1550116	A	G	4	4	8	0	0	8	0	0
2	25042625	rs1044040	C	G	191	184	375	0	1	376	0	0
2	25044100	rs74624011	C	T	21	30	51	0	0	51	0	0
2	25044740	rs76078428	C	T	7	10	17	0	0	17	0	0
2	25044754	rs3198665	A	G	6	12	18	0	0	18	0	0
2	25044755	rs1058064	C	T	6	12	18	0	0	18	0	0
2	25044763	rs3198667	A	G	5	9	14	0	0	14	0	0
2	25044957	rs17799872	G	A	8	12	20	0	0	20	0	0
2	25046090	rs1127568	T	C	122	143	265	0	1	266	0	0
2	25046355	rs4665273	T	C	4	2	6	0	0	6	0	0
2	25046844	rs4665274	A	G	5	4	9	0	0	9	0	0
2	25047484	rs1814391	G	A	4	4	8	0	0	8	0	0
2	25047632	rs1806822	C	T	2	6	8	0	0	8	0	0
2	25047910	rs934610	A	G	6	8	14	0	0	14	0	0
2	25048847	rs2289090	A	G	5	5	10	0	0	10	0	0
2	25050977	rs7566416	T	C	100	93	193	0	4	197	0	0
2	25051727	rs72792190	A	G	11	21	32	0	0	32	0	0
2	25053019	rs138095446	C	G	7	9	16	0	0	16	0	0
2	25053066	rs145484204	T	C	9	14	23	0	0	23	0	0
2	25053828	rs1056074	T	C	5	6	11	0	0	11	0	0
2	25054261	rs753529	G	A	4	7	11	0	0	11	0	0
2	25055300	rs4665727	A	G	2	9	11	0	0	11	0	0
2	25055446	rs6713448	T	G	3	8	11	0	0	11	0	0
2	25056496	rs72792199	C	T	7	6	13	0	0	13	0	0
2	25056499	rs13416733	G	C	7	6	13	0	0	13	0	0
2	25056618	rs11688862	G	C	21	27	48	0	1	49	0	0
2	25058941	rs79988608	G	A	4	3	7	0	0	7	0	0
2	25064157	rs2241758	G	C	68	61	129	0	1	130	0	0
2	25141434	rs61732745	G	A	57	40	97	0	2	99	0	0
2	25169200	rs1172294	A	G	9	12	21	0	0	21	0	0
2	25194741	rs7593864	G	A	22	8	30	0	0	30	0	0
2	25966027	.	T	C	14	14	28	0	1	29	0	0
2	26149988	rs10202406	G	C	7	7	14	0	0	14	0	0
2	26150589	rs6738270	G	T	2	4	6	0	0	6	0	0
2	26150773	rs6728684	T	G	8	2	10	0	0	10	0	0
2	26151206	rs6731972	T	C	8	11	19	0	0	19	0	0
2	26151643	rs2072695	A	T	1	6	7	0	0	7	0	0
2	26284143	rs1030730	T	C	5	6	11	0	0	11	0	0
2	26284670	rs1434079	C	G	5	1	6	0	0	6	0	0
2	26287376	rs34536218	T	A	2	4	6	0	0	6	0	0
2	26290828	rs3955310	T	G	2	4	6	0	0	6	0	0
2	26291146	rs2384322	C	G	6	15	21	0	1	22	0	0
2	26344787	rs11126375	G	A	4	4	8	0	0	8	0	0
2	26359315	rs3177055	G	A	5	6	11	0	0	11	0	0
2	26413817	rs1049987	C	T	267	266	533	0	1	534	0	0
2	26413917	rs7260	C	T	428	431	859	0	4	863	0	0
2	26419470	rs6730310	C	G	4	4	8	0	1	9	0	0
2	26419474	rs6730311	C	T	4	5	9	0	0	9	0	0
2	26423414	rs6716858	G	A	7	10	17	0	0	17	0	0
2	26438276	rs962217	T	C	4	4	8	0	0	8	0	0
2	26455127	rs11552518	G	A	243	257	500	0	2	502	0	0
2	26465848	rs6752314	C	T	6	5	11	0	0	11	0	0
2	26477650	rs2033317	G	A	5	7	12	0	0	12	0	0
2	26481959	rs34728554	C	G	7	8	15	0	0	15	0	0
2	26482129	rs146134032	A	G	4	5	9	0	0	9	0	0
2	26482361	rs35461456	C	G	4	5	9	0	0	9	0	0
2	26485586	rs10495756	A	G	6	7	13	0	0	13	0	0
2	26489576	rs35709279	T	C	6	2	8	0	0	8	0	0
2	26489621	rs34291477	A	G	3	3	6	0	0	6	0	0
2	26501953	rs7604564	C	A	7	5	12	0	1	13	0	0
2	26502875	rs1056389	T	C	125	128	253	0	2	255	0	0
2	26512733	rs1056632	T	G	16	7	23	0	1	24	0	0
2	27260469	rs1124649	G	A	47	38	85	0	0	85	0	0
2	27293150	rs1053609	G	T	12	2	14	0	0	14	0	0
2	27306455	rs36035398	C	T	13	6	19	0	0	19	0	0
2	27309659	rs6742004	A	C	5	1	6	0	0	6	0	0
2	27315252	rs2304681	G	A	5	4	9	0	0	9	0	0
2	27324036	rs1057394	G	A	14	13	27	0	0	27	0	0
2	27324724	rs2384571	G	C	19	10	29	0	0	29	0	0
2	27324751	rs2384572	G	T	19	11	30	0	2	32	0	0
2	27424636	rs1395	G	A	39	45	84	0	0	84	0	0
2	27429808	rs61280535	G	A	25	19	44	0	0	44	0	0
2	27430781	rs1275528	A	G	5	3	8	0	0	8	0	0
2	27435374	rs11608	G	A	35	33	68	0	0	68	0	0
2	27437496	rs1275535	C	T	4	4	8	0	0	8	0	0
2	27460968	rs1141313	A	G	12	23	35	0	1	36	0	0
2	27462076	rs3739092	C	T	28	10	38	0	0	38	0	0
2	27548818	.	G	C	12	14	26	0	1	27	0	0
2	27550967	rs1049817	A	G	33	41	74	0	1	75	0	0
2	27574953	rs4665969	T	C	4	2	6	0	0	6	0	0
2	27579231	rs6760828	T	C	6	6	12	0	0	12	0	0
2	27589810	rs2280737	T	C	6	7	13	0	0	13	0	0
2	27592423	rs7602534	C	T	2	6	8	0	0	8	0	0
2	27595515	.	T	C	74	61	135	0	0	135	0	0
2	27595756	rs1528533	G	C	12	7	19	0	0	19	0	0
2	27596395	rs6547589	C	A	15	9	24	0	0	24	0	0
2	27598097	rs4665972	T	C	6	3	9	0	0	9	0	0
2	27598155	rs4665973	G	A	4	2	6	0	1	7	0	0
2	27599132	rs12475426	G	A	5	7	12	0	0	12	0	0
2	27599875	rs1104	T	G	87	61	148	0	0	148	0	0
2	27600239	rs13472	G	A	36	21	57	0	0	57	0	0
2	27600814	rs61995753	G	A	77	43	120	0	0	120	0	0
2	27604279	rs4582	A	G	174	191	365	0	1	366	0	0
2	27608115	rs1647284	C	T	6	4	10	0	0	10	0	0
2	27652153	rs780100	G	T	3	3	6	0	0	6	0	0
2	27655447	rs3845686	T	G	4	2	6	0	0	6	0	0
2	27656036	rs809673	A	G	3	3	6	0	0	6	0	0
2	27657167	rs704791	T	C	7	7	14	0	0	14	0	0
2	27657681	rs77005271	C	T	24	14	38	0	0	38	0	0
2	27659491	rs780102	T	C	25	25	50	0	0	50	0	0
2	27663215	rs1260341	T	A	13	2	15	0	0	15	0	0
2	27663416	rs1260342	G	T	9	8	17	0	0	17	0	0
2	27667297	rs4803	A	G	7	7	14	0	0	14	0	0
2	27672200	rs147850047	C	T	9	8	17	0	1	18	0	0
2	27676287	rs56076827	A	T	8	13	21	0	0	21	0	0
2	27677498	rs148624326	C	A	10	7	17	0	0	17	0	0
2	27689700	rs1406295	A	G	3	3	6	0	1	7	0	0
2	27883358	rs111746097	T	C	6	7	13	0	0	13	0	0
2	28000724	rs35463245	C	G	12	14	26	0	0	26	0	0
2	28001051	rs17006242	C	A	6	10	16	0	0	16	0	0
2	28002002	rs3792253	T	C	15	13	28	0	0	28	0	0
2	28112655	rs78911608	C	G	15	15	30	0	1	31	0	0
2	28165263	.	T	C	37	19	56	0	0	56	0	0
2	28219608	rs1458397	T	C	6	3	9	0	0	9	0	0
2	28542345	rs6547841	T	C	4	2	6	0	0	6	0	0
2	28624161	rs4666069	C	T	5	4	9	0	1	10	0	0
2	28629159	rs34638167	C	T	8	5	13	0	0	13	0	0
2	28632191	rs931949	G	A	85	74	159	0	1	160	0	0
2	28824793	rs7601771	C	G	8	3	11	0	0	11	0	0
2	28854958	rs2199619	C	T	28	23	51	0	1	52	0	0
2	28856195	rs3752900	A	G	1	8	9	0	0	9	0	0
2	28856382	rs55708064	A	G	3	17	20	0	0	20	0	0
2	28856594	rs6721990	T	C	4	18	22	0	0	22	0	0
2	28856801	rs6719289	A	G	8	12	20	0	0	20	0	0
2	28865760	rs2272387	T	C	13	2	15	0	0	15	0	0
2	28865968	rs57817040	T	C	16	5	21	0	1	22	0	0
2	28866032	rs3088281	A	C	19	4	23	0	0	23	0	0
2	28866469	rs2272386	A	C	9	5	14	0	0	14	0	0
2	28975690	rs4666119	C	G	4	4	8	0	0	8	0	0
2	28976403	rs4665434	A	G	6	2	8	0	0	8	0	0
2	28978398	rs77011205	T	G	3	5	8	0	0	8	0	0
2	28981983	rs6547873	G	A	7	3	10	0	0	10	0	0
2	28982030	rs6547874	A	G	5	3	8	0	0	8	0	0
2	28983991	rs10865507	T	C	7	5	12	0	0	12	0	0
2	28989667	rs6709674	A	G	4	6	10	0	0	10	0	0
2	28992004	rs12472549	T	C	5	2	7	0	0	7	0	0
2	28992020	rs11127189	T	G	5	2	7	0	0	7	0	0
2	28992293	rs12714243	G	A	3	7	10	0	0	10	0	0
2	28992607	rs6706858	C	G	1	6	7	0	0	7	0	0
2	28995226	rs10183665	A	G	5	2	7	0	0	7	0	0
2	28996295	rs7579277	G	A	4	3	7	0	1	8	0	0
2	28998077	rs10204329	G	C	4	7	11	0	0	11	0	0
2	28999336	rs6728459	A	G	5	4	9	0	0	9	0	0
2	29001691	rs1128416	A	G	310	314	624	0	1	625	0	0
2	29004299	rs6730321	T	C	4	2	6	0	0	6	0	0
2	29005602	rs3768665	G	A	9	8	17	0	0	17	0	0
2	29005870	rs3768666	C	T	14	9	23	0	0	23	0	0
2	29006591	rs6547877	G	C	6	5	11	0	0	11	0	0
2	29007349	rs6742291	T	C	16	28	44	0	0	44	0	0
2	29007855	rs6725177	C	G	7	7	14	0	0	14	0	0
2	29008175	rs62129843	T	C	9	7	16	0	0	16	0	0
2	29008425	rs4632297	T	A	17	14	31	0	0	32	1	0
2	29009049	rs4254466	G	A	21	15	36	0	0	36	0	0
2	29009089	rs4477866	C	A	11	22	33	0	0	35	2	0
2	29009840	rs6747852	A	T	20	18	38	0	0	38	0	0
2	29010066	rs6547878	T	C	25	18	43	0	0	43	0	0
2	29010339	rs6419696	G	A	19	21	40	0	1	41	0	0
2	29010517	rs2045886	A	G	33	33	66	0	0	66	0	0
2	29012574	rs13016112	T	C	29	11	40	0	0	40	0	0
2	29014746	rs13011935	C	T	14	16	30	0	0	30	0	0
2	29015982	rs13018031	G	C	25	27	52	0	1	53	0	0
2	29016019	rs13019397	C	T	26	21	47	0	0	47	0	0
2	29017474	rs13030835	G	A	5	4	9	0	0	9	0	0
2	29018889	rs6547880	T	C	5	5	10	0	0	10	0	0
2	29023100	rs34686032	T	C	399	70	469	0	22	491	0	0
2	29023749	rs7475	A	G	79	70	149	0	1	150	0	0
2	29025479	rs3190	A	G	45	47	92	0	0	92	0	0
2	29092679	rs4233729	T	C	19	33	52	0	0	52	0	0
2	29092850	rs4666122	G	T	19	33	52	0	0	52	0	0
2	29135468	rs6715296	C	G	148	134	282	0	0	282	0	0
2	29138009	rs6547892	A	G	3	5	8	0	0	8	0	0
2	29138167	rs12623400	A	G	6	4	10	0	0	10	0	0
2	29138452	rs6727420	C	T	6	3	9	0	0	9	0	0
2	29139542	rs4456657	A	G	7	4	11	0	0	11	0	0
2	29140021	rs10175980	G	A	6	7	13	0	0	13	0	0
2	29140085	rs7419369	G	A	6	2	8	0	0	8	0	0
2	29142855	rs6714560	G	A	4	6	10	0	0	10	0	0
2	29143689	rs6547893	C	T	4	2	6	0	0	6	0	0
2	29143834	rs6547895	T	C	4	3	7	0	0	7	0	0
2	29144354	rs34564767	C	A	4	3	7	0	0	7	0	0
2	29146823	rs9309665	G	T	9	7	16	0	0	16	0	0
2	29147012	rs11676658	A	G	4	2	6	0	0	6	0	0
2	29148315	rs10164596	C	G	5	10	15	0	0	15	0	0
2	29148507	rs4666138	G	C	4	2	6	0	0	6	0	0
2	29150981	rs6755185	C	G	4	4	8	0	0	8	0	0
2	29152384	rs34113296	T	G	6	1	7	0	0	7	0	0
2	29161173	rs11127194	G	C	3	4	7	0	0	7	0	0
2	29162148	rs62132028	C	T	7	7	14	0	0	14	0	0
2	29162754	rs60848661	A	G	3	3	6	0	0	6	0	0
2	29167722	rs4398230	C	T	9	11	20	0	1	21	0	0
2	29167933	rs35937475	T	C	2	4	6	0	0	6	0	0
2	29169612	rs3087649	T	C	182	230	412	0	4	416	0	0
2	29383256	rs3100246	G	T	24	16	40	0	0	40	0	0
2	30371358	rs7588777	T	C	69	69	138	0	1	139	0	0
2	30372327	rs3768667	T	C	25	25	50	0	0	50	0	0
2	30376345	rs13017699	A	T	59	62	121	0	0	121	0	0
2	30377884	rs6743004	T	C	72	53	125	0	1	126	0	0
2	30380923	rs7600457	A	G	20	30	50	0	2	52	0	0
2	30381187	rs7603324	A	G	14	18	32	0	0	32	0	0
2	30381505	rs1137288	T	C	1586	1443	3029	0	13	3042	0	0
2	30482099	rs906864	G	A	10	10	20	0	0	20	0	0
2	30682470	rs55723517	A	T	3	4	7	0	0	7	0	0
2	30719986	rs533680577	A	T	4	2	6	0	0	6	0	0
2	31135184	rs2288101	G	T	24	11	35	0	0	35	0	0
2	31149066	rs17010480	C	T	4	3	7	0	0	7	0	0
2	31178818	rs2288100	C	T	7	5	12	0	0	12	0	0
2	31314941	rs116409504	G	C	4	2	6	0	0	6	0	0
2	31314943	rs2365196	C	G	4	2	6	0	0	6	0	0
2	31315264	rs10205657	T	C	3	4	7	0	1	8	0	0
2	31489575	rs77999318	G	A	9	10	19	0	0	19	0	0
2	31490493	rs78608057	G	A	16	9	25	0	0	25	0	0
2	31490659	rs116045601	C	T	8	16	24	0	0	24	0	0
2	31490716	rs630359	C	G	11	19	30	0	0	30	0	0
2	32142520	rs11124272	C	A	21	20	41	0	0	41	0	0
2	32168123	rs41280625	C	T	13	17	30	0	1	31	0	0
2	32289746	rs2280967	T	C	2	9	11	0	0	11	0	0
2	32379663	rs56272862	A	G	28	33	61	0	0	61	0	0
2	32381109	rs6709048	G	T	4	6	10	0	1	11	0	0
2	32381110	rs9789593	T	G	10	1	11	0	1	12	0	0
2	32381829	rs3769602	G	A	8	3	11	0	0	11	0	0
2	32447718	rs177083	C	T	4	8	12	0	0	12	0	0
2	32447868	rs430759	A	G	2	5	7	0	0	7	0	0
2	32740138	rs34757266	T	C	44	42	86	0	1	87	0	0
2	32746605	rs62136327	G	C	3	3	6	0	0	6	0	0
2	32901733	rs187550461	G	T	1	5	6	0	0	6	0	0
2	32983526	rs2273665	C	T	24	5	29	0	0	29	0	0
2	32985448	rs13418467	C	G	7	6	13	0	0	13	0	0
2	32986173	rs57861653	A	G	6	11	17	0	0	17	0	0
2	32986435	rs55782356	T	C	9	18	27	0	0	27	0	0
2	32986777	rs4952291	A	G	10	14	24	0	0	24	0	0
2	32986842	rs4952292	G	A	3	10	13	0	1	14	0	0
2	33702102	rs12613020	T	G	4	5	9	0	0	9	0	0
2	33702486	rs61334194	C	G	4	6	10	0	0	10	0	0
2	33702679	rs2367735	G	T	3	6	9	0	0	9	0	0
2	33706519	rs143393654	C	T	9	4	13	0	0	13	0	0
2	33733753	rs78471655	T	G	4	3	7	0	0	7	0	0
2	37075013	rs1861435	T	A	9	14	23	0	0	23	0	0
2	37226299	rs62133078	C	T	18	5	23	0	0	23	0	0
2	37226903	rs4670181	G	C	8	6	14	0	0	14	0	0
2	37227112	rs2372788	G	C	4	5	9	0	0	9	0	0
2	37227544	rs60572996	A	T	12	3	15	0	0	15	0	0
2	37233538	rs2110998	T	C	6	5	11	0	0	11	0	0
2	37241050	rs17020125	G	A	87	77	164	0	2	166	0	0
2	37260822	rs78906805	C	A	4	4	8	0	0	8	0	0
2	37262509	rs2372913	G	A	4	4	8	0	0	8	0	0
2	37263049	rs2110996	G	A	4	6	10	0	0	10	0	0
2	37264675	rs2372914	T	C	2	4	6	0	0	6	0	0
2	37267901	rs2287108	A	T	4	19	23	0	0	23	0	0
2	37267930	rs2287107	C	G	1	7	8	0	0	8	0	0
2	37308713	rs17498825	C	A	3	4	7	0	0	7	0	0
2	37325108	rs3856499	T	C	11	10	21	0	0	21	0	0
2	37325780	rs1060957	A	G	61	42	103	0	0	103	0	0
2	37327806	rs17020213	C	T	32	51	83	0	0	83	0	0
2	37333345	.	T	C	14	11	25	0	0	25	0	0
2	37339321	rs72789101	G	A	3	3	6	0	0	6	0	0
2	37375932	rs2270414	G	A	15	5	20	0	0	20	0	0
2	37376291	rs2254958	G	A	53	12	65	0	1	66	0	0
2	37376314	rs2307466	G	C	15	44	59	0	0	59	0	0
2	37429434	.	C	T	36	27	63	0	2	65	0	0
2	37479756	rs10184179	C	T	19	12	31	0	0	31	0	0
2	37480249	rs1056021	A	G	31	53	84	0	0	84	0	0
2	37483540	.	G	A	3	3	6	0	0	6	0	0
2	37491032	rs34819784	G	C	4	2	6	0	0	6	0	0
2	37546845	rs1158218	T	C	2	4	6	0	0	6	0	0
2	37870208	rs4670746	T	C	44	50	94	0	0	94	0	0
2	37872139	rs10694	G	A	30	31	61	0	1	62	0	0
2	37872508	rs7735	G	A	79	74	153	0	1	154	0	0
2	37899310	rs9309013	A	G	5	2	7	0	0	7	0	0
2	38563527	rs10177042	C	G	4	5	9	0	0	9	0	0
2	38564522	rs10084313	A	G	5	3	8	0	1	9	0	0
2	38565363	rs11889842	T	A	5	3	8	0	0	8	0	0
2	38565390	rs11884107	C	T	6	7	13	0	0	13	0	0
2	38568808	rs11679270	C	A	9	5	14	0	0	14	0	0
2	38568827	rs11679271	C	T	9	3	12	0	0	12	0	0
2	38570908	rs10195631	T	A	5	2	7	0	0	7	0	0
2	38709568	rs13013924	A	G	1	84	85	0	4	89	0	0
2	38972624	.	C	T	19	12	31	0	0	31	0	0
2	39025555	rs1530853	G	A	14	6	20	0	0	20	0	0
2	39050141	rs3770681	A	C	11	8	19	0	0	19	0	0
2	39082344	rs7598922	T	C	7	2	9	0	0	9	0	0
2	39212637	rs1059310	T	C	17	12	29	0	0	29	0	0
2	39680986	rs78716897	A	G	3	4	7	0	0	7	0	0
2	42981239	rs930421	A	G	3	3	6	0	0	6	0	0
2	42983004	rs4953641	T	C	3	3	6	0	0	6	0	0
2	42989744	rs2278584	G	C	8	7	15	0	0	15	0	0
2	42990336	rs1992286	T	G	8	8	16	0	0	16	0	0
2	42994484	rs2304661	G	T	60	30	90	0	3	93	0	0
2	43424046	rs7568470	T	G	6	2	8	0	0	8	0	0
2	43452183	rs7933	A	G	265	199	464	0	5	469	0	0
2	43453251	rs537015646	C	G	114	155	269	0	0	269	0	0
2	43455654	rs745763	T	C	2	4	6	0	0	6	0	0
2	43797619	rs17031056	C	T	15	19	34	0	0	34	0	0
2	43801712	rs11899823	A	G	13	18	31	0	0	31	0	0
2	43804229	rs13021894	T	C	12	15	27	0	0	27	0	0
2	44004010	rs2288709	T	C	11	14	25	0	0	25	0	0
2	44028013	rs11556157	A	T	7	8	15	0	0	15	0	0
2	44036913	rs8302	T	C	3	6	9	0	0	9	0	0
2	44114074	rs1139250	G	A	5	4	9	0	0	9	0	0
2	44115183	rs1136998	T	A	62	66	128	0	1	130	1	0
2	44117563	rs74919473	A	C	8	3	11	0	0	11	0	0
2	44118428	rs12473732	C	T	5	5	10	0	0	10	0	0
2	44119416	rs7597379	T	C	5	3	8	0	0	8	0	0
2	44120947	rs4563284	C	T	0	6	6	0	0	6	0	0
2	44121928	rs17496251	T	C	2	6	8	0	1	9	0	0
2	44121943	rs62138479	A	G	3	8	11	0	0	11	0	0
2	44123617	rs113108726	C	T	9	11	20	0	0	20	0	0
2	44123758	rs76850904	G	A	14	6	20	0	0	20	0	0
2	44124055	rs10495910	T	C	4	2	6	0	0	6	0	0
2	44154510	rs41527246	T	C	5	10	15	0	1	16	0	0
2	44177948	rs4245798	T	C	13	9	22	0	0	22	0	0
2	44178778	rs13415134	C	G	6	14	20	0	0	20	0	0
2	44179736	rs11898901	C	T	7	10	17	0	0	17	0	0
2	44182250	rs62135067	A	G	5	5	10	0	0	10	0	0
2	44183945	rs62135102	C	T	6	3	9	0	0	9	0	0
2	44185129	rs4347883	T	C	4	6	10	0	0	10	0	0
2	44185718	rs17496618	T	C	3	4	7	0	0	7	0	0
2	44187652	rs62135104	A	G	5	6	11	0	0	11	0	0
2	44437217	rs6730278	G	A	4	4	8	0	0	8	0	0
2	44437997	rs6544747	C	G	3	3	6	0	0	6	0	0
2	44438246	rs11689845	G	T	2	7	9	0	0	9	0	0
2	44440033	rs7602283	T	A	1	5	6	0	0	6	0	0
2	44449690	rs11124980	C	T	6	7	13	0	0	13	0	0
2	44450831	rs111762858	T	G	5	3	8	0	0	8	0	0
2	44452390	rs920520	C	T	3	6	9	0	0	9	0	0
2	44459275	rs56203913	C	T	7	6	13	0	0	13	0	0
2	44463793	rs12052229	T	C	7	0	7	0	0	7	0	0
2	44471409	rs12613956	T	G	9	12	21	0	0	21	0	0
2	45943966	rs10188091	T	A	3	5	8	0	0	8	0	0
2	46217331	rs2245633	T	C	3	3	6	0	0	6	0	0
2	46217670	rs2595214	A	G	2	4	6	0	0	6	0	0
2	46232372	rs2595222	G	A	5	3	8	0	0	8	0	0
2	46233977	rs13398251	C	T	7	1	8	0	0	8	0	0
2	46238244	rs6544867	A	G	4	3	7	0	0	7	0	0
2	46239924	rs56350372	G	A	9	3	12	0	0	12	0	0
2	46239935	rs35442838	A	T	9	2	11	0	0	11	0	0
2	46242974	rs3820733	A	G	8	13	21	0	0	21	0	0
2	46243313	rs3738898	A	G	13	6	19	0	0	19	0	0
2	46243865	rs13027146	T	C	6	7	13	0	0	13	0	0
2	46245180	rs7593128	A	T	10	3	13	0	0	13	0	0
2	46245192	rs75982293	A	G	12	3	15	0	0	15	0	0
2	46245619	rs6744578	A	T	6	7	13	0	0	13	0	0
2	46255053	rs7607941	A	G	1	6	7	0	0	7	0	0
2	46768559	rs1868844	G	A	6	8	14	0	0	14	0	0
2	46768650	rs3754554	C	T	5	4	9	0	0	9	0	0
2	46769135	rs3754553	T	C	3	4	7	0	0	7	0	0
2	46986416	rs6738426	A	G	89	72	161	0	1	162	0	0
2	46987300	rs3768720	T	G	58	53	111	0	2	114	1	0
2	46987349	.	A	G	65	56	121	0	1	122	0	0
2	46987935	rs3768719	T	G	24	23	47	0	1	48	0	0
2	46988275	rs1058157	G	A	12	10	22	0	0	22	0	0
2	47129502	rs13424086	G	C	34	47	81	0	0	81	0	0
2	47129944	rs17035887	G	A	25	30	55	0	0	55	0	0
2	47130527	rs6743966	G	A	32	32	64	0	0	64	0	0
2	47130925	rs28770495	A	C	21	15	36	0	0	36	0	0
2	47131256	rs111535939	C	A	22	32	54	0	0	54	0	0
2	47131560	rs111603188	G	A	27	14	41	0	1	42	0	0
2	47131909	rs28516550	C	G	40	30	70	0	1	71	0	0
2	47132856	rs55834277	G	A	2	6	8	0	1	9	0	0
2	47134390	rs62136823	C	G	2	7	9	0	0	9	0	0
2	47134658	rs59763254	G	C	3	3	6	0	0	6	0	0
2	47149810	rs13432591	A	G	2	4	6	0	0	6	0	0
2	47168070	rs4314044	A	G	2	4	6	0	0	6	0	0
2	47168892	rs6755386	G	C	4	8	12	0	0	12	0	0
2	47169003	rs6755303	C	T	9	19	28	0	0	28	0	0
2	47169099	rs6729569	A	C	13	19	32	0	0	32	0	0
2	47170152	rs9973769	A	C	5	2	7	0	0	7	0	0
2	47171955	rs9973504	C	T	3	4	7	0	0	7	0	0
2	47175969	rs72886699	A	G	2	4	6	0	0	6	0	0
2	47180023	rs12479328	A	G	2	5	7	0	0	7	0	0
2	47182698	rs1036294	C	T	3	3	6	0	0	6	0	0
2	47184447	rs6726941	C	T	15	10	25	0	0	25	0	0
2	47185160	rs72806525	G	A	8	6	14	0	0	14	0	0
2	47185830	rs3814035	C	T	5	1	6	0	0	6	0	0
2	47186917	rs79862717	T	G	12	5	17	0	0	17	0	0
2	47197630	rs72806537	C	G	4	3	7	0	0	7	0	0
2	47199946	rs735887	T	G	3	3	6	0	0	6	0	0
2	47200025	rs735888	G	A	5	3	8	0	0	8	0	0
2	47200224	rs2347260	A	G	5	3	8	0	0	8	0	0
2	47201099	rs6731862	T	C	8	4	12	0	0	12	0	0
2	47201161	rs6716882	G	A	7	5	12	0	0	12	0	0
2	47201988	rs72888545	C	T	5	3	8	0	0	8	0	0
2	47203954	rs35597921	C	A	3	4	7	0	0	7	0	0
2	47205483	rs17036004	G	T	1	5	6	0	0	6	0	0
2	47206716	rs17480779	C	G	2	7	9	0	0	9	0	0
2	47208028	rs55824224	T	C	4	4	8	0	0	8	0	0
2	47208975	rs34800049	G	A	4	8	12	0	0	12	0	0
2	47209168	rs993848	C	T	4	3	7	0	0	7	0	0
2	47209722	rs12998344	C	G	6	5	11	0	0	11	0	0
2	47209868	rs13025013	T	C	15	27	42	0	0	42	0	0
2	47210728	rs75312903	T	C	3	4	7	0	0	7	0	0
2	47211873	rs60732316	G	A	0	6	6	0	0	6	0	0
2	47216684	rs55805005	G	A	3	4	7	0	0	7	0	0
2	47219977	.	G	A	4	2	6	0	0	6	0	0
2	47220185	rs74499298	G	T	6	3	9	0	0	9	0	0
2	47220341	rs72888558	C	T	6	1	7	0	0	7	0	0
2	47220840	rs6751621	G	A	18	27	45	0	0	45	0	0
2	47221105	rs17540003	C	T	21	14	35	0	0	35	0	0
2	47222758	rs60866910	G	A	30	22	52	0	2	54	0	0
2	47223181	rs17036022	C	A	24	27	51	0	1	52	0	0
2	47223182	rs17540184	G	A	30	23	53	0	0	53	0	0
2	47223522	rs17481182	A	C	20	21	41	0	0	41	0	0
2	47224927	rs17481321	C	A	26	24	50	0	1	51	0	0
2	47225050	rs74886475	C	G	27	36	63	0	0	63	0	0
2	47225087	rs13432506	C	A	31	43	74	0	0	74	0	0
2	47225186	rs17481349	T	C	33	40	73	0	1	74	0	0
2	47225426	rs17540462	T	C	33	24	57	0	0	57	0	0
2	47226183	rs17540504	G	A	49	50	99	0	1	100	0	0
2	47226394	rs72872910	T	C	42	44	86	0	6	93	1	0
2	47226870	rs13399571	T	C	99	90	189	0	1	190	0	0
2	47227277	rs72806571	A	G	12	4	16	0	0	16	0	0
2	47227353	rs57770875	G	T	2	6	8	0	0	8	0	0
2	47227768	rs17036033	G	A	5	1	6	0	0	6	0	0
2	47228723	rs112001467	C	T	4	7	11	0	0	11	0	0
2	47229025	rs2007462	T	C	2	5	7	0	0	7	0	0
2	47229380	rs17540615	C	T	8	8	16	0	0	16	0	0
2	47230731	rs13425630	A	G	8	18	26	0	0	26	0	0
2	47230889	rs60962761	C	T	10	2	12	0	0	12	0	0
2	47231030	rs59586041	T	G	15	12	27	0	0	27	0	0
2	47231032	rs13425971	A	G	14	12	26	0	0	26	0	0
2	47231674	rs10779934	G	A	7	18	25	0	0	25	0	0
2	47231912	rs75696611	C	T	4	10	14	0	0	14	0	0
2	47232072	rs11899526	T	C	4	19	23	0	0	23	0	0
2	47232495	rs1865258	A	G	5	12	17	0	1	18	0	0
2	47232587	rs55839799	G	A	11	15	26	0	1	27	0	0
2	47233048	rs13407983	G	A	9	17	26	0	0	26	0	0
2	47252737	rs56272463	G	A	6	3	9	0	0	9	0	0
2	47252842	rs55830528	T	C	8	3	11	0	0	11	0	0
2	47252864	rs17036138	C	T	10	2	12	0	1	13	0	0
2	47252874	rs57861250	G	A	2	10	12	0	3	15	0	0
2	47253039	rs55686748	T	C	8	2	10	0	0	10	0	0
2	47253485	rs12373778	A	G	3	5	8	0	0	8	0	0
2	47253611	rs12373780	A	G	3	9	12	0	1	13	0	0
2	47255059	rs6761572	T	C	2	5	7	0	0	7	0	0
2	47255651	rs11125111	G	A	6	7	13	0	0	13	0	0
2	47260839	rs7578472	T	C	5	2	7	0	0	7	0	0
2	47264082	rs76138156	T	G	2	7	9	0	0	9	0	0
2	47265455	rs11901122	A	T	3	3	6	0	0	6	0	0
2	47265516	rs11890603	C	T	5	2	7	0	0	7	0	0
2	47267731	rs79717208	G	C	2	4	6	0	0	6	0	0
2	47268113	rs11884118	A	C	5	9	14	0	0	14	0	0
2	47271430	rs11125113	G	A	5	4	9	0	1	10	0	0
2	47272131	rs13398062	A	G	5	4	9	0	0	9	0	0
2	47272245	rs13423726	C	T	7	4	11	0	0	11	0	0
2	47272620	rs76876112	A	G	2	10	12	0	1	13	0	0
2	47272903	rs17541307	C	T	2	14	16	0	0	16	0	0
2	47273668	rs12712986	G	A	4	6	10	0	1	11	0	0
2	47273732	rs7593339	G	A	7	1	8	0	0	8	0	0
2	47274051	rs4953450	T	C	4	4	8	0	0	8	0	0
2	47274255	.	G	C	5	3	8	0	0	8	0	0
2	47275061	rs72808520	T	C	7	12	19	0	0	19	0	0
2	47275828	rs6731390	G	A	2	4	6	0	0	6	0	0
2	47275893	rs6731476	G	C	3	6	9	0	0	9	0	0
2	47276199	rs10198941	G	A	6	1	7	0	0	7	0	0
2	47277035	rs77908208	C	T	4	10	14	0	0	14	0	0
2	47277522	rs78178942	C	T	127	35	162	0	2	164	0	0
2	47277556	rs17036164	A	T	144	43	187	0	2	189	0	0
2	47277670	rs78194063	C	A	177	43	220	0	1	221	0	0
2	47277913	rs75556828	C	T	187	57	244	0	1	245	0	0
2	47278315	rs2117166	C	G	88	28	116	0	0	116	0	0
2	47278448	rs13389149	T	C	7	8	15	0	0	15	0	0
2	47278666	rs139592802	G	C	12	18	30	0	0	30	0	0
2	47279457	.	C	A	7	4	11	0	0	11	0	0
2	47279605	rs17036168	C	T	3	12	15	0	0	15	0	0
2	47279635	rs58268419	G	T	1	9	10	0	0	10	0	0
2	47280311	rs76476016	G	C	1	10	11	0	0	11	0	0
2	47281634	rs74779880	C	A	4	9	13	0	0	13	0	0
2	47282513	rs149664358	C	G	6	6	12	0	0	12	0	0
2	47283793	rs10460536	T	C	2	6	8	0	0	8	0	0
2	47284041	rs80253444	C	T	4	10	14	0	0	14	0	0
2	47284135	rs75261166	G	C	5	1	6	0	0	6	0	0
2	47284334	rs113814439	C	T	6	2	8	0	0	8	0	0
2	47285714	rs9309141	T	G	9	5	14	0	0	14	0	0
2	47286759	rs13393256	A	C	9	15	24	0	0	24	0	0
2	47286857	rs6734192	C	T	6	6	12	0	0	12	0	0
2	47287158	rs2916261	A	G	2	10	12	0	0	12	0	0
2	47287594	rs2570514	T	G	4	5	9	0	1	10	0	0
2	47290570	rs4953456	T	C	3	5	8	0	0	8	0	0
2	47292805	rs12465751	G	A	2	5	7	0	0	7	0	0
2	47292830	rs2692220	G	T	2	5	7	0	0	7	0	0
2	47293658	rs76774541	G	C	3	5	8	0	0	8	0	0
2	47294223	rs79394460	T	C	5	3	8	0	0	8	0	0
2	47295025	rs75557526	A	C	5	2	7	0	0	7	0	0
2	47295065	rs17036208	T	A	3	8	11	0	0	11	0	0
2	47295473	rs2280648	G	A	5	8	13	0	0	13	0	0
2	47296302	rs72875120	A	C	8	7	15	0	0	15	0	0
2	47297082	rs2570515	C	T	3	7	10	0	0	10	0	0
2	47297227	rs75399165	G	A	3	4	7	0	0	7	0	0
2	47297426	rs2347603	T	A	2	6	8	0	0	8	0	0
2	47297659	rs59897602	G	A	1	10	11	0	0	11	0	0
2	47297798	rs7605122	C	G	2	13	15	0	0	15	0	0
2	47297823	rs60408932	T	A	3	10	13	0	0	13	0	0
2	47298000	rs80100838	G	T	3	4	7	0	0	7	0	0
2	47298809	rs7609058	G	C	2	11	13	0	0	13	0	0
2	47299166	rs111409822	G	A	6	4	10	0	0	10	0	0
2	47299833	rs76848229	C	T	3	8	11	0	0	11	0	0
2	47299964	rs578170295	C	T	5	6	11	0	0	11	0	0
2	47301029	rs3739099	A	G	214	285	499	0	1	500	0	0
2	47302832	rs74801760	G	A	294	227	521	0	6	528	1	0
2	47306220	rs56131440	G	A	24	4	28	0	1	29	0	0
2	47306991	rs11892004	G	C	25	9	34	0	0	34	0	0
2	47307458	rs7569336	C	G	15	4	19	0	0	19	0	0
2	47309610	rs78504079	A	C	9	6	15	0	0	15	0	0
2	47390026	rs1027478	C	T	6	5	11	0	0	11	0	0
2	47390058	rs17036325	T	C	5	6	11	0	0	11	0	0
2	47391560	.	G	A	3	6	9	0	0	9	0	0
2	47396558	rs815817	C	T	4	2	6	0	0	6	0	0
2	47399601	rs4953472	A	G	6	2	8	0	0	8	0	0
2	47400734	rs78439417	T	G	4	5	9	0	0	9	0	0
2	47403129	rs878665	G	T	6	3	9	0	0	9	0	0
2	47403383	rs11842	G	T	5	11	16	0	0	16	0	0
2	48033195	.	G	A	8	9	17	0	0	17	0	0
2	48043981	rs72809593	T	G	14	16	30	0	0	30	0	0
2	48591889	rs11125169	G	C	9	7	16	0	0	16	0	0
2	48592569	rs11125170	T	C	3	7	10	0	0	10	0	0
2	48593219	rs62137013	G	A	6	5	11	0	0	11	0	0
2	48593224	rs6743757	A	G	6	5	11	0	0	11	0	0
2	48593801	rs61062762	A	G	4	6	10	0	0	10	0	0
2	48594355	rs17325488	A	G	6	8	14	0	0	14	0	0
2	48594595	rs4344965	C	T	9	10	19	0	0	19	0	0
2	48597559	rs7562069	G	A	3	5	8	0	1	9	0	0
2	48713777	rs33994624	C	T	12	8	20	0	0	20	0	0
2	48808594	rs3749142	C	T	9	5	14	0	0	14	0	0
2	48824650	rs35265092	G	A	2	4	6	0	0	6	0	0
2	48824652	rs35304210	T	C	2	4	6	0	0	6	0	0
2	48824698	rs13018198	T	C	5	4	9	0	0	9	0	0
2	48825139	rs1045921	A	C	3	3	6	0	0	6	0	0
2	54801525	rs62134679	T	C	5	4	9	0	0	9	0	0
2	54844790	rs2229506	C	T	196	217	413	0	1	414	0	0
2	54853529	rs4671964	A	G	15	8	23	0	1	24	0	0
2	54867421	rs10166797	G	T	5	2	7	0	0	7	0	0
2	54877365	rs13401431	C	T	9	7	16	0	0	16	0	0
2	54882678	rs12475342	G	A	25	16	41	0	0	41	0	0
2	54882713	rs28710338	G	C	12	15	27	0	0	27	0	0
2	54884074	rs3769331	T	C	27	27	54	0	1	55	0	0
2	54884870	rs966003	C	T	42	26	68	0	1	69	0	0
2	54885370	rs17416284	A	T	2	5	7	0	0	7	0	0
2	54885596	rs6705756	G	T	2	6	8	0	0	8	0	0
2	54885640	rs2971880	T	A	9	2	11	0	0	11	0	0
2	54886347	rs1052820	G	A	343	382	725	0	4	729	0	0
2	54888778	rs2971878	T	C	83	92	175	0	7	182	0	0
2	54889015	rs1047465	A	G	101	111	212	0	1	213	0	0
2	54892506	rs7583633	C	G	24	14	38	0	1	39	0	0
2	54894649	rs907136	G	A	5	3	8	0	0	8	0	0
2	54895319	rs139247782	C	T	5	2	7	0	0	7	0	0
2	55204165	rs6705519	C	T	41	26	67	0	2	69	0	0
2	55204498	rs2968804	G	C	42	25	67	0	2	69	0	0
2	55205124	rs2588519	T	C	43	27	70	0	2	72	0	0
2	55207693	rs3198123	C	T	18	13	31	0	0	31	0	0
2	55208419	rs2580767	G	T	7	9	16	0	0	16	0	0
2	55219810	rs142163107	A	T	4	3	7	0	0	7	0	0
2	55220960	rs2588517	T	C	7	5	12	0	0	12	0	0
2	55223638	rs55762835	G	A	5	1	6	0	0	6	0	0
2	55238429	rs6722182	C	T	2	4	6	0	0	6	0	0
2	55252294	.	G	A	55	47	102	0	3	106	1	0
2	55516090	rs1045613	C	T	35	40	75	0	1	76	0	0
2	55517491	rs1047948	G	A	11	11	22	0	0	22	0	0
2	55562692	rs2576715	C	T	5	3	8	0	0	8	0	0
2	55584160	rs2920971	G	A	6	5	11	0	0	11	0	0
2	55584723	rs2589102	C	T	3	4	7	0	0	7	0	0
2	55631013	rs6721972	T	C	5	3	8	0	0	8	0	0
2	55861478	rs113399180	C	T	10	8	18	0	0	18	0	0
2	58268180	rs1518404	T	A	7	2	9	0	0	9	0	0
2	58284751	rs1371212	T	C	3	4	7	0	0	7	0	0
2	58316814	rs1051061	A	G	32	35	67	0	0	67	0	0
2	58361134	rs12999901	G	A	8	6	14	0	0	14	0	0
2	58388696	rs848291	A	G	18	21	39	0	0	39	0	0
2	58390679	rs12624152	T	G	7	6	13	0	0	13	0	0
2	60687959	rs7569946	A	G	23	19	42	0	0	42	0	0
2	60770080	rs13018474	G	A	18	20	38	0	0	38	0	0
2	60772227	.	T	C	51	35	86	0	0	86	0	0
2	61022435	rs76955417	A	T	8	0	8	0	0	8	0	0
2	61108996	rs842650	A	T	7	6	13	0	1	14	0	0
2	61112552	rs6545835	G	T	11	5	16	0	0	16	0	0
2	61115039	rs10208155	T	G	9	7	16	0	0	16	0	0
2	61116241	rs13422089	C	G	11	9	20	0	0	20	0	0
2	61116481	rs842648	A	G	7	18	25	0	0	25	0	0
2	61118739	rs10185028	A	G	5	6	11	0	1	12	0	0
2	61122533	rs842643	C	A	4	12	16	0	0	16	0	0
2	61122628	rs138841715	A	G	9	9	18	0	0	18	0	0
2	61122973	rs6545836	G	A	11	7	18	0	0	18	0	0
2	61124466	rs13406503	A	G	4	5	9	0	1	10	0	0
2	61126664	rs10193964	A	G	34	35	69	0	0	69	0	0
2	61130883	rs13027883	G	C	3	3	6	0	0	6	0	0
2	61132029	rs9752570	T	A	3	3	6	0	0	6	0	0
2	61133793	rs7604989	A	G	6	5	11	0	0	11	0	0
2	61134764	rs72807480	A	C	4	7	11	0	0	11	0	0
2	61151661	rs36047498	A	T	53	60	113	0	0	113	0	0
2	61156142	.	G	A	162	51	213	0	2	215	0	0
2	61164729	rs6726160	T	G	6	7	13	0	0	13	0	0
2	61165366	rs11682126	C	T	7	13	20	0	0	20	0	0
2	61167761	rs1053862	A	G	4	4	8	0	0	8	0	0
2	61168000	rs1206	G	T	4	6	10	0	0	10	0	0
2	61170173	rs34906318	A	G	7	4	11	0	0	11	0	0
2	61258799	.	T	C	55	49	104	0	0	104	0	0
2	61276857	rs56739127	C	T	12	14	26	0	0	26	0	0
2	61404931	rs2600667	A	T	7	7	14	0	0	14	0	0
2	61468761	rs72884996	T	C	72	68	140	0	3	143	0	0
2	61533480	rs7369217	A	G	15	8	23	0	0	23	0	0
2	61566536	rs17008405	T	C	25	35	60	0	1	61	0	0
2	61617681	rs79279844	A	G	3	3	6	0	0	6	0	0
2	61719945	rs41281521	A	G	13	7	20	0	0	20	0	0
2	61764098	rs3771259	A	C	5	5	10	0	0	10	0	0
2	62098168	.	T	G	7	2	9	0	0	9	0	0
2	62098794	rs62149873	C	T	3	5	8	0	0	8	0	0
2	62100380	rs76248080	G	T	153	122	275	0	5	280	0	0
2	62107632	rs2272429	G	A	14	6	20	0	0	20	0	0
2	62107846	rs12466630	A	C	3	6	9	0	0	9	0	0
2	62108014	rs78454153	T	A	8	7	15	0	0	15	0	0
2	62108393	rs17514211	C	A	1	5	6	0	0	6	0	0
2	62109278	rs151311929	G	C	8	2	10	0	0	10	0	0
2	62109677	rs7590526	G	A	4	7	11	0	0	11	0	0
2	62109914	rs62149894	G	A	7	3	10	0	0	10	0	0
2	62115776	rs41281525	G	A	22	14	36	0	0	36	0	0
2	62450631	rs3811616	A	G	188	182	370	0	4	374	0	0
2	62450743	rs1136151	T	C	237	232	469	0	7	476	0	0
2	62451422	rs13393608	A	G	134	161	295	0	3	298	0	0
2	64068278	rs11540495	G	C	10	10	20	0	0	20	0	0
2	64069732	rs6546029	G	A	0	7	7	0	0	7	0	0
2	64097159	rs6546036	C	G	9	2	11	0	0	11	0	0
2	64124722	rs11558741	C	A	27	16	43	0	1	44	0	0
2	64141006	rs115480583	A	T	15	10	25	0	0	25	0	0
2	64187994	rs547510181	G	C	3	3	6	0	0	6	0	0
2	64232016	rs112162700	G	A	6	2	8	0	0	8	0	0
2	64327544	rs329498	G	T	672	613	1285	0	8	1293	0	0
2	64327592	rs329497	T	C	651	586	1237	0	10	1247	0	0
2	64331868	.	A	G	468	528	996	0	13	1012	3	0
2	64332574	rs559983934	T	C	96	97	193	0	2	195	0	0
2	64334736	.	C	T	55	57	112	0	0	112	0	0
2	64371297	rs36107593	G	C	180	199	379	0	0	379	0	0
2	64479060	rs1025209	G	A	6	5	11	0	0	11	0	0
2	64479079	rs1025210	G	A	6	6	12	0	0	12	0	0
2	64479606	rs2020377	T	C	3	6	9	0	2	11	0	0
2	64479841	rs1963382	G	C	8	6	14	0	0	14	0	0
2	64780404	.	G	A	52	72	124	0	0	124	0	0
2	64809278	rs72814024	G	A	16	10	26	0	0	26	0	0
2	64859679	rs7451	T	C	247	224	471	0	1	472	0	0
2	64862055	rs2070063	A	G	340	359	699	0	9	708	0	0
2	64880999	.	C	G	83	77	160	0	0	160	0	0
2	65221184	rs1541580	C	T	3	3	6	0	0	6	0	0
2	65249014	rs113001957	G	T	16	15	31	0	0	31	0	0
2	65455301	rs7566950	C	T	7	7	14	0	1	15	0	0
2	65456245	rs6546137	G	C	9	5	14	0	0	14	0	0
2	65456687	rs6546138	T	C	9	3	12	0	0	12	0	0
2	65467707	rs55926917	G	A	3	6	9	0	0	9	0	0
2	65467784	rs1547970	G	A	5	1	6	0	1	7	0	0
2	65467849	rs35346281	A	G	2	5	7	0	0	7	0	0
2	65471806	rs60726151	G	T	3	4	7	0	0	7	0	0
2	65497634	rs7246	T	C	181	203	384	0	0	384	0	0
2	65569939	rs10188563	A	G	3	3	6	0	0	6	0	0
2	65571139	rs35493937	G	C	14	12	26	0	0	26	0	0
2	65659488	rs12185577	A	G	1	5	6	0	0	6	0	0
2	66670895	.	C	T	5	4	9	0	0	9	0	0
2	66670976	rs1401444	C	A	5	3	8	0	0	8	0	0
2	66671858	rs2049019	C	A	3	6	9	0	0	9	0	0
2	66781453	rs2300478	T	G	1	6	7	0	0	7	0	0
2	66784649	rs2284707	A	C	10	7	17	0	0	17	0	0
2	66786405	rs10202912	A	G	2	8	10	0	0	10	0	0
2	66791480	rs13003701	G	C	5	8	13	0	0	13	0	0
2	66792291	rs6735071	C	T	7	5	12	0	1	13	0	0
2	66792683	rs71411945	G	A	4	6	10	0	0	10	0	0
2	67631831	rs61740794	G	A	7	6	13	0	0	13	0	0
2	68269974	.	G	T	56	68	124	0	27	151	0	0
2	68270068	rs10444	A	G	140	65	205	0	0	205	0	0
2	68281759	rs10203061	A	G	3	3	6	0	0	6	0	0
2	68407283	rs114706405	T	C	265	283	548	0	4	552	0	0
2	68447502	rs78934824	C	T	16	14	30	0	0	30	0	0
2	68477513	rs553968651	G	A	2	4	6	0	0	6	0	0
2	68609588	rs185210940	G	A	38	47	85	0	1	86	0	0
2	68611112	rs35052538	A	G	130	133	263	0	2	265	0	0
2	68614036	rs150256339	G	A	147	153	300	0	0	300	0	0
2	68753240	rs35002937	T	A	3	6	9	0	0	9	0	0
2	68765205	rs13404469	C	T	1	9	10	0	0	10	0	0
2	68965078	rs4854502	G	T	9	1	10	0	0	10	0	0
2	68965499	.	G	A	3	4	7	0	0	7	0	0
2	68966613	rs75547566	A	T	3	4	7	0	0	7	0	0
2	68970181	rs10176108	A	C	5	4	9	0	0	9	0	0
2	68970341	rs79122609	C	T	5	5	10	0	0	10	0	0
2	68971565	rs75986568	A	G	6	7	13	0	0	13	0	0
2	68971617	rs76510129	A	G	5	4	9	0	0	9	0	0
2	69011154	rs10202102	C	T	3	5	8	0	0	8	0	0
2	69011311	rs10202327	C	G	2	7	9	0	0	9	0	0
2	69011340	rs11680403	A	C	8	2	10	0	0	10	0	0
2	69011570	rs528229553	T	G	3	5	8	0	0	8	0	0
2	69011925	rs6546435	G	A	4	5	9	0	0	9	0	0
2	69012846	rs11682171	A	T	1	5	6	0	0	6	0	0
2	69013007	rs11677065	T	C	3	7	10	0	0	10	0	0
2	69013166	rs11694733	C	T	3	5	8	0	0	8	0	0
2	69013251	rs11694785	C	T	2	6	8	0	0	8	0	0
2	69014226	rs13026372	T	A	16	7	23	0	0	23	0	0
2	69014280	rs10207163	T	C	7	15	22	0	0	22	0	0
2	69014347	rs11687893	C	G	8	9	17	0	0	17	0	0
2	69014444	rs10194963	G	A	6	7	13	0	0	13	0	0
2	69014520	rs2292903	G	A	13	8	21	0	0	21	0	0
2	69014596	rs2292902	C	T	11	4	15	0	1	16	0	0
2	69015400	.	A	G	5	4	9	0	0	9	0	0
2	69017904	rs12477343	G	T	5	3	8	0	0	8	0	0
2	69018157	rs12478131	C	T	5	4	9	0	0	9	0	0
2	69018787	rs10208669	G	A	1	6	7	0	0	7	0	0
2	69019549	rs10211539	C	T	5	3	8	0	0	8	0	0
2	69020663	rs1578878	T	C	10	3	13	0	0	13	0	0
2	69023704	rs12713663	G	A	4	6	10	0	0	10	0	0
2	69023994	rs11691280	A	T	3	5	8	0	0	8	0	0
2	69025232	rs11126196	G	C	4	5	9	0	0	9	0	0
2	69025676	rs11126197	C	G	6	6	12	0	1	13	0	0
2	69027052	rs17602973	C	G	10	14	24	0	0	24	0	0
2	69028585	rs7585846	A	G	12	17	29	0	0	29	0	0
2	69028589	rs7585849	A	G	10	15	25	0	0	25	0	0
2	69028821	rs11889350	G	A	20	10	30	0	0	30	0	0
2	69029215	rs13018928	G	A	6	15	21	0	0	21	0	0
2	69029421	rs539348919	T	G	8	7	15	0	0	15	0	0
2	69029690	rs6712120	G	C	10	6	16	0	0	16	0	0
2	69029707	rs4854457	T	C	11	6	17	0	0	17	0	0
2	69029770	rs6727322	T	C	11	4	15	0	0	15	0	0
2	69031110	rs11126198	G	A	14	8	22	0	0	22	0	0
2	69031128	rs11126199	G	A	19	9	28	0	0	28	0	0
2	69031300	rs11893484	C	T	14	12	26	0	0	26	0	0
2	69031778	rs10187087	C	G	12	20	32	0	0	32	0	0
2	69051602	rs13402713	T	C	5	6	11	0	0	11	0	0
2	69547236	rs7642	G	C	17	19	36	0	0	36	0	0
2	69548320	rs13396883	C	T	8	3	11	0	0	11	0	0
2	69548591	rs28694003	C	T	4	6	10	0	0	10	0	0
2	69549262	rs13751	T	C	4	8	12	0	0	12	0	0
2	69550036	rs7579532	T	C	29	18	47	0	0	47	0	0
2	69550230	rs7582334	T	G	6	5	11	0	0	11	0	0
2	69550256	rs7568296	C	T	8	6	14	0	0	14	0	0
2	69550652	rs10185336	G	A	13	15	28	0	1	29	0	0
2	69551011	rs10198150	T	C	10	6	16	0	0	16	0	0
2	69551052	rs10198171	T	C	14	12	26	0	0	26	0	0
2	69552521	rs2667	C	A	12	6	18	0	0	18	0	0
2	69575823	rs4524165	G	C	1	5	6	0	0	6	0	0
2	69659126	rs4453725	A	T	16	32	48	0	0	48	0	0
2	69686286	rs7577689	A	G	23	25	48	0	0	48	0	0
2	69687224	rs4441525	C	T	15	21	36	0	0	36	0	0
2	69687726	rs7581876	A	G	11	12	23	0	0	23	0	0
2	69687731	rs7608459	C	G	10	13	23	0	0	23	0	0
2	69689319	rs60724200	T	G	6	4	10	0	0	10	0	0
2	69690187	rs13427243	A	G	7	10	17	0	0	17	0	0
2	69693006	rs9309428	C	T	14	9	23	0	0	23	0	0
2	69737379	rs11692488	C	T	16	21	37	0	0	37	0	0
2	69737948	rs2002879	G	A	9	4	13	0	0	13	0	0
2	69738093	rs2002878	C	T	7	3	10	0	0	10	0	0
2	69739675	rs4852799	C	T	9	2	11	0	0	11	0	0
2	69740091	rs6752846	C	T	8	2	10	0	0	10	0	0
2	69740279	rs11126234	T	G	6	2	8	0	0	8	0	0
2	69740765	rs11126235	C	T	6	1	7	0	0	7	0	0
2	69741609	rs2276689	C	T	17	15	32	0	2	34	0	0
2	70057448	rs3732266	T	G	5	3	8	0	0	8	0	0
2	70068635	rs2872075	G	T	11	1	12	0	0	12	0	0
2	70068642	rs13020991	A	G	8	1	9	0	0	9	0	0
2	70094137	rs35084691	C	T	3	3	6	0	0	6	0	0
2	70106832	rs6747542	T	C	15	18	33	0	0	33	0	0
2	70108256	rs1056482	T	A	14	18	32	0	0	32	0	0
2	70131791	rs1048139	T	A	30	17	47	0	1	48	0	0
2	70131964	rs1048165	A	C	62	38	100	0	24	124	0	0
2	70145450	rs6718298	A	C	1	9	10	0	0	10	0	0
2	70145717	rs6546558	C	T	3	6	9	0	0	9	0	0
2	70146121	rs6721891	A	G	5	5	10	0	0	10	0	0
2	70146125	rs6750488	C	T	5	5	10	0	0	10	0	0
2	70146625	rs7419837	T	C	4	2	6	0	0	6	0	0
2	70147664	rs62152020	C	T	3	3	6	0	0	6	0	0
2	70148093	rs35344582	C	T	4	2	6	0	0	6	0	0
2	70149225	rs1454498	C	A	4	2	6	0	0	6	0	0
2	70152027	rs726920	G	C	3	3	6	0	0	6	0	0
2	70154037	rs7573442	G	A	5	7	12	0	0	12	0	0
2	70154187	rs11893500	T	C	4	3	7	0	0	7	0	0
2	70155482	rs4144081	G	A	5	5	10	0	0	10	0	0
2	70156321	rs12713683	G	A	5	6	11	0	0	11	0	0
2	70156540	rs6712827	C	G	4	5	9	0	0	9	0	0
2	70156589	rs6741449	A	G	6	4	10	0	0	10	0	0
2	70160658	rs897119	T	C	7	5	12	0	0	12	0	0
2	70160982	rs897120	A	G	9	9	18	0	0	18	0	0
2	70161032	rs6729760	C	T	10	10	20	0	0	20	0	0
2	70161226	.	G	A	9	11	20	0	0	20	0	0
2	70161342	rs12613947	A	G	6	5	11	0	0	11	0	0
2	70162534	rs2228183	T	G	303	291	594	0	2	596	0	0
2	70163316	rs34586537	T	G	12	11	23	0	0	23	0	0
2	70163434	rs11126251	T	G	16	17	33	0	0	33	0	0
2	70164034	rs3771531	T	C	15	19	34	0	0	34	0	0
2	70167197	rs12475412	C	T	64	39	103	0	10	113	0	0
2	70273171	.	G	A	6	6	12	0	0	12	0	0
2	71214173	rs1045525	G	C	86	71	157	0	0	157	0	0
2	71214755	rs28364738	G	A	71	82	153	0	0	153	0	0
2	71215025	rs11556871	G	A	67	48	115	0	0	115	0	0
2	71215617	rs4852735	A	G	72	86	158	0	1	159	0	0
2	71216246	rs2286980	A	C	6	4	10	0	0	10	0	0
2	71216640	rs72832798	G	A	5	3	8	0	0	8	0	0
2	71217757	rs4852736	T	C	3	3	6	0	0	6	0	0
2	71221822	rs2302561	A	G	18	36	54	0	0	54	0	0
2	71838597	rs2303606	C	A	7	5	12	0	0	12	0	0
2	72403848	rs41417	T	C	17	15	32	0	0	32	0	0
2	72405008	rs41416	C	G	4	8	12	0	0	12	0	0
2	72405098	rs41415	C	A	4	12	16	0	1	17	0	0
2	72405827	rs41414	A	T	10	10	20	0	0	20	0	0
2	72405833	rs41413	A	G	10	9	19	0	1	20	0	0
2	72707874	rs653220	A	G	7	6	13	0	0	13	0	0
2	72943892	rs6546782	G	A	5	5	10	0	1	11	0	0
2	73169500	rs1048704	G	A	17	10	27	0	0	27	0	0
2	73169582	rs11686652	C	G	22	13	35	0	1	36	0	0
2	73226090	rs12233055	G	A	6	5	11	0	0	11	0	0
2	73442812	rs7557285	G	A	3	3	6	0	0	6	0	0
2	73477527	rs2231437	C	T	199	215	414	0	2	416	0	0
2	73483057	rs1045902	T	C	57	53	110	0	1	111	0	0
2	73483186	rs1218	C	G	60	46	106	0	0	106	0	0
2	73484751	rs56262012	A	T	48	41	89	0	3	92	0	0
2	73490412	rs34363861	A	G	37	25	62	0	1	63	0	0
2	73653835	rs115817471	A	G	2	4	6	0	0	6	0	0
2	73677903	.	C	T	19	8	27	0	1	28	0	0
2	73679013	rs45608038	A	G	11	18	29	0	0	29	0	0
2	74093720	rs36031378	A	G	11	8	19	0	0	19	0	0
2	74159734	rs6737156	T	C	8	1	9	0	0	9	0	0
2	74273240	rs6754218	A	G	5	3	8	0	0	8	0	0
2	74274064	.	C	G	35	29	64	0	0	64	0	0
2	74274329	rs61741171	C	T	51	41	92	0	1	93	0	0
2	74300717	rs7560668	T	C	40	36	76	0	2	78	0	0
2	74301840	rs6755711	G	T	16	10	26	0	0	26	0	0
2	74302498	rs4073048	C	T	3	9	12	0	1	13	0	0
2	74303203	rs3902790	A	T	6	8	14	0	0	14	0	0
2	74304378	rs6745576	C	G	19	22	41	0	0	41	0	0
2	74305203	rs9309478	G	C	23	23	46	0	1	47	0	0
2	74311065	rs13027288	C	T	4	2	6	0	0	6	0	0
2	74324997	rs34584402	T	C	3	5	8	0	0	8	0	0
2	74334462	rs828867	G	A	51	50	101	0	0	101	0	0
2	74380989	rs11126425	A	G	361	360	721	0	5	726	0	0
2	74383630	rs11540640	G	A	205	236	441	0	3	444	0	0
2	74383911	rs828852	G	A	16	12	28	0	1	29	0	0
2	74383912	rs56259334	T	C	17	12	29	0	0	29	0	0
2	74384628	rs58479981	G	A	23	19	42	0	1	43	0	0
2	74386569	rs3762480	T	C	3	10	13	0	0	13	0	0
2	74388889	rs1667610	T	C	6	32	38	0	0	38	0	0
2	74389608	rs6726891	C	G	7	3	10	0	0	10	0	0
2	74405867	rs2272239	T	G	152	151	303	0	13	316	0	0
2	74405952	rs2272240	T	C	59	46	105	0	6	111	0	0
2	74436003	.	G	T	6	6	12	0	2	14	0	0
2	74436227	rs56100026	G	A	6	3	9	0	0	9	0	0
2	74439180	rs844169	T	G	16	8	24	0	0	24	0	0
2	74442997	.	A	T	16	16	32	0	0	32	0	0
2	74445035	rs59237163	A	G	7	5	12	0	0	12	0	0
2	74682512	rs2268417	C	T	6	0	6	0	0	6	0	0
2	74686329	rs2270016	C	T	10	3	13	0	0	13	0	0
2	74687550	rs8469	T	C	75	77	152	0	5	157	0	0
2	74690039	rs2268416	G	A	21	21	42	0	0	42	0	0
2	74690378	rs1063588	C	T	22	18	40	0	0	40	0	0
2	74699778	rs1047911	C	A	80	52	132	0	3	135	0	0
2	74710491	rs6707475	C	T	21	26	47	0	0	47	0	0
2	74721055	rs2301984	A	G	34	25	59	0	1	60	0	0
2	74781577	rs75192983	T	C	6	4	10	0	0	10	0	0
2	74781871	rs13416172	C	G	17	15	32	0	0	32	0	0
2	75099477	rs2229621	A	T	56	65	121	0	2	123	0	0
2	75101454	rs2229622	T	C	73	81	154	0	0	154	0	0
2	75102176	rs1869340	A	G	6	1	7	0	0	7	0	0
2	75102524	rs13394603	T	C	4	2	6	0	0	6	0	0
2	75103322	rs3771763	C	T	5	3	8	0	0	8	0	0
2	75104119	rs10153633	A	G	5	1	6	0	0	6	0	0
2	75104218	rs10153634	A	G	6	1	7	0	0	7	0	0
2	75104570	rs3771760	A	G	2	4	6	0	0	6	0	0
2	75104575	rs3771759	G	A	2	4	6	0	0	6	0	0
2	75104945	rs3771758	G	A	3	3	6	0	0	6	0	0
2	75107367	rs1807090	T	G	2	5	7	0	0	7	0	0
2	75113657	rs2229626	C	T	121	81	202	0	3	205	0	0
2	75196731	rs7881	A	G	60	62	122	0	1	123	0	0
2	84653484	rs36015835	T	A	3	4	7	0	0	7	0	0
2	84656923	rs78316549	G	T	13	8	21	0	0	21	0	0
2	85133320	rs12471929	C	T	35	35	70	0	4	74	0	0
2	85199303	rs146458576	G	A	8	4	12	0	0	12	0	0
2	85264070	rs142160515	A	C	1	6	7	0	0	7	0	0
2	85274666	rs17025827	T	C	3	7	10	0	0	10	0	0
2	85280043	rs12616403	G	C	2	6	8	0	1	9	0	0
2	85542686	rs7608881	G	C	10	6	16	0	0	16	0	0
2	85542718	rs7608892	G	A	8	9	17	0	0	17	0	0
2	85543064	rs4446071	T	C	6	4	10	0	0	10	0	0
2	85543222	rs4599108	C	T	8	5	13	0	1	14	0	0
2	85545490	rs7428	T	C	353	290	643	0	3	646	0	0
2	85546052	rs1053561	A	G	287	260	547	0	4	551	0	0
2	85546192	rs1053560	C	T	253	261	514	0	4	518	0	0
2	85546615	rs1061782	C	T	200	196	396	0	5	401	0	0
2	85546932	rs4832164	A	C	316	287	603	0	3	606	0	0
2	85547376	rs7607284	C	G	251	242	493	0	1	494	0	0
2	85547429	rs4459734	G	T	244	255	499	0	4	503	0	0
2	85547963	rs1554110	C	T	287	340	627	0	3	630	0	0
2	85548639	rs6547611	A	G	237	202	439	0	1	440	0	0
2	85549527	rs3184781	T	C	154	160	314	0	2	316	0	0
2	85549547	rs3184780	C	T	155	136	291	0	1	292	0	0
2	85549868	rs4240199	A	G	12	4	16	0	0	16	0	0
2	85549874	rs3637	A	G	13	5	18	0	1	19	0	0
2	85550396	rs72840063	T	A	7	4	11	0	0	11	0	0
2	85551184	rs6547612	C	T	11	14	25	0	0	25	0	0
2	85551696	rs17026212	T	G	11	8	19	0	0	19	0	0
2	85551779	rs2366404	G	A	9	12	21	0	0	21	0	0
2	85553784	rs1044973	C	T	198	184	382	0	2	384	0	0
2	85554080	rs4247303	G	A	192	148	340	0	1	341	0	0
2	85555262	rs10460585	T	G	11	14	25	0	0	25	0	0
2	85555277	rs10460586	G	A	10	10	20	0	0	20	0	0
2	85569294	rs999939	T	C	4	3	7	0	0	7	0	0
2	85569877	rs9808566	C	T	12	4	16	0	0	16	0	0
2	85584988	rs56352074	T	C	3	3	6	0	0	6	0	0
2	85767735	rs2028900	C	T	10	8	18	0	0	18	0	0
2	85769711	rs1078004	C	G	110	117	227	0	0	227	0	0
2	85769975	rs2043675	A	G	25	30	55	0	0	55	0	0
2	85805367	rs3770098	C	A	2	4	6	0	0	6	0	0
2	85805654	rs7579147	G	A	5	6	11	0	0	11	0	0
2	85806068	rs3731827	T	C	8	9	17	0	0	17	0	0
2	85806266	rs3731828	C	T	607	396	1003	0	4	1007	0	0
2	85807082	.	T	A	10	6	16	0	0	16	0	0
2	85808573	rs1972297	T	C	4	5	9	0	0	9	0	0
2	85808737	rs1009	A	G	730	548	1278	0	4	1282	0	0
2	85808871	rs1058588	C	T	691	457	1148	0	8	1157	1	0
2	85808982	rs1010	T	C	816	821	1637	0	17	1654	0	0
2	86775305	.	T	C	15	7	22	0	1	23	0	0
2	87069379	rs4322832	G	A	6	2	8	0	0	8	0	0
2	87069431	rs4514875	C	T	4	3	7	0	0	7	0	0
2	87258718	.	G	A	6	2	8	0	0	8	0	0
2	87302754	rs192296432	G	A	14	17	31	0	0	31	0	0
2	87755101	rs1262	C	T	56	68	124	0	0	124	0	0
2	87779747	rs200640242	T	C	3	3	6	0	0	6	0	0
2	87820915	.	C	T	93	61	154	0	1	155	0	0
2	88036478	.	C	T	9	0	9	0	0	9	0	0
2	88873619	rs67351000	T	C	6	9	15	0	0	15	0	0
2	88879131	rs1805164	T	C	39	32	71	0	0	71	0	0
2	88880235	rs56653552	T	A	6	2	8	0	0	8	0	0
2	88880479	rs60676261	G	A	8	5	13	0	0	13	0	0
2	88882942	rs6750998	T	A	4	2	6	0	0	6	0	0
2	88901605	rs530831975	G	A	2	5	7	0	0	7	0	0
2	88908328	rs10196205	T	C	3	3	6	0	0	6	0	0
2	89004147	rs2222029	T	C	7	6	13	0	0	13	0	0
2	89050126	rs6974	T	G	183	195	378	0	2	380	0	0
2	89161069	rs113458930	G	C	126	45	171	0	5	182	6	0
2	89161072	rs113539064	T	C	80	40	120	0	1	124	3	0
2	89165189	rs232218	A	C	22	18	40	0	0	40	0	0
2	89513365	rs181706250	A	G	9	1	10	0	0	10	0	0
2	91805816	.	G	A	6	0	6	0	0	6	0	0
2	91805833	.	A	G	14	0	14	0	0	14	0	0
2	91805928	.	T	C	59	0	59	0	0	59	0	0
2	91805938	.	A	G	59	0	59	0	0	59	0	0
2	95763345	rs10183994	A	G	5	1	6	0	0	6	0	0
2	96473318	rs116287759	A	G	4	5	9	0	0	9	0	0
2	96516082	.	G	A	6	0	6	0	0	6	0	0
2	96516084	.	A	G	6	0	6	0	0	6	0	0
2	96809331	rs1724120	T	C	751	667	1418	0	4	1423	1	0
2	96811434	rs2969489	T	C	14	13	27	0	2	29	0	0
2	96850885	rs4826	T	C	205	286	491	0	2	493	0	0
2	96851119	rs11164062	C	A	175	189	364	0	5	369	0	0
2	96858914	rs997548	A	G	4	14	18	0	0	18	0	0
2	96859034	rs997547	A	G	120	134	254	0	2	256	0	0
2	96861159	rs2276650	C	G	96	131	227	0	1	228	0	0
2	96874590	rs6725867	T	C	5	3	8	0	0	8	0	0
2	96874591	rs6725872	T	C	6	3	9	0	0	9	0	0
2	96902320	rs57476471	A	C	5	2	7	0	0	7	0	0
2	96902604	rs61697794	C	T	4	4	8	0	0	8	0	0
2	96903360	rs4371393	A	G	3	3	6	0	0	6	0	0
2	96904127	rs6576968	G	A	3	3	6	0	0	6	0	0
2	96905568	rs12617019	T	C	5	3	8	0	0	8	0	0
2	96914636	rs11551400	T	C	90	103	193	0	1	194	0	0
2	96917588	rs7058	T	G	366	348	714	0	6	722	2	0
2	96919642	rs3852673	C	T	295	267	562	0	5	567	0	0
2	96920893	rs72825877	T	G	3	4	7	0	0	7	0	0
2	96934504	rs62153033	T	C	31	18	49	0	0	49	0	0
2	96937296	rs1044594	G	C	43	53	96	0	0	96	0	0
2	96943473	rs3214063	T	C	23	24	47	0	0	47	0	0
2	96945712	rs62153039	C	T	13	7	20	0	0	20	0	0
2	96952833	rs3171927	A	G	162	149	311	0	6	317	0	0
2	96960471	rs772177	C	A	1	5	6	0	0	6	0	0
2	96978317	rs1081717	G	C	13	14	27	0	0	27	0	0
2	96991298	rs183487009	C	T	8	5	13	0	0	13	0	0
2	96993757	rs2279105	C	T	14	7	21	0	0	21	0	0
2	96993884	rs1048675	A	G	10	10	20	0	0	20	0	0
2	97020049	rs3731935	T	C	9	7	16	0	0	16	0	0
2	97030247	rs2305935	T	C	5	11	16	0	0	16	0	0
2	97203137	rs749027	A	C	7	6	13	0	1	14	0	0
2	97212693	rs2278563	C	T	19	22	41	0	0	41	0	0
2	97212755	rs1011040	T	C	11	13	24	0	1	25	0	0
2	97792828	rs200222684	C	T	4	2	6	0	0	6	0	0
2	98279540	rs139143943	T	C	30	20	50	0	0	50	0	0
2	98372980	rs6875	A	G	13	16	29	0	0	29	0	0
2	98373006	rs5865	C	T	14	11	25	0	0	25	0	0
2	98391887	rs3821053	G	A	2	8	10	0	0	10	0	0
2	98598530	rs75759809	G	C	28	35	63	0	1	64	0	0
2	98600082	rs10210880	C	A	21	27	48	0	0	48	0	0
2	98611994	rs2279824	G	T	4	3	7	0	0	7	0	0
2	98612266	rs3088327	A	G	4	10	14	0	0	14	0	0
2	99113740	rs56197140	T	C	1	5	6	0	0	6	0	0
2	99122921	rs77128953	T	A	9	2	11	0	0	11	0	0
2	99123177	rs3820943	G	C	2	8	10	0	0	10	0	0
2	99149946	rs2278211	G	A	6	5	11	0	0	11	0	0
2	99172244	rs2278206	A	G	11	8	19	0	0	19	0	0
2	99185423	rs1001856	C	G	4	5	9	0	0	9	0	0
2	99185867	rs3754876	C	T	4	8	12	0	0	12	0	0
2	99187433	rs3769709	A	T	9	2	11	0	1	12	0	0
2	99187650	rs3769708	T	C	7	7	14	0	0	14	0	0
2	99188783	rs72821965	T	C	3	5	8	0	0	8	0	0
2	99193496	rs2230388	C	T	21	14	35	0	0	35	0	0
2	99204428	rs6736755	C	T	9	10	19	0	0	19	0	0
2	99204646	.	T	C	15	3	18	0	0	18	0	0
2	99205962	rs2276603	T	C	7	12	19	0	0	19	0	0
2	99216531	rs11537554	A	G	8	11	19	0	1	20	0	0
2	99216593	rs72823794	T	A	10	13	23	0	0	23	0	0
2	99222834	rs17506535	G	C	6	2	8	0	0	8	0	0
2	99222916	rs4851145	C	T	7	4	11	0	0	11	0	0
2	99225168	rs1139829	C	T	24	15	39	0	0	39	0	0
2	99225645	rs11896729	T	C	2	11	13	0	0	13	0	0
2	99226021	rs3203856	C	T	4	7	11	0	0	11	0	0
2	99226173	rs1062847	T	A	10	13	23	0	0	23	0	0
2	99227812	rs72823796	C	T	4	6	10	0	0	10	0	0
2	99231805	rs7595120	C	G	7	5	12	0	0	12	0	0
2	99232312	rs1516085	G	A	7	6	13	0	0	13	0	0
2	99232405	rs190071922	A	G	12	6	18	0	0	18	0	0
2	99233781	rs3820941	C	T	7	7	14	0	0	14	0	0
2	99233894	rs3769698	T	C	8	15	23	0	0	23	0	0
2	99239164	rs72825704	T	C	3	4	7	0	0	7	0	0
2	100020945	rs3087401	C	T	23	27	50	0	0	50	0	0
2	100166454	rs13427251	A	T	25	13	38	0	0	38	0	0
2	100167239	rs4851212	G	A	44	27	71	0	0	71	0	0
2	100210074	rs1047281	G	C	14	16	30	0	0	30	0	0
2	100210642	rs1047265	T	C	20	24	44	0	0	44	0	0
2	100218080	rs4851214	G	A	14	12	26	0	0	26	0	0
2	100222391	rs35913285	C	T	1	5	6	0	0	6	0	0
2	101619283	rs2278724	C	G	3	4	7	0	0	7	0	0
2	101619321	rs2278723	T	C	3	3	6	0	0	6	0	0
2	101622728	rs10934	C	T	150	176	326	0	1	327	0	0
2	101623667	rs11695176	C	T	10	4	14	0	0	14	0	0
2	101624471	rs746924	T	C	9	9	18	0	0	18	0	0
2	101635538	rs13007048	C	T	72	7	79	0	0	79	0	0
2	101638888	rs3739014	A	G	9	9	18	0	2	20	0	0
2	101644855	rs11683877	G	A	9	8	17	0	0	17	0	0
2	101656726	rs2289953	T	C	3	3	6	0	0	6	0	0
2	101870862	rs935067	G	A	3	3	6	0	0	6	0	0
2	101882663	rs4561686	G	C	5	2	7	0	0	7	0	0
2	101883027	rs3736586	T	C	2	5	7	0	0	7	0	0
2	101883046	rs1660694	A	G	2	5	7	0	0	7	0	0
2	101892105	rs1192808	G	A	40	31	71	0	0	71	0	0
2	101894222	rs6737919	C	T	4	3	7	0	0	7	0	0
2	101894820	rs1192809	A	G	5	3	8	0	0	8	0	0
2	101897871	rs1192793	C	T	1	6	7	0	0	7	0	0
2	101897973	.	T	A	5	2	7	0	0	7	0	0
2	101898412	rs13151	G	C	151	127	278	0	1	279	0	0
2	101899130	rs935065	T	C	5	11	16	0	1	17	0	0
2	101899431	rs6715956	A	G	8	12	20	0	2	22	0	0
2	101900500	rs1192795	T	C	18	9	27	0	0	27	0	0
2	101902260	rs1192796	C	T	6	8	14	0	0	14	0	0
2	101904406	rs4851415	T	C	7	4	11	0	0	11	0	0
2	101967346	rs6543032	C	T	4	5	9	0	0	9	0	0
2	101999296	rs7577564	C	T	4	3	7	0	0	7	0	0
2	102018908	rs2175968	A	G	1	8	9	0	0	9	0	0
2	102029646	rs12620464	T	C	6	0	6	0	0	6	0	0
2	102032661	rs76866419	G	C	5	1	6	0	0	6	0	0
2	102067083	rs7585228	T	C	1	7	8	0	0	8	0	0
2	102462574	rs17802002	C	T	11	6	17	0	0	17	0	0
2	102463272	rs62156941	T	A	3	6	9	0	0	9	0	0
2	102465650	rs62156942	T	A	2	6	8	0	0	8	0	0
2	102466140	rs10489973	G	T	3	6	9	0	0	9	0	0
2	102467816	rs2108196	C	T	3	4	7	0	1	8	0	0
2	102468124	rs2298943	C	T	5	2	7	0	1	8	0	0
2	102468624	rs2298942	A	G	12	7	19	0	1	20	0	0
2	102468824	rs2298941	A	C	4	8	12	0	0	12	0	0
2	102470235	rs62156943	G	A	8	9	17	0	1	18	0	0
2	102472459	rs1139583	A	G	120	121	241	0	6	247	0	0
2	102483883	rs17745869	T	G	63	50	113	0	4	117	0	0
2	102500336	rs17802614	G	A	5	5	10	0	0	10	0	0
2	102509994	rs55821509	G	A	49	41	90	0	3	93	0	0
2	102794326	rs3917326	C	T	2	4	6	0	0	6	0	0
2	105654588	rs13399067	C	T	7	1	8	0	0	8	0	0
2	105882761	rs1866040	G	A	265	285	550	0	4	554	0	0
2	105882780	rs11685266	C	T	299	271	570	0	2	572	0	0
2	105884500	rs35046128	G	A	7	5	12	0	0	12	0	0
2	105885194	rs17030722	A	G	8	5	13	0	0	13	0	0
2	105885432	rs67307760	C	T	4	4	8	0	0	8	0	0
2	105885961	rs2241797	T	C	221	170	391	0	0	391	0	0
2	105888839	rs2576735	C	T	11	8	19	0	0	19	0	0
2	105889349	rs11676273	G	A	206	190	396	0	2	398	0	0
2	105897740	rs1020064	T	G	9	11	20	0	0	20	0	0
2	105897964	rs2576741	T	C	6	4	10	0	0	10	0	0
2	105898822	rs2576742	T	A	10	6	16	0	0	16	0	0
2	105899702	rs3792044	A	C	9	7	16	0	0	16	0	0
2	105901107	rs3828300	G	A	2	5	7	0	0	7	0	0
2	105901337	rs2576743	C	T	2	5	7	0	0	7	0	0
2	105902255	rs3792050	T	C	3	3	6	0	0	6	0	0
2	105906410	rs35350916	C	G	2	4	6	0	0	6	0	0
2	105910513	rs1030877	G	A	3	3	6	0	0	6	0	0
2	105924017	rs67600221	C	T	22	10	32	0	0	32	0	0
2	106712516	rs11900943	C	A	6	3	9	0	0	9	0	0
2	106722953	rs17032398	T	C	9	4	13	0	0	13	0	0
2	106727010	rs66529457	G	A	5	4	9	0	0	9	0	0
2	106762366	rs2028566	T	C	6	4	10	0	0	10	0	0
2	106766480	rs11685300	G	A	5	5	10	0	0	10	0	0
2	109070518	rs61129860	C	T	2	5	7	0	0	7	0	0
2	109071822	rs2683800	G	A	12	0	12	0	0	12	0	0
2	109089695	rs2718705	G	A	6	5	11	0	0	11	0	0
2	109089745	rs2577621	A	G	5	5	10	0	0	10	0	0
2	109089952	rs2577620	A	G	9	4	13	0	0	13	0	0
2	109090267	rs2577619	G	C	3	3	6	0	0	6	0	0
2	109090539	rs2718703	G	A	7	2	9	0	0	9	0	0
2	109091479	rs6719131	C	G	24	35	59	0	2	61	0	0
2	109091555	rs1053027	G	C	29	42	71	0	0	71	0	0
2	109091816	rs2577618	G	A	6	4	10	0	0	10	0	0
2	109092662	rs2577617	C	T	14	4	18	0	0	18	0	0
2	109099385	rs2577614	C	T	1	5	6	0	0	6	0	0
2	109104643	rs2053262	G	A	3	3	6	0	0	6	0	0
2	109106381	rs12104502	A	G	57	35	92	0	0	92	0	0
2	109122414	rs2917976	A	T	7	1	8	0	0	8	0	0
2	109124356	rs13386343	C	A	51	27	78	0	0	78	0	0
2	109125164	rs12779	A	G	44	65	109	0	0	109	0	0
2	109125221	rs145909274	C	G	44	29	73	0	1	74	0	0
2	109277231	.	A	G	6	1	7	0	0	7	0	0
2	109277239	rs12472770	C	T	0	6	6	0	0	6	0	0
2	109280501	rs62151369	T	C	4	2	6	0	0	6	0	0
2	109293130	.	A	G	38	24	62	0	0	62	0	0
2	109295193	rs3863928	A	G	3	3	6	0	0	6	0	0
2	109301841	rs930038	G	A	12	8	20	0	0	20	0	0
2	109336523	.	A	G	5	3	8	0	0	8	0	0
2	109347947	rs826526	T	G	4	28	32	0	0	32	0	0
2	109357175	.	T	G	21	40	61	0	0	61	0	0
2	109357651	rs4012071	A	T	7	12	19	0	0	19	0	0
2	109357772	rs826565	T	C	9	17	26	0	1	27	0	0
2	109358997	rs826564	C	A	22	38	60	0	0	60	0	0
2	109359052	rs2059725	G	A	40	21	61	0	2	63	0	0
2	109359680	rs826563	C	T	4	40	44	0	0	44	0	0
2	109360896	.	T	C	10	28	38	0	3	41	0	0
2	109363025	rs826561	T	C	4	5	9	0	0	9	0	0
2	109363928	rs826560	G	A	7	10	17	0	0	17	0	0
2	109364301	rs826559	G	A	9	12	21	0	0	21	0	0
2	109364443	rs826558	T	C	17	10	27	0	0	27	0	0
2	109364893	rs826557	G	C	3	13	16	0	0	16	0	0
2	109367977	rs144029181	A	G	17	12	29	0	0	29	0	0
2	109368773	rs866114	T	A	10	21	31	0	0	31	0	0
2	109369126	rs826522	G	A	11	21	32	0	0	32	0	0
2	109369720	rs826521	G	T	1	5	6	0	0	6	0	0
2	109374952	.	A	G	203	279	482	0	2	484	0	0
2	109375504	rs826547	A	T	14	0	14	0	0	14	0	0
2	109386721	rs826581	T	G	2	4	6	0	0	6	0	0
2	109388846	rs700876	G	A	6	10	16	0	0	16	0	0
2	109390116	rs749946	T	G	16	19	35	0	2	37	0	0
2	109391095	rs1724203	C	T	14	26	40	0	0	40	0	0
2	109391783	rs1649330	G	C	20	46	66	0	0	66	0	0
2	109393766	rs56132830	A	T	10	3	13	0	0	13	0	0
2	109393774	rs371189636	A	T	10	0	10	0	1	11	0	0
2	109393779	rs375449172	A	T	10	0	10	0	0	10	0	0
2	109393780	rs367803624	G	T	10	0	10	0	0	10	0	0
2	109393781	rs371705935	A	T	10	0	10	0	0	10	0	0
2	109394015	rs1614285	T	A	5	10	15	0	0	15	0	0
2	109394238	rs1724204	C	T	6	10	16	0	0	16	0	0
2	109395678	rs1724205	C	A	33	49	82	0	0	82	0	0
2	109396609	rs35096475	C	T	12	23	35	0	2	37	0	0
2	109396694	rs34533357	G	A	21	48	69	0	1	70	0	0
2	109401259	rs826556	C	T	68	73	141	0	2	143	0	0
2	109408208	rs6740879	G	A	5	4	9	0	0	9	0	0
2	109429146	rs975597	T	A	8	3	11	0	0	11	0	0
2	111886332	rs13429049	C	T	8	4	12	0	0	12	0	0
2	111923630	rs6753785	T	G	17	25	42	0	0	42	0	0
2	112005079	rs13391770	A	G	4	3	7	0	0	7	0	0
2	112588975	rs147457004	G	A	10	17	27	0	0	27	0	0
2	112605302	rs4848197	C	T	11	4	15	0	0	15	0	0
2	112751928	rs7604639	G	A	2	8	10	0	0	10	0	0
2	112755001	rs2230515	A	G	2	12	14	0	0	14	0	0
2	112763640	rs7583987	C	G	2	5	7	0	0	7	0	0
2	112763710	rs4511729	T	C	2	6	8	0	0	8	0	0
2	112765973	rs1131244	A	G	0	15	15	0	0	15	0	0
2	112786049	rs2230517	G	A	2	19	21	0	0	21	0	0
2	112786357	rs10205793	G	A	0	17	17	0	0	17	0	0
2	112812882	rs13421261	C	T	6	2	8	0	0	8	0	0
2	112813066	rs10176660	G	C	3	7	10	0	0	10	0	0
2	113130994	.	A	G	5	2	7	0	0	7	0	0
2	113145814	.	C	T	3	12	15	0	0	15	0	0
2	113162596	.	C	G	6	2	8	0	0	8	0	0
2	113162683	.	G	A	4	2	6	0	0	6	0	0
2	113166279	.	C	T	10	3	13	0	0	13	0	0
2	113167195	rs372365831	T	C	5	8	13	0	0	13	0	0
2	113168506	.	C	T	20	3	23	0	0	23	0	0
2	113168594	.	A	G	19	1	20	0	1	21	0	0
2	113168799	.	A	G	9	1	10	0	0	10	0	0
2	113258916	rs2918763	C	T	8	4	12	0	0	12	0	0
2	113277949	rs62157538	T	C	3	8	11	0	0	11	0	0
2	113288588	rs1127264	C	T	2	4	6	0	0	6	0	0
2	113289032	rs11644	A	G	7	14	21	0	0	21	0	0
2	113308516	rs2304555	T	A	21	11	32	0	1	33	0	0
2	113309473	rs1545133	C	T	15	14	29	0	1	30	0	0
2	113312117	rs11689338	A	G	4	10	14	0	0	14	0	0
2	113318909	rs6707131	G	A	4	2	6	0	0	6	0	0
2	113334357	rs7578724	G	A	10	8	18	0	1	19	0	0
2	113334572	rs17586430	A	C	3	3	6	0	0	6	0	0
2	113346512	rs1047652	A	C	65	12	77	0	1	78	0	0
2	113404708	rs4849091	G	A	88	57	145	0	0	145	0	0
2	113409837	rs1053652	G	C	11	7	18	0	0	18	0	0
2	113410015	rs10758	A	G	12	10	22	0	1	23	0	0
2	113412003	rs10184339	C	T	12	10	22	0	0	22	0	0
2	113414986	rs3827758	A	G	46	43	89	0	0	89	0	0
2	113417579	rs58662040	G	A	3	5	8	0	0	8	0	0
2	113419738	rs60372418	C	G	10	10	20	0	1	21	0	0
2	113498566	rs3811040	A	G	2	6	8	0	0	8	0	0
2	113587433	rs1071676	C	G	28	23	51	0	0	51	0	0
2	113588793	rs1143639	C	T	3	8	11	0	0	11	0	0
2	113589333	rs1143637	C	T	5	2	7	0	0	7	0	0
2	113590390	rs1143634	G	A	71	80	151	0	0	151	0	0
2	113590467	rs1143633	C	T	7	3	10	0	0	10	0	0
2	113887207	rs419598	T	C	6	8	14	0	0	14	0	0
2	113891412	rs9005	G	A	14	5	19	0	0	19	0	0
2	114343971	.	T	C	3	5	8	0	0	8	0	0
2	114343984	.	C	A	3	5	8	0	0	8	0	0
2	114343989	.	C	T	6	1	7	0	1	8	0	0
2	114343997	.	T	C	3	3	6	0	0	6	0	0
2	114344007	.	C	T	8	1	9	0	0	9	0	0
2	114346873	.	C	T	6	2	8	0	0	8	0	0
2	114346904	.	T	A	6	1	7	0	0	7	0	0
2	114347371	.	A	C	6	0	6	0	0	6	0	0
2	114347577	rs2900687	T	C	3	3	6	0	0	6	0	0
2	114349599	.	C	T	10	3	13	0	0	13	0	0
2	114349866	.	T	C	2	5	7	0	0	7	0	0
2	114350105	.	T	G	3	5	8	0	0	8	0	0
2	114351412	.	A	G	5	3	8	0	0	8	0	0
2	114352071	rs420746	T	C	5	4	9	0	0	9	0	0
2	114352643	.	G	A	9	5	14	0	0	14	0	0
2	114353351	rs11691138	C	T	24	11	35	0	0	35	0	0
2	114355167	.	A	G	313	110	423	0	6	430	1	0
2	114356066	.	G	A	14	1	15	0	1	16	0	0
2	114356239	rs11490622	T	C	48	54	102	0	0	102	0	0
2	114357350	rs67465876	T	C	2	9	11	0	0	11	0	0
2	114369646	rs1665293	C	A	12	3	15	0	0	15	0	0
2	114369669	rs1622231	A	G	10	6	16	0	0	16	0	0
2	114369771	.	C	T	8	13	21	0	0	21	0	0
2	114691291	rs148473081	C	T	7	7	14	0	0	14	0	0
2	114698991	rs17269808	A	G	3	4	7	0	0	7	0	0
2	114704342	rs75122029	C	T	2	6	8	0	0	8	0	0
2	114710025	rs146876731	C	T	9	6	15	0	0	15	0	0
2	118575215	rs1052637	C	G	24	29	53	0	0	53	0	0
2	118583940	rs2303348	C	T	35	41	76	0	0	76	0	0
2	118588622	rs15975	C	T	33	17	50	0	1	51	0	0
2	118588713	rs10094	C	T	38	25	63	0	0	63	0	0
2	118589843	rs571	C	T	5	6	11	0	1	12	0	0
2	118673663	rs1046330	T	C	38	41	79	0	0	79	0	0
2	118673738	rs1046328	G	A	52	46	98	0	0	98	0	0
2	118675004	rs72834376	C	T	38	37	75	0	0	75	0	0
2	118675578	rs12711888	C	T	28	36	64	0	1	65	0	0
2	118675743	rs11123466	G	A	26	40	66	0	0	66	0	0
2	118676111	rs6755016	T	C	34	39	73	0	0	73	0	0
2	118676836	rs1863040	T	C	13	27	40	0	0	40	0	0
2	118677471	.	C	T	46	39	85	0	1	86	0	0
2	118694393	rs2303333	C	G	5	2	7	0	0	7	0	0
2	118694579	rs2303332	G	T	3	5	8	0	0	8	0	0
2	118695249	rs11890013	G	A	4	14	18	0	0	18	0	0
2	118695432	rs1541715	G	A	4	4	8	0	0	8	0	0
2	118695838	rs6725474	G	A	4	3	7	0	0	7	0	0
2	118697432	rs3755494	A	G	3	3	6	0	0	6	0	0
2	118697803	rs3755495	C	G	3	6	9	0	0	9	0	0
2	118698932	rs72836302	T	C	4	2	6	0	0	6	0	0
2	118708284	rs7578387	C	T	10	4	14	0	0	14	0	0
2	118708813	rs3771941	C	T	2	8	10	0	0	10	0	0
2	118708850	rs3771942	C	G	12	4	16	0	1	17	0	0
2	118709122	rs3771943	T	G	16	7	23	0	0	23	0	0
2	118739135	rs918854	A	T	4	3	7	0	0	7	0	0
2	118750407	rs7564075	A	T	1	5	6	0	0	6	0	0
2	118750865	rs13024267	G	A	3	3	6	0	0	6	0	0
2	118771566	rs11545372	C	A	30	34	64	0	0	64	0	0
2	120021917	rs3731603	C	A	2	4	6	0	0	6	0	0
2	120022385	.	C	T	6	0	6	0	0	6	0	0
2	120059988	rs1890	T	C	12	10	22	0	0	22	0	0
2	120060082	rs1052500	T	C	21	12	33	0	1	34	0	0
2	120078778	rs1132267	T	C	14	17	31	0	1	32	0	0
2	120123208	rs4849777	A	C	3	4	7	0	0	7	0	0
2	120125029	rs2084202	A	G	107	74	181	0	1	182	0	0
2	120125315	rs8192501	G	A	7	8	15	0	0	15	0	0
2	120125936	rs2244135	T	C	13	10	23	0	0	23	0	0
2	122096018	rs934940	C	A	37	42	79	0	0	79	0	0
2	122492869	rs11676686	T	C	6	5	11	0	2	13	0	0
2	127413616	.	G	A	4	5	9	0	0	9	0	0
2	127414593	rs13008888	G	C	19	22	41	0	0	41	0	0
2	127414661	rs6729097	C	T	21	28	49	0	1	50	0	0
2	127414803	rs28387085	G	A	22	17	39	0	0	39	0	0
2	127415578	rs11894065	C	T	37	25	62	0	1	63	0	0
2	127417098	rs12993890	C	T	4	10	14	0	0	14	0	0
2	127417987	rs28387094	C	T	5	5	10	0	0	10	0	0
2	127418837	rs7574360	C	T	8	9	17	0	0	17	0	0
2	127419043	rs34234112	T	G	5	3	8	0	0	8	0	0
2	127419582	rs10928978	G	T	7	3	10	0	0	10	0	0
2	127420228	rs10928979	A	G	6	5	11	0	1	12	0	0
2	127420383	rs13008527	G	A	3	4	7	0	0	7	0	0
2	127420931	rs2016257	A	G	33	20	53	0	3	56	0	0
2	127421391	rs12692114	C	G	58	29	87	0	0	87	0	0
2	127421701	rs12468957	G	A	36	13	49	0	2	51	0	0
2	127422573	rs4662685	G	A	34	25	59	0	0	59	0	0
2	127422593	rs7589096	C	T	29	22	51	0	1	52	0	0
2	127422910	rs7597905	T	C	10	5	15	0	0	15	0	0
2	127423006	rs13028641	G	C	7	2	9	0	0	9	0	0
2	127423104	rs12692115	C	T	4	4	8	0	0	8	0	0
2	127424041	rs28387109	T	C	5	4	9	0	0	9	0	0
2	127424389	rs17690541	C	T	7	6	13	0	0	13	0	0
2	127424566	rs7596516	C	T	6	6	12	0	0	12	0	0
2	127424849	rs11694376	T	C	4	5	9	0	0	9	0	0
2	127425021	rs11692939	A	C	5	3	8	0	0	8	0	0
2	127426671	rs17690564	T	C	2	6	8	0	0	8	0	0
2	127426697	rs17741574	C	T	3	5	8	0	0	8	0	0
2	127426979	rs28387124	T	G	12	7	19	0	0	19	0	0
2	127427025	rs28387125	G	A	12	11	23	0	0	23	0	0
2	127427297	rs28387126	G	A	3	7	10	0	0	10	0	0
2	127427674	rs28387130	G	A	7	4	11	0	0	11	0	0
2	127430087	rs28369981	C	A	11	9	20	0	0	20	0	0
2	127434530	rs28369987	G	A	10	9	19	0	0	19	0	0
2	127435528	.	C	T	3	7	10	0	0	10	0	0
2	127443627	rs1866658	A	G	28	30	58	0	0	58	0	0
2	127443771	rs7599354	G	T	27	33	60	0	0	60	0	0
2	127443958	rs17741936	T	G	25	35	60	0	0	60	0	0
2	127445822	rs6713073	C	G	25	19	44	0	0	44	0	0
2	127446220	rs2018638	G	A	31	21	52	0	0	52	0	0
2	127446415	rs28387199	C	T	16	27	43	0	0	43	0	0
2	127446489	rs935019	A	G	22	18	40	0	0	40	0	0
2	127446529	rs28647563	G	A	24	20	44	0	0	44	0	0
2	127446937	rs730664	C	T	16	25	41	0	0	41	0	0
2	127447170	rs28609696	G	A	11	8	19	0	0	19	0	0
2	127448415	rs74499727	C	T	26	58	84	0	0	84	0	0
2	127448802	.	C	T	131	66	197	0	2	199	0	0
2	127449447	.	C	G	45	40	85	0	0	85	0	0
2	127453261	rs1530147	A	C	4	2	6	0	0	6	0	0
2	127454230	rs6568	T	G	139	104	243	0	2	245	0	0
2	128017491	rs4150518	A	G	3	5	8	0	0	8	0	0
2	128051726	rs9282675	G	A	3	4	7	0	1	8	0	0
2	128060068	rs4233583	C	A	40	35	75	0	0	75	0	0
2	128060163	rs4233584	C	T	36	39	75	0	0	75	0	0
2	128061053	rs4497825	A	G	43	27	70	0	0	70	0	0
2	128062048	rs3088374	T	C	95	77	172	0	0	172	0	0
2	128079806	rs3732209	A	G	32	25	57	0	0	57	0	0
2	128143424	rs13425274	A	T	2	6	8	0	0	8	0	0
2	128145472	rs79789049	G	A	6	5	11	0	0	11	0	0
2	128240174	rs114303242	C	T	5	5	10	0	0	10	0	0
2	128369896	rs777435	A	G	5	2	7	0	0	7	0	0
2	128459039	rs1048211	A	G	16	8	24	0	0	24	0	0
2	128461524	rs7584783	G	T	8	6	14	0	1	15	0	0
2	128461556	rs7575478	A	G	7	5	12	0	0	12	0	0
2	128464116	rs34550770	G	A	38	20	58	0	0	58	0	0
2	128562813	rs7578247	A	G	6	1	7	0	0	7	0	0
2	128601490	rs11688522	T	C	11	4	15	0	0	15	0	0
2	128601602	rs12692069	T	C	12	4	16	0	0	16	0	0
2	128602341	rs6746537	T	C	5	2	7	0	0	7	0	0
2	128602517	rs72848835	C	T	11	8	19	0	0	19	0	0
2	128602913	rs77758280	G	A	5	9	14	0	0	14	0	0
2	128604232	rs1061056	A	T	14	4	18	0	0	18	0	0
2	128605151	rs41552916	T	C	37	42	79	0	1	80	0	0
2	128608184	rs11556864	C	T	84	71	155	0	9	164	0	0
2	128608290	rs6713679	T	C	6	8	14	0	0	14	0	0
2	128620372	rs2261682	T	C	27	20	47	0	0	47	0	0
2	128625962	.	G	A	2	5	7	0	0	7	0	0
2	128699833	rs1370229	C	T	4	3	7	0	0	7	0	0
2	128767850	.	C	T	24	28	52	0	2	54	0	0
2	128934400	rs2290111	T	C	9	10	19	0	0	19	0	0
2	128939799	rs17178720	C	T	5	13	18	0	0	18	0	0
2	128939817	rs1699	G	A	8	13	21	0	1	22	0	0
2	128947505	rs11542865	G	A	10	7	17	0	0	17	0	0
2	128947895	rs9973651	T	C	5	10	15	0	1	16	0	0
2	128949208	rs13028303	G	A	10	14	24	0	0	24	0	0
2	128949893	rs1054317	A	G	15	11	26	0	0	26	0	0
2	128950217	rs11542864	C	T	9	13	22	0	0	22	0	0
2	129025705	rs112636716	C	G	38	84	122	0	0	122	0	0
2	129035017	rs6723548	T	C	2	7	9	0	0	9	0	0
2	129035083	rs17016070	C	T	3	8	11	0	0	11	0	0
2	129039613	rs61245091	G	A	1	6	7	0	0	7	0	0
2	129042723	rs75808943	C	G	1	5	6	0	0	6	0	0
2	129042912	rs150099907	C	T	2	6	8	0	0	8	0	0
2	129043010	rs6711447	A	G	3	6	9	0	0	9	0	0
2	129045471	rs6723230	T	C	3	5	8	0	0	8	0	0
2	129045584	rs12469358	T	C	3	6	9	0	0	9	0	0
2	129048433	rs2084498	A	G	10	3	13	0	5	18	0	0
2	129050354	rs6761320	C	T	8	9	17	0	2	19	0	0
2	129050472	rs1375349	A	G	13	20	33	0	1	34	0	0
2	129050585	rs1375348	C	G	25	21	46	0	0	46	0	0
2	129050909	rs1375347	A	G	19	22	41	0	0	41	0	0
2	129051064	rs6431009	T	C	21	15	36	0	0	36	0	0
2	129051185	.	G	A	25	24	49	0	0	49	0	0
2	129052352	rs4662790	A	G	18	18	36	0	1	37	0	0
2	129052367	rs56197944	G	C	19	20	39	0	0	39	0	0
2	129052417	rs17040155	G	C	17	29	46	0	0	46	0	0
2	129052655	rs4662791	T	C	17	29	46	0	0	46	0	0
2	129052860	rs7566627	C	T	23	27	50	0	3	53	0	0
2	129053866	rs7586881	T	A	17	16	33	0	0	33	0	0
2	129055476	rs12622112	G	A	5	5	10	0	0	10	0	0
2	129056518	rs1530719	G	A	4	12	16	0	1	17	0	0
2	129056884	rs8179790	T	C	6	14	20	0	1	21	0	0
2	129056917	rs8179791	T	C	7	12	19	0	0	19	0	0
2	129057026	rs8179774	A	G	8	14	22	0	0	22	0	0
2	129057292	rs7595689	A	G	5	10	15	0	0	15	0	0
2	129057416	rs7598684	T	A	6	7	13	0	0	13	0	0
2	129057947	rs6431010	G	A	9	10	19	0	0	19	0	0
2	129058615	rs12467100	C	G	10	8	18	0	0	18	0	0
2	129059215	rs840887	T	C	6	14	20	0	0	20	0	0
2	129059884	rs840888	A	G	11	10	21	0	0	21	0	0
2	129061915	rs840890	T	C	11	8	19	0	0	19	0	0
2	129062290	rs840891	G	T	7	13	20	0	0	20	0	0
2	129062947	rs62158068	C	T	8	12	20	0	0	20	0	0
2	129063188	rs140513978	C	T	8	10	18	0	0	18	0	0
2	129063875	rs844484	C	T	13	9	22	0	0	22	0	0
2	129064882	rs840892	T	C	8	8	16	0	0	16	0	0
2	129066114	.	C	T	16	10	26	0	0	26	0	0
2	129066260	rs840870	G	T	11	15	26	0	0	26	0	0
2	129066438	rs840871	G	A	5	13	18	0	0	18	0	0
2	129066717	rs840872	T	C	9	17	26	0	0	26	0	0
2	129067826	rs840874	C	G	4	5	9	0	0	9	0	0
2	129068234	rs840875	T	C	8	16	24	0	0	24	0	0
2	129069705	rs78474171	T	C	9	9	18	0	0	18	0	0
2	129070028	rs67592012	C	T	6	9	15	0	0	15	0	0
2	129070742	rs13392124	G	A	12	11	23	0	0	23	0	0
2	129070902	rs6745479	C	T	4	6	10	0	0	10	0	0
2	129071774	rs840879	A	G	19	20	39	0	0	39	0	0
2	129072360	rs861461	C	G	13	22	35	0	0	35	0	0
2	129072749	rs840880	C	G	16	21	37	0	0	37	0	0
2	129073568	rs840881	G	C	11	14	25	0	0	25	0	0
2	129073674	rs4662601	G	T	11	10	21	0	1	22	0	0
2	129074699	rs10928813	G	A	6	10	16	0	0	16	0	0
2	129074989	.	C	T	11	9	20	0	1	21	0	0
2	129075205	rs191141668	G	A	13	19	32	0	0	32	0	0
2	129075961	rs1133923	T	C	25	18	43	0	1	44	0	0
2	130909061	rs6985	G	T	62	0	62	0	4	66	0	0
2	130909081	rs139458844	C	A	56	0	56	0	6	62	0	0
2	130909819	rs3192417	G	C	140	143	283	0	0	283	0	0
2	130909882	rs3192414	C	G	127	190	317	0	4	322	1	0
2	130910847	rs4511676	G	A	5	7	12	0	0	12	0	0
2	130912326	rs111583358	G	A	7	6	13	0	0	13	0	0
2	130912514	rs10928960	A	G	11	16	27	0	0	27	0	0
2	130913460	rs11679878	C	T	5	12	17	0	0	17	0	0
2	130914655	rs13024697	G	A	9	7	16	0	0	16	0	0
2	130914797	.	T	C	12	11	23	0	0	23	0	0
2	130916286	rs11684431	C	T	34	29	63	0	0	63	0	0
2	130916415	rs2084784	A	G	26	14	40	0	0	40	0	0
2	130918026	rs3990508	G	A	12	31	43	0	0	43	0	0
2	130919226	rs34463896	C	T	9	10	19	0	0	19	0	0
2	130919308	rs13411684	A	G	6	9	15	0	0	15	0	0
2	130920763	rs12620443	A	G	5	9	14	0	0	14	0	0
2	130920774	rs10198100	A	G	6	9	15	0	0	15	0	0
2	130924500	.	C	T	3	5	8	0	0	8	0	0
2	130925088	rs10909567	C	T	79	110	189	0	2	191	0	0
2	130932371	rs111636541	C	A	3	4	7	0	0	7	0	0
2	130939288	rs1968676	A	G	10	17	27	0	0	27	0	0
2	130939348	rs1817097	G	A	11	13	24	0	0	24	0	0
2	130940090	rs1968675	G	T	19	43	62	0	0	62	0	0
2	130943513	rs10198499	T	C	3	3	6	0	0	6	0	0
2	131104049	rs11542414	C	T	104	100	204	0	0	204	0	0
2	131905028	.	A	G	107	88	195	0	4	199	0	0
2	132271480	rs139560500	G	A	7	10	17	0	0	17	0	0
2	132404552	rs62176638	G	A	1	5	6	0	0	6	0	0
2	132404784	rs12465649	G	A	4	2	6	0	0	6	0	0
2	132405435	rs62176639	C	T	6	15	21	0	0	21	0	0
2	135206934	rs681148	C	T	21	16	37	0	0	37	0	0
2	135207690	.	C	G	27	18	45	0	0	45	0	0
2	135207964	rs34944508	C	T	27	22	49	0	0	49	0	0
2	135209154	rs636975	A	G	23	21	44	0	1	45	0	0
2	135209591	rs669740	C	T	26	23	49	0	1	50	0	0
2	135211549	rs34497810	G	C	39	25	64	0	0	64	0	0
2	135211861	rs7841	C	T	35	44	79	0	2	81	0	0
2	135470804	rs13399359	G	A	2	5	7	0	0	7	0	0
2	135697014	rs6713522	A	G	4	3	7	0	1	8	0	0
2	135697249	rs11895201	T	A	10	4	14	0	0	14	0	0
2	135697396	rs4954199	G	A	4	9	13	0	0	13	0	0
2	135697543	rs10175818	C	A	15	13	28	0	1	29	0	0
2	135697737	rs10190690	T	C	5	10	15	0	0	15	0	0
2	135697760	rs74997024	G	C	12	6	18	0	0	18	0	0
2	135697797	rs10198975	G	T	6	14	20	0	0	20	0	0
2	135698075	rs78085498	C	T	4	2	6	0	0	6	0	0
2	135698138	rs75626308	G	A	5	4	9	0	0	9	0	0
2	135699124	rs6737606	G	C	13	17	30	0	0	30	0	0
2	135700151	rs3816339	A	T	1	9	10	0	0	10	0	0
2	135700503	rs13418192	A	G	17	25	42	0	0	42	0	0
2	135704656	rs7574434	A	G	16	16	32	0	0	32	0	0
2	135707513	rs4954201	T	C	6	1	7	0	0	7	0	0
2	135716539	.	G	A	7	5	12	0	0	12	0	0
2	135920394	rs61748693	C	T	73	62	135	0	1	136	0	0
2	136873084	rs2228014	G	A	4044	3072	7116	0	95	7211	0	0
2	136874135	rs139877430	G	A	230	232	462	0	13	475	0	0
2	139327055	rs7598316	A	G	15	17	32	0	0	32	0	0
2	139330057	rs1045918	G	A	29	20	49	0	0	49	0	0
2	143886437	rs354707	T	A	0	6	6	0	0	6	0	0
2	143886953	rs354709	T	C	8	15	23	0	0	23	0	0
2	144194565	rs17230746	C	T	168	128	296	0	1	297	0	0
2	144363104	rs12612108	G	C	1	9	10	0	0	10	0	0
2	144371873	rs72857975	A	G	36	42	78	0	1	79	0	0
2	144372973	rs10496950	C	G	4	3	7	0	0	7	0	0
2	144428480	rs11685813	G	A	2	6	8	0	0	8	0	0
2	144899559	rs3731958	C	A	28	17	45	0	0	45	0	0
2	144965236	rs10928206	G	C	4	2	6	0	0	6	0	0
2	145143934	rs62169201	G	A	4	2	6	0	0	6	0	0
2	145270592	rs6740731	G	A	29	37	66	0	0	66	0	0
2	148716428	rs2307394	T	C	25	20	45	0	0	45	0	0
2	148718920	rs4972317	T	C	4	6	10	0	0	10	0	0
2	148778272	rs897172	A	G	21	14	35	0	0	35	0	0
2	149529095	rs13022974	A	G	7	7	14	0	0	14	0	0
2	149529212	rs16829255	C	T	6	6	12	0	0	12	0	0
2	150437374	rs79091630	T	C	5	5	10	0	0	10	0	0
2	152105759	rs289882	A	G	2	4	6	0	0	6	0	0
2	152118271	rs55775354	G	A	13	8	21	0	0	21	0	0
2	152118275	rs56376752	A	G	13	8	21	0	0	21	0	0
2	152127699	rs13004590	G	T	6	8	14	0	0	14	0	0
2	152132130	rs289834	A	G	99	111	210	0	3	213	0	0
2	152134149	rs4665150	G	A	2	4	6	0	0	6	0	0
2	152139416	rs1048135	G	A	57	51	108	0	0	108	0	0
2	152144920	rs6744450	G	A	4	2	6	0	0	6	0	0
2	152146194	rs2194492	G	C	23	33	56	0	0	56	0	0
2	152664438	rs72866485	T	C	3	3	6	0	0	6	0	0
2	152693242	rs143821304	A	C	4	3	7	0	0	7	0	0
2	153001794	rs10182220	G	T	4	3	7	0	0	7	0	0
2	153004967	rs4664537	T	C	3	5	8	0	0	8	0	0
2	153405594	rs1155779	G	A	4	2	6	0	0	6	0	0
2	153504552	rs12693429	G	A	3	6	9	0	0	9	0	0
2	153505003	rs1065266	C	T	1	11	12	0	0	12	0	0
2	153511027	rs9789505	T	C	24	19	43	0	1	44	0	0
2	153522963	rs3762503	T	C	16	11	27	0	0	27	0	0
2	157406249	rs2116665	G	A	11	2	13	0	0	13	0	0
2	157440644	rs1991776	G	C	12	4	16	0	0	16	0	0
2	157441664	rs2280278	G	C	15	15	30	0	0	30	0	0
2	157442253	rs1053394	G	A	5	2	7	0	0	7	0	0
2	158281216	rs62175245	T	A	7	9	16	0	0	16	0	0
2	158310157	.	T	A	6	4	10	0	0	10	0	0
2	160094527	rs190044157	C	T	12	5	17	0	0	17	0	0
2	160112434	rs718572	T	C	3	5	8	0	0	8	0	0
2	160115401	rs56249397	C	G	2	5	7	0	0	7	0	0
2	160289863	rs61733380	T	C	27	26	53	0	1	54	0	0
2	160461478	rs10195287	C	T	6	2	8	0	0	8	0	0
2	160461680	rs10198053	G	A	5	1	6	0	0	6	0	0
2	160472950	rs13388082	C	T	54	36	90	0	0	90	0	0
2	160473399	rs1046496	A	T	29	33	62	0	0	62	0	0
2	160604452	rs11555185	C	T	41	48	89	0	0	89	0	0
2	160604936	rs13024801	G	A	46	48	94	0	1	95	0	0
2	160616975	rs11687502	T	G	7	2	9	0	0	9	0	0
2	160620769	rs5835759	G	A	9	3	12	0	1	13	0	0
2	160621739	rs2059699	G	T	3	3	6	0	0	6	0	0
2	160622630	rs12469866	G	C	4	4	8	0	0	8	0	0
2	160622961	rs10929952	C	T	7	4	11	0	0	11	0	0
2	160623366	rs4664301	C	T	7	7	14	0	0	14	0	0
2	160623590	rs12617546	G	A	6	0	6	0	0	6	0	0
2	160625727	rs13432	C	G	47	45	92	0	0	92	0	0
2	160626622	rs1042666	C	T	63	78	141	0	1	142	0	0
2	160626898	rs17815029	T	C	49	59	108	0	0	108	0	0
2	160626980	rs17815040	G	A	41	47	88	0	2	90	0	0
2	160627317	rs1126842	C	G	50	46	96	0	0	96	0	0
2	160628155	rs3771721	C	G	35	24	59	0	0	59	0	0
2	160639970	rs2114626	T	C	32	44	76	0	0	76	0	0
2	160653720	rs7588230	C	T	29	29	58	0	0	58	0	0
2	160659996	rs13307	G	A	19	14	33	0	0	33	0	0
2	160662329	rs12478470	T	C	4	2	6	0	0	6	0	0
2	160663435	rs12463589	T	C	4	3	7	0	0	7	0	0
2	160673526	rs2059696	A	G	32	42	74	0	1	75	0	0
2	160676427	rs12692566	C	A	37	25	62	0	0	62	0	0
2	160710922	rs2729705	T	C	35	37	72	0	0	72	0	0
2	160711045	rs3951216	G	C	42	33	75	0	0	75	0	0
2	160712119	rs2048436	A	G	2	5	7	0	0	7	0	0
2	160743040	rs2271381	T	A	24	30	54	0	0	54	0	0
2	161158738	rs4278892	A	G	18	13	31	0	0	31	0	0
2	162018643	rs1267059	A	C	3	5	8	0	0	8	0	0
2	162059969	rs11884495	A	T	3	6	9	0	0	9	0	0
2	162061652	rs535628733	A	G	2	4	6	0	0	6	0	0
2	162165008	rs9713	A	T	120	116	236	0	0	236	0	0
2	162258433	rs6733456	C	T	4	3	7	0	0	7	0	0
2	162264215	rs2018759	G	A	3	4	7	0	0	7	0	0
2	163124051	rs1990760	C	T	25	17	42	0	0	42	0	0
2	163166763	rs75787686	T	G	15	12	27	0	0	27	0	0
2	163208893	rs17783344	T	G	75	101	176	0	0	176	0	0
2	163210343	rs7587426	C	T	9	9	18	0	1	19	0	0
2	163213723	rs7608315	A	C	15	13	28	0	0	28	0	0
2	165566877	rs3820981	A	G	3	3	6	0	0	6	0	0
2	165597501	rs12692745	A	G	1	6	7	0	0	7	0	0
2	165597741	rs12990772	C	T	4	4	8	0	0	8	0	0
2	165597762	rs35212788	C	G	4	3	7	0	0	7	0	0
2	166730734	rs56115495	T	C	5	7	12	0	0	12	0	0
2	166730748	rs77199262	C	T	8	8	16	0	0	16	0	0
2	166747785	rs13404648	A	G	3	6	9	0	0	9	0	0
2	166770120	rs10176588	A	G	4	10	14	0	0	14	0	0
2	166773971	rs6750044	G	A	8	9	17	0	1	18	0	0
2	166797646	rs1432273	C	T	4	5	9	0	0	9	0	0
2	170362073	rs7589199	T	C	3	4	7	0	0	7	0	0
2	170403030	rs2253680	T	C	14	17	31	0	0	31	0	0
2	170411693	rs2683455	T	C	20	14	34	0	0	34	0	0
2	170465777	rs2592814	G	T	2	4	6	0	0	6	0	0
2	170465778	rs2592815	T	G	2	4	6	0	0	6	0	0
2	170469525	rs2044503	A	G	4	3	7	0	0	7	0	0
2	170482557	rs57302780	G	T	6	1	7	0	0	7	0	0
2	170484782	rs4667606	G	A	4	3	7	0	0	7	0	0
2	170489970	rs2305177	A	G	13	8	21	0	0	21	0	0
2	170493103	rs1050354	T	A	138	89	227	0	1	228	0	0
2	170493863	rs8207	A	G	82	70	152	0	1	153	0	0
2	170535962	rs9751461	G	T	3	3	6	0	0	6	0	0
2	170543126	rs1058345	A	G	4	4	8	0	0	8	0	0
2	170543491	rs4030396	A	G	7	5	12	0	0	12	0	0
2	170543520	rs2353692	C	G	4	4	8	0	0	8	0	0
2	170543715	rs4547504	A	C	2	4	6	0	0	6	0	0
2	170544112	rs13028137	T	C	5	1	6	0	0	6	0	0
2	170545000	rs13008569	A	C	5	5	10	0	0	10	0	0
2	170545357	rs13009265	A	G	1	6	7	0	0	7	0	0
2	170662634	rs13393212	C	A	15	19	34	0	0	34	0	0
2	170662845	rs76274982	A	T	7	4	11	0	0	11	0	0
2	170666813	rs3754913	T	C	230	228	458	0	5	463	0	0
2	170762566	rs10194785	A	T	11	7	18	0	0	18	0	0
2	171799715	rs10803854	T	C	10	4	14	0	0	14	0	0
2	171808625	rs16859066	C	G	5	1	6	0	0	6	0	0
2	171810732	rs12612871	G	C	11	6	17	0	0	17	0	0
2	171821996	.	G	T	4	6	10	0	0	10	0	0
2	171847832	rs16859081	G	C	2	5	7	0	0	7	0	0
2	171849612	rs1045327	T	C	43	51	94	0	0	94	0	0
2	171876212	rs2676151	G	A	4	4	8	0	0	8	0	0
2	171910313	rs11553951	C	T	77	49	126	0	2	128	0	0
2	171927666	rs2356597	A	G	1	7	8	0	0	8	0	0
2	171928320	rs6742854	T	A	3	4	7	0	0	7	0	0
2	171943358	rs13010307	C	T	6	1	7	0	0	7	0	0
2	171944915	rs6761759	A	G	6	1	7	0	1	8	0	0
2	171945593	rs958183	T	C	5	1	6	0	0	6	0	0
2	171946197	rs13030784	A	G	20	6	26	0	0	26	0	0
2	171946331	rs13430489	A	G	11	1	12	0	0	12	0	0
2	171946572	rs10930455	T	C	6	3	9	0	1	10	0	0
2	171946911	rs10930457	A	G	4	10	14	0	2	16	0	0
2	171947615	rs13411575	C	G	16	28	44	0	0	44	0	0
2	171947799	rs13425247	T	A	24	41	65	0	0	65	0	0
2	172648088	.	C	T	6	4	10	0	0	10	0	0
2	173989752	rs4972530	A	G	4	8	12	0	0	12	0	0
2	173990421	rs13020796	T	C	8	2	10	0	0	10	0	0
2	174002739	rs67683956	A	G	9	0	9	0	0	9	0	0
2	174055646	rs35853276	T	C	57	43	100	0	1	101	0	0
2	174075194	rs10930579	T	C	28	32	60	0	0	60	0	0
2	174076273	rs4972536	T	C	46	49	95	0	1	96	0	0
2	174076457	rs10185321	A	G	36	24	60	0	0	60	0	0
2	174077015	rs12693019	G	A	8	16	24	0	0	24	0	0
2	174078413	rs6717067	G	A	24	15	39	0	1	40	0	0
2	174086285	rs74417392	C	T	7	2	9	0	0	9	0	0
2	174086492	rs16861363	C	T	6	4	10	0	0	10	0	0
2	174087309	rs6731949	G	A	15	13	28	0	0	28	0	0
2	174087310	rs6746658	T	A	15	13	28	0	0	28	0	0
2	174088266	rs10497402	G	A	17	8	25	0	0	25	0	0
2	174228744	rs1529887	T	C	37	25	62	0	0	62	0	0
2	174229122	rs11078	G	A	11	15	26	0	0	26	0	0
2	174229226	rs2288995	C	T	9	7	16	0	0	16	0	0
2	174776091	rs72911137	C	T	3	7	10	0	0	10	0	0
2	174776792	rs72911138	C	G	5	3	8	0	0	8	0	0
2	174777145	rs4494814	G	T	3	5	8	0	0	8	0	0
2	174781976	rs7580502	A	T	4	4	8	0	0	8	0	0
2	174785272	rs10190140	A	G	4	3	7	0	0	7	0	0
2	174787707	rs150553590	A	G	4	2	6	0	0	6	0	0
2	174794206	rs56063803	A	G	21	16	37	0	1	38	0	0
2	174794290	rs55664124	A	T	26	23	49	0	0	49	0	0
2	174795081	rs6733612	G	A	13	11	24	0	0	24	0	0
2	174798064	rs72911175	G	A	5	8	13	0	0	13	0	0
2	174819044	rs11683792	G	A	9	9	18	0	0	18	0	0
2	174937467	rs3739152	T	C	0	6	6	0	0	6	0	0
2	174939984	.	G	A	82	90	172	0	46	218	0	0
2	174965611	rs75107833	A	G	9	9	18	0	0	18	0	0
2	175426750	rs6732100	A	G	21	14	35	0	0	35	0	0
2	175434671	rs13391840	A	G	7	8	15	0	0	15	0	0
2	175435701	rs10165817	T	C	5	6	11	0	0	11	0	0
2	175436234	rs1044335	C	T	176	182	358	0	3	361	0	0
2	175442657	rs10182449	A	C	5	8	13	0	0	13	0	0
2	175443772	rs59865252	T	C	2	5	7	0	0	7	0	0
2	175445645	rs13412409	A	G	5	4	9	0	0	9	0	0
2	175948167	rs12998426	G	C	10	5	15	0	0	15	0	0
2	176789427	rs74954281	A	C	6	4	10	0	0	10	0	0
2	176789816	rs12477861	C	T	2	9	11	0	0	11	0	0
2	176790172	rs12477970	C	T	6	8	14	0	0	14	0	0
2	176790182	rs12469909	A	G	6	7	13	0	0	13	0	0
2	176791329	rs76606171	T	C	4	4	8	0	0	8	0	0
2	176791642	rs12621733	G	A	6	1	7	0	0	7	0	0
2	176791759	rs7571968	A	C	2	6	8	0	0	8	0	0
2	176792116	rs76675199	C	G	4	6	10	0	0	10	0	0
2	176792330	rs78714646	C	A	2	6	8	0	0	8	0	0
2	176792357	rs62186993	A	G	2	5	7	0	0	7	0	0
2	176793016	rs12622783	G	A	10	5	15	0	0	15	0	0
2	177195341	rs74492834	A	G	25	12	37	0	0	37	0	0
2	178078402	.	C	T	5	3	8	0	0	8	0	0
2	178097666	rs10183914	C	T	3	6	9	0	0	9	0	0
2	178099612	rs6433654	G	C	2	4	6	0	0	6	0	0
2	178103229	rs6726395	A	G	4	7	11	0	0	11	0	0
2	178116459	rs117263449	C	T	13	14	27	0	0	27	0	0
2	178118990	rs13001694	A	G	10	8	18	0	0	18	0	0
2	178119204	rs36030784	A	C	9	10	19	0	0	19	0	0
2	178121005	rs13028464	C	T	2	5	7	0	0	7	0	0
2	178121112	rs13005431	T	C	4	5	9	0	0	9	0	0
2	178121524	rs35284526	C	A	10	5	15	0	0	15	0	0
2	178121653	rs73976300	C	T	6	5	11	0	0	11	0	0
2	178122727	rs62173695	G	A	6	4	10	0	0	10	0	0
2	178125142	rs34468415	A	G	5	11	16	0	0	16	0	0
2	178125528	rs55940464	A	G	6	2	8	0	0	8	0	0
2	178125722	rs58493972	G	A	8	4	12	0	0	12	0	0
2	178126127	rs56718550	C	T	11	15	26	0	1	27	0	0
2	178127040	rs34551701	A	C	8	16	24	0	0	24	0	0
2	178128003	rs7564947	T	C	35	28	63	0	1	64	0	0
2	178128693	rs17524059	A	C	15	20	35	0	2	37	0	0
2	178130071	rs6706649	C	T	38	51	89	0	0	89	0	0
2	178329935	rs9789580	C	T	18	19	37	0	1	38	0	0
2	178330173	rs9789582	C	G	4	2	6	0	0	6	0	0
2	178331206	rs2084233	G	A	7	4	11	0	0	11	0	0
2	178331667	rs6719114	A	G	5	5	10	0	1	11	0	0
2	178406481	rs8941	C	T	12	10	22	0	0	22	0	0
2	178407176	rs10803912	C	A	9	8	17	0	1	18	0	0
2	178407897	rs2293475	T	C	15	9	24	0	0	24	0	0
2	179297824	rs6739142	A	G	3	7	10	0	0	10	0	0
2	179303976	rs10930831	G	C	5	2	7	0	0	7	0	0
2	179313682	rs13382684	G	C	4	6	10	0	1	11	0	0
2	179358665	rs2303536	A	G	44	39	83	0	1	84	0	0
2	179368916	rs3731754	C	G	23	24	47	0	0	47	0	0
2	179377280	rs8179648	G	A	3	4	7	0	0	7	0	0
2	179403593	rs2303539	G	A	8	9	17	0	0	17	0	0
2	179404786	rs2288325	A	T	3	7	10	0	0	10	0	0
2	179405885	rs3731751	T	C	6	2	8	0	0	8	0	0
2	179406003	rs3731750	C	A	2	4	6	0	0	6	0	0
2	179406191	rs3731749	C	T	5	6	11	0	0	11	0	0
2	180810180	rs6433817	C	T	24	22	46	0	1	47	0	0
2	180810202	rs1046356	C	T	20	19	39	0	0	39	0	0
2	180835792	rs3768837	T	A	15	9	24	0	0	24	0	0
2	181887458	rs79807622	A	C	4	3	7	0	0	7	0	0
2	181897419	rs57230918	C	A	9	4	13	0	0	13	0	0
2	181897869	rs62180159	G	C	36	22	58	0	0	58	0	0
2	181898087	rs6713336	T	C	37	22	59	0	0	59	0	0
2	181898629	rs113365767	T	C	32	15	47	0	0	47	0	0
2	181899324	rs62181560	A	G	4	11	15	0	0	15	0	0
2	181899325	rs10930948	G	A	4	11	15	0	0	15	0	0
2	181912401	rs62181571	C	T	2	4	6	0	0	6	0	0
2	181914897	rs7371259	A	G	2	4	6	0	0	6	0	0
2	181914941	rs4667041	A	G	2	4	6	0	0	6	0	0
2	181917754	rs62181573	A	G	5	2	7	0	0	7	0	0
2	181918896	rs7562697	A	G	2	6	8	0	0	8	0	0
2	181919490	rs10171998	G	C	5	8	13	0	0	13	0	0
2	181920129	rs56970984	C	G	6	7	13	0	1	14	0	0
2	181920762	rs78590213	T	G	3	5	8	0	0	8	0	0
2	181920763	rs79719017	T	C	3	5	8	0	0	8	0	0
2	181921417	rs62181575	G	A	6	10	16	0	0	16	0	0
2	181921679	rs7370006	C	A	1	5	6	0	0	6	0	0
2	181921999	rs7371639	A	G	3	3	6	0	0	6	0	0
2	181922014	rs7370048	G	A	4	2	6	0	0	6	0	0
2	181923066	rs62181577	G	A	3	5	8	0	0	8	0	0
2	182360182	rs2305586	T	C	3	3	6	0	0	6	0	0
2	182374534	rs1143674	A	G	45	53	98	0	0	98	0	0
2	182394145	rs3770104	C	T	6	7	13	0	0	13	0	0
2	182395345	rs1143676	G	A	86	86	172	0	1	173	0	0
2	182396032	rs6433921	T	G	5	3	8	0	0	8	0	0
2	182396054	rs6433922	C	T	3	3	6	0	0	6	0	0
2	182399097	rs7562325	T	C	101	75	176	0	0	176	0	0
2	182401752	rs1047307	G	A	156	117	273	0	2	275	0	0
2	182402790	rs6747500	G	A	14	24	38	0	0	38	0	0
2	183593697	rs288280	C	T	26	35	61	0	0	61	0	0
2	183622547	rs288334	T	G	52	36	88	0	0	88	0	0
2	183627504	rs192618	A	G	54	49	103	0	0	103	0	0
2	183642628	rs288283	C	T	28	18	46	0	0	46	0	0
2	183642878	rs13509	G	A	4	4	8	0	0	8	0	0
2	183643905	rs288241	A	T	5	1	6	0	0	6	0	0
2	183644191	rs288240	T	C	6	7	13	0	0	13	0	0
2	185463535	rs73041379	G	A	4	10	14	0	0	14	0	0
2	185479385	rs73041394	A	G	2	5	7	0	0	7	0	0
2	185480633	rs1427150	T	C	4	2	6	0	0	6	0	0
2	187364009	rs77291912	C	G	5	4	9	0	0	9	0	0
2	187543374	rs1839123	C	T	3	4	7	0	0	7	0	0
2	188408848	rs7594359	C	T	3	3	6	0	0	6	0	0
2	188420709	rs111484006	A	G	28	7	35	0	2	37	0	0
2	188420816	rs58412611	A	C	13	19	32	0	0	32	0	0
2	188421264	rs180800277	C	T	28	7	35	0	0	35	0	0
2	188422490	rs11898340	T	C	21	7	28	0	0	28	0	0
2	190323530	rs1157910	A	G	8	6	14	0	0	14	0	0
2	190430177	rs2304704	A	G	18	19	37	0	0	37	0	0
2	190445194	rs11568351	G	C	10	16	26	0	1	27	0	0
2	190445284	rs13008848	C	G	8	14	22	0	0	22	0	0
2	190526205	rs2289226	C	T	4	11	15	0	0	15	0	0
2	190526224	rs1132360	C	T	12	20	32	0	0	32	0	0
2	190636039	rs2289405	C	T	3	3	6	0	0	6	0	0
2	190636411	rs6942	C	G	102	64	166	0	1	167	0	0
2	190648757	.	G	A	6	8	14	0	0	14	0	0
2	190648805	rs5742926	G	T	7	4	11	0	0	11	0	0
2	190649316	rs5742933	G	C	3	12	15	0	0	15	0	0
2	190649582	rs1899025	C	T	4	2	6	0	0	6	0	0
2	191064753	rs6753459	C	T	3	4	7	0	0	7	0	0
2	191149069	rs3791800	A	C	4	2	6	0	0	6	0	0
2	191161622	rs1058180	T	C	2	5	7	0	0	7	0	0
2	191184475	rs291466	A	G	3	3	6	0	0	6	0	0
2	191224981	rs4656	G	T	6	7	13	0	0	13	0	0
2	191226742	rs2067416	A	G	1	5	6	0	0	6	0	0
2	191226886	rs2067417	A	G	1	8	9	0	0	9	0	0
2	191226932	rs2067418	T	C	2	6	8	0	0	8	0	0
2	191231503	rs4940	G	A	4	5	9	0	0	9	0	0
2	191301368	rs9646748	A	G	52	23	75	0	0	75	0	0
2	191301640	rs113040578	C	T	36	40	76	0	0	76	0	0
2	191320178	rs62181016	G	A	2	6	8	0	0	8	0	0
2	191366707	rs1128723	A	G	18	20	38	0	0	38	0	0
2	191379268	rs4586658	G	A	5	8	13	0	0	13	0	0
2	191756401	rs6758866	A	G	5	2	7	0	0	7	0	0
2	191759564	rs12990256	G	A	11	6	17	0	0	17	0	0
2	191763485	rs2108818	G	C	35	23	58	0	0	58	0	0
2	191763508	rs4597558	C	A	25	32	57	0	3	60	0	0
2	191765206	rs3771313	T	C	10	5	15	0	0	15	0	0
2	191770894	rs12998878	G	A	10	4	14	0	0	14	0	0
2	191777315	rs6743496	A	G	1	5	6	0	0	6	0	0
2	191780421	rs149783304	A	T	3	3	6	0	0	6	0	0
2	191804032	rs2883582	C	G	3	3	6	0	0	6	0	0
2	191824675	.	G	A	3	5	8	0	0	8	0	0
2	191825063	rs4853454	T	C	7	2	9	0	1	10	0	0
2	191825769	rs883844	T	C	5	1	6	0	0	6	0	0
2	191827011	rs11692579	G	C	8	6	14	0	0	14	0	0
2	191828203	.	A	T	3	4	7	0	0	7	0	0
2	191828205	rs1546647	C	A	5	4	9	0	0	9	0	0
2	191828596	rs1546646	A	G	3	5	8	0	0	8	0	0
2	191829412	rs3088307	C	G	3	10	13	0	0	13	0	0
2	191829777	rs1168	C	T	20	16	36	0	0	36	0	0
2	191830805	rs17748980	A	C	26	26	52	0	1	53	0	0
2	191832492	rs12693588	T	C	11	12	23	0	1	24	0	0
2	191832662	rs12693589	T	C	29	18	47	0	1	48	0	0
2	191835596	rs3771300	T	G	28	33	61	0	1	62	0	0
2	191836553	rs6711082	C	T	15	17	32	0	1	33	0	0
2	191836562	rs7562400	C	G	14	18	32	0	1	33	0	0
2	191836690	rs7565237	C	T	20	20	40	0	2	42	0	0
2	191836771	rs4853533	T	C	22	11	33	0	0	33	0	0
2	191837841	rs11894425	T	C	8	13	21	0	0	21	0	0
2	191838204	rs6718902	C	T	14	16	30	0	0	30	0	0
2	191838514	rs13395505	G	A	17	15	32	0	0	32	0	0
2	191839976	rs1914408	C	T	17	26	43	0	0	43	0	0
2	191843830	rs2280235	A	G	5	7	12	0	0	13	1	0
2	191875901	rs13029532	C	A	14	9	23	0	0	23	0	0
2	191878654	rs6745710	C	G	8	10	18	0	0	18	0	0
2	192554444	rs72908432	A	G	7	7	14	0	0	14	0	0
2	192556867	rs58788680	C	T	5	6	11	0	0	11	0	0
2	192560825	rs10192358	C	T	19	16	35	0	1	36	0	0
2	196522885	rs2486	C	T	7	6	13	0	0	13	0	0
2	196525404	rs7014	T	C	6	1	7	0	0	7	0	0
2	196536505	rs1866452	A	G	4	10	14	0	0	14	0	0
2	196536677	rs2375524	G	A	2	5	7	0	0	7	0	0
2	196536982	rs76563866	G	A	4	4	8	0	0	8	0	0
2	196614140	rs10931710	C	G	6	2	8	0	0	8	0	0
2	196998971	rs72919164	C	T	332	364	696	0	7	703	0	0
2	197005446	rs78252231	G	A	13	12	25	0	0	25	0	0
2	197012673	rs138097368	C	T	18	12	30	0	0	30	0	0
2	197108309	rs74264958	T	C	4	2	6	0	0	6	0	0
2	197134037	rs13004625	C	T	1	5	6	0	0	6	0	0
2	197853567	rs2256931	A	G	17	20	37	0	1	38	0	0
2	197855152	rs715185	T	C	10	2	12	0	0	12	0	0
2	198122900	rs2697287	T	C	6	6	12	0	0	12	0	0
2	198125341	.	G	C	25	11	36	0	0	36	0	0
2	198125499	.	T	C	13	8	21	0	0	21	0	0
2	198126163	rs1976965	A	C	15	2	17	0	0	17	0	0
2	198126737	rs2697286	G	A	13	6	19	0	0	19	0	0
2	198126797	rs2712873	A	G	18	6	24	0	0	24	0	0
2	198126979	rs12468436	C	T	10	7	17	0	1	18	0	0
2	198127129	rs2697285	G	A	9	2	11	0	0	11	0	0
2	198127399	rs2178202	G	A	10	2	12	0	0	12	0	0
2	198127968	rs2697282	T	C	3	4	7	0	0	7	0	0
2	198128280	rs16863762	A	G	6	0	6	0	0	6	0	0
2	198128894	rs2697278	T	C	6	5	11	0	0	11	0	0
2	198129143	rs2697277	T	A	4	4	8	0	0	8	0	0
2	198129160	rs2712870	T	C	4	3	7	0	0	7	0	0
2	198163527	rs7422899	G	C	9	1	10	0	0	10	0	0
2	198257795	rs4685	T	C	953	1004	1957	0	8	1965	0	0
2	198258388	rs3115366	G	A	16	7	23	0	0	23	0	0
2	198260098	rs2564389	A	T	31	26	57	0	0	57	0	0
2	198261596	rs56718086	A	G	10	8	18	0	0	18	0	0
2	198265173	rs788017	T	A	7	3	10	0	0	10	0	0
2	198265350	rs12621129	T	C	2	6	8	0	0	8	0	0
2	198265526	rs788018	A	G	848	851	1699	0	8	1707	0	0
2	198283305	rs788023	T	C	663	620	1283	0	6	1289	0	0
2	198285554	rs2565161	C	G	11	1	12	0	0	12	0	0
2	198352293	rs788016	G	A	8	7	15	0	0	15	0	0
2	198354414	rs2565163	T	C	23	16	39	0	0	39	0	0
2	198356065	rs2564384	T	C	30	30	60	0	1	61	0	0
2	198362018	rs8539	T	C	138	154	292	0	0	292	0	0
2	198365043	rs1116734	C	G	4	2	6	0	1	7	0	0
2	198401610	rs56067932	G	A	5	4	9	0	0	9	0	0
2	198409884	rs11680291	A	G	4	2	6	0	0	6	0	0
2	198411825	rs147603323	C	T	3	3	6	0	0	6	0	0
2	198413692	rs13418032	G	C	8	1	9	0	0	9	0	0
2	200776353	rs62178345	T	G	11	11	22	0	0	22	0	0
2	200795571	rs6435036	A	G	5	4	9	0	0	9	0	0
2	200823281	rs281767	C	A	4	7	11	0	0	11	0	0
2	200823474	rs7598665	C	A	2	4	6	0	0	6	0	0
2	200823523	rs76225625	C	T	4	2	6	0	0	6	0	0
2	200827421	rs16832106	A	G	5	4	9	0	0	9	0	0
2	200831863	rs10497843	C	G	6	3	9	0	0	9	0	0
2	200833967	rs144123512	C	T	3	3	6	0	1	7	0	0
2	201354676	rs16833578	A	G	47	34	81	0	0	81	0	0
2	201354935	rs3795969	C	G	39	38	77	0	0	77	0	0
2	201358423	rs11884301	C	T	2	5	7	0	0	7	0	0
2	201437214	rs17532679	A	G	4	3	7	0	0	7	0	0
2	201560605	rs2247030	T	G	39	1	40	0	0	40	0	0
2	201565970	rs2540054	A	G	0	13	13	0	0	13	0	0
2	201571143	rs2540051	G	A	0	9	9	0	0	9	0	0
2	201572564	rs2715892	A	T	0	10	10	0	0	10	0	0
2	201597253	rs2348115	G	C	2	12	14	0	0	14	0	0
2	201605500	rs10169230	G	T	0	15	15	0	0	15	0	0
2	201609120	rs10931918	A	G	0	14	14	0	0	14	0	0
2	201610584	rs2348121	T	C	2	16	18	0	0	18	0	0
2	201610645	rs13025464	T	C	1	7	8	0	0	8	0	0
2	201616355	rs4581881	G	C	1	13	14	0	0	14	0	0
2	201638647	rs12622452	A	G	0	10	10	0	0	10	0	0
2	201678985	rs6709748	T	C	5	8	13	0	0	13	0	0
2	201682395	rs11685853	G	A	4	5	9	0	0	9	0	0
2	201689544	rs183997345	G	A	24	13	37	0	0	37	0	0
2	201690994	rs17467616	A	T	14	11	25	0	0	25	0	0
2	201721134	rs13405189	G	A	45	43	88	0	1	89	0	0
2	201724360	rs12465952	A	G	70	82	152	0	0	152	0	0
2	201727773	rs12478395	C	T	77	86	163	0	1	164	0	0
2	202124502	rs6735656	G	T	3	5	8	0	0	8	0	0
2	202124997	rs6754084	T	C	2	4	6	0	0	6	0	0
2	202131587	rs2293554	T	G	10	6	16	0	0	16	0	0
2	202138400	rs7564683	G	T	9	9	18	0	1	19	0	0
2	202138458	rs7578639	T	C	18	13	31	0	1	32	0	0
2	202143491	rs60928755	G	C	12	14	26	0	0	26	0	0
2	202143928	rs10931936	T	C	27	20	47	0	0	47	0	0
2	202145359	rs13422553	C	T	46	25	71	0	1	72	0	0
2	202145612	rs10804111	C	T	34	19	53	0	0	53	0	0
2	202149696	rs1045487	G	A	142	273	415	0	7	422	0	0
2	202151163	rs3769818	A	G	5	18	23	0	1	24	0	0
2	202151439	rs3185378	G	C	117	195	312	0	0	313	1	0
2	202151746	rs17860433	A	G	126	66	192	0	1	193	0	0
2	202151781	rs1045494	T	C	64	132	196	0	3	199	0	0
2	202244458	rs11898629	C	T	6	2	8	0	0	8	0	0
2	202245244	rs3795966	A	G	33	22	55	0	0	55	0	0
2	202264156	rs13022344	C	T	22	23	45	0	0	45	0	0
2	202342402	rs12990557	G	T	47	35	82	0	0	82	0	0
2	202490812	rs73989521	C	A	3	5	8	0	0	8	0	0
2	202575821	rs3219168	G	A	6	4	10	0	0	10	0	0
2	202598113	rs2276615	C	T	6	5	11	0	0	11	0	0
2	203631359	rs11680951	G	A	17	17	34	0	0	34	0	0
2	203631445	rs60626957	T	C	21	21	42	0	0	42	0	0
2	203632510	rs11544338	T	C	11	11	22	0	0	22	0	0
2	203642155	rs62194158	G	A	7	2	9	0	0	9	0	0
2	203741362	rs72934740	A	T	4	3	7	0	1	8	0	0
2	203765756	rs35212307	T	C	17	14	31	0	0	31	0	0
2	203846817	rs72932557	A	T	3	4	7	0	0	7	0	0
2	203848402	rs72932561	G	A	5	2	7	0	0	7	0	0
2	203880992	rs2351524	T	C	7	6	13	0	0	13	0	0
2	204292517	rs2469954	T	C	5	5	10	0	0	10	0	0
2	204294322	.	A	C	5	11	16	0	0	16	0	0
2	204294412	rs2254175	A	G	8	2	10	0	0	10	0	0
2	204600625	rs3181112	A	G	3	3	6	0	0	6	0	0
2	205969220	rs2289025	G	A	6	7	13	0	0	13	0	0
2	206364737	rs10197347	T	C	7	3	10	0	0	10	0	0
2	206418600	rs10189250	A	G	3	4	7	0	0	7	0	0
2	206418631	rs10165586	C	T	3	6	9	0	1	10	0	0
2	206419018	rs35265460	G	A	2	4	6	0	0	6	0	0
2	206419749	rs6435289	C	T	2	5	7	0	0	7	0	0
2	206592695	rs849526	T	C	2	5	7	0	0	7	0	0
2	206871591	rs818021	C	T	4	6	10	0	1	11	0	0
2	207630338	rs3762567	C	T	5	1	6	0	0	6	0	0
2	207632952	rs2287630	G	A	6	6	12	0	1	13	0	0
2	207634236	rs2277912	T	G	6	0	6	0	0	6	0	0
2	207941837	rs79909292	T	A	29	26	55	0	0	55	0	0
2	207941850	rs1263599	C	T	23	27	50	0	0	50	0	0
2	207942792	rs190674132	G	A	38	25	63	0	0	63	0	0
2	207942894	rs6725221	C	G	30	28	58	0	1	59	0	0
2	207943774	rs67686520	G	A	40	28	68	0	2	70	0	0
2	207975206	rs17282699	T	C	6	2	8	0	0	8	0	0
2	207975253	rs34546415	C	G	7	4	11	0	0	11	0	0
2	207981258	rs12328563	C	T	9	7	16	0	0	16	0	0
2	207983805	rs10170608	A	G	16	14	30	0	0	30	0	0
2	207984651	rs2284936	C	T	16	14	30	0	0	30	0	0
2	207986063	rs2269078	T	A	20	26	46	0	0	46	0	0
2	207986933	rs10204517	G	A	44	35	79	0	0	79	0	0
2	207987739	rs2269076	C	T	8	14	22	0	1	23	0	0
2	208012509	rs2284932	G	A	13	13	26	0	0	26	0	0
2	208014310	rs72966214	T	C	4	2	6	0	0	6	0	0
2	208031796	rs2037893	C	G	3	3	6	0	0	6	0	0
2	208686410	rs12619380	C	T	22	12	34	0	0	34	0	0
2	208732554	rs10208193	T	A	17	17	34	0	0	34	0	0
2	208841133	rs4021953	A	G	8	5	13	0	0	13	0	0
2	208841964	rs4441448	A	G	23	27	50	0	0	50	0	0
2	208864224	rs13011597	A	G	6	2	8	0	0	8	0	0
2	208866073	.	G	A	24	41	65	0	0	65	0	0
2	208986637	rs2305430	T	C	0	7	7	0	1	8	0	0
2	209131796	rs17652774	T	C	3	5	8	0	0	8	0	0
2	209175972	rs116462142	A	G	6	5	11	0	0	11	0	0
2	209359062	rs1057392	T	C	6	0	6	0	0	6	0	0
2	210885022	rs7585265	C	T	4	7	11	0	0	11	0	0
2	216176807	rs4535042	T	G	9	3	12	0	0	12	0	0
2	216176824	rs28366035	C	T	12	14	26	0	0	26	0	0
2	216190020	rs2372536	C	G	42	52	94	0	1	95	0	0
2	216212339	rs4673993	T	C	8	6	14	0	0	14	0	0
2	216212614	rs11682496	T	C	5	4	9	0	0	9	0	0
2	217003152	rs2303400	T	C	6	6	12	0	0	12	0	0
2	217070766	rs2440	G	A	88	85	173	0	2	175	0	0
2	217322186	rs284557	G	A	5	4	9	0	0	9	0	0
2	217364452	rs284573	C	G	20	9	29	0	0	29	0	0
2	217368615	rs284540	C	T	6	3	9	0	1	10	0	0
2	218667836	rs3088214	G	A	5	3	8	0	0	8	0	0
2	218668732	rs1063281	C	T	7	4	11	0	0	11	0	0
2	218674697	rs918949	C	T	6	6	12	0	0	12	0	0
2	218683139	rs34291329	G	A	5	3	8	0	0	8	0	0
2	218683154	rs2571445	A	G	4	3	7	0	0	7	0	0
2	218683257	rs2571442	A	G	6	4	10	0	0	10	0	0
2	219106936	.	T	G	34	32	66	0	0	66	0	0
2	219146751	rs148148840	G	A	126	85	211	0	7	218	0	0
2	219146778	.	T	C	94	117	211	0	16	228	1	0
2	219259844	rs1059823	A	G	5	2	7	0	0	7	0	0
2	219260651	rs13062	C	A	1	5	6	0	0	6	0	0
2	219261176	rs2279014	C	T	4	9	13	0	0	13	0	0
2	219264107	rs2739049	G	A	7	3	10	0	0	10	0	0
2	219317248	rs3755042	T	C	9	14	23	0	0	23	0	0
2	219318078	rs4674310	T	C	2	5	7	0	0	7	0	0
2	219335935	rs659185	C	T	9	4	13	0	0	13	0	0
2	219335944	rs10200507	C	A	4	2	6	0	0	6	0	0
2	219390967	rs10179708	T	A	4	4	8	0	0	8	0	0
2	219427597	rs593888	A	G	4	3	7	0	0	7	0	0
2	219427625	rs566082	G	A	4	2	6	0	0	6	0	0
2	219432237	rs471846	C	T	4	2	6	0	0	6	0	0
2	219432953	rs500317	G	C	10	8	18	0	0	18	0	0
2	219432995	rs500422	C	A	8	8	16	0	0	16	0	0
2	219433597	rs526897	G	A	15	12	27	0	1	28	0	0
2	219434194	rs532425	A	G	5	2	7	0	0	7	0	0
2	219434208	rs532475	C	T	5	2	7	0	0	7	0	0
2	219435288	rs508157	G	A	6	1	7	0	0	7	0	0
2	219437476	rs522377	T	C	5	2	7	0	0	7	0	0
2	219437596	rs523937	G	C	4	5	9	0	0	9	0	0
2	219441603	rs486076	C	T	4	4	8	0	1	9	0	0
2	219442499	rs3755041	A	T	4	4	8	0	0	8	0	0
2	219443001	rs562510	A	C	3	3	6	0	0	6	0	0
2	219443717	rs3770216	A	G	3	4	7	0	0	7	0	0
2	219457731	rs10190250	C	T	22	23	45	0	0	45	0	0
2	219458656	rs538483	T	C	13	8	21	0	1	22	0	0
2	219459937	.	A	G	77	73	150	0	1	151	0	0
2	219501328	rs1055816	G	A	3	4	7	0	0	7	0	0
2	219508372	rs3770213	A	T	23	30	53	0	1	54	0	0
2	219508988	rs3770214	T	C	22	31	53	0	1	54	0	0
2	219509618	rs2230115	C	A	17	20	37	0	0	37	0	0
2	219513782	rs4674322	T	C	19	21	40	0	0	40	0	0
2	219523433	rs4674324	T	G	16	17	33	0	0	33	0	0
2	219555262	rs1344642	G	A	3	3	6	0	0	6	0	0
2	219562675	rs1863704	G	A	5	5	10	0	0	10	0	0
2	219602499	rs3731877	G	C	1	8	9	0	0	9	0	0
2	219602819	rs3731876	G	A	5	3	8	0	0	8	0	0
2	219610433	rs586194	A	G	7	6	13	0	1	14	0	0
2	219619550	rs3770220	C	T	2	5	7	0	0	7	0	0
2	219940484	rs359960	C	T	7	11	18	0	0	18	0	0
2	219941063	rs897477	G	A	13	4	17	0	0	17	0	0
2	220037097	rs11236	C	T	217	206	423	0	1	424	0	0
2	220037666	rs1127102	A	G	178	175	353	0	3	356	0	0
2	220037756	rs1043160	A	G	205	219	424	0	2	426	0	0
2	220039272	rs7593818	G	C	5	8	13	0	0	13	0	0
2	220040330	rs1127101	A	G	199	192	391	0	2	393	0	0
2	220041091	rs6436123	G	A	12	2	14	0	0	14	0	0
2	220046349	rs2272017	G	C	8	7	15	0	0	15	0	0
2	220046975	rs3731900	C	A	219	169	388	0	10	398	0	0
2	220047393	rs3731901	C	T	242	213	455	0	1	456	0	0
2	220048150	rs7017	C	T	313	255	568	0	0	568	0	0
2	220048721	rs12694453	A	G	40	35	75	0	0	75	0	0
2	220048796	rs34157145	C	T	41	44	85	0	0	85	0	0
2	220048907	rs10932798	A	G	61	58	119	0	1	120	0	0
2	220049128	rs2385395	G	T	66	20	86	0	1	87	0	0
2	220049290	rs2385394	C	T	75	47	122	0	1	123	0	0
2	220049511	rs2385392	T	C	46	14	60	0	3	63	0	0
2	220072852	rs4674367	C	T	5	3	8	0	0	8	0	0
2	220084469	rs3731885	G	A	57	32	89	0	1	90	0	0
2	220084864	rs3755047	G	A	72	71	143	0	1	144	0	0
2	220084902	rs3755048	G	A	79	67	146	0	1	147	0	0
2	220085845	rs2276633	A	G	35	65	100	0	1	101	0	0
2	220086280	rs9989854	C	T	5	8	13	0	0	13	0	0
2	220089685	rs2276637	G	C	4	4	8	0	0	8	0	0
2	220097257	rs61747682	G	C	22	21	43	0	0	43	0	0
2	220099331	rs7574937	C	T	7	6	13	0	1	14	0	0
2	220108300	rs11552796	T	C	0	6	6	0	0	6	0	0
2	220110255	rs3755052	C	G	9	2	11	0	0	11	0	0
2	220112765	rs56019765	G	A	1	6	7	0	0	7	0	0
2	220113384	rs8447	G	A	46	35	81	0	0	81	0	0
2	220113683	rs3731887	A	T	10	8	18	0	0	18	0	0
2	220116509	rs45488900	G	T	3	6	9	0	0	9	0	0
2	220146064	rs6730173	C	G	3	5	8	0	0	8	0	0
2	220147847	rs3821039	G	A	8	1	9	0	0	9	0	0
2	220371035	rs1046474	C	G	21	21	42	0	0	42	0	0
2	220470710	rs149218768	G	A	45	36	81	0	0	81	0	0
2	223493435	rs2019357	G	A	4	2	6	0	0	6	0	0
2	223510927	rs1868026	G	C	4	3	7	0	1	8	0	0
2	223511668	rs12474777	G	A	12	5	17	0	0	17	0	0
2	223520797	rs12467164	T	G	6	3	9	0	0	9	0	0
2	223765491	rs2119160	C	T	11	12	23	0	0	23	0	0
2	223773523	rs146044900	C	T	18	21	39	0	1	40	0	0
2	223781474	rs76033111	G	A	18	19	37	0	1	38	0	0
2	223796662	rs140185115	G	A	9	3	12	0	0	12	0	0
2	223797166	rs146872605	C	T	3	7	10	0	0	10	0	0
2	223803886	rs77518884	A	G	6	3	9	0	0	9	0	0
2	223804445	rs75548885	C	T	4	3	7	0	0	7	0	0
2	223804829	rs12694586	A	C	4	4	8	0	0	8	0	0
2	223805478	rs370354752	C	T	4	3	7	0	0	7	0	0
2	223805594	rs148734576	C	G	3	5	8	0	1	9	0	0
2	223805974	rs1014280	A	G	1	5	6	0	0	6	0	0
2	224682759	rs10180900	G	A	9	13	22	0	0	22	0	0
2	224682861	rs10180835	C	T	20	33	53	0	0	53	0	0
2	224683153	rs62185132	G	A	9	9	18	0	0	18	0	0
2	224741210	rs13022532	G	C	266	255	521	0	1	523	1	0
2	224743373	rs571111	C	T	216	208	424	0	5	430	1	0
2	224745552	rs1318970	G	C	9	8	17	0	0	17	0	0
2	224745701	rs486593	A	C	12	9	21	0	0	21	0	0
2	224747784	rs12997341	T	G	5	4	9	0	0	9	0	0
2	224864185	rs13392268	G	A	5	6	11	0	0	11	0	0
2	224864256	rs13392374	G	A	8	6	14	0	1	15	0	0
2	224864350	rs13392495	G	A	7	4	11	0	0	11	0	0
2	224864508	rs13392722	G	C	3	9	12	0	0	12	0	0
2	224865006	rs10177151	G	C	6	8	14	0	0	14	0	0
2	224865065	rs10189547	T	C	3	7	10	0	0	10	0	0
2	224865817	rs10203588	A	C	3	3	6	0	0	6	0	0
2	224866177	rs3795877	A	G	3	3	6	0	0	6	0	0
2	224866427	rs34078713	A	G	5	4	9	0	0	9	0	0
2	225264547	rs16865947	T	C	3	5	8	0	0	8	0	0
2	225630233	rs1045654	C	T	38	29	67	0	0	67	0	0
2	225630435	rs1045653	C	T	48	59	107	0	1	108	0	0
2	225631260	rs3768869	A	G	10	7	17	0	0	17	0	0
2	225631486	rs3768870	A	C	7	8	15	0	0	15	0	0
2	225631874	rs10181850	A	C	4	6	10	0	0	10	0	0
2	225633209	rs3754623	G	T	7	6	13	0	0	13	0	0
2	225633812	rs3754624	T	C	17	6	23	0	0	23	0	0
2	225634693	rs1565073	T	G	12	8	20	0	0	20	0	0
2	225655883	rs3768882	C	T	1	6	7	0	0	7	0	0
2	225676646	rs201429923	G	A	23	8	31	0	0	31	0	0
2	225717807	.	G	T	21	25	46	0	0	46	0	0
2	225787050	rs62187985	C	G	2	5	7	0	0	7	0	0
2	225811581	rs13021295	T	A	12	17	29	0	1	30	0	0
2	225826368	rs77363337	C	A	2	4	6	0	0	6	0	0
2	227729328	rs191381349	G	A	2	6	8	0	0	8	0	0
2	227860671	rs10933164	G	A	7	9	16	0	0	16	0	0
2	228189985	rs28365988	C	A	2	5	7	0	0	7	0	0
2	228190002	rs7562498	C	G	6	3	9	0	0	9	0	0
2	228212798	rs56022659	G	C	4	4	8	0	0	8	0	0
2	228212952	rs11892173	T	A	5	1	6	0	0	6	0	0
2	228216616	rs73994254	G	A	6	8	14	0	0	14	0	0
2	228220161	rs58426936	C	T	4	8	12	0	0	12	0	0
2	228221725	rs4844	A	G	175	174	349	0	1	350	0	0
2	228222000	.	G	C	117	0	117	0	2	119	0	0
2	228222293	rs8222	C	G	35	40	75	0	1	76	0	0
2	228420193	rs4402755	A	T	5	7	12	0	0	12	0	0
2	230634948	rs13015202	G	A	4	4	8	0	0	8	0	0
2	230637272	rs7565780	T	C	8	6	14	0	1	15	0	0
2	230658429	rs13003437	C	G	11	11	22	0	1	23	0	0
2	230668858	rs13018957	T	C	43	62	105	0	0	105	0	0
2	230708296	rs549193	A	G	6	0	6	0	1	7	0	0
2	230709198	rs1035833	A	G	5	4	9	0	0	9	0	0
2	230710248	rs34834962	G	C	3	5	8	0	0	8	0	0
2	230723057	rs59234368	C	T	13	7	20	0	0	20	0	0
2	230861519	rs1035834	G	T	4	5	9	0	0	9	0	0
2	231030733	rs1137605	T	C	2	4	6	0	0	6	0	0
2	231031376	rs13026121	A	G	1	6	7	0	0	7	0	0
2	231031467	rs13026878	G	C	4	8	12	0	0	12	0	0
2	231032048	rs4973278	C	G	2	5	7	0	0	7	0	0
2	231032372	rs10210254	A	G	5	3	8	0	1	9	0	0
2	231036860	rs3948463	C	T	4	2	6	0	0	6	0	0
2	231037616	rs35495464	A	G	5	1	6	0	0	6	0	0
2	231072709	rs1365776	C	T	30	36	66	0	1	67	0	0
2	231077112	rs28930679	G	A	31	40	71	0	0	71	0	0
2	231241932	rs143048294	C	T	7	1	8	0	0	8	0	0
2	231304526	rs73000239	T	C	3	5	8	0	0	8	0	0
2	231307584	rs17333189	C	T	2	4	6	0	0	6	0	0
2	231312140	rs1156156	G	A	9	4	13	0	0	13	0	0
2	231312555	rs73000253	C	T	1	10	11	0	0	11	0	0
2	231320835	rs10933337	T	A	3	3	6	0	0	6	0	0
2	231322831	rs112983309	G	T	6	3	9	0	0	9	0	0
2	231326188	rs11692640	A	G	3	3	6	0	0	6	0	0
2	231326201	rs11681514	C	G	3	3	6	0	0	6	0	0
2	231327622	rs17333482	G	C	4	6	10	0	0	10	0	0
2	231327688	rs73000277	G	A	7	5	12	0	0	12	0	0
2	231327856	rs17333503	C	T	9	12	21	0	0	21	0	0
2	231328078	rs1649864	A	G	6	2	8	0	0	8	0	0
2	231328412	rs1678200	C	G	28	33	61	0	0	61	0	0
2	231328426	rs1678201	G	C	30	34	64	0	0	64	0	0
2	231328580	rs1678202	T	G	22	35	57	0	0	57	0	0
2	231328696	rs2306274	C	T	18	15	33	0	0	33	0	0
2	231328720	rs2306275	C	T	18	11	29	0	0	29	0	0
2	231328728	rs2306276	C	T	16	9	25	0	2	27	0	0
2	231329050	rs1678203	G	A	11	5	16	0	0	16	0	0
2	231329517	rs1649866	G	A	3	11	14	0	0	14	0	0
2	231329637	rs1678204	C	T	5	5	10	0	0	10	0	0
2	231329720	rs6436938	G	A	4	10	14	0	0	14	0	0
2	231329857	rs2559088	C	A	1	10	11	0	0	11	0	0
2	231329893	rs2619158	G	T	2	8	10	0	0	10	0	0
2	231329908	rs2619159	A	G	2	8	10	0	0	10	0	0
2	231329971	rs6739283	A	C	2	7	9	0	0	9	0	0
2	231330446	rs1613630	C	T	5	11	16	0	0	16	0	0
2	231330520	rs1649867	A	G	4	9	13	0	0	13	0	0
2	231330538	rs1278	C	T	8	9	17	0	0	17	0	0
2	231330826	rs113262860	G	A	3	7	10	0	1	11	0	0
2	231331706	rs2303609	C	T	19	23	42	0	0	42	0	0
2	231332218	rs1621973	G	T	5	7	12	0	0	12	0	0
2	231332279	rs149021784	G	C	6	6	12	0	0	12	0	0
2	231332405	rs2434048	A	G	1	5	6	0	0	6	0	0
2	231332809	rs1564322	T	C	9	7	16	0	0	16	0	0
2	231332907	rs1564323	G	A	11	4	15	0	0	15	0	0
2	231333257	rs12617536	C	T	8	7	15	0	0	15	0	0
2	231333416	rs62193415	C	T	16	12	28	0	0	28	0	0
2	231333505	rs1649871	C	T	3	6	9	0	0	9	0	0
2	231333509	rs1649872	G	A	3	6	9	0	0	9	0	0
2	231333763	rs12724	A	G	230	232	462	0	2	464	0	0
2	231334216	rs1051579	T	C	6	5	11	0	0	11	0	0
2	231334299	rs1051580	G	A	7	6	13	0	0	13	0	0
2	231334421	rs1051581	A	C	3	6	9	0	0	9	0	0
2	231334679	rs1678162	A	G	2	4	6	0	0	6	0	0
2	231335159	rs7878	A	G	7	8	15	0	1	16	0	0
2	231371758	rs7601665	G	A	5	7	12	0	0	12	0	0
2	231395989	rs4973327	A	G	5	3	8	0	0	8	0	0
2	231406070	rs17275036	G	A	8	12	20	0	0	20	0	0
2	231407663	rs9288668	C	T	9	6	15	0	0	15	0	0
2	231579273	rs2459925	A	G	6	4	10	0	0	10	0	0
2	231678185	rs2244954	A	C	3	5	8	0	0	8	0	0
2	231683932	.	G	T	58	60	118	0	0	118	0	0
2	231731975	rs934822	G	A	4	6	10	0	0	10	0	0
2	231732132	rs934824	G	C	7	0	7	0	0	7	0	0
2	231732186	rs3111757	T	A	4	5	9	0	0	9	0	0
2	231732197	rs3111756	G	A	3	5	8	0	0	8	0	0
2	231732511	rs2918011	A	T	3	5	8	0	0	8	0	0
2	231732514	rs2918012	A	C	3	5	8	0	0	8	0	0
2	231733703	rs3111754	T	C	3	5	8	0	0	8	0	0
2	231734414	rs3111753	G	A	6	1	7	0	0	7	0	0
2	231734580	rs77199945	G	A	9	1	10	0	0	10	0	0
2	231734799	rs3098331	A	G	6	7	13	0	0	13	0	0
2	231734997	rs3098332	A	G	2	7	9	0	0	9	0	0
2	231735410	rs115865011	C	T	5	6	11	0	1	12	0	0
2	231735596	rs3098333	C	T	2	6	8	0	0	8	0	0
2	231736107	rs3111751	G	A	3	3	6	0	0	6	0	0
2	231736156	rs3098334	C	T	3	3	6	0	0	6	0	0
2	231736641	rs1866230	C	T	5	2	7	0	0	7	0	0
2	231736890	rs72995296	G	A	7	5	12	0	0	12	0	0
2	231737798	rs4972973	G	A	7	2	9	0	0	9	0	0
2	231738168	rs2289235	G	A	413	502	915	0	7	922	0	0
2	231738263	rs2289234	C	T	616	788	1404	0	7	1411	0	0
2	231738269	rs2289233	G	A	602	748	1350	0	7	1358	1	0
2	231738318	rs3816150	T	C	7	3	10	0	0	10	0	0
2	231738466	rs6436977	A	C	4	3	7	0	0	7	0	0
2	231738509	rs3098336	C	G	2	6	8	0	0	8	0	0
2	231948178	rs906879	A	G	3	6	9	0	0	9	0	0
2	232030861	rs2303349	A	G	11	7	18	0	0	18	0	0
2	232033474	rs147373408	A	G	17	12	29	0	0	29	0	0
2	232034342	rs1025107	C	T	23	13	36	0	1	37	0	0
2	232035429	rs6749	G	A	56	78	134	0	2	136	0	0
2	232035793	rs2032953	C	T	30	15	45	0	1	46	0	0
2	232036396	rs12463656	G	A	14	15	29	0	0	29	0	0
2	232036843	rs12468767	T	G	17	28	45	0	0	45	0	0
2	232319572	.	C	A	151	144	295	0	33	328	0	0
2	232321956	rs7598759	C	T	50	48	98	0	0	98	0	0
2	232322779	rs6754426	G	A	40	44	84	0	0	84	0	0
2	232322829	rs6712148	T	C	40	42	82	0	1	83	0	0
2	232389529	rs3752760	C	G	7	3	10	0	0	10	0	0
2	232389530	rs3752761	A	G	6	2	8	0	2	10	0	0
2	232389744	rs3752762	A	G	7	3	10	0	0	10	0	0
2	232574504	rs2060412	C	T	26	37	63	0	1	64	0	0
2	232576431	rs2070936	T	C	80	96	176	0	1	177	0	0
2	232597475	rs8165	T	C	19	15	34	0	0	34	0	0
2	232657746	rs6721685	A	G	6	2	8	0	0	8	0	0
2	232667656	rs62198575	C	G	4	3	7	0	0	7	0	0
2	232999580	rs3116172	C	T	5	7	12	0	0	12	0	0
2	233000699	rs3103258	G	A	4	4	8	0	0	8	0	0
2	233124685	rs2633264	T	C	4	2	6	0	0	6	0	0
2	233181344	rs6743962	G	C	4	4	8	0	0	8	0	0
2	233412820	rs4973539	A	G	10	3	13	0	0	13	0	0
2	233413648	rs72991949	G	A	8	11	19	0	0	19	0	0
2	233414660	rs4973541	G	A	7	11	18	0	0	18	0	0
2	233414721	rs11683262	C	T	4	9	13	0	0	13	0	0
2	233414832	rs11689217	T	G	1	6	7	0	0	7	0	0
2	233424891	rs1729245	G	A	3	4	7	0	0	7	0	0
2	233428242	rs1550098	A	G	2	5	7	0	0	7	0	0
2	233428385	rs1550096	C	T	4	5	9	0	0	9	0	0
2	233429424	rs1729256	A	G	6	7	13	0	0	13	0	0
2	233432633	rs3791712	A	T	22	24	46	0	0	46	0	0
2	233432883	rs3791711	A	G	20	17	37	0	0	37	0	0
2	233446568	rs17296210	G	A	17	17	34	0	0	34	0	0
2	233446821	rs6437068	A	G	11	12	23	0	0	23	0	0
2	233599904	rs11555646	A	C	11	23	34	0	0	34	0	0
2	233600606	rs13013142	A	G	10	6	16	0	1	17	0	0
2	233602028	rs6738386	T	C	2	4	6	0	0	6	0	0
2	233602293	rs66549961	A	G	12	6	18	0	0	18	0	0
2	233603065	rs2344613	C	G	4	3	7	0	1	8	0	0
2	233681512	rs1078323	T	G	21	13	34	0	1	35	0	0
2	233683245	rs1446310	G	C	2	6	8	0	0	8	0	0
2	233683984	rs13001052	C	T	4	3	7	0	0	7	0	0
2	233708806	rs3816334	A	G	36	25	61	0	1	62	0	0
2	233710713	rs4973054	G	C	1	5	6	0	0	6	0	0
2	233711046	rs991873	A	G	2	6	8	0	0	8	0	0
2	233712296	rs6437074	G	A	6	1	7	0	0	7	0	0
2	233721455	rs1947105	G	A	7	3	10	0	0	10	0	0
2	233723182	rs1284	G	A	22	28	50	0	3	53	0	0
2	233724536	rs7589201	A	G	6	4	10	0	0	10	0	0
2	233724716	.	T	C	5	1	6	0	0	6	0	0
2	233953940	rs7566856	G	A	5	3	8	0	0	8	0	0
2	233957253	rs6756729	A	T	6	2	8	0	0	8	0	0
2	233957372	rs10933428	T	C	4	3	7	0	0	7	0	0
2	233997899	rs11681000	C	T	3	3	6	0	0	6	0	0
2	233997982	rs10933433	C	G	5	1	6	0	0	6	0	0
2	234001105	rs11677508	C	T	2	4	6	0	0	6	0	0
2	234054873	rs1135173	G	A	106	87	193	0	0	193	0	0
2	234067785	rs36164374	G	A	2	4	6	0	0	6	0	0
2	234068068	rs67498812	A	G	6	0	6	0	0	6	0	0
2	234068192	rs75322627	T	A	4	2	6	0	1	7	0	0
2	234068705	rs28669088	C	T	5	7	12	0	0	12	0	0
2	234069266	rs28534487	C	A	12	7	19	0	0	19	0	0
2	234069323	rs28655385	C	A	33	15	48	0	0	48	0	0
2	234069324	.	G	A	17	32	49	0	0	49	0	0
2	234069512	rs28459768	A	C	21	10	31	0	0	31	0	0
2	234069764	rs28478933	C	A	10	15	25	0	0	25	0	0
2	234069811	rs28429042	C	T	8	19	27	0	0	27	0	0
2	234069980	rs28631646	C	T	17	13	30	0	0	30	0	0
2	234070042	rs28539971	G	A	23	9	32	0	0	32	0	0
2	234070085	rs35877172	C	T	21	13	34	0	0	34	0	0
2	234070171	rs28605534	G	C	21	23	44	0	1	45	0	0
2	234070190	rs28609111	G	A	19	15	34	0	3	37	0	0
2	234070233	rs28576692	T	C	24	25	49	0	0	49	0	0
2	234078582	rs10754947	G	A	30	41	71	0	0	71	0	0
2	234110974	rs6761018	A	C	10	14	24	0	1	25	0	0
2	234160345	rs2289477	T	G	9	9	18	0	0	18	0	0
2	234167421	rs6431661	C	T	1	5	6	0	0	6	0	0
2	234171812	rs13011156	A	G	43	36	79	0	0	80	1	0
2	234181848	rs2289474	C	T	3	5	8	0	0	8	0	0
2	234182240	rs2289472	C	T	7	2	9	0	0	9	0	0
2	234183368	rs2241880	A	G	40	56	96	0	0	96	0	0
2	234194957	rs13005285	T	G	3	3	6	0	0	6	0	0
2	234197717	rs4663136	C	G	2	4	6	0	0	6	0	0
2	234198852	rs55754152	T	A	12	8	20	0	0	20	0	0
2	234199401	rs11890449	C	T	11	7	18	0	0	18	0	0
2	234199537	rs6431262	G	T	6	13	19	0	0	19	0	0
2	234200999	rs56242862	T	A	4	2	6	0	0	6	0	0
2	234201657	rs11679064	A	G	12	9	21	0	1	22	0	0
2	234202190	rs11890330	T	C	14	19	33	0	0	33	0	0
2	234202321	rs3749079	C	T	11	21	32	0	1	33	0	0
2	234202766	rs6748547	G	A	11	12	23	0	0	23	0	0
2	234203543	rs72976353	T	C	91	103	194	0	2	196	0	0
2	234203547	rs1045095	T	C	90	101	191	0	1	192	0	0
2	234203740	rs11682236	A	G	74	86	160	0	1	161	0	0
2	234203876	rs10803619	C	T	98	97	195	0	0	195	0	0
2	234204113	rs6861	T	C	66	97	163	0	0	163	0	0
2	234265403	rs55693723	T	C	6	6	12	0	0	12	0	0
2	234265805	rs72978363	C	T	6	4	10	0	0	10	0	0
2	234267565	rs55684040	A	G	4	3	7	0	0	7	0	0
2	234280729	rs10153744	A	G	4	5	9	0	0	9	0	0
2	234282210	rs6722763	A	G	4	3	7	0	0	7	0	0
2	234354245	rs2305542	G	A	17	4	21	0	0	21	0	0
2	234364824	.	A	G	4	6	10	0	1	11	0	0
2	234372429	rs2971856	G	A	15	9	24	0	1	25	0	0
2	234372985	rs2242098	A	C	7	2	9	0	0	9	0	0
2	234373702	rs3768801	G	A	2	5	7	0	0	7	0	0
2	234373870	rs2085128	G	A	2	4	6	0	0	6	0	0
2	234378902	rs1053895	T	C	125	118	243	0	2	245	0	0
2	234380123	rs882428	A	G	198	143	341	0	1	342	0	0
2	234380666	rs2026	C	T	66	50	116	0	2	118	0	0
2	234394487	rs1048603	G	A	4	6	10	0	0	10	0	0
2	234396566	rs10929178	G	C	2	4	6	0	0	6	0	0
2	234749258	rs10511	T	C	5	8	13	0	0	13	0	0
2	234749354	rs12582	G	A	8	9	17	0	0	17	0	0
2	234749780	rs3821238	G	C	8	6	14	0	0	14	0	0
2	235402656	rs10194289	G	T	94	83	177	0	1	178	0	0
2	235402779	.	T	A	100	65	165	0	1	166	0	0
2	235403796	.	T	A	66	29	95	0	5	100	0	0
2	235403797	.	A	T	57	39	96	0	4	100	0	0
2	235403987	rs8245	C	G	177	142	319	0	4	323	0	0
2	237996889	rs72973998	A	G	2	10	12	0	0	12	0	0
2	238483164	rs6766	T	C	46	72	118	0	0	118	0	0
2	238483262	rs75158612	G	A	50	101	151	0	0	151	0	0
2	238483331	rs8184	G	C	53	105	158	0	0	158	0	0
2	238483475	rs2280288	T	C	33	99	132	0	0	132	0	0
2	238483671	rs59945834	G	A	26	68	94	0	1	95	0	0
2	238483729	rs2280289	A	G	36	58	94	0	0	94	0	0
2	238484190	rs78478325	T	C	16	38	54	0	1	55	0	0
2	238484222	rs10202062	G	A	19	41	60	0	0	60	0	0
2	238484344	rs13414095	T	G	16	33	49	0	0	49	0	0
2	238484662	rs59848818	G	C	23	50	73	0	0	73	0	0
2	238484874	rs74800521	C	T	21	39	60	0	0	60	0	0
2	238485713	rs12478282	G	A	9	73	82	0	2	84	0	0
2	238487353	rs6746529	G	C	5	4	9	0	0	9	0	0
2	238487850	rs59044255	A	G	2	10	12	0	1	13	0	0
2	238488890	rs60550867	C	T	2	8	10	0	0	10	0	0
2	238491258	rs13404216	C	A	6	7	13	0	0	13	0	0
2	238493666	rs12465265	G	A	4	4	8	0	0	8	0	0
2	238494448	rs3829285	T	C	2	8	10	0	1	11	0	0
2	238494742	rs3751112	A	G	4	3	7	0	0	7	0	0
2	238498545	rs9287621	A	G	4	4	8	0	0	8	0	0
2	238498561	rs9287622	G	C	4	5	9	0	0	9	0	0
2	238499318	rs2292875	A	G	14	42	56	0	1	57	0	0
2	238499319	rs57423896	T	C	15	42	57	0	0	57	0	0
2	238499534	rs2292872	C	T	22	60	82	0	1	83	0	0
2	238499690	rs2292871	A	G	21	64	85	0	0	85	0	0
2	238499782	rs79820740	C	T	18	36	54	0	7	62	1	0
2	238499866	.	C	T	16	29	45	0	0	45	0	0
2	238499997	rs6745883	T	C	16	32	48	0	1	49	0	0
2	238499998	rs6742869	A	G	17	32	49	0	0	49	0	0
2	238500046	rs6742960	A	G	17	22	39	0	0	39	0	0
2	238500211	rs6431548	C	T	12	11	23	0	1	24	0	0
2	238536246	rs28364855	C	T	5	6	11	0	0	11	0	0
2	238536820	rs11677667	C	T	4	3	7	0	0	7	0	0
2	238536987	rs11683452	A	G	5	1	6	0	0	6	0	0
2	238537311	rs6431550	T	C	6	0	6	0	0	6	0	0
2	238539515	rs11681146	C	T	2	5	7	0	0	7	0	0
2	238541766	rs6754972	C	T	6	2	8	0	0	8	0	0
2	238541792	rs72991724	C	T	6	2	8	0	0	8	0	0
2	238546572	rs12052937	C	T	4	3	7	0	0	7	0	0
2	238546938	rs1817894	G	A	4	2	6	0	0	6	0	0
2	238547518	rs1038989	A	G	5	6	11	0	0	11	0	0
2	238549745	rs6708497	C	A	4	2	6	0	0	6	0	0
2	238549997	rs6736671	G	A	3	4	7	0	0	7	0	0
2	238550072	rs6723786	A	G	5	1	6	0	0	6	0	0
2	238554451	rs3795906	A	T	94	122	216	0	1	217	0	0
2	238554551	rs3820819	G	A	99	141	240	0	3	243	0	0
2	238554657	rs7595246	T	C	100	163	263	0	1	264	0	0
2	238554999	rs7595625	T	A	29	17	46	0	0	46	0	0
2	238555316	rs10803659	T	C	35	25	60	0	0	60	0	0
2	238555352	rs6757425	G	A	35	20	55	0	0	55	0	0
2	238555898	rs4663774	T	C	8	7	15	0	0	15	0	0
2	238556095	rs7596620	A	G	11	1	12	0	0	12	0	0
2	238559117	rs10211234	C	T	7	5	12	0	0	12	0	0
2	238559382	rs7558097	T	C	10	7	17	0	1	18	0	0
2	238559580	rs7603218	G	T	13	8	21	0	0	21	0	0
2	238561083	rs2029771	A	C	9	1	10	0	0	10	0	0
2	238561249	rs2029770	A	G	7	3	10	0	1	11	0	0
2	238561551	rs4663775	G	T	10	5	15	0	0	15	0	0
2	238564463	rs12614428	A	G	5	2	7	0	1	8	0	0
2	238582301	rs6725051	G	T	5	1	6	0	0	6	0	0
2	238646789	rs149377574	T	A	8	6	14	0	1	15	0	0
2	238649173	rs55948570	C	T	11	8	19	0	0	19	0	0
2	238651706	rs2279647	C	T	5	9	14	0	0	14	0	0
2	238655484	rs3754717	G	A	5	3	8	0	0	8	0	0
2	238656212	rs3754713	A	C	2	6	8	0	0	8	0	0
2	238660580	rs3820807	G	A	2	4	6	0	0	6	0	0
2	238663466	rs3754708	A	T	3	3	6	0	0	6	0	0
2	238663471	rs3754707	T	G	3	3	6	0	0	6	0	0
2	238663503	rs3754706	C	T	3	3	6	0	0	6	0	0
2	238664010	rs3769058	G	A	4	5	9	0	0	9	0	0
2	238664090	rs56258701	G	T	7	0	7	0	0	7	0	0
2	238664125	rs3769057	A	G	6	0	6	0	1	7	0	0
2	238664246	rs3820806	A	G	5	3	8	0	0	8	0	0
2	238664446	rs11678499	A	G	5	7	12	0	0	12	0	0
2	238665103	rs4663786	A	G	7	4	11	0	0	11	0	0
2	238666716	rs62194225	G	A	4	11	15	0	0	15	0	0
2	238668802	rs3213868	A	G	244	218	462	0	3	465	0	0
2	238669150	rs56230769	G	C	41	35	76	0	0	76	0	0
2	238669484	rs56001807	T	C	36	41	77	0	2	79	0	0
2	238670016	rs12613148	G	A	19	34	53	0	0	53	0	0
2	238671117	rs734388	A	G	50	50	100	0	0	100	0	0
2	238671328	rs868119	A	G	249	217	466	0	2	468	0	0
2	238672703	rs3739038	C	G	354	266	620	0	3	623	0	0
2	238674791	rs56074707	T	C	14	18	32	0	0	32	0	0
2	238675892	rs10179864	A	G	7	13	20	0	0	20	0	0
2	238676722	rs3820818	C	T	18	13	31	0	0	31	0	0
2	238677841	rs55663452	C	T	32	43	75	0	0	75	0	0
2	238678001	rs76248225	T	G	39	37	76	0	0	76	0	0
2	238678002	rs76642509	C	G	39	37	76	0	0	76	0	0
2	238678004	rs75319932	A	G	39	37	76	0	0	76	0	0
2	238678875	rs6719679	A	G	6	6	12	0	0	12	0	0
2	238680058	rs59473571	G	A	8	8	16	0	0	16	0	0
2	238680442	rs2289094	T	C	7	8	15	0	0	15	0	0
2	238681123	.	C	T	4	2	6	0	0	6	0	0
2	238682752	rs2279641	A	G	3	9	12	0	0	12	0	0
2	238682770	rs2279642	C	T	4	7	11	0	0	11	0	0
2	238683358	rs2279645	G	A	4	3	7	0	0	7	0	0
2	238683370	rs2279646	A	G	4	2	6	0	1	7	0	0
2	238684791	rs13398895	C	T	3	4	7	0	0	7	0	0
2	238685395	rs61084569	G	C	5	4	9	0	0	9	0	0
2	238687893	rs60023357	G	A	5	4	9	0	0	9	0	0
2	238688275	rs2117363	C	T	54	56	110	0	0	110	0	0
2	238688305	rs2117364	C	T	48	48	96	0	1	97	0	0
2	238689369	rs6739130	A	G	7	5	12	0	0	12	0	0
2	238689405	rs55824227	G	A	5	5	10	0	0	10	0	0
2	238689431	rs6742292	T	C	4	4	8	0	0	8	0	0
2	238690424	rs13411625	A	T	7	9	16	0	0	16	0	0
2	238691122	rs56295728	A	G	6	5	11	0	0	11	0	0
2	238691602	rs55795029	T	A	8	4	12	0	0	12	0	0
2	238691917	rs55926333	A	G	5	5	10	0	0	10	0	0
2	238692996	rs35828868	T	C	2	6	8	0	0	8	0	0
2	238697892	rs10173348	T	G	1	5	6	0	0	6	0	0
2	238707292	rs74527049	G	A	4	4	8	0	0	8	0	0
2	238707783	rs115028752	C	T	1	7	8	0	1	9	0	0
2	238708054	rs75565744	C	T	1	5	6	0	0	6	0	0
2	238708793	rs62196081	C	T	3	10	13	0	1	14	0	0
2	238947982	rs11695668	G	A	4	6	10	0	0	10	0	0
2	238949743	rs708078	G	A	5	4	9	0	0	9	0	0
2	238951513	rs821500	G	C	12	8	20	0	0	20	0	0
2	238951607	rs11688228	A	G	7	12	19	0	0	19	0	0
2	238990388	rs3210400	G	A	7	6	13	0	0	13	0	0
2	239007163	rs73098352	C	A	7	3	10	0	0	10	0	0
2	239007232	rs28576957	A	G	3	8	11	0	0	11	0	0
2	239007534	rs61544914	A	G	12	9	21	0	0	21	0	0
2	239007705	rs142900735	G	A	11	16	27	0	0	27	0	0
2	239085680	.	T	C	5	8	13	0	0	13	0	0
2	239093065	rs112417511	G	A	4	3	7	0	0	7	0	0
2	239229372	rs13398676	C	A	2	10	12	0	0	12	0	0
2	239237846	.	G	A	6	9	15	0	2	17	0	0
2	239237953	rs12464423	G	T	19	11	30	0	0	30	0	0
2	239972830	rs13383500	G	T	24	12	36	0	0	36	0	0
2	240003870	rs1063639	G	A	24	22	46	0	0	46	0	0
2	240004124	rs10185553	A	C	6	6	12	0	0	12	0	0
2	240004249	rs72996170	G	A	1	5	6	0	0	6	0	0
2	240004807	rs3791372	T	C	2	4	6	0	0	6	0	0
2	240004891	rs3791374	A	G	3	4	7	0	0	7	0	0
2	240004961	rs28404128	A	G	4	3	7	0	0	7	0	0
2	240016012	rs72996180	C	T	6	4	10	0	0	10	0	0
2	240016403	rs2279272	A	G	0	6	6	0	0	6	0	0
2	240205687	rs59161018	A	G	3	5	8	0	1	9	0	0
2	240897085	rs7573892	C	T	18	15	33	0	0	33	0	0
2	240897331	rs34277046	G	A	15	16	31	0	0	31	0	0
2	240898578	rs4854069	C	T	9	7	16	0	1	17	0	0
2	240899346	rs66534347	G	A	7	12	19	0	0	19	0	0
2	240900121	rs13424612	C	T	4	2	6	0	0	6	0	0
2	240900919	rs10206993	C	A	2	5	7	0	0	7	0	0
2	240901290	rs7577635	T	C	4	2	6	0	0	6	0	0
2	240901315	rs7593079	G	C	4	2	6	0	0	6	0	0
2	240901849	.	T	C	2	4	6	0	0	6	0	0
2	240902988	rs4076744	G	C	6	2	8	0	0	8	0	0
2	240903572	rs4464310	T	C	5	1	6	0	0	6	0	0
2	240904884	rs58652766	G	A	2	4	6	0	0	6	0	0
2	240905550	rs6437355	G	C	3	3	6	0	0	6	0	0
2	240907394	rs4854066	T	A	3	3	6	0	0	6	0	0
2	240914002	rs4854064	T	G	4	3	7	0	0	7	0	0
2	240946766	rs13848	T	C	114	138	252	0	4	256	0	0
2	240951603	rs12478169	C	T	5	5	10	0	0	10	0	0
2	240953374	rs2278592	G	A	8	3	11	0	0	11	0	0
2	240954110	rs2289407	A	G	5	6	11	0	0	11	0	0
2	240961728	rs2083411	T	C	90	79	169	0	0	169	0	0
2	241419842	rs6739196	G	A	7	6	13	0	0	13	0	0
2	241463595	rs35996697	T	C	22	30	52	0	1	53	0	0
2	241468875	rs35278753	C	T	7	0	7	0	0	7	0	0
2	241500896	rs1128149	C	T	18	19	37	0	0	37	0	0
2	241501851	rs1138848	T	C	6	4	10	0	0	10	0	0
2	241501866	rs1138847	T	C	6	4	10	0	0	10	0	0
2	241504114	rs55869488	C	T	19	10	29	0	0	29	0	0
2	241558397	rs6437353	G	A	4	4	8	0	0	8	0	0
2	241564980	rs13019955	C	A	8	12	20	0	2	22	0	0
2	241566429	rs2975781	C	T	5	2	7	0	0	7	0	0
2	241567962	rs2953154	C	G	5	6	11	0	0	11	0	0
2	241568631	rs2953155	A	G	4	3	7	0	0	7	0	0
2	241569329	rs2975785	A	G	3	4	7	0	0	7	0	0
2	241570249	rs3749172	A	C	25	39	64	0	2	66	0	0
2	241570391	rs2975786	A	G	40	40	80	0	0	80	0	0
2	241940625	rs79809862	C	T	0	7	7	0	0	7	0	0
2	241941607	rs77794625	C	A	5	4	9	0	0	9	0	0
2	241943253	rs6735450	C	T	0	6	6	0	0	6	0	0
2	242122391	rs3868	T	C	10	9	19	0	0	19	0	0
2	242167337	rs1064767	T	C	43	47	90	0	1	91	0	0
2	242168976	rs15129	T	C	301	355	656	0	4	660	0	0
2	242176549	rs7607714	A	G	2	9	11	0	0	11	0	0
2	242177565	rs2289795	A	C	3	8	11	0	1	12	0	0
2	242208792	.	C	T	10	18	28	0	0	28	0	0
2	242210408	.	A	G	17	9	26	0	0	26	0	0
2	242211450	.	A	G	8	6	14	0	0	14	0	0
2	242212177	.	C	T	39	27	66	0	2	68	0	0
2	242213195	.	A	G	4	6	10	0	0	10	0	0
2	242213649	.	T	C	3	3	6	0	0	6	0	0
2	242254563	.	C	T	24	27	51	0	1	52	0	0
2	242256812	.	G	C	8	2	10	0	0	10	0	0
2	242274998	.	C	G	7	1	8	0	0	8	0	0
2	242276441	.	A	G	13	7	20	0	0	20	0	0
2	242291743	.	A	G	80	90	170	0	0	170	0	0
2	242292378	.	G	T	93	113	206	0	1	207	0	0
2	242293021	.	A	G	112	107	219	0	2	221	0	0
2	242321026	.	G	A	2	4	6	0	0	6	0	0
2	242382606	.	A	T	3	4	7	0	0	7	0	0
2	242384581	.	C	A	8	6	14	0	0	14	0	0
2	242385340	.	A	G	15	9	24	0	0	24	0	0
2	242386125	.	G	T	17	18	35	0	0	35	0	0
2	242434602	.	A	G	101	123	224	0	0	225	1	0
2	242573211	.	T	C	101	78	179	0	2	181	0	0
2	242588253	.	T	A	5	3	8	0	0	8	0	0
2	242592420	.	C	T	11	5	16	0	0	16	0	0
2	242594622	.	C	T	7	4	11	0	1	12	0	0
2	242595614	.	A	T	14	12	26	0	0	26	0	0
2	242595920	.	T	C	9	4	13	0	0	13	0	0
2	242596471	.	A	G	6	7	13	0	0	13	0	0
2	242597318	.	G	C	11	6	17	0	0	17	0	0
2	242599195	.	T	C	44	51	95	0	1	96	0	0
2	242599196	.	T	C	43	52	95	0	0	95	0	0
2	242599561	.	C	T	47	33	80	0	0	80	0	0
2	242601428	.	G	A	8	2	10	0	1	11	0	0
2	242605422	.	G	A	5	2	7	0	0	7	0	0
2	242605438	.	T	A	3	5	8	0	0	8	0	0
2	242606036	.	G	C	3	6	9	0	0	9	0	0
2	242607451	.	T	C	9	10	19	0	1	20	0	0
2	242607483	.	G	T	9	9	18	0	0	18	0	0
2	242607484	.	C	T	9	9	18	0	0	18	0	0
2	242607807	.	G	C	14	4	18	0	0	18	0	0
2	242607924	.	A	G	12	9	21	0	0	21	0	0
2	242608714	.	G	A	11	10	21	0	1	22	0	0
2	242608961	.	C	T	5	5	10	0	0	10	0	0
2	242609037	.	C	T	3	4	7	0	0	7	0	0
2	242609047	.	G	C	4	2	6	0	0	6	0	0
2	242609078	.	A	C	4	3	7	0	0	7	0	0
2	242609094	.	C	A	4	5	9	0	0	9	0	0
2	242609143	.	T	C	4	5	9	0	0	9	0	0
2	242609158	.	A	G	3	3	6	0	0	6	0	0
2	242609216	.	G	A	4	7	11	0	0	11	0	0
2	242609300	.	A	G	12	3	15	0	0	15	0	0
2	242609323	.	G	A	3	17	20	0	0	20	0	0
2	242609436	.	C	T	14	12	26	0	0	26	0	0
2	242609504	.	T	C	11	14	25	0	0	25	0	0
2	242609554	.	C	T	8	11	19	0	0	19	0	0
2	242609647	.	G	C	9	18	27	0	0	27	0	0
2	242609660	.	C	G	11	17	28	0	0	28	0	0
2	242609789	.	C	T	10	15	25	0	0	25	0	0
2	242609987	.	G	A	15	17	32	0	0	32	0	0
2	242609992	.	T	C	15	17	32	0	0	32	0	0
2	242610253	.	T	C	17	14	31	0	1	32	0	0
2	242610405	.	C	T	17	19	36	0	1	37	0	0
2	242610738	.	T	C	80	71	151	0	0	151	0	0
2	242611050	.	C	G	17	18	35	0	0	35	0	0
2	242611167	.	C	G	19	16	35	0	0	35	0	0
2	242611272	.	T	C	20	8	28	0	0	28	0	0
2	242611287	.	G	A	8	17	25	0	1	26	0	0
2	242611547	.	G	A	22	14	36	0	0	36	0	0
2	242612151	.	C	T	12	9	21	0	1	22	0	0
2	242612755	.	G	A	11	17	28	0	0	28	0	0
2	242612835	.	T	C	14	10	24	0	0	24	0	0
2	242615172	.	G	T	5	4	9	0	0	9	0	0
2	242615472	.	G	A	26	27	53	0	0	53	0	0
2	242618050	.	A	G	23	22	45	0	0	45	0	0
2	242674803	.	G	A	9	9	18	0	0	18	0	0
2	242684574	.	C	A	11	5	16	0	1	17	0	0
2	242684945	.	A	G	10	8	18	0	0	18	0	0
2	242685109	.	T	C	7	5	12	0	0	12	0	0
2	242686529	.	A	T	11	6	17	0	0	17	0	0
2	242687015	.	A	G	4	3	7	0	0	7	0	0
2	242687154	.	T	C	1	5	6	0	0	6	0	0
2	242688203	.	C	T	5	14	19	0	0	19	0	0
2	242688292	.	C	T	12	18	30	0	0	30	0	0
2	242688366	.	C	T	7	9	16	0	0	16	0	0
2	242688434	.	T	C	9	3	12	0	0	12	0	0
2	242688672	.	C	T	4	4	8	0	0	8	0	0
2	242688870	.	T	C	4	2	6	0	0	6	0	0
2	242690675	.	G	A	17	14	31	0	1	32	0	0
2	242693324	.	G	A	4	2	6	0	0	6	0	0
2	242693595	.	T	A	4	5	9	0	1	10	0	0
2	242699032	.	G	A	1	5	6	0	0	6	0	0
2	242701989	.	C	T	3	4	7	0	0	7	0	0
2	242702343	.	G	A	5	6	11	0	0	11	0	0
2	242702812	.	G	A	4	2	6	0	0	6	0	0
2	242703317	.	C	T	3	3	6	0	0	6	0	0
2	242703363	.	G	A	6	8	14	0	0	14	0	0
2	242703369	.	G	A	8	6	14	0	0	14	0	0
2	242703937	.	G	A	8	11	19	0	0	19	0	0
2	242704122	.	C	A	11	9	20	0	0	20	0	0
2	242707477	.	T	C	12	22	34	0	0	34	0	0
2	242708045	.	C	T	30	33	63	0	0	63	0	0
2	242708162	.	C	T	13	13	26	0	0	26	0	0
2	242708185	.	A	G	7	10	17	0	0	17	0	0
2	242740090	.	C	G	4	4	8	0	0	8	0	0
2	242751691	.	T	A	5	5	10	0	0	10	0	0
20	256886	rs3827150	A	G	3	6	9	0	0	9	0	0
20	256992	rs3827151	A	G	3	7	10	0	0	10	0	0
20	278515	rs2223665	T	C	5	5	10	0	0	10	0	0
20	279483	rs1046560	T	C	63	52	115	0	0	115	0	0
20	279536	.	G	A	46	44	90	0	2	92	0	0
20	279774	rs1046561	A	C	9	3	12	0	0	12	0	0
20	334852	rs183369458	A	C	1	5	6	0	0	6	0	0
20	442323	rs157800	T	A	11	10	21	0	4	25	0	0
20	462008	rs459012	T	C	49	42	91	0	1	92	0	0
20	462765	rs74570593	A	G	69	64	133	0	0	133	0	0
20	463608	rs41279418	A	T	156	184	340	0	3	343	0	0
20	481193	rs56272098	A	G	10	9	19	0	0	19	0	0
20	485321	rs6037819	C	T	12	7	19	0	0	19	0	0
20	629213	rs3746799	T	C	87	82	169	0	1	170	0	0
20	1108122	rs6514113	C	T	335	294	629	0	3	632	0	0
20	1126745	rs6040122	C	G	4	3	7	0	0	7	0	0
20	1127821	rs6040140	A	G	6	12	18	0	1	19	0	0
20	1127822	rs6040141	C	T	5	13	18	0	0	18	0	0
20	1136656	rs4813945	G	A	5	2	7	0	0	7	0	0
20	1140727	rs6040222	A	G	7	2	9	0	0	9	0	0
20	1146136	rs2072965	T	C	22	13	35	0	0	35	0	0
20	1147749	rs1803414	T	A	44	53	97	0	0	97	0	0
20	1148640	rs62186930	A	G	7	9	16	0	0	16	0	0
20	1148783	rs4813044	A	G	8	4	12	0	0	12	0	0
20	1148897	rs1053653	T	C	3	3	6	0	0	6	0	0
20	1292989	rs4814111	C	T	9	10	19	0	0	19	0	0
20	1350508	rs11712	A	G	285	336	621	0	14	635	0	0
20	1350672	rs6041749	T	C	437	371	808	0	13	821	0	0
20	1355044	rs1951765	T	A	6	2	8	0	1	9	0	0
20	1355701	rs6131424	G	A	2	4	6	0	0	6	0	0
20	1428408	rs76408530	T	C	3	3	6	0	0	6	0	0
20	1428445	rs2317653	T	C	4	2	6	0	0	6	0	0
20	1428452	rs2317654	A	C	5	2	7	0	0	7	0	0
20	1447941	rs3795134	C	G	4	3	7	0	0	7	0	0
20	1592215	rs41289057	C	G	1	14	15	0	0	15	0	0
20	1592265	rs45471597	A	G	1	17	18	0	0	18	0	0
20	1592284	rs1135196	G	A	1	16	17	0	0	17	0	0
20	1895794	rs1135192	G	A	15	1	16	0	0	16	0	0
20	1895796	rs143735290	T	C	15	1	16	0	0	16	0	0
20	1895797	rs146490405	G	A	15	1	16	0	0	16	0	0
20	1895813	rs17855609	A	T	17	0	17	0	0	17	0	0
20	1895815	rs17853846	A	G	20	0	20	0	0	20	0	0
20	1895820	rs17855610	C	T	18	2	20	0	0	20	0	0
20	1895889	rs1057114	G	C	23	17	40	0	0	41	1	0
20	1895963	rs17855613	A	G	13	6	19	0	0	19	0	0
20	1895965	rs17855614	C	A	14	6	20	0	0	20	0	0
20	1895984	.	C	A	18	5	23	0	0	23	0	0
20	1895990	.	G	A	17	6	23	0	0	23	0	0
20	1896059	rs115287948	G	A	28	11	39	0	2	41	0	0
20	1896060	rs114499682	T	C	28	12	40	0	1	41	0	0
20	1896100	.	C	T	30	20	50	0	0	50	0	0
20	1918401	rs111565548	C	T	46	36	82	0	6	88	0	0
20	1919324	rs7274469	C	T	48	53	101	0	0	101	0	0
20	2098184	rs41279012	G	A	5	6	11	0	0	11	0	0
20	2101098	.	A	G	7	2	9	0	0	9	0	0
20	2106357	.	G	A	6	5	11	0	0	11	0	0
20	2111562	rs148687369	T	G	3	5	8	0	0	8	0	0
20	2126180	rs2185675	G	C	8	18	26	0	0	26	0	0
20	2445401	rs117885142	C	T	42	19	61	0	0	61	0	0
20	2633296	rs6138678	G	C	22	14	36	0	0	36	0	0
20	2634167	rs6050911	C	A	4	4	8	0	0	8	0	0
20	2636218	rs742842	C	A	11	7	18	0	0	18	0	0
20	2638210	rs45545333	C	T	9	13	22	0	0	22	0	0
20	2638579	rs6753	T	C	147	172	319	0	6	325	0	0
20	2638882	rs5856	T	C	128	59	187	0	0	188	1	0
20	2639570	rs6037255	G	T	33	25	58	0	0	58	0	0
20	2639806	rs2325899	G	A	29	22	51	0	0	51	0	0
20	2640102	rs2235955	G	A	23	16	39	0	0	39	0	0
20	2777459	rs1985525	T	C	13	6	19	0	0	19	0	0
20	2777828	rs742707	G	T	4	4	8	0	0	8	0	0
20	2778363	rs215540	C	T	16	4	20	0	0	20	0	0
20	2818801	rs751899	T	C	3	3	6	0	0	6	0	0
20	2821144	rs913659	C	T	20	19	39	0	0	39	0	0
20	2855466	rs622601	A	G	4	2	6	0	0	6	0	0
20	2870285	rs577116	A	G	4	4	8	0	0	8	0	0
20	2872860	rs585035	T	C	4	2	6	0	0	6	0	0
20	2873366	rs508518	C	T	5	8	13	0	0	13	0	0
20	2873460	rs598147	A	G	4	6	10	0	0	10	0	0
20	2873629	.	G	C	30	30	60	0	1	61	0	0
20	2942096	rs6084219	C	A	4	4	8	0	0	8	0	0
20	2945759	rs1178027	C	T	103	101	204	0	2	206	0	0
20	2996497	rs1178016	C	T	144	136	280	0	0	280	0	0
20	3002432	rs633293	C	T	3	3	6	0	0	6	0	0
20	3089655	.	G	A	19	10	29	0	0	29	0	0
20	3089748	rs114889451	C	T	18	25	43	0	0	43	0	0
20	3090124	rs913555	A	G	20	23	43	0	0	43	0	0
20	3090316	rs1801899	C	T	23	28	51	0	0	51	0	0
20	3090848	rs708973	T	G	28	28	56	0	1	57	0	0
20	3130954	rs116712514	A	T	22	12	34	0	0	34	0	0
20	3138280	rs3827132	C	A	1	5	6	0	0	6	0	0
20	3230360	rs73081036	G	A	28	46	74	0	0	74	0	0
20	3629701	rs2295675	G	A	7	7	14	0	0	14	0	0
20	3734386	rs9171	T	C	227	189	416	0	3	419	0	0
20	3734514	rs2295340	T	C	245	252	497	0	3	501	1	0
20	3764657	.	G	A	110	101	211	0	4	215	0	0
20	3784110	rs1056720	C	T	38	19	57	0	0	57	0	0
20	3785978	rs11087604	G	A	27	40	67	0	0	67	0	0
20	3785984	rs11087605	C	T	29	45	74	0	0	74	0	0
20	3786637	rs8156	G	C	24	29	53	0	0	53	0	0
20	3805317	rs111286370	C	T	26	29	55	0	0	55	0	0
20	3848416	rs16989000	A	C	12	20	32	0	0	32	0	0
20	3870124	rs3737084	G	C	18	16	34	0	0	34	0	0
20	3889124	rs2282131	A	G	160	145	305	0	0	305	0	0
20	3893800	rs73084555	A	T	2	4	6	0	0	6	0	0
20	3894584	rs7268978	T	C	5	1	6	0	1	7	0	0
20	3894637	rs6107370	T	C	5	1	6	0	0	6	0	0
20	3894638	.	A	G	5	1	6	0	0	6	0	0
20	3894657	rs6116097	C	T	5	2	7	0	0	7	0	0
20	3896742	rs6052170	C	T	4	8	12	0	0	12	0	0
20	3899640	rs241594	G	A	17	9	26	0	0	26	0	0
20	3901024	rs113800135	G	A	15	14	29	0	0	29	0	0
20	3902301	rs74788399	G	A	14	11	25	0	0	25	0	0
20	3903634	rs11906612	C	T	31	30	61	0	0	61	0	0
20	3910406	rs3746665	T	C	75	49	124	0	0	125	1	0
20	3910861	rs3746666	A	G	70	46	116	0	3	119	0	0
20	3911021	rs73084583	T	G	58	50	108	0	1	109	0	0
20	3912637	rs397095	G	T	83	95	178	0	2	180	0	0
20	3912638	rs443168	C	G	84	95	179	0	0	179	0	0
20	3914215	rs14047	G	A	48	59	107	0	1	108	0	0
20	3914302	rs17286349	G	A	69	64	133	0	0	133	0	0
20	3915064	rs241605	C	T	8	8	16	0	0	16	0	0
20	3916602	rs241608	T	C	2	4	6	0	0	6	0	0
20	3940590	rs75159180	A	G	4	7	11	0	0	11	0	0
20	3940952	rs17214949	T	C	14	6	20	0	0	20	0	0
20	3944150	rs73086535	T	C	15	11	26	0	0	26	0	0
20	3970173	rs17215340	C	G	11	9	20	0	0	20	0	0
20	3970211	rs6052217	A	G	9	7	16	0	0	16	0	0
20	3970212	rs6052218	A	G	9	7	16	0	0	16	0	0
20	3970307	rs6052219	A	G	71	28	99	0	0	99	0	0
20	3977325	rs73086581	T	C	3	3	6	0	0	6	0	0
20	3980276	rs6084542	C	T	2	10	12	0	0	12	0	0
20	3986723	rs2300213	T	C	3	3	6	0	0	6	0	0
20	4158803	rs6076628	C	G	15	15	30	0	0	30	0	0
20	4158980	rs13040752	G	A	6	5	11	0	0	11	0	0
20	4159107	rs1741323	C	T	12	4	16	0	0	16	0	0
20	4159320	rs6052418	T	C	13	8	21	0	0	21	0	0
20	4159584	rs1741324	T	C	13	10	23	0	0	23	0	0
20	4160952	rs4815662	G	T	9	10	19	0	0	19	0	0
20	4161500	rs8118315	C	T	23	12	35	0	0	35	0	0
20	4162287	rs6037781	T	G	21	15	36	0	2	38	0	0
20	4162411	rs1124983	T	C	17	16	33	0	1	34	0	0
20	4162700	rs45610331	G	A	37	37	74	0	0	74	0	0
20	4164283	rs1741327	A	G	186	167	353	0	2	355	0	0
20	4166795	rs1310181	T	A	7	2	9	0	0	9	0	0
20	4176341	rs6084660	C	T	7	2	9	0	0	9	0	0
20	4761049	rs41279428	C	T	143	193	336	0	1	337	0	0
20	4762701	rs2422973	A	G	155	139	294	0	0	294	0	0
20	4762736	rs2422974	G	C	179	146	325	0	3	328	0	0
20	4762869	rs2422975	G	A	215	110	325	0	1	326	0	0
20	4763084	rs2422976	G	C	166	93	259	0	2	261	0	0
20	4763093	rs2422977	T	C	172	101	273	0	0	273	0	0
20	4763108	rs2422978	G	A	164	107	271	0	7	278	0	0
20	4763155	rs41279432	C	T	101	135	236	0	0	237	1	0
20	4763818	rs41279436	T	C	90	125	215	0	0	215	0	0
20	4764003	rs1535381	C	T	153	103	256	0	3	259	0	0
20	4764576	rs73058451	C	T	69	100	169	0	1	170	0	0
20	4764629	rs3746674	G	A	82	113	195	0	0	195	0	0
20	4764682	rs2422979	T	C	96	71	167	0	0	167	0	0
20	4764748	rs73058454	G	C	97	129	226	0	2	228	0	0
20	4765266	.	A	G	5	2	7	0	1	8	0	0
20	4765486	rs2422980	G	A	13	6	19	0	0	19	0	0
20	4766197	rs2422982	G	A	10	14	24	0	0	24	0	0
20	4766456	rs73058461	C	T	16	17	33	0	0	33	0	0
20	4766567	rs73058462	T	C	13	29	42	0	0	42	0	0
20	4783820	rs2423009	G	T	2	4	6	0	0	6	0	0
20	4783952	rs6084896	C	T	5	3	8	0	0	8	0	0
20	4790580	rs2423024	C	A	3	3	6	0	0	6	0	0
20	4803608	rs2326552	C	T	2	4	6	0	0	6	0	0
20	4804108	rs1104901	T	C	4	2	6	0	0	6	0	0
20	4834338	rs1131382	C	T	19	25	44	0	0	44	0	0
20	4835245	rs6139568	C	T	31	15	46	0	0	46	0	0
20	4838270	rs3787455	G	A	2	5	7	0	0	7	0	0
20	4854682	rs1110277	A	G	19	21	40	0	0	40	0	0
20	5081049	rs2715	T	C	93	111	204	0	2	206	0	0
20	5099636	rs25406	G	A	6	2	8	0	0	8	0	0
20	5525635	rs11571	T	C	95	107	202	0	0	202	0	0
20	5527176	rs8657	T	A	17	7	24	0	0	24	0	0
20	5528518	rs3747910	A	G	2	6	8	0	1	9	0	0
20	5528534	rs3747911	A	G	2	9	11	0	0	11	0	0
20	5533653	rs6076848	A	T	9	11	20	0	0	20	0	0
20	5535249	rs7273989	G	A	13	11	24	0	1	25	0	0
20	5540924	rs3747913	T	C	2	5	7	0	0	7	0	0
20	5541524	rs6053497	T	G	3	8	11	0	0	11	0	0
20	5542052	rs2273371	A	G	6	3	9	0	0	9	0	0
20	5542471	rs6107653	C	A	21	13	34	0	0	34	0	0
20	5543455	rs4361194	T	A	5	6	11	0	0	11	0	0
20	5543651	rs6076851	C	T	10	7	17	0	0	17	0	0
20	5544841	rs148613063	T	C	15	10	25	0	1	26	0	0
20	5544985	rs199986018	A	C	4	7	11	0	1	12	0	0
20	5544986	.	A	C	10	2	12	0	0	12	0	0
20	5549446	rs6116851	C	T	12	5	17	0	0	17	0	0
20	5549506	rs62204032	A	T	3	13	16	0	0	16	0	0
20	5551767	rs6053503	A	G	3	11	14	0	0	14	0	0
20	5552286	rs11087686	G	A	10	0	10	0	0	10	0	0
20	5552501	rs6053505	A	G	3	7	10	0	0	10	0	0
20	5565374	rs6133234	A	G	10	16	26	0	0	26	0	0
20	5568662	rs6053520	T	C	6	4	10	0	0	10	0	0
20	5569648	rs6133235	G	T	5	9	14	0	1	15	0	0
20	5731955	rs6107683	C	T	8	5	13	0	0	13	0	0
20	5844352	rs144897306	G	C	4	2	6	0	0	6	0	0
20	5918693	rs236170	G	A	8	4	12	0	0	12	0	0
20	5923203	rs394940	T	C	8	9	17	0	0	17	0	0
20	5923204	rs451571	T	C	8	9	17	0	0	17	0	0
20	7961715	rs1058029	G	A	15	12	27	0	0	27	0	0
20	7962072	rs8764	A	C	20	21	41	0	0	41	0	0
20	7963235	.	G	T	83	67	150	0	2	152	0	0
20	7967980	rs17425725	G	C	51	50	101	0	0	101	0	0
20	7980390	rs1012891	C	T	66	65	131	0	0	131	0	0
20	7999537	rs2294247	C	A	9	8	17	0	0	17	0	0
20	8000386	rs2205783	A	G	3	4	7	0	0	7	0	0
20	8130943	rs16994453	C	T	77	64	141	0	2	143	0	0
20	8134140	rs6055577	C	A	5	1	6	0	0	6	0	0
20	8140769	rs2327027	C	A	8	9	17	0	0	17	0	0
20	8140925	rs2327028	C	T	6	3	9	0	0	9	0	0
20	8210782	rs6055676	T	C	7	0	7	0	0	7	0	0
20	8388859	rs6086435	T	A	6	1	7	0	0	7	0	0
20	8389911	rs6140613	T	G	4	2	6	0	0	6	0	0
20	8482025	rs6039177	C	G	1	5	6	0	0	6	0	0
20	8492650	rs6086477	G	A	2	5	7	0	0	7	0	0
20	8630944	rs7264711	A	C	5	3	8	0	0	8	0	0
20	8633099	rs6086551	T	C	5	11	16	0	0	16	0	0
20	8633262	rs8115504	G	A	32	21	53	0	0	53	0	0
20	8633398	rs8115555	G	A	37	28	65	0	0	65	0	0
20	8633433	rs6133597	T	C	40	26	66	0	1	67	0	0
20	8633733	rs6055978	C	T	52	43	95	0	1	96	0	0
20	8633847	rs6118282	G	A	13	19	32	0	0	32	0	0
20	8717713	rs3761170	G	A	28	38	66	0	0	66	0	0
20	8720401	rs6086574	T	G	8	1	9	0	0	9	0	0
20	8727788	rs6056056	C	T	6	5	11	0	0	11	0	0
20	8729119	rs6039249	A	G	2	4	6	0	0	6	0	0
20	8729333	rs6039250	T	C	5	5	10	0	0	10	0	0
20	8729397	rs6056059	G	A	5	5	10	0	0	10	0	0
20	8730844	rs4816074	A	G	3	4	7	0	0	7	0	0
20	8737734	rs2076413	G	A	24	20	44	0	4	48	0	0
20	8770822	rs2294597	C	T	34	20	54	0	3	57	0	0
20	8772761	rs6108191	G	A	4	2	6	0	0	6	0	0
20	8848994	rs3848830	C	T	3	3	6	0	0	6	0	0
20	8852328	rs4502502	A	C	3	3	6	0	0	6	0	0
20	8864177	rs1047381	T	C	7	8	15	0	0	15	0	0
20	8864203	rs708910	A	G	8	9	17	0	0	17	0	0
20	8865006	rs1047383	C	T	15	15	30	0	0	30	0	0
20	8945826	rs76519024	A	G	4	3	7	0	0	7	0	0
20	9506535	rs62193584	A	T	3	5	8	0	0	8	0	0
20	10386013	rs1545	C	A	5	7	12	0	0	12	0	0
20	10386059	rs1547	G	A	4	4	8	0	0	8	0	0
20	10393629	rs17852625	G	A	6	3	9	0	0	9	0	0
20	10604466	rs55855614	G	A	3	3	6	0	0	6	0	0
20	10619014	rs7828	A	C	7	13	20	0	0	20	0	0
20	10620275	rs1051421	G	A	34	30	64	0	0	64	0	0
20	11871563	rs182782561	C	G	13	5	18	0	0	18	0	0
20	13695680	rs6110019	C	T	11	5	16	0	0	16	0	0
20	13766447	rs6110037	A	G	2	7	9	0	0	9	0	0
20	13784719	rs6110048	G	A	5	2	7	0	0	7	0	0
20	13788882	rs736365	G	A	4	3	7	0	0	7	0	0
20	13789247	rs885796	A	G	3	3	6	0	0	6	0	0
20	13790292	rs6110050	A	C	2	4	6	0	0	6	0	0
20	13793874	rs4813145	G	A	4	2	6	0	0	6	0	0
20	13796657	rs2064644	G	A	6	4	10	0	0	10	0	0
20	13798776	rs2423752	T	C	3	4	7	0	0	7	0	0
20	16350615	rs74509243	C	A	2	4	6	0	0	6	0	0
20	16359650	rs8116503	C	T	11	4	15	0	0	15	0	0
20	17611777	rs3790325	T	C	4	9	13	0	0	13	0	0
20	17652572	rs3790307	T	A	14	5	19	0	0	19	0	0
20	17924591	rs2145020	T	C	12	11	23	0	1	24	0	0
20	17926263	.	T	A	5	12	17	0	0	17	0	0
20	17927028	rs6136233	C	T	26	8	34	0	0	34	0	0
20	17927210	rs62208130	A	G	5	7	12	0	1	13	0	0
20	17930034	rs2295455	T	C	5	2	7	0	0	7	0	0
20	17931513	rs6111754	C	T	14	6	20	0	0	20	0	0
20	17931519	rs8120332	T	C	5	13	18	0	0	18	0	0
20	17932210	rs2273448	C	T	146	103	249	0	6	255	0	0
20	17932415	rs2273449	T	C	32	22	54	0	0	54	0	0
20	17932978	rs6111755	A	T	3	3	6	0	0	6	0	0
20	17934961	rs2236158	T	C	10	3	13	0	0	13	0	0
20	17935822	rs10485575	T	C	3	5	8	0	0	8	0	0
20	17942616	rs2328231	T	C	2	7	9	0	0	9	0	0
20	17942651	rs2328232	C	T	1	9	10	0	0	10	0	0
20	17942792	rs2328233	G	T	9	11	20	0	1	21	0	0
20	17943138	rs2004931	G	A	4	7	11	0	0	11	0	0
20	17943492	rs753213	A	T	6	5	11	0	0	11	0	0
20	17947738	rs62208159	G	A	14	13	27	0	0	27	0	0
20	17948082	rs2295457	T	C	19	11	30	0	0	30	0	0
20	17948894	rs6111762	G	A	58	61	119	0	0	119	0	0
20	17949452	rs910902	C	T	7	15	22	0	0	22	0	0
20	17950476	.	A	G	14	3	17	0	0	17	0	0
20	17950545	rs11551768	A	T	10	7	17	0	0	17	0	0
20	17968923	rs28455091	T	C	49	50	99	0	2	101	0	0
20	17971553	rs7010	T	G	43	55	98	0	0	98	0	0
20	18123577	rs41276414	C	G	18	18	36	0	0	36	0	0
20	18143117	rs1205193	T	G	6	6	12	0	0	12	0	0
20	18296072	rs1033545	T	A	4	2	6	0	0	6	0	0
20	18364931	rs2424181	A	G	5	7	12	0	0	12	0	0
20	18374929	.	A	G	3	4	7	0	0	7	0	0
20	18464610	rs146172510	G	C	4	8	12	0	1	13	0	0
20	18465004	rs1133724	C	G	15	12	27	0	0	27	0	0
20	18468917	rs6081168	T	A	3	3	6	0	0	6	0	0
20	18469387	rs137912009	G	A	1	5	6	0	0	6	0	0
20	18469853	rs138409979	G	A	2	4	6	0	0	6	0	0
20	18513605	rs2295556	C	T	2	4	6	0	0	6	0	0
20	18549300	rs6132080	C	T	12	2	14	0	0	14	0	0
20	18549325	rs67499983	C	T	10	2	12	0	1	13	0	0
20	18549398	rs6132081	G	A	6	4	10	0	0	10	0	0
20	18549503	rs6132082	C	T	11	4	15	0	0	15	0	0
20	18609016	rs2295574	T	C	5	6	11	0	1	12	0	0
20	18609314	rs2295573	T	C	4	6	10	0	0	10	0	0
20	18611196	rs6045526	C	T	4	3	7	0	0	7	0	0
20	18611962	rs6081260	A	G	8	8	16	0	0	16	0	0
20	18618017	rs6081267	C	G	1	6	7	0	0	7	0	0
20	19261623	rs1569767	G	A	10	4	14	0	0	14	0	0
20	19702049	rs3828002	G	A	23	6	29	0	0	29	0	0
20	19703369	rs144954252	C	G	14	10	24	0	1	25	0	0
20	20007869	.	C	T	6	3	9	0	0	9	0	0
20	20007902	rs62203273	A	G	3	3	6	0	0	6	0	0
20	20016095	rs75503129	G	T	8	5	13	0	0	13	0	0
20	20019658	rs138020838	C	T	4	3	7	0	0	7	0	0
20	20020603	rs77745762	A	G	17	14	31	0	0	31	0	0
20	20023326	rs926646	T	C	14	20	34	0	0	34	0	0
20	20025386	rs145142926	C	T	14	22	36	0	0	36	0	0
20	21115991	rs6047267	G	A	3	3	6	0	0	6	0	0
20	21142523	rs4815025	C	G	24	20	44	0	0	44	0	0
20	21142813	rs2236178	T	C	34	28	62	0	0	62	0	0
20	21146816	rs6137276	A	G	21	0	21	0	3	24	0	0
20	21146839	rs2876595	T	C	23	0	23	0	1	24	0	0
20	21147009	rs6047283	A	G	7	4	11	0	0	11	0	0
20	21147407	rs6035796	A	G	3	3	6	0	1	7	0	0
20	21148683	rs4815026	G	T	6	2	8	0	0	8	0	0
20	21150267	rs6132402	G	C	10	7	17	0	0	17	0	0
20	23027413	rs3176123	T	G	6	15	21	0	0	21	0	0
20	23028724	rs1042579	G	A	3	8	11	0	0	11	0	0
20	23334781	rs41282288	C	T	135	113	248	0	1	249	0	0
20	23349749	rs3746733	C	T	5	3	8	0	0	8	0	0
20	23349765	rs3746734	C	T	6	4	10	0	1	11	0	0
20	23350525	rs17830281	C	T	5	5	10	0	0	10	0	0
20	23351288	rs17757228	A	T	21	22	43	0	2	45	0	0
20	23352685	rs7988	C	A	11	18	29	0	0	29	0	0
20	23355915	rs147078828	A	G	19	12	31	0	0	31	0	0
20	23356985	rs3827085	A	T	30	27	57	0	0	57	0	0
20	23357331	rs3827086	C	T	17	13	30	0	0	30	0	0
20	23357725	rs6137913	G	A	15	19	34	0	1	35	0	0
20	23358651	rs6083100	G	A	2	4	6	0	0	6	0	0
20	24929947	rs227652	C	T	62	47	109	0	1	110	0	0
20	24930085	rs227653	G	A	110	57	167	0	2	169	0	0
20	24939764	rs45556041	C	T	5	2	7	0	0	7	0	0
20	24944166	rs6707	C	T	115	98	213	0	2	215	0	0
20	24944933	rs761368	T	C	6	7	13	0	0	13	0	0
20	24947476	rs6083697	C	A	8	5	13	0	0	13	0	0
20	24948630	rs6050214	A	G	4	4	8	0	0	8	0	0
20	24949944	rs6138438	G	C	6	4	10	0	0	10	0	0
20	24987438	rs6083718	C	T	103	90	193	0	1	194	0	0
20	24987787	rs6132784	A	G	70	98	168	0	0	168	0	0
20	24994289	rs6050249	C	T	36	48	84	0	1	85	0	0
20	25005744	rs62217173	C	T	1	5	6	0	0	6	0	0
20	25011423	rs6050259	T	C	45	63	108	0	0	108	0	0
20	25035711	rs4815364	G	A	5	2	7	0	0	7	0	0
20	25036163	rs4815365	G	A	12	5	17	0	0	17	0	0
20	25038372	rs62217194	G	A	5	3	8	0	0	8	0	0
20	25200322	rs12479688	C	T	4	3	7	0	0	7	0	0
20	25266633	rs6107022	C	T	9	4	13	0	0	13	0	0
20	25672169	.	G	A	14	8	22	0	0	22	0	0
20	25672987	rs6050791	G	A	4	4	8	0	0	8	0	0
20	29623223	.	T	C	127	0	127	0	0	127	0	0
20	29625876	.	C	T	109	0	109	0	1	110	0	0
20	29625935	.	A	G	112	0	112	0	0	112	0	0
20	29626672	.	C	G	9	0	9	0	0	9	0	0
20	29626694	.	C	T	13	0	13	0	0	13	0	0
20	29626720	.	C	T	12	0	12	0	0	12	0	0
20	29626773	.	A	T	0	16	16	0	0	16	0	0
20	29626826	.	A	T	7	0	7	0	0	7	0	0
20	29628271	.	C	T	88	0	88	0	1	89	0	0
20	29633916	.	G	T	37	0	37	0	0	37	0	0
20	29633927	rs62196372	C	A	30	0	30	0	0	30	0	0
20	29633929	rs7509092	A	G	29	0	29	0	0	29	0	0
20	29633952	.	C	T	16	0	16	0	0	16	0	0
20	29633986	rs2379676	A	C	7	0	7	0	0	7	0	0
20	30139152	rs73116293	C	T	2	5	7	0	0	7	0	0
20	30146021	.	T	G	4	2	6	0	0	6	0	0
20	30150324	rs73116296	G	A	5	8	13	0	0	13	0	0
20	30372114	rs6060944	G	A	7	4	11	0	1	12	0	0
20	30381758	rs1062794	G	C	13	24	37	0	1	38	0	0
20	30641904	rs75747523	G	A	7	4	11	0	0	11	0	0
20	30642418	rs192169540	G	T	7	6	13	0	1	14	0	0
20	30668633	rs242606	G	A	5	2	7	0	0	7	0	0
20	30680338	rs926688	G	T	3	4	7	0	0	7	0	0
20	30681543	rs980368	A	G	7	3	10	0	0	10	0	0
20	30753270	rs14316	T	C	23	28	51	0	0	51	0	0
20	30775139	rs1002137	C	A	2	5	7	0	0	7	0	0
20	30777336	rs3813922	G	T	7	3	10	0	0	10	0	0
20	30782113	rs6061216	A	G	26	14	40	0	1	41	0	0
20	30782543	rs1056776	C	G	32	31	63	0	1	64	0	0
20	30783919	rs28396287	A	G	83	73	156	0	1	157	0	0
20	30785593	rs6121381	A	T	7	12	19	0	0	19	0	0
20	30788194	.	C	T	9	7	16	0	0	16	0	0
20	30789062	rs733320	C	A	4	7	11	0	0	11	0	0
20	30789188	rs911129	A	G	2	6	8	0	0	8	0	0
20	30795819	rs1923095	T	C	13	13	26	0	0	26	0	0
20	30915461	rs1129012	T	C	20	33	53	0	0	53	0	0
20	30919183	rs1029116	A	G	15	18	33	0	0	33	0	0
20	30921846	rs3813921	A	G	44	45	89	0	0	89	0	0
20	30952181	rs2424876	T	G	4	5	9	0	0	9	0	0
20	30954977	rs2424877	C	T	9	10	19	0	1	20	0	0
20	31019024	rs2295765	C	T	15	10	25	0	0	25	0	0
20	31035129	rs1737887	A	G	9	4	13	0	0	13	0	0
20	31042595	rs1737890	G	T	5	2	7	0	0	7	0	0
20	31330360	rs146897560	G	A	4	8	12	0	0	12	0	0
20	31330361	rs139369350	G	A	3	8	11	0	0	11	0	0
20	31378772	rs7360212	A	C	2	4	6	0	0	6	0	0
20	31386347	rs6058891	T	C	24	11	35	0	0	35	0	0
20	31386449	rs2424922	T	C	24	7	31	0	0	31	0	0
20	31388080	rs17123657	C	T	26	18	44	0	1	45	0	0
20	31427342	rs2235760	C	T	3	3	6	0	0	6	0	0
20	31427635	rs2070090	C	T	481	493	974	0	2	976	0	0
20	31435260	rs242536	T	G	69	67	136	0	0	136	0	0
20	31436747	rs242538	C	T	483	467	950	0	2	952	0	0
20	31960695	rs145149086	T	A	8	5	13	0	0	13	0	0
20	32212690	rs3803939	C	T	10	7	17	0	0	17	0	0
20	32248163	rs3746460	C	T	15	13	28	0	0	28	0	0
20	32263624	rs3213180	G	C	27	26	53	0	0	53	0	0
20	32295541	rs910397	C	T	4	3	7	0	0	7	0	0
20	32379263	rs2626551	T	C	10	9	19	0	0	19	0	0
20	32437142	rs1810534	C	T	14	20	34	0	0	34	0	0
20	32660190	rs10485504	C	T	16	20	36	0	0	36	0	0
20	32664601	rs148075348	C	A	515	476	991	0	6	1000	3	0
20	32952125	rs12624640	G	A	5	1	6	0	0	6	0	0
20	32957216	rs3746455	G	A	24	37	61	0	0	61	0	0
20	33037644	rs6088502	A	T	4	3	7	0	0	7	0	0
20	33057328	rs6059855	C	G	5	7	12	0	0	12	0	0
20	33057954	rs6059856	G	C	10	7	17	0	0	17	0	0
20	33058628	rs6087587	G	T	9	9	18	0	0	18	0	0
20	33060081	rs6088508	A	G	3	3	6	0	0	6	0	0
20	33063283	rs6059859	T	C	5	2	7	0	0	7	0	0
20	33063830	rs6059860	A	C	2	6	8	0	0	8	0	0
20	33069553	rs62212233	C	T	3	4	7	0	0	7	0	0
20	33076333	rs2144717	A	G	4	5	9	0	0	9	0	0
20	33095891	rs6088512	G	A	28	57	85	0	0	85	0	0
20	33147737	rs6059915	C	G	16	51	67	0	2	69	0	0
20	33292777	rs910869	C	T	10	4	14	0	0	14	0	0
20	33292893	rs910870	T	C	8	6	14	0	0	14	0	0
20	33294353	rs6060001	A	G	12	6	18	0	0	18	0	0
20	33294945	rs6060003	T	C	12	7	19	0	0	19	0	0
20	33301216	rs369941329	C	A	6	3	9	0	0	9	0	0
20	33328024	rs6119516	C	T	5	6	11	0	0	11	0	0
20	33337751	rs3787220	T	C	56	48	104	0	1	105	0	0
20	33345747	rs41290900	T	C	27	31	58	0	1	59	0	0
20	33590417	rs1058003	G	A	149	127	276	0	2	278	0	0
20	33590584	rs8501	T	C	101	85	186	0	2	188	0	0
20	33591591	rs752075	C	A	20	13	33	0	1	34	0	0
20	33592248	rs752448	C	T	30	35	65	0	1	66	0	0
20	33592474	rs752449	A	G	44	53	97	0	4	101	0	0
20	33593457	rs3746431	T	C	31	33	64	0	0	64	0	0
20	33593674	rs3746430	T	C	22	16	38	0	0	39	1	0
20	33593789	rs4911168	C	G	12	11	23	0	0	23	0	0
20	33593834	rs4911169	G	A	11	18	29	0	0	29	0	0
20	33594226	rs6060151	G	T	17	26	43	0	1	44	0	0
20	33594464	rs80325521	G	A	11	4	15	0	0	15	0	0
20	33595300	rs2273636	C	T	19	13	32	0	0	32	0	0
20	33596117	rs2295701	G	C	29	30	59	0	0	59	0	0
20	33596876	rs3818253	G	A	7	18	25	0	0	25	0	0
20	33601959	rs1998232	T	G	8	2	10	0	0	10	0	0
20	33657126	rs1998233	G	A	84	81	165	0	2	167	0	0
20	33703607	rs3746429	C	T	132	83	215	0	5	220	0	0
20	33714187	rs2295887	G	A	2	4	6	0	0	6	0	0
20	33714805	rs6087677	T	C	2	7	9	0	0	9	0	0
20	33718706	rs1535466	G	A	6	1	7	0	0	7	0	0
20	33805856	rs58427177	C	T	7	2	9	0	0	9	0	0
20	33865895	rs2425042	G	A	23	28	51	0	1	52	0	0
20	33866753	rs7004	G	C	60	43	103	0	0	103	0	0
20	33867924	rs2250205	G	A	5	7	12	0	0	12	0	0
20	33870366	rs117801348	T	A	2	4	6	0	0	6	0	0
20	33871661	rs2425046	T	C	3	4	7	0	0	7	0	0
20	33871675	rs2425047	A	C	3	5	8	0	0	8	0	0
20	33872311	rs2275275	G	C	3	6	9	0	0	9	0	0
20	33891004	rs3764732	G	A	14	8	22	0	0	22	0	0
20	33894091	rs2425054	A	G	2	4	6	0	0	6	0	0
20	34062642	rs224362	C	T	3	5	8	0	0	8	0	0
20	34062710	rs224363	C	T	3	4	7	0	0	7	0	0
20	34064478	rs57616316	C	T	42	37	79	0	0	79	0	0
20	34138406	rs224416	G	A	5	2	7	0	0	7	0	0
20	34138549	rs56695771	G	A	5	3	8	0	1	9	0	0
20	34142512	rs6060462	G	A	4	8	12	0	0	12	0	0
20	34142527	rs224418	T	C	7	9	16	0	1	17	0	0
20	34144311	rs11906494	G	C	10	10	20	0	0	20	0	0
20	34144746	rs8825	A	G	819	714	1533	0	20	1553	0	0
20	34214368	rs6060516	T	C	3	5	8	0	0	8	0	0
20	34217309	rs6060518	A	C	2	4	6	0	0	6	0	0
20	34219496	rs6579255	T	C	254	247	501	0	2	503	0	0
20	34237224	rs8050	C	A	5	3	8	0	0	8	0	0
20	34239382	rs6060539	C	T	3	3	6	0	0	6	0	0
20	34240686	rs74880624	T	C	87	82	169	0	2	171	0	0
20	34243017	rs6121015	C	T	56	39	95	0	0	95	0	0
20	34248134	rs11698796	T	C	5	1	6	0	0	6	0	0
20	34251945	rs17092957	G	A	4	2	6	0	0	6	0	0
20	34252006	rs6121020	C	T	4	2	6	0	1	7	0	0
20	34292961	rs2425071	C	A	24	19	43	0	0	43	0	0
20	34293067	.	A	G	13	13	26	0	0	26	0	0
20	34293686	rs2425072	T	C	94	76	170	0	2	172	0	0
20	34293699	rs2425073	A	G	89	58	147	0	8	155	0	0
20	34294050	rs2425074	C	G	128	128	256	0	0	256	0	0
20	34294409	rs2050729	A	G	18	19	37	0	0	37	0	0
20	34295249	rs2425076	C	A	233	151	384	0	5	389	0	0
20	34298096	rs17092999	T	C	101	114	215	0	1	216	0	0
20	34298191	rs2425079	T	C	146	154	300	0	2	302	0	0
20	34299733	rs2425081	C	A	120	122	242	0	4	246	0	0
20	34299778	rs2425082	A	G	143	145	288	0	2	290	0	0
20	34300456	rs2425083	C	T	52	40	92	0	2	94	0	0
20	34301871	rs2425084	C	T	9	12	21	0	0	21	0	0
20	34313297	rs6060582	C	T	9	14	23	0	0	23	0	0
20	34313426	rs56941405	C	T	6	9	15	0	0	15	0	0
20	34314251	.	C	T	7	0	7	0	0	7	0	0
20	34319765	rs2425111	A	C	63	160	223	0	2	225	0	0
20	34319775	rs2425112	A	T	61	158	219	0	0	219	0	0
20	34321138	rs6119646	T	C	101	120	221	0	5	226	0	0
20	34321218	rs6119647	A	T	51	44	95	0	6	101	0	0
20	34322346	rs2425114	T	C	217	229	446	0	2	448	0	0
20	34322418	rs2425115	A	G	156	185	341	0	0	341	0	0
20	34322585	rs17093035	C	T	185	198	383	0	2	385	0	0
20	34323553	rs2425116	T	C	14	4	18	0	0	18	0	0
20	34323776	rs2425117	C	T	95	62	157	0	1	158	0	0
20	34324098	rs2425118	G	A	47	54	101	0	3	104	0	0
20	34324216	rs2425119	C	A	59	55	114	0	1	115	0	0
20	34324456	rs2425120	A	T	25	20	45	0	0	45	0	0
20	34324484	rs6058312	A	C	27	45	72	0	0	72	0	0
20	34324648	rs4519606	T	C	14	42	56	0	0	56	0	0
20	34325351	rs56392905	A	G	27	16	43	0	1	44	0	0
20	34325610	rs7268246	A	G	21	26	47	0	0	47	0	0
20	34325632	rs7268253	A	G	26	25	51	0	0	51	0	0
20	34325671	rs7269829	T	C	32	32	64	0	0	64	0	0
20	34325779	.	A	C	37	2	39	0	1	40	0	0
20	34326186	rs2425121	A	T	39	37	76	0	0	76	0	0
20	34328274	rs1538426	G	A	224	210	434	0	2	436	0	0
20	34328848	rs2425122	C	T	13	4	17	0	0	17	0	0
20	34329359	rs2066066	T	C	8	2	10	0	1	11	0	0
20	34329547	rs2425123	A	G	8	2	10	0	0	10	0	0
20	34360447	rs112535159	G	A	6	9	15	0	0	15	0	0
20	34362787	rs73902907	G	A	150	122	272	0	2	274	0	0
20	34370367	rs4911520	C	T	4	2	6	0	0	6	0	0
20	34392122	rs112277543	C	T	11	0	11	0	0	11	0	0
20	34393458	rs59294666	C	T	6	0	6	0	0	6	0	0
20	34394901	rs141121880	C	T	7	0	7	0	0	7	0	0
20	34431660	rs58121874	C	T	7	3	10	0	0	10	0	0
20	34431747	rs60828070	G	A	8	7	15	0	0	15	0	0
20	34431788	rs117862489	G	A	5	4	9	0	0	9	0	0
20	34432958	rs78094716	A	G	4	2	6	0	0	6	0	0
20	34442672	rs2425170	A	G	3	9	12	0	0	12	0	0
20	34443173	rs2425171	G	C	1	6	7	0	0	7	0	0
20	34443893	rs2425172	A	G	3	4	7	0	0	7	0	0
20	34445563	rs2425175	G	A	3	5	8	0	0	8	0	0
20	34445741	rs2425176	T	C	5	3	8	0	0	8	0	0
20	34471289	rs17093210	T	C	11	24	35	0	0	35	0	0
20	34536022	rs6060709	A	G	49	33	82	0	0	82	0	0
20	34536055	rs6060710	A	G	45	42	87	0	0	87	0	0
20	34537180	rs34977741	G	A	40	52	92	0	0	92	0	0
20	34537887	rs6579266	G	A	34	47	81	0	0	81	0	0
20	34537994	rs58481463	G	T	29	36	65	0	3	68	0	0
20	34634914	rs6121135	G	T	107	85	192	0	7	199	0	0
20	34635537	rs2982537	T	C	89	73	162	0	1	163	0	0
20	34637814	rs2982538	C	G	66	53	119	0	1	120	0	0
20	34638251	rs2921393	G	A	135	114	249	0	0	249	0	0
20	34828133	.	C	G	107	93	200	0	1	201	0	0
20	34828459	rs716431	T	C	86	122	208	0	3	211	0	0
20	34828609	rs709050	G	A	43	48	91	0	0	91	0	0
20	34836418	rs6060871	A	C	5	6	11	0	0	11	0	0
20	34839321	rs61599953	G	T	4	6	10	0	0	10	0	0
20	34842955	rs6060873	C	T	4	4	8	0	0	8	0	0
20	35156848	rs6025503	G	A	0	22	22	0	0	27	5	0
20	35202722	.	C	G	5	4	9	0	1	10	0	0
20	35280673	.	G	A	33	42	75	0	1	76	0	0
20	35407640	rs11697056	C	T	32	29	61	0	2	63	0	0
20	35412281	.	T	C	18	16	34	0	1	35	0	0
20	35414768	rs3902969	C	T	11	10	21	0	0	21	0	0
20	35422936	rs35707272	G	T	23	10	33	0	0	33	0	0
20	35467713	rs1146250	G	A	8	3	11	0	0	11	0	0
20	35518879	rs1129218	T	C	65	53	118	0	2	120	0	0
20	35519475	rs6029941	G	A	50	54	104	0	0	104	0	0
20	35723516	rs62206491	C	T	3	8	11	0	0	11	0	0
20	35868046	rs6073777	A	G	4	2	6	0	0	6	0	0
20	35927179	rs1127262	G	A	7	4	11	0	0	11	0	0
20	35945104	rs1043404	G	A	21	6	27	0	0	27	0	0
20	35945174	rs1806940	G	T	6	24	30	0	1	31	0	0
20	36028831	rs1570209	T	C	8	10	18	0	0	18	0	0
20	36130239	rs2425345	C	G	2	5	7	0	0	7	0	0
20	36134234	rs6066666	A	G	0	7	7	0	0	7	0	0
20	36148497	rs3795148	T	C	8	5	13	0	1	14	0	0
20	36148985	rs6019062	T	C	14	6	20	0	1	21	0	0
20	36149571	rs117228460	T	C	5	3	8	0	0	8	0	0
20	36153344	rs6019102	C	T	7	5	12	0	0	12	0	0
20	36153360	rs6019103	A	C	7	5	12	0	0	12	0	0
20	36153821	rs73101504	C	T	3	3	6	0	0	6	0	0
20	36154004	rs6090836	T	C	7	6	13	0	0	13	0	0
20	36154462	rs12481150	C	A	4	8	12	0	0	12	0	0
20	36481807	rs2235459	A	C	3	3	6	0	0	6	0	0
20	36611664	rs2037	C	T	11	11	22	0	1	23	0	0
20	36662255	rs881556	C	T	14	10	24	0	0	24	0	0
20	36668874	rs2273353	G	A	21	12	33	0	0	33	0	0
20	36671470	rs990792	G	T	1	7	8	0	0	8	0	0
20	36688068	rs6022706	A	G	4	4	8	0	0	8	0	0
20	36688370	rs6013782	C	G	5	4	9	0	0	9	0	0
20	36688764	rs73098431	C	A	2	4	6	0	0	6	0	0
20	36688893	rs6022716	A	G	3	3	6	0	0	6	0	0
20	36691581	rs6068657	C	T	2	4	6	0	0	6	0	0
20	36692842	rs6063998	A	G	5	1	6	0	0	6	0	0
20	36694323	rs2295351	G	C	4	4	8	0	0	8	0	0
20	36694877	rs6068675	A	G	3	4	7	0	0	7	0	0
20	36697863	rs6013812	A	G	4	4	8	0	0	8	0	0
20	36698920	rs6022796	A	G	8	4	12	0	0	12	0	0
20	36699860	rs6022804	G	T	7	8	15	0	0	15	0	0
20	36701254	rs6013824	T	C	7	3	10	0	0	10	0	0
20	36701510	rs6068698	C	T	4	6	10	0	0	10	0	0
20	36702156	.	G	A	4	7	11	0	0	11	0	0
20	36702543	rs6064017	G	T	6	7	13	0	0	13	0	0
20	36704226	rs6097662	G	A	5	4	9	0	0	9	0	0
20	36705777	rs6091779	A	G	2	4	6	0	0	6	0	0
20	36707403	rs6013839	G	C	4	2	6	0	0	6	0	0
20	36709997	rs6068740	G	A	15	13	28	0	0	28	0	0
20	36710741	rs2092906	T	C	6	7	13	0	0	13	0	0
20	36711395	rs6068747	C	A	16	5	21	0	0	21	0	0
20	36711447	rs6022887	T	C	13	5	18	0	0	18	0	0
20	36713579	rs6064028	G	T	13	9	22	0	1	23	0	0
20	36713594	rs6064029	C	T	14	8	22	0	0	22	0	0
20	36714612	rs6064031	G	C	19	14	33	0	0	33	0	0
20	36715450	rs6022919	G	C	20	19	39	0	0	39	0	0
20	36715822	rs12625508	G	A	19	28	47	0	0	47	0	0
20	36716942	rs6097732	C	A	27	24	51	0	1	52	0	0
20	36718059	rs3746466	G	A	24	17	41	0	0	41	0	0
20	36965617	rs1131847	A	G	33	16	49	0	0	49	0	0
20	37049878	rs1739653	T	C	5	6	11	0	0	11	0	0
20	37050753	rs3752277	A	G	6	7	13	0	0	13	0	0
20	37050817	rs3752278	T	C	4	14	18	0	0	18	0	0
20	37050958	rs61743910	G	A	3	12	15	0	0	15	0	0
20	37050959	rs3752279	A	C	12	3	15	0	0	15	0	0
20	37051007	rs3752280	G	A	10	4	14	0	0	14	0	0
20	37055875	rs707578	T	C	5	2	7	0	0	7	0	0
20	37059349	rs788344	C	T	3	3	6	0	0	6	0	0
20	37059444	rs788345	T	G	4	4	8	0	0	8	0	0
20	37059749	rs788346	T	G	216	99	315	0	0	315	0	0
20	37125857	rs1303577	C	T	2	6	8	0	0	8	0	0
20	37129684	rs73292722	A	G	15	8	23	0	1	24	0	0
20	37129981	rs73292723	G	T	5	5	10	0	0	10	0	0
20	37130080	rs2902674	G	C	5	8	13	0	0	13	0	0
20	37130346	rs6070382	C	T	8	6	14	0	0	14	0	0
20	37147601	rs6070443	C	G	5	3	8	0	0	8	0	0
20	37150718	rs6070459	G	A	3	3	6	0	0	6	0	0
20	37151889	rs11699660	G	C	6	4	10	0	0	10	0	0
20	37168469	rs6070521	G	T	13	13	26	0	0	26	0	0
20	37197667	rs2179664	T	C	2	7	9	0	0	9	0	0
20	37197701	rs1292938	A	C	5	4	9	0	0	9	0	0
20	37199539	rs6070645	T	C	5	4	9	0	0	9	0	0
20	37199879	.	C	A	1	5	6	0	0	6	0	0
20	37200322	rs2206783	A	G	17	9	26	0	0	26	0	0
20	37200566	rs6064724	A	C	3	4	7	0	0	7	0	0
20	37201105	rs7271966	T	C	7	5	12	0	0	12	0	0
20	37205507	rs73294769	C	T	11	9	20	0	0	20	0	0
20	37205892	rs6070663	T	C	14	13	27	0	0	27	0	0
20	37206547	.	A	G	16	21	37	0	0	37	0	0
20	37383640	rs2748663	T	C	9	6	15	0	0	15	0	0
20	37392106	rs2244791	G	A	5	1	6	0	0	6	0	0
20	37400490	rs6128952	G	A	16	15	31	0	0	31	0	0
20	37400506	rs73104029	C	T	17	20	37	0	0	37	0	0
20	37400516	rs62202475	G	T	21	21	42	0	0	42	0	0
20	37437497	rs140825976	G	A	3	5	8	0	0	8	0	0
20	37438824	rs6124079	G	A	6	2	8	0	0	8	0	0
20	37439160	rs11906487	C	T	9	4	13	0	0	13	0	0
20	37440046	rs6101301	T	C	3	4	7	0	0	7	0	0
20	37440386	rs78771342	T	C	3	3	6	0	0	6	0	0
20	37440918	rs6071578	G	T	7	0	7	0	0	7	0	0
20	37445747	rs6129108	C	T	4	3	7	0	0	7	0	0
20	37446985	rs6124087	C	T	5	2	7	0	0	7	0	0
20	37455025	rs62202520	C	G	6	3	9	0	0	9	0	0
20	37455269	rs909865	C	T	8	4	12	0	0	12	0	0
20	37455370	rs6093097	C	A	6	5	11	0	0	11	0	0
20	37455995	rs2015901	C	T	8	8	16	0	1	17	0	0
20	37456205	rs2016946	T	C	6	6	12	0	0	12	0	0
20	37457184	rs6101326	C	G	4	2	6	0	0	6	0	0
20	37461311	rs6015966	G	C	2	4	6	0	0	6	0	0
20	37461354	rs6028157	C	G	7	2	9	0	0	9	0	0
20	37475516	rs6028161	C	T	4	2	6	0	0	6	0	0
20	37549715	rs7266267	C	G	46	40	86	0	0	86	0	0
20	39660112	rs73257891	A	G	3	5	8	0	0	8	0	0
20	39661084	rs74815643	A	G	64	65	129	0	1	130	0	0
20	39663582	rs75709949	C	T	6	4	10	0	0	10	0	0
20	39665750	rs4810309	A	G	8	8	16	0	1	17	0	0
20	39713535	rs6072268	G	A	9	9	18	0	0	18	0	0
20	39718481	rs73259882	T	C	5	4	9	0	0	9	0	0
20	39719202	rs6124315	A	G	6	8	14	0	0	14	0	0
20	39724338	rs6065311	T	C	7	20	27	0	2	29	0	0
20	39740098	rs57772411	C	A	12	8	20	0	0	20	0	0
20	39741069	rs6065312	C	A	15	14	29	0	1	30	0	0
20	39751279	rs73261805	G	A	11	9	20	0	0	20	0	0
20	39792063	rs2228246	A	G	2	9	11	0	2	13	0	0
20	39797465	rs753381	T	C	5	16	21	0	0	21	0	0
20	39813256	rs6072302	C	G	5	4	9	0	0	9	0	0
20	39813729	rs2664537	G	A	3	6	9	0	0	9	0	0
20	39832628	rs17265513	T	C	10	3	13	0	0	13	0	0
20	40032029	rs1156	T	G	45	49	94	0	0	94	0	0
20	40081911	rs6016560	G	A	4	2	6	0	0	6	0	0
20	40094515	rs4812512	C	A	4	6	10	0	0	10	0	0
20	40095031	rs4810320	G	T	4	6	10	0	0	10	0	0
20	40115364	rs6072386	C	G	81	72	153	0	1	154	0	0
20	40116467	rs4812516	C	T	75	49	124	0	1	125	0	0
20	40126679	rs2294564	T	A	12	9	21	0	0	21	0	0
20	40141295	rs2145040	G	A	49	50	99	0	3	102	0	0
20	40155005	rs6093492	C	T	2	4	6	0	0	6	0	0
20	40155375	rs6065367	C	T	2	6	8	0	0	8	0	0
20	42087454	rs6103330	T	C	39	34	73	0	0	73	0	0
20	42089511	rs2235611	T	C	565	592	1157	0	5	1162	0	0
20	42177113	rs916411	G	A	11	0	11	0	0	11	0	0
20	42178435	rs2269623	T	C	15	0	15	0	0	15	0	0
20	42178556	rs2269622	G	C	13	0	13	0	0	13	0	0
20	42179184	rs2269621	C	T	11	0	11	0	0	11	0	0
20	42247585	.	A	G	67	67	134	0	1	135	0	0
20	42825487	rs9875	T	C	160	141	301	0	2	303	0	0
20	42826555	rs1971447	C	A	15	17	32	0	0	32	0	0
20	42826710	rs6103674	C	T	14	23	37	0	0	37	0	0
20	42827286	rs6065709	A	T	6	7	13	0	0	13	0	0
20	42832308	rs13044950	T	C	23	20	43	0	1	44	0	0
20	42832789	rs6073369	C	T	7	5	12	0	0	12	0	0
20	42836152	.	A	C	127	106	233	0	1	234	0	0
20	42838550	rs2143606	A	G	93	108	201	0	2	203	0	0
20	42838712	rs2143607	C	G	117	124	241	0	4	245	0	0
20	42839175	rs41307187	T	C	35	14	49	0	0	49	0	0
20	43123028	rs1983	G	A	5	5	10	0	0	10	0	0
20	43280227	rs73598374	C	T	86	63	149	0	1	150	0	0
20	43530234	rs4931	A	C	225	232	457	0	4	461	0	0
20	43532388	rs6031860	A	G	4	9	13	0	0	13	0	0
20	43532438	rs12481468	T	C	9	13	22	0	0	22	0	0
20	43533286	rs3761188	T	G	22	25	47	0	1	48	0	0
20	43534903	rs16989481	G	A	20	10	30	0	0	30	0	0
20	43535101	rs6876	T	C	99	100	199	0	3	202	0	0
20	43536455	rs8356	C	T	96	77	173	0	3	176	0	0
20	43538733	rs2072727	T	C	2	4	6	0	0	6	0	0
20	43559767	rs13041777	C	G	5	6	11	0	0	11	0	0
20	43579155	rs78968319	C	T	2	4	6	0	0	6	0	0
20	43588189	.	G	A	2	6	8	0	0	8	0	0
20	43956191	rs2076025	T	C	3	3	6	0	0	6	0	0
20	43992645	rs2743419	C	T	2	6	8	0	1	9	0	0
20	43992746	rs6017554	C	T	3	3	6	0	0	6	0	0
20	43993539	rs2743423	T	C	5	5	10	0	0	10	0	0
20	43995880	rs2245717	T	G	107	133	240	0	3	244	1	0
20	43996012	rs2664543	G	T	119	127	246	0	1	247	0	0
20	43996132	rs2664583	C	T	108	104	212	0	2	214	0	0
20	43996189	rs1046612	G	A	134	120	254	0	2	256	0	0
20	43996466	rs707576	C	T	110	88	198	0	1	200	1	0
20	43996807	rs3827039	C	T	50	45	95	0	0	95	0	0
20	43997240	rs2248637	A	G	49	57	106	0	1	107	0	0
20	43997502	rs7098	C	T	60	52	112	0	3	115	0	0
20	43997646	rs7099	C	A	60	56	116	0	0	116	0	0
20	44002665	rs2231626	C	G	3	4	7	0	0	7	0	0
20	44004777	rs760641	T	C	1	5	6	0	0	6	0	0
20	44038574	rs1127497	A	G	15	14	29	0	0	29	0	0
20	44045570	rs1028307	A	C	4	4	8	0	0	8	0	0
20	44047493	rs141420243	G	T	79	24	103	0	0	103	0	0
20	44051187	rs6032173	A	C	4	13	17	0	0	17	0	0
20	44051264	rs6104152	T	C	11	6	17	0	0	17	0	0
20	44051918	rs3091492	G	A	3	5	8	0	0	8	0	0
20	44053069	rs2741566	T	C	10	14	24	0	0	24	0	0
20	44054349	rs707577	T	C	212	244	456	0	2	458	0	0
20	44420682	rs2664591	T	C	2	4	6	0	0	6	0	0
20	44425747	rs73122768	C	T	5	4	9	0	0	9	0	0
20	44425795	rs67571923	C	T	5	5	10	0	0	10	0	0
20	44430740	rs41282768	C	T	5	2	7	0	0	7	0	0
20	44438299	rs399672	G	A	5	3	8	0	0	8	0	0
20	44466270	rs4337538	A	G	5	1	6	0	0	6	0	0
20	44485686	rs73911122	G	A	5	4	9	0	0	9	0	0
20	44511533	rs3746500	G	A	24	15	39	0	0	39	0	0
20	44513357	rs59782893	G	A	10	11	21	0	0	21	0	0
20	44519742	rs117529875	G	A	2	6	8	0	0	8	0	0
20	44523782	rs4608591	C	T	4	5	9	0	0	9	0	0
20	44526783	rs7270170	G	A	4	5	9	0	0	9	0	0
20	44569930	rs6065908	C	T	6	16	22	0	0	22	0	0
20	44571317	rs58749629	G	A	16	16	32	0	0	32	0	0
20	44576502	rs7679	T	C	110	107	217	0	3	220	0	0
20	44582187	rs73128528	A	T	6	1	7	0	0	7	0	0
20	44585420	rs4465830	A	G	6	2	8	0	0	8	0	0
20	44586023	rs3827066	C	T	7	7	14	0	0	14	0	0
20	44637624	rs1805088	C	T	2	6	8	0	0	8	0	0
20	44637678	rs41427445	A	G	2	6	8	0	0	8	0	0
20	44645010	rs20544	C	T	16	19	35	0	0	35	0	0
20	44645153	rs9509	T	C	7	9	16	0	0	16	0	0
20	44690468	rs79600465	C	T	15	16	31	0	0	31	0	0
20	44691350	rs1537028	T	G	15	11	26	0	1	27	0	0
20	44708715	rs112980138	C	T	3	4	7	0	0	7	0	0
20	44717746	rs2206892	C	T	25	44	69	0	1	70	0	0
20	44718227	rs11557123	A	G	5	7	12	0	0	12	0	0
20	44749251	rs4239702	T	C	5	4	9	0	0	9	0	0
20	44750124	rs11700323	G	A	7	7	14	0	0	14	0	0
20	44750125	rs11698468	A	T	7	7	14	0	0	14	0	0
20	44751415	rs11699100	A	G	4	7	11	0	0	11	0	0
20	44753236	rs73115010	T	C	5	7	12	0	0	12	0	0
20	44754858	rs6074028	A	G	6	6	12	0	4	17	1	0
20	44755641	rs113827260	G	T	7	8	15	0	0	15	0	0
20	44757407	rs3765459	G	A	5	6	11	0	0	11	0	0
20	44757475	rs11697349	C	T	4	4	8	0	0	8	0	0
20	45008389	.	T	C	22	30	52	0	1	53	0	0
20	45838368	.	C	A	52	36	88	0	0	88	0	0
20	45839074	rs57342350	A	T	20	14	34	0	1	35	0	0
20	45853037	rs2664544	A	G	26	33	59	0	0	59	0	0
20	45868001	rs16992455	T	C	2	5	7	0	0	7	0	0
20	46258774	rs6094753	G	A	5	3	8	0	0	8	0	0
20	46264888	rs2230782	G	C	72	71	143	0	0	143	0	0
20	46279531	rs2256720	T	C	4	2	6	0	0	6	0	0
20	46279613	rs2745724	G	A	3	3	6	0	0	6	0	0
20	46282346	rs3092417	A	G	115	90	205	0	0	213	8	0
20	46284584	rs2179591	A	G	21	20	41	0	1	42	0	0
20	46365571	rs3810526	A	G	6	5	11	0	0	11	0	0
20	47241618	rs2598	A	G	267	276	543	0	2	545	0	0
20	47242739	.	T	C	69	54	123	0	1	124	0	0
20	47242971	rs6095216	T	G	79	64	143	0	1	144	0	0
20	47256300	rs6019339	C	T	8	8	16	0	0	16	0	0
20	47260645	rs6019342	T	G	10	10	20	0	1	21	0	0
20	47260936	rs6019344	A	G	6	13	19	0	0	19	0	0
20	47262549	rs6012504	C	T	261	280	541	0	5	546	0	0
20	47278601	rs761270	G	C	4	2	6	0	0	6	0	0
20	47291521	rs57135563	C	A	14	10	24	0	0	24	0	0
20	47291776	rs4810850	A	G	19	7	26	0	0	26	0	0
20	47291927	rs4810851	A	G	7	4	11	0	0	11	0	0
20	47292233	rs6019365	G	C	9	11	20	0	0	20	0	0
20	47292329	rs11086258	T	C	3	4	7	0	0	7	0	0
20	47292330	rs11086259	G	A	3	4	7	0	0	7	0	0
20	47293156	rs4810852	A	C	3	4	7	0	0	7	0	0
20	47293180	rs4810853	C	T	2	4	6	0	0	6	0	0
20	47293848	rs56048107	G	T	0	7	7	0	0	7	0	0
20	47294399	rs113459980	C	T	2	19	21	0	1	22	0	0
20	47307618	rs3746820	G	A	200	220	420	0	3	423	0	0
20	47320211	rs2143563	A	G	3	3	6	0	0	6	0	0
20	47325371	rs34240673	G	A	1	8	9	0	0	9	0	0
20	47325830	rs6012518	T	C	3	3	6	0	0	6	0	0
20	47326000	rs6012519	G	A	9	6	15	0	0	15	0	0
20	47326440	rs6019386	T	G	2	4	6	0	0	6	0	0
20	47327442	rs7273568	G	T	1	7	8	0	0	8	0	0
20	47338650	rs2092492	A	G	2	4	6	0	0	6	0	0
20	47352501	rs138701783	G	C	3	5	8	0	0	8	0	0
20	47361610	rs55952330	G	A	261	248	509	0	4	513	0	0
20	47439880	rs115794147	G	A	21	15	36	0	0	36	0	0
20	47440220	rs4809728	C	G	9	7	16	0	0	16	0	0
20	47441883	rs6012538	G	A	3	7	10	0	0	10	0	0
20	47557303	rs73113972	G	T	6	1	7	0	0	7	0	0
20	47586590	rs4810902	A	G	3	3	6	0	0	6	0	0
20	47586618	rs6019565	A	G	4	2	6	0	0	6	0	0
20	47588568	rs6066932	G	A	3	4	7	0	0	7	0	0
20	47589122	rs2273102	T	C	7	5	12	0	0	12	0	0
20	47601696	rs6125511	G	T	6	10	16	0	0	16	0	0
20	47601705	rs6125512	G	A	6	9	15	0	0	15	0	0
20	47614497	rs3764682	C	A	30	20	50	0	0	50	0	0
20	47627170	rs6095396	G	T	8	5	13	0	0	13	0	0
20	47645992	rs11086276	A	C	4	2	6	0	0	6	0	0
20	47648854	rs1022687	C	T	7	6	13	0	0	13	0	0
20	47707944	rs6063351	C	T	3	3	6	0	1	7	0	0
20	47712409	rs2426128	A	G	6	5	11	0	0	11	0	0
20	47713063	rs17632	C	T	30	36	66	0	0	66	0	0
20	47731158	rs1043361	T	C	159	155	314	0	1	315	0	0
20	47731228	rs1043357	A	C	156	196	352	0	4	358	2	0
20	47731767	rs11697370	C	T	5	3	8	0	0	8	0	0
20	47739415	rs3795079	C	T	1	6	7	0	0	7	0	0
20	47748341	rs6125563	C	T	4	4	8	0	0	8	0	0
20	47748375	rs6063360	G	A	3	3	6	0	0	6	0	0
20	47750267	rs62210401	C	T	5	3	8	0	0	8	0	0
20	47760856	rs6066979	A	G	15	10	25	0	1	26	0	0
20	47760857	rs6066980	G	C	15	11	26	0	0	26	0	0
20	47761707	rs62210404	A	T	4	3	7	0	0	7	0	0
20	47762700	rs13044900	G	A	8	2	10	0	0	10	0	0
20	47763558	rs6066982	C	A	4	2	6	0	0	6	0	0
20	47763734	rs348279	T	C	0	6	6	0	0	6	0	0
20	47766197	rs7272164	T	C	8	5	13	0	0	13	0	0
20	47766929	rs8117492	C	T	4	2	6	0	0	6	0	0
20	47848037	rs238171	G	A	6	9	15	0	0	15	0	0
20	47848214	rs238172	C	T	3	8	11	0	0	11	0	0
20	47848715	rs761499	T	G	5	5	10	0	0	10	0	0
20	47849526	rs761497	G	A	5	7	12	0	0	12	0	0
20	47849546	rs6122768	T	C	3	7	10	0	0	10	0	0
20	47850182	rs238148	C	T	128	121	249	0	1	250	0	0
20	47850614	rs1079661	A	T	11	3	14	0	0	14	0	0
20	47850757	rs238149	T	G	6	7	13	0	0	13	0	0
20	47852349	rs487639	T	C	11	7	18	0	0	18	0	0
20	47852354	rs487644	T	C	11	7	18	0	0	18	0	0
20	47852822	rs238152	G	A	1	5	6	0	1	7	0	0
20	47854020	rs6067025	T	C	3	3	6	0	0	6	0	0
20	47854044	rs238153	C	T	4	4	8	0	0	8	0	0
20	47855082	rs238154	G	A	3	10	13	0	0	13	0	0
20	47855159	rs238155	C	G	6	7	13	0	0	13	0	0
20	47859217	rs1130146	G	A	173	151	324	0	0	324	0	0
20	47865372	rs238208	G	A	105	91	196	0	1	197	0	0
20	47865509	rs238209	G	A	84	102	186	0	1	187	0	0
20	47866411	rs6063378	G	A	14	18	32	0	0	32	0	0
20	47866880	rs190220	A	G	8	7	15	0	0	15	0	0
20	47867028	rs171131	A	T	8	14	22	0	0	22	0	0
20	47867592	rs238213	A	G	12	4	16	0	0	16	0	0
20	47867599	rs11696801	T	G	11	4	15	0	0	15	0	0
20	47868862	rs238214	A	T	13	17	30	0	0	30	0	0
20	47869859	rs11698090	T	A	6	2	8	0	0	8	0	0
20	47870506	rs238215	T	C	11	17	28	0	0	28	0	0
20	47870752	rs238216	T	C	14	9	23	0	0	23	0	0
20	47871624	rs238218	C	T	8	3	11	0	2	13	0	0
20	47871729	rs238219	G	A	10	18	28	0	0	28	0	0
20	47872327	rs238220	A	G	7	14	21	0	0	21	0	0
20	47872377	rs238221	C	G	58	60	118	0	1	119	0	0
20	47872900	rs6125600	T	C	11	9	20	0	0	20	0	0
20	47874860	rs192535041	G	A	3	3	6	0	0	6	0	0
20	47879382	rs238175	T	C	6	1	7	0	0	7	0	0
20	47886684	rs57950	G	A	72	51	123	0	0	123	0	0
20	47895197	rs479474	C	T	393	324	717	0	4	721	0	0
20	47896213	rs238195	C	T	14	19	33	0	2	35	0	0
20	47898217	rs238196	G	A	37	27	64	0	0	64	0	0
20	47899486	rs238199	C	T	68	60	128	0	1	129	0	0
20	47899889	rs238201	T	C	52	46	98	0	0	98	0	0
20	47900164	rs6067034	G	A	48	48	96	0	1	97	0	0
20	47900336	rs238202	G	C	53	48	101	0	0	101	0	0
20	47902776	rs237744	T	C	20	18	38	0	1	39	0	0
20	47903344	rs237742	T	C	92	67	159	0	1	160	0	0
20	47903784	rs237740	T	C	49	48	97	0	0	97	0	0
20	47903826	rs6122781	T	G	50	52	102	0	0	102	0	0
20	47904143	rs237739	C	T	52	42	94	0	1	95	0	0
20	47904298	rs6125610	C	T	81	60	141	0	0	141	0	0
20	47904734	rs6125611	G	T	27	19	46	0	0	46	0	0
20	47904920	rs237738	T	C	32	45	77	0	2	79	0	0
20	47905008	rs237737	G	A	64	74	138	0	1	139	0	0
20	47905508	rs8197	G	A	89	72	161	0	2	163	0	0
20	48500761	.	A	G	5	1	6	0	0	6	0	0
20	48501606	rs645544	A	G	3	4	7	0	0	7	0	0
20	48522330	rs495337	G	A	104	100	204	0	2	206	0	0
20	48522585	rs492702	G	A	81	76	157	0	1	158	0	0
20	48697791	rs1049871	T	A	13	12	25	0	0	25	0	0
20	48698923	rs8585	G	A	121	158	279	0	0	279	0	0
20	48705216	rs6012829	C	G	174	45	219	0	0	219	0	0
20	48707556	rs6020247	C	T	18	8	26	0	1	27	0	0
20	48707730	rs2301019	T	C	13	7	20	0	0	20	0	0
20	48707834	rs6020250	C	T	16	7	23	0	0	23	0	0
20	48708747	rs3819905	G	A	5	5	10	0	0	10	0	0
20	48711386	rs6020255	T	C	9	10	19	0	0	19	0	0
20	48711425	rs6020256	C	T	5	8	13	0	1	14	0	0
20	48711570	rs6020257	G	T	7	3	10	0	0	10	0	0
20	48740545	rs2664558	G	A	11	26	37	0	1	38	0	0
20	48741172	rs6125909	A	G	328	339	667	0	7	674	0	0
20	48743796	rs6122877	C	T	5	11	16	0	0	16	0	0
20	48746189	rs6122878	C	T	291	298	589	0	0	589	0	0
20	48765535	rs111410779	C	T	2	4	6	0	0	6	0	0
20	48808011	rs4253439	C	T	68	71	139	0	0	139	0	0
20	48894756	rs3088220	C	T	9	8	17	0	0	17	0	0
20	48894872	rs3761180	T	C	1	5	6	0	0	6	0	0
20	49135299	rs2426156	T	G	3	3	6	0	0	6	0	0
20	49191228	rs1885177	A	C	20	10	30	0	0	30	0	0
20	49191904	rs754118	T	C	18	23	41	0	0	41	0	0
20	49194096	rs2426162	T	C	13	22	35	0	0	35	0	0
20	49194607	rs6020611	A	G	16	26	42	0	0	42	0	0
20	49194615	rs2426163	A	G	19	29	48	0	0	48	0	0
20	49195248	rs968701	G	A	31	60	91	0	1	92	0	0
20	49195359	.	G	T	22	40	62	0	1	63	0	0
20	49195493	rs4809800	C	A	32	48	80	0	0	80	0	0
20	49196167	rs2282147	T	C	20	14	34	0	0	34	0	0
20	49196599	rs718049	C	T	21	37	58	0	0	58	0	0
20	49196602	rs718053	G	A	20	35	55	0	1	56	0	0
20	49196930	rs718050	A	G	15	18	33	0	0	33	0	0
20	49196998	rs3787348	G	T	17	25	42	0	0	42	0	0
20	49197203	rs914460	C	T	18	37	55	0	3	58	0	0
20	49198327	rs2426164	G	A	12	11	23	0	2	25	0	0
20	49457269	rs16995521	A	G	11	0	11	0	2	13	0	0
20	49457753	rs79859497	C	G	6	2	8	0	0	8	0	0
20	49493609	rs6702	G	A	5	9	14	0	0	14	0	0
20	49506195	rs875068	C	G	9	13	22	0	0	22	0	0
20	49506691	.	A	C	3	4	7	0	0	7	0	0
20	49506698	rs910072	A	C	1	6	7	0	0	7	0	0
20	49509184	rs17790938	G	A	112	101	213	0	0	213	0	0
20	49514013	rs4811100	T	C	4	2	6	0	0	6	0	0
20	49520193	rs6020837	C	T	5	8	13	0	0	13	0	0
20	49524451	rs16995592	A	G	4	8	12	0	0	12	0	0
20	49524601	rs16984523	T	C	6	5	11	0	0	11	0	0
20	49525089	rs150215935	G	A	3	4	7	0	0	7	0	0
20	49525434	rs1010944	A	G	4	3	7	0	0	7	0	0
20	49526297	rs73909829	C	T	12	12	24	0	0	24	0	0
20	49526485	rs73909831	C	T	5	5	10	0	0	10	0	0
20	49527371	rs78860779	A	G	2	4	6	0	0	6	0	0
20	49527494	rs16995600	G	A	5	2	7	0	0	7	0	0
20	49527922	rs12480328	T	C	5	6	11	0	0	11	0	0
20	49533949	rs6096186	T	C	4	2	6	0	0	6	0	0
20	49538799	rs2870023	C	T	3	3	6	0	0	6	0	0
20	49542079	rs6091238	A	G	2	4	6	0	0	6	0	0
20	49547665	.	C	T	5	5	10	0	0	10	0	0
20	49554352	rs6020858	A	T	3	3	6	0	0	6	0	0
20	49554764	rs73909843	T	C	3	4	7	0	0	7	0	0
20	49559426	rs56165102	A	G	6	5	11	0	0	11	0	0
20	49567328	rs117851374	A	T	6	18	24	0	0	24	0	0
20	49569025	rs55987409	C	T	3	4	7	0	0	7	0	0
20	49570403	rs73909848	A	G	6	5	11	0	0	11	0	0
20	50004654	rs1052653	T	C	26	20	46	0	0	46	0	0
20	50005077	rs1052649	C	T	4	4	8	0	0	8	0	0
20	50005736	rs2869419	G	C	30	34	64	0	0	64	0	0
20	50007215	rs763944	T	C	8	11	19	0	0	19	0	0
20	50092027	rs6013193	T	G	25	13	38	0	0	38	0	0
20	50287736	rs2255341	C	T	9	34	43	0	0	43	0	0
20	50287790	rs2255342	A	G	7	36	43	0	0	43	0	0
20	50314078	rs13044892	G	A	8	0	8	0	0	8	0	0
20	50327352	rs6126313	C	T	12	1	13	0	0	13	0	0
20	50327716	rs34036696	G	C	12	2	14	0	0	14	0	0
20	50328328	rs1205697	T	G	10	1	11	0	0	11	0	0
20	50328854	rs2426387	C	T	2	8	10	0	0	10	0	0
20	50405502	rs17802735	C	G	9	2	11	0	0	11	0	0
20	50769183	rs3746415	G	A	8	5	13	0	0	13	0	0
20	50769379	rs3746414	C	T	8	8	16	0	0	16	0	0
20	50769549	rs3746413	A	G	3	6	9	0	0	9	0	0
20	52184909	.	G	A	95	77	172	0	5	177	0	0
20	52184944	rs1555926	C	T	73	71	144	0	1	145	0	0
20	52185814	rs4602270	C	A	5	7	12	0	0	12	0	0
20	52185968	rs41274704	C	T	11	9	20	0	0	20	0	0
20	52186784	rs2766672	A	G	9	8	17	0	0	17	0	0
20	52187465	rs8118414	T	C	11	10	21	0	0	21	0	0
20	52192408	rs34495111	C	T	136	91	227	0	2	229	0	0
20	52193368	rs3748503	C	T	124	95	219	0	0	219	0	0
20	52193660	rs35720349	G	A	78	54	132	0	1	133	0	0
20	52193698	rs7270855	G	A	95	68	163	0	1	164	0	0
20	52198340	rs16998248	T	A	83	79	162	0	0	162	0	0
20	52204062	rs6091709	G	A	4	3	7	0	0	7	0	0
20	53691519	rs6098405	C	T	38	0	38	0	5	43	0	0
20	54961463	rs1047972	T	C	3	4	7	0	0	7	0	0
20	54967565	rs2236207	A	G	4	7	11	0	0	11	0	0
20	54979171	rs7806	C	T	12	20	32	0	0	32	0	0
20	54988502	rs6024864	G	A	3	3	6	0	0	6	0	0
20	55012318	rs911159	G	A	46	54	100	0	0	100	0	0
20	55015166	rs927174	A	C	4	2	6	0	0	6	0	0
20	55015237	rs74753154	C	T	0	8	8	0	0	8	0	0
20	55018260	rs7274581	T	C	4	3	7	0	0	7	0	0
20	55020557	rs16979933	T	C	7	6	13	0	0	13	0	0
20	55020689	rs6024881	T	G	4	2	6	0	0	6	0	0
20	55029388	rs4811694	A	G	14	13	27	0	0	27	0	0
20	55029758	rs401897	T	C	24	12	36	0	1	37	0	0
20	55030037	rs6024888	A	G	31	20	51	0	0	51	0	0
20	55030081	rs386274	C	A	24	10	34	0	1	35	0	0
20	55069291	rs2870744	T	G	5	2	7	0	0	7	0	0
20	55069310	rs8123062	T	C	4	2	6	0	0	6	0	0
20	55070664	rs7265697	C	G	3	3	6	0	0	6	0	0
20	55070798	rs6064404	C	T	3	4	7	0	0	7	0	0
20	55070946	rs6064405	C	G	2	5	7	0	0	7	0	0
20	55075991	rs1884419	G	A	8	0	8	0	0	8	0	0
20	55076035	rs1884420	T	A	4	3	7	0	0	7	0	0
20	55077917	rs60654041	C	T	1	5	6	0	0	6	0	0
20	55079036	rs6069766	A	G	4	2	6	0	0	6	0	0
20	55079380	rs34983295	G	A	8	5	13	0	0	13	0	0
20	55080052	rs6099176	T	C	6	2	8	0	0	8	0	0
20	55081256	rs6024914	G	A	10	3	13	0	0	13	0	0
20	55084232	rs6024919	A	G	4	2	6	0	0	6	0	0
20	55085166	rs6014755	T	C	4	3	7	0	0	7	0	0
20	55087041	rs11699883	A	C	7	4	11	0	0	11	0	0
20	55087964	rs11699551	T	C	7	3	10	0	1	11	0	0
20	55087997	rs6099181	C	T	8	5	13	0	0	13	0	0
20	55088404	rs1059768	A	G	304	299	603	0	2	605	0	0
20	55088798	rs13043526	T	C	9	3	12	0	0	12	0	0
20	55093901	rs6999	A	G	54	76	130	0	0	130	0	0
20	55097478	rs6099184	A	G	6	5	11	0	0	11	0	0
20	55099470	rs6024927	T	C	7	6	13	0	0	13	0	0
20	55111371	rs2296130	G	A	17	25	42	0	0	42	0	0
20	55953553	rs6025518	C	T	5	7	12	0	0	12	0	0
20	55959220	rs117329471	C	T	9	3	12	0	0	12	0	0
20	55966904	rs117963839	C	T	12	23	35	0	1	36	0	0
20	55968113	rs439749	G	A	33	39	72	0	0	72	0	0
20	55969116	rs6092472	A	G	39	36	75	0	0	75	0	0
20	55969270	rs1555275	A	G	46	37	83	0	2	85	0	0
20	55969276	rs1555276	G	A	44	35	79	0	6	85	0	0
20	55969492	rs328491	C	T	52	27	79	0	1	80	0	0
20	55969697	rs328492	C	G	33	27	60	0	1	61	0	0
20	55970333	rs2426714	G	A	8	10	18	0	0	18	0	0
20	55970689	rs2426715	C	T	37	21	58	0	0	58	0	0
20	55971012	rs8125560	A	C	33	54	87	0	0	87	0	0
20	55971501	rs2426717	T	A	41	20	61	0	0	61	0	0
20	55971809	rs117621405	C	T	40	35	75	0	0	75	0	0
20	55972965	rs1006645	C	T	62	42	104	0	1	105	0	0
20	55973344	rs35817974	G	A	24	46	70	0	1	71	0	0
20	55975099	rs6014986	T	A	61	61	122	0	0	122	0	0
20	55975714	rs6014987	T	C	36	65	101	0	1	102	0	0
20	55977243	rs4811842	C	T	15	14	29	0	0	29	0	0
20	55977759	rs11905479	G	A	45	54	99	0	2	101	0	0
20	55978153	rs13037066	A	G	55	69	124	0	0	124	0	0
20	55980747	rs73917118	G	A	77	52	129	0	4	133	0	0
20	55982579	rs3764719	T	C	79	93	172	0	4	176	0	0
20	55983073	rs11546710	C	T	1206	1021	2227	0	9	2236	0	0
20	55983695	rs11546711	T	C	1188	1116	2304	0	33	2337	0	0
20	56275806	rs56213462	G	A	7	10	17	0	0	17	0	0
20	56276150	rs60128421	T	C	1	5	6	0	0	6	0	0
20	56276578	rs4810096	G	A	14	2	16	0	0	16	0	0
20	56277224	rs3795093	G	A	3	12	15	0	0	15	0	0
20	56277270	rs6015057	G	A	3	11	14	0	0	14	0	0
20	56277758	.	C	A	10	7	17	0	0	17	0	0
20	56280240	rs73298694	C	T	1	7	8	0	0	8	0	0
20	56280359	rs6025733	A	C	2	5	7	0	0	7	0	0
20	56280433	rs73298699	T	G	3	10	13	0	0	13	0	0
20	56280948	rs59638329	C	T	3	7	10	0	1	11	0	0
20	56281445	rs6015062	T	G	1	8	9	0	0	9	0	0
20	56282050	rs6015063	C	T	0	6	6	0	0	6	0	0
20	56282491	rs4811905	A	G	5	2	7	0	0	7	0	0
20	56282585	rs6025735	C	G	1	5	6	0	0	6	0	0
20	56283302	rs2295582	C	A	10	7	17	0	0	17	0	0
20	56888213	rs527158	C	A	4	2	6	0	0	6	0	0
20	56888641	rs551988	T	C	54	63	117	0	0	117	0	0
20	56902567	rs489355	T	C	4	2	6	0	0	6	0	0
20	56907442	rs531133	A	G	3	5	8	0	0	8	0	0
20	56909926	rs6070428	A	G	3	13	16	0	1	17	0	0
20	56919790	rs111626487	G	A	6	2	8	0	0	8	0	0
20	56932810	rs540250	G	T	3	4	7	0	0	7	0	0
20	56941275	rs1045387	G	A	8	5	13	0	0	13	0	0
20	56941286	rs35136891	C	A	5	8	13	0	0	13	0	0
20	56941728	rs1045402	G	C	7	1	8	0	0	8	0	0
20	56942082	rs1045408	A	T	3	6	9	0	1	10	0	0
20	56942312	rs707557	C	T	8	3	11	0	0	11	0	0
20	57020573	rs1802459	A	G	5	7	12	0	0	12	0	0
20	57253275	rs11578	C	T	86	80	166	0	1	167	0	0
20	57253296	rs4812024	A	G	81	59	140	0	1	141	0	0
20	57253404	rs7683	G	A	79	78	157	0	0	157	0	0
20	57253427	rs111631847	G	A	70	66	136	0	0	136	0	0
20	57253530	rs147429412	G	A	82	62	144	0	1	145	0	0
20	57253640	rs185815575	G	A	53	67	120	0	1	121	0	0
20	57269495	rs7262862	G	A	48	56	104	0	0	104	0	0
20	57290347	.	C	G	68	49	117	0	1	118	0	0
20	57290705	rs12220	T	C	54	42	96	0	1	97	0	0
20	57290846	rs8978	C	T	20	14	34	0	0	34	0	0
20	57480933	rs919197	T	C	4	10	14	0	0	14	0	0
20	57481148	rs3787493	A	G	10	25	35	0	0	35	0	0
20	57481587	rs6015400	C	G	9	6	15	0	0	15	0	0
20	57483655	rs234630	T	C	32	32	64	0	1	65	0	0
20	57483948	rs234629	G	A	19	28	47	0	0	47	0	0
20	57484302	.	C	T	5	9	14	0	0	14	0	0
20	57485611	rs234628	T	C	18	13	31	0	0	31	0	0
20	57563061	rs6070684	C	T	6	2	8	0	0	8	0	0
20	57564489	rs41314904	G	A	15	10	25	0	0	25	0	0
20	57564695	rs17851253	C	T	75	44	119	0	1	120	0	0
20	57566637	rs149265	C	T	17	17	34	0	1	35	0	0
20	57569816	rs7341	G	T	80	138	218	0	1	219	0	0
20	57570456	rs10369	C	T	284	331	615	0	4	619	0	0
20	57571763	rs9760	A	G	246	277	523	0	18	542	1	0
20	57579975	rs236729	T	C	3	3	6	0	0	6	0	0
20	57604343	rs151353	A	C	1	8	9	0	0	9	0	0
20	57606971	rs151354	A	G	2	4	6	0	1	7	0	0
20	57609055	rs151357	A	G	74	87	161	0	5	166	0	0
20	57609590	rs7474	A	G	109	72	181	0	0	181	0	0
20	57610059	rs151358	C	A	142	145	287	0	1	288	0	0
20	57613373	rs151360	T	C	7	5	12	0	0	12	0	0
20	57616650	rs6015423	C	T	5	4	9	0	0	9	0	0
20	57829301	rs259956	T	C	3	4	7	0	0	7	0	0
20	58587841	rs910695	A	C	5	7	12	0	0	12	0	0
20	58644995	rs6071100	T	C	3	3	6	0	0	6	0	0
20	60587666	rs6142920	G	A	2	6	8	0	1	9	0	0
20	60701916	rs147306329	G	A	21	15	36	0	2	38	0	0
20	60768573	rs41284984	C	T	9	6	15	0	0	15	0	0
20	60774035	rs6142990	A	G	3	4	7	0	0	7	0	0
20	60776182	rs1054885	G	A	5	8	13	0	0	13	0	0
20	60776302	rs2184160	G	A	3	3	6	0	0	6	0	0
20	60777171	rs2184156	C	T	5	2	7	0	0	7	0	0
20	60778208	rs1047154	G	T	10	4	14	0	0	14	0	0
20	60778225	rs1047156	G	T	11	7	18	0	0	18	0	0
20	60778301	rs1047164	G	A	13	6	19	0	0	19	0	0
20	60832067	rs3787432	C	T	16	25	41	0	0	41	0	0
20	60848348	rs2236526	C	T	5	3	8	0	0	8	0	0
20	60848835	rs2236525	C	T	6	3	9	0	0	9	0	0
20	60848948	rs2236524	G	A	7	0	7	0	1	8	0	0
20	60850110	rs6142732	A	T	3	9	12	0	0	12	0	0
20	60851579	rs6121975	G	A	3	6	9	0	0	9	0	0
20	60851743	.	G	A	5	6	11	0	0	11	0	0
20	60855449	rs28653375	C	T	5	1	6	0	0	6	0	0
20	60857034	rs2274938	G	A	4	5	9	0	0	9	0	0
20	60858758	rs35636653	C	T	5	1	6	0	0	6	0	0
20	60858776	rs6121538	A	G	5	5	10	0	0	10	0	0
20	60858917	rs2274937	G	A	6	1	7	0	0	7	0	0
20	60859537	rs6121978	A	G	10	2	12	0	0	12	0	0
20	60860916	rs4925367	G	A	27	22	49	0	1	50	0	0
20	60860944	rs4925368	C	T	28	26	54	0	3	57	0	0
20	60861061	rs6089342	G	A	30	35	65	0	0	65	0	0
20	60861782	rs2297592	A	G	25	24	49	0	0	49	0	0
20	60864390	rs3746657	C	T	0	7	7	0	0	7	0	0
20	60867993	rs6062198	G	A	9	0	9	0	1	10	0	0
20	60879829	rs7264166	C	T	7	5	12	0	0	12	0	0
20	60883273	rs2236523	A	C	16	5	21	0	0	21	0	0
20	60962943	rs1043008	T	C	3796	3583	7379	0	42	7422	1	0
20	60963188	rs6121395	G	C	8	11	19	0	0	19	0	0
20	60963494	rs6089356	C	T	232	57	289	0	0	289	0	0
20	60963775	rs709206	T	A	4	4	8	0	0	8	0	0
20	60964064	rs8668	A	G	8	17	25	0	0	25	0	0
20	60964122	rs747949	G	A	4	10	14	0	0	14	0	0
20	60964301	rs747948	C	T	7	6	13	0	0	13	0	0
20	60964629	rs6121396	T	C	5	8	13	0	0	13	0	0
20	60964857	rs13043447	C	T	6	10	16	0	1	17	0	0
20	60965586	rs11697527	C	T	5	5	10	0	0	10	0	0
20	60965677	rs41308711	A	G	3	3	6	0	0	6	0	0
20	60966374	rs13042761	G	C	3	4	7	0	0	7	0	0
20	60973389	rs62196293	A	G	4	2	6	0	0	6	0	0
20	60973432	rs62196294	T	G	3	3	6	0	0	6	0	0
20	61302510	rs6062771	C	T	6	5	11	0	0	11	0	0
20	61303004	rs3787538	T	C	8	9	17	0	0	17	0	0
20	61303535	.	G	A	9	8	17	0	0	17	0	0
20	61429615	rs2294981	C	T	4	3	7	0	0	7	0	0
20	61440971	rs1048792	G	A	113	93	206	0	2	208	0	0
20	61442184	rs11698564	G	A	6	7	13	0	0	13	0	0
20	61443687	rs6122311	G	A	59	79	138	0	1	139	0	0
20	61444939	rs11543349	G	C	48	45	93	0	0	93	0	0
20	61468571	rs2294995	T	C	22	11	33	0	0	33	0	0
20	61491289	.	G	C	2	4	6	0	0	6	0	0
20	61509380	rs144289212	A	C	3	7	10	0	0	10	0	0
20	61545751	rs11544691	G	A	24	45	69	0	0	69	0	0
20	61548621	rs6090162	G	T	5	6	11	0	0	11	0	0
20	61554253	rs145983630	A	C	5	3	8	0	0	8	0	0
20	61561956	.	G	A	16	8	24	0	0	24	0	0
20	61569523	rs8120151	G	C	51	39	90	0	0	90	0	0
20	61599246	rs45569732	C	T	275	267	542	0	4	547	1	0
20	61735112	rs3746746	A	C	7	3	10	0	0	10	0	0
20	61735303	rs750696	C	T	10	10	20	0	0	20	0	0
20	61735419	rs750697	G	A	11	8	19	0	0	19	0	0
20	61735509	rs750698	T	G	7	10	17	0	1	18	0	0
20	61830133	rs3787511	G	A	4	2	6	0	0	6	0	0
20	61834695	rs6122103	G	A	121	137	258	0	1	260	1	0
20	61837559	rs6090300	C	T	3	3	6	0	0	6	0	0
20	61837923	rs6090303	T	C	4	6	10	0	0	10	0	0
20	61838046	rs6122398	T	C	8	4	12	0	0	12	0	0
20	61845953	rs4809505	C	T	2	4	6	0	0	6	0	0
20	61908218	rs187936682	C	T	10	6	16	0	1	17	0	0
20	61915375	rs11086161	G	T	24	20	44	0	0	44	0	0
20	61920102	.	G	A	69	75	144	0	1	145	0	0
20	62190180	rs11551683	A	G	29	18	47	0	1	48	0	0
20	62190345	rs310627	G	A	27	21	48	0	0	48	0	0
20	62190402	rs4809581	T	C	18	28	46	0	1	47	0	0
20	62191937	rs11551685	G	A	24	24	48	0	0	48	0	0
20	62192374	rs3810480	C	T	3	5	8	0	0	8	0	0
20	62200627	.	G	A	5	8	13	0	0	13	0	0
20	62235401	rs111377612	C	T	22	10	32	0	3	35	0	0
20	62235668	rs79210185	C	A	29	45	74	0	0	74	0	0
20	62237024	rs113197729	G	A	3	3	6	0	0	6	0	0
20	62254228	rs78347540	G	A	2	4	6	0	0	6	0	0
20	62321189	rs61753459	C	T	20	18	38	0	2	40	0	0
20	62324290	rs61736615	G	A	15	23	38	0	0	38	0	0
20	62326110	rs3208008	A	C	16	14	30	0	0	30	0	0
20	62327582	rs2297441	G	A	9	1	10	0	0	10	0	0
20	62328267	rs2257440	C	T	11	36	47	0	2	49	0	0
20	62328453	rs2258056	T	C	5	32	37	0	0	37	0	0
20	62328742	rs909341	C	T	12	31	43	0	1	44	0	0
20	62328829	rs1291205	C	G	15	20	35	0	0	35	0	0
20	62329099	rs6062496	G	A	15	3	18	0	0	18	0	0
20	62329169	rs1291206	G	A	4	15	19	0	1	20	0	0
20	62329412	rs1291207	G	A	5	16	21	0	0	21	0	0
20	62331989	rs1048665	T	G	32	50	82	0	1	83	0	0
20	62365556	rs1151622	A	G	34	42	76	0	1	77	0	0
20	62365866	rs2427533	C	T	23	26	49	0	0	49	0	0
20	62366478	rs2427534	A	G	3	9	12	0	0	12	0	0
20	62370349	rs1056441	T	C	3	12	15	0	0	15	0	0
20	62372041	rs1741708	G	T	7	12	19	0	0	19	0	0
20	62372148	rs6062510	G	C	11	4	15	0	0	15	0	0
20	62372706	rs4809221	G	A	19	14	33	0	0	33	0	0
20	62373707	rs8957	G	T	223	276	499	0	0	499	0	0
20	62373983	rs2256814	G	A	6	5	11	0	0	11	0	0
20	62374389	rs1058319	C	T	191	170	361	0	3	364	0	0
20	62376939	rs2296763	A	C	8	13	21	0	0	21	0	0
20	62378121	rs35982738	C	T	0	9	9	0	0	9	0	0
20	62378349	rs5019252	C	T	3	8	11	0	0	11	0	0
20	62378364	rs12625387	C	T	4	9	13	0	0	13	0	0
20	62492772	rs6011193	C	G	10	4	14	0	0	14	0	0
20	62515177	rs35438264	G	C	7	6	13	0	0	13	0	0
20	62515614	rs76057319	C	T	16	8	24	0	0	24	0	0
20	62517549	rs4809241	A	G	16	18	34	0	0	34	0	0
20	62518441	rs3795154	C	T	10	15	25	0	0	25	0	0
20	62518689	rs3795155	C	G	23	19	42	0	0	42	0	0
20	62518729	rs3795156	A	G	22	24	46	0	0	46	0	0
20	62518766	rs3795157	C	T	22	22	44	0	0	44	0	0
20	62520671	rs6062569	T	C	4	13	17	0	0	17	0	0
20	62520674	rs6010690	G	T	2	13	15	0	1	16	0	0
20	62522315	rs8567	A	G	352	316	668	0	8	676	0	0
20	62522466	rs7000	A	G	283	285	568	0	0	568	0	0
20	62573064	rs817370	T	C	6	11	17	0	0	17	0	0
20	62573697	.	A	G	3	5	8	0	0	8	0	0
20	62579034	.	G	A	6	5	11	0	0	11	0	0
20	62579209	rs6011235	G	A	7	8	15	0	0	15	0	0
20	62579655	.	C	T	4	3	7	0	0	7	0	0
20	62579992	.	C	T	7	0	7	0	1	8	0	0
20	62663588	rs188121290	T	C	6	7	13	0	0	13	0	0
20	62663804	rs12624642	G	C	4	8	12	0	0	12	0	0
20	62703490	rs13039439	C	T	7	11	18	0	0	18	0	0
20	62704844	rs75215933	T	C	63	74	137	0	2	139	0	0
20	62887619	rs10470009	A	C	3	4	7	0	0	7	0	0
20	62898588	rs12625099	T	C	4	4	8	0	0	8	0	0
20	62900973	rs3795071	A	G	2	4	6	0	0	6	0	0
20	62905721	rs17492025	G	A	18	22	40	0	4	44	0	0
21	9907345	.	C	T	19	0	19	0	0	19	0	0
21	9907375	.	T	C	14	0	14	0	0	14	0	0
21	9907384	.	G	A	13	0	13	0	0	13	0	0
21	9907397	.	C	T	11	0	11	0	0	11	0	0
21	9907416	rs3887623	C	T	7	0	7	0	0	7	0	0
21	9907592	.	T	C	8	0	8	0	0	8	0	0
21	20230375	.	A	G	0	10	10	0	1	11	0	0
21	34988745	rs6517184	T	C	17	0	17	0	0	17	0	0
21	47419603	rs74852641	G	A	1	8	9	0	0	9	0	0
22	17574341	rs5994160	C	T	6	2	8	0	0	8	0	0
22	17581838	rs2241044	A	C	4	4	8	0	0	8	0	0
22	17585465	rs2302520	G	T	5	6	11	0	0	11	0	0
22	17587515	rs2241048	T	C	1	6	7	0	0	7	0	0
22	17589246	rs879576	G	A	123	116	239	0	2	241	0	0
22	17590180	rs41323645	G	A	22	31	53	0	0	53	0	0
22	17591144	rs3179921	C	T	145	159	304	0	3	307	0	0
22	17591697	rs882644	G	A	100	86	186	0	3	189	0	0
22	17593929	rs5746995	A	G	3	5	8	0	1	9	0	0
22	17594623	rs11702918	C	T	7	6	13	0	0	13	0	0
22	17594755	rs11703539	G	A	8	5	13	0	0	13	0	0
22	17594772	rs12484781	T	A	6	8	14	0	0	14	0	0
22	17594886	rs738035	T	C	14	9	23	0	0	23	0	0
22	17594915	rs738034	G	A	8	6	14	0	1	15	0	0
22	17595070	rs5992628	T	G	9	3	12	0	0	12	0	0
22	17595175	rs62623403	C	T	12	7	19	0	0	19	0	0
22	17596178	rs4819962	T	C	5	14	19	0	0	19	0	0
22	17597462	rs971768	G	A	6	7	13	0	0	13	0	0
22	17599860	rs2277830	A	C	3	4	7	0	0	7	0	0
22	17600293	rs13056456	G	A	3	4	7	0	0	7	0	0
22	17622267	rs2286955	C	T	3	4	7	0	0	7	0	0
22	17640045	rs7287672	G	A	20	20	40	0	0	40	0	0
22	17660407	rs74446184	G	A	25	22	47	0	0	47	0	0
22	17660473	rs76206943	G	A	28	31	59	0	0	59	0	0
22	17660556	rs1135909	T	C	35	25	60	0	0	60	0	0
22	17660615	rs75762931	C	T	16	23	39	0	0	39	0	0
22	17660686	rs74276417	C	T	14	15	29	0	1	30	0	0
22	17661347	rs1139055	C	G	13	11	24	0	0	24	0	0
22	17661764	rs7288562	T	C	6	18	24	0	1	25	0	0
22	17661791	rs7285896	C	T	9	13	22	0	0	22	0	0
22	17661922	rs7289697	C	G	16	9	25	0	0	25	0	0
22	17661935	rs11704850	A	T	15	7	22	0	0	22	0	0
22	17662793	rs7289170	A	G	12	11	23	0	0	23	0	0
22	17690409	rs362129	G	A	5	7	12	0	0	12	0	0
22	17690430	rs7289141	C	G	6	5	11	0	0	11	0	0
22	18209613	rs4488761	A	G	49	48	97	0	0	97	0	0
22	18209920	rs9306198	C	T	61	38	99	0	1	100	0	0
22	18211205	rs9967	T	C	40	62	102	0	0	102	0	0
22	18221167	rs181388	A	G	3	4	7	0	0	7	0	0
22	18222665	rs181392	T	C	2	5	7	0	0	7	0	0
22	18224155	rs181396	G	A	1	6	7	0	0	7	0	0
22	18229774	rs181402	T	C	3	3	6	0	0	6	0	0
22	18232368	rs2895951	G	A	3	3	6	0	0	6	0	0
22	18232653	rs181403	A	T	3	5	8	0	0	8	0	0
22	18232723	rs181404	G	C	3	5	8	0	0	8	0	0
22	18233000	rs181405	G	A	3	4	7	0	0	7	0	0
22	18260425	rs73148873	G	C	8	5	13	0	0	13	0	0
22	18261304	rs5992829	G	A	5	4	9	0	0	9	0	0
22	18261306	rs5992830	G	A	5	4	9	0	0	9	0	0
22	18261323	rs5992831	A	G	5	5	10	0	0	10	0	0
22	18261344	rs5992832	A	G	5	6	11	0	0	11	0	0
22	18261346	rs5992833	A	G	5	5	10	0	1	11	0	0
22	18261496	rs5992834	G	A	7	7	14	0	2	16	0	0
22	18261544	rs5992835	G	A	11	9	20	0	0	20	0	0
22	18261587	rs391085	T	C	8	11	19	0	0	19	0	0
22	18261600	rs5992836	A	T	13	9	22	0	0	22	0	0
22	18261853	rs73148875	T	C	16	7	23	0	0	23	0	0
22	18276426	.	T	C	3	4	7	0	0	7	0	0
22	18278128	rs426276	T	A	5	3	8	0	0	8	0	0
22	18300594	rs11704160	G	A	5	6	11	0	0	11	0	0
22	18300879	rs11704809	G	A	10	9	19	0	0	19	0	0
22	18301190	rs73382765	G	A	6	8	14	0	0	14	0	0
22	18301693	rs8135914	T	C	7	5	12	0	0	12	0	0
22	18569731	rs11703511	T	C	1	6	7	0	0	7	0	0
22	18571008	rs464385	G	A	40	45	85	0	0	85	0	0
22	18572106	rs456551	T	A	19	19	38	0	0	38	0	0
22	18573967	rs1043278	A	G	6	9	15	0	0	15	0	0
22	18574361	rs362226	G	A	6	2	8	0	0	8	0	0
22	18574488	rs80132947	G	A	7	6	13	0	0	13	0	0
22	18579761	rs468784	C	A	4	3	7	0	0	7	0	0
22	18579824	rs467712	C	T	4	2	6	0	0	6	0	0
22	18582650	rs467998	A	C	4	2	6	0	0	6	0	0
22	18894600	rs416659	G	C	2	4	6	0	0	6	0	0
22	18896429	rs5747925	T	C	6	1	7	0	0	7	0	0
22	18896529	rs430748	C	T	3	3	6	0	0	6	0	0
22	18896530	rs430899	A	C	3	3	6	0	0	6	0	0
22	18896709	rs431289	T	C	3	4	7	0	0	7	0	0
22	18907124	rs1076466	G	A	7	0	7	0	0	7	0	0
22	18908875	rs1808320	A	G	15	17	32	0	0	32	0	0
22	18912678	rs4819756	A	G	34	10	44	0	0	44	0	0
22	19024651	rs2073776	C	T	56	60	116	0	0	116	0	0
22	19024695	.	G	A	55	55	110	0	0	110	0	0
22	19025082	rs112819192	C	T	42	29	71	0	2	73	0	0
22	19025330	rs8399	A	C	46	40	86	0	0	86	0	0
22	19025897	rs1894262	C	T	51	41	92	0	0	92	0	0
22	19026025	rs10160	A	G	56	38	94	0	1	95	0	0
22	19026613	rs2072123	A	G	37	38	75	0	1	76	0	0
22	19028320	rs9618453	C	G	11	1	12	0	0	12	0	0
22	19028476	rs2073775	T	C	6	2	8	0	0	8	0	0
22	19028480	rs2073774	T	C	7	2	9	0	0	9	0	0
22	19034079	rs715539	A	T	6	8	14	0	0	14	0	0
22	19034240	rs2012929	A	G	4	9	13	0	0	13	0	0
22	19034829	rs2000996	A	G	5	4	9	0	0	9	0	0
22	19035072	rs17810649	A	G	7	5	12	0	0	12	0	0
22	19109764	rs11550626	A	G	23	12	35	0	0	35	0	0
22	19109812	rs11550627	A	G	22	12	34	0	0	34	0	0
22	19122665	rs2240111	C	T	62	58	120	0	16	136	0	0
22	19123075	rs2240112	T	C	4	8	12	0	0	12	0	0
22	19123952	rs16983371	T	C	3	3	6	0	0	6	0	0
22	19124546	rs5747998	C	G	7	5	12	0	0	12	0	0
22	19125383	rs56326510	A	C	9	5	14	0	0	14	0	0
22	19126631	rs2298273	T	C	6	9	15	0	0	15	0	0
22	19128169	rs7285177	G	A	17	9	26	0	0	26	0	0
22	19128559	rs55754617	C	T	16	18	34	0	0	34	0	0
22	19129672	rs55694607	A	G	10	10	20	0	0	20	0	0
22	19318622	rs1210690	T	C	47	44	91	0	1	92	0	0
22	19386633	rs2238768	T	C	20	6	26	0	0	26	0	0
22	19420306	rs12165902	C	G	7	1	8	0	0	8	0	0
22	19423250	rs7575	G	A	17	24	41	0	1	42	0	0
22	19428511	rs11744	A	G	41	30	71	0	2	73	0	0
22	19431049	rs9606020	C	T	13	13	26	0	0	26	0	0
22	19431485	rs756648	G	A	15	11	26	0	0	26	0	0
22	19432445	rs9606022	A	G	6	6	12	0	0	12	0	0
22	19432456	rs885976	G	A	6	6	12	0	0	12	0	0
22	19438362	rs5748208	A	C	17	27	44	0	1	45	0	0
22	19440597	rs75637138	G	A	12	11	23	0	0	23	0	0
22	19442013	rs2073727	C	T	13	7	20	0	0	20	0	0
22	19445054	rs5746738	G	A	6	1	7	0	0	7	0	0
22	19445576	rs199878217	C	G	1	5	6	0	0	6	0	0
22	19448563	rs8137899	A	G	6	2	8	0	0	8	0	0
22	19451268	rs5748219	G	C	5	3	8	0	1	9	0	0
22	19455376	rs5746742	C	T	6	2	8	0	0	8	0	0
22	19468514	rs13447189	T	C	8	3	11	0	0	11	0	0
22	19712094	rs1059196	C	T	29	23	52	0	0	52	0	0
22	19776019	rs2073768	G	A	11	16	27	0	1	28	0	0
22	19789541	rs2073770	A	C	10	16	26	0	0	26	0	0
22	19833702	rs75763953	T	C	4	5	9	0	0	9	0	0
22	19833781	rs1053001	G	A	7	13	20	0	0	20	0	0
22	19833989	rs1052988	G	A	8	4	12	0	0	12	0	0
22	19834026	rs1052978	A	G	11	2	13	0	0	13	0	0
22	19835110	rs75127693	C	T	8	4	12	0	0	12	0	0
22	19836908	.	T	G	6	2	8	0	0	8	0	0
22	19837575	rs3747066	C	T	5	5	10	0	0	10	0	0
22	19868177	rs192869629	C	T	28	25	53	0	0	53	0	0
22	19868218	rs1139793	A	G	30	19	49	0	1	50	0	0
22	19907099	rs5748469	C	A	18	18	36	0	0	36	0	0
22	19907118	rs5748470	G	A	13	10	23	0	0	23	0	0
22	19949952	rs6269	A	G	9	6	15	0	0	15	0	0
22	19950268	rs740602	G	A	414	435	849	0	6	855	0	0
22	19956781	rs165599	G	A	13	17	30	0	1	31	0	0
22	19957023	rs165728	C	T	19	30	49	0	0	49	0	0
22	19957631	rs9265	C	A	9	15	24	0	0	24	0	0
22	19957763	rs165655	G	A	12	11	23	0	0	23	0	0
22	19957787	rs165840	C	T	12	11	23	0	0	23	0	0
22	19959473	rs165815	C	T	17	8	25	0	0	25	0	0
22	20079603	rs11089328	A	G	3	4	7	0	0	7	0	0
22	20080811	rs9606242	T	C	6	4	10	0	0	10	0	0
22	20080927	rs9606243	A	G	3	3	6	0	0	6	0	0
22	20090038	rs9605063	G	T	8	4	12	0	0	12	0	0
22	20092777	rs9606251	C	A	3	3	6	0	0	6	0	0
22	20097730	rs41281423	C	T	27	29	56	0	0	56	0	0
22	20098882	rs720014	T	C	50	42	92	0	2	94	0	0
22	20099331	rs3757	G	A	14	5	19	0	0	19	0	0
22	20099654	rs9605066	C	T	18	12	30	0	0	30	0	0
22	20100409	rs9606254	C	T	7	4	11	0	0	11	0	0
22	20113253	rs175162	T	G	4	3	7	0	0	7	0	0
22	20127554	rs175174	A	G	16	17	33	0	0	33	0	0
22	20131115	rs9605069	C	T	23	36	59	0	0	59	0	0
22	20131693	rs185173685	A	G	48	45	93	0	1	94	0	0
22	20132638	rs175178	T	A	68	67	135	0	2	137	0	0
22	20132972	rs175179	A	G	70	55	125	0	11	136	0	0
22	20133290	rs11556521	T	C	167	138	305	0	2	307	0	0
22	20134147	rs1974652	A	G	6	2	8	0	0	8	0	0
22	20134350	rs1974653	C	A	4	2	6	0	0	6	0	0
22	20134739	rs9605070	C	T	7	2	9	0	0	9	0	0
22	20135211	rs7290959	T	C	8	13	21	0	0	21	0	0
22	20135383	rs7286804	C	T	5	10	15	0	0	15	0	0
22	20296314	.	C	T	7	4	11	0	0	11	0	0
22	20296321	.	G	A	8	5	13	0	0	13	0	0
22	20296540	rs4995261	T	C	4	4	8	0	0	8	0	0
22	20307256	rs7235	G	A	102	67	169	0	2	171	0	0
22	20796117	rs8353	G	T	13	19	32	0	0	32	0	0
22	20796175	rs9997	T	C	15	18	33	0	0	33	0	0
22	20853607	rs62219897	C	T	2	4	6	0	0	6	0	0
22	20924028	rs165846	A	G	11	9	20	0	0	20	0	0
22	20926295	rs165620	G	C	10	11	21	0	0	21	0	0
22	20926559	rs79995359	G	A	7	12	19	0	0	19	0	0
22	20928130	rs11704626	C	T	17	13	30	0	3	33	0	0
22	20929286	rs165842	C	G	26	15	41	0	0	41	0	0
22	20929782	rs177426	C	A	18	7	25	0	1	26	0	0
22	20932279	rs94001	C	T	24	18	42	0	1	43	0	0
22	20935009	rs73159139	C	T	31	26	57	0	0	57	0	0
22	20935946	rs73159140	G	A	52	42	94	0	1	95	0	0
22	20938175	rs118094808	G	A	13	6	19	0	0	19	0	0
22	20940208	rs165615	T	C	10	4	14	0	0	14	0	0
22	21049940	.	C	T	22	0	22	0	0	22	0	0
22	21049980	.	C	T	22	0	22	0	0	22	0	0
22	21050201	.	C	T	48	0	48	0	0	48	0	0
22	21050235	.	C	G	40	0	40	0	0	40	0	0
22	21050243	.	C	T	33	0	33	0	0	33	0	0
22	21051739	.	A	G	25	0	25	0	0	25	0	0
22	21051859	rs1042668	G	A	0	9	9	0	0	9	0	0
22	21065285	.	A	G	8	8	16	0	0	16	0	0
22	21065932	rs5751786	A	T	6	5	11	0	0	11	0	0
22	21066789	.	A	G	46	16	62	0	0	62	0	0
22	21066897	rs1135929	G	A	36	26	62	0	0	62	0	0
22	21076129	rs4820579	C	T	9	7	16	0	0	16	0	0
22	21076208	rs4822471	G	T	8	7	15	0	0	15	0	0
22	21076753	rs5760196	T	G	4	3	7	0	0	7	0	0
22	21076754	rs5760197	T	C	4	3	7	0	0	7	0	0
22	21076916	rs59987153	A	T	6	5	11	0	0	11	0	0
22	21079909	rs5751806	A	G	3	6	9	0	0	9	0	0
22	21082748	rs56836387	A	C	6	6	12	0	0	12	0	0
22	21090700	rs3091348	C	T	6	2	8	0	0	8	0	0
22	21090744	rs3859860	C	T	10	3	13	0	0	13	0	0
22	21108383	rs76886969	T	A	3	4	7	0	0	7	0	0
22	21113161	rs75177245	G	A	4	2	6	0	0	6	0	0
22	21213380	rs1061063	C	T	14	12	26	0	0	26	0	0
22	21213416	rs1061064	A	G	16	14	30	0	0	30	0	0
22	21242864	rs79383799	C	T	28	37	65	0	0	65	0	0
22	21243687	rs11577	T	G	26	39	65	0	0	65	0	0
22	21245139	rs145199625	G	A	29	33	62	0	1	63	0	0
22	21305049	rs57573660	G	A	118	108	226	0	1	227	0	0
22	21306400	rs1043235	A	G	133	177	310	0	1	311	0	0
22	21306743	rs1043242	A	G	104	100	204	0	0	204	0	0
22	21307388	rs115497413	T	C	94	87	181	0	2	183	0	0
22	21352181	rs178296	T	C	28	22	50	0	1	51	0	0
22	21354970	rs426938	C	G	23	16	39	0	0	39	0	0
22	21474662	.	G	T	17	0	17	0	0	17	0	0
22	21474762	.	T	C	87	0	87	0	2	89	0	0
22	22043909	rs62235099	G	A	0	8	8	0	0	8	0	0
22	22044240	rs8142802	G	T	4	3	7	0	0	7	0	0
22	22046302	rs73382392	T	G	5	4	9	0	0	9	0	0
22	22046318	rs861825	C	T	4	3	7	0	0	7	0	0
22	22048770	rs2070504	C	G	8	2	10	0	0	10	0	0
22	22050234	rs11912412	G	A	9	2	11	0	0	11	0	0
22	22050366	rs73382397	T	C	8	9	17	0	0	17	0	0
22	22051548	rs3209602	G	A	30	60	90	0	0	90	0	0
22	22051761	.	C	T	40	42	82	0	0	82	0	0
22	22052617	rs59916934	A	G	5	5	10	0	1	11	0	0
22	22052814	rs1045681	A	G	10	10	20	0	0	20	0	0
22	22053776	rs7285388	T	C	7	8	15	0	0	15	0	0
22	22053880	rs3747094	A	G	8	7	15	0	0	15	0	0
22	22053885	rs3747095	G	T	8	7	15	0	0	15	0	0
22	22053901	rs73382399	G	A	7	10	17	0	0	17	0	0
22	22054640	rs59864261	T	C	5	6	11	0	0	11	0	0
22	22055280	rs710172	A	G	9	14	23	0	0	23	0	0
22	22055394	rs1860	A	G	14	13	27	0	0	27	0	0
22	22115886	rs13515	C	T	67	71	138	0	2	140	0	0
22	22117502	rs13058	A	C	94	80	174	0	3	177	0	0
22	22119911	rs61757967	C	T	3	3	6	0	0	6	0	0
22	22120381	rs76533939	C	A	6	4	10	0	0	10	0	0
22	22121155	rs2266965	A	G	4	4	8	0	0	8	0	0
22	22121327	rs5755074	C	T	8	6	14	0	0	14	0	0
22	22162126	rs3729910	A	G	45	51	96	0	0	96	0	0
22	22180183	rs7286558	C	T	5	1	6	0	0	6	0	0
22	22180873	rs9610371	A	C	3	4	7	0	0	7	0	0
22	22274211	rs5756076	C	T	204	206	410	0	0	410	0	0
22	22274550	rs143895538	C	T	154	158	312	0	3	315	0	0
22	22275006	rs2073415	G	A	240	237	477	0	3	480	0	0
22	22277307	rs2070506	C	T	197	190	387	0	4	391	0	0
22	22277571	rs2070507	A	C	158	96	254	0	0	254	0	0
22	22280917	rs738858	C	G	8	5	13	0	0	13	0	0
22	22282263	rs2329884	C	T	7	3	10	0	0	10	0	0
22	22282776	rs894095	A	G	11	5	16	0	0	16	0	0
22	22284357	rs2083565	C	T	4	2	6	0	0	6	0	0
22	22287862	rs2027789	G	A	185	149	334	0	0	334	0	0
22	22287964	rs2027790	T	C	3	3	6	0	0	6	0	0
22	22311882	.	G	A	30	0	30	0	0	30	0	0
22	22312484	rs2266971	C	T	10	2	12	0	0	12	0	0
22	22313733	rs75104161	G	A	6	4	10	0	0	10	0	0
22	22316157	rs9610720	C	T	5	1	6	0	0	6	0	0
22	22333025	rs11703249	C	T	3	6	9	0	0	9	0	0
22	22470651	rs5750530	A	G	8	0	8	0	0	8	0	0
22	22471884	rs1934535	T	C	17	0	17	0	1	18	0	0
22	22471985	rs6000999	A	G	26	0	26	0	0	26	0	0
22	22472029	rs6001000	T	C	23	0	23	0	0	23	0	0
22	22472059	rs8136946	A	G	25	0	25	0	0	25	0	0
22	22472099	rs8135482	G	A	19	0	19	0	1	20	0	0
22	22472191	rs149448276	T	C	12	0	12	0	0	12	0	0
22	22599674	rs5995719	C	T	10	50	60	0	1	61	0	0
22	22599705	rs5995720	G	A	9	45	54	0	3	57	0	0
22	22599764	rs6001563	A	G	11	46	57	0	0	57	0	0
22	22661173	rs7410785	T	C	23	136	159	0	11	170	0	0
22	22661181	rs73880611	C	G	20	147	167	0	6	173	0	0
22	22661318	.	T	C	123	120	243	0	1	244	0	0
22	22661626	rs2329974	T	C	55	93	148	0	0	148	0	0
22	22661662	rs1044448	A	T	25	48	73	0	0	73	0	0
22	22662770	rs10427551	T	A	4	11	15	0	0	15	0	0
22	22662940	rs11702949	T	C	5	4	9	0	0	9	0	0
22	22663086	rs1054157	T	G	7	1	8	0	0	8	0	0
22	22663087	rs1054158	A	G	7	1	8	0	0	8	0	0
22	22663668	rs3966372	G	A	11	6	17	0	0	17	0	0
22	22664158	.	G	A	10	2	12	0	0	12	0	0
22	22664215	.	C	T	10	1	11	0	0	11	0	0
22	22664639	rs9306349	G	A	8	5	13	0	1	14	0	0
22	22673639	rs737765	T	C	6	3	9	0	0	9	0	0
22	22674600	rs2012017	A	C	8	3	11	0	0	11	0	0
22	22674650	rs6001780	C	T	9	2	11	0	3	14	0	0
22	22675412	rs8142426	T	C	14	12	26	0	0	26	0	0
22	22677176	rs11704294	T	C	69	4	73	0	3	77	1	0
22	22677182	rs11703618	C	A	57	11	68	0	4	74	2	0
22	22712467	rs5757973	T	G	14	7	21	0	0	22	1	0
22	22724341	rs9607803	A	C	0	6	6	0	0	6	0	0
22	22764350	rs186944811	G	A	42	30	72	0	1	74	1	0
22	23040462	rs1312	T	C	14	30	44	0	1	45	0	0
22	23040767	rs5751516	G	T	2	7	9	0	0	9	0	0
22	23055421	rs1985790	G	A	94	10	104	0	0	104	0	0
22	23055440	rs1008910	C	A	85	3	88	0	1	95	6	0
22	23055533	rs4446155	G	A	38	4	42	0	1	44	1	0
22	23055539	rs1985791	G	T	41	3	44	0	0	48	4	0
22	23101523	rs3737543	G	A	16	37	53	0	0	55	2	0
22	23248549	.	G	A	79	15	94	0	2	96	0	0
22	23248758	.	G	A	163	91	254	0	2	256	0	0
22	23248839	rs7117	A	T	58	45	103	0	0	103	0	0
22	23545434	rs5759646	C	A	2	7	9	0	0	9	0	0
22	23545879	rs2267013	A	G	135	146	281	0	4	285	0	0
22	23575660	rs5759653	C	T	3	3	6	0	0	6	0	0
22	23585132	rs1004040	A	G	3	5	8	0	0	8	0	0
22	23603957	rs5759667	T	G	6	10	16	0	0	16	0	0
22	23606384	rs5759668	C	T	87	53	140	0	3	143	0	0
22	23606659	.	T	C	40	76	116	0	0	116	0	0
22	23606747	rs6003593	C	A	60	52	112	0	2	114	0	0
22	23606958	rs1811017	A	G	97	93	190	0	2	192	0	0
22	23606965	rs1811018	G	A	102	100	202	0	0	202	0	0
22	23616878	rs6003599	G	A	1	5	6	0	0	6	0	0
22	23631801	rs2227939	T	C	443	569	1012	0	11	1023	0	0
22	23631823	rs62219796	T	C	4	4	8	0	0	8	0	0
22	23632257	rs9608100	A	G	9	3	12	0	0	12	0	0
22	23632513	rs16802	A	G	3	11	14	0	0	14	0	0
22	23635374	rs5751621	G	A	7	4	11	0	0	11	0	0
22	23635924	rs5996516	G	C	4	4	8	0	0	8	0	0
22	23635987	rs12484808	A	C	6	3	9	0	0	9	0	0
22	23636118	rs2267023	A	G	4	4	8	0	1	9	0	0
22	23636339	rs2267024	C	T	4	4	8	0	0	8	0	0
22	23637200	rs2239666	T	C	6	4	10	0	0	10	0	0
22	23637664	rs8138857	A	G	9	8	17	0	0	17	0	0
22	23638635	rs5759686	C	T	15	9	24	0	0	24	0	0
22	23639408	.	G	T	11	2	13	0	0	13	0	0
22	23639415	rs11705139	T	G	3	10	13	0	0	13	0	0
22	23639534	rs5751624	A	G	12	11	23	0	0	23	0	0
22	23639971	rs73152664	A	G	21	18	39	0	0	39	0	0
22	23639984	rs73152666	A	G	19	14	33	0	1	34	0	0
22	23640470	rs5759687	G	C	16	9	25	0	0	25	0	0
22	23643247	rs5751625	T	C	29	27	56	0	1	57	0	0
22	23643482	rs5759690	G	A	21	26	47	0	1	48	0	0
22	23643530	rs5759691	G	T	22	25	47	0	0	47	0	0
22	23644314	rs5759692	G	A	37	31	68	0	3	71	0	0
22	23647040	rs2032112	G	A	9	4	13	0	0	13	0	0
22	23648478	rs2267027	C	T	6	4	10	0	0	10	0	0
22	23650622	rs131701	A	T	3	5	8	0	0	8	0	0
22	23650847	rs5751628	A	G	7	6	13	0	0	13	0	0
22	23650987	rs131702	G	T	10	13	23	0	0	23	0	0
22	23651101	rs5759695	T	G	10	3	13	0	0	13	0	0
22	23651206	rs28465412	A	G	7	7	14	0	0	14	0	0
22	23651215	rs143777398	A	G	6	7	13	0	0	13	0	0
22	23651303	rs2267028	G	A	6	5	11	0	1	12	0	0
22	23652201	rs131703	A	G	13	2	15	0	1	16	0	0
22	23652212	rs140509	C	T	16	3	19	0	0	19	0	0
22	23652956	rs180797	C	T	12	4	16	0	0	16	0	0
22	23653555	.	T	C	13	10	23	0	0	23	0	0
22	23653850	.	G	C	15	0	15	0	0	15	0	0
22	23653880	rs180801	G	A	12	3	15	0	1	16	0	0
22	23654436	rs5759698	A	G	26	15	41	0	0	41	0	0
22	23654740	rs201772177	T	C	7	3	10	0	0	10	0	0
22	23654993	rs180805	A	G	27	19	46	0	0	46	0	0
22	23655219	rs180806	G	A	21	18	39	0	1	40	0	0
22	23655620	rs180807	T	C	9	9	18	0	0	18	0	0
22	23657225	.	T	C	6	3	9	0	1	10	0	0
22	23657226	rs570445890	G	A	7	3	10	0	0	10	0	0
22	23657241	.	T	C	6	3	9	0	0	9	0	0
22	23657252	.	A	G	6	2	8	0	0	8	0	0
22	23657266	rs2330379	C	T	6	1	7	0	0	7	0	0
22	23657735	rs180812	G	A	684	678	1362	0	5	1368	1	0
22	23657874	rs392389	A	G	644	426	1070	0	8	1078	0	0
22	23657875	rs440531	A	C	636	429	1065	0	12	1077	0	0
22	23657939	rs113629387	T	C	560	426	986	0	9	996	1	0
22	23657970	rs28573708	T	G	394	498	892	0	6	899	1	0
22	23658007	rs180817	G	A	377	317	694	0	8	702	0	0
22	23658968	.	A	G	0	21	21	0	0	21	0	0
22	23659068	rs5759705	C	T	6	54	60	0	0	60	0	0
22	23659533	rs28650060	C	T	68	37	105	0	0	105	0	0
22	23659749	rs199867487	A	G	5	12	17	0	0	17	0	0
22	24129240	rs11090285	C	T	24	36	60	0	0	60	0	0
22	24168998	rs55858347	A	G	4	6	10	0	0	10	0	0
22	24171201	rs3788363	C	T	5	6	11	0	1	12	0	0
22	24172449	rs9608203	G	A	9	8	17	0	0	17	0	0
22	24174303	rs5760060	G	A	6	8	14	0	0	14	0	0
22	24175101	rs17003993	T	C	6	5	11	0	0	11	0	0
22	24175208	rs2267044	G	A	4	14	18	0	0	18	0	0
22	24237221	rs2070766	C	G	6	33	39	0	0	39	0	0
22	24314006	rs1006771	G	T	4	8	12	0	0	12	0	0
22	24503820	rs9608238	C	T	5	4	9	0	0	9	0	0
22	24507460	rs78946667	G	A	7	7	14	0	0	14	0	0
22	24622648	rs2275984	T	C	36	25	61	0	0	61	0	0
22	24654902	.	T	C	7	0	7	0	1	8	0	0
22	24655227	rs28625949	G	A	21	0	21	0	1	22	0	0
22	24655282	rs28368772	C	A	27	0	27	0	0	27	0	0
22	24717518	rs3747113	G	A	39	44	83	0	2	85	0	0
22	24737868	rs738811	A	C	2	5	7	0	0	7	0	0
22	24792663	rs73167602	A	T	4	6	10	0	0	10	0	0
22	24811667	rs3747114	G	A	73	82	155	0	2	157	0	0
22	24812377	rs3747115	T	C	82	98	180	0	19	199	0	0
22	24821764	rs116704292	G	A	2	4	6	0	0	6	0	0
22	24825511	rs2298383	C	T	3	6	9	0	0	9	0	0
22	24826085	rs5760414	T	C	7	3	10	0	0	10	0	0
22	24826155	rs3761420	G	A	5	6	11	0	0	11	0	0
22	24827571	rs150722843	G	A	4	5	9	0	0	9	0	0
22	24827622	rs5996696	A	C	4	6	10	0	0	10	0	0
22	24828853	rs71651683	C	T	9	8	17	0	0	17	0	0
22	24830400	rs75727533	C	A	4	2	6	0	0	6	0	0
22	24830401	rs80355897	C	A	4	2	6	0	0	6	0	0
22	24832547	rs17004919	A	G	3	5	8	0	0	8	0	0
22	24833760	rs4822489	T	G	1	5	6	0	0	6	0	0
22	24834564	rs17004920	G	C	5	8	13	0	0	13	0	0
22	24919920	rs75314055	G	C	3	3	6	0	0	6	0	0
22	24936970	rs9704	A	G	282	312	594	0	1	595	0	0
22	24937487	rs2011947	A	G	134	138	272	0	1	273	0	0
22	24938455	rs1004134	T	A	219	186	405	0	5	410	0	0
22	24938908	rs8139822	A	G	218	213	431	0	3	434	0	0
22	24940196	rs1008550	T	G	4	10	14	0	0	14	0	0
22	24940959	rs743367	C	T	1	5	6	0	0	6	0	0
22	24943409	rs75978243	T	C	11	8	19	0	0	19	0	0
22	24943658	rs762284	T	C	23	12	35	0	0	35	0	0
22	24944782	rs1003580	A	G	12	18	30	0	0	30	0	0
22	24945385	rs16978652	G	A	5	3	8	0	0	8	0	0
22	24945739	rs9612654	C	G	7	5	12	0	0	12	0	0
22	24946522	rs7292105	G	C	6	2	8	0	0	8	0	0
22	24948172	rs4820595	A	G	4	4	8	0	0	8	0	0
22	24949130	rs80051910	T	C	3	6	9	0	0	9	0	0
22	24949953	rs7290144	G	C	4	3	7	0	1	8	0	0
22	24951556	rs114059315	C	T	8	12	20	0	0	20	0	0
22	24964128	rs4597	T	C	103	144	247	0	4	251	0	0
22	24970107	rs762286	A	G	29	22	51	0	0	52	1	0
22	24979004	rs77154974	T	C	4	3	7	0	0	7	0	0
22	24979447	rs2236626	C	T	9	0	9	0	0	9	0	0
22	24981880	rs116161010	C	T	8	8	16	0	0	16	0	0
22	25004987	rs57719575	G	C	1	23	24	0	0	24	0	0
22	25048069	rs28470624	G	A	14	0	14	0	0	14	0	0
22	25574507	.	C	G	0	354	354	0	0	354	0	0
22	25748718	rs133188	A	G	75	86	161	0	2	163	0	0
22	25749257	rs12485018	C	T	5	16	21	0	2	23	0	0
22	25750873	rs133189	G	A	10	13	23	0	0	23	0	0
22	25750932	rs149245368	A	C	15	11	26	0	0	26	0	0
22	25751415	rs5752142	C	T	12	10	22	0	0	22	0	0
22	25753777	rs5996921	A	G	15	23	38	0	0	38	0	0
22	25753970	rs5996922	G	A	15	20	35	0	0	35	0	0
22	25754259	rs5761045	G	A	26	14	40	0	0	40	0	0
22	25754412	rs7288967	C	T	32	24	56	0	0	56	0	0
22	25754505	rs5761046	G	A	27	24	51	0	1	52	0	0
22	25754600	rs133195	A	G	26	20	46	0	1	47	0	0
22	25755315	rs5761047	A	T	17	15	32	0	0	32	0	0
22	25755599	rs5761048	G	A	14	20	34	0	0	34	0	0
22	25755895	rs151010331	A	G	123	102	225	0	1	226	0	0
22	25756674	rs133198	C	T	25	37	62	0	0	62	0	0
22	25756679	rs141967952	A	C	27	34	61	0	0	61	0	0
22	25757268	rs133201	A	G	27	27	54	0	0	54	0	0
22	25757270	rs12485036	T	C	27	27	54	0	0	54	0	0
22	25761258	rs9620521	G	C	35	19	54	0	0	54	0	0
22	25761936	rs713847	C	T	24	16	40	0	1	41	0	0
22	25762010	rs713878	T	C	10	16	26	0	0	26	0	0
22	25768387	rs78345670	T	C	16	15	31	0	0	31	0	0
22	25769225	rs6004609	G	A	23	16	39	0	2	41	0	0
22	25769265	rs12484419	G	A	16	15	31	0	0	31	0	0
22	25770473	rs133215	T	C	23	13	36	0	0	36	0	0
22	25771156	rs133217	A	G	12	13	25	0	0	25	0	0
22	25775263	rs5996924	G	A	4	8	12	0	0	12	0	0
22	25775535	rs5761054	C	T	5	2	7	0	0	7	0	0
22	25776260	rs150206843	C	T	12	9	21	0	0	21	0	0
22	25776810	rs6004610	T	G	3	5	8	0	0	8	0	0
22	25779754	rs13053438	G	A	15	23	38	0	0	38	0	0
22	25780117	rs11704398	G	A	28	23	51	0	0	51	0	0
22	25783704	rs79288	A	G	15	12	27	0	0	27	0	0
22	25784184	rs10222309	A	G	7	12	19	0	0	19	0	0
22	25784405	rs10222306	C	A	4	9	13	0	0	13	0	0
22	25784853	rs9624813	G	A	10	8	18	0	0	18	0	0
22	25786161	rs8139955	C	T	9	5	14	0	0	14	0	0
22	25786422	rs10222259	A	G	7	6	13	0	1	14	0	0
22	25788542	rs6004618	T	C	7	9	16	0	0	16	0	0
22	25788649	rs6004619	A	G	5	8	13	0	0	13	0	0
22	25788807	rs6004620	G	A	7	4	11	0	0	11	0	0
22	25788854	rs6004621	C	T	4	6	10	0	0	10	0	0
22	25788912	rs133225	A	G	5	5	10	0	1	11	0	0
22	25789037	rs6004622	C	A	6	12	18	0	0	18	0	0
22	25789324	rs11703146	G	A	6	1	7	0	0	7	0	0
22	25790339	rs1207634	G	A	7	3	10	0	0	10	0	0
22	25790501	rs133227	T	C	9	6	15	0	0	15	0	0
22	25790680	rs5996926	C	T	11	6	17	0	0	17	0	0
22	25790799	rs4356757	T	A	7	6	13	0	0	13	0	0
22	25791286	rs5996927	G	C	3	5	8	0	2	10	0	0
22	25791356	rs5996928	A	G	3	5	8	0	0	8	0	0
22	25791463	rs5996929	G	A	4	6	10	0	0	10	0	0
22	25792267	rs11090388	T	C	4	12	16	0	0	16	0	0
22	25792699	rs8139495	A	G	4	6	10	0	0	10	0	0
22	25792735	rs7287614	G	A	8	4	12	0	0	12	0	0
22	25792984	rs7287976	G	A	5	2	7	0	0	7	0	0
22	25793019	rs133230	A	G	5	2	7	0	0	7	0	0
22	25794500	rs6004624	A	G	6	6	12	0	0	12	0	0
22	25796594	rs133231	A	C	3	3	6	0	0	6	0	0
22	25799013	rs84487	T	C	3	6	9	0	0	9	0	0
22	25799024	rs126225	T	A	6	7	13	0	0	13	0	0
22	25799113	rs2331038	T	C	7	5	12	0	0	12	0	0
22	25800512	rs1207616	T	G	3	3	6	0	0	6	0	0
22	26111018	rs9608416	G	A	4	3	7	0	0	7	0	0
22	26830424	.	G	A	1	5	6	0	0	6	0	0
22	26839213	rs35429415	G	A	5	9	14	0	0	14	0	0
22	26839657	rs5761525	T	A	2	4	6	0	0	6	0	0
22	26859942	rs5752330	C	T	38	46	84	0	1	85	0	0
22	26861545	rs3213583	A	G	10	5	15	0	0	15	0	0
22	26862153	rs739289	C	A	4	10	14	0	0	14	0	0
22	26862212	rs713998	T	C	56	42	98	0	0	98	0	0
22	26863032	rs5761546	G	T	5	7	12	0	0	12	0	0
22	26863093	rs5761547	C	T	4	8	12	0	0	12	0	0
22	26863559	rs737800	T	C	7	9	16	0	0	16	0	0
22	26863639	rs737801	A	G	7	12	19	0	0	19	0	0
22	26866723	rs13054747	C	T	35	31	66	0	1	67	0	0
22	26871068	rs2331252	C	T	6	2	8	0	0	8	0	0
22	26877981	rs3747134	G	A	38	40	78	0	1	79	0	0
22	26878024	rs5761557	A	G	41	37	78	0	2	80	0	0
22	26880006	rs371251054	C	T	3	4	7	0	1	8	0	0
22	26884039	rs4820682	G	A	27	14	41	0	0	41	0	0
22	26886702	rs4822726	T	G	2	5	7	0	1	8	0	0
22	26886882	.	C	T	6	4	10	0	0	10	0	0
22	26887829	rs1045523	A	G	26	22	48	0	1	49	0	0
22	26888060	rs17850763	G	A	154	125	279	0	4	283	0	0
22	26888725	rs2032574	T	C	9	8	17	0	1	18	0	0
22	26889564	rs4822727	C	T	5	9	14	0	1	15	0	0
22	26891808	rs4822728	C	T	6	2	8	0	0	8	0	0
22	26891823	rs4822729	C	G	8	3	11	0	0	11	0	0
22	26892392	rs73880110	A	T	7	1	8	0	0	8	0	0
22	26893912	rs5752336	G	A	1	5	6	0	0	6	0	0
22	26894117	rs5761564	A	G	3	6	9	0	0	9	0	0
22	26894165	rs34026915	A	G	5	2	7	0	0	7	0	0
22	26895337	rs1008530	G	A	89	73	162	0	1	163	0	0
22	26910207	rs35044058	A	G	4	4	8	0	0	8	0	0
22	26921725	rs4275	A	G	14	24	38	0	0	38	0	0
22	26931221	rs4149478	C	T	9	1	10	0	0	10	0	0
22	26932150	rs3752523	G	A	14	9	23	0	0	23	0	0
22	26936897	rs12169509	G	A	74	100	174	0	0	174	0	0
22	26937327	rs4822735	C	G	24	22	46	0	1	47	0	0
22	26957136	rs41281589	T	C	12	0	12	0	1	13	0	0
22	28145605	rs17476776	C	T	171	164	335	0	10	345	0	0
22	28159672	rs5762347	G	A	0	6	6	0	0	6	0	0
22	28160616	rs45513196	A	C	6	0	6	0	0	6	0	0
22	28195386	rs45589338	C	A	23	22	45	0	1	46	0	0
22	28272328	rs5762393	G	A	4	2	6	0	0	6	0	0
22	28318032	rs5752658	A	G	21	22	43	0	0	43	0	0
22	28374216	rs2142561	T	C	28	26	54	0	0	54	0	0
22	28374219	rs7625	G	A	27	27	54	0	0	54	0	0
22	28375675	rs2294820	A	G	12	10	22	0	0	22	0	0
22	28378472	rs5762430	A	G	12	25	37	0	1	38	0	0
22	28393540	rs138650	C	T	7	3	10	0	0	10	0	0
22	29130458	rs1805129	T	C	29	17	46	0	0	46	0	0
22	29153372	rs189159237	C	A	15	18	33	0	1	34	0	0
22	29168755	rs11556025	T	C	3	6	9	0	0	9	0	0
22	29179739	rs2347447	C	A	6	5	11	0	0	11	0	0
22	29180934	rs114950881	T	G	6	0	6	0	0	6	0	0
22	29182500	rs5762795	C	A	124	127	251	0	3	254	0	0
22	29183133	rs6005881	A	G	45	36	81	0	5	86	0	0
22	29191879	rs2097461	T	C	13	19	32	0	0	32	0	0
22	29192670	rs2239815	T	C	60	68	128	0	0	128	0	0
22	29193638	rs5762803	G	C	35	23	58	0	0	58	0	0
22	29630337	rs3950176	G	A	62	46	108	0	4	112	0	0
22	29655371	rs8550	C	T	69	84	153	0	6	159	0	0
22	29656389	rs2231398	G	T	40	51	91	0	1	92	0	0
22	29669712	rs55801595	C	G	34	32	66	0	1	67	0	0
22	29676832	rs141031975	T	G	5	8	13	0	1	14	0	0
22	29676862	.	T	G	5	1	6	0	1	7	0	0
22	29677164	rs5997460	A	G	14	10	24	0	0	24	0	0
22	29677967	rs5752899	C	A	12	13	25	0	0	25	0	0
22	29681216	rs131184	A	G	11	12	23	0	0	23	0	0
22	29685752	rs5763131	A	G	16	17	33	0	0	33	0	0
22	29686918	rs149841245	T	C	154	136	290	0	4	294	0	0
22	29692488	rs140065	G	T	2	5	7	0	0	7	0	0
22	29692497	rs131190	G	T	2	4	6	0	0	6	0	0
22	29693640	rs5752900	G	A	7	7	14	0	0	14	0	0
22	29695929	rs2518683	T	G	4	5	9	0	0	9	0	0
22	29748655	rs4823032	T	C	3	4	7	0	1	8	0	0
22	29748859	rs8140836	G	A	5	5	10	0	0	10	0	0
22	29750186	rs3788412	T	C	6	1	7	0	0	7	0	0
22	29751030	rs6006103	G	C	10	8	18	0	2	20	0	0
22	29752180	rs4823033	C	G	8	16	24	0	0	24	0	0
22	29887186	rs710195	G	C	1	5	6	0	0	6	0	0
22	29908072	rs1049534	C	T	75	50	125	0	1	126	0	0
22	29951650	rs7609	A	T	37	33	70	0	0	70	0	0
22	29957570	rs1058642	G	A	38	27	65	0	0	65	0	0
22	30367857	rs737906	T	C	21	28	49	0	0	49	0	0
22	30374281	rs9306468	T	C	4	3	7	0	0	7	0	0
22	30395834	rs1807508	C	T	1	5	6	0	0	6	0	0
22	30412759	rs17647135	T	C	17	20	37	0	0	37	0	0
22	30413339	rs41165	C	T	10	19	29	0	1	30	0	0
22	30418161	rs41168	A	C	10	11	21	0	0	21	0	0
22	30422107	rs41171	C	G	64	70	134	0	0	135	1	0
22	30424863	rs41173	C	G	16	18	34	0	0	34	0	0
22	30432502	rs12627944	G	A	5	1	6	0	0	6	0	0
22	30636706	rs9606706	C	T	10	0	10	0	0	10	0	0
22	30638664	rs8136774	C	T	2	4	6	0	0	6	0	0
22	30659566	rs2070889	G	A	172	155	327	0	1	329	1	0
22	30661184	rs5763918	T	C	24	29	53	0	0	54	1	0
22	30661480	rs78568412	T	C	25	23	48	0	0	48	0	0
22	30662183	.	C	G	12	18	30	0	0	30	0	0
22	30683199	.	C	T	9	4	13	0	0	13	0	0
22	30691307	rs737805	G	A	18	11	29	0	1	30	0	0
22	30694634	rs79386338	T	C	10	8	18	0	0	18	0	0
22	30700924	rs2240422	C	T	2	4	6	0	0	6	0	0
22	30717906	rs80104181	G	C	2	7	9	0	0	9	0	0
22	30736921	rs117444066	T	G	2	14	16	0	0	16	0	0
22	30737015	rs5749068	C	T	1	12	13	0	0	13	0	0
22	30737771	rs34244534	G	T	243	171	414	0	8	422	0	0
22	30738587	rs2074733	T	C	7	16	23	0	0	23	0	0
22	30739174	rs75265757	G	A	2	4	6	0	0	6	0	0
22	30740914	rs114214629	C	G	1	5	6	0	0	6	0	0
22	30782089	rs5997629	A	G	21	22	43	0	0	43	0	0
22	30823196	rs5753130	T	C	12	16	28	0	0	28	0	0
22	30824621	rs114347202	A	T	9	17	26	0	0	26	0	0
22	30977353	rs42942	T	A	123	112	235	0	2	237	0	0
22	30981660	.	A	C	7	5	12	0	0	12	0	0
22	31013419	rs9621049	C	T	105	79	184	0	2	186	0	0
22	31022590	rs12169610	C	T	138	75	213	0	1	214	0	0
22	31022635	rs12160073	C	T	71	124	195	0	1	196	0	0
22	31043766	rs3179442	G	A	4	2	6	0	0	6	0	0
22	31058115	rs8630	G	A	5	2	7	0	0	7	0	0
22	31060029	rs1005887	G	C	3	5	8	0	0	8	0	0
22	31283719	rs5753373	C	G	6	7	13	0	0	13	0	0
22	31285680	rs5749186	G	A	4	2	6	0	0	6	0	0
22	31302233	rs3804085	T	C	2	6	8	0	0	8	0	0
22	31303708	rs8004	G	A	5	3	8	0	0	8	0	0
22	31321847	rs2240175	C	A	19	16	35	0	0	35	0	0
22	31321948	rs2240176	G	A	16	11	27	0	1	28	0	0
22	31333631	rs3747151	T	C	21	16	37	0	0	37	0	0
22	31342376	rs2072132	G	C	12	15	27	0	1	28	0	0
22	31354653	rs737924	G	A	15	14	29	0	1	30	0	0
22	31355354	rs2285918	G	A	6	5	11	0	0	11	0	0
22	31360592	rs2240182	G	A	4	3	7	0	0	7	0	0
22	31366675	rs886471	G	T	43	38	81	0	0	81	0	0
22	31368096	rs5749201	A	T	12	10	22	0	0	22	0	0
22	31369324	rs7284767	G	A	47	51	98	0	0	98	0	0
22	31369789	rs8139350	C	G	7	4	11	0	0	11	0	0
22	31374043	rs140473822	G	C	93	83	176	0	3	179	0	0
22	31491295	rs3205187	G	C	4	5	9	0	0	9	0	0
22	31602139	rs3208937	A	G	22	10	32	0	0	32	0	0
22	31602187	rs13158	C	T	29	11	40	0	0	40	0	0
22	31602641	.	G	C	29	25	54	0	0	54	0	0
22	31621792	rs5997917	G	A	9	10	19	0	1	20	0	0
22	31663414	rs150025556	G	A	0	7	7	0	0	7	0	0
22	31663842	rs2228619	C	G	15	11	26	0	0	26	0	0
22	31673398	rs550114149	A	C	0	10	10	0	2	12	0	0
22	31673859	rs5997937	C	T	18	30	48	0	1	49	0	0
22	31674776	.	C	T	31	46	77	0	0	77	0	0
22	31675185	rs4141404	A	C	24	36	60	0	0	60	0	0
22	31678235	rs139952607	G	A	865	954	1819	0	6	1825	0	0
22	31678958	rs4618154	C	G	618	722	1340	0	9	1350	1	0
22	31679110	rs2040533	G	C	701	734	1435	0	4	1440	1	0
22	31679741	rs5997940	T	C	37	30	67	0	0	67	0	0
22	31680240	rs1034587	G	T	23	34	57	0	0	57	0	0
22	31681062	rs5749246	A	G	22	38	60	0	0	60	0	0
22	31681150	rs11704523	G	A	31	43	74	0	1	75	0	0
22	31682448	rs5997942	C	T	21	37	58	0	1	59	0	0
22	31683559	rs7291131	G	T	8	10	18	0	0	18	0	0
22	31683711	rs5749248	C	A	16	18	34	0	0	34	0	0
22	31685129	rs11089495	C	T	25	31	56	0	0	56	0	0
22	31685458	rs5753543	G	A	55	46	101	0	2	103	0	0
22	31686144	rs2413049	A	G	56	59	115	0	3	118	0	0
22	31686724	rs182492803	G	A	7	7	14	0	0	14	0	0
22	31724023	.	C	T	2	4	6	0	0	6	0	0
22	31726471	rs5997956	C	T	4	3	7	0	0	7	0	0
22	31741067	rs714909	G	A	109	134	243	0	4	247	0	0
22	31830351	rs5749272	T	C	5	7	12	0	0	12	0	0
22	31830421	rs3091392	T	C	5	5	10	0	0	10	0	0
22	31833759	rs695455	G	A	9	8	17	0	0	17	0	0
22	32001050	rs2236033	G	A	3	5	8	0	0	8	0	0
22	32002294	rs5753723	T	C	3	8	11	0	0	11	0	0
22	32011225	rs12171042	T	C	20	12	32	0	1	33	0	0
22	32015162	rs8461	C	T	32	21	53	0	0	53	0	0
22	32015406	rs14034	T	C	17	25	42	0	0	42	0	0
22	32015450	rs9956	T	G	16	29	45	0	0	45	0	0
22	32079303	rs3804087	T	C	19	24	43	0	0	43	0	0
22	32079937	rs10154786	G	T	9	18	27	0	0	27	0	0
22	32080244	rs5998086	G	A	30	17	47	0	0	47	0	0
22	32080949	rs12166526	C	A	16	17	33	0	0	33	0	0
22	32108824	rs131224	T	A	14	13	27	0	0	27	0	0
22	32110163	rs140078	G	A	15	18	33	0	0	33	0	0
22	32110943	rs140079	G	A	12	11	23	0	0	23	0	0
22	32111149	rs9621321	G	C	12	9	21	0	0	21	0	0
22	32112461	rs140081	T	C	7	13	20	0	0	20	0	0
22	32267042	rs136866	A	G	3	3	6	0	0	6	0	0
22	32268400	rs737084	A	G	5	4	9	0	0	9	0	0
22	32268404	rs147016213	G	A	5	4	9	0	0	9	0	0
22	32269711	rs12167583	C	T	18	19	37	0	0	37	0	0
22	32275515	rs200033252	C	T	36	41	77	0	0	77	0	0
22	32341035	rs543401142	C	T	3	8	11	0	0	11	0	0
22	32341092	rs13055495	A	G	15	9	24	0	0	24	0	0
22	32341141	rs13057194	T	C	16	25	41	0	0	41	0	0
22	32342410	rs141972153	C	T	13	5	18	0	2	20	0	0
22	32342976	rs3747158	G	A	8	3	11	0	1	12	0	0
22	32756744	.	A	G	3	7	10	0	0	10	0	0
22	32759025	rs5998440	G	C	3	3	6	0	0	6	0	0
22	32764869	rs5998460	A	G	4	2	6	0	0	6	0	0
22	32779227	rs2413113	T	C	4	3	7	0	0	7	0	0
22	32779924	rs7287726	A	G	3	7	10	0	0	10	0	0
22	32781422	rs926308	G	T	6	9	15	0	0	15	0	0
22	32790159	rs143827677	C	T	1	5	6	0	1	7	0	0
22	35664327	rs2235147	T	C	14	6	20	0	0	20	0	0
22	35679951	rs2272789	T	C	0	6	6	0	0	6	0	0
22	35689415	rs2272791	G	T	3	5	8	0	0	8	0	0
22	35733654	rs138794	G	A	4	3	7	0	0	7	0	0
22	35737214	rs2267334	C	G	17	12	29	0	0	29	0	0
22	35737461	rs2267335	G	A	4	7	11	0	0	11	0	0
22	35740347	rs78955559	G	A	18	15	33	0	0	33	0	0
22	35740866	rs762967	G	A	21	22	43	0	0	43	0	0
22	35741171	rs4386	T	C	24	21	45	0	0	45	0	0
22	35777185	rs2071747	G	C	17	15	32	0	0	32	0	0
22	35782807	.	G	A	19	13	32	0	0	32	0	0
22	35798046	rs737777	G	T	6	5	11	0	0	11	0	0
22	35802661	rs2307340	C	G	161	136	297	0	1	298	0	0
22	35820254	rs4645824	G	A	186	176	362	0	0	362	0	0
22	36537029	rs11705238	C	T	12	8	20	0	0	20	0	0
22	36537500	rs132618	A	T	20	16	36	0	0	36	0	0
22	36537725	rs61731692	G	A	11	13	24	0	0	24	0	0
22	36544563	rs132640	A	G	1	5	6	0	0	6	0	0
22	36677914	rs7078	A	G	659	815	1474	0	16	1490	0	0
22	36678118	rs136200	C	T	900	747	1647	0	67	1715	1	0
22	36679058	rs735854	T	C	10	4	14	0	0	14	0	0
22	36679215	rs735853	C	G	8	10	18	0	0	18	0	0
22	36679531	rs2008328	C	T	13	10	23	0	0	23	0	0
22	36679639	rs9622371	T	C	2	6	8	0	1	9	0	0
22	36680825	rs2071733	C	G	9	4	13	0	0	13	0	0
22	36682707	rs13053731	G	A	12	11	23	0	0	23	0	0
22	36683555	rs9610482	C	T	12	21	33	0	0	33	0	0
22	36684092	rs5756129	T	C	17	19	36	0	0	36	0	0
22	36684354	rs2269529	T	C	529	533	1062	0	10	1072	0	0
22	36684358	rs2269530	C	A	528	521	1049	0	7	1056	0	0
22	36686526	rs62232665	G	A	2	4	6	0	0	6	0	0
22	36690113	rs4821478	G	A	4	3	7	0	0	7	0	0
22	36693442	rs9610486	G	A	5	2	7	0	0	7	0	0
22	36693980	rs5756133	T	A	3	8	11	0	0	11	0	0
22	36702300	rs1009150	C	T	3	3	6	0	0	6	0	0
22	36707047	rs2157253	C	A	5	81	86	0	0	86	0	0
22	36707200	rs2157254	G	C	8	92	100	0	0	100	0	0
22	36707403	rs2157255	T	A	1	39	40	0	5	45	0	0
22	36707661	rs2157256	A	G	0	108	108	0	1	109	0	0
22	36707712	rs2187778	G	A	1	95	96	0	0	96	0	0
22	36707758	rs2187779	G	C	1	94	95	0	0	95	0	0
22	36707862	rs9622376	G	A	2	85	87	0	0	87	0	0
22	36707873	rs9622377	C	T	1	77	78	0	0	78	0	0
22	36707951	rs5756138	T	C	1	93	94	0	1	95	0	0
22	36714659	rs1002246	G	A	6	0	6	0	0	6	0	0
22	36716029	rs6000239	T	C	4	15	19	0	0	19	0	0
22	36716209	rs3752463	G	A	4	7	11	0	0	11	0	0
22	36718858	rs2071731	G	A	19	12	31	0	0	31	0	0
22	36719012	rs5756153	G	A	7	10	17	0	0	17	0	0
22	36720424	rs5756154	C	T	34	31	65	0	0	65	0	0
22	36720569	rs5756155	C	T	57	30	87	0	0	87	0	0
22	36720779	rs5756156	C	T	8	12	20	0	0	20	0	0
22	36722490	rs8136069	C	A	7	3	10	0	0	10	0	0
22	36723697	rs5756157	T	G	8	4	12	0	0	12	0	0
22	36728256	rs5750252	A	G	3	3	6	0	0	6	0	0
22	36729074	rs4820234	A	G	2	4	6	0	0	6	0	0
22	36730947	rs2413398	T	G	5	6	11	0	1	12	0	0
22	36732537	rs1557540	C	T	5	3	8	0	1	9	0	0
22	36736649	rs5756159	T	A	3	3	6	0	0	6	0	0
22	36877058	rs59841625	A	G	3	3	6	0	0	6	0	0
22	36907098	rs728785	T	C	35	30	65	0	2	67	0	0
22	37257177	rs34567417	G	A	110	75	185	0	2	187	0	0
22	37257712	rs34421414	C	A	11	4	15	0	0	15	0	0
22	37257822	rs11912791	C	T	8	2	10	0	0	10	0	0
22	37334953	rs6000495	G	A	14	18	32	0	0	32	0	0
22	37523721	rs228941	C	G	16	12	28	0	0	28	0	0
22	37539638	rs148800183	G	A	11	4	15	0	1	16	0	0
22	37621358	rs12166968	C	G	326	364	690	0	8	698	0	0
22	37621951	rs9610680	G	A	876	880	1756	0	11	1768	1	0
22	37622486	rs9622584	G	A	9	7	16	0	0	16	0	0
22	37624999	rs739041	A	G	5	7	12	0	0	12	0	0
22	37625277	rs11089831	G	A	3	5	8	0	0	8	0	0
22	37625419	rs739042	A	G	3	6	9	0	0	9	0	0
22	37626102	rs2284037	A	G	2	4	6	0	0	6	0	0
22	37627845	rs8135343	G	A	5	5	10	0	0	10	0	0
22	37632770	rs13058338	T	A	6	3	9	0	0	9	0	0
22	37636351	rs2157206	C	A	1	5	6	0	0	6	0	0
22	37678551	rs3213556	A	G	56	64	120	0	4	124	0	0
22	37678565	rs3213557	G	A	91	80	171	0	0	171	0	0
22	37708388	rs187877148	C	T	11	3	14	0	0	14	0	0
22	37869131	rs113103841	G	A	6	9	15	0	0	15	0	0
22	37870771	rs2071841	G	A	19	22	41	0	1	42	0	0
22	37878767	rs149001354	C	A	5	5	10	0	0	10	0	0
22	37881513	rs6000748	G	C	7	6	13	0	0	13	0	0
22	37964693	.	C	T	35	69	104	0	0	104	0	0
22	38022622	rs6000847	A	C	9	12	21	0	0	21	0	0
22	38022666	rs73887013	A	C	14	15	29	0	0	29	0	0
22	38121152	rs9610841	C	A	1	7	8	0	0	8	0	0
22	38122122	rs5756795	T	C	1	6	7	0	0	7	0	0
22	38123800	rs6519078	T	A	4	2	6	0	0	6	0	0
22	38126542	rs144633537	T	C	5	1	6	0	0	6	0	0
22	38164106	rs4821708	C	T	102	77	179	0	2	181	0	0
22	38170026	rs1129448	G	A	88	76	164	0	0	164	0	0
22	38170754	rs55649555	C	A	42	47	89	0	0	89	0	0
22	38172213	rs3171656	G	A	89	84	173	0	2	176	1	0
22	38172380	rs15691	C	A	53	51	104	0	0	104	0	0
22	38202399	rs6000898	T	C	804	569	1373	0	77	1451	1	0
22	38204089	rs710187	C	T	18	10	28	0	0	28	0	0
22	38205989	rs2285178	T	C	4	6	10	0	0	10	0	0
22	38212762	rs13911	A	G	52	31	83	0	0	83	0	0
22	38250728	rs2413490	C	T	5	1	6	0	0	6	0	0
22	38267088	rs142832133	T	C	7	7	14	0	0	14	0	0
22	38267446	rs1009045	G	C	6	7	13	0	1	14	0	0
22	38267619	rs4820310	T	A	4	3	7	0	0	8	1	0
22	38268922	rs139838	G	A	8	8	16	0	0	16	0	0
22	38273749	rs9466	T	C	1441	1431	2872	0	15	2888	1	0
22	38285300	rs6000926	T	C	19	27	46	0	0	46	0	0
22	38341134	rs139859	T	C	5	5	10	0	1	11	0	0
22	38343143	rs139860	T	C	12	2	14	0	1	15	0	0
22	38344053	rs117123358	G	A	6	4	10	0	0	10	0	0
22	38344054	rs117518937	C	A	5	5	10	0	0	10	0	0
22	38364205	rs3026641	G	A	5	11	16	0	0	16	0	0
22	38364339	rs5756866	T	C	16	10	26	0	0	26	0	0
22	38364552	rs139879	T	C	12	13	25	0	0	25	0	0
22	38458681	rs738443	G	A	3	4	7	0	0	7	0	0
22	38462662	.	C	T	5	8	13	0	0	13	0	0
22	38463141	rs3026688	C	A	7	11	18	0	0	18	0	0
22	38463535	rs880669	C	T	7	5	12	0	1	13	0	0
22	38463652	rs2076369	T	G	7	3	10	0	0	10	0	0
22	38463968	rs2076370	A	G	8	8	16	0	1	17	0	0
22	38467784	rs760975	G	C	9	10	19	0	0	19	0	0
22	38483171	rs142001534	G	A	1	6	7	0	0	7	0	0
22	38483174	rs78489217	A	T	0	7	7	0	0	7	0	0
22	38518229	rs2235346	G	T	4	5	9	0	0	9	0	0
22	38519335	rs2072867	A	G	3	6	9	0	0	9	0	0
22	38523065	rs3827354	T	C	11	8	19	0	0	19	0	0
22	38618677	rs80159443	C	T	2	4	6	0	0	6	0	0
22	38687997	rs1057465	T	C	8	4	12	0	0	12	0	0
22	38689984	rs5757022	T	A	11	8	19	0	0	19	0	0
22	38690698	rs2075983	A	G	11	4	15	0	0	15	0	0
22	38693229	.	C	A	59	66	125	0	1	126	0	0
22	38695099	rs1534891	T	C	4	11	15	0	0	15	0	0
22	38695406	rs5750581	C	T	7	8	15	0	0	15	0	0
22	38757454	rs113873251	A	G	18	7	25	0	1	26	0	0
22	38879495	rs16998989	G	A	56	68	124	0	0	124	0	0
22	39116543	.	A	G	5	6	11	0	0	11	0	0
22	39257673	rs1053197	G	A	92	93	185	0	2	187	0	0
22	39258743	rs74653710	C	T	77	75	152	0	0	152	0	0
22	39259626	rs12628941	C	T	34	52	86	0	1	87	0	0
22	39266451	rs7292074	C	A	2	4	6	0	0	6	0	0
22	39477123	rs5757465	T	C	25	22	47	0	0	47	0	0
22	39527790	rs710190	T	C	4	7	11	0	0	11	0	0
22	39527814	rs710191	G	T	3	6	9	0	0	9	0	0
22	39527909	rs139383	G	A	2	4	6	0	0	6	0	0
22	39528440	rs79503	A	G	2	5	7	0	0	7	0	0
22	39912969	rs11703406	C	T	50	54	104	0	1	105	0	0
22	39917047	rs117186267	C	T	62	42	104	0	0	104	0	0
22	40364122	rs61752259	G	A	2	6	8	0	0	8	0	0
22	40368229	rs138011	T	C	3	3	6	0	0	6	0	0
22	40726183	rs139919	T	C	5	1	6	0	0	6	0	0
22	40726749	rs139920	C	T	4	4	8	0	0	8	0	0
22	40726762	rs139921	A	G	7	4	11	0	0	11	0	0
22	40729614	rs470113	A	G	16	22	38	0	0	38	0	0
22	40744540	rs78281341	A	G	4	5	9	0	0	9	0	0
22	40758581	rs2075764	C	T	2	5	7	0	0	7	0	0
22	40803367	rs77222252	C	T	44	27	71	0	0	71	0	0
22	40806270	rs9611341	C	T	4	4	8	0	0	8	0	0
22	40806752	rs56066924	T	G	137	173	310	0	6	316	0	0
22	40808938	rs55812888	G	A	4	7	11	0	0	11	0	0
22	40809638	rs111985546	G	A	4	2	6	0	0	6	0	0
22	40810303	rs8138288	T	C	4	3	7	0	0	7	0	0
22	40810392	rs8137675	G	C	4	2	6	0	0	6	0	0
22	40810437	rs9611342	T	C	6	4	10	0	0	10	0	0
22	40810442	rs9611343	T	C	7	4	11	0	0	11	0	0
22	40810851	rs73887805	A	G	4	6	10	0	0	10	0	0
22	40810951	rs6001904	T	C	3	3	6	0	0	6	0	0
22	40811227	rs6001905	C	G	6	4	10	0	1	11	0	0
22	40813676	rs2413622	G	C	5	13	18	0	0	18	0	0
22	40814594	rs56211152	C	T	124	133	257	0	3	260	0	0
22	40822149	rs80207320	A	G	4	3	7	0	0	7	0	0
22	40947458	rs9623184	C	T	6	5	11	0	0	11	0	0
22	41223190	rs710193	C	T	571	597	1168	0	4	1172	0	0
22	41526364	rs75719186	C	G	4	2	6	0	0	6	0	0
22	41541527	rs2413637	G	C	5	1	6	0	0	6	0	0
22	41543171	rs59568053	G	A	2	4	6	0	0	6	0	0
22	41549009	rs6002268	T	C	27	28	55	0	0	55	0	0
22	41549297	rs7510675	A	G	19	22	41	0	1	42	0	0
22	41551039	rs20552	T	A	194	216	410	0	5	415	0	0
22	41558232	rs1033611	A	G	4	9	13	0	0	13	0	0
22	41565285	rs5751058	A	G	3	7	10	0	0	10	0	0
22	41568480	rs2076577	T	C	5	1	6	0	0	6	0	0
22	41569887	rs2076580	G	A	131	94	225	0	1	226	0	0
22	41570071	rs2076581	T	C	163	180	343	0	3	346	0	0
22	41570745	rs5758251	T	C	74	64	138	0	1	139	0	0
22	41610024	rs139451	G	A	22	15	37	0	1	38	0	0
22	41626663	rs139480	C	T	21	18	39	0	0	39	0	0
22	41627073	rs3721	C	T	32	27	59	0	1	60	0	0
22	41641984	rs1953	C	T	85	90	175	0	1	177	1	0
22	41645757	rs71948	C	G	81	85	166	0	0	166	0	0
22	41646738	rs11703267	A	G	8	4	12	0	0	12	0	0
22	41652733	rs139509	G	A	45	54	99	0	0	99	0	0
22	41914434	rs41276321	A	C	13	10	23	0	0	23	0	0
22	41930522	rs9623414	G	A	12	7	19	0	0	19	0	0
22	42059768	rs132788	G	T	551	447	998	0	3	1001	0	0
22	42070793	rs132806	C	T	50	69	119	0	1	120	0	0
22	42074230	rs11703145	C	T	10	2	12	0	0	12	0	0
22	42267605	rs133290	C	A	5	1	6	0	0	6	0	0
22	42269628	rs133291	C	T	5	2	7	0	0	7	0	0
22	42274034	rs9623465	G	T	199	188	387	0	1	388	0	0
22	42287454	rs2267443	A	G	3	4	7	0	0	7	0	0
22	42428727	rs133349	A	T	10	8	18	0	0	18	0	0
22	42454950	rs1063392	A	G	18	23	41	0	0	41	0	0
22	42455248	rs62238588	C	T	24	19	43	0	0	43	0	0
22	42481849	rs7245	G	A	35	30	65	0	0	65	0	0
22	42484712	rs62238594	C	T	4	6	10	0	0	10	0	0
22	42486056	rs5751211	G	A	6	4	10	0	0	10	0	0
22	42534148	rs2743449	C	T	2	4	6	0	0	6	0	0
22	42534601	rs2743450	G	A	5	2	7	0	0	7	0	0
22	42534682	rs2743451	T	C	3	6	9	0	0	9	0	0
22	42534956	rs2743453	A	G	11	8	19	0	0	19	0	0
22	42536263	rs1058174	G	A	4	2	6	0	0	6	0	0
22	42536313	rs2743456	G	A	5	3	8	0	0	8	0	0
22	42546018	rs28493713	T	C	4	2	6	0	0	6	0	0
22	42546852	rs59390354	G	A	6	8	14	0	0	14	0	0
22	42547229	rs5758608	C	T	6	2	8	0	0	8	0	0
22	42548178	rs5758612	A	G	4	4	8	0	0	8	0	0
22	42609148	rs5758651	T	C	19	28	47	0	0	47	0	0
22	42904224	.	T	G	4	3	7	0	0	7	0	0
22	42958411	rs145227256	G	A	6	6	12	0	0	12	0	0
22	42967403	rs137047	G	A	3	5	8	0	0	8	0	0
22	42967774	rs117652355	C	T	1	6	7	0	0	7	0	0
22	42968013	.	G	A	4	2	6	0	0	6	0	0
22	42968424	rs142638456	C	T	7	4	11	0	0	11	0	0
22	42969130	rs137051	G	A	7	4	11	0	0	11	0	0
22	42969466	rs2007185	C	G	3	3	6	0	0	6	0	0
22	42969854	rs137053	T	G	2	7	9	0	0	9	0	0
22	42969877	rs137054	G	A	2	5	7	0	0	7	0	0
22	42972063	.	C	T	7	15	22	0	0	22	0	0
22	42972590	rs137071	A	G	21	19	40	0	0	40	0	0
22	42974581	rs137075	T	C	1	5	6	0	0	6	0	0
22	42981138	rs137085	T	C	336	281	617	0	5	622	0	0
22	42981167	rs137086	G	A	334	283	617	0	1	618	0	0
22	42981678	rs1043606	T	C	261	264	525	0	6	531	0	0
22	42983782	rs2071842	C	A	16	14	30	0	0	30	0	0
22	42984908	rs78715709	C	T	12	10	22	0	0	22	0	0
22	42985163	rs4822170	C	A	5	4	9	0	0	9	0	0
22	42985798	rs137095	T	C	8	6	14	0	0	14	0	0
22	42988679	rs137099	G	A	7	8	15	0	1	16	0	0
22	42990074	rs137100	C	T	9	12	21	0	0	21	0	0
22	43009759	rs137112	C	T	5	1	6	0	0	6	0	0
22	43011403	rs137115	T	C	2	4	6	0	0	6	0	0
22	43023980	rs137138	G	A	16	10	26	0	0	26	0	0
22	43024410	rs137139	C	T	8	5	13	0	0	13	0	0
22	43172646	rs13055920	G	A	177	0	177	0	2	179	0	0
22	43193323	rs5751372	T	C	116	137	253	0	1	254	0	0
22	43193915	rs1811846	A	T	7	18	25	0	0	25	0	0
22	43194273	rs1807591	G	A	12	8	20	0	0	20	0	0
22	43195147	rs1128013	A	G	89	104	193	0	1	194	0	0
22	43195296	rs5758948	A	G	11	6	17	0	0	17	0	0
22	43195671	rs5758949	A	T	8	14	22	0	0	22	0	0
22	43195697	rs2179872	A	G	7	13	20	0	0	20	0	0
22	43197034	rs5758951	A	G	8	5	13	0	0	13	0	0
22	43197830	rs112803795	C	T	9	1	10	0	0	10	0	0
22	43197859	rs3788596	A	G	8	3	11	0	0	11	0	0
22	43197897	rs3788597	C	G	9	3	12	0	0	12	0	0
22	43198295	rs2006040	T	C	6	2	8	0	0	8	0	0
22	43198836	rs2413721	T	G	7	2	9	0	0	9	0	0
22	43198934	rs2413722	C	T	6	2	8	0	0	8	0	0
22	43200220	rs2413723	C	T	4	4	8	0	0	8	0	0
22	43202339	rs2413725	G	C	10	5	15	0	0	15	0	0
22	43202340	rs2413726	G	A	10	5	15	0	0	15	0	0
22	43203137	rs738535	C	T	84	87	171	0	0	171	0	0
22	43206950	rs1018448	A	C	25	70	95	0	1	96	0	0
22	43218463	rs5758957	C	T	4	2	6	0	0	6	0	0
22	43252280	rs5758990	A	G	7	2	9	0	0	9	0	0
22	43265827	rs7074	G	T	24	13	37	0	0	37	0	0
22	43265917	.	C	T	82	80	162	0	0	162	0	0
22	43266363	rs7073	C	T	122	92	214	0	2	216	0	0
22	43266774	rs8569	C	T	90	58	148	0	0	148	0	0
22	43267873	rs4822212	G	T	3	3	6	0	0	6	0	0
22	43268009	rs13433641	T	C	3	6	9	0	0	9	0	0
22	43268502	rs9607973	A	G	6	3	9	0	0	9	0	0
22	43269547	rs2267461	C	T	4	2	6	0	0	6	0	0
22	43270440	rs2092664	A	C	4	4	8	0	0	8	0	0
22	43272085	rs5751396	G	C	5	3	8	0	0	8	0	0
22	43272792	rs5751397	C	T	20	12	32	0	0	32	0	0
22	43273740	rs5759006	C	G	26	18	44	0	0	44	0	0
22	43273891	rs4822215	T	G	17	5	22	0	0	22	0	0
22	43274283	rs5759007	C	T	6	5	11	0	0	11	0	0
22	43274367	rs5759008	A	T	12	3	15	0	0	15	0	0
22	43274722	rs9611950	G	A	19	13	32	0	0	32	0	0
22	43274772	rs9611951	A	G	17	12	29	0	0	29	0	0
22	43274889	rs9611952	G	A	10	9	19	0	0	19	0	0
22	43275250	rs2073199	G	A	15	11	26	0	0	26	0	0
22	43275968	rs8141676	G	C	11	13	24	0	0	24	0	0
22	43276030	rs4820492	A	C	6	15	21	0	0	21	0	0
22	43276606	.	C	T	9	7	16	0	0	16	0	0
22	43277117	.	C	T	14	15	29	0	0	29	0	0
22	43277147	rs4822216	A	G	14	13	27	0	0	27	0	0
22	43277922	rs738537	G	A	18	5	23	0	1	24	0	0
22	43278162	rs4822217	T	C	6	12	18	0	0	18	0	0
22	43278220	rs2899365	C	T	84	69	153	0	1	154	0	0
22	43279282	rs9611953	A	G	4	3	7	0	1	8	0	0
22	43289473	rs5759013	G	A	79	50	129	0	1	130	0	0
22	43291095	rs3091382	C	T	3	3	6	0	0	6	0	0
22	43291529	rs5759015	C	A	5	1	6	0	0	6	0	0
22	43294744	rs4822223	T	C	4	3	7	0	0	7	0	0
22	43295268	rs875629	C	T	6	2	8	0	0	8	0	0
22	43295271	rs738397	C	T	6	2	8	0	0	8	0	0
22	43296051	rs2002595	C	A	4	2	6	0	0	6	0	0
22	43331105	.	T	G	6	1	7	0	0	7	0	0
22	43435812	rs1052163	C	T	8	7	15	0	0	15	0	0
22	43455531	rs1132079	C	T	6	9	15	0	0	15	0	0
22	43459846	rs1052160	G	A	6	7	13	0	0	13	0	0
22	43459864	rs2272870	G	A	6	6	12	0	0	12	0	0
22	43465814	rs2076155	A	G	4	4	8	0	0	8	0	0
22	43528858	rs55888369	G	A	7	7	14	0	0	14	0	0
22	43548155	rs138908	T	G	1	7	8	0	0	8	0	0
22	43558972	rs6972	G	A	414	336	750	0	12	762	0	0
22	43559137	rs6973	G	T	338	284	622	0	1	623	0	0
22	43562829	rs47340	G	T	15	17	32	0	0	32	0	0
22	43563711	rs107402	A	G	12	15	27	0	0	27	0	0
22	43568512	rs34074034	C	T	19	17	36	0	0	36	0	0
22	43570463	rs2269525	A	G	7	1	8	0	0	8	0	0
22	43572354	rs11704935	C	T	8	12	20	0	2	22	0	0
22	43596929	rs137890579	G	A	11	3	14	0	0	14	0	0
22	43599665	.	G	A	47	61	108	0	0	108	0	0
22	43606233	rs138968120	G	A	46	48	94	0	1	95	0	0
22	43613550	rs138995	C	T	3	5	8	0	0	8	0	0
22	43613551	rs138996	A	G	3	5	8	0	0	8	0	0
22	43654573	rs115965745	G	A	5	3	8	0	0	8	0	0
22	43654951	rs733182	T	C	4	4	8	0	0	8	0	0
22	43656322	rs2413752	A	G	8	3	11	0	0	11	0	0
22	43657040	rs59766248	G	A	2	4	6	0	0	6	0	0
22	43657778	rs12171164	T	A	4	5	9	0	0	9	0	0
22	43658461	rs11090147	A	G	7	4	11	0	0	11	0	0
22	44351351	rs2294920	T	C	10	21	31	0	0	31	0	0
22	44368204	rs3177036	A	G	71	66	137	0	0	137	0	0
22	44372632	rs14315	C	T	116	80	196	0	0	196	0	0
22	44380033	rs6006598	T	C	2	5	7	0	0	7	0	0
22	44382247	rs6006467	A	C	3	7	10	0	0	10	0	0
22	44382533	rs2294926	C	T	2	5	7	0	0	7	0	0
22	44383070	rs12166587	T	C	5	3	8	0	0	8	0	0
22	44383502	rs9625970	T	C	5	1	6	0	0	6	0	0
22	44384881	rs16991288	G	C	5	4	9	0	1	10	0	0
22	44557025	rs2267621	A	G	3	5	8	0	0	8	0	0
22	44557355	rs139076	G	A	2	6	8	0	0	8	0	0
22	44558459	rs2744984	A	C	8	3	11	0	0	11	0	0
22	44558493	rs4426616	G	C	3	7	10	0	0	10	0	0
22	44558576	.	A	G	1	5	6	0	0	6	0	0
22	44558718	rs139077	G	A	5	2	7	0	0	7	0	0
22	44566132	.	C	T	15	6	21	0	0	21	0	0
22	44581403	rs5764592	A	G	5	3	8	0	0	8	0	0
22	44581549	rs6006693	G	A	10	11	21	0	0	21	0	0
22	44582105	rs139132	G	A	88	82	170	0	1	171	0	0
22	44582136	rs3747213	G	A	87	78	165	0	0	165	0	0
22	44582820	rs139133	T	G	68	75	143	0	1	144	0	0
22	44584857	rs139137	C	G	3	5	8	0	0	8	0	0
22	44586522	rs2272942	C	T	322	357	679	0	3	682	0	0
22	44589857	rs139142	T	G	12	2	14	0	0	14	0	0
22	44592492	rs139145	T	G	4	4	8	0	0	8	0	0
22	44593488	rs139146	C	G	10	12	22	0	0	22	0	0
22	44593624	rs139147	T	C	12	11	23	0	0	23	0	0
22	44594209	rs139150	T	G	11	5	16	0	0	16	0	0
22	44594584	rs139152	C	G	304	369	673	0	8	681	0	0
22	44594992	rs76846378	T	A	3	3	6	0	0	6	0	0
22	44595439	rs139153	C	T	5	11	16	0	0	16	0	0
22	44595562	rs139154	C	A	11	13	24	0	0	24	0	0
22	44596743	rs139158	C	A	8	9	17	0	1	18	0	0
22	44597504	rs139160	T	C	6	2	8	0	0	8	0	0
22	44597596	rs139161	G	A	5	7	12	0	0	12	0	0
22	44597747	rs139162	C	T	7	11	18	0	0	18	0	0
22	44597929	rs139163	G	A	8	13	21	0	0	21	0	0
22	44598301	rs139165	G	T	5	3	8	0	0	8	0	0
22	44598606	rs139166	C	T	5	8	13	0	0	13	0	0
22	44598692	rs139167	G	A	12	3	15	0	0	15	0	0
22	44599258	rs139168	C	A	7	10	17	0	0	17	0	0
22	44599452	rs139170	C	T	10	4	14	0	0	14	0	0
22	44599531	rs139171	G	A	7	6	13	0	0	13	0	0
22	44599656	rs139173	G	A	10	4	14	0	0	14	0	0
22	44599781	rs139174	G	A	10	3	13	0	0	13	0	0
22	44599922	rs139175	A	G	4	6	10	0	0	10	0	0
22	44600135	rs139176	C	A	7	14	21	0	0	21	0	0
22	44600172	rs139177	A	G	11	13	24	0	0	24	0	0
22	44600175	rs139178	C	T	12	11	23	0	0	23	0	0
22	44600500	rs139179	C	T	10	14	24	0	0	24	0	0
22	44600633	rs139180	G	C	8	8	16	0	0	16	0	0
22	44600652	rs139181	G	A	8	6	14	0	0	14	0	0
22	44600954	rs139182	T	C	14	11	25	0	0	25	0	0
22	44600995	rs139183	C	A	13	10	23	0	1	24	0	0
22	44601499	rs139184	C	G	15	21	36	0	0	36	0	0
22	44602001	rs139185	G	T	1	6	7	0	1	8	0	0
22	44602549	rs139187	A	C	38	54	92	0	2	94	0	0
22	44603582	rs139188	G	A	45	28	73	0	0	73	0	0
22	44603870	rs139190	T	C	79	88	167	0	5	172	0	0
22	44605522	rs139195	T	C	2	5	7	0	0	7	0	0
22	44605799	rs139196	A	G	2	5	7	0	0	7	0	0
22	44606259	rs1133428	A	G	6	7	13	0	0	13	0	0
22	44608457	rs139203	A	C	5	1	6	0	0	6	0	0
22	44609159	rs139206	A	G	3	3	6	0	0	6	0	0
22	44609369	rs2748869	C	T	5	4	9	0	0	9	0	0
22	44609398	rs6006499	T	C	4	4	8	0	1	9	0	0
22	44609610	rs62654728	C	A	7	3	10	0	0	10	0	0
22	44610112	rs139207	T	C	4	5	9	0	0	9	0	0
22	44610726	rs139208	A	C	9	7	16	0	0	16	0	0
22	44610981	rs139209	G	A	3	9	12	0	1	13	0	0
22	44611050	rs139210	G	T	0	6	6	0	0	6	0	0
22	45128232	rs8141631	T	C	12	9	21	0	0	21	0	0
22	45245359	rs5766099	C	T	8	1	9	0	0	9	0	0
22	45248241	rs6007324	A	G	4	2	6	0	0	6	0	0
22	45254340	rs11913791	T	C	2	4	6	0	0	6	0	0
22	45255639	.	C	T	3	5	8	0	0	8	0	0
22	45256223	rs2349860	C	T	2	4	6	0	0	6	0	0
22	45258324	rs2071762	C	T	4	2	6	0	0	6	0	0
22	45258457	rs8881	A	G	6	4	10	0	0	10	0	0
22	45556668	rs132838	T	C	2	4	6	0	0	6	0	0
22	45561392	rs132857	A	G	2	6	8	0	0	8	0	0
22	45566912	rs132875	C	A	41	26	67	0	0	67	0	0
22	45567035	rs132876	C	T	39	12	51	0	1	52	0	0
22	45567580	rs132881	C	A	10	9	19	0	0	19	0	0
22	45567983	rs132882	A	G	6	9	15	0	0	15	0	0
22	45568419	rs8135904	G	A	8	17	25	0	0	25	0	0
22	45568511	rs132883	G	T	3	5	8	0	0	8	0	0
22	45568986	rs132884	A	G	16	23	39	0	0	39	0	0
22	45570114	rs132888	G	A	6	10	16	0	2	18	0	0
22	45570969	rs9615052	C	T	18	7	25	0	1	26	0	0
22	45573154	rs2238800	C	T	14	19	33	0	0	33	0	0
22	45573406	rs9615053	C	A	21	18	39	0	0	39	0	0
22	45574986	rs9615054	T	G	5	4	9	0	0	9	0	0
22	45575468	rs226522	A	G	9	10	19	0	0	19	0	0
22	45576401	rs2238801	C	T	7	5	12	0	0	12	0	0
22	45577110	rs226523	T	C	8	11	19	0	0	19	0	0
22	45577231	rs226524	T	C	114	154	268	0	4	272	0	0
22	45577537	rs9615056	C	A	2	5	7	0	1	8	0	0
22	45579422	rs6006950	A	G	3	4	7	0	0	7	0	0
22	45580836	rs9614613	G	C	163	112	275	0	3	278	0	0
22	45582860	rs1058024	G	C	72	65	137	0	1	138	0	0
22	45583606	rs1058033	G	T	278	242	520	0	2	522	0	0
22	45583740	rs1058040	G	C	75	75	150	0	3	153	0	0
22	45583803	rs1058043	A	G	33	35	68	0	1	69	0	0
22	45588604	rs2350623	C	T	17	18	35	0	2	37	0	0
22	45589703	rs5766526	G	C	11	9	20	0	0	20	0	0
22	45589817	rs1125397	T	C	19	8	27	0	1	28	0	0
22	45590117	rs1986175	A	G	16	20	36	0	1	37	0	0
22	45590861	rs2235152	G	A	20	15	35	0	0	35	0	0
22	45592580	rs2072719	T	C	152	148	300	0	1	301	0	0
22	45593055	rs3179803	G	A	102	87	189	0	0	189	0	0
22	45732328	rs11704481	G	A	3	3	6	0	0	6	0	0
22	46068741	rs134860	C	T	2	6	8	0	0	8	0	0
22	46410149	rs28678802	A	G	1	7	8	0	1	9	0	0
22	46436973	rs7511186	T	A	4	6	10	0	0	10	0	0
22	46438611	rs11090796	T	C	5	1	6	0	1	7	0	0
22	46440007	rs8137273	T	G	2	5	7	0	0	7	0	0
22	46440273	rs8140558	A	G	18	15	33	0	0	33	0	0
22	46440605	rs1135856	T	C	26	27	53	0	1	54	0	0
22	46446563	rs9627386	G	A	4	6	10	0	0	10	0	0
22	46469046	.	G	C	19	20	39	0	0	39	0	0
22	46548566	.	C	T	8	4	12	0	0	12	0	0
22	46571994	rs4253659	C	A	7	2	9	0	1	10	0	0
22	46611728	rs4253738	C	T	20	25	45	0	1	46	0	0
22	46612036	rs4253742	T	C	21	25	46	0	0	46	0	0
22	46612293	rs192950054	A	G	29	33	62	0	4	66	0	0
22	46612307	rs4253743	A	G	26	32	58	0	11	69	0	0
22	46612904	rs4253744	C	G	37	48	85	0	1	86	0	0
22	46613154	rs4253746	A	T	25	40	65	0	0	65	0	0
22	46613237	rs4253747	T	A	15	22	37	0	0	37	0	0
22	46616117	rs4253757	A	C	12	4	16	0	0	16	0	0
22	46616732	rs4253758	T	C	8	3	11	0	0	11	0	0
22	46616914	rs79983878	C	T	3	5	8	0	1	9	0	0
22	46973892	rs9616057	T	C	1	5	6	0	0	6	0	0
22	46974203	rs9616058	G	A	5	3	8	0	0	8	0	0
22	46974717	rs9284525	G	C	4	3	7	0	0	7	0	0
22	46979402	rs1079836	C	G	3	4	7	0	0	7	0	0
22	46981340	rs5768990	A	G	7	1	8	0	0	8	0	0
22	46982721	rs9615390	T	C	6	1	7	0	0	7	0	0
22	46982722	rs9616067	G	A	6	1	7	0	0	7	0	0
22	46983297	rs137982323	C	T	5	1	6	0	0	6	0	0
22	46984809	rs5768994	T	C	6	2	8	0	0	8	0	0
22	46984853	rs5768995	T	G	2	4	6	0	0	6	0	0
22	46985917	rs9627514	G	A	5	4	9	0	0	9	0	0
22	46985977	rs12167722	T	C	3	3	6	0	0	6	0	0
22	46986119	rs13057198	G	C	2	4	6	0	0	6	0	0
22	46986889	rs5767281	G	A	3	3	6	0	0	6	0	0
22	46986911	rs5767282	C	T	5	3	8	0	0	8	0	0
22	46987047	rs5767283	T	A	3	3	6	0	0	6	0	0
22	46987087	rs5769001	G	T	3	4	7	0	0	7	0	0
22	46987302	rs5767284	C	T	7	3	10	0	0	10	0	0
22	46987981	rs5769003	C	T	5	2	7	0	0	7	0	0
22	47073721	rs5769068	C	T	197	124	321	0	5	326	0	0
22	47082159	rs801720	C	A	24	15	39	0	1	40	0	0
22	47087670	rs36211083	G	A	16	9	25	0	0	25	0	0
22	47091127	.	A	G	10	17	27	0	0	27	0	0
22	47130078	rs2080581	T	A	8	5	13	0	0	13	0	0
22	47130651	rs1548977	A	G	4	11	15	0	0	15	0	0
22	47130782	rs1548978	A	T	5	10	15	0	0	15	0	0
22	47131397	rs5769125	G	C	5	8	13	0	0	13	0	0
22	47158179	rs12389	G	A	67	24	91	0	1	92	0	0
22	47163320	rs801634	T	A	1	5	6	0	0	6	0	0
22	47327745	rs1983566	T	C	4	2	6	0	0	6	0	0
22	50463231	rs137885	T	C	2	6	8	0	0	8	0	0
22	50464439	rs137887	G	C	6	3	9	0	0	9	0	0
22	50464496	rs137888	G	A	4	4	8	0	0	8	0	0
22	50473618	rs5771127	A	G	6	4	10	0	0	10	0	0
22	50473631	rs9617057	T	C	5	4	9	0	1	10	0	0
22	50473636	rs9617135	G	T	6	5	11	0	0	11	0	0
22	50473644	rs9617058	A	G	5	5	10	0	0	10	0	0
22	50473719	rs9617136	A	G	10	6	16	0	0	16	0	0
22	50473961	rs5771313	C	T	5	5	10	0	0	10	0	0
22	50474857	rs1079653	A	G	4	16	20	0	0	20	0	0
22	50474943	rs1010282	G	A	13	7	20	0	0	20	0	0
22	50475316	rs2010453	C	T	7	10	17	0	0	17	0	0
22	50498248	rs41283489	C	A	32	54	86	0	0	86	0	0
22	50498885	rs9628320	G	A	15	19	34	0	0	34	0	0
22	50516195	rs137926	T	C	6	4	10	0	0	10	0	0
22	50609904	rs6010195	T	G	11	25	36	0	0	36	0	0
22	50614549	rs138194734	A	G	11	12	23	0	1	24	0	0
22	50625271	rs73187244	T	C	17	13	30	0	0	30	0	0
22	50625449	rs73187245	C	T	16	15	31	0	0	31	0	0
22	50625800	rs738338	A	G	14	16	30	0	0	30	0	0
22	50626301	rs5771214	C	T	20	7	27	0	0	27	0	0
22	50627188	rs11912419	C	T	22	21	43	0	0	43	0	0
22	50629104	rs151004894	G	A	6	15	21	0	0	21	0	0
22	50630794	rs56308603	G	A	44	44	88	0	2	90	0	0
22	50630973	rs760756	G	A	58	41	99	0	1	100	0	0
22	50631146	rs2341366	A	G	50	37	87	0	2	89	0	0
22	50632505	rs732710	C	T	49	44	93	0	1	94	0	0
22	50632963	rs6537637	G	T	21	21	42	0	0	42	0	0
22	50632964	rs6537638	A	T	19	20	39	0	1	40	0	0
22	50633048	rs730559	T	G	20	27	47	0	0	47	0	0
22	50633686	rs6537639	T	C	28	23	51	0	0	51	0	0
22	50633890	rs9617045	G	A	10	10	20	0	1	21	0	0
22	50634587	rs12152137	C	T	12	21	33	0	0	33	0	0
22	50634899	rs141511494	C	A	25	24	49	0	2	51	0	0
22	50634951	rs77364321	C	T	32	27	59	0	0	59	0	0
22	50635193	rs4084288	G	A	11	14	25	0	1	26	0	0
22	50635848	rs2272844	C	G	31	47	78	0	0	78	0	0
22	50636086	rs117073176	C	A	72	78	150	0	0	150	0	0
22	50636097	rs115013776	G	A	73	68	141	0	0	141	0	0
22	50638086	rs2272845	C	G	20	25	45	0	0	45	0	0
22	50638172	rs563890950	G	C	28	15	43	0	0	43	0	0
22	50638811	rs151311757	G	A	12	13	25	0	1	26	0	0
22	50638953	rs1009610	A	G	4	4	8	0	0	8	0	0
22	50639965	rs2272846	C	A	2	12	14	0	0	14	0	0
22	50642359	rs73187254	C	T	36	25	61	0	1	62	0	0
22	50642777	rs4838861	C	T	36	22	58	0	0	58	0	0
22	50642793	rs4838814	C	G	31	21	52	0	1	53	0	0
22	50644480	rs56109781	T	C	26	26	52	0	0	52	0	0
22	50645219	rs11913090	G	A	26	35	61	0	0	61	0	0
22	50646202	rs2272847	G	A	41	40	81	0	1	82	0	0
22	50646936	rs5771102	G	C	32	43	75	0	0	75	0	0
22	50647969	rs4611754	C	T	28	21	49	0	0	49	0	0
22	50648223	rs140144566	G	T	32	28	60	0	2	63	1	0
22	50648577	rs2294401	C	T	38	29	67	0	0	67	0	0
22	50650597	rs5771237	G	C	20	15	35	0	0	35	0	0
22	50651238	rs6010205	T	G	17	13	30	0	3	33	0	0
22	50653018	rs13058530	G	A	9	5	14	0	2	16	0	0
22	50653895	rs909687	G	C	14	5	19	0	0	19	0	0
22	50654906	rs143358267	C	T	8	18	26	0	0	26	0	0
22	50655098	rs2272851	A	G	9	5	14	0	0	14	0	0
22	50655676	rs2272852	G	A	99	135	234	0	0	234	0	0
22	50658494	rs5771241	C	A	17	11	28	0	0	28	0	0
22	50658501	rs9617119	A	G	10	14	24	0	0	24	0	0
22	50658698	rs5771107	T	A	17	30	47	0	1	48	0	0
22	50665860	rs730936	T	C	6	2	8	0	0	8	0	0
22	50682865	rs5771270	G	A	26	15	41	0	1	42	0	0
22	50686830	rs35820251	G	A	79	83	162	0	1	163	0	0
22	50687178	rs41283469	C	T	83	92	175	0	0	175	0	0
22	50687328	rs76646287	C	A	26	14	40	0	1	41	0	0
22	50687595	rs75455741	A	G	51	90	141	0	0	141	0	0
22	50689002	rs77003572	G	A	8	5	13	0	0	13	0	0
22	50691709	rs2235354	C	T	23	17	40	0	0	40	0	0
22	50693889	rs2066770	G	A	18	15	33	0	0	33	0	0
22	50695370	rs2072876	G	A	11	23	34	0	0	34	0	0
22	50699668	rs2272857	A	G	6	1	7	0	0	7	0	0
22	50702970	rs2072877	C	T	5	12	17	0	0	17	0	0
22	50703059	rs2072878	A	G	8	10	18	0	0	18	0	0
22	50704661	rs2076139	T	C	8	11	19	0	0	19	0	0
22	50714289	rs5771118	T	C	13	1	14	0	0	14	0	0
22	50714491	rs6010224	A	C	12	12	24	0	1	25	0	0
22	50714541	rs6010225	A	G	10	9	19	0	0	19	0	0
22	50715973	rs28637964	G	T	3	3	6	0	0	6	0	0
22	50716167	rs1127000	G	A	226	182	408	0	0	408	0	0
22	50717547	rs28633213	T	C	6	2	8	0	0	8	0	0
22	50717833	rs28418659	C	T	6	2	8	0	0	8	0	0
22	50718757	rs78659355	T	C	1	7	8	0	0	8	0	0
22	50719251	rs11547734	A	G	178	131	309	0	4	313	0	0
22	50720181	rs28442189	C	G	7	5	12	0	0	12	0	0
22	50720622	rs11547728	C	T	172	155	327	0	5	332	0	0
22	50721003	rs28404597	G	A	6	8	14	0	0	14	0	0
22	50721492	rs62621372	C	T	122	132	254	0	0	254	0	0
22	50721756	rs28497828	G	A	7	12	19	0	0	19	0	0
22	50722408	rs79966207	T	C	103	107	210	0	0	210	0	0
22	50724593	rs117199604	G	A	9	16	25	0	0	25	0	0
22	50728062	rs28379706	T	C	46	70	116	0	0	117	1	0
22	50733818	rs28625946	G	C	12	1	13	0	0	13	0	0
22	50747995	rs35729162	C	T	12	7	19	0	0	19	0	0
22	50748307	rs78854007	G	A	10	16	26	0	0	26	0	0
22	50748325	rs35197053	C	T	13	15	28	0	1	29	0	0
22	50748943	rs67286232	T	C	14	15	29	0	0	29	0	0
22	50749153	rs113848466	T	C	16	13	29	0	0	29	0	0
22	50749197	rs62241223	C	T	9	11	20	0	0	20	0	0
22	50749241	rs62241224	T	C	11	10	21	0	0	21	0	0
22	50749352	rs62241225	A	G	5	2	7	0	0	7	0	0
22	50753334	rs73439311	G	A	11	19	30	0	0	30	0	0
22	50754363	rs35812349	A	G	3	3	6	0	0	6	0	0
22	50754648	.	T	C	12	23	35	0	0	35	0	0
22	50760203	rs117410796	C	G	3	3	6	0	0	6	0	0
22	50860495	rs9616998	A	G	3	3	6	0	0	6	0	0
22	50874573	rs12484005	T	G	2	6	8	0	0	8	0	0
22	50875745	rs12167996	A	T	5	1	6	0	0	6	0	0
22	50876662	rs11555194	T	G	55	61	116	0	1	117	0	0
22	50878196	rs13057311	G	A	66	64	130	0	0	130	0	0
22	50878927	rs12171249	G	A	10	5	15	0	0	15	0	0
22	50879931	rs5770930	G	A	3	4	7	0	0	7	0	0
22	50881002	rs12485072	A	G	5	4	9	0	0	9	0	0
22	50882048	.	G	A	12	7	19	0	1	20	0	0
22	50895020	rs5771001	C	T	56	55	111	0	1	112	0	0
22	50896121	rs4824118	C	T	17	8	25	0	0	25	0	0
22	50896901	rs11703111	G	A	9	4	13	0	0	13	0	0
22	50897215	rs73441477	G	A	6	8	14	0	0	14	0	0
22	50941985	rs6009975	T	C	103	133	236	0	2	238	0	0
22	50944163	rs128941	G	A	64	64	128	0	1	129	0	0
22	50945256	rs131824	A	G	39	37	76	0	1	77	0	0
22	50945799	rs41281543	C	G	9	16	25	0	1	26	0	0
22	50959052	rs5770855	A	G	14	7	21	0	0	21	0	0
22	50959538	rs56229588	T	C	18	10	28	0	0	28	0	0
22	50961854	rs2782	T	C	28	22	50	0	0	50	0	0
22	50962208	rs12148	T	G	67	69	136	0	0	136	0	0
22	50962782	rs140523	C	G	39	38	77	0	0	77	0	0
22	50964236	rs11479	G	A	6	13	19	0	0	19	0	0
22	50964446	rs1138404	A	T	16	23	39	0	1	40	0	0
22	50964862	rs131804	G	A	10	18	28	0	0	28	0	0
22	50966545	rs131802	A	G	18	7	25	0	0	25	0	0
22	50966634	rs131801	G	T	4	12	16	0	0	16	0	0
22	50966914	rs470119	T	C	7	13	20	0	0	20	0	0
22	50981214	rs5770772	C	T	3	4	7	0	0	7	0	0
22	50988317	rs148213739	C	T	15	11	26	0	0	26	0	0
22	51007488	rs7238	A	G	13	15	28	0	1	29	0	0
22	51009953	rs470117	C	T	12	4	16	0	0	16	0	0
22	51011376	rs8142477	G	C	12	16	28	0	0	28	0	0
22	51015838	rs3213445	T	C	7	5	12	0	0	12	0	0
22	51017082	rs131758	T	A	4	2	6	0	0	6	0	0
22	51017394	rs3180872	G	C	4	4	8	0	0	8	0	0
22	51017476	rs1056964	A	G	87	70	157	0	0	157	0	0
22	51018911	rs2269382	C	T	2	4	6	0	0	6	0	0
22	51020069	rs2269381	G	C	8	13	21	0	0	21	0	0
22	51062222	rs131717	G	C	3	3	6	0	0	6	0	0
22	51062581	rs376910590	C	T	5	2	7	0	0	7	0	0
22	51062938	rs5770953	C	T	9	6	15	0	0	15	0	0
22	51066552	rs6151406	C	G	19	10	29	0	1	30	0	0
22	51155151	rs6009953	T	C	4	4	8	0	0	8	0	0
22	51161019	rs5770994	C	T	18	22	40	0	4	44	0	0
22	51162059	rs10451	G	A	23	27	50	0	0	50	0	0
22	51162850	rs5770822	C	T	8	8	16	0	0	16	0	0
22	51164109	rs5770995	G	C	12	12	24	0	0	24	0	0
22	51164115	rs5770996	C	T	12	12	24	0	0	24	0	0
22	51164287	rs6009957	T	C	12	20	32	0	1	33	0	0
22	51165390	rs76268556	C	T	11	8	19	0	0	19	0	0
22	51165664	rs8137951	G	A	11	14	25	0	0	25	0	0
22	51169045	rs8140772	C	T	9	9	18	0	0	18	0	0
22	51206533	rs5771009	T	C	7	8	15	0	1	16	0	0
3	3169190	rs189178	A	T	2	6	8	0	0	8	0	0
3	3171897	rs6788122	T	C	9	3	12	0	0	12	0	0
3	3187643	rs7629889	G	A	5	4	9	0	0	9	0	0
3	3189279	rs1705805	A	G	5	7	12	0	0	12	0	0
3	3191426	rs1045433	T	C	5	1	6	0	0	6	0	0
3	3192927	rs1620675	T	G	7	2	9	0	0	9	0	0
3	3193826	rs1055926	T	A	5	4	9	0	0	9	0	0
3	3195369	rs73005226	A	G	3	4	7	0	0	7	0	0
3	3195574	rs3846135	C	T	13	7	20	0	0	20	0	0
3	3197035	rs2291398	T	G	11	15	26	0	1	27	0	0
3	3198513	rs1672767	C	T	6	0	6	0	0	6	0	0
3	3199170	rs1669339	T	G	2	5	7	0	0	7	0	0
3	3199635	rs1669338	A	C	7	4	11	0	0	11	0	0
3	3200013	rs6784329	C	T	4	6	10	0	0	10	0	0
3	3201432	rs1705832	T	C	3	3	6	0	0	6	0	0
3	3201780	rs3792415	G	C	2	5	7	0	0	7	0	0
3	3204000	rs55959448	C	T	4	4	8	0	0	8	0	0
3	3206281	rs1705814	C	T	6	4	10	0	0	10	0	0
3	3208474	rs35751033	A	G	3	4	7	0	0	7	0	0
3	3209242	rs4685612	G	T	21	20	41	0	0	41	0	0
3	3211472	rs711595	A	T	5	3	8	0	1	9	0	0
3	3211515	rs711616	T	C	5	3	8	0	0	8	0	0
3	3213689	rs1669323	G	A	8	9	17	0	0	17	0	0
3	3213775	rs3749360	G	A	12	5	17	0	0	17	0	0
3	4358210	rs7647539	A	G	22	23	45	0	0	45	0	0
3	4403153	rs14275	T	G	23	19	42	0	0	42	0	0
3	4403536	rs74979662	A	T	15	14	29	0	0	29	0	0
3	4403614	rs2819562	T	C	16	16	32	0	0	32	0	0
3	4403767	rs2819561	A	G	26	25	51	0	0	51	0	0
3	4403817	rs2633851	T	A	23	24	47	0	0	47	0	0
3	4403837	rs2633852	A	G	15	21	36	0	0	36	0	0
3	4508742	rs2819590	C	T	5	7	12	0	0	12	0	0
3	4712413	rs2306875	G	A	29	20	49	0	1	50	0	0
3	4871924	rs112695811	C	A	5	4	9	0	0	9	0	0
3	4872618	rs117193511	C	T	7	0	7	0	0	7	0	0
3	5019579	rs867893	G	T	10	24	34	0	0	34	0	0
3	5019936	rs1110261	G	A	11	14	25	0	0	25	0	0
3	5021403	rs2271566	C	T	964	1107	2071	0	16	2087	0	0
3	5022961	rs13076468	A	C	39	42	81	0	0	81	0	0
3	5023574	rs6790630	G	A	73	111	184	0	0	184	0	0
3	5023996	rs6779816	A	G	66	69	135	0	1	136	0	0
3	5024771	rs908078	T	C	1296	1507	2803	0	19	2822	0	0
3	5025645	rs34883305	G	C	1632	1545	3177	0	14	3196	5	0
3	5025650	rs34870629	G	T	1627	1501	3128	0	15	3143	0	0
3	5025654	rs74439275	G	A	1660	1436	3096	0	29	3125	0	0
3	5026008	rs11130215	A	G	1397	1373	2770	0	28	2798	0	0
3	5026261	rs3750275	A	G	1502	1519	3021	0	56	3077	0	0
3	5164855	rs6808846	C	G	35	28	63	0	2	65	0	0
3	5166383	rs6442936	G	C	31	33	64	0	1	65	0	0
3	5167618	rs4499578	G	A	20	22	42	0	0	42	0	0
3	5170047	rs114246171	A	G	4	6	10	0	0	10	0	0
3	5170332	rs11710829	A	C	8	7	15	0	1	16	0	0
3	5201054	rs6787725	G	A	5	1	6	0	0	6	0	0
3	5212716	rs3856888	C	G	8	9	17	0	0	17	0	0
3	5212903	rs3856889	C	T	12	3	15	0	0	15	0	0
3	5218263	.	A	C	5	3	8	0	0	8	0	0
3	5231037	rs343422	G	C	11	10	21	0	0	21	0	0
3	5246159	rs146155803	A	G	14	3	17	0	0	17	0	0
3	5246166	rs13085849	C	T	3	15	18	0	0	18	0	0
3	5253361	.	G	A	33	16	49	0	1	50	0	0
3	5255718	rs62255915	G	T	30	29	59	0	1	60	0	0
3	5255940	.	G	A	6	7	13	0	0	13	0	0
3	5256169	rs341987	G	A	10	10	20	0	0	20	0	0
3	5257078	rs55901544	G	A	7	11	18	0	0	18	0	0
3	5258078	rs341984	G	A	111	96	207	0	1	208	0	0
3	8920505	rs193920	T	C	4	3	7	0	0	7	0	0
3	8955389	rs373572	C	T	10	11	21	0	0	21	0	0
3	8976779	rs375649	G	A	3	5	8	0	0	8	0	0
3	9005102	rs34927291	C	T	8	8	16	0	0	16	0	0
3	9422720	rs1129869	A	G	4	3	7	0	0	7	0	0
3	9428270	rs2251361	G	A	4	6	10	0	1	11	0	0
3	9432421	rs116802725	A	G	26	26	52	0	0	52	0	0
3	9692087	rs56310367	G	A	3	6	9	0	0	9	0	0
3	9693810	rs13315714	A	G	20	3	23	0	0	23	0	0
3	9694642	.	C	T	7	8	15	0	0	15	0	0
3	9700844	rs4260426	A	C	3	4	7	0	0	7	0	0
3	9705733	rs11715076	A	G	2	5	7	0	0	7	0	0
3	9709043	rs9816328	G	A	5	8	13	0	0	13	0	0
3	9709386	rs9879089	T	A	9	11	20	0	0	20	0	0
3	9710307	rs12493353	T	C	8	16	24	0	1	25	0	0
3	9725000	rs41277465	T	A	2	5	7	0	1	8	0	0
3	9727002	rs787836	G	C	53	34	87	0	0	87	0	0
3	9727675	rs787837	T	C	52	53	105	0	0	105	0	0
3	9732339	rs4684650	G	A	28	36	64	0	0	64	0	0
3	9733962	rs4684651	T	C	13	25	38	0	1	39	0	0
3	9734855	rs4684652	A	G	16	30	46	0	0	46	0	0
3	9735001	rs7617347	T	A	16	19	35	0	0	35	0	0
3	9735085	rs7615134	A	C	16	21	37	0	0	37	0	0
3	9735683	rs11131183	G	A	24	14	38	0	0	38	0	0
3	9735908	rs159147	G	A	14	10	24	0	0	24	0	0
3	9736452	rs12490544	C	G	23	16	39	0	0	39	0	0
3	9739235	rs6795630	G	A	15	10	25	0	1	26	0	0
3	9740598	rs12495642	G	A	14	5	19	0	1	20	0	0
3	9798773	rs1052133	C	G	5	7	12	0	0	12	0	0
3	9821914	rs14204	C	T	103	97	200	0	1	201	0	0
3	9829171	rs2290309	G	A	5	2	7	0	0	7	0	0
3	9834538	rs41278549	G	A	4	4	8	0	0	8	0	0
3	9841366	rs6772098	A	C	5	2	7	0	0	7	0	0
3	9847673	rs7637785	A	C	9	12	21	0	0	21	0	0
3	9852148	rs9827444	G	A	3	3	6	0	0	6	0	0
3	9859198	rs11131190	G	A	3	5	8	0	0	8	0	0
3	9859456	rs3806672	C	G	8	4	12	0	0	12	0	0
3	9859460	rs3806671	C	T	4	8	12	0	0	12	0	0
3	9859777	rs3806670	G	T	18	7	25	0	0	25	0	0
3	9860623	rs3806668	T	G	4	2	6	0	0	6	0	0
3	9867625	rs3732527	C	T	43	30	73	0	0	73	0	0
3	9869375	rs9827315	C	T	6	3	9	0	0	9	0	0
3	9870414	rs17050593	C	T	6	1	7	0	0	7	0	0
3	9870857	rs2290303	G	A	36	32	68	0	3	71	0	0
3	9871030	rs2290305	T	G	44	53	97	0	1	98	0	0
3	9877452	rs4686377	G	A	26	11	37	0	0	37	0	0
3	9877481	rs9878419	G	A	15	12	27	0	1	28	0	0
3	9877783	rs9878944	G	A	16	13	29	0	0	29	0	0
3	9883021	rs2426	G	A	5	6	11	0	0	11	0	0
3	9932337	rs279558	G	C	10	7	17	0	0	17	0	0
3	9934605	rs279553	T	C	18	13	31	0	0	31	0	0
3	9935773	rs279542	C	G	3	4	7	0	0	7	0	0
3	9970158	rs279548	C	T	15	15	30	0	1	31	0	0
3	10059436	rs8411	T	C	75	53	128	0	3	131	0	0
3	10142949	rs3172417	C	T	10	7	17	0	0	17	0	0
3	10207116	.	G	T	1	6	7	0	0	7	0	0
3	10207798	.	A	G	3	3	6	0	0	6	0	0
3	10255902	rs11465899	C	T	3	3	6	0	0	6	0	0
3	10259114	rs6804954	G	A	7	6	13	0	0	13	0	0
3	10259756	rs67180243	A	G	6	3	9	0	0	9	0	0
3	10260217	rs55890954	C	T	4	5	9	0	0	9	0	0
3	10261295	rs11465909	C	T	5	4	9	0	0	9	0	0
3	10264480	rs3844283	C	G	38	70	108	0	2	110	0	0
3	10276163	rs708035	T	A	60	66	126	0	1	127	0	0
3	10280233	rs778044	C	T	2	4	6	0	0	6	0	0
3	10280753	rs11465932	G	A	5	3	8	0	0	8	0	0
3	10282609	rs73028494	C	T	5	2	7	0	0	7	0	0
3	10282755	rs62240097	G	T	9	2	11	0	0	11	0	0
3	10283550	rs776509	C	A	2	4	6	0	0	6	0	0
3	10322337	.	T	A	258	204	462	0	2	464	0	0
3	10325750	rs171336	T	G	2	6	8	0	0	8	0	0
3	10326686	rs35684	A	G	14	8	22	0	0	22	0	0
3	10328250	rs35683	A	C	4	2	6	0	0	6	0	0
3	10332365	rs26802	T	G	5	2	7	0	0	7	0	0
3	10332468	rs27647	C	T	14	15	29	0	0	29	0	0
3	10342876	rs696221	C	T	246	232	478	0	12	490	0	0
3	10343244	rs35673	G	A	13	20	33	0	0	33	0	0
3	10345180	rs35672	G	T	10	10	20	0	0	20	0	0
3	10347707	rs154235	G	A	2	7	9	0	0	9	0	0
3	10348749	rs241504	A	T	3	3	6	0	0	6	0	0
3	10349446	rs526437	C	T	9	3	12	0	0	12	0	0
3	10351694	rs73030488	G	A	2	9	11	0	0	11	0	0
3	10351830	rs35668	G	A	2	7	9	0	0	9	0	0
3	10355584	rs154238	C	G	17	14	31	0	0	31	0	0
3	10356146	rs154237	A	C	11	12	23	0	1	24	0	0
3	10356314	rs154236	C	T	9	18	27	0	0	27	0	0
3	10356740	rs118693	T	A	11	4	15	0	0	15	0	0
3	10356760	rs118694	G	A	10	6	16	0	0	16	0	0
3	10359250	rs629067	C	T	5	9	14	0	1	15	0	0
3	10359462	rs28349	A	G	6	3	9	0	0	9	0	0
3	11235419	rs6774099	G	T	8	7	15	0	0	15	0	0
3	11320120	rs384989	C	T	5	3	8	0	0	8	0	0
3	11325276	rs2594966	G	A	36	12	48	0	0	48	0	0
3	11329085	rs346081	A	G	3	3	6	0	0	6	0	0
3	11329216	rs346082	C	G	4	2	6	0	1	7	0	0
3	11395821	rs2594973	C	G	2	4	6	0	0	6	0	0
3	11396100	rs9873503	T	C	2	5	7	0	0	7	0	0
3	11396101	rs9853547	C	G	2	5	7	0	0	7	0	0
3	11396562	rs2606738	T	C	9	3	12	0	0	12	0	0
3	11596302	rs8154	T	C	15	18	33	0	1	34	0	0
3	11598378	rs9881151	T	C	139	152	291	0	3	294	0	0
3	11599733	rs7355828	G	A	115	94	209	0	3	212	0	0
3	11601360	rs9848960	C	T	3	7	10	0	0	10	0	0
3	11602577	rs9854573	C	T	3	7	10	0	0	10	0	0
3	11602608	rs11344852	C	G	3	4	7	0	0	7	0	0
3	11602910	rs9855241	C	T	2	4	6	0	0	6	0	0
3	11605373	rs9832407	A	G	3	4	7	0	0	7	0	0
3	11607235	rs892937	C	G	2	5	7	0	0	7	0	0
3	11687852	rs9310387	G	A	31	16	47	0	0	47	0	0
3	11687863	rs9310388	A	G	31	19	50	0	0	50	0	0
3	11687952	rs9310389	C	T	16	9	25	0	0	25	0	0
3	11886451	rs380999	G	A	10	11	21	0	0	21	0	0
3	12641349	rs5746226	A	G	3	3	6	0	0	6	0	0
3	12641350	rs5746225	A	G	3	3	6	0	0	6	0	0
3	12878465	rs3773304	C	A	9	10	19	0	0	19	0	0
3	12878553	rs3773305	T	C	8	9	17	0	0	17	0	0
3	12880030	rs3821608	G	C	9	7	16	0	0	16	0	0
3	12939546	rs9211	G	A	41	41	82	0	1	83	0	0
3	12940346	rs14191	G	A	38	21	59	0	0	59	0	0
3	12941094	rs3773308	G	A	39	35	74	0	0	74	0	0
3	12942328	rs3773309	T	C	39	20	59	0	1	60	0	0
3	12959695	rs2596900	T	C	6	2	8	0	0	8	0	0
3	13357903	rs185249331	C	T	336	367	703	0	0	703	0	0
3	13357986	rs354476	A	G	372	371	743	0	2	745	0	0
3	13358130	rs1048620	C	T	391	375	766	0	7	773	0	0
3	13358171	rs1048637	T	G	406	350	756	0	3	760	1	0
3	13358204	rs1048650	G	A	417	415	832	0	2	834	0	0
3	13358819	.	A	G	414	428	842	0	9	851	0	0
3	13361287	rs354478	C	T	317	257	574	0	4	578	0	0
3	13364876	rs514084	G	T	302	259	561	0	5	566	0	0
3	13365653	rs673373	T	C	2	4	6	0	0	6	0	0
3	13366873	rs652613	C	G	4	3	7	0	0	7	0	0
3	13367406	rs665064	C	T	293	275	568	0	12	580	0	0
3	13368892	rs2271509	G	A	293	261	554	0	0	554	0	0
3	13379400	rs3773302	C	T	171	169	340	0	5	345	0	0
3	13383540	rs2271504	A	G	220	253	473	0	0	473	0	0
3	13389533	rs75671719	G	A	25	22	47	0	0	47	0	0
3	13390629	rs6806012	A	G	10	10	20	0	0	20	0	0
3	13390740	rs6795149	T	G	1	5	6	0	0	6	0	0
3	13395475	rs2280085	G	C	150	148	298	0	0	298	0	0
3	13395579	rs2280084	C	A	147	143	290	0	3	293	0	0
3	13407556	rs3732671	T	C	132	145	277	0	1	278	0	0
3	13418086	rs6442377	C	A	14	11	25	0	0	25	0	0
3	13418327	rs3796322	C	T	6	7	13	0	0	13	0	0
3	13418331	rs3796321	A	T	5	8	13	0	1	14	0	0
3	13418383	rs3796320	G	A	7	11	18	0	0	18	0	0
3	13421150	rs7628051	C	T	144	170	314	0	1	315	0	0
3	13460172	rs149476272	C	G	2	4	6	0	0	6	0	0
3	13546937	rs77021151	G	A	8	11	19	0	0	19	0	0
3	14177194	rs2607765	T	C	6	13	19	0	0	19	0	0
3	14179422	rs2731329	A	G	11	4	15	0	0	15	0	0
3	14179453	rs2731328	C	G	8	4	12	0	0	12	0	0
3	14180552	rs2607767	A	G	8	7	15	0	0	15	0	0
3	14180633	rs2731320	C	T	7	9	16	0	0	16	0	0
3	14183410	rs1043943	T	C	129	130	259	0	0	259	0	0
3	14183758	rs1043953	A	G	113	152	265	0	1	267	1	0
3	14184074	rs13069	A	C	80	122	202	0	8	210	0	0
3	14184669	rs8516	T	C	126	132	258	0	5	263	0	0
3	14184719	rs10468	T	C	155	161	316	0	5	321	0	0
3	14186823	rs2470458	T	C	20	17	37	0	0	37	0	0
3	14186830	rs2470352	A	T	19	19	38	0	0	38	0	0
3	14187345	rs2229090	G	C	14	26	40	0	1	41	0	0
3	14187449	rs2228001	G	T	13	19	32	0	0	32	0	0
3	14199887	rs2228000	G	A	16	9	25	0	0	25	0	0
3	14199908	rs2227999	C	T	19	11	30	0	0	30	0	0
3	14240226	rs62232866	G	A	5	2	7	0	0	7	0	0
3	14240501	rs2733552	A	G	3	4	7	0	0	7	0	0
3	14446873	rs58589206	G	T	3	3	6	0	0	6	0	0
3	14446890	rs1156567	G	C	4	2	6	0	0	6	0	0
3	14497019	rs3773179	G	T	2	11	13	0	0	13	0	0
3	14511840	rs11928756	T	C	4	3	7	0	1	8	0	0
3	14513456	rs55853390	C	T	5	5	10	0	0	10	0	0
3	14529557	rs190375178	G	A	22	14	36	0	0	36	0	0
3	14703297	rs9840626	C	T	6	3	9	0	0	9	0	0
3	14704235	rs12498035	A	G	2	8	10	0	0	10	0	0
3	14707132	rs3773489	A	C	4	2	6	0	0	6	0	0
3	14712473	rs1901	G	A	81	68	149	0	0	149	0	0
3	14713058	rs11717438	G	T	34	23	57	0	1	58	0	0
3	14713121	rs11717411	C	G	33	18	51	0	0	51	0	0
3	14713306	rs11709673	A	G	20	24	44	0	0	44	0	0
3	14713526	rs13081145	G	A	21	19	40	0	2	42	0	0
3	14719946	rs7633080	C	T	2	6	8	0	0	8	0	0
3	15276562	rs35189473	G	A	36	22	58	0	0	58	0	0
3	15310004	rs3773468	C	G	5	2	7	0	0	7	0	0
3	15311464	rs1287468	G	T	20	15	35	0	0	35	0	0
3	15312276	rs1287469	C	T	15	11	26	0	0	26	0	0
3	15313598	rs2688668	G	A	11	9	20	0	0	20	0	0
3	15314812	rs4036835	T	C	12	14	26	0	0	26	0	0
3	15315029	rs4036836	G	A	6	9	15	0	0	15	0	0
3	15317608	rs4685243	A	G	5	6	11	0	0	11	0	0
3	15317675	rs4685244	T	C	7	3	10	0	0	10	0	0
3	15318013	rs988682	G	A	6	8	14	0	0	14	0	0
3	15319103	rs12634507	C	G	3	6	9	0	0	9	0	0
3	15319518	rs12330149	A	G	3	4	7	0	0	7	0	0
3	15319545	rs12330571	C	G	4	4	8	0	0	8	0	0
3	15320333	rs60785976	G	A	6	3	9	0	0	9	0	0
3	15321269	rs11128741	G	A	7	5	12	0	0	12	0	0
3	15322501	rs6772096	A	G	0	8	8	0	0	8	0	0
3	15322923	rs6772489	A	G	2	4	6	0	0	6	0	0
3	15325149	rs826431	C	T	5	5	10	0	0	10	0	0
3	15331349	rs79748777	C	T	6	2	8	0	0	8	0	0
3	15333106	rs2729687	G	T	4	2	6	0	0	6	0	0
3	15337700	rs712869	A	T	5	2	7	0	0	7	0	0
3	15338861	rs1287641	G	C	3	5	8	0	0	8	0	0
3	15345364	.	T	G	2	5	7	0	0	7	0	0
3	15345924	rs9828229	G	A	3	3	6	0	0	6	0	0
3	15354990	rs9810098	A	T	3	4	7	0	0	7	0	0
3	15367319	rs56414062	A	G	28	34	62	0	1	63	0	0
3	15367638	rs56066728	T	A	36	39	75	0	0	76	1	0
3	15367840	rs57223949	C	T	3	6	9	0	0	9	0	0
3	15371621	rs3773465	C	T	5	6	11	0	0	11	0	0
3	15470856	rs6766406	A	C	3	3	6	0	0	6	0	0
3	15471963	rs6807620	C	T	5	1	6	0	0	6	0	0
3	15473764	rs1563416	G	A	9	6	15	0	0	15	0	0
3	15482775	rs6778562	C	G	228	226	454	0	1	455	0	0
3	15483426	.	T	G	210	154	364	0	1	365	0	0
3	15483830	rs1048608	A	G	234	284	518	0	2	520	0	0
3	15491756	rs3274	G	A	4	2	6	0	0	6	0	0
3	15492150	rs3846128	C	T	7	10	17	0	0	17	0	0
3	15492786	rs2278962	T	A	6	10	16	0	1	17	0	0
3	15492807	rs2278961	G	A	9	12	21	0	0	21	0	0
3	15502130	rs7628975	A	G	3	4	7	0	0	7	0	0
3	15611366	rs6797859	A	G	2	4	6	0	0	6	0	0
3	15613279	rs56298314	T	G	4	3	7	0	0	7	0	0
3	15614339	rs12635456	A	G	6	7	13	0	0	13	0	0
3	15717614	rs17041435	G	A	55	34	89	0	0	89	0	0
3	15743203	rs12488774	T	C	6	5	11	0	0	11	0	0
3	15817094	.	T	C	6	8	14	0	0	14	0	0
3	15818130	rs150524506	G	C	32	23	55	0	0	55	0	0
3	15820052	rs112867551	G	C	60	75	135	0	2	137	0	0
3	15832547	rs73040253	C	T	8	6	14	0	0	14	0	0
3	16299968	rs842252	G	A	6	3	9	0	0	9	0	0
3	16300625	rs842254	T	C	3	4	7	0	0	7	0	0
3	16301564	rs842255	G	A	5	2	7	0	0	7	0	0
3	16305674	rs14080	C	G	17	6	23	0	0	23	0	0
3	16312564	rs842259	C	T	5	4	9	0	0	9	0	0
3	16327855	rs842274	T	G	10	1	11	0	0	11	0	0
3	16354096	rs949756	A	G	3	5	8	0	0	8	0	0
3	16357978	rs842424	T	A	96	76	172	0	4	176	0	0
3	16358383	.	G	A	84	46	130	0	2	132	0	0
3	16358584	rs690241	T	C	78	60	138	0	0	138	0	0
3	16359071	rs574668	G	A	2	4	6	0	0	6	0	0
3	16360345	rs689716	T	C	8	8	16	0	0	16	0	0
3	16360833	rs555948	A	C	4	8	12	0	0	12	0	0
3	16362129	rs478483	G	T	3	5	8	0	0	8	0	0
3	16362300	rs842421	T	C	9	8	17	0	0	17	0	0
3	16363689	rs538180	T	A	5	5	10	0	0	10	0	0
3	16364919	rs690216	A	C	78	65	143	0	0	143	0	0
3	16495468	rs4684281	A	G	4	9	13	0	0	13	0	0
3	16495542	rs4685341	A	G	6	7	13	0	0	13	0	0
3	16495771	rs77197813	T	A	3	3	6	0	0	6	0	0
3	16497772	rs58969168	C	A	1	5	6	0	0	6	0	0
3	16497854	rs9824582	T	A	1	5	6	0	0	6	0	0
3	16502009	rs58458328	T	C	4	5	9	0	0	9	0	0
3	16504557	rs17042294	C	T	4	2	6	0	0	6	0	0
3	16504830	rs56010341	T	C	8	4	12	0	0	12	0	0
3	16504949	rs59510526	T	C	1	5	6	0	0	6	0	0
3	16505355	rs59403460	G	A	9	5	14	0	0	14	0	0
3	16505411	rs17042300	T	G	6	5	11	0	0	11	0	0
3	16505610	rs17042304	G	A	4	6	10	0	0	10	0	0
3	16507325	rs1517520	C	T	10	5	15	0	1	16	0	0
3	16508057	rs6767890	A	G	6	6	12	0	0	12	0	0
3	16547665	rs9854409	G	A	4	4	8	0	1	9	0	0
3	16547738	rs34240418	G	C	11	10	21	0	1	22	0	0
3	16551213	rs2881513	C	G	5	7	12	0	0	12	0	0
3	16551287	rs1429163	G	A	11	9	20	0	0	20	0	0
3	16551540	rs28680533	G	A	10	12	22	0	0	22	0	0
3	16551795	rs11128793	C	A	13	10	23	0	0	23	0	0
3	17131421	rs35185988	C	T	9	9	18	0	0	18	0	0
3	17131501	rs11549706	C	T	7	5	12	0	0	12	0	0
3	18055231	rs61978649	A	C	13	13	26	0	0	26	0	0
3	18149144	rs1113786	G	T	4	3	7	0	0	7	0	0
3	18150244	rs1355726	C	G	6	5	11	0	0	11	0	0
3	18152182	rs143971876	T	C	0	6	6	0	0	6	0	0
3	18152292	rs11924785	A	C	5	2	7	0	0	7	0	0
3	18230131	rs2001792	T	C	2	18	20	0	0	20	0	0
3	18310505	rs12714955	C	T	7	2	9	0	0	9	0	0
3	18387611	rs7427289	T	A	7	13	20	0	0	20	0	0
3	18388620	rs68076437	C	T	5	12	17	0	0	17	0	0
3	18391303	rs12492270	A	T	4	7	11	0	0	11	0	0
3	18391667	rs35039109	T	G	3	6	9	0	0	9	0	0
3	18392551	rs12630303	G	A	2	4	6	0	0	6	0	0
3	18392692	rs7627392	A	C	3	3	6	0	0	6	0	0
3	18397682	rs6577640	C	T	9	6	15	0	0	15	0	0
3	18416972	rs9814665	C	T	3	3	6	0	0	6	0	0
3	18417102	rs73038369	G	T	5	3	8	0	0	8	0	0
3	18426851	rs9758860	A	G	6	11	17	0	0	17	0	0
3	18426898	rs9758869	A	C	4	10	14	0	0	14	0	0
3	18427924	rs2229261	G	T	203	208	411	0	1	412	0	0
3	18428450	rs13321420	C	T	8	8	16	0	1	17	0	0
3	18431029	rs13089991	A	G	7	6	13	0	0	13	0	0
3	18435601	rs9858924	C	A	2	6	8	0	0	8	0	0
3	18438158	rs9310564	A	G	4	7	11	0	0	11	0	0
3	18452539	rs7641608	T	C	18	47	65	0	1	66	0	0
3	18465822	rs114898672	T	C	18	10	28	0	7	35	0	0
3	18466059	rs73040343	A	G	66	39	105	0	2	107	0	0
3	18487158	rs7645355	G	C	7	2	9	0	0	9	0	0
3	20120653	rs62243100	A	G	5	3	8	0	0	8	0	0
3	20120811	rs9864695	T	C	5	7	12	0	0	12	0	0
3	20195395	rs68050031	C	T	13	19	32	0	0	32	0	0
3	22423338	rs4472062	G	C	36	0	36	0	4	40	0	0
3	22423717	rs200955161	T	C	24	0	24	0	0	24	0	0
3	23269006	rs4858063	G	A	6	7	13	0	1	14	0	0
3	23284359	rs143458819	C	T	6	5	11	0	0	11	0	0
3	23300276	rs6762546	C	T	10	3	13	0	0	13	0	0
3	23312956	rs2884787	C	T	2	8	10	0	0	10	0	0
3	23313837	rs2359754	A	C	6	2	8	0	0	8	0	0
3	23313843	rs2359755	A	C	6	2	8	0	0	8	0	0
3	23314241	rs2088129	G	A	6	6	12	0	0	12	0	0
3	23314438	rs73037723	T	C	11	2	13	0	0	13	0	0
3	23388882	rs140198067	A	T	3	7	10	0	0	10	0	0
3	23393845	rs13319402	C	G	5	2	7	0	0	7	0	0
3	23396247	rs77090762	C	T	3	4	7	0	0	7	0	0
3	23396320	rs148462165	C	T	6	4	10	0	1	11	0	0
3	23401446	rs9757330	G	C	6	4	10	0	0	10	0	0
3	23401462	rs9758590	T	A	5	3	8	0	0	8	0	0
3	23401647	rs2047339	G	A	3	4	7	0	0	7	0	0
3	23459329	rs1695180	G	T	2	4	6	0	0	6	0	0
3	23632234	rs7631705	T	C	4	6	10	0	0	10	0	0
3	23633010	rs62256989	A	G	3	3	6	0	1	7	0	0
3	23854643	rs4858090	G	A	5	1	6	0	0	6	0	0
3	23859061	rs6774787	T	C	4	4	8	0	0	8	0	0
3	23895465	rs34986000	T	A	5	4	9	0	0	9	0	0
3	23900401	rs6779573	C	A	2	4	6	0	0	6	0	0
3	23901028	rs6779537	T	A	6	4	10	0	0	10	0	0
3	23902733	rs17787211	C	T	4	3	7	0	0	7	0	0
3	23904444	rs1139150	C	T	3	3	6	0	0	6	0	0
3	23906463	rs11710679	A	G	6	7	13	0	0	13	0	0
3	23907775	rs17787217	T	C	9	7	16	0	1	17	0	0
3	23909393	rs73825124	A	G	5	5	10	0	0	10	0	0
3	23911593	rs4538321	C	T	5	4	9	0	0	9	0	0
3	23911939	rs13085379	G	C	7	6	13	0	0	13	0	0
3	23913408	rs376937160	C	T	3	3	6	0	0	6	0	0
3	23914674	rs73825170	G	A	6	3	9	0	0	9	0	0
3	23916460	rs6798386	C	G	3	9	12	0	0	12	0	0
3	23919444	rs11711380	C	T	6	9	15	0	0	15	0	0
3	23921779	rs6797686	C	T	5	3	8	0	0	8	0	0
3	23930271	rs73825178	T	C	24	27	51	0	1	52	0	0
3	23933969	rs8933	C	A	5	13	18	0	0	18	0	0
3	23934115	rs6789983	T	G	2	4	6	0	0	6	0	0
3	23942831	rs9836860	A	G	10	4	14	0	0	14	0	0
3	23959425	rs35629664	C	G	2688	2445	5133	0	9	5142	0	0
3	23961762	rs1133926	A	G	1164	1127	2291	0	7	2298	0	0
3	23963183	rs9755750	G	A	6	2	8	0	0	8	0	0
3	23964951	rs9834166	C	T	4	5	9	0	0	9	0	0
3	23965214	rs73825181	T	G	5	1	6	0	0	6	0	0
3	23965336	rs9838694	G	T	7	7	14	0	0	14	0	0
3	23988113	rs62253380	G	C	9	1	10	0	0	10	0	0
3	25698704	rs11917359	G	A	7	2	9	0	0	9	0	0
3	25702770	rs190264988	G	A	5	5	10	0	0	10	0	0
3	25771957	rs7652535	T	C	2	4	6	0	0	6	0	0
3	27442336	rs3736312	G	A	4	2	6	0	0	6	0	0
3	28377006	rs115995900	G	A	5	6	11	0	0	11	0	0
3	30650064	rs6550005	A	G	6	5	11	0	0	11	0	0
3	30664321	rs7644802	G	A	6	2	8	0	0	8	0	0
3	30697661	rs1019855	A	G	3	3	6	0	0	6	0	0
3	30700498	rs3773637	A	G	2	4	6	0	0	6	0	0
3	30700922	rs995435	A	G	2	4	6	0	0	6	0	0
3	30701756	rs67578310	C	T	10	49	59	0	1	60	0	0
3	30702152	rs79013507	A	T	51	10	61	0	2	64	1	0
3	30702212	rs34033344	G	T	5	36	41	0	0	41	0	0
3	30740192	rs1870700	C	T	5	1	6	0	0	6	0	0
3	31574227	.	G	A	24	36	60	0	0	60	0	0
3	31574258	rs62234703	A	C	25	23	48	0	0	48	0	0
3	31575056	rs76374061	A	G	4	3	7	0	0	7	0	0
3	31575172	rs73824170	G	C	5	7	12	0	0	12	0	0
3	31584438	rs6763173	A	T	4	4	8	0	0	8	0	0
3	31639335	rs9835139	A	T	6	3	9	0	0	9	0	0
3	31640597	rs13095077	A	G	3	3	6	0	0	6	0	0
3	31647716	rs9812889	G	A	7	1	8	0	0	8	0	0
3	31650288	rs7433833	C	T	3	3	6	0	0	6	0	0
3	31651335	rs7349468	G	A	6	2	8	0	0	8	0	0
3	31654626	rs11708385	G	T	3	3	6	0	0	6	0	0
3	31661754	rs9859349	G	A	16	11	27	0	0	27	0	0
3	31661857	rs73062047	G	A	9	9	18	0	2	20	0	0
3	31664171	rs9681121	C	T	4	8	12	0	0	12	0	0
3	31668300	rs62234756	A	G	8	9	17	0	1	18	0	0
3	31673470	rs62234758	C	T	6	4	10	0	0	10	0	0
3	31674165	.	T	G	6	1	7	0	0	7	0	0
3	31676340	rs9817781	A	G	7	6	13	0	1	14	0	0
3	31676450	.	C	T	8	7	15	0	0	15	0	0
3	31678512	rs9828641	A	G	78	48	126	0	3	129	0	0
3	32209750	rs3087806	T	C	8	6	14	0	0	14	0	0
3	32209927	rs7363	A	G	10	14	24	0	0	24	0	0
3	32493682	rs342745	A	G	8	1	9	0	0	9	0	0
3	32523287	rs17029597	A	C	314	333	647	0	1	648	0	0
3	32531442	rs6793004	G	A	10	11	21	0	0	21	0	0
3	32533010	rs7640978	C	T	24	16	40	0	0	40	0	0
3	32533246	rs35574803	T	C	155	143	298	0	1	299	0	0
3	32535382	rs9834932	A	G	3	9	12	0	0	12	0	0
3	32537791	rs342763	C	T	1	5	6	0	0	6	0	0
3	32538236	rs113775470	T	C	4	4	8	0	0	8	0	0
3	32538247	rs3773777	C	T	5	4	9	0	0	9	0	0
3	32568632	rs62252794	G	A	9	0	9	0	0	9	0	0
3	32578505	rs2303857	T	C	100	88	188	0	4	193	1	0
3	32584688	rs62252796	C	A	5	3	8	0	0	8	0	0
3	32995928	rs2228428	C	T	1	7	8	0	0	8	0	0
3	33087057	rs11927929	T	C	20	5	25	0	0	25	0	0
3	33087200	rs6780220	A	C	14	37	51	0	0	51	0	0
3	33087348	rs34840292	C	T	6	5	11	0	0	11	0	0
3	33087395	rs35480293	C	A	5	4	9	0	0	9	0	0
3	33118631	rs9865342	G	A	9	1	10	0	0	10	0	0
3	33126972	rs73043340	C	T	1	5	6	0	1	7	0	0
3	33128011	rs61319121	C	T	9	1	10	0	0	10	0	0
3	33128784	rs9815409	G	A	4	3	7	0	0	7	0	0
3	33128891	rs62250506	G	A	8	0	8	0	0	8	0	0
3	33131070	rs9311003	C	T	1	5	6	0	1	7	0	0
3	33138549	rs7637099	G	A	37	39	76	0	0	76	0	0
3	33155782	rs11558338	G	A	32	34	66	0	0	66	0	0
3	33161898	rs4076086	C	T	274	257	531	0	0	531	0	0
3	33164827	rs6774417	T	C	5	1	6	0	0	6	0	0
3	33174156	rs1135127	T	G	420	360	780	0	5	785	0	0
3	33174168	rs1135128	G	A	429	357	786	0	2	788	0	0
3	33185407	rs4678475	G	A	28	44	72	0	1	73	0	0
3	33186356	rs1127898	T	C	99	112	211	0	0	211	0	0
3	33187425	rs1132392	G	A	5	17	22	0	0	22	0	0
3	33187831	rs4678478	C	T	9	10	19	0	0	19	0	0
3	33430093	rs11260	G	A	65	96	161	0	3	164	0	0
3	33432307	rs4678951	C	A	4	3	7	0	0	7	0	0
3	33432951	rs13084502	C	T	5	8	13	0	1	14	0	0
3	33434831	rs2293250	G	A	55	50	105	0	0	105	0	0
3	33447076	rs12492331	C	T	5	4	9	0	0	9	0	0
3	33449228	rs17030628	C	T	10	7	17	0	0	17	0	0
3	33458266	rs3736563	T	C	62	81	143	0	2	145	0	0
3	33468329	rs9311014	G	T	1	5	6	0	0	6	0	0
3	33478266	rs4678584	G	A	4	2	6	0	1	7	0	0
3	33539893	rs13954	A	G	1	5	6	0	0	6	0	0
3	33543487	rs115643461	A	T	3	7	10	0	0	10	0	0
3	33543628	rs1532590	T	C	2	7	9	0	0	9	0	0
3	33551726	rs114424311	G	A	3	3	6	0	0	6	0	0
3	33552155	rs61735757	G	A	17	10	27	0	0	27	0	0
3	33586917	rs115926391	C	T	5	2	7	0	0	7	0	0
3	33588636	rs9819067	A	C	6	9	15	0	0	15	0	0
3	33589233	rs115459388	G	A	5	2	7	0	0	7	0	0
3	33589835	rs147700082	G	A	5	2	7	0	0	7	0	0
3	33590241	rs112811508	C	T	1	5	6	0	0	6	0	0
3	33608875	rs6774696	T	C	4	2	6	0	0	6	0	0
3	33738851	rs12492346	T	C	3	3	6	0	0	6	0	0
3	33759390	rs115396290	G	C	7	3	10	0	0	10	0	0
3	36869439	rs4789	T	C	10	12	22	0	1	23	0	0
3	36898381	rs41511748	G	A	3	7	10	0	0	10	0	0
3	37030175	rs9311149	C	A	15	23	38	0	1	39	0	0
3	37032296	rs1046512	A	C	29	43	72	0	1	73	0	0
3	37032370	rs3172297	T	C	10	13	23	0	0	23	0	0
3	37053568	rs1799977	A	G	19	15	34	0	0	34	0	0
3	37094679	rs4579	G	A	24	27	51	0	0	51	0	0
3	37095070	rs10849	C	T	57	64	121	0	0	121	0	0
3	37106115	rs1468713	A	G	5	3	8	0	0	8	0	0
3	37107022	rs7639375	C	A	6	5	11	0	0	11	0	0
3	37107470	rs2302503	G	A	16	22	38	0	1	39	0	0
3	37108896	rs6550448	T	A	15	9	24	0	0	24	0	0
3	37109633	rs56180213	C	A	8	9	17	0	0	17	0	0
3	37111130	rs9823428	G	A	2	4	6	0	0	6	0	0
3	37113405	rs17810211	T	C	5	8	13	0	0	13	0	0
3	37115658	rs1558527	T	C	3	7	10	0	0	10	0	0
3	37116042	rs7651033	C	T	4	7	11	0	0	11	0	0
3	37116386	rs2302504	G	T	5	1	6	0	0	6	0	0
3	37184473	rs336601	G	A	99	65	164	0	0	164	0	0
3	37185143	rs7640224	A	T	46	68	114	0	1	115	0	0
3	37185960	rs10154916	T	C	37	32	69	0	0	69	0	0
3	37187398	rs4678939	C	T	20	28	48	0	1	49	0	0
3	37187513	rs4678940	G	A	11	20	31	0	0	31	0	0
3	37188318	rs6550458	T	A	6	8	14	0	0	14	0	0
3	37210874	rs11920928	T	C	10	9	19	0	0	19	0	0
3	37211972	rs931721	T	C	1	5	6	0	0	6	0	0
3	37214204	rs17811658	T	C	14	14	28	0	0	28	0	0
3	37214685	rs4678944	C	T	83	24	107	0	1	108	0	0
3	37217622	rs9829683	C	A	58	55	113	0	0	113	0	0
3	37285152	rs2271548	C	T	2	5	7	0	0	7	0	0
3	37317043	rs3733028	T	C	2	5	7	0	1	8	0	0
3	37358764	rs10865876	A	G	0	7	7	0	0	7	0	0
3	37366459	rs11718848	C	A	23	24	47	0	0	47	0	0
3	37368755	rs62241896	T	A	32	23	55	0	1	56	0	0
3	37407489	rs17266090	A	G	3	4	7	0	0	7	0	0
3	37407664	rs62241901	G	T	107	91	198	0	0	198	0	0
3	37514459	rs183197	A	G	2	5	7	0	0	7	0	0
3	37523079	rs17227748	G	A	91	86	177	0	2	179	0	0
3	37781278	rs1402755	C	T	6	4	10	0	0	10	0	0
3	37782318	rs62241530	G	A	5	7	12	0	0	12	0	0
3	37782388	rs9840828	T	G	6	4	10	0	0	10	0	0
3	37826845	rs1984311	C	T	18	7	25	0	0	25	0	0
3	37827545	rs4084868	T	C	0	7	7	0	0	7	0	0
3	37827962	rs7625632	G	A	8	8	16	0	0	16	0	0
3	37828110	rs71614158	A	C	9	8	17	0	1	18	0	0
3	37828111	rs76307127	A	C	11	7	18	0	0	18	0	0
3	37829174	rs2685108	A	T	24	24	48	0	0	48	0	0
3	37829791	rs9875428	T	G	23	22	45	0	0	45	0	0
3	37829959	rs7609597	A	G	14	9	23	0	1	24	0	0
3	37830119	rs2507947	T	A	23	24	47	0	0	47	0	0
3	37850052	rs75433234	T	C	2	4	6	0	0	6	0	0
3	37863134	rs2844420	G	A	37	46	83	0	1	84	0	0
3	38175477	.	C	T	102	91	193	0	2	195	0	0
3	38258179	rs272576	T	C	3	3	6	0	0	6	0	0
3	38288805	rs139273983	A	G	3	4	7	0	0	7	0	0
3	39104002	rs78065750	T	G	6	3	9	0	0	9	0	0
3	39107597	rs149271782	A	G	9	8	17	0	0	17	0	0
3	39108974	rs3732373	G	A	8	8	16	0	1	17	0	0
3	39135551	rs17852414	G	A	115	128	243	0	2	245	0	0
3	39184353	rs704960	C	T	1356	1390	2746	0	22	2769	1	0
3	39185077	rs1274957	G	A	1088	975	2063	0	18	2081	0	0
3	39186038	rs784518	C	G	35	77	112	0	0	112	0	0
3	39186150	rs7621922	A	C	78	44	122	0	3	125	0	0
3	39186200	rs7610619	C	G	69	44	113	0	1	114	0	0
3	39187597	rs784516	G	A	106	103	209	0	0	210	1	0
3	39187858	rs13084317	G	A	91	83	174	0	1	175	0	0
3	39188351	rs1105163	C	T	28	20	48	0	0	48	0	0
3	39188843	rs885067	A	G	17	17	34	0	0	34	0	0
3	39190775	rs1274964	A	G	14	16	30	0	0	30	0	0
3	39191029	rs1274963	A	G	8	7	15	0	0	15	0	0
3	39191043	rs1274962	T	C	10	8	18	0	0	18	0	0
3	39191335	rs1274961	T	C	12	16	28	0	0	28	0	0
3	39192542	rs1274960	T	C	18	26	44	0	0	44	0	0
3	39195462	rs2249736	G	T	9	12	21	0	0	21	0	0
3	39225075	rs114470485	G	A	2	8	10	0	0	10	0	0
3	39431081	rs2270770	G	A	146	109	255	0	1	256	0	0
3	39432247	rs2276715	C	T	11	11	22	0	1	23	0	0
3	39432785	rs45503293	C	T	20	15	35	0	1	36	0	0
3	39434704	rs34719646	G	C	4	2	6	0	0	6	0	0
3	39438599	rs6890	T	A	78	77	155	0	1	156	0	0
3	39448804	rs1472508	G	A	3	4	7	0	0	7	0	0
3	39449137	rs1803893	T	C	2308	604	2912	0	13	2926	1	0
3	39450751	rs62242644	G	T	7	2	9	0	0	9	0	0
3	39451712	rs7621701	T	A	5	3	8	0	0	8	0	0
3	39452123	rs2077797	G	A	15	10	25	0	0	25	0	0
3	39452129	rs2077799	G	T	16	11	27	0	0	27	0	0
3	39453057	rs2269349	C	T	7	8	15	0	0	15	0	0
3	39453610	rs2723	C	T	14	16	30	0	0	30	0	0
3	39543427	rs2175722	G	T	3	3	6	0	0	6	0	0
3	40351484	rs11709089	C	T	30	14	44	0	0	44	0	0
3	40352051	rs9826419	G	A	22	8	30	0	1	31	0	0
3	40352134	rs3214006	C	T	12	12	24	0	0	24	0	0
3	40352647	rs1454491	C	G	9	16	25	0	0	25	0	0
3	40352884	rs1454492	C	T	7	6	13	0	0	13	0	0
3	41272663	.	A	G	22	20	42	0	0	42	0	0
3	41756965	rs61744388	C	T	11	10	21	0	0	21	0	0
3	41756986	rs61744385	A	T	9	8	17	0	1	18	0	0
3	41831203	rs17215589	C	T	13	15	28	0	0	28	0	0
3	41847979	rs143787364	A	G	3	4	7	0	0	7	0	0
3	41877414	rs3774372	T	C	13	19	32	0	0	32	0	0
3	41925398	rs1052501	C	T	23	13	36	0	0	36	0	0
3	41952852	rs35263917	T	C	15	19	34	0	0	34	0	0
3	41960006	rs1716975	T	C	10	12	22	0	1	23	0	0
3	41977464	rs73071203	A	C	4	7	11	0	0	11	0	0
3	41978738	rs73071208	A	T	44	75	119	0	0	119	0	0
3	41996136	rs2272007	T	C	72	49	121	0	4	125	0	0
3	42002761	rs55916855	A	G	1	5	6	0	1	7	0	0
3	42057101	rs939561	G	A	1	6	7	0	0	7	0	0
3	42131415	rs1995137	A	G	6	4	10	0	0	10	0	0
3	42131501	rs1995136	G	C	4	3	7	0	1	8	0	0
3	42131734	rs2173336	C	T	9	1	10	0	0	10	0	0
3	42131829	rs2133069	C	G	4	2	6	0	0	6	0	0
3	42141253	rs13434127	T	C	2	5	7	0	0	7	0	0
3	42181396	rs11129942	C	T	4	3	7	0	0	7	0	0
3	42238457	rs145742623	C	G	8	3	11	0	0	11	0	0
3	42266621	rs4478056	T	C	19	10	29	0	2	31	0	0
3	42591455	rs78297236	G	A	17	20	37	0	1	38	0	0
3	42591943	rs2241542	G	A	13	18	31	0	0	31	0	0
3	42592319	rs342536	T	C	17	8	25	0	2	27	0	0
3	42592874	rs342537	T	C	19	13	32	0	0	32	0	0
3	42607384	rs75644663	A	G	2	6	8	0	0	8	0	0
3	42610374	rs2271186	A	G	43	37	80	0	0	80	0	0
3	42636141	rs4549	G	A	201	134	335	0	3	339	1	0
3	42652674	rs3774402	A	G	3	4	7	0	0	7	0	0
3	42665278	rs3774407	G	T	2	4	6	0	0	6	0	0
3	42669393	rs17074673	A	G	4	6	10	0	0	10	0	0
3	42669460	rs17074674	T	C	6	8	14	0	0	14	0	0
3	42670219	rs58868911	T	C	7	7	14	0	0	14	0	0
3	42670348	rs59914338	G	A	15	10	25	0	0	25	0	0
3	42670449	rs339733	A	G	8	9	17	0	0	17	0	0
3	42671668	rs17074680	T	G	12	8	20	0	0	20	0	0
3	42672486	rs1062051	G	A	2	6	8	0	0	8	0	0
3	42679497	rs35890296	C	T	47	39	86	0	2	88	0	0
3	42679777	rs33969824	T	G	42	46	88	0	1	89	0	0
3	42680000	rs35770315	C	T	69	54	123	0	1	124	0	0
3	42689109	rs67533173	G	T	59	58	117	0	0	117	0	0
3	42689777	rs8351	T	G	99	79	178	0	1	180	1	0
3	42700630	rs339723	A	G	4	5	9	0	0	9	0	0
3	42799765	rs17238798	G	A	3	7	10	0	0	10	0	0
3	42826041	rs6865	T	G	17	13	30	0	0	30	0	0
3	43121559	rs604033	C	T	11	5	16	0	2	18	0	0
3	43122966	rs2936818	G	A	7	8	15	0	0	15	0	0
3	44762830	rs56084453	A	G	0	18	18	0	0	18	0	0
3	44801090	rs62244221	C	T	4	4	8	0	0	8	0	0
3	44802882	.	G	C	13	1	14	0	0	14	0	0
3	44956860	rs6622	C	T	16	16	32	0	0	32	0	0
3	44958773	rs7644978	T	C	9	16	25	0	0	25	0	0
3	44973377	.	C	A	3	3	6	0	0	6	0	0
3	44973680	rs62242619	G	T	4	6	10	0	0	10	0	0
3	45052775	rs6794	G	C	59	39	98	0	0	98	0	0
3	45124498	rs79950616	G	A	30	27	57	0	1	58	0	0
3	45125566	rs4682765	C	T	13	17	30	0	0	30	0	0
3	45126558	rs2176804	C	T	19	17	36	0	0	36	0	0
3	45201365	rs6806366	T	C	25	0	25	0	1	26	0	0
3	45266555	rs33749	T	C	6	7	13	0	0	13	0	0
3	45557707	rs11549809	G	A	5	9	14	0	0	14	0	0
3	45636213	rs267239	C	G	19	23	42	0	1	43	0	0
3	45636335	rs267238	A	G	26	24	50	0	2	52	0	0
3	45637253	rs267237	C	T	17	31	48	0	0	48	0	0
3	45637439	rs267236	T	C	33	26	59	0	1	60	0	0
3	45718327	rs7640969	T	G	5	6	11	0	0	11	0	0
3	45719209	rs2247771	T	C	22	23	45	0	1	46	0	0
3	45747497	rs2373047	C	A	2	4	6	0	0	6	0	0
3	45748429	rs2742441	G	A	4	5	9	0	0	9	0	0
3	45748435	rs2673039	A	G	4	6	10	0	0	10	0	0
3	45748599	rs2742442	T	A	3	3	6	0	0	6	0	0
3	45748632	rs2673038	A	G	2	6	8	0	0	8	0	0
3	45749094	rs2673037	A	T	10	10	20	0	1	21	0	0
3	45749722	rs2245705	T	C	2	5	7	0	0	7	0	0
3	45779136	rs1468542	A	T	21	26	47	0	0	47	0	0
3	46449978	rs11266744	A	C	6	7	13	0	0	13	0	0
3	46450070	rs3204849	T	A	8	7	15	0	0	15	0	0
3	46480958	rs2073495	C	G	91	77	168	0	1	169	0	0
3	46711135	rs3747519	T	C	6	12	18	0	1	19	0	0
3	46711300	rs3747520	C	T	4	4	8	0	0	8	0	0
3	46711507	rs3827495	C	T	11	3	14	0	0	14	0	0
3	46711807	rs11711100	C	T	0	7	7	0	0	7	0	0
3	46723551	rs4683310	G	A	4	4	8	0	0	8	0	0
3	46727909	rs34935085	C	A	2	4	6	0	0	6	0	0
3	46751229	rs56002857	C	T	4	2	6	0	0	6	0	0
3	46752153	rs4683315	G	A	5	2	7	0	0	7	0	0
3	47042546	.	C	T	94	89	183	0	2	185	0	0
3	47065255	rs71328912	C	T	4	7	11	0	0	11	0	0
3	47101751	rs115293106	C	T	8	2	10	0	0	10	0	0
3	47385389	rs148682976	G	A	6	8	14	0	0	14	0	0
3	47459679	rs12487736	C	T	27	47	74	0	0	74	0	0
3	47466580	.	C	T	2	4	6	0	0	6	0	0
3	47712202	rs1141601	T	C	116	104	220	0	0	220	0	0
3	47894101	rs1875103	C	T	157	142	299	0	7	306	0	0
3	48299439	rs6787500	T	C	3	3	6	0	0	6	0	0
3	48309828	rs11718329	C	G	2	4	6	0	1	7	0	0
3	48312060	rs6442111	G	C	6	7	13	0	0	13	0	0
3	48312229	rs1045482	A	G	1	9	10	0	1	11	0	0
3	48312402	rs3937	T	C	2	13	15	0	0	15	0	0
3	48335808	rs1134867	T	C	12	4	16	0	0	16	0	0
3	48335857	rs3197223	C	T	9	3	12	0	0	12	0	0
3	48636507	rs9166	G	T	96	85	181	0	0	181	0	0
3	48663344	rs141959192	C	T	39	31	70	0	0	70	0	0
3	49060253	.	C	T	20	10	30	0	0	30	0	0
3	49146656	rs113592495	T	G	22	29	51	0	0	51	0	0
3	49322027	rs2304442	T	A	11	5	16	0	0	16	0	0
3	49331060	rs9883409	T	C	29	30	59	0	1	60	0	0
3	49332815	rs17080505	G	C	5	2	7	0	0	7	0	0
3	49333171	rs2334956	C	A	8	5	13	0	1	14	0	0
3	49334608	rs3774799	G	C	11	12	23	0	0	23	0	0
3	49334627	rs35260967	G	A	11	12	23	0	0	23	0	0
3	49334797	rs35395347	A	G	8	7	15	0	1	16	0	0
3	49335745	rs35220094	C	T	1	6	7	0	0	7	0	0
3	49336232	rs11720964	T	C	13	1	14	0	0	14	0	0
3	49343175	rs2230929	G	A	151	143	294	0	0	294	0	0
3	49349444	rs11709788	G	C	3	3	6	0	0	6	0	0
3	49356578	.	A	G	6	3	9	0	1	10	0	0
3	49358646	rs34915642	G	A	13	7	20	0	0	20	0	0
3	49359102	rs35869135	A	G	1	8	9	0	0	9	0	0
3	49359943	rs9873994	T	C	10	6	16	0	0	16	0	0
3	49362369	rs56038006	C	T	134	112	246	0	0	246	0	0
3	49394834	rs1050450	G	A	1371	2095	3466	0	19	3485	0	0
3	49395743	.	C	T	17	19	36	0	0	36	0	0
3	49395757	rs1800668	G	A	7	4	11	0	0	11	0	0
3	49399259	rs1987628	G	A	31	34	65	0	0	66	1	0
3	49405164	rs67485053	A	G	6	4	10	0	0	10	0	0
3	49406080	rs2878298	T	C	7	8	15	0	0	15	0	0
3	49406708	rs148734725	G	A	6	0	6	0	0	6	0	0
3	49407229	rs7373849	G	A	16	13	29	0	0	29	0	0
3	49407660	rs34588335	G	C	8	9	17	0	0	17	0	0
3	49408974	rs13087851	A	G	4	4	8	0	0	8	0	0
3	49409704	rs17595772	G	A	16	6	22	0	0	22	0	0
3	49411404	rs7621003	T	C	2	4	6	0	0	6	0	0
3	49412559	rs6809216	G	A	5	9	14	0	0	14	0	0
3	49453834	rs6997	C	T	77	82	159	0	0	159	0	0
3	49455330	rs11715915	C	T	5	2	7	0	0	7	0	0
3	49459376	rs1464566	T	C	5	1	6	0	0	6	0	0
3	49507847	rs4855839	G	A	5	3	8	0	0	8	0	0
3	49570200	rs1801143	C	T	14	14	28	0	0	28	0	0
3	49570882	rs1050088	T	C	9	13	22	0	0	22	0	0
3	49572140	rs4625	A	G	12	19	31	0	0	31	0	0
3	49714225	rs1131095	T	C	56	41	97	0	0	97	0	0
3	49721532	rs3197999	G	A	5	3	8	0	0	8	0	0
3	49723784	.	C	A	5	3	8	0	0	8	0	0
3	49737954	rs35620248	G	A	14	21	35	0	0	35	0	0
3	49738945	rs6804655	C	T	18	19	37	0	0	37	0	0
3	49750188	rs3749240	T	A	8	9	17	0	0	17	0	0
3	49751585	rs2291542	C	T	41	27	68	0	0	68	0	0
3	49758764	rs4768	A	G	75	64	139	0	1	140	0	0
3	49762626	rs140864960	G	A	39	34	73	0	1	74	0	0
3	49762662	rs7634902	G	T	37	27	64	0	1	65	0	0
3	49763338	rs1049256	T	C	38	24	62	0	0	62	0	0
3	49770032	rs3749237	G	A	4	5	9	0	0	9	0	0
3	49819102	rs11130221	C	G	5	3	8	0	0	8	0	0
3	49843723	rs3819325	T	C	3	3	6	0	0	6	0	0
3	49847623	rs1799845	A	G	21	12	33	0	2	35	0	0
3	49849723	rs1799843	G	A	7	9	16	0	0	16	0	0
3	49866392	rs1128535	C	T	6	4	10	0	0	10	0	0
3	50097319	rs2245365	C	A	17	12	29	0	0	29	0	0
3	50098112	rs2624815	A	G	9	6	15	0	0	15	0	0
3	50108792	rs3774734	C	A	4	3	7	0	0	7	0	0
3	50109073	rs9856572	A	T	4	2	6	0	0	6	0	0
3	50114515	rs7061	C	T	119	134	253	0	0	253	0	0
3	50128386	rs2240326	G	A	13	6	19	0	0	19	0	0
3	50128893	rs2624853	A	G	8	8	16	0	0	16	0	0
3	50131140	rs17225749	T	A	5	8	13	0	0	13	0	0
3	50135412	rs7648652	A	C	12	9	21	0	0	21	0	0
3	50136165	rs6808044	A	G	12	13	25	0	1	26	0	0
3	50136463	rs13095697	G	A	12	13	25	0	0	25	0	0
3	50139142	rs2856234	A	G	30	31	61	0	0	61	0	0
3	50144951	rs1061474	T	C	91	80	171	0	1	172	0	0
3	50148305	rs2301166	C	G	14	16	30	0	0	30	0	0
3	50152491	rs62263602	C	T	5	4	9	0	0	9	0	0
3	50153356	rs1138536	T	C	228	278	506	0	3	511	2	0
3	50154989	rs2624825	G	A	83	87	170	0	1	171	0	0
3	50155468	rs2624826	T	G	145	147	292	0	5	297	0	0
3	50278717	rs58051625	G	C	4	6	10	0	0	10	0	0
3	50281168	rs10510755	C	T	12	10	22	0	0	22	0	0
3	50284052	.	C	T	10	10	20	0	0	20	0	0
3	50285677	rs57319506	T	C	6	4	10	0	0	10	0	0
3	50286325	.	C	T	11	9	20	0	0	20	0	0
3	50291617	rs9852677	G	A	9	7	16	0	0	16	0	0
3	50291785	rs2282751	G	A	3	3	6	0	0	6	0	0
3	50294066	rs41291724	C	G	35	28	63	0	1	64	0	0
3	50332697	rs13100173	G	A	13	10	23	0	0	23	0	0
3	50369546	rs2073498	C	A	193	137	330	0	1	331	0	0
3	50369914	rs78501918	A	G	26	26	52	0	2	54	0	0
3	50371432	rs2236947	C	A	18	24	42	0	0	42	0	0
3	50374293	rs2073499	A	G	23	20	43	0	0	43	0	0
3	50375066	rs79536844	C	T	8	5	13	0	0	13	0	0
3	50388607	rs2233474	C	A	17	14	31	0	0	31	0	0
3	50597092	rs1034405	G	A	2	5	7	0	0	7	0	0
3	50609624	rs2232248	T	G	16	21	37	0	0	37	0	0
3	50644134	rs175634	C	T	47	40	87	0	0	87	0	0
3	50645793	rs622502	C	G	2	5	7	0	0	7	0	0
3	50649370	rs6768300	C	G	4	3	7	0	0	7	0	0
3	50679244	rs6791880	G	A	5	19	24	0	0	24	0	0
3	50686062	rs1385025	G	A	301	273	574	0	2	576	0	0
3	50708169	rs13075344	T	C	35	33	68	0	0	68	0	0
3	51432895	rs4687569	T	C	17	10	27	0	0	27	0	0
3	51738256	rs4067	A	G	46	51	97	0	0	97	0	0
3	52523121	.	C	G	18	10	28	0	1	29	0	0
3	52551110	.	G	A	496	444	940	0	6	946	0	0
3	52870618	rs4687663	T	A	3	11	14	0	0	14	0	0
3	52871101	rs1139106	G	A	19	27	46	0	1	47	0	0
3	52871929	rs3733047	G	A	30	18	48	0	1	49	0	0
3	52873984	rs11626	C	T	29	18	47	0	1	48	0	0
3	52874288	rs6445538	T	C	24	17	41	0	1	42	0	0
3	52874296	rs6445539	G	A	22	13	35	0	0	35	0	0
3	53215799	rs7630325	G	A	26	17	43	0	0	43	0	0
3	53215875	rs11130350	A	C	22	21	43	0	0	43	0	0
3	53216419	rs143052840	G	A	14	15	29	0	0	29	0	0
3	53216692	rs13084863	C	T	31	18	49	0	0	49	0	0
3	53217413	rs2306572	A	G	12	3	15	0	0	15	0	0
3	53220215	rs2230494	G	A	152	139	291	0	4	295	0	0
3	53220569	rs45596236	G	A	18	38	56	0	0	56	0	0
3	53221987	rs3773722	G	A	7	1	8	0	0	8	0	0
3	53222761	rs2306574	C	T	215	202	417	0	4	421	0	0
3	53224507	.	A	C	8	7	15	0	0	15	0	0
3	53259155	rs17306163	T	A	28	53	81	0	2	83	0	0
3	53259769	.	G	A	612	96	708	0	41	752	3	0
3	53259996	rs3816767	G	A	9	1	10	0	0	10	0	0
3	53260099	rs7647720	A	T	7	1	8	0	0	8	0	0
3	53260325	rs7650103	A	G	12	0	12	0	0	12	0	0
3	53261677	rs11719464	T	C	15	4	19	0	0	19	0	0
3	53265581	rs17234092	C	T	11	4	15	0	0	15	0	0
3	53267155	rs2242301	G	A	18	3	21	0	0	21	0	0
3	53268122	rs34107310	C	T	13	1	14	0	0	14	0	0
3	53268137	rs35794580	C	A	11	1	12	0	1	13	0	0
3	53268242	rs13074156	G	A	15	1	16	0	0	16	0	0
3	53268429	rs3773739	A	G	9	4	13	0	0	13	0	0
3	53268545	rs3773740	T	C	9	2	11	0	0	11	0	0
3	53269743	rs60499054	G	A	7	0	7	0	0	7	0	0
3	53269904	rs4687715	G	A	1	8	9	0	0	9	0	0
3	53270344	rs3773744	T	C	8	0	8	0	0	8	0	0
3	53270424	rs3773745	A	G	8	0	8	0	0	8	0	0
3	53270928	rs2884495	T	C	14	1	15	0	0	15	0	0
3	53270947	rs2358621	A	C	14	1	15	0	0	15	0	0
3	53272314	rs3773747	T	C	28	98	126	0	0	126	0	0
3	53272782	rs62255988	G	A	30	74	104	0	0	104	0	0
3	53318868	rs11551405	C	A	115	124	239	0	0	239	0	0
3	53319203	rs1108506	C	G	125	110	235	0	4	239	0	0
3	53321002	rs6792874	T	C	60	51	111	0	0	111	0	0
3	53321631	rs9628	A	C	123	119	242	0	1	243	0	0
3	53323914	rs2279319	T	C	6	9	15	0	0	15	0	0
3	53328655	rs62256057	C	T	4	2	6	0	0	6	0	0
3	53328703	rs17307289	A	C	4	3	7	0	0	7	0	0
3	53328868	rs73080271	C	G	5	5	10	0	0	10	0	0
3	53328883	rs7643417	A	G	4	5	9	0	0	9	0	0
3	53337444	rs62256962	G	A	4	3	7	0	0	7	0	0
3	53345623	rs17307574	T	C	3	4	7	0	1	8	0	0
3	53349036	rs62256965	A	G	3	3	6	0	0	6	0	0
3	56761650	rs808	A	G	140	96	236	0	2	238	0	0
3	56763316	rs1565376	G	A	129	88	217	0	1	218	0	0
3	56763328	rs1565377	T	C	132	95	227	0	0	227	0	0
3	56771251	rs3772219	A	C	89	65	154	0	2	156	0	0
3	57542173	rs2241988	C	T	63	62	125	0	0	125	0	0
3	57545993	rs7618684	A	C	36	35	71	0	3	74	0	0
3	57546198	rs1979074	G	A	101	84	185	0	1	186	0	0
3	57549891	rs7631048	A	G	8	3	11	0	0	11	0	0
3	57550839	rs113175072	G	C	1	6	7	0	0	7	0	0
3	57562480	rs1134702	A	C	3	6	9	0	0	9	0	0
3	57567248	rs9879889	C	A	4	6	10	0	0	10	0	0
3	57567263	rs11720508	C	T	5	4	9	0	1	10	0	0
3	57567891	rs11130590	T	A	3	6	9	0	0	9	0	0
3	57571491	rs6445913	G	A	3	3	6	0	0	6	0	0
3	57577615	rs73084420	A	G	2	5	7	0	0	7	0	0
3	57581563	rs113166996	A	T	12	3	15	0	0	15	0	0
3	57582552	rs73084426	G	A	3	5	8	0	0	8	0	0
3	57611237	rs8059	A	G	26	16	42	0	0	42	0	0
3	57612300	rs6770988	G	A	27	37	64	0	0	64	0	0
3	57612623	rs6762914	T	C	18	15	33	0	0	33	0	0
3	57613454	rs56135778	G	C	15	23	38	0	0	38	0	0
3	57662948	rs17058450	C	T	5	1	6	0	0	6	0	0
3	57742725	rs7427792	G	T	8	8	16	0	0	16	0	0
3	57840871	rs11717914	G	A	5	3	8	0	0	8	0	0
3	57841453	.	C	A	0	6	6	0	0	6	0	0
3	57842757	rs9840125	A	G	3	3	6	0	0	6	0	0
3	57842953	rs9878303	C	G	2	7	9	0	0	9	0	0
3	57882601	rs17058639	C	T	38	34	72	0	1	73	0	0
3	57888325	rs73088398	A	G	3	3	6	0	0	6	0	0
3	57888588	rs73088399	T	C	2	4	6	0	0	6	0	0
3	57890426	rs9811472	C	T	2	4	6	0	0	6	0	0
3	57891278	rs4681654	T	G	4	5	9	0	0	9	0	0
3	57894043	rs4681764	T	C	4	4	8	0	0	8	0	0
3	57894223	rs4681655	T	C	3	4	7	0	0	7	0	0
3	57896054	rs113167437	G	A	13	7	20	0	0	20	0	0
3	57897885	rs73090308	A	G	24	29	53	0	0	53	0	0
3	57913714	rs1057719	A	G	40	39	79	0	3	82	0	0
3	57914178	rs1043045	T	C	37	42	79	0	1	80	0	0
3	58002106	rs12715519	C	A	0	20	20	0	0	20	0	0
3	58081888	rs1522384	T	C	110	125	235	0	1	236	0	0
3	58091098	rs7638552	C	T	5	7	12	0	0	12	0	0
3	58095466	rs2708318	G	T	1	13	14	0	0	14	0	0
3	58095500	rs2686635	G	T	2	10	12	0	0	12	0	0
3	58098444	rs7615893	T	C	11	4	15	0	0	15	0	0
3	58099177	rs13327831	T	G	5	5	10	0	0	10	0	0
3	58099183	rs56143512	G	A	5	5	10	0	0	10	0	0
3	58099675	rs7616838	A	G	9	4	13	0	0	13	0	0
3	58099780	rs55905032	T	C	4	4	8	0	0	8	0	0
3	58100274	rs34349120	A	C	3	4	7	0	0	7	0	0
3	58100416	rs7428240	A	G	6	3	9	0	0	9	0	0
3	58100447	rs7430045	G	T	6	2	8	0	0	8	0	0
3	58100769	rs7653042	C	T	4	4	8	0	1	9	0	0
3	58101555	rs12630504	T	G	15	4	19	0	1	20	0	0
3	58109162	rs1131356	G	A	122	134	256	0	1	257	0	0
3	58112440	rs2362903	A	G	112	109	221	0	2	223	0	0
3	58112488	rs2362904	C	T	100	92	192	0	1	193	0	0
3	58118555	rs12632456	G	A	143	149	292	0	1	293	0	0
3	58126223	rs4284952	A	C	4	2	6	0	0	6	0	0
3	58130168	rs2362911	A	G	3	3	6	0	0	6	0	0
3	58137846	.	T	A	1	6	7	0	0	7	0	0
3	58144340	rs6787425	T	C	13	13	26	0	0	26	0	0
3	58145263	rs12634123	G	A	13	5	18	0	0	18	0	0
3	58146860	rs150794391	G	C	15	6	21	0	0	21	0	0
3	58150433	rs4234386	C	T	7	11	18	0	0	18	0	0
3	58151947	rs2362901	C	G	6	13	19	0	0	19	0	0
3	58152065	rs2362902	A	C	8	11	19	0	1	20	0	0
3	58152108	rs4299451	A	G	9	9	18	0	0	18	0	0
3	58152745	rs4343595	A	C	5	8	13	0	0	13	0	0
3	58152799	rs2885645	A	G	3	12	15	0	0	15	0	0
3	58154327	rs8640	C	T	337	309	646	0	5	652	1	0
3	58154671	rs4681787	T	C	3	5	8	0	0	8	0	0
3	58156176	rs4681660	G	A	13	15	28	0	0	29	1	0
3	58157519	rs1131264	G	C	307	293	600	0	2	602	0	0
3	58292300	rs17355543	C	T	9	4	13	0	0	13	0	0
3	58292485	rs28404421	G	A	7	1	8	0	0	8	0	0
3	58304112	rs1135089	C	T	15	11	26	0	2	28	0	0
3	58304608	rs3210776	C	G	7	6	13	0	0	13	0	0
3	58304692	rs112424860	C	T	7	4	11	0	0	11	0	0
3	58305033	rs14927	A	C	18	15	33	0	0	33	0	0
3	58305079	rs12688	T	C	15	16	31	0	2	33	0	0
3	58305235	rs10687	G	T	12	14	26	0	0	26	0	0
3	58306946	rs11713627	T	G	5	6	11	0	0	11	0	0
3	58307644	rs6777105	A	G	8	7	15	0	0	15	0	0
3	58307693	rs12638947	G	A	7	9	16	0	1	17	0	0
3	58307829	rs1913714	G	T	5	7	12	0	0	12	0	0
3	58308214	rs1913715	G	A	4	7	11	0	0	11	0	0
3	58308331	rs1913716	G	A	7	5	12	0	0	12	0	0
3	58308519	rs6791748	G	A	4	2	6	0	0	6	0	0
3	58308960	rs1055973	T	C	2	4	6	0	1	7	0	0
3	58309602	rs2280166	C	T	2	6	8	0	0	8	0	0
3	58393574	rs4518147	T	G	5	2	7	0	0	7	0	0
3	58396163	rs12629939	T	C	3	4	7	0	0	7	0	0
3	58397399	rs56267535	A	G	2	6	8	0	0	8	0	0
3	58398813	rs13071422	A	G	3	4	7	0	0	7	0	0
3	58403806	rs9846867	A	G	5	3	8	0	1	9	0	0
3	58403811	rs6762478	A	G	3	6	9	0	0	9	0	0
3	58404486	rs4470539	C	G	3	10	13	0	0	13	0	0
3	58405284	rs4320076	T	G	10	7	17	0	0	17	0	0
3	58406693	rs6772652	A	G	20	20	40	0	1	41	0	0
3	58407837	rs9822328	T	C	38	25	63	0	0	63	0	0
3	58408247	rs12490706	A	G	32	22	54	0	0	54	0	0
3	58408353	rs12497256	G	A	43	30	73	0	1	74	0	0
3	58408765	rs6782218	T	C	9	13	22	0	1	23	0	0
3	58408910	rs6767291	C	T	27	29	56	0	0	56	0	0
3	58409063	rs12631656	T	C	18	16	34	0	1	35	0	0
3	58409082	rs12634132	A	G	13	16	29	0	0	29	0	0
3	58409679	rs12486031	G	A	27	34	61	0	0	61	0	0
3	58409763	rs12485999	C	T	24	17	41	0	1	42	0	0
3	58409927	rs74727114	G	C	31	29	60	0	0	60	0	0
3	58409972	rs12492472	A	C	34	34	68	0	0	68	0	0
3	58410431	rs11714515	A	G	24	30	54	0	1	55	0	0
3	58413405	rs1126737	T	C	12	10	22	0	1	23	0	0
3	58413465	rs7231	G	C	30	29	59	0	0	59	0	0
3	58413662	rs7230	G	A	62	47	109	0	1	110	0	0
3	58414382	rs62259769	C	T	26	32	58	0	0	58	0	0
3	58415590	rs2070662	C	A	3	4	7	0	0	7	0	0
3	58417014	rs7644348	G	A	8	1	9	0	0	9	0	0
3	58417190	rs7644457	G	C	4	3	7	0	0	7	0	0
3	61728256	rs680294	G	T	0	20	20	0	0	20	0	0
3	61728564	rs3817452	G	A	12	0	12	0	1	13	0	0
3	63850298	rs6779372	T	G	4	2	6	0	0	7	1	0
3	63850299	rs3733120	G	C	4	3	7	0	0	7	0	0
3	63850660	rs3733121	C	G	2	5	7	0	0	7	0	0
3	63864612	rs832195	T	C	7	6	13	0	0	13	0	0
3	63899626	rs138280523	A	C	6	1	7	0	1	8	0	0
3	63900477	rs7627690	C	A	8	5	13	0	0	13	0	0
3	63900923	rs573393342	T	C	11	8	19	0	0	19	0	0
3	63901180	rs6809100	A	G	1	5	6	0	0	6	0	0
3	63947128	rs6801346	G	A	7	7	14	0	0	14	0	0
3	63967900	rs1053338	A	G	43	54	97	0	0	97	0	0
3	63974477	rs3774726	C	T	10	12	22	0	1	23	0	0
3	63981419	.	A	G	82	66	148	0	1	149	0	0
3	63982082	rs3774729	G	A	69	73	142	0	4	146	0	0
3	63986170	rs13272	A	G	55	51	106	0	1	107	0	0
3	63988171	rs3733126	C	T	95	123	218	0	2	220	0	0
3	63996262	rs1046025	C	T	24	17	41	0	0	41	0	0
3	63997491	rs2280162	G	A	22	16	38	0	0	38	0	0
3	63997896	rs2280160	G	A	4	4	8	0	0	8	0	0
3	63999823	rs6802053	A	C	12	8	20	0	0	20	0	0
3	64000464	rs66473811	T	C	37	39	76	0	0	76	0	0
3	64001925	rs9879045	C	T	21	5	26	0	3	29	0	0
3	64003589	rs140682323	A	G	19	27	46	0	1	47	0	0
3	64003983	rs831692	G	A	20	7	27	0	0	27	0	0
3	64004101	rs17344090	T	C	24	20	44	0	0	44	0	0
3	64008510	rs3846221	T	C	11	7	18	0	0	18	0	0
3	66348475	rs782748	C	A	6	3	9	0	0	9	0	0
3	66349124	.	A	G	5	3	8	0	0	8	0	0
3	66419942	rs1129179	A	G	156	104	260	0	0	260	0	0
3	66419956	rs13874	C	T	169	106	275	0	1	276	0	0
3	66422369	rs7631431	A	G	4	3	7	0	0	7	0	0
3	66424645	rs62243216	C	T	4	7	11	0	0	11	0	0
3	66424979	rs12488247	G	C	8	4	12	0	0	12	0	0
3	66425061	rs332377	G	C	0	7	7	0	0	7	0	0
3	66425953	rs332376	A	G	9	6	15	0	0	15	0	0
3	66426241	rs13071458	A	C	19	12	31	0	0	31	0	0
3	66427038	rs9654021	G	A	5	4	9	0	1	10	0	0
3	66427885	rs231276	A	G	6	7	13	0	0	13	0	0
3	66428282	rs1046844	C	T	151	121	272	0	0	272	0	0
3	66428450	rs1046867	G	A	68	56	124	0	0	124	0	0
3	66430811	rs2279290	T	G	9	10	19	0	0	19	0	0
3	66433676	rs900171	A	G	5	10	15	0	0	15	0	0
3	66433937	rs9872772	T	G	4	8	12	0	0	12	0	0
3	67048762	rs4856833	T	C	16	10	26	0	0	26	0	0
3	67061488	rs114707650	G	A	60	51	111	0	1	112	0	0
3	69075791	rs67138835	A	T	8	6	14	0	0	14	0	0
3	69076210	rs113699639	G	A	3	6	9	0	0	9	0	0
3	69082657	rs937859	T	C	14	9	23	0	2	25	0	0
3	69085845	rs11128108	C	T	5	1	6	0	0	6	0	0
3	69086463	rs11128109	C	T	4	7	11	0	0	11	0	0
3	69093997	rs1463957	T	C	16	26	42	0	0	42	0	0
3	69094894	rs2314230	C	T	16	19	35	0	2	37	0	0
3	69098435	rs3732628	A	G	13	10	23	0	0	23	0	0
3	69098939	rs17005254	A	C	3	6	9	0	0	9	0	0
3	69099328	rs114445898	T	A	10	11	21	0	1	22	0	0
3	69099746	rs10865643	G	A	5	6	11	0	0	11	0	0
3	69101369	rs41291197	C	T	56	49	105	0	0	105	0	0
3	69106304	rs1866264	C	T	4	7	11	0	0	11	0	0
3	69106305	rs1866265	C	G	4	7	11	0	0	11	0	0
3	69128682	rs3755718	T	C	4	5	9	0	0	9	0	0
3	69128743	rs3755719	A	G	4	6	10	0	0	10	0	0
3	69151501	rs9856591	C	T	1	5	6	0	0	6	0	0
3	69152593	rs7650936	C	G	6	2	8	0	0	8	0	0
3	69153854	rs7038	G	T	333	354	687	0	2	689	0	0
3	69154343	rs7039	C	G	144	156	300	0	2	302	0	0
3	70016904	rs704246	C	T	2	4	6	0	0	6	0	0
3	71015640	rs3773496	G	A	3	5	8	0	0	8	0	0
3	71018517	rs9845197	C	G	4	2	6	0	0	6	0	0
3	71018894	rs62257217	C	T	2	5	7	0	0	7	0	0
3	71136310	rs182018598	C	A	6	0	6	0	0	6	0	0
3	71258187	rs939840	C	T	4	2	6	0	0	6	0	0
3	71258386	rs939841	T	C	3	3	6	0	0	6	0	0
3	71824151	rs2322142	C	T	16	6	22	0	0	22	0	0
3	71824257	rs75433452	G	A	9	2	11	0	0	11	0	0
3	71824375	rs79745559	G	A	12	3	15	0	0	15	0	0
3	71825739	rs6807443	G	C	9	10	19	0	0	19	0	0
3	71825763	rs6807450	G	A	11	12	23	0	0	23	0	0
3	71826229	rs2322144	G	A	12	1	13	0	0	13	0	0
3	72149119	rs3749430	A	G	2	5	7	0	0	7	0	0
3	72149144	rs3749431	A	G	2	4	6	0	0	6	0	0
3	72424471	rs12956	A	G	57	77	134	0	2	136	0	0
3	72426070	.	T	A	29	24	53	0	1	54	0	0
3	72426073	.	T	A	35	18	53	0	2	55	0	0
3	72432888	rs7628338	G	A	8	4	12	0	0	12	0	0
3	72437681	rs59193875	G	A	4	3	7	0	0	7	0	0
3	72469651	rs4676875	T	C	1	5	6	0	0	6	0	0
3	72488540	rs12497521	G	C	14	34	48	0	1	49	0	0
3	72490752	rs2028240	G	T	6	11	17	0	0	17	0	0
3	72494085	rs13318329	G	A	8	9	17	0	1	18	0	0
3	72494218	rs116083406	G	A	7	4	11	0	0	11	0	0
3	72863504	rs3821561	T	C	2	8	10	0	0	10	0	0
3	87284001	rs6800357	G	A	11	3	14	0	0	14	0	0
3	87285444	rs4859049	A	G	3	3	6	0	0	6	0	0
3	87295049	rs11540913	T	C	131	125	256	0	2	258	0	0
3	87295368	rs1825899	T	A	4	6	10	0	0	10	0	0
3	87295512	rs56064230	C	G	3	10	13	0	0	13	0	0
3	87301263	rs3804602	T	C	8	3	11	0	0	11	0	0
3	87301445	rs2009491	C	A	11	6	17	0	0	17	0	0
3	87301600	rs2009663	C	A	14	5	19	0	1	20	0	0
3	87301674	rs2009668	C	T	16	8	24	0	0	24	0	0
3	87304561	rs1060241	G	A	8	9	17	0	0	17	0	0
3	96069524	.	G	A	9	0	9	0	1	10	0	0
3	98225441	rs1132750	A	C	7	5	12	0	0	12	0	0
3	98238737	.	A	C	17	20	37	0	0	37	0	0
3	98239269	rs112164618	G	A	14	11	25	0	0	25	0	0
3	98453010	rs278372	C	A	5	2	7	0	0	7	0	0
3	98486212	rs72932678	C	T	7	5	12	0	0	12	0	0
3	98501219	.	C	T	5	1	6	0	0	6	0	0
3	98509587	rs278390	G	A	4	6	10	0	0	10	0	0
3	98514041	rs12203	G	C	6	5	11	0	0	11	0	0
3	98515161	rs704586	G	A	7	7	14	0	0	14	0	0
3	98515569	rs8833	C	T	3	5	8	0	0	8	0	0
3	98541116	rs828616	G	A	2	4	6	0	0	6	0	0
3	99582242	rs809415	G	T	8	6	14	0	0	14	0	0
3	99583484	rs1718235	C	T	6	8	14	0	0	14	0	0
3	99584429	rs1626074	G	A	5	3	8	0	0	8	0	0
3	99886662	rs11537816	G	A	19	20	39	0	0	39	0	0
3	100430675	rs6777763	G	A	2	5	7	0	0	7	0	0
3	100449501	rs3773922	C	T	7	8	15	0	0	15	0	0
3	100451780	rs10936343	T	C	6	7	13	0	0	13	0	0
3	100452573	rs4928085	T	C	13	13	26	0	0	26	0	0
3	100452644	rs10936345	C	G	8	10	18	0	0	18	0	0
3	100452668	rs10936346	G	C	8	12	20	0	0	20	0	0
3	100452911	rs1012364	T	A	5	1	6	0	0	6	0	0
3	100454278	rs931206	A	G	6	10	16	0	0	16	0	0
3	100455139	rs3773921	T	C	25	16	41	0	0	41	0	0
3	100458260	rs7617184	G	A	9	10	19	0	1	20	0	0
3	100458996	rs41373752	A	G	8	8	16	0	0	16	0	0
3	100459375	rs13078643	C	T	21	11	32	0	0	32	0	0
3	100460603	rs4928086	T	G	17	23	40	0	0	40	0	0
3	100463268	rs2293030	A	C	29	37	66	0	0	66	0	0
3	100463984	rs13092027	T	C	3	16	19	0	0	19	0	0
3	100467676	rs7297	A	T	147	163	310	0	3	313	0	0
3	101065451	rs144275796	C	A	5	4	9	0	0	9	0	0
3	101068620	rs2553419	C	T	7	6	13	0	0	13	0	0
3	101177848	rs6809436	T	G	24	23	47	0	0	47	0	0
3	101283792	rs3762735	C	G	44	44	88	0	0	88	0	0
3	101293565	rs1078154	A	T	6	6	12	0	0	12	0	0
3	101293676	rs1078153	A	G	7	7	14	0	1	15	0	0
3	101295502	rs35917542	T	A	147	1	148	0	14	162	0	0
3	101295584	rs4234491	C	T	11	42	53	0	7	60	0	0
3	101297354	rs16844078	A	G	4	6	10	0	0	10	0	0
3	101297747	rs7621062	C	G	9	9	18	0	0	18	0	0
3	101297772	rs7621068	C	T	7	8	15	0	0	15	0	0
3	101305078	rs13062677	G	A	3	6	9	0	0	9	0	0
3	101306489	rs13070567	C	G	3	7	10	0	1	11	0	0
3	101306635	rs13097625	T	G	5	10	15	0	0	15	0	0
3	101308776	rs6777292	C	T	6	9	15	0	0	15	0	0
3	101312800	rs11556582	T	A	111	91	202	0	1	203	0	0
3	101373480	rs34508490	A	G	5	5	10	0	0	10	0	0
3	101373806	rs11924203	C	T	3	13	16	0	0	16	0	0
3	101374451	rs75720698	G	A	4	2	6	0	0	6	0	0
3	101385261	rs4683854	C	G	4	3	7	0	0	7	0	0
3	101397087	rs3806652	G	A	7	5	12	0	0	12	0	0
3	101400374	rs74828294	T	G	29	43	72	0	0	72	0	0
3	101401248	rs41273611	G	C	28	21	49	0	0	49	0	0
3	101484335	rs2625282	G	A	2	10	12	0	0	12	0	0
3	101486050	rs6764700	A	G	2	5	7	0	0	7	0	0
3	101500980	rs2466368	A	C	12	8	20	0	0	20	0	0
3	101541692	rs2926542	G	T	3	3	6	0	2	8	0	0
3	101545319	rs2625288	A	G	8	8	16	0	1	17	0	0
3	101545585	rs622013	A	T	11	12	23	0	1	24	0	0
3	101573052	rs678354	C	G	31	23	54	0	0	54	0	0
3	101574503	rs677011	G	A	27	25	52	0	1	53	0	0
3	101576175	rs14134	T	C	717	690	1407	0	10	1418	1	0
3	101576404	rs622122	A	T	70	62	132	0	0	132	0	0
3	101576762	rs599849	G	A	32	26	58	0	0	58	0	0
3	101579158	rs680508	A	G	553	581	1134	0	3	1137	0	0
3	105260518	rs579565	G	A	4	6	10	0	0	10	0	0
3	105294982	rs490029	C	T	5	1	6	0	0	6	0	0
3	105374814	rs9657915	A	G	5	9	14	0	0	14	0	0
3	105375132	rs9657914	A	G	1	5	6	0	0	6	0	0
3	105377515	rs1042852	C	T	17	16	33	0	0	33	0	0
3	105389153	rs11713094	A	G	29	18	47	0	0	47	0	0
3	105401406	rs2301051	A	T	9	1	10	0	0	10	0	0
3	105402744	rs2120585	A	G	5	2	7	0	0	7	0	0
3	105403128	rs3772539	G	A	5	4	9	0	0	9	0	0
3	105417893	rs9870097	T	C	2	5	7	0	0	7	0	0
3	105420265	rs999046	T	C	3	5	8	0	0	8	0	0
3	105420963	.	T	C	9	11	20	0	1	21	0	0
3	105421823	rs1545304	G	A	6	2	8	0	0	8	0	0
3	105422405	rs1443108	C	T	8	3	11	0	0	11	0	0
3	105422536	rs7646445	T	C	4	4	8	0	0	8	0	0
3	105422844	rs2305037	C	T	15	18	33	0	1	34	0	0
3	105438957	rs2305036	T	G	24	28	52	0	2	54	0	0
3	105439026	rs2305035	G	A	19	17	36	0	0	36	0	0
3	107396287	rs13326227	T	G	0	15	15	0	0	15	0	0
3	107525060	rs76251161	A	T	46	63	109	0	2	111	0	0
3	107526033	rs1053471	T	A	50	39	89	0	0	89	0	0
3	107769319	rs36115125	A	C	4	4	8	0	0	8	0	0
3	107779615	.	A	G	215	216	431	0	2	433	0	0
3	107798578	rs2289079	G	C	1	6	7	0	0	7	0	0
3	107857070	.	T	C	51	47	98	0	0	98	0	0
3	108095365	rs2124736	G	A	2	5	7	0	0	7	0	0
3	108541761	rs9879812	T	C	4	2	6	0	1	7	0	0
3	108567449	rs2593833	G	C	4	4	8	0	0	8	0	0
3	109046411	rs3792321	G	A	107	74	181	0	1	182	0	0
3	109047191	rs3804621	G	A	13	14	27	0	0	27	0	0
3	109048992	rs1177388	G	C	14	13	27	0	0	27	0	0
3	109049104	rs2699988	G	A	16	11	27	0	0	27	0	0
3	109049105	rs2699989	C	T	14	11	25	0	1	26	0	0
3	109050980	rs1163438	T	C	13	14	27	0	1	28	0	0
3	109051009	rs6791602	C	T	16	3	19	0	0	19	0	0
3	109051621	rs6767607	A	T	37	27	64	0	0	64	0	0
3	109051708	rs9876515	G	A	27	18	45	0	0	45	0	0
3	109052216	rs6770591	A	C	7	15	22	0	0	22	0	0
3	109052221	rs6770593	A	C	6	13	19	0	3	22	0	0
3	109052732	rs3762648	T	C	88	92	180	0	2	182	0	0
3	111262754	rs2088468	A	G	6	7	13	0	0	13	0	0
3	111265038	rs113365339	A	T	2	4	6	0	1	7	0	0
3	111346317	rs4682292	C	T	2	4	6	0	0	6	0	0
3	111443003	rs9854875	A	G	5	2	7	0	0	7	0	0
3	111444886	rs1398754	C	T	7	8	15	0	0	15	0	0
3	111444977	rs1398753	C	A	7	8	15	0	0	15	0	0
3	111836040	rs729641	C	T	5	10	15	0	0	15	0	0
3	111836566	rs11824	T	C	11	4	15	0	0	15	0	0
3	112052103	rs2276772	G	T	9	13	22	0	0	22	0	0
3	112052927	rs9868582	G	T	10	8	18	0	1	19	0	0
3	112053246	rs1317243	T	C	13	8	21	0	0	21	0	0
3	112053565	rs1317244	G	A	6	2	8	0	0	8	0	0
3	112059213	rs2399416	G	A	7	3	10	0	0	10	0	0
3	112059768	rs1131199	C	G	12	20	32	0	0	32	0	0
3	112063850	rs2272022	C	A	51	33	84	0	0	84	0	0
3	112066141	rs13098589	C	T	7	4	11	0	0	11	0	0
3	112066360	rs7612748	C	T	5	2	7	0	0	7	0	0
3	112069392	rs9842650	T	C	7	9	16	0	0	16	0	0
3	112069755	rs12491166	T	C	5	6	11	0	0	11	0	0
3	112070576	rs7637088	T	A	14	15	29	0	0	29	0	0
3	112071282	rs62264128	A	G	9	14	23	0	0	23	0	0
3	112071413	rs62264129	A	T	9	17	26	0	1	27	0	0
3	112071934	rs2399422	G	A	3	5	8	0	0	8	0	0
3	112252532	rs3732817	A	G	4	5	9	0	1	10	0	0
3	112258993	rs9831088	A	G	8	8	16	0	0	16	0	0
3	113010466	rs2291905	T	C	7	4	11	0	2	13	0	0
3	113015660	rs2270781	G	A	3	3	6	0	0	6	0	0
3	113176122	rs7637618	G	A	17	16	33	0	0	33	0	0
3	113222036	rs11537650	G	A	10	12	22	0	1	23	0	0
3	113370957	.	T	A	64	66	130	0	2	132	0	0
3	113372048	rs9814605	A	G	31	15	46	0	3	49	0	0
3	113375077	rs75025102	T	C	61	67	128	0	0	128	0	0
3	113377505	rs16861271	T	G	31	23	54	0	1	55	0	0
3	113480413	rs57336266	G	A	5	1	6	0	0	6	0	0
3	113720517	rs6784095	T	A	3	4	7	0	0	7	0	0
3	113795834	rs7631864	G	A	6	3	9	0	0	9	0	0
3	113801826	rs13086657	C	T	6	0	6	0	0	6	0	0
3	114065776	rs2470195	A	G	14	4	18	0	1	19	0	0
3	114066310	rs1357016	T	A	12	12	24	0	1	25	0	0
3	114067518	rs2722015	C	T	10	9	19	0	0	19	0	0
3	114067960	rs953897	T	C	3	4	7	0	0	7	0	0
3	114068210	rs56104346	A	C	4	9	13	0	0	13	0	0
3	115922516	rs545404369	C	T	18	0	18	0	0	18	0	0
3	116364914	rs13324635	C	T	9	0	9	0	2	11	0	0
3	118948618	rs4422293	G	C	5	5	10	0	1	11	0	0
3	118948716	rs4422294	G	A	26	17	43	0	0	43	0	0
3	118955101	rs6805447	A	G	5	6	11	0	0	11	0	0
3	118957913	rs6767078	A	T	5	2	7	0	0	7	0	0
3	119020081	rs7627301	G	A	3	4	7	0	0	7	0	0
3	119023438	rs11914541	A	G	3	3	6	0	0	6	0	0
3	119167458	rs6802790	G	A	1	8	9	0	0	9	0	0
3	119174315	rs116400263	G	A	5	5	10	0	0	10	0	0
3	119178535	rs73857028	G	A	7	2	9	0	0	9	0	0
3	119211366	rs11922005	A	T	3	6	9	0	0	9	0	0
3	119211867	rs1938	G	C	3	6	9	0	0	9	0	0
3	119212417	rs11915398	C	T	3	4	7	0	0	7	0	0
3	119212540	rs11919541	T	C	3	7	10	0	0	10	0	0
3	119212998	rs16829878	T	G	6	6	12	0	0	12	0	0
3	119219573	rs11539377	A	G	12	6	18	0	0	18	0	0
3	119222456	rs1131265	G	C	10	8	18	0	0	18	0	0
3	119236104	rs57168946	G	A	18	14	32	0	0	32	0	0
3	119263680	rs2228017	C	T	3	3	6	0	0	6	0	0
3	120045966	rs11554681	T	C	18	23	41	0	0	41	0	0
3	120048093	rs11716277	T	C	9	10	19	0	0	19	0	0
3	120049117	rs6438575	T	C	9	16	25	0	0	25	0	0
3	120067797	rs4676696	G	A	7	4	11	0	0	11	0	0
3	120408170	rs72625420	A	C	14	8	22	0	0	22	0	0
3	120453253	rs143083144	T	C	4	2	6	0	0	6	0	0
3	121154974	rs1381057	T	C	4	4	8	0	0	8	0	0
3	121350593	rs1128158	C	A	257	249	506	0	11	517	0	0
3	121350616	rs1128154	G	T	285	237	522	0	16	538	0	0
3	121353254	rs2070179	T	C	256	272	528	0	2	530	0	0
3	121355723	rs9809114	T	C	3	3	6	0	0	6	0	0
3	121356719	rs74746356	G	A	4	4	8	0	0	8	0	0
3	121356732	rs112102372	A	G	4	3	7	0	0	7	0	0
3	121361787	rs2070178	G	A	245	208	453	0	3	456	0	0
3	121362639	rs9846174	T	C	6	5	11	0	0	11	0	0
3	121410365	rs116186804	T	C	46	40	86	0	1	87	0	0
3	121435621	rs9832267	T	C	23	23	46	0	1	47	0	0
3	121435624	rs9812411	C	T	23	24	47	0	0	47	0	0
3	121440339	rs9876021	A	G	4	5	9	0	0	9	0	0
3	121488995	rs1135750	C	G	31	18	49	0	1	50	0	0
3	121491112	rs9681209	G	C	5	2	7	0	0	7	0	0
3	121500699	rs17849995	C	T	59	45	104	0	1	105	0	0
3	121504737	rs7623743	T	C	6	5	11	0	0	11	0	0
3	121504833	rs7612211	C	G	8	2	10	0	0	10	0	0
3	121505364	rs7626574	T	C	8	0	8	0	0	8	0	0
3	121505464	rs4676751	T	A	7	0	7	0	0	7	0	0
3	121509881	rs6808500	A	G	8	5	13	0	0	13	0	0
3	121515620	rs6438666	T	C	8	11	19	0	0	19	0	0
3	121526204	rs4543051	G	A	50	27	77	0	0	77	0	0
3	121549780	rs6438679	G	A	7	3	10	0	0	10	0	0
3	121549966	rs7612301	T	C	3	4	7	0	0	7	0	0
3	121552365	rs7646523	T	C	3	3	6	0	0	6	0	0
3	121556729	rs3805126	A	G	6	4	10	0	0	10	0	0
3	121557706	rs77416683	A	C	6	1	7	0	0	7	0	0
3	121558911	rs13096164	A	C	9	3	12	0	0	12	0	0
3	121560223	rs4642169	A	G	4	4	8	0	0	8	0	0
3	121561047	rs1920323	T	A	5	1	6	0	0	6	0	0
3	121563355	rs9884018	T	C	222	229	451	0	3	454	0	0
3	121634134	.	A	C	24	17	41	0	0	41	0	0
3	121641693	rs2293616	G	A	26	16	42	0	1	43	0	0
3	121643804	rs2257212	C	T	13	10	23	0	0	23	0	0
3	121645629	rs2262494	G	A	4	2	6	0	0	6	0	0
3	121646382	rs1882003	T	G	1	5	6	0	0	6	0	0
3	121646641	rs1143670	A	G	22	17	39	0	0	39	0	0
3	121647286	rs1143671	C	T	31	13	44	0	0	44	0	0
3	121649477	rs2700424	C	G	4	4	8	0	0	8	0	0
3	121650872	rs3792597	C	T	5	2	7	0	0	7	0	0
3	121659197	rs3817599	G	A	2	4	6	0	0	6	0	0
3	121661597	rs1136995	G	A	9	4	13	0	0	13	0	0
3	121774281	rs11575853	A	G	4	3	7	0	0	7	0	0
3	122056432	rs17589	C	T	268	162	430	0	7	437	0	0
3	122127592	rs4678192	A	G	4	2	6	0	0	6	0	0
3	122127789	rs10511409	C	T	2	5	7	0	0	7	0	0
3	122127822	rs13320117	T	C	6	3	9	0	0	9	0	0
3	122127926	rs17266628	A	G	9	7	16	0	0	16	0	0
3	122128394	rs1127343	G	A	7	0	7	0	0	7	0	0
3	122128466	rs4306808	G	C	5	8	13	0	0	13	0	0
3	122128519	rs10511410	G	C	10	7	17	0	0	17	0	0
3	122133830	rs3749213	T	G	2	5	7	0	0	7	0	0
3	122139914	rs9862634	G	A	6	0	6	0	0	6	0	0
3	122141135	rs11932	C	T	7	7	14	0	0	14	0	0
3	122145324	rs3762637	C	T	36	39	75	0	0	75	0	0
3	122179632	rs60222267	G	T	3	4	7	0	0	7	0	0
3	122251838	rs28403550	C	A	19	16	35	0	0	35	0	0
3	122252380	rs73192103	A	G	20	11	31	0	2	33	0	0
3	122252428	rs78429050	T	C	12	13	25	0	0	25	0	0
3	122254769	rs3817040	G	A	7	4	11	0	0	11	0	0
3	122274757	rs73192127	G	C	23	12	35	0	0	35	0	0
3	122283095	rs28372690	G	A	4	7	11	0	0	11	0	0
3	122290579	rs2036342	C	T	14	21	35	0	0	35	0	0
3	122290801	rs12490075	G	A	7	4	11	0	0	11	0	0
3	122292965	rs74937187	G	A	27	18	45	0	0	45	0	0
3	122293209	rs1045089	C	T	3	4	7	0	0	7	0	0
3	122293773	rs7071	A	T	10	16	26	0	0	26	0	0
3	122296638	rs1875272	G	A	3	6	9	0	0	9	0	0
3	122334330	.	C	T	8	6	14	0	0	14	0	0
3	122345870	rs17208928	C	T	13	3	16	0	0	16	0	0
3	122354037	rs1106346	A	G	24	12	36	0	1	37	0	0
3	122354716	rs61754895	C	T	26	21	47	0	1	48	0	0
3	122356172	rs2668332	C	T	20	11	31	0	0	31	0	0
3	122356200	rs2668334	T	C	12	7	19	0	0	19	0	0
3	122356346	rs2668335	C	T	7	8	15	0	0	15	0	0
3	122356700	rs56403232	T	G	9	9	18	0	0	18	0	0
3	122357632	rs1143339	A	G	8	4	12	0	0	12	0	0
3	122400549	rs1512052	G	C	4	5	9	0	0	9	0	0
3	122402774	rs59887682	A	T	4	3	7	0	0	7	0	0
3	122403544	rs1256197	C	T	4	3	7	0	0	7	0	0
3	122437321	rs7645033	T	C	24	23	47	0	0	47	0	0
3	122437834	rs3821688	A	G	2	4	6	0	0	6	0	0
3	122440066	rs6438759	A	G	6	3	9	0	0	9	0	0
3	122446450	rs1560352	G	A	3	6	9	0	2	11	0	0
3	122447574	rs3732832	A	C	10	7	17	0	1	18	0	0
3	122448551	rs9872606	C	T	34	47	81	0	0	81	0	0
3	122448914	rs6774933	T	C	50	30	80	0	1	81	0	0
3	122471831	rs4048549	G	A	1	6	7	0	0	7	0	0
3	122473354	rs12496363	C	T	7	3	10	0	0	10	0	0
3	123633220	rs2700372	T	G	14	10	24	0	0	24	0	0
3	123634046	rs2700373	G	A	31	47	78	0	0	78	0	0
3	123668268	rs2141604	T	C	6	9	15	0	0	15	0	0
3	123669449	rs58785116	G	A	5	5	10	0	0	10	0	0
3	123672378	rs2700357	C	T	6	3	9	0	0	9	0	0
3	123672874	rs2700351	G	A	7	7	14	0	0	14	0	0
3	123677383	rs2700399	A	C	5	4	9	0	0	9	0	0
3	123678483	rs2700394	G	A	3	7	10	0	0	10	0	0
3	123678569	rs1814975	C	T	10	5	15	0	0	15	0	0
3	124456742	rs1801019	G	C	9	11	20	0	0	20	0	0
3	124457272	rs13061561	C	T	13	12	25	0	0	25	0	0
3	124457483	rs17843826	T	G	8	1	9	0	0	9	0	0
3	124462808	rs13146	C	T	38	33	71	0	0	72	1	0
3	124463656	rs2242247	A	T	5	3	8	0	0	8	0	0
3	124463657	rs649652	C	T	5	3	8	0	0	8	0	0
3	124481052	rs14386	G	A	7	4	11	0	0	11	0	0
3	124481987	rs2676	A	G	7	6	13	0	0	13	0	0
3	124482113	rs2675	T	G	15	9	24	0	0	24	0	0
3	124482222	rs2674	C	T	21	14	35	0	0	35	0	0
3	124515308	rs1803825	A	G	19	11	30	0	0	30	0	0
3	124515509	rs2291088	G	A	23	10	33	0	0	33	0	0
3	125725455	rs11543284	G	C	79	61	140	0	1	141	0	0
3	125726048	rs2279819	G	C	109	123	232	0	1	234	1	0
3	125769757	rs4077563	C	T	3	3	6	0	1	7	0	0
3	125802961	rs17523373	G	A	7	5	12	0	0	12	0	0
3	126156660	rs7131	C	G	59	33	92	0	0	92	0	0
3	126158622	rs1799404	A	C	7	2	9	0	0	9	0	0
3	126161625	rs6783961	T	C	7	2	9	0	0	9	0	0
3	126161697	.	G	C	5	1	6	0	0	6	0	0
3	126162151	rs777515	T	C	2	7	9	0	0	9	0	0
3	126162829	rs113749872	T	C	5	3	8	0	0	8	0	0
3	126165359	rs6782107	C	T	9	4	13	0	1	14	0	0
3	126166911	rs800946	G	C	1	5	6	0	0	6	0	0
3	126167565	rs777492	G	C	3	4	7	0	0	7	0	0
3	126168529	rs6795359	G	A	2	4	6	0	0	6	0	0
3	126170695	rs12957	T	G	18	21	39	0	0	39	0	0
3	126170965	rs1844689	G	A	26	14	40	0	0	40	0	0
3	126173470	rs777503	C	T	14	28	42	0	1	43	0	0
3	126174271	rs813556	G	A	21	18	39	0	0	39	0	0
3	126174781	rs74904184	T	G	6	12	18	0	1	20	1	0
3	126175401	rs812368	G	A	8	23	31	0	0	31	0	0
3	126175410	rs58538708	G	C	25	8	33	0	0	33	0	0
3	126176112	rs777505	G	A	10	19	29	0	0	29	0	0
3	126176756	rs11716924	C	A	12	6	18	0	0	18	0	0
3	126176885	rs11717788	G	A	9	7	16	0	1	17	0	0
3	126177376	rs11706486	T	C	6	1	7	0	0	7	0	0
3	126178390	rs1043803	A	C	66	61	127	0	1	128	0	0
3	126179492	rs777507	G	A	60	100	160	0	1	161	0	0
3	126180088	rs3230	A	G	70	82	152	0	1	153	0	0
3	126180121	rs3231	C	T	74	76	150	0	1	151	0	0
3	126182920	rs1687462	C	T	9	13	22	0	0	22	0	0
3	126183244	rs77947202	A	G	13	11	24	0	0	24	0	0
3	126183546	rs6810140	G	A	12	12	24	0	0	24	0	0
3	126184029	rs10934778	C	T	4	5	9	0	1	10	0	0
3	126184450	rs4679245	T	C	12	5	17	0	0	17	0	0
3	126184941	rs1799389	C	T	6	8	14	0	0	14	0	0
3	126192081	rs800949	C	G	2	5	7	0	0	7	0	0
3	126192459	rs777502	A	G	4	4	8	0	0	8	0	0
3	126194076	rs812367	T	C	41	24	65	0	0	65	0	0
3	126753653	rs45473193	G	A	5	2	7	0	0	7	0	0
3	126754644	rs9856665	G	C	7	5	12	0	0	12	0	0
3	126754653	rs115349184	C	T	6	5	11	0	0	11	0	0
3	127294501	rs41266479	A	G	4	4	8	0	0	8	0	0
3	127390525	rs41266485	C	T	5	3	8	0	0	8	0	0
3	127391378	rs1056235	G	A	2	7	9	0	0	9	0	0
3	127394280	rs782455	C	T	3	3	6	0	0	6	0	0
3	127394820	rs35703629	C	T	80	91	171	0	0	171	0	0
3	127397553	rs9859117	G	C	5	4	9	0	0	9	0	0
3	127408182	rs9383	C	T	104	85	189	0	2	191	0	0
3	127408239	rs7578	G	A	98	78	176	0	1	177	0	0
3	127409941	rs782444	T	C	87	86	173	0	0	173	0	0
3	127410033	rs76232599	C	G	71	69	140	0	2	142	0	0
3	127410915	rs814131	C	T	38	21	59	0	1	60	0	0
3	127463188	rs1046821	G	A	26	18	44	0	0	44	0	0
3	127463759	rs57825345	G	A	24	12	36	0	0	36	0	0
3	127464917	rs483193	G	A	3	4	7	0	0	7	0	0
3	127465159	rs640262	G	A	5	2	7	0	0	7	0	0
3	127465204	rs78548233	C	T	2	5	7	0	0	7	0	0
3	127465870	rs512726	G	A	2	5	7	0	0	7	0	0
3	127473488	rs6778770	A	G	3	4	7	0	0	7	0	0
3	127527964	rs10934820	C	T	6	3	9	0	0	9	0	0
3	127538412	rs874546	A	G	5	1	6	0	0	6	0	0
3	127772536	rs2335772	G	T	5	7	12	0	0	12	0	0
3	127772785	rs13094572	G	A	5	6	11	0	0	11	0	0
3	127772793	rs3774797	G	A	6	6	12	0	0	12	0	0
3	127773627	rs1030656	G	C	12	4	16	0	0	16	0	0
3	127773676	rs1030655	T	C	10	3	13	0	0	13	0	0
3	127779944	rs2335771	A	G	5	4	9	0	0	9	0	0
3	127780871	rs9820563	A	G	4	2	6	0	0	6	0	0
3	127783698	rs1044843	A	T	3	4	7	0	0	7	0	0
3	127784118	rs13070488	T	C	38	33	71	0	1	72	0	0
3	127784262	rs2075402	C	T	27	21	48	0	1	49	0	0
3	127784513	rs9819960	T	C	26	24	50	0	0	50	0	0
3	127784612	rs6439111	C	G	8	4	12	0	0	12	0	0
3	127786551	rs9858267	G	A	22	22	44	0	0	44	0	0
3	127786675	rs2276867	T	G	22	18	40	0	0	40	0	0
3	127787157	rs3733158	A	G	14	11	25	0	0	25	0	0
3	127788955	rs10934847	G	A	347	344	691	0	4	696	1	0
3	127789172	rs1042907	G	C	343	336	679	0	3	682	0	0
3	127789594	rs1042911	T	G	358	337	695	0	2	697	0	0
3	127789695	rs1042912	C	T	286	318	604	0	1	605	0	0
3	127799983	rs1057220	A	C	12	20	32	0	0	32	0	0
3	127800071	rs1057156	A	G	11	18	29	0	0	29	0	0
3	127872602	rs11719546	A	G	8	3	11	0	1	12	0	0
3	127983495	rs2811544	T	C	19	20	39	0	0	39	0	0
3	128338953	rs1127030	T	C	74	112	186	0	1	187	0	0
3	128339057	.	A	T	175	154	329	0	12	341	0	0
3	128340110	rs55987729	T	C	20	18	38	0	1	39	0	0
3	128340896	rs2712419	T	C	11	35	46	0	0	46	0	0
3	128346214	rs2712371	G	A	6	3	9	0	0	9	0	0
3	128356852	rs1697	C	T	345	432	777	0	8	785	0	0
3	128359957	rs2811495	A	G	3	3	6	0	0	6	0	0
3	128359958	rs2811496	A	T	3	3	6	0	0	6	0	0
3	128364269	rs6801509	C	T	42	14	56	0	3	59	0	0
3	128364797	rs7429360	A	G	3	3	6	0	0	6	0	0
3	128364895	rs2712409	G	C	2	4	6	0	0	6	0	0
3	128366256	rs2811500	C	T	7	7	14	0	0	14	0	0
3	128366726	rs4557179	A	C	4	5	9	0	0	9	0	0
3	128369055	rs4467479	C	G	8	6	14	0	0	14	0	0
3	128459069	rs11716613	C	A	2	4	6	0	0	6	0	0
3	128513786	rs67087503	C	T	3	3	6	0	0	6	0	0
3	128530671	rs144875699	G	A	4	3	7	0	0	7	0	0
3	128533128	rs59753334	C	G	174	144	318	0	2	320	0	0
3	128589359	rs728839	A	G	3	7	10	0	0	10	0	0
3	128614185	rs1680778	A	C	19	21	40	0	0	40	0	0
3	128625790	rs1680789	G	T	3	3	6	0	0	6	0	0
3	128627933	rs876755	C	T	18	30	48	0	2	50	0	0
3	128751670	rs73210702	G	A	4	3	7	0	0	7	0	0
3	128755953	rs3732430	G	A	7	2	9	0	0	9	0	0
3	128893277	.	C	T	4	2	6	0	0	6	0	0
3	128992047	rs6762578	G	A	4	2	6	0	0	6	0	0
3	129020778	rs6765930	A	G	18	22	40	0	0	40	0	0
3	129035485	rs4073154	A	G	3	5	8	0	0	8	0	0
3	129102128	rs4072152	C	A	8	2	10	0	0	10	0	0
3	129103875	rs57976386	T	C	3	6	9	0	0	9	0	0
3	129105793	rs72982651	C	T	6	0	6	0	0	6	0	0
3	129106684	rs116528977	T	C	8	12	20	0	0	20	0	0
3	129108435	rs12632105	G	C	8	9	17	0	1	18	0	0
3	129108915	rs72982655	C	T	10	11	21	0	0	21	0	0
3	129108935	rs16859047	C	T	13	11	24	0	0	24	0	0
3	129109377	rs114139364	T	G	9	10	19	0	0	19	0	0
3	129109507	rs3821918	A	C	10	6	16	0	1	17	0	0
3	129109698	rs139976016	A	G	6	4	10	0	0	10	0	0
3	129109700	rs143433418	T	C	6	4	10	0	0	10	0	0
3	129109705	rs146731707	C	G	6	3	9	0	0	9	0	0
3	129109709	rs139128882	G	A	6	3	9	0	0	9	0	0
3	129109764	rs3806709	C	A	7	4	11	0	0	11	0	0
3	129110603	rs115244980	C	T	7	6	13	0	1	14	0	0
3	129111702	rs13060036	C	T	7	4	11	0	0	11	0	0
3	129111899	rs145940478	C	T	4	3	7	0	0	7	0	0
3	129112166	rs113771682	C	T	2	7	9	0	0	9	0	0
3	129112186	rs142638920	C	T	2	5	7	0	0	7	0	0
3	129112454	rs60960425	A	G	3	6	9	0	0	9	0	0
3	129116393	rs77812985	C	T	5	3	8	0	0	8	0	0
3	129117233	rs76611397	C	T	8	1	9	0	0	9	0	0
3	129149961	rs2307285	T	C	15	16	31	0	0	31	0	0
3	129151170	rs3138360	C	T	16	13	29	0	0	29	0	0
3	129224131	rs2713621	G	T	5	2	7	0	0	7	0	0
3	129234259	rs2260840	T	C	9	4	13	0	1	14	0	0
3	129282540	rs7616908	A	G	6	1	7	0	0	7	0	0
3	129283353	rs72987976	T	G	4	6	10	0	0	10	0	0
3	129283765	rs2625971	G	A	6	3	9	0	1	10	0	0
3	129284637	rs2245469	A	G	23	13	36	0	0	36	0	0
3	129285175	rs11925462	G	A	9	7	16	0	0	16	0	0
3	129285577	rs2285363	A	C	45	48	93	0	0	93	0	0
3	129285587	rs2285364	G	A	46	48	94	0	1	95	0	0
3	129286413	rs2245285	G	C	336	322	658	0	2	660	0	0
3	129286531	rs2245281	C	A	11	7	18	0	0	18	0	0
3	129287379	.	T	G	10	10	20	0	0	20	0	0
3	129287473	rs2625974	C	T	10	13	23	0	1	24	0	0
3	129289090	rs57800385	C	T	20	12	32	0	1	33	0	0
3	129289752	rs2285365	C	T	345	379	724	0	1	726	1	0
3	129289831	rs2244962	A	G	5	9	14	0	0	14	0	0
3	129290954	.	A	C	7	7	14	0	0	14	0	0
3	129291499	rs2285368	G	A	240	311	551	0	1	552	0	0
3	129291751	rs2244708	T	C	215	227	442	0	9	451	0	0
3	129293106	rs6762822	G	C	12	16	28	0	0	28	0	0
3	129293256	rs2255703	T	C	225	265	490	0	2	492	0	0
3	129293839	rs76030891	G	A	4	4	8	0	0	8	0	0
3	129293973	rs11923853	T	C	3	4	7	0	0	7	0	0
3	129295013	rs74960238	C	A	15	24	39	0	0	40	1	0
3	129296020	rs2625961	C	T	14	16	30	0	0	30	0	0
3	129296756	rs73863641	G	T	12	20	32	0	0	32	0	0
3	129302455	rs2285370	G	A	190	215	405	0	6	411	0	0
3	129303072	rs2285371	G	A	213	209	422	0	7	429	0	0
3	129303572	rs58656084	T	A	5	3	8	0	0	8	0	0
3	129303744	rs2625998	G	A	6	2	8	0	0	8	0	0
3	129304250	rs58562619	G	A	4	2	6	0	0	6	0	0
3	129304450	rs56922937	C	G	3	3	6	0	0	6	0	0
3	129304797	rs2285372	G	A	154	166	320	0	1	322	1	0
3	129305460	rs2301572	C	T	134	121	255	0	1	256	0	0
3	129694681	rs5658	C	G	7	4	11	0	0	11	0	0
3	129813301	rs4610271	G	A	8	1	9	0	0	9	0	0
3	129817197	rs189107736	T	A	9	2	11	0	0	11	0	0
3	129817239	rs142691368	C	T	11	2	13	0	0	13	0	0
3	129817254	rs147018983	G	A	14	2	16	0	0	16	0	0
3	129817290	rs59443817	A	G	12	2	14	0	0	14	0	0
3	129817394	rs115314519	A	T	9	1	10	0	0	10	0	0
3	129817804	rs2587970	G	A	1	5	6	0	0	6	0	0
3	129829463	rs4072146	C	A	8	1	9	0	0	9	0	0
3	129831572	rs56689350	C	T	15	2	17	0	1	18	0	0
3	129838184	rs9289355	T	G	6	3	9	0	0	9	0	0
3	129838501	rs2587960	C	T	0	6	6	0	0	6	0	0
3	129838699	rs73866379	G	A	8	3	11	0	0	11	0	0
3	129838767	rs73866381	T	C	7	1	8	0	1	9	0	0
3	130428146	rs10934954	C	T	6	6	12	0	0	12	0	0
3	130431425	rs74464627	T	C	1	7	8	0	0	8	0	0
3	130431481	rs75219664	T	C	0	6	6	0	0	6	0	0
3	130432965	rs75998334	A	G	2	6	8	0	0	8	0	0
3	130433587	rs78696057	C	A	3	7	10	0	0	10	0	0
3	130433921	rs113759543	A	G	4	4	8	0	0	8	0	0
3	130438747	rs11713407	G	A	3	3	6	0	0	6	0	0
3	130449222	rs2170990	A	G	5	8	13	0	0	13	0	0
3	130457554	rs79229830	G	A	2	4	6	0	0	6	0	0
3	130457582	rs2403311	C	T	2	4	6	0	0	6	0	0
3	130462017	rs6793931	A	G	4	2	6	0	0	6	0	0
3	130462986	rs11713445	G	A	3	3	6	0	0	6	0	0
3	130465474	rs2293179	A	C	16	23	39	0	0	39	0	0
3	130571098	rs927537	G	A	20	20	40	0	0	40	0	0
3	130573462	rs1745649	A	G	17	24	41	0	0	41	0	0
3	130573787	rs852211	T	C	30	21	51	0	0	51	0	0
3	130580226	rs647895	A	G	20	14	34	0	0	34	0	0
3	130583064	rs141052881	T	A	25	23	48	0	0	48	0	0
3	130584361	rs852228	A	T	31	28	59	0	0	59	0	0
3	130586971	rs1101222	C	G	7	4	11	0	0	11	0	0
3	130587783	.	T	C	9	10	19	0	0	19	0	0
3	130588475	rs1606490	A	G	37	19	56	0	1	57	0	0
3	130588557	rs1606489	A	G	34	12	46	0	0	46	0	0
3	130589853	rs6779657	G	A	21	13	34	0	0	34	0	0
3	130591716	rs1708291	T	C	12	12	24	0	0	24	0	0
3	130591879	rs1708290	G	A	11	7	18	0	0	18	0	0
3	130607453	rs852220	T	C	4	4	8	0	0	8	0	0
3	130630024	.	C	A	6	2	8	0	0	8	0	0
3	130631081	.	A	C	8	3	11	0	0	11	0	0
3	130631702	rs852206	G	A	26	12	38	0	0	38	0	0
3	130724380	rs75436749	G	A	3	7	10	0	0	10	0	0
3	131102053	rs11549806	A	G	23	27	50	0	1	52	1	0
3	131106031	rs72995220	G	T	1	5	6	0	0	6	0	0
3	131182349	rs9860545	T	C	5	1	6	0	0	6	0	0
3	131183241	rs17277065	T	C	5	1	6	0	0	6	0	0
3	132068831	rs2228402	C	T	6	3	9	0	0	9	0	0
3	132075554	rs3181784	T	C	3	3	6	0	0	6	0	0
3	132257385	rs149506627	A	G	7	10	17	0	1	18	0	0
3	132361596	rs9877018	G	A	13	13	26	0	0	26	0	0
3	132395679	rs140487427	T	G	20	16	36	0	1	37	0	0
3	132403418	rs34391943	C	T	6	6	12	0	0	12	0	0
3	133301238	rs9847114	G	A	0	6	6	0	0	6	0	0
3	133301508	rs9847556	G	A	4	2	6	0	0	6	0	0
3	133302438	rs115352688	G	A	4	3	7	0	0	7	0	0
3	133304357	rs4854734	A	T	5	1	6	0	0	6	0	0
3	133304601	rs6439426	G	A	3	5	8	0	0	8	0	0
3	133306518	rs6776497	G	A	74	90	164	0	0	164	0	0
3	133307491	rs6792846	T	C	313	317	630	0	4	634	0	0
3	133887131	rs7620941	G	A	3	3	6	0	0	6	0	0
3	133894102	rs6439464	G	A	7	3	10	0	0	10	0	0
3	133894761	rs28622917	T	G	4	5	9	0	0	9	0	0
3	133914636	rs9881896	C	T	1	8	9	0	0	9	0	0
3	133914748	rs9882168	C	T	2	7	9	0	0	9	0	0
3	133914765	rs13099506	G	A	3	4	7	0	0	7	0	0
3	133919909	rs4682664	T	C	11	4	15	0	0	15	0	0
3	133920075	rs4682666	C	T	6	8	14	0	0	14	0	0
3	133941320	rs1131262	C	T	18	15	33	0	0	33	0	0
3	134257239	rs138823027	A	G	6	0	6	0	0	6	0	0
3	134281177	.	G	T	5	6	11	0	1	12	0	0
3	135979698	rs589092	A	G	5	2	7	0	0	7	0	0
3	135980425	rs35681043	T	G	1	6	7	0	0	7	0	0
3	135980673	rs2290131	C	T	10	1	11	0	0	11	0	0
3	136056861	rs696520	T	C	35	58	93	0	1	94	0	0
3	136088038	rs9860801	G	A	30	35	65	0	0	65	0	0
3	136306139	rs6806795	C	T	4	5	9	0	0	9	0	0
3	136561353	rs183039330	G	C	3	3	6	0	0	6	0	0
3	136574521	rs1052620	C	T	10	3	13	0	0	13	0	0
3	138244400	rs9878436	C	T	18	26	44	0	0	44	0	0
3	138289163	rs1673608	T	C	20	16	36	0	0	36	0	0
3	138289221	rs1673607	C	T	21	23	44	0	1	45	0	0
3	138329862	rs811322	G	A	12	4	16	0	0	16	0	0
3	139067258	rs77869711	C	T	9	7	16	0	0	16	0	0
3	139067383	rs17394620	A	G	8	12	20	0	1	21	0	0
3	139068346	rs75256094	T	G	13	6	19	0	0	19	0	0
3	139069569	rs6776315	T	C	13	11	24	0	0	24	0	0
3	139069693	rs17316181	C	A	21	16	37	0	0	37	0	0
3	139074194	rs2291555	T	A	6	7	13	0	0	13	0	0
3	139075145	rs41399544	G	A	1	5	6	0	0	6	0	0
3	139075386	rs17335312	C	T	4	4	8	0	0	8	0	0
3	139075419	rs58060926	C	G	3	3	6	0	0	6	0	0
3	139077177	rs79695313	C	G	4	2	6	0	0	6	0	0
3	139285560	.	C	T	4	2	6	0	0	6	0	0
3	140178485	rs7632885	G	A	11	2	13	0	0	13	0	0
3	140291413	rs347975	A	G	5	3	8	0	0	8	0	0
3	140291778	rs347974	C	G	2	7	9	0	0	9	0	0
3	140292536	rs347973	G	A	2	5	7	0	0	7	0	0
3	140294336	rs347971	A	G	3	6	9	0	0	9	0	0
3	140294985	rs347970	G	A	8	14	22	0	0	22	0	0
3	141208684	rs11717842	A	C	4	8	12	0	0	12	0	0
3	141209101	rs34342794	C	T	1	7	8	0	0	8	0	0
3	141213581	rs6795168	T	A	7	2	9	0	0	9	0	0
3	141215116	rs9837959	C	T	282	94	376	0	0	376	0	0
3	141215273	rs9838230	C	T	268	182	450	0	27	477	0	0
3	141215409	rs9838419	C	G	358	253	611	0	10	621	0	0
3	141215498	rs77468424	C	A	274	182	456	0	5	461	0	0
3	141216134	rs71619392	G	A	16	13	29	0	0	29	0	0
3	141298640	rs9829588	G	C	5	3	8	0	0	8	0	0
3	141327474	rs295323	G	A	42	15	57	0	0	57	0	0
3	141331222	rs2172471	G	A	22	8	30	0	0	30	0	0
3	141333835	rs11557453	C	T	20	9	29	0	0	29	0	0
3	141465819	rs186428075	A	G	5	5	10	0	0	10	0	0
3	141636530	rs9810697	A	G	5	1	6	0	0	6	0	0
3	141637910	rs72988236	T	C	1	6	7	0	0	7	0	0
3	141638674	rs113368930	G	T	4	2	6	0	0	6	0	0
3	141641538	rs6769618	A	G	8	6	14	0	0	14	0	0
3	141641794	.	C	T	6	7	13	0	0	13	0	0
3	141642914	rs6798210	G	T	8	6	14	0	0	14	0	0
3	141643147	rs111610868	T	C	10	7	17	0	0	17	0	0
3	141643287	rs113164173	C	G	11	8	19	0	0	19	0	0
3	141644175	rs4683650	T	C	9	14	23	0	0	23	0	0
3	141644274	rs1131029	G	C	10	10	20	0	0	20	0	0
3	141663683	rs1045279	C	T	30	15	45	0	0	45	0	0
3	141663752	rs9942	A	G	27	22	49	0	2	51	0	0
3	141664047	rs3762727	T	G	10	1	11	0	0	14	3	0
3	141712780	rs3817176	C	T	3	3	6	0	0	6	0	0
3	141719380	rs11706480	C	T	1	5	6	0	0	6	0	0
3	141720712	rs34186890	A	G	2	5	7	0	0	7	0	0
3	141760831	rs9880805	A	G	3	3	6	0	0	6	0	0
3	141854997	.	G	T	4	2	6	0	0	6	0	0
3	142027811	rs3762799	A	G	34	31	65	0	1	66	0	0
3	142036520	rs9289648	T	C	4	5	9	0	0	9	0	0
3	142043408	rs139099511	G	A	4	2	6	0	0	6	0	0
3	142139172	rs57177110	T	C	4	7	11	0	0	11	0	0
3	142139275	rs28708455	T	C	5	1	6	0	0	6	0	0
3	142217537	rs2227932	A	G	14	12	26	0	0	26	0	0
3	142222284	rs2227931	A	G	6	2	8	0	0	8	0	0
3	142232408	rs34124242	T	C	11	8	19	0	0	19	0	0
3	142277536	rs2227929	A	G	6	7	13	0	0	13	0	0
3	142277575	rs2227930	A	T	4	5	9	0	0	9	0	0
3	142281612	rs2227928	A	G	2	9	11	0	0	11	0	0
3	142742285	rs2290549	A	G	2	5	7	0	0	7	0	0
3	142753395	rs527742613	T	A	13	12	25	0	0	25	0	0
3	142758560	rs74959249	G	T	8	3	11	0	0	11	0	0
3	142767864	rs139221996	A	G	4	3	7	0	0	7	0	0
3	142767981	rs79159918	G	C	3	4	7	0	0	7	0	0
3	142778666	rs10790	C	T	13	8	21	0	0	21	0	0
3	148727133	rs4938	G	A	54	39	93	0	1	94	0	0
3	148745236	rs3347	A	G	67	44	111	0	3	114	0	0
3	148748380	rs3182285	T	C	12	3	15	0	0	15	0	0
3	148748500	rs79551442	C	G	11	12	23	0	2	25	0	0
3	148759325	rs2290725	T	C	3	3	6	0	0	6	0	0
3	148786085	rs2305868	T	C	4	2	6	0	0	6	0	0
3	148890344	rs11537809	G	A	12	6	18	0	0	18	0	0
3	149530625	rs11557682	C	T	7	5	12	0	0	12	0	0
3	150128839	.	G	T	160	169	329	0	2	332	1	0
3	150260853	rs10272	C	T	187	226	413	0	1	414	0	0
3	150264003	rs1130834	G	C	154	152	306	0	3	309	0	0
3	150264136	rs1049947	G	A	66	70	136	0	0	136	0	0
3	150280445	rs1132979	C	G	157	179	336	0	0	336	0	0
3	150283050	rs73001341	C	A	9	8	17	0	0	17	0	0
3	150283562	rs3209262	T	C	9	6	15	0	1	16	0	0
3	150283812	rs9823447	C	A	10	13	23	0	0	23	0	0
3	150285520	rs2293151	T	C	117	120	237	0	1	238	0	0
3	150325498	rs9879590	G	C	4	3	7	0	0	7	0	0
3	150327283	rs76252482	C	T	5	1	6	0	0	6	0	0
3	150329681	rs112711134	G	A	4	4	8	0	0	8	0	0
3	150332011	rs1568585	G	T	12	10	22	0	0	22	0	0
3	150339065	rs13062205	A	C	6	11	17	0	0	17	0	0
3	150345664	rs11548666	A	G	417	419	836	0	22	858	0	0
3	150345690	rs2272084	T	G	321	238	559	0	2	561	0	0
3	150346471	rs2049227	T	C	12	9	21	0	0	21	0	0
3	150346654	rs6777911	A	G	34	41	75	0	1	76	0	0
3	150347833	rs7979	G	A	16	16	32	0	0	32	0	0
3	150459005	rs8403	G	T	112	98	210	0	1	211	0	0
3	150475420	rs1148369	T	C	7	4	11	0	0	11	0	0
3	151045246	rs1388628	C	G	10	10	20	0	0	20	0	0
3	151045295	rs1388627	A	G	13	9	22	0	0	22	0	0
3	151045534	rs11712291	A	G	6	2	8	0	1	9	0	0
3	151143447	rs6440742	G	T	6	3	9	0	0	9	0	0
3	151150968	rs12635196	T	G	4	3	7	0	0	7	0	0
3	151154666	rs2172250	T	C	30	49	79	0	0	79	0	0
3	151155620	rs6781302	G	A	23	20	43	0	0	43	0	0
3	151165678	rs9871952	T	C	13	5	18	0	0	18	0	0
3	151166422	rs6798252	C	T	8	11	19	0	0	19	0	0
3	151171439	rs7619322	A	C	6	5	11	0	0	11	0	0
3	151171542	rs7621591	A	G	12	12	24	0	0	24	0	0
3	152022890	rs6784925	C	T	5	8	13	0	0	13	0	0
3	152025796	rs6807753	T	C	7	7	14	0	0	14	0	0
3	152029167	rs13063739	T	C	4	3	7	0	0	7	0	0
3	152030320	rs11919936	A	G	7	15	22	0	1	23	0	0
3	152031117	rs77341204	T	C	5	2	7	0	0	7	0	0
3	152033659	.	T	A	3	4	7	0	0	7	0	0
3	152035367	rs13068236	T	C	16	1	17	0	1	18	0	0
3	152048137	rs13071480	T	C	5	5	10	0	0	10	0	0
3	152048499	rs11928080	A	G	10	2	12	0	0	12	0	0
3	152051065	rs74359275	T	C	8	14	22	0	1	23	0	0
3	152143625	rs12633174	G	A	3	3	6	0	0	6	0	0
3	152172146	rs13085647	G	A	5	4	9	0	0	9	0	0
3	152180329	rs17437560	C	T	110	120	230	0	2	232	0	0
3	152182300	rs79130661	T	C	6	19	25	0	4	29	0	0
3	152880236	rs34370628	G	A	5	2	7	0	0	7	0	0
3	154018887	rs9438	G	C	11	8	19	0	1	20	0	0
3	155544858	rs77664705	T	A	2	4	6	0	0	6	0	0
3	155572129	rs1131925	C	T	14	18	32	0	0	32	0	0
3	156241949	rs7619602	T	C	6	4	10	0	0	10	0	0
3	156241965	rs2280299	A	G	5	7	12	0	0	12	0	0
3	156242091	rs2280298	G	A	5	5	10	0	0	10	0	0
3	156258287	rs13068904	C	T	15	11	26	0	0	26	0	0
3	156258531	rs6764265	T	A	10	11	21	0	0	21	0	0
3	156258817	rs3773713	T	C	18	24	42	0	0	42	0	0
3	156259178	rs6764992	T	C	30	18	48	0	2	50	0	0
3	156259348	rs1129094	G	A	14	15	29	0	0	29	0	0
3	156259485	rs8665	G	A	32	23	55	0	0	55	0	0
3	156260202	rs71310479	C	T	46	34	80	0	0	80	0	0
3	156261110	rs1983206	T	C	6	2	8	0	0	8	0	0
3	156397174	rs345985	C	T	8	4	12	0	0	12	0	0
3	156397389	rs184695	T	C	9	8	17	0	0	17	0	0
3	156399180	rs3851992	G	A	12	19	31	0	0	31	0	0
3	156406952	rs73168635	A	G	3	3	6	0	0	6	0	0
3	156415563	rs13314482	G	T	4	5	9	0	0	9	0	0
3	156418756	rs1367311	C	T	4	3	7	0	0	7	0	0
3	156421525	rs34277251	G	T	24	25	49	0	0	49	0	0
3	156423072	rs346003	A	T	24	18	42	0	1	43	0	0
3	156868450	rs8925	T	C	157	153	310	0	12	322	0	0
3	156870059	rs73154633	C	T	187	147	334	0	8	342	0	0
3	156870816	rs41272613	A	G	307	255	562	0	1	563	0	0
3	156872076	rs12492801	G	A	190	174	364	0	1	365	0	0
3	156873220	rs4680342	G	C	30	29	59	0	2	61	0	0
3	156875341	rs7633004	G	A	75	72	147	0	2	149	0	0
3	156876502	rs6441114	G	A	69	86	155	0	0	155	0	0
3	156876574	rs6441115	A	G	91	116	207	0	3	210	0	0
3	156876803	rs6441116	T	G	5	4	9	0	0	9	0	0
3	156878389	rs17552941	C	G	3	6	9	0	0	9	0	0
3	157956687	rs6797351	A	G	5	2	7	0	0	7	0	0
3	158314188	rs6804230	T	C	6	3	9	0	0	9	0	0
3	158320597	rs4875	T	C	48	41	89	0	0	89	0	0
3	158320703	rs15967	C	A	54	38	92	0	0	92	0	0
3	158323665	rs7628293	A	G	7	7	14	0	0	14	0	0
3	158362391	rs28372852	C	T	20	17	37	0	0	37	0	0
3	158362441	rs1864507	T	C	35	21	56	0	0	56	0	0
3	158366900	rs2303909	G	A	1	6	7	0	0	7	0	0
3	158378156	rs7648483	C	T	4	4	8	0	0	8	0	0
3	158378284	rs62288301	G	A	5	4	9	0	0	9	0	0
3	158387487	rs6441215	T	C	6	3	9	0	0	9	0	0
3	158388394	rs6785658	T	G	3	4	7	0	0	7	0	0
3	158388780	rs8455	T	C	18	16	34	0	0	34	0	0
3	158389772	rs7624934	C	T	10	7	17	0	0	17	0	0
3	158389860	rs17630607	C	T	8	6	14	0	0	14	0	0
3	158390395	rs9841	A	T	6	9	15	0	0	15	0	0
3	158404267	rs10936158	C	T	3	5	8	0	0	8	0	0
3	158404818	rs9819575	T	G	4	3	7	0	1	8	0	0
3	158406461	rs61376564	T	G	3	4	7	0	0	7	0	0
3	158407186	rs62288344	A	C	4	4	8	0	0	8	0	0
3	158407231	rs62288345	G	T	3	4	7	0	0	7	0	0
3	158407333	rs62288346	C	T	6	4	10	0	0	10	0	0
3	158407430	rs13325932	A	G	10	4	14	0	0	14	0	0
3	158409262	rs1047355	C	T	91	58	149	0	0	149	0	0
3	158409482	rs1047366	C	T	15	10	25	0	1	26	0	0
3	158409947	rs8650	T	A	14	11	25	0	0	25	0	0
3	158519446	rs2244996	T	C	13	7	20	0	0	20	0	0
3	158520011	rs28364680	C	T	55	47	102	0	1	103	0	0
3	158534129	rs61796777	G	A	3	3	6	0	0	6	0	0
3	158535951	rs10936160	T	C	5	5	10	0	0	10	0	0
3	158536075	rs10936161	A	G	2	6	8	0	0	8	0	0
3	158536123	rs10936162	C	T	4	3	7	0	0	7	0	0
3	158537443	rs3765083	A	G	168	194	362	0	3	365	0	0
3	158541077	rs41272627	C	T	4	3	7	0	0	7	0	0
3	158542809	rs6785502	G	A	5	3	8	0	0	8	0	0
3	158545632	rs12634337	A	G	7	9	16	0	0	16	0	0
3	158545761	rs7640147	G	C	4	4	8	0	4	12	0	0
3	158545912	rs12054172	A	G	7	6	13	0	0	13	0	0
3	158546984	rs12490494	T	G	170	185	355	0	1	356	0	0
3	159557953	rs13064339	T	C	73	116	189	0	1	190	0	0
3	159561926	rs13065938	G	A	2	7	9	0	0	9	0	0
3	159610754	rs3773785	C	T	3	4	7	0	0	7	0	0
3	159612616	rs4680530	T	C	3	3	6	0	0	6	0	0
3	159614478	rs9812520	A	G	4	2	6	0	0	6	0	0
3	160787502	rs2306061	C	T	7	11	18	0	0	18	0	0
3	160939141	rs28384382	C	T	51	27	78	0	0	78	0	0
3	160969268	rs4493449	C	T	109	34	143	0	0	143	0	0
3	167167186	rs6770577	T	A	13	13	26	0	0	26	0	0
3	167173628	rs7619751	A	G	7	13	20	0	0	20	0	0
3	167173649	rs62279826	G	A	9	10	19	0	0	19	0	0
3	167175039	rs73173009	G	C	2	5	7	0	0	7	0	0
3	167175247	rs4955672	C	G	13	8	21	0	0	21	0	0
3	167175421	rs4955673	C	G	8	3	11	0	0	11	0	0
3	167184878	rs9841174	T	C	6	14	20	0	0	20	0	0
3	167189607	rs17246389	A	C	9	4	13	0	0	13	0	0
3	167217964	rs13060964	A	G	23	30	53	0	1	54	0	0
3	167266791	rs62277772	A	C	34	24	58	0	0	58	0	0
3	167268123	rs62278305	G	T	16	18	34	0	1	35	0	0
3	167269843	rs62278306	C	G	3	3	6	0	0	6	0	0
3	167279650	rs6774632	A	G	3	7	10	0	0	10	0	0
3	167731414	.	C	T	11	17	28	0	0	28	0	0
3	169201002	rs200335084	T	A	9	0	9	0	0	9	0	0
3	169500397	rs35406871	T	C	55	54	109	0	0	109	0	0
3	169503432	rs2141595	C	T	2	5	7	0	0	7	0	0
3	169504004	rs111431310	G	C	4	2	6	0	0	6	0	0
3	169506141	rs1920122	C	T	6	7	13	0	0	13	0	0
3	169506173	rs1920123	C	T	5	6	11	0	0	11	0	0
3	169808114	rs10936611	A	C	22	14	36	0	0	36	0	0
3	169818669	rs2111821	G	A	2	5	7	0	0	7	0	0
3	171320227	rs9822322	C	T	25	29	54	0	3	57	0	0
3	171322271	rs74336171	A	G	2	4	6	0	0	6	0	0
3	171338237	rs9881788	T	G	41	53	94	0	0	94	0	0
3	171385191	rs3774037	A	G	7	13	20	0	1	21	0	0
3	171385611	rs9841075	T	C	7	10	17	0	0	17	0	0
3	171385903	rs6783321	C	T	10	6	16	0	0	16	0	0
3	171386147	rs3774036	T	C	8	15	23	0	0	23	0	0
3	171386231	rs1473377	G	T	6	13	19	0	0	19	0	0
3	171388264	rs9836712	G	T	6	7	13	0	0	13	0	0
3	171389233	rs11712503	C	T	5	8	13	0	0	13	0	0
3	171389389	rs9290424	A	G	6	9	15	0	0	15	0	0
3	171389976	rs3774033	A	G	5	8	13	0	0	13	0	0
3	171390599	rs28668937	A	G	3	6	9	0	0	9	0	0
3	171395468	rs2124147	A	G	32	39	71	0	1	72	0	0
3	171404478	rs2290480	C	A	14	23	37	0	0	37	0	0
3	171507563	rs4586847	C	T	28	16	44	0	0	44	0	0
3	171507730	rs9815321	G	T	88	63	151	0	0	151	0	0
3	171508463	rs9839909	T	C	17	10	27	0	0	27	0	0
3	171509125	rs1574456	A	G	22	17	39	0	0	40	1	0
3	171509135	rs1574455	C	T	19	19	38	0	0	38	0	0
3	171509626	rs4321552	G	C	9	8	17	0	0	17	0	0
3	171509742	rs2901734	G	C	14	16	30	0	1	31	0	0
3	171509747	rs13077802	A	G	16	15	31	0	0	31	0	0
3	171510238	rs3934620	C	T	17	15	32	0	0	32	0	0
3	171510841	rs9831169	C	T	15	15	30	0	0	30	0	0
3	171510898	rs9872581	A	G	13	14	27	0	0	27	0	0
3	171511020	rs9855210	T	G	20	14	34	0	0	34	0	0
3	171511139	rs72622538	C	T	4	2	6	0	0	6	0	0
3	171511355	rs12632766	G	A	11	9	20	0	0	20	0	0
3	171512200	rs72622539	C	T	10	13	23	0	0	23	0	0
3	171513160	rs72622540	T	A	10	9	19	0	0	19	0	0
3	171513388	rs4894512	T	C	6	8	14	0	0	14	0	0
3	171514900	rs34549938	C	T	3	10	13	0	0	13	0	0
3	171517614	rs9839880	C	T	4	2	6	0	0	6	0	0
3	171519564	rs4373091	C	T	4	7	11	0	0	11	0	0
3	171519793	rs13321742	G	A	33	101	134	0	0	134	0	0
3	171520169	rs72622541	A	G	18	24	42	0	0	42	0	0
3	171520323	rs13068741	C	T	19	17	36	0	0	36	0	0
3	171521120	rs9860739	G	C	12	12	24	0	0	24	0	0
3	171521133	rs60943020	T	C	13	10	23	0	1	24	0	0
3	171521613	rs13075194	A	G	4	5	9	0	0	9	0	0
3	171522078	rs72622542	T	A	13	19	32	0	0	32	0	0
3	171522280	rs56221325	G	A	13	9	22	0	0	22	0	0
3	171522370	rs9290435	A	G	13	9	22	0	0	22	0	0
3	171522415	rs6445029	A	G	11	8	19	0	0	19	0	0
3	171522744	rs2141748	C	T	12	15	27	0	0	27	0	0
3	171524190	rs13092828	C	A	16	20	36	0	1	37	0	0
3	171526153	rs9859043	C	T	4	2	6	0	0	6	0	0
3	171526156	rs11924635	C	A	2	4	6	0	0	6	0	0
3	171526304	rs13072966	C	A	4	10	14	0	0	14	0	0
3	171528595	rs116388557	A	G	5	20	25	0	0	25	0	0
3	171844787	rs4894810	A	T	2	5	7	0	0	7	0	0
3	171870146	rs4282087	G	A	5	3	8	0	0	8	0	0
3	171870801	rs11709298	G	A	6	4	10	0	0	10	0	0
3	171871564	rs9868235	A	G	4	3	7	0	0	7	0	0
3	171873767	rs6790787	A	T	8	6	14	0	0	14	0	0
3	171880571	rs4435670	T	C	36	40	76	0	0	76	0	0
3	171881016	rs4593057	G	A	20	24	44	0	0	44	0	0
3	171899488	rs9857359	A	G	5	3	8	0	0	8	0	0
3	171969077	rs7652177	C	G	27	13	40	0	0	40	0	0
3	172223620	rs1131580	A	G	27	7	34	0	0	34	0	0
3	172223627	rs1131579	T	C	28	7	35	0	0	35	0	0
3	172223690	rs1131568	T	C	30	9	39	0	0	39	0	0
3	172223926	rs1131542	T	G	30	16	46	0	0	46	0	0
3	172224075	rs1131535	C	T	25	13	38	0	1	39	0	0
3	172224303	rs1131532	A	G	29	14	43	0	0	43	0	0
3	176738798	rs6983	T	C	58	66	124	0	1	125	0	0
3	176739388	rs3188954	C	T	87	56	143	0	1	144	0	0
3	176739404	rs3188952	A	G	88	59	147	0	1	148	0	0
3	176741730	rs10222515	G	C	18	25	43	0	0	43	0	0
3	176742683	rs144236885	T	C	32	38	70	0	1	71	0	0
3	176747454	rs4465952	G	A	5	7	12	0	0	12	0	0
3	176750309	rs9290609	C	T	5	3	8	0	0	8	0	0
3	176771675	.	T	G	29	21	50	0	0	50	0	0
3	176771847	rs140181568	T	C	3	5	8	0	0	8	0	0
3	176771849	rs145749628	T	C	3	5	8	0	0	8	0	0
3	176771851	rs141727557	T	C	4	3	7	0	1	8	0	0
3	176771853	rs139405656	T	C	5	3	8	0	0	8	0	0
3	176794294	rs73187515	C	T	7	3	10	0	0	10	0	0
3	176794617	rs9838212	C	A	11	7	18	0	0	18	0	0
3	176798573	rs41450848	A	G	3	4	7	0	0	7	0	0
3	176799486	rs79708141	G	A	5	4	9	0	0	9	0	0
3	176804259	rs7637259	T	C	2	5	7	0	0	7	0	0
3	178739594	rs1542	C	G	23	3	26	0	0	26	0	0
3	178741640	rs1071618	C	T	3	24	27	0	0	27	0	0
3	178742671	rs61798176	G	A	4	14	18	0	0	18	0	0
3	178784789	rs4416420	A	G	5	35	40	0	0	40	0	0
3	178785653	rs11918549	C	T	2	4	6	0	0	6	0	0
3	178942431	rs2699889	C	G	3	4	7	0	0	7	0	0
3	178960980	rs1059690	G	A	1	5	6	0	0	6	0	0
3	178968634	rs7645550	C	T	2	12	14	0	0	14	0	0
3	179087104	rs62408874	A	G	3	6	9	0	0	9	0	0
3	179095590	rs13061738	C	T	7	5	12	0	0	12	0	0
3	179111144	rs11720405	G	A	5	4	9	0	0	9	0	0
3	179111894	rs62408877	C	T	10	11	21	0	0	21	0	0
3	179115380	rs10937003	C	T	120	127	247	0	1	248	0	0
3	179115501	rs13088298	A	T	88	104	192	0	0	192	0	0
3	179115649	rs11539416	G	A	35	41	76	0	0	76	0	0
3	179117663	rs17292964	G	C	13	8	21	0	0	21	0	0
3	179118397	rs11714353	A	C	108	115	223	0	1	224	0	0
3	179120982	rs62408882	C	A	9	2	11	0	0	11	0	0
3	179122707	rs2287311	C	G	12	4	16	0	0	16	0	0
3	179122918	rs2287310	T	C	5	14	19	0	1	20	0	0
3	179169230	rs7611674	T	G	4	3	7	0	0	7	0	0
3	179371154	rs2276803	C	T	6	4	10	0	0	10	0	0
3	179503459	.	A	C	3	6	9	0	0	9	0	0
3	180685453	rs182054150	T	A	4	2	6	0	0	6	0	0
3	180693801	rs114795645	T	A	1	6	7	0	0	7	0	0
3	182656944	rs9880394	A	G	51	52	103	0	0	103	0	0
3	182658429	rs1509234	C	T	15	13	28	0	0	28	0	0
3	182659953	rs9878775	T	C	10	11	21	0	1	22	0	0
3	182661952	rs1057949	C	T	8	3	11	0	0	12	1	0
3	182663516	rs1509229	G	A	6	2	8	0	0	8	0	0
3	182681740	rs4859146	C	T	75	76	151	0	1	152	0	0
3	182733547	rs12486983	T	C	5	6	11	0	0	11	0	0
3	182736611	rs11917464	A	G	4	2	6	0	0	6	0	0
3	182745757	rs2134427	A	T	2	4	6	0	0	6	0	0
3	182755209	rs2270968	T	G	12	25	37	0	0	37	0	0
3	182790249	rs7622479	G	A	16	17	33	0	0	33	0	0
3	182970375	rs7650710	C	A	5	9	14	0	0	14	0	0
3	182970558	rs75513317	T	G	5	8	13	0	0	13	0	0
3	182970805	rs6809841	C	T	8	14	22	0	0	22	0	0
3	182971392	rs13313978	C	G	10	15	25	0	0	25	0	0
3	182972912	rs6768556	G	C	3	7	10	0	1	11	0	0
3	182973255	rs6793163	A	C	7	1	8	0	0	8	0	0
3	182973302	rs11916629	G	C	4	3	7	0	0	7	0	0
3	182975678	rs28731202	T	C	1	5	6	0	0	6	0	0
3	182977819	rs73884611	C	T	3	3	6	0	0	6	0	0
3	182978787	rs9819105	C	T	3	3	6	0	0	6	0	0
3	182990138	.	C	G	310	206	516	0	4	520	0	0
3	183169943	rs10937131	G	T	2	4	6	0	0	6	0	0
3	183169944	rs10937132	A	G	2	4	6	0	0	6	0	0
3	183170136	rs10804889	A	C	4	4	8	0	0	8	0	0
3	183207072	rs16857672	A	G	13	10	23	0	0	23	0	0
3	183207231	rs55733741	T	C	14	6	20	0	0	20	0	0
3	183207240	rs114765475	G	C	5	14	19	0	1	20	0	0
3	183207297	rs1553693	G	A	19	6	25	0	0	25	0	0
3	183207519	rs57041915	C	T	15	6	21	0	0	21	0	0
3	183207520	rs17620998	G	A	6	13	19	0	0	19	0	0
3	183207554	rs55681827	T	C	12	6	18	0	0	18	0	0
3	183208737	rs7644322	G	A	13	6	19	0	0	19	0	0
3	183208915	rs7622061	A	G	21	9	30	0	1	31	0	0
3	183210854	rs2255932	A	G	11	6	17	0	0	17	0	0
3	183211127	rs2662768	G	A	14	16	30	0	0	30	0	0
3	183211128	rs2686426	C	T	14	16	30	0	0	30	0	0
3	183211327	rs2686427	G	A	16	18	34	0	0	34	0	0
3	183211906	rs1520101	A	G	30	33	63	0	0	63	0	0
3	183212026	rs2256061	C	T	28	20	48	0	0	48	0	0
3	183234383	rs10804891	T	G	3	4	7	0	0	7	0	0
3	183238992	rs12495530	G	A	5	1	6	0	0	6	0	0
3	183354008	rs71318332	G	A	4	7	11	0	0	11	0	0
3	183354252	rs2271978	G	A	3	4	7	0	0	7	0	0
3	183354524	rs2280425	C	T	6	6	12	0	0	12	0	0
3	183355405	rs9858528	A	G	8	7	15	0	1	16	0	0
3	183355585	rs9821481	G	T	8	2	10	0	0	10	0	0
3	183355592	rs9821484	G	C	8	2	10	0	0	10	0	0
3	183355958	rs9825728	C	A	8	10	18	0	0	18	0	0
3	183356594	rs12631492	C	T	12	9	21	0	1	22	0	0
3	183356627	rs35993231	T	C	13	9	22	0	0	22	0	0
3	183356629	rs7431540	C	G	13	9	22	0	0	22	0	0
3	183356632	rs13078822	C	T	13	9	22	0	0	22	0	0
3	183356647	rs4618245	G	A	10	8	18	0	0	18	0	0
3	183356855	rs2313449	C	T	4	3	7	0	0	7	0	0
3	183357845	rs7647286	A	C	11	8	19	0	0	19	0	0
3	183358016	rs2313450	G	A	27	9	36	0	0	36	0	0
3	183359157	rs11928801	A	G	16	3	19	0	0	19	0	0
3	183359215	rs11921185	G	A	11	0	11	0	1	12	0	0
3	183359497	rs13097199	G	T	22	9	31	0	0	31	0	0
3	183359695	rs13097581	G	A	18	14	32	0	0	32	0	0
3	183359802	rs13097464	C	G	21	14	35	0	0	35	0	0
3	183359987	rs13059594	G	A	24	15	39	0	0	39	0	0
3	183360613	rs201799468	A	T	3	10	13	0	0	13	0	0
3	183360707	rs9810418	A	G	6	9	15	0	0	15	0	0
3	183360741	rs9848425	G	A	5	7	12	0	0	12	0	0
3	183360785	rs9848549	G	A	4	7	11	0	0	11	0	0
3	183360893	rs9852379	G	A	12	15	27	0	0	27	0	0
3	183360959	rs9852261	C	G	11	11	22	0	0	22	0	0
3	183361146	rs9852571	C	T	5	5	10	0	0	10	0	0
3	183361256	rs6802882	T	C	9	7	16	0	0	16	0	0
3	183361947	rs9877526	T	C	24	9	33	0	2	35	0	0
3	183362001	rs9877556	T	C	30	8	38	0	0	38	0	0
3	183362011	rs9857607	C	T	34	6	40	0	1	41	0	0
3	183362190	rs4516634	T	G	45	15	60	0	0	60	0	0
3	183362460	rs3849576	G	A	20	13	33	0	0	33	0	0
3	183362742	rs4388003	G	A	5	4	9	0	0	9	0	0
3	183362827	rs9858949	C	T	9	10	19	0	1	20	0	0
3	183363256	rs6772397	A	G	13	11	24	0	0	24	0	0
3	183363263	rs6797002	C	T	14	11	25	0	0	25	0	0
3	183363270	rs6797004	C	G	14	10	24	0	0	24	0	0
3	183363298	rs6797012	C	G	13	9	22	0	0	22	0	0
3	183365484	rs13100975	C	T	4	3	7	0	0	7	0	0
3	183365656	rs13058832	C	T	7	2	9	0	0	9	0	0
3	183365726	rs28525108	A	G	9	4	13	0	0	13	0	0
3	183365874	rs28538996	G	T	5	3	8	0	0	8	0	0
3	183367149	rs9876259	T	C	4	3	7	0	0	7	0	0
3	183367722	rs9857450	G	T	4	2	6	0	0	6	0	0
3	183368216	rs3755648	A	T	318	228	546	0	1	547	0	0
3	183368891	rs2293031	C	T	336	273	609	0	0	609	0	0
3	183369481	rs9829681	A	G	4	4	8	0	0	8	0	0
3	183371167	rs12696506	A	G	14	12	26	0	0	26	0	0
3	183371250	rs11917105	T	G	9	10	19	0	0	19	0	0
3	183371301	rs11928492	G	A	8	12	20	0	0	20	0	0
3	183371347	rs11917141	T	C	6	12	18	0	0	18	0	0
3	183371457	rs11920784	A	G	7	10	17	0	0	17	0	0
3	183372673	rs9283652	G	A	6	7	13	0	0	13	0	0
3	183372957	rs9812941	G	A	13	9	22	0	1	23	0	0
3	183373028	rs9290767	C	T	20	5	25	0	0	25	0	0
3	183373567	rs10470355	A	G	10	5	15	0	0	15	0	0
3	183373641	rs10470521	C	G	3	7	10	0	0	10	0	0
3	183373651	rs6791677	A	G	3	5	8	0	0	8	0	0
3	183378710	rs71631241	G	A	6	0	6	0	0	6	0	0
3	183378745	rs71631242	T	C	6	0	6	0	0	6	0	0
3	183380900	rs9827156	G	A	5	2	7	0	0	7	0	0
3	183381773	rs3772707	A	G	42	29	71	0	0	71	0	0
3	183381882	rs3772706	A	C	53	35	88	0	1	89	0	0
3	183383720	rs6783616	G	A	6	2	8	0	0	8	0	0
3	183383904	rs6783641	C	T	5	5	10	0	0	10	0	0
3	183383947	rs6796766	T	G	5	6	11	0	0	11	0	0
3	183384674	rs9844222	C	T	9	8	17	0	0	17	0	0
3	183384747	rs1979252	C	G	8	13	21	0	0	21	0	0
3	183385003	rs1979251	C	T	11	7	18	0	0	18	0	0
3	183385405	rs12487341	C	G	11	10	21	0	2	23	0	0
3	183385581	rs9841090	T	C	6	3	9	0	0	9	0	0
3	183385589	rs9821336	G	C	6	3	9	0	0	9	0	0
3	183386204	rs9825921	C	T	3	6	9	0	0	9	0	0
3	183386558	rs1983386	T	C	5	9	14	0	0	14	0	0
3	183386962	rs6794358	G	T	3	7	10	0	0	10	0	0
3	183387272	rs16857954	A	G	13	7	20	0	0	20	0	0
3	183387494	rs13084291	A	G	9	9	18	0	1	19	0	0
3	183388403	rs3772705	A	G	6	6	12	0	0	12	0	0
3	183388450	rs3772704	T	C	9	9	18	0	0	18	0	0
3	183388526	rs3772703	G	A	10	9	19	0	0	19	0	0
3	183389926	rs2033925	G	A	3	4	7	0	0	7	0	0
3	183390915	rs4315707	T	C	23	16	39	0	0	39	0	0
3	183391024	rs2033924	A	G	5	4	9	0	0	9	0	0
3	183392219	rs9819919	A	G	31	28	59	0	0	59	0	0
3	183392832	rs12636131	G	T	3	7	10	0	0	10	0	0
3	183393324	rs9863562	G	A	18	22	40	0	0	40	0	0
3	183393807	rs6806799	A	G	4	6	10	0	0	10	0	0
3	183393846	rs6806883	A	C	4	9	13	0	0	13	0	0
3	183394001	rs6806996	A	G	4	9	13	0	0	13	0	0
3	183394164	rs6807195	A	G	18	25	43	0	0	43	0	0
3	183395944	rs9850810	G	A	4	6	10	0	1	11	0	0
3	183397507	rs9856997	G	A	36	33	69	0	1	70	0	0
3	183398071	rs10937148	C	A	123	104	227	0	5	232	0	0
3	183400488	rs11927407	C	G	43	43	86	0	2	88	0	0
3	183400741	rs7430693	G	T	22	24	46	0	8	54	0	0
3	183400773	rs34777445	C	A	41	35	76	0	2	78	0	0
3	183400967	rs1456330	A	G	62	45	107	0	1	108	0	0
3	183400980	rs35808745	A	G	62	49	111	0	5	116	0	0
3	183401931	rs11542855	C	A	90	40	130	0	2	132	0	0
3	183401938	rs2314158	G	A	86	54	140	0	0	140	0	0
3	183432983	rs3736535	C	T	37	30	67	0	0	67	0	0
3	183460102	rs830182	G	A	3	5	8	0	0	8	0	0
3	183460343	rs830181	C	T	6	6	12	0	0	12	0	0
3	183476685	rs262993	G	A	27	37	64	0	0	64	0	0
3	183477126	rs262992	A	G	3	4	7	0	0	7	0	0
3	183477480	rs12639043	C	T	1	8	9	0	0	9	0	0
3	183477665	rs262991	A	G	3	8	11	0	0	11	0	0
3	183506444	rs263019	A	G	4	3	7	0	0	7	0	0
3	183507633	rs263020	G	C	5	1	6	0	1	7	0	0
3	183508186	rs2582079	G	T	6	7	13	0	0	13	0	0
3	183528442	rs263024	C	T	38	34	72	0	0	72	0	0
3	183533964	rs8391	T	C	12	5	17	0	0	17	0	0
3	183534069	rs3732582	G	C	6	12	18	0	0	18	0	0
3	183534170	rs1061594	C	T	11	6	17	0	0	17	0	0
3	183534487	rs2606225	G	C	8	2	10	0	0	10	0	0
3	183534494	rs2606226	G	T	8	5	13	0	0	13	0	0
3	183534538	rs1061593	T	C	9	7	16	0	0	16	0	0
3	183534913	rs2255019	A	G	6	2	8	0	0	8	0	0
3	183535094	rs2582091	C	T	5	2	7	0	0	7	0	0
3	183558402	rs3732581	C	G	118	92	210	0	1	211	0	0
3	183560195	rs13091	A	G	57	51	108	0	2	110	0	0
3	183702089	rs3749440	A	G	11	5	16	0	0	16	0	0
3	183702275	rs4148575	A	G	12	5	17	0	1	18	0	0
3	183735644	rs56843723	G	A	1	5	6	0	0	6	0	0
3	183890034	rs59843451	C	T	29	23	52	0	0	52	0	0
3	183890868	rs11919795	A	G	70	57	127	0	0	127	0	0
3	183891137	rs10937163	C	T	59	58	117	0	2	119	0	0
3	183960252	rs706584	A	C	18	13	31	0	0	31	0	0
3	183976108	rs902415	T	C	4	5	9	0	0	9	0	0
3	184026703	rs6845	C	T	173	157	330	0	1	331	0	0
3	184033082	rs142244056	C	T	12	5	17	0	0	17	0	0
3	184036894	rs55748802	C	T	23	27	50	0	4	54	0	0
3	184039666	rs2178403	A	G	173	175	348	0	3	351	0	0
3	184046355	rs1879244	C	T	4	3	7	0	0	7	0	0
3	184046470	rs2230571	C	T	242	226	468	0	6	474	0	0
3	184062776	rs9839000	A	G	8	5	13	0	0	13	0	0
3	184063791	rs9944	A	G	6	4	10	0	0	10	0	0
3	184529990	rs7640976	C	G	11	14	25	0	0	25	0	0
3	184542344	rs78004904	C	G	8	4	12	0	0	12	0	0
3	184573555	rs6443999	C	T	19	21	40	0	1	41	0	0
3	184700426	rs11555405	C	T	35	48	83	0	0	83	0	0
3	184769911	rs2271257	C	T	59	44	103	0	1	104	0	0
3	184769941	rs2271258	T	C	58	51	109	0	0	109	0	0
3	185135448	rs13099317	G	A	24	0	24	0	1	25	0	0
3	185135935	rs3796201	T	C	35	0	35	0	2	37	0	0
3	185390343	.	A	T	60	0	60	0	5	65	0	0
3	185408770	rs6770227	G	C	3	5	8	0	0	8	0	0
3	185440960	rs6777038	C	T	4	4	8	0	0	8	0	0
3	185468884	rs6769946	C	T	5	1	6	0	0	6	0	0
3	185469491	rs12636310	A	G	3	3	6	0	0	6	0	0
3	185479733	rs6789741	G	T	3	3	6	0	0	6	0	0
3	185529080	rs1470579	A	C	7	3	10	0	0	10	0	0
3	185529174	rs1470580	T	A	4	4	8	0	0	8	0	0
3	185529629	rs9852647	T	G	4	3	7	0	0	7	0	0
3	185530177	rs138960826	G	A	2	6	8	0	0	8	0	0
3	185530290	rs6769511	T	C	1	8	9	0	0	9	0	0
3	185530322	rs9837654	G	A	1	7	8	0	0	8	0	0
3	185652184	rs1862903	T	C	17	17	34	0	0	34	0	0
3	185655277	rs542556633	G	A	6	9	15	0	0	15	0	0
3	185766711	rs79060173	G	A	2	4	6	0	0	6	0	0
3	185795017	rs73052025	C	A	4	6	10	0	0	10	0	0
3	185812998	.	C	T	13	8	21	0	0	21	0	0
3	185826740	rs869400	T	G	9	9	18	0	0	18	0	0
3	185826764	rs869399	C	T	4	4	8	0	0	8	0	0
3	185841421	rs9825254	A	G	7	3	10	0	0	10	0	0
3	185841624	rs9863591	G	C	3	3	6	0	0	6	0	0
3	185843271	rs73052057	G	A	9	3	12	0	0	12	0	0
3	185849190	rs9839150	A	G	3	3	6	0	0	6	0	0
3	185865240	rs2280209	C	A	15	19	34	0	0	34	0	0
3	185865617	rs2280210	A	T	101	96	197	0	1	198	0	0
3	185866243	rs9835936	C	A	38	56	94	0	1	96	1	0
3	185866615	rs13089860	A	G	41	38	79	0	2	81	0	0
3	185867283	rs6444109	A	G	48	54	102	0	1	103	0	0
3	185867391	rs2575	G	A	42	49	91	0	1	92	0	0
3	185867550	rs2574	G	C	49	54	103	0	2	105	0	0
3	185883282	rs62288978	A	C	3	6	9	0	0	9	0	0
3	185883562	rs1400362	T	C	4	4	8	0	0	8	0	0
3	185884216	rs938587	A	T	5	2	7	0	0	7	0	0
3	185884518	rs3774052	G	A	6	2	8	0	0	8	0	0
3	185908285	rs13079928	T	C	13	5	18	0	0	18	0	0
3	185913464	rs2300711	T	C	6	1	7	0	0	7	0	0
3	185915287	rs2268850	C	T	5	1	6	0	0	6	0	0
3	185990096	rs2193587	C	T	38	38	76	0	2	78	0	0
3	185995196	rs1541614	T	C	51	32	83	0	3	86	0	0
3	186006618	rs1004588	G	C	64	54	118	0	2	120	0	0
3	186079261	rs73182221	G	A	3	7	10	0	0	10	0	0
3	186264587	rs4686430	T	G	7	5	12	0	0	12	0	0
3	186271326	rs62291966	T	C	15	18	33	0	0	33	0	0
3	186503435	rs1426810	G	A	43	36	79	0	2	81	0	0
3	186503496	rs57904146	T	C	36	54	90	0	0	90	0	0
3	186504148	rs266718	T	C	57	70	127	0	2	129	0	0
3	186505706	rs12630327	A	C	109	113	222	0	1	223	0	0
3	186506167	.	A	C	614	629	1243	0	38	1281	0	0
3	186507757	rs1047148	G	A	12	17	29	0	0	29	0	0
3	187912388	rs4686478	G	A	5	1	6	0	0	6	0	0
3	188592577	rs140211843	A	G	3	4	7	0	0	7	0	0
3	188599054	rs17205285	G	A	1	9	10	0	0	10	0	0
3	188599276	rs80200434	A	G	6	3	9	0	0	9	0	0
3	188607071	rs76971802	C	T	23	15	38	0	0	38	0	0
3	190233523	rs7630034	G	A	5	2	7	0	0	7	0	0
3	190234161	rs9811205	A	G	6	3	9	0	0	9	0	0
3	190236758	rs9990231	T	C	46	24	70	0	0	70	0	0
3	190237101	rs11719243	A	G	7	8	15	0	0	15	0	0
3	190237351	rs9290935	T	C	17	17	34	0	0	34	0	0
3	190237797	rs7628333	C	T	21	7	28	0	0	28	0	0
3	190238043	rs3821744	C	T	24	21	45	0	0	45	0	0
3	190347523	rs1024946	G	A	31	24	55	0	2	57	0	0
3	190349049	rs2193878	A	T	6	8	14	0	0	14	0	0
3	190349670	rs56823006	A	G	5	5	10	0	0	10	0	0
3	190351182	rs4687164	G	T	6	6	12	0	0	12	0	0
3	190351207	rs113789448	G	A	6	6	12	0	0	12	0	0
3	190351281	rs4686559	G	A	4	3	7	0	0	7	0	0
3	190351666	rs12497824	C	T	2	4	6	0	1	7	0	0
3	190357721	rs58230362	C	A	4	5	9	0	0	9	0	0
3	190358352	rs9815685	G	A	6	4	10	0	1	11	0	0
3	190359456	rs9821122	G	A	6	7	13	0	0	13	0	0
3	190359804	rs62286262	A	G	9	11	20	0	0	20	0	0
3	190360571	rs3935774	C	T	3	6	9	0	0	9	0	0
3	190360642	rs3935775	A	T	5	8	13	0	0	13	0	0
3	190361497	rs9831803	G	T	3	7	10	0	1	11	0	0
3	193334991	rs7624750	G	A	59	49	108	0	2	110	0	0
3	193335048	.	G	T	54	61	115	0	1	116	0	0
3	193337021	rs9817704	G	A	8	5	13	0	0	13	0	0
3	193340310	rs34520293	A	C	9	6	15	0	0	15	0	0
3	193341016	rs12490391	C	T	11	18	29	0	0	29	0	0
3	193343761	rs6791301	C	G	9	10	19	0	0	19	0	0
3	193346648	rs6444733	A	C	7	3	10	0	1	11	0	0
3	193346921	rs6444734	C	T	4	2	6	0	0	6	0	0
3	193350500	rs7650613	T	A	4	3	7	0	0	7	0	0
3	193350837	rs13096511	T	G	4	5	9	0	0	9	0	0
3	193350876	rs13078398	G	T	7	7	14	0	0	14	0	0
3	193374964	rs9851685	T	C	116	119	235	0	5	240	0	0
3	193385275	rs13070791	C	T	4	3	7	0	0	7	0	0
3	193385276	rs13070610	A	G	4	3	7	0	0	7	0	0
3	193386239	rs12494482	C	T	9	11	20	0	0	20	0	0
3	193386462	rs2276722	C	T	6	8	14	0	1	15	0	0
3	193386538	rs414237	C	T	8	2	10	0	0	10	0	0
3	193391085	rs6796713	G	A	2	5	7	0	0	7	0	0
3	193393612	rs3851984	A	G	5	6	11	0	0	11	0	0
3	193412672	rs1061648	A	G	31	36	67	0	1	68	0	0
3	193413502	rs12630	C	T	7	8	15	0	0	15	0	0
3	193413732	rs1056366	A	G	27	33	60	0	0	60	0	0
3	193414481	rs1056390	C	T	14	13	27	0	0	27	0	0
3	193414733	rs1056392	A	G	26	33	59	0	0	59	0	0
3	193414780	rs11719309	T	C	27	21	48	0	0	48	0	0
3	194305017	rs143486195	C	T	7	8	15	0	0	15	0	0
3	194308974	rs78250008	G	A	7	8	15	0	0	15	0	0
3	194310731	rs1055161	C	A	7	0	7	0	1	8	0	0
3	194372906	rs115562595	T	C	11	9	20	0	0	20	0	0
3	194789163	rs6794037	T	C	6	10	16	0	0	16	0	0
3	194789496	rs139106820	C	T	8	9	17	0	0	17	0	0
3	194789553	rs57202169	A	C	14	7	21	0	0	21	0	0
3	194789558	rs60093934	C	G	15	9	24	0	0	24	0	0
3	194789663	rs55912217	T	C	19	8	27	0	0	27	0	0
3	194790422	rs3796158	G	A	7	10	17	0	1	18	0	0
3	194790434	rs3796159	C	G	7	9	16	0	1	17	0	0
3	195162556	.	C	T	6	4	10	0	0	10	0	0
3	195241389	rs73065894	G	A	127	118	245	0	3	248	0	0
3	195248757	rs73196127	T	G	2	7	9	0	1	10	0	0
3	195248960	rs73067603	C	A	9	2	11	0	0	11	0	0
3	195249587	rs34357956	C	T	12	10	22	0	0	22	0	0
3	195250086	rs76080354	T	C	9	8	17	0	0	17	0	0
3	195251934	rs34460735	A	G	5	8	13	0	0	13	0	0
3	195255816	rs34658674	C	T	9	3	12	0	0	12	0	0
3	195270012	rs11475	A	G	105	94	199	0	1	200	0	0
3	195270078	rs823518	C	G	84	66	150	0	0	150	0	0
3	195392763	rs4927675	G	C	3	4	7	0	0	7	0	0
3	195394315	.	T	A	0	11	11	0	0	11	0	0
3	195398250	.	C	A	4	3	7	0	0	7	0	0
3	195398271	.	A	G	5	6	11	0	0	11	0	0
3	195401595	.	A	G	2	4	6	0	0	6	0	0
3	195401807	.	C	T	5	1	6	0	0	6	0	0
3	195403053	.	A	G	3	3	6	0	0	6	0	0
3	195412920	.	C	T	7	2	9	0	0	9	0	0
3	195413318	.	T	G	3	3	6	0	0	6	0	0
3	195423249	.	C	G	6	4	10	0	0	10	0	0
3	195425545	.	A	G	6	1	7	0	0	7	0	0
3	195425645	.	T	G	5	7	12	0	0	12	0	0
3	195426490	.	A	G	6	0	6	0	0	6	0	0
3	195426826	.	G	T	6	1	7	0	0	7	0	0
3	195426849	rs3107774	C	A	4	2	6	0	0	6	0	0
3	195426855	rs3107773	G	A	5	1	6	0	0	6	0	0
3	195426860	.	T	C	4	3	7	0	0	7	0	0
3	195427064	.	G	C	6	0	6	0	0	6	0	0
3	195427156	rs374146311	G	A	5	1	6	0	0	6	0	0
3	195427776	rs1874020	T	C	7	1	8	0	0	8	0	0
3	195435053	.	G	A	2	6	8	0	0	8	0	0
3	195452799	.	C	T	3	3	6	0	0	6	0	0
3	195452805	.	T	C	6	0	6	0	0	6	0	0
3	195452951	.	G	C	3	5	8	0	0	8	0	0
3	195453064	.	T	G	5	3	8	0	0	8	0	0
3	195453244	rs140946665	G	A	9	1	10	0	0	10	0	0
3	195453257	.	G	A	11	1	12	0	0	12	0	0
3	195453288	.	A	C	13	1	14	0	0	14	0	0
3	195453329	.	C	A	10	1	11	0	0	11	0	0
3	195453417	rs73203948	C	T	8	0	8	0	0	8	0	0
3	195590875	rs6773526	A	G	120	129	249	0	0	249	0	0
3	195596636	rs13084875	C	T	15	33	48	0	0	48	0	0
3	195596907	rs2278034	T	C	10	14	24	0	0	24	0	0
3	195620038	rs9846297	G	A	8	6	14	0	0	14	0	0
3	195624484	rs62283334	T	C	5	4	9	0	0	9	0	0
3	195686832	.	G	A	11	0	11	0	0	11	0	0
3	195686868	.	G	A	14	2	16	0	0	16	0	0
3	195697003	.	C	T	6	1	7	0	0	7	0	0
3	195697019	.	C	A	7	1	8	0	0	8	0	0
3	195703611	.	T	C	12	4	16	0	0	16	0	0
3	195704005	.	G	A	7	2	9	0	0	9	0	0
3	195708256	.	C	T	2	12	14	0	2	16	0	0
3	195708372	rs544342623	G	A	6	0	6	0	0	6	0	0
3	195708880	rs2620600	C	T	4	14	18	0	0	18	0	0
3	195708973	.	C	G	5	8	13	0	0	13	0	0
3	195710989	rs2620604	G	A	15	11	26	0	0	26	0	0
3	195710993	rs4927692	A	G	15	11	26	0	0	26	0	0
3	195711648	rs28607046	A	G	2	4	6	0	0	6	0	0
3	195775824	rs41299394	C	T	3	6	9	0	0	9	0	0
3	195775991	rs12487702	G	A	5	5	10	0	0	10	0	0
3	195776240	rs570	C	T	253	348	601	0	2	604	1	0
3	195776976	rs406271	T	C	984	895	1879	0	17	1896	0	0
3	195779155	rs41298097	C	T	11	6	17	0	0	17	0	0
3	195779706	rs34906439	A	G	4	13	17	0	0	17	0	0
3	195779736	rs41298087	C	T	5	13	18	0	0	18	0	0
3	195780709	rs557527	G	A	12	18	30	0	1	31	0	0
3	195781325	rs7645812	C	T	3	6	9	0	0	9	0	0
3	195781684	rs41259844	C	T	15	24	39	0	0	39	0	0
3	195782176	rs419068	C	T	47	78	125	0	0	125	0	0
3	195782177	rs366268	A	G	47	77	124	0	1	125	0	0
3	195782184	rs419059	C	T	47	89	136	0	1	137	0	0
3	195782655	rs148276433	C	T	59	19	78	0	5	83	0	0
3	195783481	rs62284053	C	T	19	41	60	0	0	60	0	0
3	195784076	rs539816	T	A	24	39	63	0	0	63	0	0
3	195784192	rs492349	G	A	33	52	85	0	1	86	0	0
3	195784210	rs492288	C	T	41	57	98	0	1	99	0	0
3	195784648	rs41297523	T	C	7	14	21	0	5	27	1	0
3	195784997	rs3933	G	A	39	47	86	0	2	88	0	0
3	195789428	rs507131	C	A	76	45	121	0	3	124	0	0
3	195790022	rs499591	A	T	20	17	37	0	0	37	0	0
3	195790691	rs2300779	G	A	49	39	88	0	0	88	0	0
3	195796574	rs3827556	A	T	87	82	169	0	2	171	0	0
3	195796908	rs3804141	C	T	134	118	252	0	0	252	0	0
3	195798097	rs3761716	T	G	56	66	122	0	3	125	0	0
3	195798258	rs480760	T	C	88	93	181	0	2	183	0	0
3	195801426	rs41301353	C	A	8	9	17	0	1	18	0	0
3	195804449	rs41300427	C	T	3	4	7	0	0	7	0	0
3	195806641	rs62285381	C	T	8	6	14	0	0	14	0	0
3	195807688	rs3804138	T	C	12	6	18	0	0	18	0	0
3	195808024	rs6763092	A	G	10	9	19	0	0	19	0	0
3	195961254	rs60631199	C	T	6	2	8	0	0	8	0	0
3	195961685	rs1044988	A	G	24	22	46	0	0	46	0	0
3	195962244	rs870339	G	T	10	9	19	0	1	20	0	0
3	195964298	rs884534	A	G	8	8	16	0	0	16	0	0
3	195964672	rs77591549	G	A	20	23	43	0	2	45	0	0
3	195964673	rs75470234	A	T	21	24	45	0	0	45	0	0
3	195964687	rs712012	C	T	19	23	42	0	0	42	0	0
3	195965115	rs939883	A	T	25	14	39	0	0	39	0	0
3	195965509	rs3184886	T	C	41	45	86	0	0	86	0	0
3	195968029	.	A	C	4	2	6	0	3	9	0	0
3	195968281	rs57987393	A	G	13	4	17	0	0	17	0	0
3	195968643	rs1045075	G	A	8	4	12	0	0	12	0	0
3	195970896	.	C	T	6	0	6	0	0	6	0	0
3	196014073	rs6766480	T	C	2	4	6	0	0	6	0	0
3	196014366	rs6809764	C	G	7	5	12	0	0	12	0	0
3	196076503	rs4371545	T	C	128	152	280	0	2	282	0	0
3	196076739	rs4513483	A	T	68	60	128	0	1	130	1	0
3	196078149	rs6772164	C	A	44	51	95	0	0	95	0	0
3	196078427	rs6774852	C	T	72	60	132	0	0	132	0	0
3	196078746	rs9848247	C	T	126	99	225	0	6	231	0	0
3	196091317	rs7617626	A	T	8	6	14	0	0	14	0	0
3	196091911	rs6774540	T	C	18	23	41	0	0	41	0	0
3	196093346	rs11185535	A	T	20	22	42	0	0	42	0	0
3	196094213	rs4916427	C	T	18	19	37	0	0	37	0	0
3	196094417	rs4916428	G	C	36	32	68	0	1	69	0	0
3	196126065	rs7373049	C	T	13	14	27	0	2	29	0	0
3	196126077	rs7373385	A	G	13	13	26	0	0	26	0	0
3	196126539	rs9846106	G	A	54	27	81	0	0	81	0	0
3	196127406	rs13089205	A	G	40	27	67	0	0	67	0	0
3	196195998	rs73891247	G	A	58	33	91	0	2	93	0	0
3	196196046	rs73213995	C	T	63	28	91	0	0	91	0	0
3	196197804	rs11719920	T	G	47	61	108	0	1	109	0	0
3	196198022	rs111444359	G	A	10	11	21	0	0	21	0	0
3	196199204	rs3796129	G	T	50	66	116	0	0	116	0	0
3	196212282	rs11718980	G	A	6	2	8	0	0	8	0	0
3	196213904	rs73219637	T	C	4	4	8	0	0	8	0	0
3	196230444	rs113586283	G	C	59	30	89	0	1	90	0	0
3	196230564	rs9837291	G	C	29	16	45	0	2	47	0	0
3	196281208	rs9311	T	C	11	17	28	0	0	28	0	0
3	196366699	rs1684448	C	T	61	113	174	0	0	174	0	0
3	196366964	rs939874	G	A	1	6	7	0	0	7	0	0
3	196368638	rs6804254	C	T	4	4	8	0	0	8	0	0
3	196372995	rs555519569	A	T	2	7	9	0	0	9	0	0
3	196373037	rs9823810	T	C	5	8	13	0	0	13	0	0
3	196373038	rs9811703	C	T	5	8	13	0	0	13	0	0
3	196374156	rs1212534	A	C	3	5	8	0	0	8	0	0
3	196377750	rs1798629	C	T	7	8	15	0	0	15	0	0
3	196378018	rs1684440	A	G	4	3	7	0	0	7	0	0
3	196378637	rs843516	C	T	3	4	7	0	0	7	0	0
3	196378705	rs843517	G	A	4	3	7	0	0	7	0	0
3	196379737	rs843519	C	G	3	6	9	0	0	9	0	0
3	196379897	rs6583335	A	G	2	4	6	0	0	6	0	0
3	196379906	rs9848767	C	T	3	5	8	0	0	8	0	0
3	196379993	rs965140	G	T	10	6	16	0	0	16	0	0
3	196382011	rs7625234	T	C	16	22	38	0	1	39	0	0
3	196383215	rs9875286	G	T	33	24	57	0	1	58	0	0
3	196383803	rs11720519	G	A	5	21	26	0	0	26	0	0
3	196383858	rs7631278	T	G	10	23	33	0	0	33	0	0
3	196384013	rs11717794	T	G	10	15	25	0	0	25	0	0
3	196384501	rs4912585	C	T	13	16	29	0	0	29	0	0
3	196384519	rs9985448	A	G	16	13	29	0	0	29	0	0
3	196385395	rs35493154	T	C	26	40	66	0	0	66	0	0
3	196385702	rs7645195	G	A	21	21	42	0	0	42	0	0
3	196385734	rs7645207	G	A	22	20	42	0	0	42	0	0
3	196386964	rs1798631	C	G	185	148	333	0	2	335	0	0
3	196389580	rs6803735	A	G	7	4	11	0	0	11	0	0
3	196394518	rs6805151	T	C	3	4	7	0	0	7	0	0
3	196395430	rs6808366	T	C	4	2	6	0	0	6	0	0
3	196461474	rs1047113	A	C	2	8	10	0	0	10	0	0
3	196462115	rs76637023	G	A	1	5	6	0	0	6	0	0
3	196622010	rs13326047	A	G	7	1	8	0	0	8	0	0
3	196631138	rs7613138	G	A	4	7	11	0	0	11	0	0
3	196631313	rs7638191	C	G	3	12	15	0	1	16	0	0
3	196634954	rs4916579	T	C	5	2	7	0	0	7	0	0
3	196635675	rs9861759	G	C	6	5	11	0	0	11	0	0
3	196636040	rs7628587	G	A	4	8	12	0	0	12	0	0
3	196636274	rs7630977	G	T	9	8	17	0	0	17	0	0
3	196636674	rs4916449	G	A	6	4	10	0	0	10	0	0
3	196637406	rs4916582	A	T	5	4	9	0	0	9	0	0
3	196641105	rs6583189	G	A	3	7	10	0	0	10	0	0
3	196644682	rs114759144	G	A	5	1	6	0	0	6	0	0
3	196647724	rs9860985	C	T	7	3	10	0	0	10	0	0
3	196651590	rs9873265	A	G	8	2	10	0	1	11	0	0
3	196660555	rs1147242	C	T	25	18	43	0	0	43	0	0
3	196662521	rs6734	G	A	51	46	97	0	1	98	0	0
3	196663321	rs480668	G	T	30	50	80	0	1	81	0	0
3	196664890	rs516461	T	A	16	18	34	0	0	34	0	0
3	196665124	rs6583190	T	C	38	30	68	0	0	68	0	0
3	196665296	rs2121811	T	C	2	4	6	0	0	6	0	0
3	196665654	rs2593977	C	G	4	11	15	0	0	15	0	0
3	196665798	rs4916587	G	C	9	13	22	0	0	22	0	0
3	196665854	rs555582	A	G	7	16	23	0	0	23	0	0
3	196665864	rs556502	T	C	5	9	14	0	1	15	0	0
3	196666059	rs553783	A	G	3	12	15	0	0	15	0	0
3	196669912	rs335824	C	T	122	104	226	0	2	229	1	0
3	196670092	rs1054278	C	A	197	161	358	0	0	374	16	0
3	196674518	rs1147238	A	G	6	4	10	0	0	10	0	0
3	196674749	rs4916589	C	T	3	6	9	0	0	9	0	0
3	196674879	rs12636891	A	G	8	7	15	0	0	15	0	0
3	196674972	rs574365	C	T	5	7	12	0	0	12	0	0
3	196674973	rs573708	T	C	4	7	11	0	0	11	0	0
3	196728706	rs539510	T	C	13	12	25	0	0	25	0	0
3	196735688	.	G	A	6	4	10	0	0	10	0	0
3	196742290	rs9855410	T	C	14	15	29	0	0	29	0	0
3	196743130	rs6779362	T	C	5	12	17	0	0	17	0	0
3	196747252	rs61370412	G	T	3	3	6	0	0	6	0	0
3	196771049	rs45448597	T	C	21	32	53	0	0	53	0	0
3	196771245	rs4916600	G	A	50	51	101	0	1	102	0	0
3	196771513	rs34492126	G	A	61	27	88	0	0	88	0	0
3	196771554	rs35370245	T	C	68	36	104	0	3	107	0	0
3	197232889	rs11719360	C	T	3	3	6	0	0	6	0	0
3	197233176	rs1864671	G	A	6	4	10	0	1	11	0	0
3	197237019	rs9820761	C	T	4	12	16	0	0	16	0	0
3	197237129	rs2567370	C	G	8	5	13	0	0	13	0	0
3	197238334	rs7621257	A	G	9	4	13	0	0	13	0	0
3	197238487	rs1050119	C	T	9	3	12	0	0	12	0	0
3	197247006	rs2567329	A	G	3	4	7	0	0	7	0	0
3	197256723	rs12718046	G	C	5	3	8	0	0	8	0	0
3	197261859	rs2099247	T	C	1	5	6	0	0	6	0	0
3	197265434	rs11919456	A	G	5	6	11	0	0	11	0	0
3	197265488	rs11919480	A	G	4	6	10	0	0	10	0	0
3	197282714	.	G	A	20	18	38	0	0	38	0	0
3	197350094	.	C	T	40	1	41	0	1	42	0	0
3	197473339	.	C	G	3	3	6	0	0	6	0	0
3	197478777	rs12486112	C	T	4	6	10	0	0	10	0	0
3	197482523	rs147510240	A	T	7	5	12	0	0	12	0	0
3	197597044	rs77281724	C	T	10	15	25	0	0	25	0	0
3	197611279	rs59694244	C	T	9	2	11	0	0	11	0	0
3	197614860	.	T	C	8	4	12	0	0	12	0	0
3	197677259	rs7631002	T	C	3	5	8	0	0	8	0	0
3	197683423	rs9818493	G	A	30	16	46	0	0	46	0	0
4	57088	.	T	G	7	1	8	0	0	8	0	0
4	64892	.	G	C	7	0	7	0	0	7	0	0
4	64956	.	G	A	6	0	6	0	0	6	0	0
4	68443	.	A	T	19	0	19	0	0	19	0	0
4	506268	rs73072136	A	G	3	3	6	0	0	6	0	0
4	521313	rs147177926	T	C	4	7	11	0	0	11	0	0
4	663908	rs28675771	A	G	8	8	16	0	0	16	0	0
4	669819	.	T	G	3	4	7	0	0	7	0	0
4	755129	rs2242234	C	T	28	22	50	0	1	51	0	0
4	760819	rs4690194	C	T	29	23	52	0	1	53	0	0
4	762285	rs17164985	A	G	5	14	19	0	0	19	0	0
4	763077	rs1044147	G	A	16	16	32	0	0	32	0	0
4	763630	rs1044180	C	T	23	17	40	0	0	40	0	0
4	843184	rs6964	G	A	84	61	145	0	0	145	0	0
4	852260	.	C	G	7	6	13	0	0	13	0	0
4	852566	rs140647936	C	T	8	7	15	0	0	15	0	0
4	889006	.	C	T	4	4	8	0	0	8	0	0
4	893520	rs3775121	G	A	2	9	11	0	0	11	0	0
4	893687	rs3775120	G	A	3	5	8	0	1	9	0	0
4	893712	rs3775119	C	T	5	2	7	0	0	7	0	0
4	893913	rs3822024	G	A	6	4	10	0	1	11	0	0
4	896998	rs3775116	A	G	7	6	13	0	0	13	0	0
4	994414	rs3755955	G	A	32	18	50	0	0	50	0	0
4	995107	rs3733341	C	G	8	10	18	0	0	18	0	0
4	995305	rs6815946	T	C	23	19	42	0	0	42	0	0
4	995422	rs6829789	G	C	4	3	7	0	0	7	0	0
4	995459	rs6848974	C	T	4	4	8	0	0	8	0	0
4	995919	rs6830825	G	C	12	21	33	0	2	35	0	0
4	996165	rs6831280	G	A	20	18	38	0	1	39	0	0
4	996248	rs6836258	G	C	7	14	21	0	0	21	0	0
4	996560	rs115790973	C	G	3	5	8	0	0	8	0	0
4	996888	rs115929690	C	T	6	3	9	0	0	9	0	0
4	1018705	rs4647930	C	A	14	11	25	0	1	26	0	0
4	1019697	rs1064839	C	G	17	11	28	0	1	29	0	0
4	1020391	rs4647940	C	G	20	26	46	0	0	46	0	0
4	1162694	rs3755953	T	G	33	20	53	0	0	53	0	0
4	1164277	rs2279279	C	G	178	121	299	0	0	299	0	0
4	1165130	rs11247975	G	T	36	26	62	0	0	62	0	0
4	1165764	rs11538062	C	T	77	92	169	0	2	171	0	0
4	1167650	rs75654334	C	T	8	7	15	0	0	15	0	0
4	1169273	rs62293577	T	C	11	11	22	0	0	22	0	0
4	1169813	rs878323	G	T	10	1	11	0	0	11	0	0
4	1171863	rs12505896	C	T	3	3	6	0	0	6	0	0
4	1196580	rs36096962	T	C	6	2	8	0	0	8	0	0
4	1206434	.	G	A	4	2	6	0	0	6	0	0
4	1218506	.	G	T	6	3	9	0	0	9	0	0
4	1237014	rs3755930	T	C	8	9	17	0	0	17	0	0
4	1237192	rs528547592	G	A	11	5	16	0	0	16	0	0
4	1328297	rs10024996	G	A	5	4	9	0	0	9	0	0
4	1329360	rs36105735	T	C	2	4	6	0	1	7	0	0
4	1330759	rs1128427	T	C	22	31	53	0	0	53	0	0
4	1330983	rs13135102	A	C	3	7	10	0	0	10	0	0
4	1332175	rs13147602	A	G	3	5	8	0	0	8	0	0
4	1343405	rs2276903	T	C	5	7	12	0	0	12	0	0
4	1369885	rs11724369	G	A	5	2	7	0	0	7	0	0
4	1386459	rs13114537	G	C	4	7	11	0	0	11	0	0
4	1386570	rs13142985	A	G	3	6	9	0	0	9	0	0
4	1387275	rs34299899	A	G	3	6	9	0	0	9	0	0
4	1388413	rs78309237	T	C	6	7	13	0	1	14	0	0
4	1388429	rs79298048	G	A	5	9	14	0	0	14	0	0
4	1389101	rs71614971	A	G	9	1	10	0	2	12	0	0
4	1642374	rs7376928	A	G	3	5	8	0	0	8	0	0
4	1642519	rs3752743	T	A	3	6	9	0	0	9	0	0
4	1694809	rs8051	T	C	235	199	434	0	3	437	0	0
4	1696103	rs35313041	C	T	21	10	31	0	0	31	0	0
4	1697337	rs34049648	G	A	45	35	80	0	0	80	0	0
4	1701317	rs2247341	G	A	581	483	1064	0	5	1069	0	0
4	1703646	rs2236996	A	G	3	4	7	0	0	7	0	0
4	1704244	rs11732213	T	C	5	3	8	0	0	8	0	0
4	1704542	rs2236995	T	G	7	3	10	0	0	10	0	0
4	1707447	rs798756	T	C	8	6	14	0	0	14	0	0
4	1709462	rs798740	G	A	4	7	11	0	0	11	0	0
4	1712413	rs798741	A	G	4	3	7	0	0	7	0	0
4	1715250	rs2854921	C	T	3	3	6	0	0	6	0	0
4	1718883	rs2236787	A	T	12	12	24	0	0	24	0	0
4	1719294	rs2236786	T	C	6	15	21	0	0	21	0	0
4	1719572	rs798751	A	G	6	4	10	0	0	10	0	0
4	1719620	rs743569	T	G	7	3	10	0	0	10	0	0
4	1720550	rs2854917	T	C	5	1	6	0	1	7	0	0
4	1720757	rs798754	A	G	10	7	17	0	0	17	0	0
4	1720794	rs61675353	T	G	10	6	16	0	0	16	0	0
4	1720824	rs798755	A	G	11	5	16	0	0	16	0	0
4	1726367	rs1665362	T	A	4	3	7	0	0	7	0	0
4	1731126	rs798761	G	A	10	13	23	0	0	23	0	0
4	1731150	rs798762	T	C	9	11	20	0	0	20	0	0
4	1731621	rs798763	T	C	13	10	23	0	0	23	0	0
4	1731653	rs798764	C	T	15	8	23	0	0	23	0	0
4	1733487	rs798765	A	G	10	18	28	0	0	28	0	0
4	1734239	rs798766	T	C	3	10	13	0	0	13	0	0
4	1734281	rs798767	A	G	2	5	7	0	0	7	0	0
4	1735171	.	G	A	5	4	9	0	0	9	0	0
4	1737108	rs3752747	C	T	9	5	14	0	0	14	0	0
4	1737262	rs3752749	T	C	6	4	10	0	0	10	0	0
4	1737502	rs11248073	C	T	119	124	243	0	3	246	0	0
4	1737585	rs11729657	T	C	6	14	20	0	0	20	0	0
4	1738050	rs7662657	C	T	4	6	10	0	0	10	0	0
4	1738313	rs11730727	T	C	3	9	12	0	0	12	0	0
4	1739592	rs2305188	A	G	13	18	31	0	1	32	0	0
4	1740539	rs13123646	T	C	15	28	43	0	1	44	0	0
4	1740675	rs13138643	G	A	22	26	48	0	0	48	0	0
4	1742400	rs4865463	T	C	18	18	36	0	0	36	0	0
4	1742779	rs1530588	G	A	15	11	26	0	0	26	0	0
4	1743169	rs2166580	G	A	5	13	18	0	1	19	0	0
4	1743343	rs7682402	G	A	12	17	29	0	0	29	0	0
4	1743754	rs11248074	C	T	5	11	16	0	0	16	0	0
4	1744939	rs11736125	C	T	4	9	13	0	1	14	0	0
4	1745152	rs12511923	C	T	11	7	18	0	0	18	0	0
4	1745500	rs4865467	G	T	27	9	36	0	0	36	0	0
4	1745751	rs28521716	A	G	25	23	48	0	0	48	0	0
4	1745816	rs34770519	A	C	24	27	51	0	0	51	0	0
4	1746229	rs2290011	G	T	20	33	53	0	0	53	0	0
4	1746844	rs8389	A	T	22	26	48	0	0	48	0	0
4	1983877	.	A	C	16	21	37	0	1	38	0	0
4	1986542	rs2234570	C	T	121	82	203	0	2	205	0	0
4	1986938	rs3135123	G	A	12	5	17	0	0	17	0	0
4	1986972	rs495367	A	G	3	9	12	0	0	12	0	0
4	1987022	rs554080281	C	G	3	10	13	0	0	13	0	0
4	1987297	rs560035969	C	T	9	5	14	0	0	14	0	0
4	1987349	rs547280610	C	T	2	5	7	0	0	7	0	0
4	2001597	rs11725126	C	T	8	6	14	0	0	14	0	0
4	2257813	rs144696509	C	G	161	149	310	0	1	311	0	0
4	2650606	rs61790230	G	A	16	19	35	0	0	35	0	0
4	2701799	.	C	T	79	73	152	0	1	153	0	0
4	2706540	.	A	C	2	8	10	0	0	10	0	0
4	2743999	rs232712	A	G	254	257	511	0	2	513	0	0
4	2744521	rs17831665	C	T	82	68	150	0	6	156	0	0
4	2746307	rs11728346	A	C	87	61	148	0	2	150	0	0
4	2748697	rs142931871	C	A	14	14	28	0	0	28	0	0
4	2749069	rs2295498	G	C	12	6	18	0	0	18	0	0
4	2750810	rs7690432	G	A	4	7	11	0	0	11	0	0
4	2800654	rs11722784	G	A	10	29	39	0	0	39	0	0
4	2801373	rs231340	T	G	3	3	6	0	0	6	0	0
4	2803156	rs13146103	C	G	3	3	6	0	0	6	0	0
4	2826400	rs3213501	T	C	95	94	189	0	1	190	0	0
4	2827646	rs9685721	T	C	5	2	7	0	0	7	0	0
4	2828139	rs62637887	A	G	2	4	6	0	0	6	0	0
4	2828225	rs111215831	C	T	5	1	6	0	1	7	0	0
4	2828630	rs62645794	G	T	6	1	7	0	0	7	0	0
4	2940358	rs12651499	G	A	24	20	44	0	0	44	0	0
4	3117579	rs17780797	T	C	3	4	7	0	0	7	0	0
4	3162056	rs363099	C	T	23	21	44	0	0	44	0	0
4	3182849	rs66684864	T	G	10	7	17	0	0	17	0	0
4	3185747	rs2298967	T	C	3	5	8	0	0	8	0	0
4	3190486	rs6844859	T	C	11	8	19	0	0	19	0	0
4	3207142	rs7685686	A	G	3	3	6	0	0	6	0	0
4	3213832	rs362336	G	A	19	22	41	0	0	41	0	0
4	3215835	rs362331	T	C	28	28	56	0	0	56	0	0
4	3218739	rs10011326	A	G	5	3	8	0	0	8	0	0
4	3227419	rs362273	A	G	34	29	63	0	0	63	0	0
4	3228492	rs2237006	A	G	8	4	12	0	0	12	0	0
4	3228966	.	T	G	5	9	14	0	1	15	0	0
4	3231148	rs111065364	G	C	2	5	7	0	0	7	0	0
4	3231804	rs147438853	A	G	5	3	8	0	0	8	0	0
4	3232257	rs3121419	C	T	4	6	10	0	1	11	0	0
4	3234828	rs2269478	G	T	5	3	8	0	0	8	0	0
4	3234980	rs362272	G	A	30	32	62	0	1	63	0	0
4	3235241	rs362314	A	G	3	6	9	0	0	9	0	0
4	3235450	rs2237007	T	C	8	2	10	0	0	10	0	0
4	3235518	rs362271	G	A	7	2	9	0	0	9	0	0
4	3236632	rs2530596	T	C	6	8	14	0	1	15	0	0
4	3238754	rs3775061	A	G	3	3	6	0	0	6	0	0
4	3240159	rs2071704	C	T	6	3	9	0	0	9	0	0
4	3241413	rs2071703	A	C	8	5	13	0	0	13	0	0
4	3242100	rs362306	G	A	68	50	118	0	0	118	0	0
4	3242148	rs362268	C	G	71	58	129	0	2	131	0	0
4	3243218	rs362267	C	T	8	9	17	0	0	17	0	0
4	3257797	rs61790518	C	T	1	6	7	0	0	7	0	0
4	3376807	.	C	T	9	10	19	0	0	19	0	0
4	3377061	.	C	T	5	2	7	0	2	9	0	0
4	3417845	rs3213507	G	C	11	14	25	0	0	25	0	0
4	3419677	rs762864	G	A	6	5	11	0	0	11	0	0
4	3419986	rs743714	A	G	4	4	8	0	0	8	0	0
4	3420371	rs3748036	C	T	3	5	8	0	0	8	0	0
4	3421489	rs139008676	A	C	5	2	7	0	0	7	0	0
4	3421851	rs148108096	G	A	8	2	10	0	0	10	0	0
4	3421992	.	T	C	9	4	13	0	0	13	0	0
4	3424231	rs16844330	C	T	29	15	44	0	0	44	0	0
4	3433782	rs1055711	T	A	11	9	20	0	0	20	0	0
4	3510598	rs3182	G	A	4	3	7	0	0	7	0	0
4	3510769	rs10001975	G	A	2	5	7	0	0	7	0	0
4	3510954	rs1730765	G	A	1	8	9	0	0	9	0	0
4	3510957	rs10002108	G	A	8	1	9	0	0	9	0	0
4	3512137	rs10014466	C	T	4	5	9	0	0	9	0	0
4	3512563	rs1794423	C	T	6	9	15	0	0	15	0	0
4	3514229	rs2077130	T	C	7	5	12	0	0	12	0	0
4	3518274	rs1800491	A	C	10	11	21	0	0	21	0	0
4	3518447	rs1730778	T	C	11	13	24	0	0	24	0	0
4	3518467	rs6832834	A	G	9	13	22	0	0	22	0	0
4	3518507	rs34327156	G	C	8	13	21	0	0	21	0	0
4	3519319	rs73197133	G	A	8	7	15	0	0	15	0	0
4	3526642	rs2228158	T	C	268	219	487	0	7	494	0	0
4	3527158	rs73197147	G	A	2	4	6	0	0	6	0	0
4	3527372	rs73197148	G	A	5	3	8	0	0	8	0	0
4	3527693	rs2237010	G	A	8	4	12	0	0	12	0	0
4	3528846	rs13125213	A	G	3	3	6	0	0	6	0	0
4	3529277	rs73197150	T	C	5	4	9	0	0	9	0	0
4	3529878	rs73197151	T	C	5	8	13	0	0	13	0	0
4	3529892	rs73197152	T	C	7	7	14	0	0	14	0	0
4	3530770	rs62272716	G	A	4	2	6	0	0	6	0	0
4	3532784	.	A	C	5	2	7	0	0	7	0	0
4	3533012	rs73197160	C	T	6	3	9	0	0	9	0	0
4	3770069	rs7434444	G	C	13	21	34	0	0	34	0	0
4	3944954	rs62289007	A	G	2	4	6	0	0	6	0	0
4	4302735	rs112068977	T	C	4	3	7	0	0	7	0	0
4	4304337	rs2916382	C	T	12	8	20	0	0	20	0	0
4	4306621	rs13110731	C	G	6	1	7	0	0	7	0	0
4	4421055	rs2044	T	C	10	14	24	0	0	24	0	0
4	5749904	rs4688963	T	C	7	0	7	0	0	7	0	0
4	5749961	rs4688962	G	C	6	1	7	0	0	7	0	0
4	5754579	rs28483498	C	T	6	1	7	0	0	7	0	0
4	6594947	rs2301796	A	C	39	40	79	0	0	79	0	0
4	6596360	rs2301795	G	A	46	48	94	0	0	94	0	0
4	6600012	rs2301790	A	G	25	36	61	0	0	61	0	0
4	6677394	rs10664	C	T	119	154	273	0	3	276	0	0
4	6718775	rs3172604	G	T	68	68	136	0	3	139	0	0
4	6850929	rs6833482	G	A	3	3	6	0	0	6	0	0
4	6860740	rs6814754	T	G	4	2	6	0	0	6	0	0
4	6883012	rs3733606	C	T	39	36	75	0	0	75	0	0
4	6969163	rs62289166	A	G	31	47	78	0	0	78	0	0
4	6969613	rs6831129	T	C	8	5	13	0	1	14	0	0
4	6969919	rs6831368	A	G	13	2	15	0	1	16	0	0
4	6970415	rs28404792	C	T	8	13	21	0	1	22	0	0
4	6988165	rs4234794	A	C	9	7	16	0	0	16	0	0
4	7005196	rs2359194	G	A	3	3	6	0	0	6	0	0
4	7005199	rs7695050	C	G	3	3	6	0	0	6	0	0
4	7005753	rs3857171	C	T	7	3	10	0	0	10	0	0
4	7011186	rs6446559	G	A	3	5	8	0	0	8	0	0
4	7017864	rs3894945	G	C	5	2	7	0	0	7	0	0
4	7022496	rs7673901	T	C	2	4	6	0	0	6	0	0
4	7027828	rs2359013	G	T	2	4	6	0	0	6	0	0
4	7032554	.	G	A	80	69	149	0	1	150	0	0
4	7032924	rs3756255	A	T	78	77	155	0	1	156	0	0
4	7034028	rs3188939	T	A	66	45	111	0	1	112	0	0
4	7057106	rs10937782	G	C	27	30	57	0	0	57	0	0
4	7058782	rs73202164	C	G	9	6	15	0	0	15	0	0
4	7059453	rs151338394	G	A	11	9	20	0	0	20	0	0
4	7067335	rs6814746	T	G	2	4	6	0	0	6	0	0
4	7069804	rs3822270	C	A	3	5	8	0	0	8	0	0
4	7743786	rs57984253	C	G	5	5	10	0	0	10	0	0
4	7744046	rs12642285	G	A	6	4	10	0	0	10	0	0
4	7744327	rs2234765	C	A	3	9	12	0	0	12	0	0
4	8201805	rs753959	C	A	8	1	9	0	0	9	0	0
4	8202181	rs146209829	G	A	8	5	13	0	0	13	0	0
4	8202698	rs1281122	G	A	5	2	7	0	0	7	0	0
4	8204854	rs7677412	G	A	6	4	10	0	0	10	0	0
4	8205136	rs56215353	C	T	3	3	6	0	0	6	0	0
4	8206468	rs1983342	T	A	5	2	7	0	1	8	0	0
4	8206481	rs1678269	C	T	2	5	7	0	0	7	0	0
4	8207154	rs1298878	C	T	2	4	6	0	0	6	0	0
4	8207676	rs1281130	G	A	5	5	10	0	0	10	0	0
4	8207810	rs922521	C	T	8	14	22	0	0	22	0	0
4	8208789	rs1281131	T	C	6	5	11	0	0	11	0	0
4	8212524	rs13152394	T	C	4	5	9	0	0	9	0	0
4	8219482	rs78909221	A	G	9	10	19	0	0	19	0	0
4	8228434	rs3796758	A	G	3	5	8	0	0	8	0	0
4	8228948	rs55642964	T	C	59	63	122	0	2	124	0	0
4	8230893	rs11728188	C	T	9	7	16	0	0	16	0	0
4	8230945	rs11729860	A	G	5	7	12	0	0	12	0	0
4	8231522	rs55993013	A	T	5	7	12	0	0	12	0	0
4	8231625	rs6842156	A	G	9	4	13	0	1	14	0	0
4	8231689	rs57641266	C	T	5	7	12	0	0	12	0	0
4	8231744	.	G	A	2	6	8	0	0	8	0	0
4	8231755	rs13151257	C	T	2	6	8	0	0	8	0	0
4	8232631	rs1281095	T	C	7	1	8	0	0	8	0	0
4	8232966	rs11732186	A	G	8	5	13	0	0	13	0	0
4	8233264	rs3756194	C	T	11	7	18	0	0	18	0	0
4	8233341	rs3756193	T	C	12	8	20	0	0	20	0	0
4	8233480	rs3756192	C	T	7	7	14	0	0	14	0	0
4	8234381	rs3775905	T	C	101	90	191	0	2	194	1	0
4	8234904	rs1281093	G	A	143	136	279	0	0	279	0	0
4	8234929	rs2291072	A	C	153	142	295	0	1	296	0	0
4	8238151	rs11603	C	T	115	169	284	0	2	286	0	0
4	8238649	rs1281107	G	A	27	25	52	0	0	52	0	0
4	8238667	rs1281106	C	G	22	26	48	0	0	48	0	0
4	8241107	rs1281104	G	A	4	7	11	0	0	11	0	0
4	8241570	rs12510612	C	A	9	4	13	0	0	13	0	0
4	8242740	rs8153	G	C	300	192	492	0	1	493	0	0
4	8272827	rs13120925	G	C	3	5	8	0	0	8	0	0
4	8274162	rs7655419	G	C	3	3	6	0	0	6	0	0
4	8276107	rs11736323	G	C	4	5	9	0	0	9	0	0
4	8276349	rs6845319	C	T	6	10	16	0	0	16	0	0
4	8276411	rs4077992	A	C	4	6	10	0	0	10	0	0
4	8276911	rs34276401	C	T	4	4	8	0	0	8	0	0
4	8277142	rs7667968	A	G	4	3	7	0	0	7	0	0
4	8278125	rs62286489	G	A	5	3	8	0	0	8	0	0
4	8278804	rs55771022	C	T	9	3	12	0	0	12	0	0
4	8278926	rs55858728	C	T	7	3	10	0	0	10	0	0
4	8278968	rs56357949	G	A	3	5	8	0	0	8	0	0
4	8279503	rs11733786	G	A	4	5	9	0	0	9	0	0
4	8279510	rs11733787	G	A	3	6	9	0	0	9	0	0
4	8280040	rs12639755	C	T	4	7	11	0	0	11	0	0
4	8280331	rs5018092	C	T	2	5	7	0	0	7	0	0
4	8282174	rs7340939	C	T	3	6	9	0	0	9	0	0
4	8282307	rs7340942	C	T	5	4	9	0	0	9	0	0
4	8283178	rs11721861	G	A	6	4	10	0	0	10	0	0
4	8283245	rs11726756	A	C	7	8	15	0	1	16	0	0
4	8283322	rs11721894	G	C	5	8	13	0	0	13	0	0
4	8283422	rs112962788	G	A	3	4	7	0	0	7	0	0
4	8283630	rs10938705	C	T	10	4	14	0	0	14	0	0
4	8284084	rs4696789	T	C	6	2	8	0	0	8	0	0
4	8359839	rs6832655	T	C	10	5	15	0	0	15	0	0
4	8375342	rs2280571	G	A	9	9	18	0	1	19	0	0
4	8454639	rs1880024	A	G	16	19	35	0	0	35	0	0
4	8471202	.	G	A	9	7	16	0	0	16	0	0
4	8472629	rs10938714	C	T	5	4	9	0	0	9	0	0
4	8473050	rs2631768	G	A	4	3	7	0	0	7	0	0
4	8475623	rs2010758	G	A	5	6	11	0	0	11	0	0
4	8476118	rs2631735	A	G	6	2	8	0	0	8	0	0
4	8481259	rs871363	T	C	3	3	6	0	0	6	0	0
4	9909923	rs2280205	G	A	8	0	8	0	0	8	0	0
4	10022981	rs2276961	C	T	5	2	7	0	0	7	0	0
4	10076658	rs9732	T	C	272	325	597	0	8	605	0	0
4	10076860	rs9926	G	A	259	318	577	0	8	585	0	0
4	10078756	rs73212828	C	T	4	14	18	0	0	18	0	0
4	10078759	rs73212830	A	T	5	14	19	0	0	19	0	0
4	10081052	rs56146302	C	T	5	12	17	0	0	17	0	0
4	10081117	rs55848383	C	A	5	14	19	0	0	19	0	0
4	10081201	rs7685806	G	A	5	8	13	0	0	13	0	0
4	10082156	rs10516200	C	A	3	6	9	0	0	9	0	0
4	10082688	rs114005604	G	C	5	7	12	0	0	12	0	0
4	10082772	rs12503195	T	C	4	4	8	0	0	8	0	0
4	10083829	rs3756230	C	G	1	15	16	0	0	16	0	0
4	10084570	rs2241470	T	G	6	11	17	0	0	17	0	0
4	10085902	rs2241472	C	G	4	11	15	0	0	15	0	0
4	10085949	rs2241473	G	A	2	6	8	0	0	8	0	0
4	10086015	rs2241474	T	C	2	4	6	0	0	6	0	0
4	10086188	rs2241475	T	G	12	12	24	0	0	24	0	0
4	10086473	rs56402960	T	A	21	8	29	0	0	29	0	0
4	10086547	rs2241476	A	C	5	26	31	0	0	31	0	0
4	10086670	rs2241477	C	T	8	24	32	0	0	32	0	0
4	10086795	rs3822249	G	C	9	14	23	0	2	25	0	0
4	10087458	rs73212840	C	T	19	11	30	0	1	31	0	0
4	10087685	rs12500400	C	T	4	12	16	0	0	16	0	0
4	10087915	rs3756229	G	A	11	13	24	0	1	25	0	0
4	10087995	rs3756227	C	A	6	12	18	0	0	18	0	0
4	10088260	rs3822248	A	G	6	12	18	0	0	18	0	0
4	10088893	rs2241478	T	C	3	19	22	0	0	22	0	0
4	10089763	rs2241480	C	T	11	14	25	0	0	25	0	0
4	10089865	rs734122	G	A	10	15	25	0	0	25	0	0
4	10090763	rs12500653	G	C	16	41	57	0	0	57	0	0
4	10091098	rs3775930	A	G	17	33	50	0	2	52	0	0
4	10091454	rs12646099	T	G	24	50	74	0	1	75	0	0
4	10092728	rs3796826	G	A	15	31	46	0	1	47	0	0
4	10092879	rs3796825	T	A	21	32	53	0	0	53	0	0
4	10093299	rs73212848	T	C	32	13	45	0	0	45	0	0
4	10094133	rs3756225	G	C	39	23	62	0	0	62	0	0
4	10094671	rs3822247	G	A	10	9	19	0	0	19	0	0
4	10094698	rs3822246	G	A	11	16	27	0	0	27	0	0
4	10094904	rs3822242	T	C	28	7	35	0	0	35	0	0
4	10094931	rs3822241	G	A	24	7	31	0	0	31	0	0
4	10096020	rs11727087	C	T	22	17	39	0	0	39	0	0
4	10096134	rs2278121	G	A	11	10	21	0	0	21	0	0
4	10096230	rs73212853	C	T	11	19	30	0	2	32	0	0
4	10096241	rs2278122	T	A	21	12	33	0	1	34	0	0
4	10096692	rs10939702	G	T	11	21	32	0	0	32	0	0
4	10096772	rs2278123	C	G	33	11	44	0	0	44	0	0
4	10097745	rs735527	A	G	5	15	20	0	0	20	0	0
4	10097976	rs3796818	C	T	16	23	39	0	0	39	0	0
4	10098192	rs11726271	G	A	29	14	43	0	0	43	0	0
4	10099277	rs41268389	G	A	10	30	40	0	1	41	0	0
4	10099674	rs62288520	G	A	11	5	16	0	0	16	0	0
4	10099772	rs62288521	G	A	4	6	10	0	0	10	0	0
4	10099831	rs2241483	A	G	6	2	8	0	0	8	0	0
4	10100341	rs55941493	G	A	6	5	11	0	0	11	0	0
4	10101083	rs2241486	C	G	15	30	45	0	1	46	0	0
4	10101131	rs2241488	T	C	16	40	56	0	1	57	0	0
4	10101443	rs6830786	C	T	13	33	46	0	1	47	0	0
4	10102593	rs16868326	T	A	8	22	30	0	1	31	0	0
4	10102736	rs56079809	C	A	31	17	48	0	0	48	0	0
4	10104103	rs34893238	C	G	17	30	47	0	0	47	0	0
4	10104173	rs73212863	C	T	12	30	42	0	0	42	0	0
4	10104191	rs73212864	G	A	14	31	45	0	0	45	0	0
4	10104571	rs12648479	G	A	27	14	41	0	0	41	0	0
4	10104670	rs717615	A	G	14	11	25	0	0	25	0	0
4	10105797	rs3756223	T	C	6	5	11	0	0	11	0	0
4	10107069	rs12509713	C	T	8	3	11	0	0	11	0	0
4	10108127	rs4697705	G	A	8	4	12	0	0	12	0	0
4	10111798	rs73212870	C	G	4	3	7	0	0	7	0	0
4	10112602	rs4459989	C	T	9	5	14	0	0	14	0	0
4	10114500	rs62288546	T	C	7	5	12	0	0	12	0	0
4	10115363	rs4348091	T	C	5	4	9	0	0	9	0	0
4	10115531	rs62288547	T	C	4	5	9	0	0	9	0	0
4	10115692	rs73212880	T	A	2	6	8	0	0	8	0	0
4	10115703	rs57757169	G	A	6	1	7	0	0	7	0	0
4	10118377	rs11557743	C	G	24	15	39	0	0	39	0	0
4	10442700	rs57723486	C	T	22	9	31	0	0	31	0	0
4	10443384	rs4422413	T	G	4	7	11	0	0	11	0	0
4	10444650	rs3217	C	T	36	48	84	0	0	84	0	0
4	10454994	rs12019277	C	A	15	14	29	0	2	31	0	0
4	10455656	rs13140527	T	C	6	8	14	0	0	14	0	0
4	10458969	rs4077362	C	T	19	17	36	0	0	36	0	0
4	13596303	rs34940579	G	A	4	3	7	0	0	7	0	0
4	13601337	rs3733557	G	A	30	23	53	0	0	53	0	0
4	15632484	rs11934401	C	T	7	7	14	0	0	14	0	0
4	15633111	rs77743450	G	A	30	20	50	0	0	50	0	0
4	15636049	rs111954606	G	A	4	4	8	0	0	8	0	0
4	15709252	rs2302464	G	A	103	96	199	0	4	203	0	0
4	15713446	rs2302463	C	T	123	125	248	0	0	248	0	0
4	15730151	rs12644354	T	C	2	7	9	0	0	9	0	0
4	15730253	rs12640596	C	T	3	5	8	0	0	8	0	0
4	15730405	rs111541714	C	A	1	6	7	0	0	7	0	0
4	15730513	rs73125993	T	C	2	6	8	0	0	8	0	0
4	15730861	rs9790535	A	G	1	5	6	0	0	6	0	0
4	15733454	rs1058212	A	C	100	116	216	0	0	216	0	0
4	15735440	rs4342183	C	T	3	3	6	0	0	6	0	0
4	15739416	rs3900588	G	C	0	7	7	0	0	7	0	0
4	15739428	rs4320134	A	T	0	6	6	0	0	6	0	0
4	15739498	rs997250	A	G	2	4	6	0	0	6	0	0
4	15739826	rs73801704	G	C	5	2	7	0	0	7	0	0
4	15835844	rs1800051	A	C	37	33	70	0	0	70	0	0
4	15851968	rs13137313	G	A	27	14	41	0	0	41	0	0
4	15961948	rs367616842	T	C	7	10	17	0	0	17	0	0
4	15964485	rs758329	G	A	28	18	46	0	0	46	0	0
4	15964501	rs2286459	G	A	22	27	49	0	0	49	0	0
4	15964763	rs4698432	C	T	14	12	26	0	0	26	0	0
4	15969938	rs3130	T	C	72	53	125	0	0	125	0	0
4	15972905	rs11735976	T	C	1	6	7	0	0	7	0	0
4	15973974	rs4698130	A	G	5	6	11	0	0	11	0	0
4	15979621	rs7690707	A	G	8	6	14	0	0	14	0	0
4	16076892	rs11733197	A	G	14	8	22	0	0	22	0	0
4	16079666	rs142275445	C	A	5	2	7	0	0	7	0	0
4	16163265	rs317854	C	G	59	43	102	0	1	103	0	0
4	16163486	rs10516299	C	T	90	47	137	0	1	138	0	0
4	16164230	rs10516298	T	C	31	17	48	0	0	48	0	0
4	16166404	rs10516297	C	T	7	13	20	0	0	20	0	0
4	16166643	rs16893138	C	T	17	6	23	0	0	23	0	0
4	16167685	rs56218994	C	T	15	13	28	0	0	28	0	0
4	16168512	rs11724423	C	A	31	19	50	0	0	50	0	0
4	16168581	rs10939651	T	C	25	11	36	0	0	36	0	0
4	16168664	rs4395495	C	T	9	1	10	0	0	10	0	0
4	16168707	rs111676522	T	A	8	3	11	0	0	11	0	0
4	16169021	rs1662650	T	A	15	8	23	0	0	23	0	0
4	16169565	rs1619904	A	G	5	3	8	0	0	8	0	0
4	16169678	rs11731602	T	G	9	6	15	0	1	16	0	0
4	16170144	rs12646600	A	G	19	13	32	0	0	32	0	0
4	16170164	rs12643544	C	T	18	15	33	0	0	33	0	0
4	16170210	rs11730922	A	C	16	22	38	0	1	39	0	0
4	16170492	rs1662652	C	A	34	22	56	0	1	57	0	0
4	16172181	rs1662654	C	T	20	10	30	0	1	31	0	0
4	16174118	rs11736424	T	A	7	1	8	0	0	8	0	0
4	16174408	rs1662656	C	G	16	8	24	0	0	24	0	0
4	16176635	rs317878	A	G	11	8	19	0	0	19	0	0
4	16177517	rs16893143	A	G	35	30	65	0	0	65	0	0
4	16178386	rs317877	T	C	13	20	33	0	0	33	0	0
4	16179741	rs16893144	C	A	7	6	13	0	0	13	0	0
4	16181570	rs178450	T	C	3	5	8	0	0	8	0	0
4	16181581	rs16893147	G	C	2	4	6	0	0	6	0	0
4	16182490	rs317875	A	G	7	4	11	0	1	12	0	0
4	16184860	rs73128457	T	C	13	12	25	0	0	25	0	0
4	16186347	rs317872	C	T	11	7	18	0	0	18	0	0
4	16186990	rs317871	G	A	5	3	8	0	0	8	0	0
4	16187016	rs113195683	C	T	5	5	10	0	0	10	0	0
4	16190325	rs12513244	C	T	4	3	7	0	0	7	0	0
4	16214005	rs13120908	A	G	3	3	6	0	0	6	0	0
4	16216051	rs35475888	C	G	10	3	13	0	0	13	0	0
4	16216616	rs35851218	T	C	1	6	7	0	0	7	0	0
4	16216945	rs4698457	C	A	7	2	9	0	0	9	0	0
4	16217627	rs56023844	T	C	1	10	11	0	0	11	0	0
4	16218142	rs9995025	A	C	19	2	21	0	0	21	0	0
4	16218496	rs13136172	G	A	13	5	18	0	0	18	0	0
4	16218758	rs2028631	C	T	6	0	6	0	0	6	0	0
4	16219216	rs56353092	G	A	5	2	7	0	1	8	0	0
4	16222827	rs6810390	T	A	6	1	7	0	0	7	0	0
4	16225211	rs4235382	G	T	10	2	12	0	0	12	0	0
4	17624662	rs373436798	C	T	4	2	6	0	0	6	0	0
4	17630789	rs139440466	G	A	13	14	27	0	0	27	0	0
4	17803618	rs13116464	C	T	17	12	29	0	0	29	0	0
4	17803621	.	G	A	21	11	32	0	0	32	0	0
4	17804286	.	T	G	15	15	30	0	4	36	2	0
4	17804717	rs111465602	A	G	22	17	39	0	1	40	0	0
4	17809265	rs13119311	G	T	9	11	20	0	0	20	0	0
4	17809538	rs2286540	A	G	12	15	27	0	0	27	0	0
4	17809956	.	T	G	8	6	14	0	0	14	0	0
4	17810255	rs2286539	G	A	7	9	16	0	0	16	0	0
4	17811415	rs16895788	C	T	38	43	81	0	0	81	0	0
4	17811654	rs78212195	T	G	26	22	48	0	0	48	0	0
4	17818885	rs2302212	T	C	3	3	6	0	0	6	0	0
4	17829990	rs3795243	G	C	4	3	7	0	0	7	0	0
4	17845238	rs7688403	G	C	3	3	6	0	0	6	0	0
4	17910840	rs61731457	T	C	13	11	24	0	0	24	0	0
4	17933639	rs35654348	C	T	5	1	6	0	0	6	0	0
4	17939302	rs34683079	T	C	4	2	6	0	0	6	0	0
4	17939331	rs6840868	C	T	5	1	6	0	0	6	0	0
4	17939921	rs12511600	C	T	2	4	6	0	0	6	0	0
4	20702164	rs76783569	G	T	10	5	15	0	0	15	0	0
4	22439914	rs6823735	A	C	9	9	18	0	0	18	0	0
4	24521431	rs6448278	C	T	5	3	8	0	0	8	0	0
4	24524724	rs7695358	G	C	4	2	6	0	0	6	0	0
4	24537920	rs11729408	A	C	12	20	32	0	1	33	0	0
4	24538573	rs4697063	A	G	22	16	38	0	0	38	0	0
4	24548678	rs7690565	G	T	17	9	26	0	0	26	0	0
4	24836619	rs16876194	C	T	4	2	6	0	0	6	0	0
4	25124746	rs13109061	T	C	4	4	8	0	0	8	0	0
4	25148136	rs3796795	G	T	2	5	7	0	0	7	0	0
4	25154016	.	A	G	4	2	6	0	0	6	0	0
4	25156483	rs3733548	A	G	4	8	12	0	0	12	0	0
4	25393889	rs2292407	C	T	1	5	6	0	0	6	0	0
4	25415810	rs55714412	C	A	1	5	6	0	0	6	0	0
4	25749303	rs7701	C	A	21	15	36	0	0	36	0	0
4	25915858	rs2305670	C	A	6	7	13	0	0	13	0	0
4	26585881	rs4692549	C	T	2	4	6	0	0	6	0	0
4	36014269	rs16991853	G	A	4	3	7	0	0	7	0	0
4	36068286	rs2271810	A	G	47	36	83	0	0	83	0	0
4	36068571	rs12645801	A	T	30	41	71	0	0	71	0	0
4	36069805	rs7657166	G	A	71	59	130	0	1	131	0	0
4	36189157	rs116105213	T	C	67	59	126	0	0	126	0	0
4	37628170	rs11096893	G	C	9	2	11	0	0	11	0	0
4	37631874	rs2174657	A	C	4	4	8	0	0	8	0	0
4	37638035	rs6824145	A	G	4	6	10	0	0	10	0	0
4	37639139	rs11733542	C	T	13	11	24	0	1	25	0	0
4	37643594	rs35777265	G	A	6	0	6	0	0	6	0	0
4	37643695	rs11737302	A	G	4	3	7	0	0	7	0	0
4	37646284	rs55872624	G	A	4	3	7	0	0	7	0	0
4	37647170	rs13126479	T	C	4	2	6	0	0	6	0	0
4	37648055	rs59689303	G	C	5	9	14	0	0	14	0	0
4	37648078	rs61699166	G	T	6	7	13	0	0	13	0	0
4	37648414	rs3849015	A	C	6	3	9	0	0	9	0	0
4	37648845	rs3849018	G	A	10	7	17	0	0	17	0	0
4	37666991	rs6837020	T	G	5	1	6	0	0	6	0	0
4	37671183	rs28521121	G	A	4	2	6	0	0	6	0	0
4	37672401	rs186758374	G	A	7	5	12	0	0	12	0	0
4	37849296	rs3775791	G	A	3	8	11	0	2	13	0	0
4	37903756	rs2279027	T	C	9	9	18	0	0	18	0	0
4	37906032	rs2995919	C	T	5	3	8	0	0	8	0	0
4	37908103	rs34871767	G	A	4	2	6	0	0	6	0	0
4	37981493	rs4832746	T	C	1	5	6	0	0	6	0	0
4	37985088	rs62298546	G	A	3	4	7	0	0	7	0	0
4	37985461	rs12645638	A	G	2	6	8	0	0	8	0	0
4	37986825	rs62298548	C	T	3	3	6	0	0	6	0	0
4	37987456	rs62298549	C	G	1	7	8	0	0	8	0	0
4	37987797	rs62298550	C	T	5	4	9	0	0	9	0	0
4	38016372	rs61731587	G	A	18	19	37	0	0	37	0	0
4	38016395	rs10501	T	G	35	45	80	0	0	80	0	0
4	38017999	rs57940528	G	A	8	3	11	0	0	11	0	0
4	38019813	rs6833071	G	C	4	5	9	0	0	9	0	0
4	38058826	rs2052694	T	C	3	4	7	0	0	7	0	0
4	38059025	rs6531605	T	C	3	6	9	0	0	9	0	0
4	38085014	rs35491817	C	T	3	3	6	0	0	6	0	0
4	38109847	rs1344603	T	C	5	2	7	0	0	7	0	0
4	38110442	rs12509214	G	A	4	3	7	0	0	7	0	0
4	38110477	rs12506500	T	A	5	4	9	0	0	9	0	0
4	38626282	rs6531654	T	C	7	3	10	0	0	10	0	0
4	38626841	rs34075114	G	C	5	3	8	0	0	8	0	0
4	38664715	rs1056583	A	C	10	21	31	0	0	31	0	0
4	38666972	rs9522	C	T	48	52	100	0	0	100	0	0
4	38684193	rs77296810	C	T	4	3	7	0	0	7	0	0
4	38684201	rs6531656	C	T	4	3	7	0	0	7	0	0
4	38687921	rs111340188	G	A	6	7	13	0	0	13	0	0
4	38688362	rs16994718	C	T	13	11	24	0	0	24	0	0
4	38688919	rs4833085	G	A	8	4	12	0	0	12	0	0
4	38689190	rs4240247	C	T	6	17	23	0	0	23	0	0
4	38689923	rs729064	T	C	3	3	6	0	0	6	0	0
4	38692806	rs3796533	G	A	72	82	154	0	2	156	0	0
4	38699853	.	T	C	76	72	148	0	1	149	0	0
4	38702437	rs7147	A	G	5	12	17	0	0	17	0	0
4	38792524	rs4543123	A	G	2	4	6	0	0	6	0	0
4	38795306	rs4286521	G	A	3	3	6	0	0	6	0	0
4	38795810	rs3924112	C	T	5	2	7	0	0	7	0	0
4	38798648	rs5743618	C	A	47	15	62	0	0	62	0	0
4	38798935	rs5743614	C	T	35	20	55	0	0	55	0	0
4	38799710	rs4833095	T	C	35	16	51	0	0	51	0	0
4	38802528	rs5743596	G	A	14	4	18	0	1	19	0	0
4	38805942	rs5743566	G	C	11	1	12	0	0	12	0	0
4	38805983	rs5743565	T	C	10	0	10	0	0	10	0	0
4	38827520	rs5743828	C	T	6	5	11	0	0	11	0	0
4	38827525	rs5743827	C	T	6	5	11	0	0	11	0	0
4	38829163	rs5743818	A	C	5	5	10	0	0	10	0	0
4	38829832	rs3775073	T	C	10	5	15	0	0	15	0	0
4	38830012	rs3821985	G	C	12	1	13	0	0	13	0	0
4	38846524	rs59770038	A	C	4	2	6	0	0	6	0	0
4	38879949	rs11096964	G	A	5	1	6	0	0	6	0	0
4	39030183	rs2254075	A	G	29	98	127	0	0	127	0	0
4	39088980	rs1469531	A	C	6	8	14	0	0	14	0	0
4	39116911	rs3733276	T	C	23	26	49	0	1	50	0	0
4	39117780	rs2890662	A	G	3	3	6	0	0	6	0	0
4	39121990	rs7677729	C	T	4	2	6	0	0	6	0	0
4	39122206	rs3796511	G	A	5	4	9	0	0	9	0	0
4	39122697	rs3733275	C	T	9	8	17	0	0	17	0	0
4	39122913	rs13182	T	A	14	21	35	0	0	35	0	0
4	39124750	rs1061377	C	A	9	3	12	0	0	12	0	0
4	39124873	rs1982009	C	T	11	6	17	0	0	17	0	0
4	39124935	rs1138494	C	T	5	5	10	0	0	10	0	0
4	39126016	rs13109200	A	G	6	8	14	0	0	14	0	0
4	39127021	rs2890659	T	C	16	15	31	0	0	31	0	0
4	39456392	rs1463478	G	A	3	3	6	0	0	6	0	0
4	39456922	rs1965260	G	C	47	38	85	0	1	86	0	0
4	39457153	rs2687955	C	T	43	26	69	0	0	69	0	0
4	39457430	rs2687956	T	C	32	34	66	0	1	67	0	0
4	39458051	rs2125313	A	G	10637	261	10898	0	15	10913	0	0
4	39458765	rs1012352	G	T	21	15	36	0	0	36	0	0
4	39459031	rs2687957	T	C	20	14	34	0	0	34	0	0
4	39459154	rs2608830	G	A	28	16	44	0	0	44	0	0
4	39459724	rs2687958	T	C	10	12	22	0	0	22	0	0
4	39459969	.	G	C	11	14	25	0	0	25	0	0
4	39466779	rs35086467	A	G	7	8	15	0	1	16	0	0
4	39478832	rs1048140	G	A	17	8	25	0	1	26	0	0
4	39501549	rs58958665	C	T	5	1	6	0	0	6	0	0
4	39703194	rs9683743	T	G	6	4	10	0	0	10	0	0
4	39719373	rs10856850	G	A	7	6	13	0	0	13	0	0
4	39762066	rs411556	C	T	6	0	6	0	0	6	0	0
4	39769143	rs28628754	C	T	4	2	6	0	0	6	0	0
4	39769260	rs7687557	A	C	4	4	8	0	0	8	0	0
4	39774422	rs62310129	C	T	4	2	6	0	0	6	0	0
4	39783729	rs305112	C	T	39	26	65	0	0	65	0	0
4	39852229	rs13135087	T	C	7	0	7	0	0	7	0	0
4	39852372	rs34679344	A	G	5	2	7	0	0	7	0	0
4	39906401	rs62307943	A	C	4	5	9	0	0	9	0	0
4	39928093	rs10013955	A	G	1	6	7	0	0	7	0	0
4	40100853	rs73229748	G	A	17	13	30	0	0	30	0	0
4	40103767	rs17511668	G	T	12	10	22	0	0	22	0	0
4	40119501	rs1128372	T	C	16	20	36	0	1	37	0	0
4	40122453	rs78417585	C	T	14	21	35	0	0	35	0	0
4	40156881	rs13130198	G	A	6	7	13	0	0	13	0	0
4	40158167	rs78152193	A	G	3	5	8	0	1	9	0	0
4	40198846	rs2245466	G	C	445	378	823	0	45	868	0	0
4	40426677	rs278982	G	A	39	16	55	0	0	55	0	0
4	40427990	rs2292039	G	C	22	14	36	0	0	36	0	0
4	40546500	rs425786	T	C	6	2	8	0	0	8	0	0
4	40753522	rs2437333	G	A	15	18	33	0	0	33	0	0
4	40753771	rs6821089	G	A	22	25	47	0	0	47	0	0
4	40754149	rs80152035	A	G	17	25	42	0	0	42	0	0
4	40754502	rs146543760	A	G	19	14	33	0	0	33	0	0
4	40754625	rs137996800	G	A	25	17	42	0	1	43	0	0
4	40755704	.	A	C	5	11	16	0	0	16	0	0
4	40810663	rs4861066	A	G	3	3	6	0	0	6	0	0
4	41259633	rs5030732	C	A	8	4	12	0	0	12	0	0
4	41453926	rs181388497	C	G	5	2	7	0	1	8	0	0
4	42410946	rs11940243	C	T	11	10	21	0	2	23	0	0
4	42411457	rs1141790	T	C	21	27	48	0	3	51	0	0
4	42412409	rs35631273	C	T	21	15	36	0	0	36	0	0
4	42412687	rs12639920	T	G	71	54	125	0	2	127	0	0
4	42453303	rs13139219	A	C	4	3	7	0	0	7	0	0
4	42457545	rs61735691	G	A	20	31	51	0	1	52	0	0
4	42490680	rs9291218	A	C	3	3	6	0	0	6	0	0
4	42629038	rs16854624	C	T	19	24	43	0	1	44	0	0
4	44682465	rs6447368	T	C	9	5	14	0	0	14	0	0
4	44701446	rs6811584	A	G	2	19	21	0	0	21	0	0
4	44701750	rs6812211	A	C	6	7	13	0	0	13	0	0
4	44701764	rs6817397	T	G	9	6	15	0	0	15	0	0
4	44705595	rs1133648	G	A	8	9	17	0	0	17	0	0
4	44705601	rs1133650	T	C	9	8	17	0	0	17	0	0
4	44707773	.	C	A	5	7	12	0	0	12	0	0
4	44707815	rs10020551	G	T	4	7	11	0	0	11	0	0
4	44708086	rs62305383	G	C	2	4	6	0	0	6	0	0
4	44708093	rs10213518	C	G	4	2	6	0	0	6	0	0
4	47488480	rs11945442	G	C	2	9	11	0	0	11	0	0
4	47514685	rs33995001	C	T	16	17	33	0	0	33	0	0
4	47515994	rs6827906	G	A	1	9	10	0	0	10	0	0
4	47557900	rs9291307	T	A	4	3	7	0	0	7	0	0
4	47589203	rs1316874	G	A	14	9	23	0	0	23	0	0
4	47593283	rs4145944	G	C	7	14	21	0	0	21	0	0
4	47593532	rs12641970	G	A	18	7	25	0	0	25	0	0
4	47593976	rs11947521	A	G	3	9	12	0	0	12	0	0
4	47594220	rs3811829	G	A	5	19	24	0	0	24	0	0
4	47901476	rs12651301	G	A	7	6	13	0	0	13	0	0
4	48343550	rs375259	C	T	5	1	6	0	0	6	0	0
4	48344930	rs392187	A	G	1	5	6	0	0	6	0	0
4	48360552	rs10026398	C	T	5	1	6	0	0	6	0	0
4	48522978	.	A	C	8	9	17	0	0	17	0	0
4	48543007	rs76637950	A	G	1	5	6	0	0	6	0	0
4	48582909	rs4695391	G	A	18	15	33	0	0	33	0	0
4	48588742	rs34558821	C	T	21	18	39	0	0	39	0	0
4	48765175	rs7657698	G	A	6	3	9	0	1	10	0	0
4	48781104	rs75396886	T	C	2	4	6	0	0	6	0	0
4	48834896	rs4694906	C	G	3	3	6	0	0	6	0	0
4	48851937	rs3761729	C	T	10	8	18	0	0	18	0	0
4	48854139	rs2572345	T	C	17	16	33	0	0	33	0	0
4	48855217	rs2712159	A	C	5	9	14	0	0	14	0	0
4	48857387	rs2712158	A	G	6	5	11	0	0	11	0	0
4	48857743	rs9637562	C	T	17	16	33	0	0	33	0	0
4	48859795	rs115033487	G	C	7	10	17	0	1	18	0	0
4	48859940	rs2883562	C	G	11	7	18	0	0	18	0	0
4	48860817	rs12512637	A	G	7	5	12	0	0	12	0	0
4	52780048	rs13531	G	C	3	5	8	0	0	8	0	0
4	53739856	rs1047959	C	G	7	8	15	0	0	15	0	0
4	54011308	rs7697820	C	T	6	5	11	0	0	11	0	0
4	54011424	rs4864727	C	T	7	5	12	0	0	12	0	0
4	54011526	rs7675987	A	G	21	12	33	0	0	33	0	0
4	54264155	rs73250962	G	A	4	6	10	0	0	10	0	0
4	54273749	.	G	A	4	3	7	0	0	7	0	0
4	54296124	rs73250964	C	T	3	3	6	0	0	6	0	0
4	54914711	rs73252926	C	T	26	26	52	0	1	53	0	0
4	55593464	rs3822214	A	C	50	10	60	0	0	60	0	0
4	55599429	rs62304360	C	T	3	7	10	0	0	10	0	0
4	55599436	rs1008658	T	C	6	1	7	0	0	7	0	0
4	55599998	rs2237012	A	G	2	4	6	0	0	6	0	0
4	55602765	rs3733542	G	C	75	27	102	0	0	102	0	0
4	55604940	rs17084733	G	A	99	24	123	0	0	123	0	0
4	55606427	rs8022	G	T	129	42	171	0	0	171	0	0
4	56236579	rs13149568	C	T	3	7	10	0	2	12	0	0
4	56264753	rs4549456	C	G	12	15	27	0	1	28	0	0
4	56264941	rs1011095	C	G	13	12	25	0	0	25	0	0
4	56266724	rs13113860	C	T	11	11	22	0	0	22	0	0
4	56266882	rs11727586	A	C	4	13	17	0	0	17	0	0
4	56298194	rs6832769	G	A	1	5	6	0	0	6	0	0
4	56298414	rs6834676	C	G	4	2	6	0	0	6	0	0
4	56309992	rs3736544	A	G	3	7	10	0	1	11	0	0
4	56318462	rs6849474	G	A	5	1	6	0	0	6	0	0
4	56318772	rs2412646	T	C	3	3	6	0	0	6	0	0
4	56756531	rs2290016	T	C	16	10	26	0	0	26	0	0
4	56761931	rs73238392	C	T	8	2	10	0	0	10	0	0
4	56762101	rs17086129	C	T	3	3	6	0	1	7	0	0
4	56771089	rs11658	G	A	17	8	25	0	0	25	0	0
4	57314612	rs138933625	C	G	71	87	158	0	1	159	0	0
4	57360597	rs62309300	G	A	5	2	7	0	0	7	0	0
4	57372077	rs6841856	G	A	14	9	23	0	0	23	0	0
4	57799604	.	A	T	110	99	209	0	0	209	0	0
4	57801922	rs1043215	G	A	7	10	17	0	0	17	0	0
4	68480019	rs114477148	T	C	2	4	6	0	0	6	0	0
4	68482401	rs28526365	T	C	7	2	9	0	0	9	0	0
4	68482405	rs28735406	G	C	5	2	7	0	0	7	0	0
4	68483412	rs114812738	T	C	20	15	35	0	1	36	0	0
4	68483472	rs1048447	A	G	16	28	44	0	0	44	0	0
4	68483491	rs13348	T	G	20	27	47	0	0	47	0	0
4	68483763	rs3188451	C	A	11	5	16	0	2	18	0	0
4	68485590	rs10866199	C	A	9	7	16	0	0	16	0	0
4	68487152	rs114174730	T	C	6	8	14	0	0	14	0	0
4	68487298	rs114299213	A	G	6	4	10	0	0	10	0	0
4	68487710	rs115348527	G	A	8	13	21	0	0	21	0	0
4	68487817	rs114279116	C	T	6	16	22	0	0	22	0	0
4	68489649	rs7684656	C	T	9	8	17	0	0	17	0	0
4	68500171	rs10008910	A	G	17	19	36	0	0	36	0	0
4	68503333	rs537851631	T	C	2	5	7	0	0	7	0	0
4	68504232	rs28471980	C	T	5	5	10	0	0	10	0	0
4	68515054	rs6840867	A	G	2	4	6	0	0	6	0	0
4	68520058	rs192125253	T	C	4	3	7	0	0	7	0	0
4	68526334	rs115766998	G	A	5	4	9	0	0	9	0	0
4	68534392	rs10010188	C	T	13	6	19	0	0	19	0	0
4	68586267	rs17635222	G	C	3	4	7	0	0	7	0	0
4	70690962	rs1220721	G	A	4	2	6	0	0	6	0	0
4	70690984	rs28884299	C	T	6	2	8	0	1	9	0	0
4	71634283	.	A	G	13	16	29	0	0	29	0	0
4	73922549	rs16849151	A	C	9	12	21	0	0	21	0	0
4	74100153	rs11724514	G	T	4	2	6	0	0	6	0	0
4	74110297	rs114341734	A	C	6	7	13	0	0	13	0	0
4	74110352	.	C	T	7	5	12	0	0	12	0	0
4	74606669	rs2227307	T	G	52	56	108	0	3	111	0	0
4	74607055	rs2227306	C	T	313	280	593	0	1	594	0	0
4	74607910	rs2227543	C	T	644	579	1223	0	10	1233	0	0
4	74609045	rs1126647	A	T	1870	1920	3790	0	16	3808	2	0
4	74963049	rs9131	C	T	711	740	1451	0	7	1458	0	0
4	75485813	rs2291714	C	T	21	23	44	0	2	46	0	0
4	76469838	rs6856772	A	G	3	4	7	0	0	7	0	0
4	76472354	rs17214073	G	C	6	3	9	0	0	9	0	0
4	76574313	.	G	A	4	2	6	0	0	6	0	0
4	76836137	rs6823734	A	G	53	35	88	0	2	90	0	0
4	77958130	rs1127587	G	A	31	34	65	0	0	65	0	0
4	77958765	rs1127595	A	G	45	51	96	0	0	96	0	0
4	77974545	rs4241599	C	T	39	22	61	0	2	63	0	0
4	77977765	rs4252890	C	G	4	4	8	0	0	8	0	0
4	77982220	rs4241601	A	G	4	11	15	0	0	15	0	0
4	77985831	rs12650027	T	C	7	4	11	0	0	11	0	0
4	77986050	rs28624595	C	G	6	6	12	0	0	12	0	0
4	77986711	.	C	T	13	7	20	0	0	20	0	0
4	78079695	rs4150050	T	G	113	103	216	0	3	219	0	0
4	78087306	rs4150094	A	G	186	201	387	0	5	392	0	0
4	78640843	rs113107172	A	G	48	59	107	0	2	109	0	0
4	78729122	rs17409006	G	C	1	5	6	0	0	6	0	0
4	79531308	rs4612	C	T	1	5	6	0	0	6	0	0
4	79697870	rs149914551	C	A	11	19	30	0	0	30	0	0
4	79791119	rs10025599	T	C	3	3	6	0	0	6	0	0
4	79832706	rs12507099	C	G	16	14	30	0	0	30	0	0
4	79841359	rs10028067	C	G	12	11	23	0	2	25	0	0
4	80827062	rs7747	T	C	114	116	230	0	3	233	0	0
4	80827798	rs63539261	A	G	87	77	164	0	1	165	0	0
4	80827799	rs1139638	A	C	87	77	164	0	0	164	0	0
4	80828740	rs6819294	T	A	42	9	51	0	0	51	0	0
4	80829019	rs6534641	T	G	3	4	7	0	0	7	0	0
4	80829121	rs6534642	T	C	8	7	15	0	0	15	0	0
4	80829204	rs6534643	A	G	10	5	15	0	0	15	0	0
4	80887556	rs10033596	G	T	6	2	8	0	0	8	0	0
4	80887969	rs11098964	A	G	6	6	12	0	0	12	0	0
4	80894682	rs10001066	A	G	6	5	11	0	0	11	0	0
4	80894706	rs10003491	T	C	6	9	15	0	0	15	0	0
4	80897785	rs73828830	G	A	7	5	12	0	1	13	0	0
4	80897999	rs10027407	C	G	3	10	13	0	0	13	0	0
4	80898027	rs10027415	C	T	3	9	12	0	0	12	0	0
4	80905833	rs28534734	T	C	0	7	7	0	0	7	0	0
4	80905851	rs28688624	A	C	0	7	7	0	0	7	0	0
4	80917701	rs4555571	C	G	5	1	6	0	0	6	0	0
4	80941455	rs28721541	G	A	4	4	8	0	0	8	0	0
4	80941471	.	T	A	4	4	8	0	0	8	0	0
4	80988123	rs10033166	G	A	4	3	7	0	0	7	0	0
4	80988478	rs11730030	C	T	11	7	18	0	0	18	0	0
4	80988744	rs17509683	G	A	7	4	11	0	0	11	0	0
4	80989630	rs17509725	C	T	10	8	18	0	0	18	0	0
4	82351066	rs182458128	G	A	4	5	9	0	0	9	0	0
4	83344744	rs9316	T	C	102	74	176	0	6	182	0	0
4	83345477	rs72909808	T	C	45	87	132	0	0	132	0	0
4	83348091	rs79740118	T	G	5	11	16	0	0	16	0	0
4	83348978	rs6826022	T	C	7	7	14	0	2	16	0	0
4	83740718	rs12331100	T	C	4	3	7	0	0	7	0	0
4	83740867	rs11099554	A	C	4	2	6	0	0	6	0	0
4	83742336	rs4634209	C	T	3	6	9	0	0	9	0	0
4	83742585	rs6828334	C	T	2	8	10	0	0	10	0	0
4	83743728	rs10471049	C	G	7	3	10	0	0	10	0	0
4	83744136	rs13104805	G	A	3	3	6	0	0	6	0	0
4	83754091	rs57994979	C	T	22	13	35	0	0	35	0	0
4	83754204	rs80275378	C	T	11	9	20	0	0	20	0	0
4	83754887	rs28611098	T	C	6	14	20	0	0	20	0	0
4	83754894	rs28661080	T	C	6	12	18	0	0	18	0	0
4	83756162	rs9997148	C	T	4	6	10	0	0	10	0	0
4	83756463	rs10021415	G	A	3	4	7	0	1	8	0	0
4	83756664	rs10021591	G	A	6	13	19	0	0	19	0	0
4	83756926	rs66932306	T	C	8	7	15	0	0	15	0	0
4	83759002	rs13118927	T	C	6	11	17	0	0	17	0	0
4	83759895	rs148732456	G	A	7	5	12	0	0	12	0	0
4	83762316	rs11731666	C	T	3	3	6	0	0	6	0	0
4	83763126	rs13142752	A	C	6	4	10	0	0	10	0	0
4	83765050	rs9690	C	A	8	7	15	0	0	15	0	0
4	83768751	rs13120533	C	T	1	5	6	0	0	6	0	0
4	83795806	rs10025654	T	C	66	63	129	0	3	132	0	0
4	83814823	rs7082	T	C	15	14	29	0	0	29	0	0
4	83817816	rs6855151	T	C	13	12	25	0	0	25	0	0
4	83840906	rs1047564	G	A	5	1	6	0	0	6	0	0
4	83848388	rs13132580	T	C	14	9	23	0	0	23	0	0
4	83976492	rs2868737	A	G	4	2	6	0	0	6	0	0
4	83977244	rs10028177	C	T	8	4	12	0	1	13	0	0
4	83979457	rs72666503	A	G	2	4	6	0	0	6	0	0
4	83980563	rs1962413	C	G	4	3	7	0	0	7	0	0
4	83983700	rs4591594	T	C	2	4	6	0	0	6	0	0
4	84188850	rs1129617	G	A	22	24	46	0	0	46	0	0
4	84191031	rs6535454	A	G	10	14	24	0	0	24	0	0
4	84203609	rs11724659	A	T	6	8	14	0	0	14	0	0
4	84204591	rs62303672	A	T	6	9	15	0	0	15	0	0
4	84204846	rs62303673	C	A	8	4	12	0	0	12	0	0
4	84383275	rs6825184	A	G	28	30	58	0	0	58	0	0
4	84383735	rs13125836	C	T	43	38	81	0	0	81	0	0
4	84526275	rs1521531	T	C	5	2	7	0	0	7	0	0
4	84526573	rs1052473	A	G	5	4	9	0	0	9	0	0
4	87910183	rs113069476	T	C	5	5	10	0	0	10	0	0
4	87910255	rs79540139	A	G	7	7	14	0	0	14	0	0
4	87921457	rs6531945	T	C	3	3	6	0	0	6	0	0
4	87928204	rs340638	C	T	21	18	39	0	0	39	0	0
4	87931965	rs340632	T	C	5	2	7	0	0	7	0	0
4	87942234	rs340647	C	T	35	39	74	0	0	74	0	0
4	87946042	rs340645	A	G	11	6	17	0	0	17	0	0
4	87967235	rs2272777	C	T	7	4	11	0	0	11	0	0
4	87968979	rs58633957	G	T	41	48	89	0	0	89	0	0
4	87970127	rs17604480	C	A	20	29	49	0	0	49	0	0
4	87971600	rs867196	G	C	9	11	20	0	2	22	0	0
4	87972465	rs375795	C	T	13	14	27	0	0	27	0	0
4	87972968	rs6531948	T	C	6	16	22	0	0	22	0	0
4	87973668	rs6840258	C	T	11	16	27	0	0	27	0	0
4	87974415	rs388401	C	G	11	23	34	0	2	36	0	0
4	87976055	rs443459	G	A	11	15	26	0	1	27	0	0
4	87976178	rs6819155	G	A	17	8	25	0	0	25	0	0
4	87976359	rs1471251	A	T	7	5	12	0	0	12	0	0
4	87979212	rs4693802	A	G	19	16	35	0	1	36	0	0
4	87980066	rs2061498	C	T	23	39	62	0	0	62	0	0
4	87980070	rs55982755	A	C	21	39	60	0	2	62	0	0
4	87980748	rs17012334	G	A	21	31	52	0	0	52	0	0
4	87982785	rs390604	T	C	14	15	29	0	0	29	0	0
4	87982790	rs384059	G	A	15	17	32	0	0	32	0	0
4	87983540	rs393991	C	A	14	28	42	0	0	42	0	0
4	87983587	rs3116678	T	C	16	28	44	0	0	44	0	0
4	87985166	rs3775228	C	T	6	14	20	0	0	20	0	0
4	87985443	rs3822042	G	T	15	14	29	0	0	29	0	0
4	87985530	rs17668131	G	T	14	9	23	0	0	23	0	0
4	87986203	rs10018897	G	A	35	19	54	0	1	55	0	0
4	87986206	rs10018904	G	C	35	20	55	0	0	55	0	0
4	87986395	rs13120301	C	T	24	33	57	0	0	57	0	0
4	87986588	rs236678	A	G	16	29	45	0	0	45	0	0
4	87986601	rs236679	A	C	14	31	45	0	0	45	0	0
4	87988508	rs236681	T	G	16	33	49	0	0	49	0	0
4	87988540	rs2280952	T	C	14	17	31	0	2	33	0	0
4	87988590	rs2280953	C	T	12	9	21	0	0	21	0	0
4	87988862	rs2280954	A	G	8	4	12	0	0	12	0	0
4	87989465	rs3775226	G	A	5	1	6	0	1	7	0	0
4	87991429	rs9992235	G	C	5	4	9	0	0	9	0	0
4	87992210	rs3736668	T	C	2	5	7	0	0	7	0	0
4	87992917	rs6827213	T	A	6	4	10	0	0	10	0	0
4	87993946	rs1841265	G	A	13	7	20	0	0	20	0	0
4	87994639	rs2869642	G	T	11	4	15	0	0	15	0	0
4	87995613	rs3775225	G	A	4	7	11	0	0	11	0	0
4	88009620	rs236676	G	A	3	3	6	0	0	6	0	0
4	88010741	rs236674	G	A	6	3	9	0	0	9	0	0
4	88024738	rs3755985	A	G	2	6	8	0	0	8	0	0
4	88024909	rs168204	A	G	2	5	7	0	0	7	0	0
4	88029482	rs3733377	C	G	3	11	14	0	0	14	0	0
4	88030486	rs3822041	A	G	4	14	18	0	0	18	0	0
4	88033352	rs447990	T	G	7	5	12	0	0	12	0	0
4	88037792	rs3755983	G	A	14	11	25	0	1	26	0	0
4	88046938	rs2926512	G	A	2	6	8	0	0	8	0	0
4	88046946	rs3775209	G	A	6	2	8	0	0	8	0	0
4	88054632	rs342465	C	T	5	9	14	0	0	14	0	0
4	88057481	rs342462	G	A	66	78	144	0	2	146	0	0
4	88058472	rs342461	A	G	121	132	253	0	2	255	0	0
4	88059242	rs342460	A	G	61	61	122	0	4	126	0	0
4	88059415	rs342459	G	A	145	130	275	0	2	277	0	0
4	88059617	rs10029915	G	C	125	134	259	0	5	264	0	0
4	88059697	rs377093348	A	G	84	77	161	0	3	164	0	0
4	88060025	rs342458	C	A	130	100	230	0	2	232	0	0
4	88060832	rs1842685	T	C	183	202	385	0	3	388	0	0
4	88259978	rs10028111	C	T	3	4	7	0	0	7	0	0
4	88312293	rs28654511	A	T	150	140	290	0	1	291	0	0
4	88929124	.	C	T	6	8	14	0	0	14	0	0
4	88947021	rs34716223	C	T	4	2	6	0	0	6	0	0
4	88954247	rs6850829	G	C	2	4	6	0	0	6	0	0
4	88956521	rs6532045	A	G	6	5	11	0	0	11	0	0
4	88959961	rs2725219	T	C	6	7	13	0	0	13	0	0
4	88959998	rs7696304	A	G	4	6	10	0	0	10	0	0
4	88960258	rs2725217	A	T	3	3	6	0	0	6	0	0
4	88997102	rs2728121	C	T	18	15	33	0	0	33	0	0
4	88997876	rs2725202	G	A	15	17	32	0	0	32	0	0
4	88998083	rs10965	G	A	21	7	28	0	0	28	0	0
4	89571448	rs11947594	G	A	3	3	6	0	0	6	0	0
4	89607905	rs3737488	A	G	22	38	60	0	0	60	0	0
4	89607932	rs7698491	G	A	41	25	66	0	1	67	0	0
4	89617387	rs8605	A	G	0	35	35	0	1	36	0	0
4	89617931	rs28435799	G	A	0	37	37	0	0	37	0	0
4	89618265	.	A	C	11	0	11	0	0	11	0	0
4	89625427	rs1804080	G	C	24	30	54	0	2	56	0	0
4	89628242	rs2924934	G	T	32	35	67	0	2	69	0	0
4	89628733	rs3775399	T	A	29	35	64	0	0	64	0	0
4	89629000	rs1063143	A	G	26	19	45	0	0	45	0	0
4	89641514	rs2924936	G	A	0	7	7	0	0	7	0	0
4	89648845	rs13130	A	G	11	16	27	0	2	29	0	0
4	89649491	rs3017895	A	G	10	11	21	0	0	21	0	0
4	89653257	rs1801915	G	A	12	3	15	0	0	15	0	0
4	89668859	rs7657817	C	T	6	5	11	0	0	11	0	0
4	89671721	rs61737091	C	T	5	4	9	0	0	9	0	0
4	89904124	rs1921681	T	C	2	5	7	0	0	7	0	0
4	89978281	rs11097210	G	A	7	5	12	0	0	12	0	0
4	90035549	rs2280099	A	G	5	4	9	0	0	9	0	0
4	90161863	rs7660707	T	C	11	6	17	0	0	17	0	0
4	90162268	rs17015234	C	A	2	6	8	0	0	8	0	0
4	90163617	rs4396961	G	A	18	17	35	0	0	35	0	0
4	90164712	rs756004	C	G	14	15	29	0	0	29	0	0
4	90164964	rs2005264	T	C	4	6	10	0	0	10	0	0
4	90165500	rs872615	T	C	2	5	7	0	0	7	0	0
4	90165642	rs872614	A	C	9	12	21	0	0	21	0	0
4	90165651	rs872613	T	A	9	13	22	0	0	22	0	0
4	90165690	rs872612	G	A	8	8	16	0	0	16	0	0
4	90168825	rs7672015	T	C	16	25	41	0	0	41	0	0
4	90168882	rs13115988	G	A	21	15	36	0	0	36	0	0
4	90170118	rs28622301	A	G	27	24	51	0	0	51	0	0
4	90228807	rs28378092	C	T	6	12	18	0	0	18	0	0
4	90646886	rs356165	G	A	3	4	7	0	0	7	0	0
4	90757948	rs2245804	T	A	5	4	9	0	0	9	0	0
4	91552749	.	G	C	1	7	8	0	0	8	0	0
4	95496882	rs2452600	C	T	7	6	13	0	0	13	0	0
4	95561459	rs7690296	A	G	9	9	18	0	0	18	0	0
4	95586015	rs1056773	T	C	2	5	7	0	0	7	0	0
4	95588075	rs3943	G	A	7	4	11	0	0	11	0	0
4	99806626	rs1992569	T	C	8	7	15	0	0	15	0	0
4	99808254	rs62323192	G	A	155	132	287	0	1	288	0	0
4	99809422	rs4699369	G	A	5	3	8	0	0	8	0	0
4	99809589	rs4699689	C	T	10	4	14	0	1	15	0	0
4	99811936	rs6830125	G	C	5	3	8	0	0	8	0	0
4	99816349	rs34164768	G	A	24	26	50	0	0	50	0	0
4	99966568	rs11721765	G	C	3	3	6	0	0	6	0	0
4	99988659	rs1230154	C	T	24	16	40	0	0	40	0	0
4	99992602	rs7669660	T	C	6	10	16	0	0	16	0	0
4	99992793	rs11547772	A	C	16	11	27	0	0	27	0	0
4	99992853	rs1061187	G	A	19	18	37	0	0	37	0	0
4	99993075	rs13832	C	A	17	15	32	0	0	33	1	0
4	99993151	rs1803037	C	T	20	24	44	0	0	44	0	0
4	99993350	rs12106	A	G	20	22	42	0	0	42	0	0
4	99993376	rs12697	A	G	46	51	97	0	0	97	0	0
4	99994565	rs7658279	G	A	6	6	12	0	0	12	0	0
4	99994608	rs7658118	C	T	4	4	8	0	0	8	0	0
4	99994622	rs7658127	C	G	3	3	6	0	0	6	0	0
4	99995138	rs7683802	T	G	1	9	10	0	0	10	0	0
4	99995703	rs28730632	G	A	1	6	7	0	0	7	0	0
4	99996373	rs1154416	G	T	5	5	10	0	0	10	0	0
4	99996379	.	T	G	8	2	10	0	0	10	0	0
4	99997179	rs4699699	C	G	4	5	9	0	0	9	0	0
4	100001540	rs28730605	C	T	5	1	6	0	1	7	0	0
4	100001682	rs28730602	G	T	5	3	8	0	0	8	0	0
4	100738035	rs715239	G	T	17	17	34	0	3	37	0	0
4	100757301	rs17539393	C	T	4	4	8	0	0	8	0	0
4	100762622	.	T	C	3	5	8	0	1	9	0	0
4	100762783	rs2851037	A	T	1	7	8	0	0	8	0	0
4	100763279	rs17029583	G	T	4	5	9	0	0	9	0	0
4	100763302	rs17611961	T	C	4	6	10	0	0	10	0	0
4	100787233	rs77036069	C	A	29	33	62	0	0	62	0	0
4	100789416	rs4699768	G	A	24	40	64	0	0	64	0	0
4	100791163	rs17540668	T	C	7	31	38	0	0	38	0	0
4	100821089	rs140678806	T	C	44	42	86	0	0	86	0	0
4	101945139	rs6826912	T	G	15	6	21	0	1	22	0	0
4	101946948	rs1042094	T	C	13	9	22	0	0	22	0	0
4	101947930	rs3804350	C	T	5	4	9	0	0	9	0	0
4	102839287	rs3733197	G	A	5	4	9	0	0	9	0	0
4	103183510	rs151390	C	T	44	38	82	0	1	83	0	0
4	103187146	rs62327916	T	G	4	3	7	0	0	7	0	0
4	103188709	rs13107325	C	T	20	26	46	0	0	46	0	0
4	103423230	rs2926005	G	A	5	8	13	0	0	13	0	0
4	103423326	rs2272676	G	T	7	2	9	0	1	10	0	0
4	103423493	rs10013613	G	T	8	3	11	0	0	11	0	0
4	103423549	.	A	G	8	0	8	0	0	8	0	0
4	103423551	.	A	G	7	0	7	0	1	8	0	0
4	103462797	rs230522	A	G	5	6	11	0	0	11	0	0
4	103463007	rs118882	T	C	3	3	6	0	0	6	0	0
4	103463328	rs230521	C	G	6	2	8	0	0	8	0	0
4	103465612	rs230520	G	A	3	5	8	0	0	8	0	0
4	103468518	rs93059	G	A	6	1	7	0	0	7	0	0
4	103469967	rs230518	C	T	5	6	11	0	0	11	0	0
4	103470193	rs230517	G	A	6	3	9	0	0	9	0	0
4	103472524	rs230513	T	C	4	7	11	0	0	11	0	0
4	103472885	rs230512	A	G	2	6	8	0	0	8	0	0
4	103476166	rs230510	T	A	3	4	7	0	0	7	0	0
4	103478265	rs230509	G	A	4	11	15	0	0	15	0	0
4	103479279	rs230508	A	G	5	5	10	0	0	10	0	0
4	103480246	rs230507	C	A	10	12	22	0	0	22	0	0
4	103480450	rs230506	A	G	5	7	12	0	0	12	0	0
4	103481351	rs230505	G	T	10	11	21	0	0	21	0	0
4	103481561	rs230504	T	C	7	6	13	0	0	13	0	0
4	103485780	rs230492	A	G	5	4	9	0	0	9	0	0
4	103486216	rs230493	A	T	5	4	9	0	0	9	0	0
4	103491863	rs230501	A	C	5	1	6	0	0	6	0	0
4	103492669	rs230503	G	A	5	2	7	0	0	7	0	0
4	103498455	rs230542	T	C	6	4	10	0	0	10	0	0
4	103503824	rs4699030	G	C	7	2	9	0	0	9	0	0
4	103506095	rs1598858	A	G	2	4	6	0	0	6	0	0
4	103506444	rs1598859	T	C	3	3	6	0	0	6	0	0
4	103507703	rs17032850	G	C	5	5	10	0	0	10	0	0
4	103508703	rs4648045	T	C	6	7	13	0	0	13	0	0
4	103508824	rs3821958	A	G	7	7	14	0	0	14	0	0
4	103509025	rs3774957	A	T	4	5	9	0	1	10	0	0
4	103509436	rs1287	G	A	5	6	11	0	0	11	0	0
4	103509455	rs7667496	C	T	4	10	14	0	0	14	0	0
4	103509681	rs7692606	T	C	7	1	8	0	0	8	0	0
4	103511114	rs3774959	G	A	7	9	16	0	0	16	0	0
4	103511330	rs3774960	C	T	15	5	20	0	0	20	0	0
4	103512451	rs59123962	T	G	7	10	17	0	0	17	0	0
4	103513073	rs4698858	C	G	9	11	20	0	1	21	0	0
4	103514445	rs1020760	C	G	1	9	10	0	0	10	0	0
4	103514658	rs1609993	T	C	133	144	277	0	5	282	0	0
4	103516811	rs4235405	T	C	8	3	11	0	0	11	0	0
4	103527068	rs4648090	G	A	6	6	12	0	0	12	0	0
4	103531112	rs3774968	A	G	7	10	17	0	0	17	0	0
4	103531991	rs4648104	G	C	8	3	11	0	0	11	0	0
4	103533821	rs4648110	T	A	7	6	13	0	0	13	0	0
4	103536024	rs4648128	A	G	15	15	30	0	1	31	0	0
4	103536261	rs230547	C	T	17	17	34	0	0	34	0	0
4	103552709	rs1054037	C	T	51	34	85	0	1	86	0	0
4	103552813	rs4013	C	T	175	149	324	0	2	326	0	0
4	103552830	rs4019	G	A	180	178	358	0	1	359	0	0
4	103553053	rs1054029	G	A	180	156	336	0	2	338	0	0
4	103553090	rs3194585	A	G	183	148	331	0	2	333	0	0
4	103554108	rs2866407	C	G	3	6	9	0	0	9	0	0
4	103554113	rs2866408	T	A	2	6	8	0	0	8	0	0
4	103554350	rs2866412	T	A	0	6	6	0	0	6	0	0
4	103554522	rs12498722	C	T	1	6	7	0	0	7	0	0
4	103555992	rs2272697	A	G	184	144	328	0	1	329	0	0
4	103556316	rs909349	T	C	4	3	7	0	0	7	0	0
4	103556462	rs4586937	G	C	5	1	6	0	0	6	0	0
4	103556861	rs3733202	T	C	5	8	13	0	0	13	0	0
4	103557077	rs2866413	G	A	90	71	161	0	2	163	0	0
4	103557192	rs4547797	C	T	7	5	12	0	0	12	0	0
4	103557219	rs2866414	C	T	5	4	9	0	0	9	0	0
4	103557251	rs10027437	G	A	6	5	11	0	0	11	0	0
4	103557463	rs10007196	A	T	1	5	6	0	0	6	0	0
4	103558169	rs4579121	C	G	5	4	9	0	0	9	0	0
4	103558514	rs6810869	T	A	3	5	8	0	0	8	0	0
4	103558805	rs6533020	T	C	3	5	8	0	0	8	0	0
4	103558833	rs6834176	C	A	3	4	7	0	0	7	0	0
4	103558853	rs6533021	A	G	4	4	8	0	0	8	0	0
4	103558951	rs6533022	T	C	2	7	9	0	0	9	0	0
4	103559876	rs2125211	A	G	8	1	9	0	0	10	1	0
4	103560745	rs765789	A	T	4	3	7	0	0	7	0	0
4	103586977	rs227361	C	T	2	4	6	0	0	6	0	0
4	103611845	rs227368	C	T	76	60	136	0	0	137	1	0
4	103622568	rs201903300	G	A	6	5	11	0	0	11	0	0
4	103622569	rs12650217	C	T	6	5	11	0	0	11	0	0
4	103664196	.	G	C	3	3	6	0	0	6	0	0
4	103726568	rs13128934	C	T	27	31	58	0	1	59	0	0
4	103729474	rs62329082	A	G	10	14	24	0	0	24	0	0
4	103731938	rs10018557	A	T	3	5	8	0	0	8	0	0
4	106123582	rs2047408	G	C	25	15	40	0	0	40	0	0
4	106155185	rs12498609	C	G	43	54	97	0	1	98	0	0
4	106389297	rs13104830	T	C	1	6	7	0	0	7	0	0
4	106389337	rs13129703	G	C	3	6	9	0	0	9	0	0
4	106392086	rs4699177	C	A	5	4	9	0	0	9	0	0
4	106392707	rs1048518	C	G	15	20	35	0	0	35	0	0
4	106393547	rs12498981	A	G	11	7	18	0	0	18	0	0
4	106394380	rs2074396	C	A	23	15	38	0	0	38	0	0
4	106604190	rs35370743	A	G	53	57	110	0	0	110	0	0
4	106604364	rs34072732	A	G	55	52	107	0	0	107	0	0
4	106611260	rs11941690	A	C	2	4	6	0	0	6	0	0
4	106768086	rs150384021	A	G	1	5	6	0	0	6	0	0
4	107083779	rs10027207	T	C	6	8	14	0	0	14	0	0
4	107236941	rs72660532	G	A	7	5	12	0	1	13	0	0
4	107239130	rs3113249	G	T	5	6	11	0	0	11	0	0
4	107242366	rs62318118	C	T	7	9	16	0	1	17	0	0
4	108641317	rs1127006	G	A	39	18	57	0	2	59	0	0
4	108853384	rs6849089	C	G	3	3	6	0	1	7	0	0
4	108955622	rs221347	T	A	14	26	40	0	0	40	0	0
4	109585895	rs11943458	A	G	0	6	6	0	0	6	0	0
4	110412541	.	C	G	30	40	70	0	0	70	0	0
4	110422695	.	C	A	5	3	8	0	0	8	0	0
4	110425176	rs1876125	T	C	4	4	8	0	0	8	0	0
4	110432078	rs7680211	G	T	9	7	16	0	0	16	0	0
4	110524470	rs10024722	C	T	23	26	49	0	1	50	0	0
4	110524484	rs112541720	C	T	21	28	49	0	0	49	0	0
4	110524784	rs197209	G	A	29	21	50	0	0	50	0	0
4	110524824	rs11734127	G	A	24	29	53	0	0	53	0	0
4	110524940	rs197207	C	T	30	28	58	0	2	61	1	0
4	110570095	rs9996730	G	T	1	6	7	0	0	7	0	0
4	110581363	rs4698744	T	A	42	49	91	0	0	91	0	0
4	110585645	rs767598	G	A	6	4	10	0	0	10	0	0
4	110603784	rs3733611	T	C	58	42	100	0	0	100	0	0
4	110608967	rs5030606	G	A	3	6	9	0	0	9	0	0
4	110610086	rs1042891	A	G	20	14	34	0	0	34	0	0
4	111409705	rs1126483	T	C	0	9	9	0	0	9	0	0
4	113197769	rs28555653	T	C	41	33	74	0	0	74	0	0
4	113245934	rs17589619	G	T	5	3	8	0	0	8	0	0
4	113709346	rs7662486	C	T	13	0	13	0	0	13	0	0
4	114372504	rs12511604	C	T	2	5	7	0	0	7	0	0
4	119526784	rs184210238	G	A	15	19	34	0	0	34	0	0
4	119623371	rs114052004	T	G	8	3	11	0	0	11	0	0
4	120138824	rs1134065	A	G	6	2	8	0	1	9	0	0
4	120219534	rs17642800	T	C	15	18	33	0	0	34	1	0
4	120420825	.	T	A	15	7	22	0	0	22	0	0
4	120423094	rs80223330	G	A	6	4	10	0	0	10	0	0
4	122589856	rs146310442	G	T	8	1	9	0	0	9	0	0
4	122591353	rs2306421	T	C	4	5	9	0	0	9	0	0
4	122618046	rs1050606	A	C	61	41	102	0	1	103	0	0
4	123171659	rs56363411	T	A	15	15	30	0	0	30	0	0
4	123227047	.	G	T	14	7	21	0	0	21	0	0
4	124319055	rs13150612	C	T	19	14	33	0	0	33	0	0
4	124319923	rs72684639	C	A	7	5	12	0	0	12	0	0
4	124320322	rs9992811	A	G	17	19	36	0	0	36	0	0
4	124320335	rs6844025	C	G	18	22	40	0	0	40	0	0
4	124320340	rs28514996	C	T	21	18	39	0	0	39	0	0
4	124320359	rs28477228	C	T	20	16	36	0	0	36	0	0
4	124320924	rs300572	A	G	59	55	114	0	2	116	0	0
4	124323738	rs300574	T	C	282	280	562	0	2	564	0	0
4	128960569	rs11098945	C	T	7	4	11	0	0	11	0	0
4	139140494	rs6838248	G	C	4	3	7	0	0	7	0	0
4	139917169	rs2271776	A	T	3	3	6	0	0	6	0	0
4	140056433	.	G	A	37	42	79	0	3	82	0	0
4	140079611	rs143359675	G	A	6	9	15	0	0	15	0	0
4	140216468	.	G	A	18	16	34	0	0	34	0	0
4	140307921	rs1450737	G	A	6	7	13	0	0	13	0	0
4	140308042	rs116705284	T	C	7	6	13	0	0	13	0	0
4	140308984	rs998310	C	A	4	2	6	0	0	6	0	0
4	140310520	rs3828506	T	C	19	21	40	0	0	40	0	0
4	140312453	rs113095157	C	T	5	7	12	0	0	12	0	0
4	140313136	.	C	T	5	6	11	0	0	11	0	0
4	140431386	.	A	T	7	10	17	0	0	17	0	0
4	140431590	.	G	C	11	11	22	0	0	22	0	0
4	140454711	rs2592972	C	T	3	4	7	0	0	7	0	0
4	140587125	rs2132845	A	T	51	36	87	0	2	89	0	0
4	140810637	rs11100342	C	T	31	28	59	0	1	60	0	0
4	140811135	rs3733382	T	C	24	25	49	0	0	49	0	0
4	141055896	rs6822207	G	A	9	3	12	0	0	12	0	0
4	142144724	rs146043272	G	C	10	9	19	0	0	19	0	0
4	142155214	rs3822128	T	C	65	82	147	0	1	148	0	0
4	142155445	rs114650792	T	A	19	9	28	0	0	28	0	0
4	144127778	rs112090426	G	A	3	6	9	0	0	9	0	0
4	144442735	rs11541117	C	T	94	91	185	0	1	186	0	0
4	144451912	rs11944532	A	G	3	4	7	0	0	7	0	0
4	144453500	rs7698480	T	C	3	8	11	0	0	11	0	0
4	144460419	rs4690793	G	C	36	39	75	0	0	75	0	0
4	144461871	rs7688293	C	T	66	58	124	0	2	126	0	0
4	144467444	rs2270677	G	A	4	4	8	0	0	8	0	0
4	144469383	rs2088415	A	G	7	5	12	0	0	12	0	0
4	144472873	rs4834996	T	C	10	11	21	0	0	21	0	0
4	144474666	rs1391191	A	C	12	19	31	0	0	31	0	0
4	144474849	rs1044156	A	G	47	86	133	0	3	136	0	0
4	144476149	rs11100791	A	G	8	6	14	0	0	14	0	0
4	144833153	rs74590858	C	G	1	7	8	0	0	8	0	0
4	144833154	rs78713560	T	G	1	7	8	0	0	8	0	0
4	144918712	rs1132783	C	G	3	5	8	0	0	8	0	0
4	144920596	rs7683365	G	A	3	6	9	0	0	9	0	0
4	145984839	rs17781702	C	A	5	1	6	0	0	6	0	0
4	146056320	rs1804528	G	A	131	110	241	0	2	243	0	0
4	146069613	rs62345103	T	C	0	6	6	0	0	6	0	0
4	146077132	rs36225838	C	T	46	63	109	0	1	110	0	0
4	146560236	rs4835011	A	G	6	5	11	0	0	11	0	0
4	151247294	rs2292207	C	A	9	8	17	0	0	17	0	0
4	151247410	rs2292206	T	C	7	5	12	0	1	13	0	0
4	151250550	rs17504145	A	G	4	3	7	0	0	7	0	0
4	151251199	rs78150402	T	C	3	8	11	0	0	11	0	0
4	151756676	rs294529	T	C	3	3	6	0	0	6	0	0
4	151758107	rs294531	C	T	2	4	6	0	0	6	0	0
4	151773593	rs1782360	G	C	30	25	55	0	0	55	0	0
4	151829824	rs1201208	T	C	17	20	37	0	0	37	0	0
4	152024326	rs4696658	T	G	60	44	104	0	0	104	0	0
4	152048304	rs13122245	C	T	1	7	8	0	0	8	0	0
4	152060204	rs10461253	T	A	5	5	10	0	0	10	0	0
4	152061201	rs2280280	T	C	29	63	92	0	0	92	0	0
4	152061987	rs7683092	C	T	22	24	46	0	1	47	0	0
4	152062671	rs7689095	C	T	4	2	6	0	0	6	0	0
4	152063021	rs10964	G	A	6	8	14	0	0	14	0	0
4	152063531	rs6535765	A	T	4	5	9	0	0	9	0	0
4	152066410	rs7668154	A	G	5	4	9	0	0	9	0	0
4	152066734	rs6825613	A	C	5	1	6	0	0	6	0	0
4	152592305	.	G	A	17	7	24	0	0	24	0	0
4	153400874	rs28587268	T	C	4	4	8	0	1	9	0	0
4	153403781	rs192470984	G	A	3	7	10	0	0	10	0	0
4	153449019	.	C	T	6	2	8	0	0	8	0	0
4	153450360	rs6816962	G	T	29	44	73	0	0	73	0	0
4	153451356	rs1023962	T	G	5	4	9	0	0	9	0	0
4	153455628	rs1484879	A	G	20	1	21	0	0	21	0	0
4	153456102	rs1351903	A	G	120	183	303	0	1	304	0	0
4	154546831	rs11737098	A	G	3	3	6	0	0	6	0	0
4	154547617	rs4696470	A	G	1	5	6	0	0	6	0	0
4	154547788	rs4696471	T	C	6	0	6	0	0	6	0	0
4	154547824	rs4696472	G	T	6	1	7	0	0	7	0	0
4	154549060	rs35127259	C	T	3	6	9	0	0	9	0	0
4	154549084	rs28375206	C	G	2	5	7	0	0	7	0	0
4	154549663	rs6535932	T	C	9	7	16	0	0	16	0	0
4	154552205	rs1530107	T	A	1	5	6	0	0	6	0	0
4	154553833	rs41280471	A	G	5	4	9	0	0	9	0	0
4	154553973	rs35897141	G	A	60	69	129	0	2	131	0	0
4	154623149	rs62323856	T	C	18	23	41	0	0	41	0	0
4	154631587	rs1337	C	G	18	18	36	0	0	36	0	0
4	155456302	rs147715639	A	G	4	4	8	0	0	8	0	0
4	155456390	rs1110	C	G	4	6	10	0	0	10	0	0
4	155456608	rs7654425	A	G	8	4	12	0	0	12	0	0
4	155457150	rs62330406	T	C	4	10	14	0	0	14	0	0
4	155457183	rs11553452	T	C	3	8	11	0	0	11	0	0
4	155457225	rs11553453	T	A	2	5	7	0	0	7	0	0
4	155457601	rs60732160	T	C	2	4	6	0	0	6	0	0
4	155458728	rs7668014	C	T	6	2	8	0	0	8	0	0
4	155459194	rs7668818	A	T	22	30	52	0	0	52	0	0
4	155461113	rs7671792	T	C	44	47	91	0	1	92	0	0
4	155462148	rs7700005	A	T	3	4	7	0	0	7	0	0
4	155464056	rs12644346	A	G	5	2	7	0	0	7	0	0
4	155464354	rs6829092	C	T	2	5	7	0	0	7	0	0
4	155465535	rs62330413	A	G	4	2	6	0	0	6	0	0
4	156600681	rs13107809	A	G	10	1	11	0	0	11	0	0
4	159045966	rs8370	A	G	6	1	7	0	0	7	0	0
4	159076826	rs6830702	C	T	6	0	6	0	0	6	0	0
4	159092605	rs17279270	A	G	5	4	9	0	0	9	0	0
4	159092633	rs2881373	A	G	5	4	9	0	0	9	0	0
4	159176039	rs17037314	C	T	5	3	8	0	0	8	0	0
4	159176109	rs1047725	C	A	3	3	6	0	0	6	0	0
4	159588731	rs3210749	A	C	25	17	42	0	0	42	0	0
4	159630817	rs8396	T	C	21	21	42	0	0	42	0	0
4	159631991	rs9410	G	T	29	41	70	0	1	71	0	0
4	159644494	rs2070630	G	C	10	16	26	0	0	26	0	0
4	159644501	rs2070629	C	T	9	16	25	0	0	25	0	0
4	159789441	rs62001914	C	A	8	9	17	0	0	17	0	0
4	159798538	rs4619844	A	C	3	4	7	0	1	8	0	0
4	159801291	rs13129071	C	G	5	2	7	0	0	7	0	0
4	159826379	rs2279153	T	C	6	7	13	0	0	13	0	0
4	159827313	rs10589	T	C	3	5	8	0	0	8	0	0
4	160277276	rs1135004	C	T	21	22	43	0	1	44	0	0
4	164049916	rs1061075	A	C	1	7	8	0	0	8	0	0
4	164055013	rs56141005	T	A	4	2	6	0	0	6	0	0
4	164059657	rs6839886	T	C	3	7	10	0	0	10	0	0
4	164078555	rs72697009	C	A	49	67	116	0	1	118	1	0
4	164082280	rs17471607	T	C	3	3	6	0	0	6	0	0
4	164435265	rs2304802	A	C	20	19	39	0	0	39	0	0
4	164440581	rs1561736	T	C	21	20	41	0	0	41	0	0
4	164446283	rs1053209	T	A	29	33	62	0	0	62	0	0
4	164447003	rs1054683	T	C	28	34	62	0	0	62	0	0
4	164447022	rs1054682	T	C	24	30	54	0	0	54	0	0
4	164447271	rs1054681	T	C	11	13	24	0	0	24	0	0
4	164447816	rs1441724	C	T	20	14	34	0	0	34	0	0
4	164447976	rs1044722	C	A	48	45	93	0	0	93	0	0
4	164448049	rs1044721	C	T	45	27	72	0	1	73	0	0
4	164449108	rs1133505	C	T	53	52	105	0	0	105	0	0
4	164449273	rs6816526	G	A	18	33	51	0	0	51	0	0
4	164466824	rs13130399	C	T	81	83	164	0	2	166	0	0
4	164505954	rs1473076	C	T	2	5	7	0	0	7	0	0
4	166000281	rs34616342	C	T	13	10	23	0	0	23	0	0
4	166133605	rs11734199	T	C	2	6	8	0	0	8	0	0
4	166138517	rs34962116	G	C	5	3	8	0	0	8	0	0
4	166139619	rs60905916	G	A	6	5	11	0	0	11	0	0
4	166183441	.	T	C	4	3	7	0	0	7	0	0
4	166190855	rs149493126	C	T	8	1	9	0	0	9	0	0
4	166192043	rs9994064	G	T	5	4	9	0	0	9	0	0
4	166192981	rs56287687	A	T	2	5	7	0	0	7	0	0
4	166224288	rs11725104	G	C	3	3	6	0	0	6	0	0
4	166231868	rs28678193	A	G	36	22	58	0	1	59	0	0
4	166237389	rs6536903	A	G	5	3	8	0	1	9	0	0
4	166241056	rs13353543	G	C	5	7	12	0	0	12	0	0
4	166241366	rs10015240	A	G	4	10	14	0	0	14	0	0
4	166242005	rs72701618	G	A	7	9	16	0	0	16	0	0
4	169158471	rs6552559	T	G	3	3	6	0	0	6	0	0
4	169158489	rs3828560	G	C	3	3	6	0	0	6	0	0
4	169343044	rs61740705	A	G	4	4	8	0	0	8	0	0
4	170015937	rs2245118	A	T	8	15	23	0	0	23	0	0
4	170019039	rs6553418	G	A	4	2	6	0	0	6	0	0
4	170026799	rs2446173	T	C	8	0	8	0	0	8	0	0
4	170045859	rs6553419	G	A	6	3	9	0	0	9	0	0
4	170046762	rs6823936	G	A	4	2	6	0	0	6	0	0
4	170075025	rs2009324	T	A	0	6	6	0	0	6	0	0
4	170077789	rs10518039	A	G	58	52	110	0	0	110	0	0
4	170088024	rs1976545	T	A	8	0	8	0	0	8	0	0
4	170133684	rs55722883	C	T	3	4	7	0	0	7	0	0
4	170133829	rs56324525	C	A	3	4	7	0	0	7	0	0
4	170133836	rs55857181	T	G	3	4	7	0	0	7	0	0
4	170144155	rs2660412	G	A	7	3	10	0	0	10	0	0
4	170144631	rs2706729	G	A	7	4	11	0	0	11	0	0
4	170145855	rs2660406	A	T	2	4	6	0	0	6	0	0
4	170146155	rs2706730	A	G	5	1	6	0	0	6	0	0
4	174154473	rs148178078	A	G	13	13	26	0	0	26	0	0
4	174180322	rs4323082	A	G	5	3	8	0	0	8	0	0
4	174188594	rs139751526	A	G	2	4	6	0	0	6	0	0
4	174221902	rs79848179	C	G	11	6	17	0	0	17	0	0
4	174235624	rs7658148	T	C	3	3	6	0	0	6	0	0
4	175178914	rs1396193	T	C	1	5	6	0	0	6	0	0
4	175237408	rs1553669	T	C	4	12	16	0	0	16	0	0
4	175239372	rs7684619	G	A	6	6	12	0	0	12	0	0
4	177242536	rs13123659	T	G	21	28	49	0	2	51	0	0
4	177242537	rs13123660	T	G	22	29	51	0	0	51	0	0
4	177243229	rs35890542	A	G	33	35	68	0	0	68	0	0
4	177245843	rs36002836	A	G	5	1	6	0	0	6	0	0
4	177245956	rs1454164	G	A	5	4	9	0	0	9	0	0
4	177246202	.	A	T	5	2	7	0	1	8	0	0
4	177249533	rs2278903	A	G	30	16	46	0	0	46	0	0
4	177249681	rs12643094	A	G	26	34	60	0	1	61	0	0
4	177249756	rs3733371	A	G	14	21	35	0	1	36	0	0
4	177251811	.	T	G	98	70	168	0	0	168	0	0
4	177253006	rs71613791	T	C	106	82	188	0	0	188	0	0
4	184562267	rs3186086	T	C	22	28	50	0	0	50	0	0
4	184600601	rs4241779	A	G	16	8	24	0	0	24	0	0
4	184612553	rs67383011	G	C	16	12	28	0	0	28	0	0
4	185369086	rs793783	G	C	4	4	8	0	0	8	0	0
4	185707576	.	A	G	2	10	12	0	3	15	0	0
4	185730358	rs112511647	C	G	6	7	13	0	1	14	0	0
4	185731070	rs111880823	C	T	11	7	18	0	0	18	0	0
4	185732109	rs112592353	T	C	8	5	13	0	0	13	0	0
4	185732658	rs11726327	A	G	5	7	12	0	0	12	0	0
4	185734313	rs115559783	T	A	8	7	15	0	0	15	0	0
4	185738423	rs143298771	G	T	2	9	11	0	0	11	0	0
4	189659622	rs12506607	G	C	12	0	12	0	0	12	0	0
4	190862083	rs1138726	T	C	65	53	118	0	2	120	0	0
4	190862155	rs4145515	T	G	129	124	253	0	1	255	1	0
4	190862182	rs2411530	C	T	137	134	271	0	2	273	0	0
4	190876195	rs7684300	C	T	167	172	339	0	2	341	0	0
4	190877710	rs4145510	A	G	2	6	8	0	0	8	0	0
4	190879500	rs12508765	T	C	4	4	8	0	0	8	0	0
4	190880291	rs7675870	A	G	4	2	6	0	0	6	0	0
4	190880853	rs1882895	G	A	5	5	10	0	0	10	0	0
4	190881438	rs2411550	T	C	3	6	9	0	0	9	0	0
5	214413	rs13173911	C	T	5	1	6	0	0	6	0	0
5	214738	rs6555042	T	C	3	3	6	0	0	6	0	0
5	225768	rs12520059	G	C	4	6	10	0	0	10	0	0
5	231111	rs1126417	T	C	152	135	287	0	0	288	1	0
5	236932	rs4957001	T	A	6	1	7	0	0	7	0	0
5	237583	rs13160257	T	C	10	2	12	0	0	12	0	0
5	242179	rs13155531	G	A	10	9	19	0	1	20	0	0
5	274884	rs12519592	T	C	11	1	12	0	0	12	0	0
5	313762	rs2672767	G	A	2	4	6	0	0	6	0	0
5	453567	rs2672722	G	A	53	59	112	0	3	115	0	0
5	456915	rs2721010	A	G	3	3	6	0	0	6	0	0
5	458500	rs77681658	A	G	6	11	17	0	0	17	0	0
5	458999	rs2434698	T	C	16	6	22	0	0	22	0	0
5	459003	rs2434699	G	A	17	6	23	0	0	23	0	0
5	459771	rs77955022	C	T	8	10	18	0	0	18	0	0
5	459943	rs7728027	T	C	9	4	13	0	0	13	0	0
5	460079	rs7716075	C	T	13	10	23	0	0	23	0	0
5	460135	rs2561665	A	G	17	7	24	0	0	24	0	0
5	462465	rs890972	C	A	9	4	13	0	0	13	0	0
5	462484	.	C	T	9	4	13	0	0	13	0	0
5	462556	rs2081942	G	A	6	6	12	0	1	13	0	0
5	462734	rs2434694	C	T	9	9	18	0	0	18	0	0
5	462995	rs4602680	C	T	5	16	21	0	0	21	0	0
5	464814	rs3815928	C	G	3	8	11	0	0	11	0	0
5	470087	rs2278251	G	A	14	6	20	0	0	20	0	0
5	471478	rs1053247	C	T	17	12	29	0	0	29	0	0
5	639231	rs12522955	C	A	5	1	6	0	0	6	0	0
5	640705	rs868649	A	G	4	2	6	0	0	6	0	0
5	642532	rs1709547	A	G	4	2	6	0	0	6	0	0
5	660491	rs7558	C	T	7	5	12	0	0	12	0	0
5	660804	rs7434	C	T	8	3	11	0	1	12	0	0
5	661856	rs72707007	T	C	5	5	10	0	0	10	0	0
5	662030	rs383167	G	C	20	11	31	0	0	31	0	0
5	662547	rs11738281	T	C	9	3	12	0	0	12	0	0
5	662613	rs3762951	C	G	8	7	15	0	0	15	0	0
5	662955	.	T	C	9	5	14	0	0	14	0	0
5	664084	rs28364691	G	A	6	7	13	0	0	13	0	0
5	665148	rs72707016	A	G	2	4	6	0	0	6	0	0
5	665295	rs61731455	A	G	6	10	16	0	0	16	0	0
5	732478	rs4956967	C	T	5	1	6	0	0	6	0	0
5	872777	.	G	A	7	7	14	0	0	14	0	0
5	1010038	rs75954784	C	T	43	31	74	0	1	75	0	0
5	1015063	rs16870629	C	T	5	5	10	0	0	10	0	0
5	1017915	rs4975528	G	A	5	4	9	0	0	9	0	0
5	1018951	rs6867712	G	C	4	5	9	0	0	9	0	0
5	1027456	rs1864094	A	G	2	4	6	0	0	6	0	0
5	1027713	rs1864093	G	A	3	5	8	0	0	8	0	0
5	1029215	rs1560174	G	A	5	4	9	0	0	9	0	0
5	1029712	rs882622	G	A	1	7	8	0	0	8	0	0
5	1029851	rs882623	T	C	3	8	11	0	0	11	0	0
5	1034246	rs4975576	A	T	7	8	15	0	0	15	0	0
5	1051687	rs1058508	T	C	124	136	260	0	3	263	0	0
5	1052360	rs3810854	C	T	116	131	247	0	3	250	0	0
5	1053216	.	G	C	12	13	25	0	0	25	0	0
5	1053341	rs2241602	A	G	9	14	23	0	0	23	0	0
5	1053396	rs2241603	C	G	14	12	26	0	2	28	0	0
5	1054197	rs4975572	C	T	29	35	64	0	1	65	0	0
5	1055564	rs2115283	C	T	32	34	66	0	0	66	0	0
5	1055565	rs2115284	G	A	35	32	67	0	0	67	0	0
5	1057113	rs2241604	C	T	14	5	19	0	0	19	0	0
5	1057405	rs2241605	G	A	13	18	31	0	0	31	0	0
5	1057615	rs2241606	A	G	84	63	147	0	2	149	0	0
5	1057890	rs2241607	G	A	5	13	18	0	0	18	0	0
5	1058779	.	G	C	13	22	35	0	0	35	0	0
5	1059610	rs13152999	G	A	15	9	24	0	1	25	0	0
5	1060379	rs35661060	G	A	8	6	14	0	0	14	0	0
5	1065399	rs737154	C	T	47	29	76	0	0	76	0	0
5	1068347	rs3789202	C	T	2	4	6	0	0	6	0	0
5	1068479	rs3789203	G	A	4	2	6	0	0	6	0	0
5	1090534	rs6864667	G	A	9	5	14	0	1	15	0	0
5	1093260	rs6554595	C	T	11	6	17	0	0	17	0	0
5	1093340	rs114447362	C	T	3	9	12	0	0	12	0	0
5	1093366	rs79086942	G	A	4	8	12	0	0	12	0	0
5	1093467	rs7721352	G	A	6	2	8	0	0	8	0	0
5	1104591	rs73031106	T	C	2	5	7	0	0	7	0	0
5	1106217	rs77601032	T	C	5	1	6	0	0	6	0	0
5	1253744	rs2853690	G	A	29	5	34	0	0	34	0	0
5	1255520	rs33954691	G	A	6	23	29	0	0	29	0	0
5	1462720	rs10630	G	A	10	15	25	0	0	25	0	0
5	1462732	rs13089	G	C	6	13	19	0	0	19	0	0
5	1476707	rs34510849	C	G	2	4	6	0	0	6	0	0
5	1802229	rs1845288	C	T	8	4	12	0	0	12	0	0
5	1803326	rs1873926	C	T	24	12	36	0	0	36	0	0
5	1803564	rs4147769	G	A	14	8	22	0	0	22	0	0
5	1803748	rs4147770	T	C	14	8	22	0	0	22	0	0
5	1804056	rs3776149	T	C	12	12	24	0	1	25	0	0
5	1804180	rs3776148	C	T	12	20	32	0	1	33	0	0
5	1804530	rs3776147	G	A	10	6	16	0	1	17	0	0
5	1806627	rs1018120	C	T	8	9	17	0	0	17	0	0
5	1807093	rs35380881	C	T	12	10	22	0	0	22	0	0
5	1807407	rs4975849	T	G	17	14	31	0	1	32	0	0
5	1807475	rs11959171	G	A	16	12	28	0	0	28	0	0
5	1807682	rs3822364	G	A	9	7	16	0	0	16	0	0
5	1807912	rs3776146	A	G	12	17	29	0	0	29	0	0
5	1808626	rs3776145	C	T	16	6	22	0	0	22	0	0
5	1808861	rs3776144	A	G	4	4	8	0	0	8	0	0
5	1809228	rs3756346	C	T	19	11	30	0	0	30	0	0
5	1809320	rs3756345	A	T	13	17	30	0	0	30	0	0
5	1809674	rs3776142	T	C	18	12	30	0	0	30	0	0
5	1809713	rs3776141	G	A	20	13	33	0	0	33	0	0
5	1812332	rs12515616	G	A	35	25	60	0	1	61	0	0
5	1812906	rs6863367	T	C	13	0	13	0	0	13	0	0
5	1812965	rs13170104	G	A	6	0	6	0	0	6	0	0
5	1812995	rs6555012	T	C	9	0	9	0	0	9	0	0
5	1813568	rs3756343	C	T	17	17	34	0	0	34	0	0
5	1813795	rs77884479	C	T	32	17	49	0	0	49	0	0
5	1814146	rs4147772	G	A	14	36	50	0	0	50	0	0
5	1815415	rs11133910	A	C	2	4	6	0	0	6	0	0
5	1815449	rs11133911	C	G	5	6	11	0	0	11	0	0
5	5437772	rs2578549	G	A	5	2	7	0	0	7	0	0
5	5438120	rs2578548	G	A	4	4	8	0	0	8	0	0
5	5460569	rs2578565	C	T	27	15	42	0	2	44	0	0
5	5460619	rs2619844	G	C	20	20	40	0	0	40	0	0
5	5462148	rs2578500	G	A	34	14	48	0	1	50	1	0
5	6600064	rs61744358	G	T	162	198	360	0	1	361	0	0
5	6600564	.	G	A	33	32	65	0	1	66	0	0
5	6600793	rs3776446	T	C	22	26	48	0	0	48	0	0
5	6600864	rs3822433	T	C	21	28	49	0	1	50	0	0
5	6602544	rs2303711	T	C	16	21	37	0	0	37	0	0
5	6602668	rs2303710	G	C	18	17	35	0	0	35	0	0
5	6603711	rs3776441	G	A	4	9	13	0	0	13	0	0
5	6603942	rs11748532	C	T	12	11	23	0	0	23	0	0
5	6604931	rs6889694	C	T	53	54	107	0	1	108	0	0
5	6604970	rs6888601	G	A	53	49	102	0	2	104	0	0
5	6605271	rs506416	G	A	54	47	101	0	0	101	0	0
5	6605532	rs2303707	C	A	54	47	101	0	0	101	0	0
5	6605829	rs11743548	G	T	32	21	53	0	6	60	1	0
5	6606019	rs6876067	A	G	25	21	46	0	0	46	0	0
5	6606303	rs6555402	C	T	52	41	93	0	0	93	0	0
5	6606323	rs6555403	T	C	48	40	88	0	0	88	0	0
5	6606445	rs6555404	G	A	21	14	35	0	0	35	0	0
5	6607916	rs720846	T	C	46	27	73	0	0	73	0	0
5	6608150	rs1366297	T	C	27	21	48	0	0	48	0	0
5	6608534	rs502272	A	T	36	41	77	0	0	77	0	0
5	6608877	rs484418	A	G	28	20	48	0	0	48	0	0
5	6608957	rs3776439	T	C	13	12	25	0	0	25	0	0
5	6609024	rs6882580	C	T	11	17	28	0	0	28	0	0
5	6609088	rs3776437	C	A	22	29	51	0	0	51	0	0
5	6609112	.	G	A	22	26	48	0	0	48	0	0
5	6609139	rs12374467	G	A	24	33	57	0	0	57	0	0
5	6610237	rs1560148	T	C	9	1	10	0	0	10	0	0
5	6610249	rs1560147	C	T	10	2	12	0	0	12	0	0
5	6610263	rs1560146	G	A	9	2	11	0	0	11	0	0
5	6610786	rs7731492	G	T	7	4	11	0	0	11	0	0
5	6610911	rs11741091	T	C	20	15	35	0	0	35	0	0
5	6611757	rs10454287	A	T	4	10	14	0	0	14	0	0
5	6620459	rs2288446	A	G	7	9	16	0	0	16	0	0
5	6621031	rs4702371	A	G	7	6	13	0	0	13	0	0
5	6621210	rs3756424	A	G	5	6	11	0	0	11	0	0
5	6622017	rs2303705	T	G	7	5	12	0	0	12	0	0
5	6622790	rs11744948	G	A	4	4	8	0	0	8	0	0
5	6624294	rs10037161	C	A	7	7	14	0	0	14	0	0
5	6624371	rs6874005	C	T	4	4	8	0	0	8	0	0
5	6626561	rs10475340	T	C	5	3	8	0	0	8	0	0
5	6626673	rs10462820	C	G	5	3	8	0	0	8	0	0
5	6629930	rs518673	G	A	2	4	6	0	0	6	0	0
5	6633042	rs10062086	C	T	14	15	29	0	1	30	0	0
5	6651970	rs3822430	A	G	17	4	21	0	0	21	0	0
5	6652009	rs8192186	G	A	22	5	27	0	0	27	0	0
5	6656210	rs3736316	G	A	17	9	26	0	0	26	0	0
5	6668842	rs3297	C	T	27	25	52	0	0	52	0	0
5	6669000	rs13974	A	G	32	16	48	0	0	48	0	0
5	6732252	rs274695	G	C	4	2	6	0	0	6	0	0
5	6734530	rs10040579	C	T	4	2	6	0	0	6	0	0
5	6734625	rs274692	C	T	3	4	7	0	0	7	0	0
5	6735245	rs1003098	C	T	4	2	6	0	0	6	0	0
5	6737134	rs200841	T	C	2	4	6	0	0	6	0	0
5	6740468	rs377137	T	G	5	4	9	0	0	9	0	0
5	6741558	rs28363367	T	G	2	4	6	0	0	6	0	0
5	6743825	.	A	G	19	15	34	0	0	34	0	0
5	6744176	rs274672	G	A	10	15	25	0	0	25	0	0
5	6745875	rs427394	A	G	10	15	25	0	0	25	0	0
5	6746648	rs2291704	T	C	2	6	8	0	0	8	0	0
5	6747238	rs2290617	T	C	3	4	7	0	0	7	0	0
5	6748810	rs2279653	G	A	8	7	15	0	0	15	0	0
5	6750830	.	G	A	6	1	7	0	0	7	0	0
5	6751526	rs10058222	T	C	2	5	7	0	0	7	0	0
5	6752109	rs3797185	G	A	4	3	7	0	0	7	0	0
5	6752385	rs274678	G	A	5	1	6	0	0	6	0	0
5	6753806	rs7356738	T	C	3	3	6	0	0	6	0	0
5	6755319	rs274675	C	T	21	29	50	0	0	50	0	0
5	6755460	rs274674	C	T	15	35	50	0	0	50	0	0
5	7743787	rs62342477	C	T	19	9	28	0	0	28	0	0
5	7810135	.	C	T	4	2	6	0	0	6	0	0
5	7812445	rs326149	G	T	3	3	6	0	0	6	0	0
5	7868030	rs2966952	T	C	6	0	6	0	0	6	0	0
5	7870973	rs1801394	A	G	14	23	37	0	0	37	0	0
5	7886104	rs162037	T	C	4	8	12	0	0	12	0	0
5	7886131	rs162038	G	C	1	5	6	0	1	7	0	0
5	7887478	rs162040	C	A	3	7	10	0	0	10	0	0
5	7897946	rs17267793	A	G	5	4	9	0	0	9	0	0
5	7898094	rs10475399	A	G	7	13	20	0	0	20	0	0
5	7899253	rs49672	A	G	13	13	26	0	0	26	0	0
5	7900833	rs8659	T	A	7	3	10	0	0	10	0	0
5	10384664	rs116769154	T	A	9	2	11	0	0	11	0	0
5	10427377	rs72740446	A	G	11	5	16	0	0	16	0	0
5	10619953	rs6882964	G	C	5	2	7	0	0	7	0	0
5	10620055	rs11748380	G	A	5	1	6	0	0	6	0	0
5	10654100	rs56010606	C	T	3	4	7	0	0	7	0	0
5	10654241	rs17829345	C	A	4	3	7	0	0	7	0	0
5	10655997	rs3733760	A	G	3	5	8	0	0	8	0	0
5	10656186	rs3733762	C	T	4	3	7	0	0	7	0	0
5	10656698	rs2279328	T	C	4	2	6	0	0	6	0	0
5	10657194	rs2279325	G	A	3	4	7	0	0	7	0	0
5	10657209	rs2279324	T	C	3	4	7	0	0	7	0	0
5	10657293	rs7735731	C	T	6	2	8	0	0	8	0	0
5	10679746	rs7973	T	C	329	311	640	0	5	645	0	0
5	10680063	rs5745300	G	A	328	319	647	0	3	650	0	0
5	10680749	rs10271	G	A	327	357	684	0	3	687	0	0
5	10681110	rs5745296	A	G	252	249	501	0	5	506	0	0
5	10734193	rs16885262	C	T	7	10	17	0	0	17	0	0
5	10742092	rs2964786	C	T	3	3	6	0	0	6	0	0
5	10742128	rs2930057	T	C	5	1	6	0	0	6	0	0
5	10742979	rs62336772	C	T	2	4	6	0	0	6	0	0
5	10744197	rs267948	C	G	3	9	12	0	0	12	0	0
5	10750542	rs267941	G	A	8	3	11	0	0	11	0	0
5	10755916	rs267934	G	A	5	2	7	0	1	8	0	0
5	10756291	rs267933	G	A	4	3	7	0	0	7	0	0
5	10756327	rs3822421	G	C	2	5	7	0	0	7	0	0
5	10758378	rs267931	C	G	7	4	11	0	0	11	0	0
5	10758562	rs267930	G	A	5	6	11	0	0	11	0	0
5	10758861	rs58891571	C	A	4	7	11	0	0	11	0	0
5	10758867	rs58583280	G	A	3	6	9	0	1	10	0	0
5	10759318	rs62336805	T	A	2	4	6	0	0	6	0	0
5	14144399	rs249493	C	G	5	3	8	0	0	8	0	0
5	14420027	rs30612	A	C	30	46	76	0	1	77	0	0
5	14480033	.	A	G	33	44	77	0	0	77	0	0
5	14505511	rs139818886	C	T	5	3	8	0	1	9	0	0
5	14507873	.	G	C	4	5	9	0	0	9	0	0
5	16616373	.	T	C	1	5	6	0	0	6	0	0
5	21480369	rs62347251	C	A	2	4	6	0	0	6	0	0
5	21480372	rs62347252	G	T	2	4	6	0	0	6	0	0
5	21497271	rs4701278	T	A	12	13	25	0	1	26	0	0
5	32256208	.	A	G	4	5	9	0	0	9	0	0
5	32280993	rs146271703	G	C	2	5	7	0	0	7	0	0
5	32592174	rs10472812	T	C	12	8	20	0	0	20	0	0
5	32593108	rs6873470	G	T	18	17	35	0	0	35	0	0
5	32595299	.	T	A	13	12	25	0	0	25	0	0
5	32602946	rs1046680	T	A	63	70	133	0	1	134	0	0
5	32788184	.	C	T	86	72	158	0	1	159	0	0
5	32788369	rs1158715	G	A	92	107	199	0	2	201	0	0
5	32788696	rs34732059	G	A	29	24	53	0	0	53	0	0
5	32789392	rs2287661	G	A	58	88	146	0	7	153	0	0
5	32789852	rs1173756	T	C	108	138	246	0	2	248	0	0
5	32790616	rs1345597	T	C	161	146	307	0	1	308	0	0
5	33441124	.	C	G	46	51	97	0	0	97	0	0
5	33457535	rs2270903	T	A	10	7	17	0	0	17	0	0
5	33460691	rs59078367	G	A	9	6	15	0	0	15	0	0
5	33461355	rs2270905	G	A	129	77	206	0	3	209	0	0
5	33468943	rs5026634	G	T	6	9	15	0	0	15	0	0
5	34018504	rs840391	T	C	5	5	10	0	0	10	0	0
5	34018684	rs840389	A	G	5	4	9	0	0	9	0	0
5	34018890	rs840388	T	G	2	4	6	0	0	6	0	0
5	34020030	rs6546	C	G	14	12	26	0	1	27	0	0
5	34020277	rs840386	C	T	10	10	20	0	0	20	0	0
5	34020358	.	T	C	12	3	15	0	0	15	0	0
5	34112426	rs159499	A	G	5	2	7	0	0	7	0	0
5	35641582	rs6897513	A	C	5	3	8	0	0	8	0	0
5	35644621	rs7706444	T	C	6	7	13	0	0	13	0	0
5	35654711	rs2270558	C	T	4	7	11	0	0	11	0	0
5	35667239	.	T	C	7	4	11	0	0	11	0	0
5	35861068	rs1494558	T	C	10	18	28	0	0	28	0	0
5	35871190	rs1494555	G	A	7	9	16	0	0	16	0	0
5	35876274	rs3194051	A	G	3	4	7	0	0	7	0	0
5	35877395	.	G	A	6	3	9	0	0	9	0	0
5	35877505	rs10063294	G	A	3	5	8	0	1	9	0	0
5	35877826	rs9292617	A	T	8	2	10	0	0	10	0	0
5	35877841	rs10491435	G	A	9	3	12	0	0	12	0	0
5	35877914	rs10491434	A	G	8	3	11	0	0	11	0	0
5	35878249	rs7716064	G	A	4	9	13	0	0	13	0	0
5	35878927	rs6451231	T	C	4	5	9	0	0	9	0	0
5	35879429	rs1053496	T	C	8	9	17	0	0	17	0	0
5	36178656	rs114270473	C	T	6	0	6	0	0	6	0	0
5	36687856	rs2269272	C	T	6	1	7	0	0	7	0	0
5	36705905	rs10461973	C	G	6	3	9	0	0	9	0	0
5	36978832	rs527531030	G	C	3	4	7	0	1	8	0	0
5	36985303	rs3822471	A	G	140	125	265	0	1	266	0	0
5	37036492	rs61748200	C	T	87	58	145	0	0	145	0	0
5	37050360	rs3849756	G	A	6	5	11	0	0	11	0	0
5	37051246	rs12188075	C	A	5	10	15	0	0	15	0	0
5	37125342	.	T	G	0	8	8	0	0	8	0	0
5	37173930	rs10076911	A	C	9	6	15	0	0	15	0	0
5	37182902	rs75589774	G	A	5	3	8	0	0	8	0	0
5	37289049	rs11750291	T	A	4	2	6	0	0	6	0	0
5	37294473	rs1045908	T	C	21	18	39	0	0	39	0	0
5	37333727	rs150594	A	G	3	10	13	0	0	13	0	0
5	37393417	rs12659660	C	G	4	2	6	0	0	6	0	0
5	37393433	rs12189377	C	T	3	4	7	0	0	7	0	0
5	38985269	rs1239259	C	A	4	5	9	0	0	9	0	0
5	38986329	rs1239257	G	T	5	4	9	0	1	10	0	0
5	38987371	rs1239256	T	C	2	7	9	0	0	9	0	0
5	39009251	rs62359820	G	C	3	7	10	0	0	10	0	0
5	39062977	rs9292730	G	A	4	2	6	0	0	6	0	0
5	39067435	rs4273623	C	T	6	3	9	0	0	9	0	0
5	39119723	rs379707	C	A	51	46	97	0	0	97	0	0
5	39124593	rs2303806	A	T	3	6	9	0	0	9	0	0
5	39141240	rs3188386	G	A	67	47	114	0	0	114	0	0
5	39200154	rs12518981	C	T	4	6	10	0	0	10	0	0
5	39269845	rs35249	C	T	14	3	17	0	0	17	0	0
5	39372150	rs1046033	A	G	14	15	29	0	0	29	0	0
5	39373253	rs4578	C	T	8	7	15	0	0	15	0	0
5	39373418	rs1802927	C	T	7	11	18	0	1	19	0	0
5	39376988	rs3733801	C	T	15	13	28	0	1	29	0	0
5	39425092	rs55818129	T	G	2	5	7	0	0	7	0	0
5	40679688	rs13186505	G	A	14	21	35	0	0	35	0	0
5	40682550	rs4546432	C	T	59	57	116	0	1	117	0	0
5	40684676	rs13354346	T	C	35	45	80	0	1	81	0	0
5	40685795	rs10036575	T	C	73	106	179	0	1	180	0	0
5	40687463	rs28540420	C	T	67	42	109	0	2	111	0	0
5	40688031	rs6451535	G	A	54	37	91	0	1	92	0	0
5	40688059	rs10055925	A	G	52	38	90	0	0	90	0	0
5	40688552	rs7726237	G	A	54	51	105	0	1	106	0	0
5	40689000	.	G	T	28	16	44	0	0	44	0	0
5	40689996	rs10060234	A	G	12	15	27	0	0	27	0	0
5	40691665	rs28569300	A	G	81	74	155	0	0	155	0	0
5	40692940	rs16870224	G	A	848	566	1414	0	20	1434	0	0
5	40773699	rs837101	T	C	6	7	13	0	0	13	0	0
5	40775297	rs3792822	C	T	15	12	27	0	0	27	0	0
5	40828478	rs389737	T	C	12	5	17	0	0	17	0	0
5	40829311	rs6876367	C	T	11	10	21	0	1	22	0	0
5	40829915	rs7717357	C	T	9	2	11	0	0	11	0	0
5	40831063	rs16870378	T	C	3	3	6	0	0	6	0	0
5	40831202	rs192219	T	C	6	2	8	0	0	8	0	0
5	41743677	rs13189192	G	A	4	3	7	0	0	7	0	0
5	41743678	rs13171121	T	A	4	3	7	0	0	7	0	0
5	41846226	rs145946595	G	T	2	5	7	0	0	7	0	0
5	41846644	.	T	C	3	5	8	0	0	8	0	0
5	41846875	rs13165731	C	G	2	4	6	0	0	6	0	0
5	41926300	rs277416	G	A	4	4	8	0	0	8	0	0
5	43054747	rs13169563	A	G	5	5	10	0	0	10	0	0
5	43073531	rs67276929	C	T	8	6	14	0	0	14	0	0
5	43073739	.	A	G	9	6	15	0	0	15	0	0
5	43120098	rs511340	A	G	3	6	9	0	0	9	0	0
5	43126528	rs6414900	G	A	3	3	6	0	0	6	0	0
5	43134166	rs499436	A	G	3	3	6	0	0	6	0	0
5	43134610	rs512040	A	G	4	2	6	0	0	6	0	0
5	43161351	rs71627581	G	A	121	97	218	0	1	219	0	0
5	43175953	rs13665	G	C	33	39	72	0	0	73	1	0
5	43495599	rs56333629	C	T	38	0	38	0	4	42	0	0
5	43495684	rs10066408	C	T	11	0	11	0	1	12	0	0
5	43527033	rs4866747	A	T	7	12	19	0	0	19	0	0
5	43527381	rs71629179	T	C	7	3	10	0	0	10	0	0
5	43531116	rs60297702	A	G	3	3	6	0	0	6	0	0
5	43535754	rs6869933	G	C	6	4	10	0	0	10	0	0
5	43543557	rs6884661	C	T	6	3	9	0	0	9	0	0
5	43543651	rs10059912	T	C	5	6	11	0	0	11	0	0
5	43545310	rs10462051	G	A	2	8	10	0	0	10	0	0
5	43545628	rs12332560	A	G	5	4	9	0	1	10	0	0
5	43549314	rs55667604	T	G	0	6	6	0	0	6	0	0
5	43550762	rs67581152	T	C	3	4	7	0	0	7	0	0
5	43609272	rs12187908	T	C	25	30	55	0	0	55	0	0
5	43609343	rs10057103	C	T	27	31	58	0	0	58	0	0
5	68890319	.	G	A	8	2	10	0	0	10	0	0
5	68928433	.	C	A	7	2	9	0	0	9	0	0
5	115249078	.	C	T	272	1	273	0	1	274	0	0
5	115249271	rs3879477	G	A	220	1	221	0	0	221	0	0
5	115249588	.	G	A	124	0	124	0	0	124	0	0
5	115249598	.	G	A	116	0	116	0	1	117	0	0
5	115249599	.	G	A	114	0	114	0	2	116	0	0
5	176940091	.	C	T	1	12	13	0	0	13	0	0
6	408079	rs1050976	C	T	5	6	11	0	0	11	0	0
6	408833	rs12211228	G	C	5	7	12	0	0	12	0	0
6	409119	rs9391997	A	G	8	4	12	0	0	12	0	0
6	410417	rs1050979	A	G	13	10	23	0	0	23	0	0
6	410493	rs1877175	A	G	11	12	23	0	0	23	0	0
6	410513	rs1877176	A	G	10	13	23	0	0	23	0	0
6	410848	rs2316515	A	G	14	4	18	0	0	18	0	0
6	411064	rs872071	A	G	13	7	20	0	0	20	0	0
6	485586	rs11242914	C	T	7	4	11	0	0	11	0	0
6	486175	rs78303339	A	G	4	7	11	0	1	12	0	0
6	537157	rs11242982	C	T	1	6	7	0	0	7	0	0
6	2352613	rs17134937	A	G	4	5	9	0	0	9	0	0
6	2766132	rs17851691	C	T	5	2	7	0	0	7	0	0
6	2766144	rs17851692	T	C	6	2	8	0	0	8	0	0
6	2766465	rs8333	T	C	16	13	29	0	0	29	0	0
6	2766860	rs41300833	A	G	34	38	72	0	0	72	0	0
6	2767421	rs6907679	T	C	1	5	6	0	0	6	0	0
6	2767727	rs6923007	G	C	5	2	7	0	0	7	0	0
6	2773076	rs160664	C	A	5	7	12	0	0	12	0	0
6	2773453	rs62393162	G	T	7	4	11	0	0	11	0	0
6	2773722	rs160665	C	T	5	4	9	0	0	9	0	0
6	2773755	rs3757086	G	A	4	7	11	0	0	11	0	0
6	2775080	rs160668	G	C	6	17	23	0	0	23	0	0
6	2775431	rs9328128	C	T	11	10	21	0	0	21	0	0
6	2777153	rs3799245	T	G	3	10	13	0	0	13	0	0
6	2777264	rs3823106	G	A	7	13	20	0	0	20	0	0
6	2777334	rs62393194	A	G	6	13	19	0	0	19	0	0
6	2777955	rs3799244	A	G	7	12	19	0	1	20	0	0
6	2777972	rs3799243	T	C	7	13	20	0	0	20	0	0
6	2777980	rs160696	C	A	8	11	19	0	0	19	0	0
6	2779882	rs898768	C	T	100	129	229	0	0	229	0	0
6	2780961	rs3799239	A	T	7	6	13	0	0	13	0	0
6	2783304	rs4083550	A	G	23	11	34	0	0	34	0	0
6	2784353	rs160704	C	G	4	15	19	0	0	19	0	0
6	2841954	rs57721448	G	T	6	5	11	0	0	11	0	0
6	2861699	rs62391494	A	G	4	2	6	0	0	6	0	0
6	2889071	rs13196459	A	C	11	11	22	0	2	24	0	0
6	2890283	rs318486	A	G	30	38	68	0	0	68	0	0
6	2959513	rs2236277	C	T	176	197	373	0	1	374	0	0
6	2966681	rs7751512	C	T	3	10	13	0	0	13	0	0
6	2970375	rs1125455	T	C	5	4	9	0	0	9	0	0
6	2970568	rs7743193	G	A	6	9	15	0	0	15	0	0
6	3010390	rs1143684	C	T	63	34	97	0	0	97	0	0
6	3023566	rs74756259	C	T	2	4	6	0	0	6	0	0
6	3027226	rs3734479	C	T	3	3	6	0	0	6	0	0
6	3082603	.	C	A	6	5	11	0	0	11	0	0
6	3154871	rs17849443	A	C	13	0	13	0	1	14	0	0
6	3723764	rs1045778	G	T	9	4	13	0	0	13	0	0
6	4031998	rs9503893	A	G	55	57	112	0	3	115	0	0
6	4053889	rs853399	T	C	8	5	13	0	0	13	0	0
6	4054234	rs853400	C	T	13	10	23	0	0	23	0	0
6	4054845	rs853402	T	G	9	13	22	0	1	23	0	0
6	4055707	rs853403	T	A	14	20	34	0	1	35	0	0
6	4057065	rs853405	T	C	28	23	51	0	0	51	0	0
6	4057160	rs853406	T	G	17	24	41	0	1	42	0	0
6	4057200	rs860477	A	G	17	26	43	0	0	43	0	0
6	4057233	rs853407	C	T	13	14	27	0	0	27	0	0
6	4059379	rs707987	A	G	17	31	48	0	0	48	0	0
6	4059532	rs72841295	C	T	30	24	54	0	1	55	0	0
6	4059616	rs707988	A	G	19	33	52	0	1	53	0	0
6	4063681	rs853411	G	A	45	62	107	0	0	107	0	0
6	4897576	rs1891045	G	A	4	2	6	0	0	6	0	0
6	4905553	rs62384663	A	C	6	0	6	0	0	6	0	0
6	4909437	rs7742807	T	C	3	3	6	0	0	6	0	0
6	4910370	rs1891046	A	G	1	7	8	0	0	8	0	0
6	4912194	rs9378917	G	A	4	5	9	0	0	9	0	0
6	4914190	rs4960049	G	T	3	5	8	0	0	8	0	0
6	4915159	rs9378918	C	T	5	4	9	0	0	9	0	0
6	4915203	rs4144546	C	T	4	5	9	0	0	9	0	0
6	4915648	rs6924037	G	A	1	6	7	0	0	7	0	0
6	4915805	rs6904931	A	G	8	1	9	0	0	9	0	0
6	4915841	rs9378919	A	G	3	6	9	0	0	9	0	0
6	4917157	rs7771387	C	G	4	2	6	0	0	6	0	0
6	4917347	rs17283864	C	G	2	5	7	0	0	7	0	0
6	4917353	rs11242983	G	A	2	5	7	0	0	7	0	0
6	4918054	rs9378920	C	T	3	3	6	0	0	6	0	0
6	4954710	rs1045074	A	G	8	7	15	0	0	15	0	0
6	5004157	.	G	A	14	13	27	0	0	27	0	0
6	6184273	.	T	C	3	3	6	0	0	6	0	0
6	6185017	rs3799557	G	A	7	3	10	0	0	10	0	0
6	6194180	rs3799554	G	A	7	7	14	0	0	14	0	0
6	6194967	rs3823191	T	C	7	2	9	0	0	9	0	0
6	6195060	rs11964160	A	G	4	5	9	0	0	9	0	0
6	6195926	rs2274391	C	T	41	16	57	0	0	57	0	0
6	6196141	rs5978	G	A	32	11	43	0	0	43	0	0
6	6196142	rs5977	G	A	32	10	42	0	1	43	0	0
6	6196604	rs3024436	G	A	21	7	28	0	0	28	0	0
6	7122936	rs1297769	G	A	3	5	8	0	0	8	0	0
6	7176744	rs2326880	C	T	4	3	7	0	0	7	0	0
6	7181735	rs9406002	A	G	125	112	237	0	1	238	0	0
6	7181993	rs9392862	T	C	178	189	367	0	5	372	0	0
6	7186801	rs34695416	G	A	4	3	7	0	0	7	0	0
6	7192501	rs7765018	C	T	4	5	9	0	0	9	0	0
6	7194182	rs4959429	A	G	4	6	10	0	0	10	0	0
6	7194411	rs4959430	T	C	2	6	8	0	0	8	0	0
6	7194598	rs6597254	C	T	6	6	12	0	0	12	0	0
6	7213200	rs17762454	C	T	3	5	8	0	0	8	0	0
6	7213279	rs6906505	C	T	6	6	12	0	0	12	0	0
6	7217053	rs12200266	A	G	5	7	12	0	0	12	0	0
6	7217220	rs12206543	G	C	4	6	10	0	0	10	0	0
6	7217664	rs34884023	T	C	2	9	11	0	0	11	0	0
6	7218337	rs13192435	T	C	4	4	8	0	0	8	0	0
6	7222813	rs2714348	G	C	5	4	9	0	0	9	0	0
6	7222830	rs2714349	G	A	5	5	10	0	0	10	0	0
6	7223663	rs7769430	G	A	4	10	14	0	0	14	0	0
6	7228046	rs2714311	T	C	2	6	8	0	0	8	0	0
6	7228462	rs2714312	A	C	3	5	8	0	0	8	0	0
6	7229346	rs2714315	T	C	105	101	206	0	5	211	0	0
6	7229619	rs12192672	G	A	224	221	445	0	0	445	0	0
6	7232186	rs9505086	T	C	189	176	365	0	1	366	0	0
6	7234172	rs72818919	G	A	8	8	16	0	0	16	0	0
6	7237629	rs11243146	A	T	3	5	8	0	0	8	0	0
6	7238575	rs2842375	A	G	2	8	10	0	0	10	0	0
6	7240577	rs2714337	A	T	6	4	10	0	1	11	0	0
6	7245458	rs1815311	A	G	11	9	20	0	1	21	0	0
6	7250960	rs2714338	G	A	100	96	196	0	2	198	0	0
6	7251037	rs2842352	C	T	60	67	127	0	0	127	0	0
6	7251451	rs1061637	C	T	54	59	113	0	1	114	0	0
6	7251726	.	T	G	85	5	90	0	6	96	0	0
6	7268750	.	T	C	4	4	8	0	0	8	0	0
6	7283184	rs3828856	C	T	8	14	22	0	0	22	0	0
6	7283474	rs113336440	G	A	8	3	11	0	0	11	0	0
6	7284096	rs41337347	C	T	5	16	21	0	0	21	0	0
6	7284143	rs56126063	C	T	4	13	17	0	0	17	0	0
6	7284459	rs9502582	C	T	8	4	12	0	0	12	0	0
6	7284487	rs9502583	G	A	9	6	15	0	0	15	0	0
6	7285289	rs15978	C	T	10	12	22	0	0	22	0	0
6	7297323	rs147068518	G	A	2	6	8	0	0	8	0	0
6	7310259	rs10004	A	G	123	115	238	0	0	238	0	0
6	7313398	rs114818913	G	T	74	68	142	0	1	143	0	0
6	7313406	rs2274210	C	G	49	59	108	0	0	108	0	0
6	7393452	rs2274212	C	T	53	46	99	0	0	99	0	0
6	7408678	rs6927113	A	G	4	5	9	0	0	9	0	0
6	7409551	rs66793322	G	A	5	5	10	0	0	10	0	0
6	7409693	rs34855016	A	G	7	5	12	0	0	12	0	0
6	7409702	rs35928169	G	C	5	5	10	0	0	10	0	0
6	8014704	rs2748375	A	C	12	12	24	0	0	24	0	0
6	8014990	rs2815151	T	C	13	7	20	0	0	20	0	0
6	8018388	rs2815168	G	T	6	0	6	0	0	6	0	0
6	10709836	.	T	A	4	4	8	0	0	8	0	0
6	10731218	rs7113	C	T	125	96	221	0	0	221	0	0
6	10829319	rs518204	C	T	22	10	32	0	0	32	0	0
6	11103062	rs58680949	G	C	2	12	14	0	1	15	0	0
6	11183587	rs1044417	C	T	5	1	6	0	0	6	0	0
6	11183896	rs13849	T	G	11	4	15	0	0	15	0	0
6	11184090	rs1570372	G	A	20	10	30	0	0	30	0	0
6	11184867	rs1803710	C	A	14	12	26	0	0	26	0	0
6	11185184	rs1911	A	G	24	14	38	0	0	38	0	0
6	11185257	rs10601	A	T	28	13	41	0	0	41	0	0
6	11185533	rs1050775	G	A	41	31	72	0	0	72	0	0
6	11188939	rs6906952	G	T	6	1	7	0	0	7	0	0
6	11538534	rs821443	C	T	27	16	43	0	0	43	0	0
6	11577085	rs490466	C	T	20	12	32	0	1	33	0	0
6	11579093	rs595877	G	A	4	2	6	0	0	6	0	0
6	11582292	rs555742	T	A	5	9	14	0	0	14	0	0
6	12013134	.	G	C	7	6	13	0	0	13	0	0
6	12055817	rs67757013	A	C	4	4	8	0	0	8	0	0
6	12056365	rs1886981	T	A	6	3	9	0	0	9	0	0
6	12122773	rs2228211	T	C	19	20	39	0	0	39	0	0
6	12124587	rs2228212	C	G	15	22	37	0	0	37	0	0
6	12140703	rs4443504	A	G	2	4	6	0	0	6	0	0
6	12141268	rs6917623	C	G	3	4	7	0	0	7	0	0
6	12141817	rs2327516	G	A	5	5	10	0	0	10	0	0
6	12142677	rs72828103	A	T	0	6	6	0	0	6	0	0
6	12143554	rs6931770	A	G	3	3	6	0	0	6	0	0
6	12143778	rs219945	G	T	8	2	10	0	0	10	0	0
6	12144327	rs139476391	C	A	6	7	13	0	0	13	0	0
6	12144367	rs36147437	G	T	6	4	10	0	0	10	0	0
6	12145332	rs4317394	A	C	0	7	7	0	0	7	0	0
6	12145423	rs7449638	A	G	6	7	13	0	1	14	0	0
6	12297028	rs9296344	T	C	4	6	10	0	0	10	0	0
6	12514969	rs9369396	C	T	1	99	100	0	0	100	0	0
6	12957621	rs11756003	G	A	7	3	10	0	0	10	0	0
6	12957825	rs4236093	C	G	3	3	6	0	0	6	0	0
6	13273318	rs202054	A	G	4	9	13	0	0	13	0	0
6	13280437	rs384730	T	A	6	2	8	0	0	8	0	0
6	13280454	rs442614	G	A	6	1	7	0	0	7	0	0
6	13280489	rs412787	T	C	5	3	8	0	0	8	0	0
6	13282067	rs17767967	C	T	3	6	9	0	0	9	0	0
6	13282442	rs35511719	T	C	3	3	6	0	0	6	0	0
6	13285713	rs9473896	T	A	2	6	8	0	0	8	0	0
6	13288425	rs202041	C	A	26	26	52	0	2	54	0	0
6	13288428	rs13191897	G	A	27	28	55	0	2	57	0	0
6	13288578	rs202039	G	A	42	66	108	0	0	108	0	0
6	13288737	rs202036	T	A	66	73	139	0	0	139	0	0
6	13288850	rs3734878	C	T	87	62	149	0	1	150	0	0
6	13289322	rs9473901	C	T	53	52	105	0	1	106	0	0
6	13300502	rs641758	A	G	0	6	6	0	0	6	0	0
6	13301043	rs202016	G	A	1	7	8	0	0	8	0	0
6	13301051	rs202017	C	G	1	6	7	0	0	7	0	0
6	13305757	rs2439534	T	C	1	6	7	0	0	7	0	0
6	13307824	rs2439537	C	T	1	8	9	0	0	9	0	0
6	13318030	rs3823441	C	A	6	2	8	0	0	8	0	0
6	13321097	rs2496132	G	A	3	3	6	0	0	6	0	0
6	13321856	rs2458307	T	C	0	9	9	0	0	9	0	0
6	13358946	rs477353	C	T	24	13	37	0	0	37	0	0
6	13361088	rs2496162	A	G	10	8	18	0	0	18	0	0
6	13361765	rs2496161	A	G	16	14	30	0	0	30	0	0
6	13361927	rs2496160	G	T	8	6	14	0	0	14	0	0
6	13364549	rs553948	T	A	7	12	19	0	0	19	0	0
6	13384746	rs531256	T	C	4	4	8	0	0	8	0	0
6	13385108	rs7760579	C	G	4	2	6	0	0	6	0	0
6	13463696	.	C	T	4	6	10	0	0	10	0	0
6	13474497	rs62385801	G	C	6	1	7	0	0	7	0	0
6	13477488	rs60199450	G	A	4	3	7	0	2	9	0	0
6	13486639	rs114976037	G	C	5	3	8	0	0	8	0	0
6	13487174	rs62385806	C	T	39	56	95	0	0	95	0	0
6	13487552	rs982391	G	T	9	12	21	0	1	22	0	0
6	13627151	rs9382303	A	G	15	10	25	0	0	25	0	0
6	13633646	rs7745281	T	C	6	7	13	0	0	13	0	0
6	13638451	rs2071835	T	G	17	22	39	0	0	39	0	0
6	13704341	rs204221	G	T	4	3	7	0	0	7	0	0
6	13787316	rs3800506	T	C	11	14	25	0	0	25	0	0
6	13788252	rs3757254	T	C	7	5	12	0	0	12	0	0
6	13790302	rs3734669	T	G	6	6	12	0	0	12	0	0
6	13790393	rs3734668	C	G	10	7	17	0	0	17	0	0
6	13801615	rs3180196	T	C	44	53	97	0	0	97	0	0
6	14130841	rs112707079	G	C	95	86	181	0	0	182	1	0
6	14131033	rs4715877	G	A	131	110	241	0	2	243	0	0
6	14131244	rs853358	A	T	147	131	278	0	0	279	1	0
6	14132241	rs9296923	G	A	241	181	422	0	3	425	0	0
6	14132551	rs9296924	A	G	218	229	447	0	4	451	0	0
6	14132611	rs9476511	A	G	226	204	430	0	0	431	1	0
6	14132887	rs9396472	G	T	274	226	500	0	1	501	0	0
6	14133573	rs9382940	C	T	220	250	470	0	2	472	0	0
6	14133647	rs7774927	T	C	250	221	471	0	0	471	0	0
6	14134083	rs9296925	T	C	64	73	137	0	0	137	0	0
6	14136373	rs3734665	A	G	1142	1217	2359	0	21	2382	2	0
6	14136428	rs1050650	A	C	973	1055	2028	0	11	2039	0	0
6	14280953	rs16874903	C	G	6	33	39	0	0	39	0	0
6	14280961	rs34126784	C	G	6	23	29	0	0	29	0	0
6	14282023	rs12526133	C	T	15	4	19	0	0	19	0	0
6	15244249	rs78855103	C	T	13	8	21	0	0	21	0	0
6	15468876	rs7768621	C	G	319	290	609	0	1	610	0	0
6	15474877	rs2237131	C	T	5	15	20	0	0	20	0	0
6	15475051	rs727734	T	A	4	13	17	0	0	17	0	0
6	15475938	rs2237129	C	A	6	6	12	0	0	12	0	0
6	15476046	rs11758203	A	G	4	2	6	0	0	6	0	0
6	15476048	rs2064100	A	G	4	2	6	0	0	6	0	0
6	15476605	rs2064098	G	T	4	9	13	0	1	14	0	0
6	15476994	.	A	T	3	3	6	0	0	6	0	0
6	15476995	.	G	C	3	3	6	0	0	6	0	0
6	15477330	rs2299037	G	A	3	6	9	0	0	9	0	0
6	15478311	rs6912499	G	A	6	4	10	0	0	10	0	0
6	15478336	rs2282823	C	T	9	3	12	0	0	12	0	0
6	15478841	rs2282822	C	T	2	8	10	0	0	10	0	0
6	15479224	rs2049950	T	C	7	7	14	0	0	14	0	0
6	15479363	rs2251828	G	A	7	9	16	0	0	16	0	0
6	15479795	rs2237128	T	C	7	3	10	0	0	10	0	0
6	15479845	rs11753594	G	T	5	5	10	0	0	10	0	0
6	15480698	rs55709778	C	T	8	11	19	0	0	19	0	0
6	15480700	rs2049952	C	G	9	11	20	0	0	20	0	0
6	15480898	rs2049951	C	T	5	7	12	0	0	12	0	0
6	15481093	rs2237127	C	A	6	4	10	0	0	10	0	0
6	15481103	rs2237126	C	T	6	4	10	0	0	10	0	0
6	15481379	rs2179167	T	C	6	14	20	0	0	20	0	0
6	15482441	rs1546851	T	C	10	15	25	0	0	25	0	0
6	15489956	rs2237125	C	T	60	45	105	0	1	106	0	0
6	15490202	rs2327897	A	G	77	77	154	0	2	156	0	0
6	15490253	rs2876393	G	A	63	58	121	0	0	121	0	0
6	15490455	rs11756854	G	A	28	23	51	0	1	52	0	0
6	15492000	rs55901822	G	A	47	52	99	0	1	100	0	0
6	15492193	rs56381700	G	A	58	49	107	0	2	109	0	0
6	15492335	rs2237123	A	G	42	50	92	0	0	92	0	0
6	15492702	rs2237122	A	G	41	47	88	0	3	91	0	0
6	15492913	.	C	T	49	39	88	0	1	89	0	0
6	15494544	rs72837821	C	T	28	20	48	0	0	48	0	0
6	15494559	rs2237119	A	G	21	17	38	0	0	38	0	0
6	15494668	rs116047526	A	T	8	3	11	0	0	11	0	0
6	15494726	rs139777568	A	G	8	6	14	0	1	15	0	0
6	15495472	rs72837824	G	T	35	39	74	0	1	75	0	0
6	15495650	rs4712252	A	C	42	28	70	0	0	70	0	0
6	15496122	rs16876519	A	G	30	39	69	0	0	69	0	0
6	15501726	rs41267698	G	A	66	36	102	0	2	104	0	0
6	15502823	rs2237111	A	T	89	85	174	0	0	174	0	0
6	15503546	rs2282818	A	G	67	47	114	0	1	115	0	0
6	15503575	rs2282816	C	T	78	56	134	0	1	135	0	0
6	15503696	rs10949304	G	C	72	64	136	0	0	136	0	0
6	15503725	rs11753936	C	T	87	54	141	0	2	143	0	0
6	15503726	rs11758484	G	T	88	53	141	0	2	143	0	0
6	15503919	rs2282815	C	A	100	86	186	0	1	187	0	0
6	15504589	rs760659	T	C	59	49	108	0	2	110	0	0
6	15505095	rs12214771	G	A	14	13	27	0	0	27	0	0
6	15505128	rs760658	T	C	14	16	30	0	0	30	0	0
6	15507250	rs35947355	G	A	18	11	29	0	0	29	0	0
6	15508110	rs2072824	G	A	53	20	73	0	1	74	0	0
6	15508268	rs35041707	C	T	37	36	73	0	1	74	0	0
6	15510489	.	C	G	38	36	74	0	1	75	0	0
6	15511051	rs35844314	T	C	37	32	69	0	0	69	0	0
6	15511409	rs35360051	C	T	21	25	46	0	0	46	0	0
6	15513482	rs2235258	G	A	166	207	373	0	1	374	0	0
6	15515784	rs1076636	T	C	18	23	41	0	0	41	0	0
6	15516078	rs1076635	A	G	13	11	24	0	0	24	0	0
6	15516709	rs1474587	T	C	39	31	70	0	0	70	0	0
6	15518367	rs142216788	C	T	15	16	31	0	0	31	0	0
6	15519376	rs13213814	T	C	14	11	25	0	0	25	0	0
6	15519403	rs13195001	C	T	12	8	20	0	0	20	0	0
6	15519885	rs13198512	C	T	12	14	26	0	0	26	0	0
6	15519914	rs13198533	C	T	16	14	30	0	0	30	0	0
6	15520778	rs13201824	G	T	254	205	459	0	11	470	0	0
6	15524563	rs2056943	T	C	8	3	11	0	0	11	0	0
6	15530908	rs7760564	A	G	7	8	15	0	0	15	0	0
6	15663118	rs11558324	T	C	13	16	29	0	0	29	0	0
6	16134247	rs6920309	C	T	3	3	6	0	0	6	0	0
6	16140827	rs4716048	C	G	6	0	6	0	0	6	0	0
6	16145325	rs9370867	A	G	91	86	177	0	0	177	0	0
6	16145473	rs1060901	C	T	101	65	166	0	0	166	0	0
6	16147349	rs2072781	T	C	63	61	124	0	2	126	0	0
6	17600619	rs6919110	A	G	5	3	8	0	0	8	0	0
6	17603200	rs4142551	C	A	7	4	11	0	0	11	0	0
6	17607840	rs17330323	A	C	4	5	9	0	0	9	0	0
6	17610090	rs1055111	T	G	4	8	12	0	0	12	0	0
6	17622372	rs6933829	C	A	5	3	8	0	0	8	0	0
6	17624033	rs4716166	G	A	12	7	19	0	0	19	0	0
6	17641343	rs12199496	C	T	5	4	9	0	1	10	0	0
6	17641501	rs2009377	C	T	5	3	8	0	0	8	0	0
6	17641959	rs59416896	G	A	8	0	8	0	0	8	0	0
6	17644445	rs6913935	T	G	6	1	7	0	0	7	0	0
6	17647646	rs6927877	A	C	2	4	6	0	0	6	0	0
6	17657631	.	A	T	5	1	6	0	0	6	0	0
6	17657632	.	T	A	5	1	6	0	0	6	0	0
6	17658333	rs7773218	G	T	9	6	15	0	0	15	0	0
6	17665479	rs6906499	G	C	79	77	156	0	0	156	0	0
6	17675246	rs2228375	T	C	93	56	149	0	0	149	0	0
6	17759737	rs1084	C	G	14	25	39	0	0	39	0	0
6	17764279	rs1044654	A	C	31	33	64	0	0	64	0	0
6	17764731	rs6459569	G	C	50	45	95	0	0	95	0	0
6	17764755	rs2296197	T	C	45	45	90	0	2	92	0	0
6	17770235	rs12524859	A	G	1	5	6	0	0	6	0	0
6	17781450	rs942376	G	A	34	31	65	0	0	65	0	0
6	17799575	rs3734235	A	G	21	29	50	0	1	51	0	0
6	17815310	rs10949448	C	T	9	9	18	0	0	18	0	0
6	17815431	rs6918261	G	A	6	6	12	0	0	12	0	0
6	17815716	rs6920106	C	T	4	5	9	0	0	9	0	0
6	17834198	rs4716189	T	G	32	32	64	0	4	68	0	0
6	17834213	rs4716190	T	C	40	29	69	0	1	70	0	0
6	18169114	rs72839199	C	T	9	14	23	0	0	23	0	0
6	18181724	rs78741126	A	C	6	1	7	0	0	7	0	0
6	18208319	rs214596	G	A	3	4	7	0	0	7	0	0
6	18209582	rs214590	C	T	5	3	8	0	0	8	0	0
6	18209763	rs6911008	C	T	5	3	8	0	0	8	0	0
6	18221471	rs214506	T	G	2	4	6	0	0	6	0	0
6	18223409	rs214505	C	T	37	41	78	0	0	78	0	0
6	18223511	.	C	A	18	9	27	0	0	27	0	0
6	18226340	rs214503	G	A	4	10	14	0	0	14	0	0
6	18227546	rs214502	A	C	4	8	12	0	0	12	0	0
6	18228288	.	C	T	4	6	10	0	0	10	0	0
6	18230358	rs214498	C	T	5	1	6	0	0	6	0	0
6	18231011	rs214497	G	T	4	4	8	0	0	8	0	0
6	18233986	rs200358314	T	A	6	0	6	0	0	6	0	0
6	18239787	rs214511	C	T	6	5	11	0	0	11	0	0
6	18240002	rs9367983	T	C	7	7	14	0	1	15	0	0
6	18241849	rs214509	G	C	2	8	10	0	0	10	0	0
6	18243173	rs1207038	C	T	3	5	8	0	0	8	0	0
6	18243273	rs1207037	T	C	5	10	15	0	0	15	0	0
6	18248718	rs76308289	A	T	3	4	7	0	0	7	0	0
6	18248916	rs214526	C	A	12	3	15	0	0	15	0	0
6	18249048	rs214525	A	G	15	19	34	0	0	34	0	0
6	18257078	rs214520	A	G	20	33	53	0	0	53	0	0
6	18257985	rs214519	G	T	21	17	38	0	1	39	0	0
6	18258085	rs7743778	A	G	39	32	71	0	0	71	0	0
6	18387692	rs9396858	A	G	69	28	97	0	1	98	0	0
6	18390201	rs7752879	A	C	4	4	8	0	0	8	0	0
6	18390923	rs6921254	A	G	10	2	12	0	0	12	0	0
6	18392048	rs6914967	G	A	4	5	9	0	0	9	0	0
6	18393271	rs1853589	G	T	7	0	7	0	0	7	0	0
6	18393606	rs9371054	T	C	14	2	16	0	0	16	0	0
6	18394793	rs9367994	C	T	10	1	11	0	0	11	0	0
6	18398335	rs7771828	T	G	10	1	11	0	0	11	0	0
6	18398395	rs9371055	C	G	7	3	10	0	0	10	0	0
6	18399394	rs1886248	C	T	14	3	17	0	0	17	0	0
6	18401381	rs6907980	A	G	12	2	14	0	1	15	0	0
6	18401608	rs11757097	T	G	24	4	28	0	0	28	0	0
6	18401683	rs79275651	T	C	4	28	32	0	1	33	0	0
6	18401771	.	A	G	1	13	14	0	0	14	0	0
6	18406738	rs6926132	G	A	8	2	10	0	0	10	0	0
6	18407553	rs2181800	G	C	6	1	7	0	0	7	0	0
6	18408515	rs2147219	T	C	5	1	6	0	0	6	0	0
6	18410218	rs10949503	G	A	5	1	6	0	0	6	0	0
6	18412909	rs113542413	T	C	0	8	8	0	0	8	0	0
6	18418708	rs2038745	T	C	6	0	6	0	0	6	0	0
6	18418726	rs6459616	A	G	6	0	6	0	0	6	0	0
6	18423405	rs6922849	C	G	7	0	7	0	0	7	0	0
6	18423998	rs57121361	C	A	1	9	10	0	0	10	0	0
6	20480586	rs3828858	A	G	4	3	7	0	0	7	0	0
6	20492995	rs1042317	T	C	26	31	57	0	4	61	0	0
6	20930113	rs11970030	G	C	0	8	8	0	0	8	0	0
6	21065450	rs56087852	A	G	16	9	25	0	0	25	0	0
6	21201493	rs9465994	G	A	10	7	17	0	0	17	0	0
6	21231474	rs1563727	C	G	4	5	9	0	0	9	0	0
6	21231882	rs35121088	A	T	6	9	15	0	0	15	0	0
6	21231956	rs4712591	G	A	7	5	12	0	0	12	0	0
6	24418348	rs2793422	G	A	12	19	31	0	0	31	0	0
6	24503590	rs2760118	C	T	12	6	18	0	0	18	0	0
6	24534193	rs1054899	C	A	1	6	7	0	0	7	0	0
6	24535780	rs2744602	G	A	3	9	12	0	0	12	0	0
6	24665340	rs3756819	A	C	30	36	66	0	0	66	0	0
6	24666007	rs1061925	T	G	51	54	105	0	1	106	0	0
6	24698215	rs7765904	G	A	14	11	25	0	0	25	0	0
6	24705835	rs3756814	T	C	177	161	338	0	0	338	0	0
6	24706770	rs6931809	T	C	3	3	6	0	1	7	0	0
6	24706852	rs6909099	A	C	10	14	24	0	0	24	0	0
6	24708786	rs7757919	G	T	5	12	17	0	0	17	0	0
6	24709830	rs9356943	T	C	16	13	29	0	0	29	0	0
6	24711019	rs9366580	G	A	35	43	78	0	0	78	0	0
6	24712044	rs9379685	A	G	17	14	31	0	1	32	0	0
6	24721024	rs3813686	A	C	102	74	176	0	2	178	0	0
6	24780892	rs1923185	A	C	48	41	89	0	1	90	0	0
6	24805574	rs4712850	G	T	15	9	24	0	0	24	0	0
6	24805627	rs12195807	T	G	18	15	33	0	0	33	0	0
6	24805780	rs4391258	C	A	25	15	40	0	0	40	0	0
6	24806048	rs3730	T	C	2	10	12	0	0	12	0	0
6	24806070	rs1132352	A	C	1	8	9	0	0	9	0	0
6	24806338	rs9393586	T	C	9	17	26	0	0	26	0	0
6	24806594	rs9358799	C	T	15	20	35	0	0	35	0	0
6	24810582	rs10946730	G	A	8	1	9	0	0	9	0	0
6	24811181	rs6932132	C	T	4	2	6	0	0	6	0	0
6	24811660	rs6912790	T	C	6	1	7	0	0	7	0	0
6	24811680	rs6933295	G	C	6	2	8	0	0	8	0	0
6	24811706	rs6932875	A	C	4	4	8	0	0	8	0	0
6	24825511	rs9358804	A	G	12	18	30	0	0	30	0	0
6	24836090	.	C	T	7	1	8	0	0	8	0	0
6	24841320	rs9366585	A	G	15	15	30	0	0	30	0	0
6	24844443	rs10946731	T	C	2	4	6	0	0	6	0	0
6	24946716	rs145513723	G	T	3	10	13	0	0	13	0	0
6	25015681	rs2183067	T	G	521	520	1041	0	4	1045	0	0
6	25017127	rs7767457	A	G	6	8	14	0	0	14	0	0
6	25017704	rs4712879	T	C	6	6	12	0	0	12	0	0
6	25018874	rs6456645	G	C	6	4	10	0	0	10	0	0
6	25021901	rs6930521	G	A	4	4	8	0	0	8	0	0
6	25028066	rs4712880	C	T	6	4	10	0	0	10	0	0
6	25028663	rs7743187	T	C	5	3	8	0	0	8	0	0
6	25030326	rs10946743	G	A	3	3	6	0	0	6	0	0
6	25472737	rs41271815	C	T	3	3	6	0	0	6	0	0
6	25983777	rs17528178	C	T	30	38	68	0	0	68	0	0
6	25985396	rs1130000	A	G	13	5	18	0	0	18	0	0
6	25986451	rs17587597	G	A	6	8	14	0	0	14	0	0
6	25990674	rs7766342	C	A	7	2	9	0	0	9	0	0
6	25993114	rs2032450	C	G	14	8	22	0	0	22	0	0
6	25999149	rs116201501	C	T	5	6	11	0	0	11	0	0
6	25999175	rs72834617	G	A	5	7	12	0	0	12	0	0
6	26027433	rs3752419	G	A	2	4	6	0	0	6	0	0
6	26044373	rs13195692	C	T	3	3	6	0	0	6	0	0
6	26045737	rs3752418	C	G	2	7	9	0	0	9	0	0
6	26045905	rs3752417	G	C	6	4	10	0	1	11	0	0
6	26056604	rs2230653	G	A	1039	1045	2084	0	5	2089	0	0
6	26126779	rs9467675	G	A	10	6	16	0	0	16	0	0
6	26126786	rs9467676	C	T	10	7	17	0	0	17	0	0
6	26127090	rs2282848	A	G	6	7	13	0	0	13	0	0
6	26128446	rs198811	C	T	2	7	9	0	0	9	0	0
6	26129375	rs6908263	G	A	4	2	6	0	0	6	0	0
6	26131633	.	C	T	2	9	11	0	0	11	0	0
6	26132218	rs9467677	A	G	6	5	11	0	0	11	0	0
6	26133616	rs198806	A	G	8	5	13	0	0	13	0	0
6	26137235	rs9366638	A	C	3	9	12	0	0	12	0	0
6	26137652	rs7760713	A	G	8	6	14	0	0	14	0	0
6	26137872	rs7747040	T	C	5	10	15	0	0	15	0	0
6	26158993	rs1009181	T	C	9	4	13	0	0	13	0	0
6	26184102	rs7766641	G	A	6	5	11	0	0	11	0	0
6	26198845	rs2179517	G	C	10	22	32	0	0	32	0	0
6	26199903	rs34961555	C	T	28	23	51	0	0	51	0	0
6	26200083	rs1059486	A	G	25	20	45	0	1	46	0	0
6	26205293	rs806795	G	A	4	11	15	0	0	15	0	0
6	26233387	rs10946808	A	G	6	3	9	0	0	9	0	0
6	26285560	rs2393592	A	G	10	14	24	0	0	24	0	0
6	26285683	rs2393593	T	C	7	8	15	0	0	15	0	0
6	26368938	.	C	T	11	1	12	0	0	12	0	0
6	26370572	rs34878490	C	T	4	2	6	0	0	6	0	0
6	26370657	rs9358936	A	G	6	1	7	0	0	7	0	0
6	26370659	rs9393711	C	T	6	1	7	0	0	7	0	0
6	26370707	rs9379862	T	C	7	1	8	0	0	8	0	0
6	26373507	rs13216828	G	A	7	1	8	0	0	8	0	0
6	26376103	rs3757138	A	G	12	0	12	0	0	12	0	0
6	26376161	rs1985732	A	G	9	1	10	0	0	10	0	0
6	26376368	rs28551159	A	G	6	0	6	0	0	6	0	0
6	26376832	rs13218591	T	C	4	2	6	0	0	6	0	0
6	26376868	rs9393716	A	G	6	1	7	0	0	7	0	0
6	26377385	rs9366655	C	G	10	0	10	0	0	10	0	0
6	26377546	rs1977	A	G	9	2	11	0	0	11	0	0
6	26377573	rs1978	T	A	8	2	10	0	0	10	0	0
6	26377591	rs1979	G	T	8	2	10	0	0	10	0	0
6	26377927	rs68072215	T	C	7	4	11	0	0	11	0	0
6	26377939	rs66823108	G	A	8	4	12	0	0	12	0	0
6	26378288	rs72841536	T	A	10	1	11	0	0	11	0	0
6	26392515	rs2072803	G	C	3	5	8	0	0	8	0	0
6	26393021	rs1614887	G	A	2	5	7	0	0	7	0	0
6	26404374	rs3799378	A	G	3	5	8	0	0	8	0	0
6	26404958	rs10456045	G	A	4	4	8	0	0	8	0	0
6	26406255	.	G	A	6	0	6	0	0	6	0	0
6	26409890	rs41266839	G	C	3	3	6	0	0	6	0	0
6	26414425	rs3208733	C	T	7	3	10	0	0	10	0	0
6	26463271	rs3823158	T	A	2	4	6	0	0	6	0	0
6	26463321	rs3734540	A	C	6	1	7	0	0	7	0	0
6	26463574	rs13195401	G	T	10	8	18	0	1	19	0	0
6	26463575	rs13195402	G	T	10	9	19	0	0	19	0	0
6	26463660	rs13195509	G	A	13	7	20	0	0	20	0	0
6	26466389	rs1977199	G	A	6	1	7	0	0	7	0	0
6	26466392	rs1977200	G	A	6	1	7	0	0	7	0	0
6	26467182	rs3799380	T	C	1	5	6	0	0	6	0	0
6	26467832	.	G	A	4	3	7	0	0	7	0	0
6	26468326	rs3734542	G	A	27	18	45	0	0	45	0	0
6	26468545	rs3734543	G	C	19	15	34	0	0	34	0	0
6	26468660	rs3734544	G	A	25	18	43	0	0	43	0	0
6	26540166	rs6932865	C	A	2	4	6	0	0	6	0	0
6	26540178	rs6933176	G	A	2	5	7	0	0	7	0	0
6	26545632	rs4871	G	A	62	46	108	0	0	108	0	0
6	26597893	rs7767847	A	T	21	35	56	0	1	57	0	0
6	26598004	rs4634439	A	G	32	21	53	0	0	53	0	0
6	26598188	rs3800303	A	G	190	171	361	0	6	367	0	0
6	26599509	rs45527431	A	G	20	5	25	0	0	25	0	0
6	27093821	rs6456768	G	C	3	5	8	0	0	8	0	0
6	27114052	rs9393790	G	T	3	12	15	0	0	15	0	0
6	27418847	rs7509	T	G	10	5	15	0	0	15	0	0
6	27420588	rs61736957	G	A	25	23	48	0	0	48	0	0
6	27425185	rs1883216	C	A	31	26	57	0	0	57	0	0
6	27775674	rs200484	A	G	15	14	29	0	0	29	0	0
6	27782528	rs401763	T	C	8	0	8	0	0	8	0	0
6	27815167	.	G	A	2	4	6	0	0	6	0	0
6	27833174	rs200981	A	G	22	18	40	0	1	41	0	0
6	27835218	rs17763089	G	A	94	85	179	0	15	194	0	0
6	27835272	rs200948	T	C	96	99	195	0	2	197	0	0
6	27858421	rs200973	A	G	5	4	9	0	0	9	0	0
6	28057260	.	T	C	7	4	11	0	0	11	0	0
6	28097193	rs4713140	G	A	4	2	6	0	0	6	0	0
6	28124114	rs13205911	C	T	14	15	29	0	0	29	0	0
6	28126840	rs9468300	C	T	62	57	119	0	0	119	0	0
6	28239915	rs11965538	G	A	6	0	6	0	0	6	0	0
6	28264692	rs3800325	C	G	5	4	9	0	0	9	0	0
6	28268824	rs33932084	A	G	2	5	7	0	0	7	0	0
6	28331127	rs13201752	A	G	1	5	6	0	0	6	0	0
6	28331128	rs13201753	A	C	1	5	6	0	0	6	0	0
6	28346910	rs7774981	T	C	6	17	23	0	0	23	0	0
6	28346945	rs7754960	G	C	4	17	21	0	1	22	0	0
6	28347013	rs7775132	T	C	4	9	13	0	0	13	0	0
6	28350239	rs2232440	G	T	13	5	18	0	0	18	0	0
6	28350240	rs2232439	C	G	13	5	18	0	0	18	0	0
6	28351728	rs1591913	C	T	2	4	6	0	0	6	0	0
6	28354250	rs3799499	G	T	2	5	7	0	0	7	0	0
6	28355710	rs77082598	G	T	5	3	8	0	1	9	0	0
6	28357966	rs9468365	A	T	2	4	6	0	0	6	0	0
6	28358195	rs2859379	C	T	13	1	14	0	0	14	0	0
6	28358320	rs1361385	A	G	2	11	13	0	0	13	0	0
6	28358335	rs1416918	G	C	2	12	14	0	0	14	0	0
6	28360659	rs2232426	G	C	4	13	17	0	0	17	0	0
6	28366151	rs2232423	A	G	10	28	38	0	0	39	1	0
6	28891176	rs2230683	T	C	10	7	17	0	0	17	0	0
6	28891458	rs1061625	T	C	7	4	11	0	0	11	0	0
6	29691772	rs2076179	T	C	6	12	18	0	0	18	0	0
6	29691857	rs2072895	C	G	6	10	16	0	0	16	0	0
6	29693938	rs2735061	G	A	5	5	10	0	0	10	0	0
6	29693969	rs1736922	C	T	5	1	6	0	0	6	0	0
6	29695854	rs2735059	G	A	4	2	6	0	0	6	0	0
6	29696656	rs885947	G	A	1	6	7	0	0	7	0	0
6	29696657	rs885946	T	C	1	6	7	0	0	7	0	0
6	29910358	rs1143146	C	G	693	865	1558	0	2	1560	0	0
6	29910402	rs1136656	G	A	941	1001	1942	0	26	1969	1	0
6	29910429	.	C	G	24	39	63	0	0	63	0	0
6	29910457	rs9260125	T	G	23	14	37	0	0	37	0	0
6	29910473	rs41561116	G	A	25	1	26	0	0	26	0	0
6	29910478	rs9260127	G	C	25	1	26	0	1	27	0	0
6	29910482	rs9256980	G	A	26	1	27	0	0	27	0	0
6	29910508	rs9260129	A	G	29	0	29	0	0	29	0	0
6	29910522	rs9260130	G	C	35	14	49	0	0	49	0	0
6	29910527	.	C	T	34	15	49	0	0	49	0	0
6	29910558	rs2075684	T	C	956	946	1902	0	6	1908	0	0
6	29910663	rs707910	G	A	1416	1192	2608	0	17	2625	0	0
6	29910716	rs1059455	C	G	1506	1021	2527	0	2	2530	1	0
6	29910725	rs199474430	C	G	1387	766	2153	0	11	2165	1	0
6	29910730	rs199474436	T	A	1337	634	1971	0	31	2002	0	0
6	29910731	rs79361534	G	A	657	1320	1977	0	10	1987	0	0
6	29910767	rs1136689	G	C	1702	2	1704	0	8	1712	0	0
6	29910801	rs1136692	C	A	383	1590	1973	0	17	1990	0	0
6	29910861	rs41555717	A	G	304	388	692	0	6	698	0	0
6	29910910	rs9260146	C	T	381	261	642	0	2	644	0	0
6	29910923	rs9260147	C	T	332	250	582	0	0	582	0	0
6	29910947	rs41545815	T	A	235	293	528	0	3	531	0	0
6	29911056	rs1071743	A	C	1558	789	2347	0	23	2370	0	0
6	29911064	rs1136695	A	G	1659	793	2452	0	24	2477	1	0
6	29911069	rs1136697	A	T	1681	837	2518	0	35	2553	0	0
6	29911086	rs1136700	T	C	1309	1466	2775	0	7	2782	0	0
6	29911114	rs3173420	G	A	1797	829	2626	0	10	2636	0	0
6	29911115	rs1059498;rs12721717	G	C	1812	835	2647	0	4	2651	0	0
6	29911119	rs3173419	G	T	1867	965	2832	0	7	2840	1	0
6	29911154	rs1059509	C	A	2026	1747	3773	0	16	3790	1	0
6	29911190	rs1059514	G	A	2179	1621	3800	0	22	3823	1	0
6	29911222	rs1059535	C	T	1625	1156	2781	0	10	2792	1	0
6	29911246	.	C	T	1094	92	1186	0	4	1190	0	0
6	29911260	rs543623321	A	C	1377	458	1835	0	31	1866	0	0
6	29911261	.	C	G	1440	460	1900	0	5	1906	1	0
6	29911344	rs17878838	C	A	250	577	827	0	4	831	0	0
6	29911356	rs3132687	G	A	644	226	870	0	3	873	0	0
6	29911360	rs17878860	A	G	256	601	857	0	6	863	0	0
6	29911419	.	A	G	212	387	599	0	5	604	0	0
6	29911534	rs75439900	A	C	238	486	724	0	3	727	0	0
6	29911538	rs2735111	G	A	237	527	764	0	21	786	1	0
6	29911545	rs76475517	G	A	261	628	889	0	2	891	0	0
6	29911571	rs29028728	G	C	277	715	992	0	6	998	0	0
6	29911604	rs77467746	C	A	308	725	1033	0	11	1044	0	0
6	29911684	rs9260164	C	T	734	301	1035	0	9	1044	0	0
6	29911727	rs29028878	T	C	335	933	1268	0	9	1277	0	0
6	29911837	rs17879578	G	A	487	971	1458	0	9	1467	0	0
6	29911951	rs1059570	C	T	1819	2054	3873	0	25	3898	0	0
6	29911957	rs12721755	G	A	1790	1923	3713	0	23	3736	0	0
6	29912041	rs9260181	C	T	1614	795	2409	0	13	2423	1	0
6	29912086	rs199474634	G	A	1907	591	2498	0	15	2513	0	0
6	29912098	rs1059638;rs142475339	G	A	2038	576	2614	0	16	2632	2	0
6	29912280	rs1136903	T	C	2880	1437	4317	0	29	4347	1	0
6	29912281	rs1136917	G	A	2986	1434	4420	0	17	4438	1	0
6	29912297	rs1136949	A	G	3153	1957	5110	0	33	5143	0	0
6	29912368	rs1141891	C	T	3230	738	3968	0	66	4035	1	0
6	29912386	rs1137160	G	C	3127	612	3739	0	24	3765	2	0
6	29912562	rs17880291	T	G	105	16	121	0	0	121	0	0
6	29912564	rs17885126	A	C	102	16	118	0	1	119	0	0
6	29912594	.	C	T	93	146	239	0	0	239	0	0
6	29912649	rs17887246	G	C	138	176	314	0	1	315	0	0
6	29912656	rs17885779	C	T	153	134	287	0	0	287	0	0
6	29912668	rs9260201	T	G	154	101	255	0	9	264	0	0
6	29912680	rs17884187	A	G	173	105	278	0	1	279	0	0
6	29912687	rs17883986	C	T	177	141	318	0	3	321	0	0
6	29912713	rs17879496	C	T	183	202	385	0	12	397	0	0
6	29912852	rs1137296	T	C	2609	303	2912	0	278	3190	0	0
6	29912856	rs2231119	A	T	2914	293	3207	0	30	3237	0	0
6	29912938	rs147947139	C	A	67	123	190	0	1	191	0	0
6	29913098	rs3129015	C	T	144	70	214	0	1	215	0	0
6	29913137	rs3132686	A	G	126	65	191	0	1	192	0	0
6	29913171	rs2975057	G	A	68	83	151	0	1	152	0	0
6	29913191	rs2975055	T	C	65	54	119	0	1	120	0	0
6	29913192	rs9260210	G	A	59	55	114	0	0	114	0	0
6	29913201	rs41557912	T	G	64	47	111	0	1	112	0	0
6	29913344	rs13395	G	A	2506	2663	5169	0	31	5200	0	0
6	29913374	rs1061815	C	G	2928	2321	5249	0	18	5268	1	0
6	29913430	rs112863520	C	T	2764	1796	4560	0	20	4580	0	0
6	29913449	rs66585529	C	G	1487	2349	3836	0	24	3860	0	0
6	29913630	rs2975053	A	T	228	12	240	0	1	241	0	0
6	29913639	rs2975052	A	G	102	8	110	0	0	110	0	0
6	30032522	rs8321	A	C	113	84	197	0	1	198	0	0
6	30152467	rs11158	G	T	72	70	142	0	4	146	0	0
6	30153363	rs2106072	G	A	59	51	110	0	3	113	0	0
6	30230768	rs3130399	A	T	4	3	7	0	0	7	0	0
6	30260019	rs1264619	G	C	7	12	19	0	0	19	0	0
6	30310294	rs111893696	A	G	17	16	33	0	0	33	0	0
6	30460755	.	C	T	1028	1053	2081	0	9	2090	0	0
6	30515043	rs3130247	T	C	57	89	146	0	0	146	0	0
6	30522077	.	C	T	4	3	7	0	0	7	0	0
6	30546417	rs117190360	T	G	3	3	6	0	0	6	0	0
6	30548676	rs1264443	T	C	16	8	24	0	1	25	0	0
6	30552610	rs1264438	C	G	5	2	7	0	0	7	0	0
6	30553871	rs1264437	C	T	4	11	15	0	0	15	0	0
6	30555062	rs1264436	C	T	24	19	43	0	0	43	0	0
6	30555146	rs9262118	G	C	15	21	36	0	1	37	0	0
6	30560861	rs1264433	G	A	7	7	14	0	1	15	0	0
6	30562021	rs1264432	G	A	5	6	11	0	0	11	0	0
6	30562671	rs1264431	C	G	2	5	7	0	0	7	0	0
6	30574428	rs116199391	A	G	8	8	16	0	1	17	0	0
6	30609629	rs3094104	A	G	3	4	7	0	0	7	0	0
6	30609661	rs3132608	T	C	3	3	6	0	0	6	0	0
6	30611350	rs9262132	C	A	7	8	15	0	0	15	0	0
6	30611968	rs2269708	T	C	9	6	15	0	0	15	0	0
6	30615603	rs117903822	A	G	6	8	14	0	1	15	0	0
6	30616815	rs117649655	G	T	1	7	8	0	0	8	0	0
6	30617134	rs147373216	A	G	4	5	9	0	0	9	0	0
6	30618906	rs9262135	A	G	9	6	15	0	0	15	0	0
6	30620528	rs41273001	G	A	8	6	14	0	0	14	0	0
6	30644359	rs16897791	G	T	529	487	1016	0	4	1020	0	0
6	30644524	rs2269707	A	G	643	636	1279	0	8	1287	0	0
6	30645546	rs3132592	T	C	3	6	9	0	1	10	0	0
6	30646137	rs60581175	C	T	2	4	6	0	0	6	0	0
6	30646724	rs73422011	T	C	4	5	9	0	0	9	0	0
6	30647398	rs117003728	C	T	6	9	15	0	0	15	0	0
6	30647784	rs73422013	A	G	6	6	12	0	0	12	0	0
6	30648629	rs9468806	G	A	6	3	9	0	0	9	0	0
6	30648819	rs9468808	G	A	5	1	6	0	0	6	0	0
6	30649134	rs6457254	C	T	6	3	9	0	0	9	0	0
6	30649540	rs7745278	A	G	8	10	18	0	0	18	0	0
6	30649931	rs2239887	C	G	1	7	8	0	0	8	0	0
6	30650860	rs117580792	G	T	2	4	6	0	0	6	0	0
6	30652781	rs9262143	C	T	334	291	625	0	2	627	0	0
6	30654390	rs56269849	G	A	100	97	197	0	15	212	0	0
6	30656398	rs2249059	T	C	101	103	204	0	0	204	0	0
6	30658385	rs2269703	C	T	5	2	7	0	0	7	0	0
6	30668143	rs118122910	A	C	40	41	81	0	1	82	0	0
6	30670700	rs2239886	A	C	5	5	10	0	0	10	0	0
6	30671452	rs77465266	T	C	41	53	94	0	0	94	0	0
6	30671760	rs75355880	C	T	28	34	62	0	0	62	0	0
6	30671969	rs80087328	G	C	31	50	81	0	0	81	0	0
6	30672718	rs74590481	G	A	22	31	53	0	6	59	0	0
6	30673113	rs79216909	G	T	17	28	45	0	0	45	0	0
6	30673163	rs115919262	T	G	25	2	27	0	1	28	0	0
6	30673177	.	A	G	27	4	31	0	4	35	0	0
6	30673186	rs143042499	C	T	31	3	34	0	4	38	0	0
6	30673422	rs9461623	A	G	53	26	79	0	4	83	0	0
6	30673489	rs9295905	G	C	37	16	53	0	0	53	0	0
6	30674126	rs9501482	T	C	4	2	6	0	0	6	0	0
6	30674183	rs9501483	G	T	4	2	6	0	0	6	0	0
6	30676046	rs28986466	C	G	16	12	28	0	0	28	0	0
6	30680562	rs28986465	G	A	13	17	30	0	0	30	0	0
6	30680608	rs2075015	C	T	17	19	36	0	0	36	0	0
6	30688575	rs3132583	G	C	2	4	6	0	0	6	0	0
6	30689001	rs3132582	T	A	3	4	7	0	0	7	0	0
6	30689503	rs73727463	C	T	4	4	8	0	0	8	0	0
6	30690938	rs25527	C	T	9	6	15	0	0	15	0	0
6	30691490	rs25497	G	A	578	400	978	0	5	983	0	0
6	30692230	rs9468815	G	T	587	343	930	0	12	943	1	0
6	30692231	rs9468816	C	T	589	350	939	0	5	944	0	0
6	30692754	rs199949106	C	T	319	182	501	0	1	502	0	0
6	30693007	rs9500863	G	A	307	264	571	0	4	575	0	0
6	30696086	rs41270533	C	T	7	1	8	0	0	8	0	0
6	30696790	rs9501027	C	T	8	1	9	0	0	9	0	0
6	30697523	rs9500866	C	T	5	3	8	0	0	8	0	0
6	30697561	rs9501028	T	C	4	3	7	0	0	7	0	0
6	30697931	rs9500867	T	C	445	174	619	0	2	621	0	0
6	30699022	rs3095327	G	A	3	5	8	0	0	8	0	0
6	30699070	rs3778628	T	C	5	3	8	0	0	8	0	0
6	30700044	rs2284172	C	A	7	6	13	0	0	13	0	0
6	30701092	rs3130658	C	T	2	9	11	0	0	11	0	0
6	30706361	rs3130660	T	A	3	5	8	0	0	8	0	0
6	30708695	rs3130661	C	T	4	21	25	0	0	25	0	0
6	30708955	rs1059612	C	T	9	41	50	0	2	52	0	0
6	30709357	rs3094125	G	A	10	33	43	0	1	44	0	0
6	30712327	rs2301277	G	A	3	6	9	0	0	9	0	0
6	30857072	rs2229933	G	C	21	8	29	0	0	29	0	0
6	30858857	rs1049622	C	T	25	17	42	0	0	42	0	0
6	30862423	rs1264319	C	T	11	21	32	0	0	32	0	0
6	30867106	rs1049628	C	T	41	21	62	0	0	62	0	0
6	30867527	rs1049633	G	A	39	50	89	0	3	92	0	0
6	30867666	rs8408	T	C	43	26	69	0	5	74	0	0
6	30876034	rs2074510	G	T	5	5	10	0	0	10	0	0
6	30876152	rs1052693	C	T	15	11	26	0	0	26	0	0
6	30877760	rs1419693	A	C	12	13	25	0	0	25	0	0
6	30882415	rs1264304	C	T	3	3	6	0	0	6	0	0
6	30886131	rs560864342	C	T	3	3	6	0	0	6	0	0
6	30887972	rs2285319	C	T	23	23	46	0	0	46	0	0
6	30888161	rs2249464	T	C	18	23	41	0	1	42	0	0
6	30889260	rs2517467	G	A	2	6	8	0	0	8	0	0
6	30893127	rs9394021	G	A	10	15	25	0	0	25	0	0
6	30893941	rs4678	G	A	54	36	90	0	0	90	0	0
6	31110391	rs1576	G	C	20	19	39	0	0	39	0	0
6	31110671	rs1265085	G	C	7	5	12	0	0	12	0	0
6	31112737	rs130079	C	A	17	12	29	0	0	29	0	0
6	31116210	rs130071	G	A	5	16	21	0	0	21	0	0
6	31116502	rs2027937	C	T	17	17	34	0	0	34	0	0
6	31118511	rs130067	T	G	7	9	16	0	0	16	0	0
6	31122482	rs130076	G	A	11	8	19	0	0	19	0	0
6	31122500	rs130065	G	A	10	11	21	0	0	21	0	0
6	31129310	rs7750641	C	T	12	7	19	0	0	19	0	0
6	31130760	rs1841	A	G	14	8	22	0	0	22	0	0
6	31163094	rs9501508	C	T	6	1	7	0	0	7	0	0
6	31163106	rs7743722	C	G	8	2	10	0	0	10	0	0
6	31163161	rs3134786	A	T	3	11	14	0	0	14	0	0
6	31163632	rs9501509	G	A	11	6	17	0	0	17	0	0
6	31163638	rs3094612	G	C	6	11	17	0	0	17	0	0
6	31163667	rs9501510	G	A	9	3	12	0	0	12	0	0
6	31163682	.	A	G	7	0	7	0	1	8	0	0
6	31164224	rs9501070	C	G	8	12	20	0	0	20	0	0
6	31164471	rs9501071	C	G	9	5	14	0	0	14	0	0
6	31164495	rs9501072	G	A	8	6	14	0	0	14	0	0
6	31164511	rs9501073	C	T	10	4	14	0	0	14	0	0
6	31164549	rs9500882	A	G	13	2	15	0	0	15	0	0
6	31164779	rs28362333	T	C	15	4	19	0	0	19	0	0
6	31164845	.	C	A	9	18	27	0	0	27	0	0
6	31164849	rs28362335	G	A	19	9	28	0	0	28	0	0
6	31164901	rs28362336	T	G	23	7	30	0	0	30	0	0
6	31164906	rs78517503	G	A	23	7	30	0	0	30	0	0
6	31164968	rs9501074	C	A	15	4	19	0	0	19	0	0
6	31165100	rs9500883	A	C	19	12	31	0	0	31	0	0
6	31165177	rs9501075	C	T	13	12	25	0	0	25	0	0
6	31165218	rs9501076	C	T	17	7	24	0	0	24	0	0
6	31236590	rs115510686	T	C	603	336	939	0	9	948	0	0
6	31236668	rs1130576	T	C	1307	692	1999	0	10	2010	1	0
6	31236690	rs1130592	T	G	1752	958	2710	0	69	2779	0	0
6	31236767	rs1049579	G	A	2382	1437	3819	0	15	3834	0	0
6	31236800	rs116229144	G	A	2311	1547	3858	0	9	3867	0	0
6	31236813	rs1049663	C	A	2272	1481	3753	0	18	3771	0	0
6	31236821	rs1049668	C	T	2345	1524	3869	0	17	3886	0	0
6	31236854	rs1049709	T	C	1542	1992	3534	0	14	3548	0	0
6	31236959	rs192019825	C	A	43	22	65	0	1	66	0	0
6	31237014	rs3998381	G	A	22	8	30	0	2	32	0	0
6	31237016	rs41544314	C	T	24	8	32	0	0	32	0	0
6	31237048	rs9264594	A	G	17	15	32	0	0	32	0	0
6	31237124	rs1130838	T	C	2339	1798	4137	0	29	4166	0	0
6	31237162	rs35708511	C	G	2127	1164	3291	0	13	3304	0	0
6	31237230	rs9264596	A	G	51	56	107	0	1	108	0	0
6	31237255	rs2523609	G	A	56	55	111	0	0	111	0	0
6	31237323	rs68094471	A	G	58	359	417	0	2	419	0	0
6	31237333	rs66772001	T	A	63	354	417	0	6	423	0	0
6	31237353	rs67827555	T	C	64	366	430	0	3	433	0	0
6	31237405	rs56010430	C	T	85	296	381	0	5	386	0	0
6	31237437	rs66459704	T	C	98	298	396	0	2	398	0	0
6	31237449	rs68037221	T	C	94	290	384	0	2	386	0	0
6	31237463	rs66620546	C	G	92	314	406	0	3	409	0	0
6	31237513	rs72558159	T	C	63	227	290	0	3	293	0	0
6	31237563	rs3819287	C	T	79	192	271	0	2	273	0	0
6	31237571	rs72558157	A	G	85	153	238	0	1	239	0	0
6	31237592	rs9264606	A	C	81	229	310	0	2	312	0	0
6	31237636	rs41541318	T	G	72	265	337	0	0	338	1	0
6	31237660	rs9264608	A	G	70	165	235	0	1	236	0	0
6	31237664	rs9264609	C	T	68	185	253	0	1	254	0	0
6	31237723	rs9264610	G	A	67	72	139	0	2	141	0	0
6	31237727	rs2074497	T	C	63	72	135	0	2	137	0	0
6	31237760	rs1143551	C	T	2531	29	2560	0	17	2578	1	0
6	31237761	rs41560617	A	G	2478	30	2508	0	45	2554	1	0
6	31237762	rs41540416	C	T	2493	29	2522	0	16	2538	0	0
6	31237767	rs1130935	T	C	2418	12	2430	0	72	2503	1	0
6	31237771	rs1050106	G	A	2500	1	2501	0	12	2513	0	0
6	31237773	rs1130947	T	C	2447	2	2449	0	9	2458	0	0
6	31237786	.	A	T	2532	0	2532	0	16	2549	1	0
6	31237802	.	A	G	2459	5	2464	0	18	2482	0	0
6	31237821	rs41545712	C	A	2801	52	2853	0	12	2866	1	0
6	31237833	rs1050180	T	A	2602	52	2654	0	107	2763	2	0
6	31237835	rs1065600	A	T	2650	53	2703	0	38	2742	1	0
6	31237858	rs34794906	T	C	2468	42	2510	0	17	2528	1	0
6	31237876	rs9264622	A	G	63	27	90	0	0	90	0	0
6	31237893	rs72558154	G	T	57	44	101	0	0	101	0	0
6	31237896	rs41557915	C	A	55	45	100	0	3	103	0	0
6	31237950	rs9264623	T	C	57	15	72	0	0	72	0	0
6	31237955	rs9264624	T	G	56	5	61	0	1	62	0	0
6	31237960	rs9264625	G	C	57	3	60	0	0	60	0	0
6	31237962	rs9264626	T	C	53	3	56	0	1	57	0	0
6	31237963	rs9264627	G	A	53	3	56	0	0	56	0	0
6	31237971	.	C	T	59	0	59	0	2	61	0	0
6	31237975	.	T	C	57	0	57	0	1	58	0	0
6	31237987	rs41556321	C	T	2496	2	2498	0	9	2507	0	0
6	31237991	rs2308628	G	T	2524	3	2527	0	10	2537	0	0
6	31238001	rs41546713	A	C	2528	35	2563	0	3	2567	1	0
6	31238002	rs41558713	G	A	2541	37	2578	0	4	2582	0	0
6	31238009	rs1131014	T	C	2465	343	2808	0	28	2837	1	0
6	31238029	rs2308622	T	C	2319	510	2829	0	34	2863	0	0
6	31238048	rs41542914	C	T	2548	712	3260	0	20	3280	0	0
6	31238135	rs1050317	G	A	2095	1133	3228	0	13	3241	0	0
6	31238138	rs1050320	C	T	2075	1174	3249	0	19	3268	0	0
6	31238230	rs1050716	G	C	2080	590	2670	0	24	2898	204	0
6	31238234	rs1050344	G	A	2358	608	2966	0	16	2983	1	0
6	31238259	rs1131096	G	C	2222	638	2860	0	7	2867	0	0
6	31238297	rs9264636	C	T	34	48	82	0	0	82	0	0
6	31238308	rs9264637	G	C	44	54	98	0	0	98	0	0
6	31238364	rs41544416	G	A	34	26	60	0	0	60	0	0
6	31238372	rs9264640	C	G	36	20	56	0	1	57	0	0
6	31238406	rs41543713	C	G	34	43	77	0	0	77	0	0
6	31238428	rs41540812	A	T	36	54	90	0	1	91	0	0
6	31238490	rs9264642	T	C	26	36	62	0	0	62	0	0
6	31238492	rs9264643	C	A	27	36	63	0	0	63	0	0
6	31238589	rs41549515	T	C	36	54	90	0	2	92	0	0
6	31238613	rs9264647	A	G	38	49	87	0	1	88	0	0
6	31238662	rs9264649	A	G	31	29	60	0	0	60	0	0
6	31238695	rs41547523	G	C	31	24	55	0	0	56	1	0
6	31238716	rs41550819	A	G	34	20	54	0	1	55	0	0
6	31238728	.	G	C	28	18	46	0	0	46	0	0
6	31238759	rs17884428	C	T	25	16	41	0	0	41	0	0
6	31238762	rs9264652	T	C	24	19	43	0	0	43	0	0
6	31238851	.	T	C	1809	678	2487	0	8	2495	0	0
6	31238889	rs2308598	T	C	3529	271	3800	0	16	3816	0	0
6	31238909	rs1050686	G	T	3636	63	3699	0	9	3709	1	0
6	31238910	rs1050685	T	C	3562	63	3625	0	35	3660	0	0
6	31238942	rs2308590	G	T	1349	164	1513	0	7	2381	861	0
6	31238970	rs142570222	T	A	3154	295	3449	0	14	3463	0	0
6	31238983	rs2308585	G	C	3207	313	3520	0	10	3530	0	0
6	31238992	rs41550715	G	C	1276	2270	3546	0	11	3558	1	0
6	31239050	rs713032	G	A	1377	850	2227	0	8	2237	2	0
6	31239057	rs2308575	C	T	1374	876	2250	0	5	2255	0	0
6	31239114	rs1071649	G	T	1307	320	1627	0	12	1649	10	0
6	31239124	rs41543218	C	A	1310	256	1566	0	6	1574	2	0
6	31239141	.	C	T	11	0	11	0	0	11	0	0
6	31239151	rs67420880	A	C	8	0	8	0	0	8	0	0
6	31239205	rs9264663	C	T	107	58	165	0	2	167	0	0
6	31239232	rs41557317	G	A	143	102	245	0	0	245	0	0
6	31239279	rs9264665	T	C	220	48	268	0	9	277	0	0
6	31239284	rs41562920	T	A	224	51	275	0	5	280	0	0
6	31239296	rs9264666	G	C	240	71	311	0	2	313	0	0
6	31239363	rs41546813	C	T	264	66	330	0	4	334	0	0
6	31239378	rs1131123	T	G	1522	411	1933	0	11	1945	1	0
6	31239407	rs17408553	G	T	1486	865	2351	0	16	2367	0	0
6	31239417	rs2308557	C	T	1446	904	2350	0	44	2395	1	0
6	31239449	rs28626310	C	G	1119	1319	2438	0	18	2456	0	0
6	31239577	rs707911	A	C	1832	473	2305	0	13	2369	51	0
6	31239622	rs9264668	C	A	2177	294	2471	0	11	3097	615	0
6	31239681	rs9264669	A	T	89	63	152	0	3	155	0	0
6	31239752	rs9264671	C	T	91	66	157	0	2	159	0	0
6	31239776	rs2074493	A	C	950	192	1142	0	3	1145	0	0
6	31239790	rs41549413	G	A	885	210	1095	0	4	1099	0	0
6	31239802	rs1050451	C	G	773	219	992	0	2	994	0	0
6	31239829	rs41548123;rs41548414	C	T	620	152	772	0	4	777	1	0
6	31239855	rs7767581	C	G	152	16	168	0	0	168	0	0
6	31239868	rs9264674	G	C	18	5	23	0	0	23	0	0
6	31248169	rs2853942	C	T	7	0	7	0	0	7	0	0
6	31248256	rs17192302	C	T	12	0	12	0	0	12	0	0
6	31324194	rs3179865	G	A	2807	915	3722	0	15	3737	0	0
6	31324200	rs1140412	G	C	2845	523	3368	0	12	3380	0	0
6	31324206	rs1131235	G	A	2909	0	2909	0	10	2958	39	0
6	31324227	rs4999716	C	A	28	0	28	0	0	28	0	0
6	31324516	rs1131215	C	A	3011	789	3800	0	12	3813	1	0
6	31324547	rs1065386	G	C	3208	230	3438	0	6	3444	0	0
6	31324549	rs1050570	T	C	3199	230	3429	0	12	3441	0	0
6	31324586	rs1050556	C	T	3525	344	3869	0	19	3890	2	0
6	31324603	rs9266178	C	T	3229	268	3497	0	15	3514	2	0
6	31324604	.	T	C	3206	266	3472	0	17	3489	0	0
6	31324615	rs1050529	C	T	2928	283	3211	0	14	3225	0	0
6	31324641	rs1050518	T	A	2245	119	2364	0	17	2382	1	0
6	31324664	rs9266184	T	G	1684	188	1872	0	24	1896	0	0
6	31324666	rs713031	A	T	1625	184	1809	0	20	1832	3	0
6	31324750	rs41558815	G	A	181	2	183	0	1	184	0	0
6	31324788	rs9266193	T	C	164	2	166	0	8	174	0	0
6	31324790	rs9266194	A	G	171	2	173	0	1	174	0	0
6	31324829	rs9266196	G	C	176	11	187	0	1	188	0	0
6	31324830	rs9266197	G	A	176	11	187	0	2	189	0	0
6	31324847	rs9266198	C	G	164	16	180	0	1	181	0	0
6	31324921	rs1050459	C	T	1067	543	1610	0	6	1616	0	0
6	31324925	rs1050458	A	G	969	362	1331	0	3	1334	0	0
6	31324931	rs9266206	A	C	871	246	1117	0	6	1123	0	0
6	31324953	rs9266207	C	T	66	26	92	0	0	92	0	0
6	31378751	rs2853982	A	G	5	2	7	0	1	8	0	0
6	31378768	rs2853981	A	G	6	2	8	0	0	8	0	0
6	31378956	rs1051790	C	G	11	11	22	0	0	22	0	0
6	31379115	rs1131896	G	A	14	19	33	0	0	33	0	0
6	31379134	rs1131897	C	G	19	21	40	0	0	40	0	0
6	31379817	rs1140700	T	C	19	10	29	0	0	29	0	0
6	31379931	rs1063635	G	A	13	8	21	0	0	21	0	0
6	31382911	rs1882	A	G	19	24	43	0	0	43	0	0
6	31431691	rs2255221	G	T	7	11	18	0	0	18	0	0
6	31431813	rs3130907	A	G	12	6	18	0	0	18	0	0
6	31432006	rs2263318	G	A	4	3	7	0	0	7	0	0
6	31462749	.	T	C	16	0	16	0	0	16	0	0
6	31462754	.	G	C	16	0	16	0	0	16	0	0
6	31473561	rs1065075	A	G	28	15	43	0	0	43	0	0
6	31473957	rs3134900	C	G	22	14	36	0	0	36	0	0
6	31474000	rs1051788	G	A	25	14	39	0	4	43	0	0
6	31475624	rs374353214	G	C	4	16	20	0	0	20	0	0
6	31475655	rs9380260	G	A	3	21	24	0	0	24	0	0
6	31475913	rs2844499	A	T	9	2	11	0	0	11	0	0
6	31476297	rs62395355	C	A	3	14	17	0	0	17	0	0
6	31476458	rs3130614	T	A	12	8	20	0	0	20	0	0
6	31499603	rs3853601	C	G	101	99	200	0	4	204	0	0
6	31501558	rs1055384	C	T	162	156	318	0	2	320	0	0
6	31506691	rs2071596	G	A	9	7	16	0	0	16	0	0
6	31507427	.	G	A	8	8	16	0	0	16	0	0
6	31555392	rs2256974	C	A	1	15	16	0	0	16	0	0
6	31555657	rs3135041	A	G	19	11	30	0	0	30	0	0
6	31595487	rs2736171	A	G	5	5	10	0	0	10	0	0
6	31596138	rs3132450	A	G	20	10	30	0	0	30	0	0
6	31598489	rs3130626	A	G	245	243	488	0	9	497	0	0
6	31599594	rs10947220	A	G	28	11	39	0	0	39	0	0
6	31601012	rs2844466	T	C	2	20	22	0	0	22	0	0
6	31601843	rs3115663	T	C	14	16	30	0	0	30	0	0
6	31602967	rs1046089	G	A	617	520	1137	0	7	1144	0	0
6	31603189	rs11538264	G	A	579	574	1153	0	6	1160	1	0
6	31603591	rs2261033	A	G	21	10	31	0	1	32	0	0
6	31603770	rs11229	A	G	576	555	1131	0	4	1135	0	0
6	31604591	rs10885	C	T	588	503	1091	0	7	1098	0	0
6	31604842	rs3817659	G	A	495	540	1035	0	8	1043	0	0
6	31605448	rs7889	C	G	5	14	19	0	0	19	0	0
6	31609272	rs3130628	T	C	34	12	46	0	0	46	0	0
6	31610384	rs1077394	C	T	7	4	11	0	0	11	0	0
6	31610479	rs3130047	C	T	7	4	11	0	1	12	0	0
6	31611746	rs7770976	G	A	161	169	330	0	10	340	0	0
6	31613739	rs3130048	T	C	14	9	23	0	0	23	0	0
6	31614102	rs2242656	C	T	6	3	9	0	0	9	0	0
6	31615514	rs10484558	T	C	181	184	365	0	3	368	0	0
6	31619576	rs3117583	A	G	11	12	23	0	0	23	0	0
6	31620134	.	A	C	5	1	6	0	0	6	0	0
6	31626221	.	A	G	19	21	40	0	0	40	0	0
6	31629324	rs143479464	A	C	9	2	11	0	0	11	0	0
6	31629953	rs7029	A	G	24	18	42	0	0	42	0	0
6	31630241	rs7992	C	T	35	38	73	0	0	73	0	0
6	31631907	rs928814	G	A	23	42	65	0	0	65	0	0
6	31632134	rs3130618	C	A	51	33	84	0	0	84	0	0
6	31632899	rs35377600	C	T	6	2	8	0	0	8	0	0
6	31635710	rs14365	T	C	434	419	853	0	2	855	0	0
6	31636742	rs9267531	A	G	10	6	16	0	1	17	0	0
6	31637807	rs4569	C	T	147	133	280	0	0	280	0	0
6	31639845	rs11758242	C	A	49	40	89	0	0	89	0	0
6	31657754	rs707917	C	G	3	3	6	0	0	6	0	0
6	31692970	rs407283	G	A	72	79	151	0	0	151	0	0
6	31704294	rs3131383	G	T	55	32	87	0	1	88	0	0
6	31705183	rs377749	A	C	18	24	42	0	3	45	0	0
6	31709045	rs28381349	C	T	21	11	32	0	0	32	0	0
6	31718396	rs3117573	C	G	2	5	7	0	0	7	0	0
6	31721033	rs3131379	G	A	6	3	9	0	0	9	0	0
6	31721652	.	G	A	4	3	7	0	0	7	0	0
6	31724219	rs805826	G	C	3	3	6	0	0	6	0	0
6	31725230	rs3117574	G	A	0	7	7	0	0	7	0	0
6	31725285	rs3131378	A	G	1	5	6	0	0	6	0	0
6	31727474	rs3117577	A	G	7	1	8	0	0	8	0	0
6	31727897	rs3115672	C	T	32	30	62	0	0	62	0	0
6	31729925	rs1802127	C	T	49	34	83	0	0	83	0	0
6	31734345	rs3115671	G	T	4	3	7	0	0	7	0	0
6	31747833	rs1076827	G	A	53	73	126	0	3	130	1	0
6	31769479	rs73400280	G	A	5	1	6	0	0	6	0	0
6	31769796	rs9461726	C	T	4	4	8	0	0	8	0	0
6	31795550	rs6457452	C	T	33	32	65	0	0	65	0	0
6	31797587	.	C	G	107	14	121	0	1	122	0	0
6	31803074	rs17201241	C	T	38	20	58	0	0	58	0	0
6	31804729	rs11968400	C	T	37	30	67	0	0	67	0	0
6	31807540	rs3130679	A	G	16	3	19	0	0	19	0	0
6	31860337	rs535586	T	C	72	78	150	0	2	152	0	0
6	31929014	rs437179	A	C	14	25	39	0	0	39	0	0
6	31935311	rs453821	C	T	2	5	7	0	0	7	0	0
6	31935928	rs13217120	G	C	9	7	16	0	0	16	0	0
6	31936668	rs410851	T	C	26	37	63	0	0	63	0	0
6	31936679	rs449643	C	T	27	32	59	0	0	59	0	0
6	31940897	rs389884	A	G	2	4	6	0	0	6	0	0
6	31941557	rs387608	G	A	3	5	8	0	0	8	0	0
6	31947460	rs389883	G	T	16	14	30	0	0	30	0	0
6	31947594	rs389512	G	C	14	17	31	0	0	31	0	0
6	32036357	rs3749962	G	A	3	5	8	0	0	8	0	0
6	32075563	rs429150	T	C	5	2	7	0	0	7	0	0
6	32083300	rs8283	A	G	222	185	407	0	1	408	0	0
6	32096001	rs3130288	C	A	6	6	12	0	0	12	0	0
6	32122472	rs3096696	C	A	15	19	34	0	0	34	0	0
6	32131972	rs3132941	G	C	6	4	10	0	0	10	0	0
6	32134510	rs3096697	G	A	9	9	18	0	1	19	0	0
6	32147478	rs57409105	G	T	98	83	181	0	3	184	0	0
6	32147696	rs3130349	G	A	96	79	175	0	1	176	0	0
6	32148031	rs1062070	A	G	104	89	193	0	1	194	0	0
6	32148403	rs8365	G	C	84	78	162	0	1	163	0	0
6	32149260	rs2071288	C	T	3	3	6	0	0	6	0	0
6	32150498	rs17846798	G	A	2	6	8	0	0	8	0	0
6	32151934	rs3131300	A	G	3	12	15	0	0	15	0	0
6	32154998	rs204994	C	T	25	16	41	0	0	41	0	0
6	32155581	rs204993	A	G	7	5	12	0	0	12	0	0
6	32156908	rs204992	G	A	18	14	32	0	0	32	0	0
6	32163799	rs8192579	T	C	6	1	7	0	0	7	0	0
6	32408497	rs3135394	A	G	4	16	20	0	0	20	0	0
6	32408842	rs3135393	A	G	6	6	12	0	0	12	0	0
6	32409060	rs6925852	G	A	7	6	13	0	0	13	0	0
6	32409708	rs17496549	C	T	8	5	13	0	0	13	0	0
6	32410083	rs16822616	C	A	18	12	30	0	1	31	0	0
6	32410210	rs3129884	T	C	16	22	38	0	0	38	0	0
6	32410215	rs3129885	T	C	16	23	39	0	0	39	0	0
6	32410691	rs3129887	G	A	17	25	42	0	0	42	0	0
6	32410941	rs9268659	T	C	9	7	16	0	0	16	0	0
6	32411035	rs8084	A	C	2749	2681	5430	0	23	5453	0	0
6	32411307	rs2239806	C	T	13	7	20	0	1	21	0	0
6	32411362	rs13218331	A	C	3	10	13	0	0	13	0	0
6	32411376	rs2239805	T	G	8	2	10	0	1	11	0	0
6	32411646	rs7192	T	G	2267	2261	4528	0	46	4576	2	0
6	32412388	rs4935356	T	A	16	14	30	0	0	30	0	0
6	32412398	rs4935354	C	T	19	14	33	0	1	34	0	0
6	32412435	rs3177928	G	A	2154	1982	4136	0	23	4160	1	0
6	32412480	rs7194	G	A	2233	2177	4410	0	21	4431	0	0
6	32412539	rs7195	A	G	2412	2457	4869	0	21	4891	1	0
6	32412566	rs1131541	T	A	2470	2140	4610	0	39	4649	0	0
6	32412592	rs1051336	G	A	2579	2107	4686	0	11	4697	0	0
6	32412809	rs1041885	T	A	255	210	465	0	6	471	0	0
6	32487724	.	C	T	5	35	40	0	0	40	0	0
6	32493545	.	T	C	0	7	7	0	0	7	0	0
6	32497890	.	A	G	6	0	6	0	0	6	0	0
6	32497905	.	G	T	19	115	134	0	1	135	0	0
6	32497910	.	T	C	195	0	195	0	0	195	0	0
6	32497913	.	C	A	195	0	195	0	1	196	0	0
6	32520755	rs3828844	A	G	0	63	63	0	0	63	0	0
6	32521160	.	C	G	15	0	15	0	1	16	0	0
6	32521644	rs17424325	C	T	27	0	27	0	0	27	0	0
6	32522053	rs115070742	G	C	14	0	14	0	0	14	0	0
6	32522265	.	C	G	30	0	30	0	0	30	0	0
6	32522494	.	C	T	24	0	24	0	0	24	0	0
6	32523079	rs116783436	C	T	43	0	43	0	1	44	0	0
6	32526559	.	A	G	4	4	8	0	0	8	0	0
6	32526624	.	A	G	6	2	8	0	0	8	0	0
6	32546666	rs1064713	G	A	1158	198	1356	0	5	1361	0	0
6	32546677	.	T	A	439	721	1160	0	1	1161	0	0
6	32546684	.	A	G	465	573	1038	0	3	1041	0	0
6	32546697	.	G	A	462	1001	1463	0	8	1471	0	0
6	32546698	.	G	A	463	1004	1467	0	8	1475	0	0
6	32546781	.	T	C	2203	219	2422	0	18	2440	0	0
6	32546800	.	A	G	0	671	671	0	1	672	0	0
6	32546838	.	A	G	450	5	455	0	0	455	0	0
6	32546839	.	G	A	448	5	453	0	2	455	0	0
6	32546846	.	C	T	5	65	70	0	2	72	0	0
6	32546849	.	G	A	64	3	67	0	2	70	1	0
6	32546918	.	G	A	1	13	14	0	0	14	0	0
6	32546938	.	T	C	11	0	11	0	0	11	0	0
6	32546941	.	C	T	0	7	7	0	0	7	0	0
6	32546948	.	C	G	8	0	8	0	0	8	0	0
6	32546950	.	A	G	0	6	6	0	0	6	0	0
6	32546965	.	G	A	6	0	6	0	0	6	0	0
6	32547980	.	A	G	8	0	8	0	0	8	0	0
6	32548026	.	G	C	351	567	918	0	3	921	0	0
6	32548211	.	C	G	5	9	14	0	0	14	0	0
6	32548250	.	G	A	16	5	21	0	0	21	0	0
6	32548251	.	C	T	5	15	20	0	0	20	0	0
6	32548252	.	C	T	17	5	22	0	0	22	0	0
6	32548272	.	T	C	8	11	19	0	0	19	0	0
6	32548466	.	C	T	16	1	17	0	0	17	0	0
6	32548500	.	G	C	14	0	14	0	0	14	0	0
6	32548660	.	T	C	12	1	13	0	0	13	0	0
6	32548809	.	A	C	8	0	8	0	0	8	0	0
6	32548852	.	C	A	0	19	19	0	0	19	0	0
6	32548853	.	A	G	0	19	19	0	0	19	0	0
6	32548976	.	C	T	17	0	17	0	0	17	0	0
6	32548977	.	A	G	17	0	17	0	0	17	0	0
6	32548982	.	T	C	17	0	17	0	0	17	0	0
6	32548998	.	C	A	12	0	12	0	0	12	0	0
6	32549004	.	A	G	10	0	10	0	0	10	0	0
6	32549014	.	G	T	0	8	8	0	0	8	0	0
6	32549017	.	A	G	9	0	9	0	0	9	0	0
6	32549359	.	C	T	2962	303	3265	0	11	3276	0	0
6	32549383	.	G	A	2495	242	2737	0	11	2749	1	0
6	32549416	.	C	T	1803	136	1939	0	14	1953	0	0
6	32549589	.	A	C	1867	71	1938	0	9	1948	1	0
6	32549607	.	T	G	1218	15	1233	0	4	1237	0	0
6	32549620	.	G	T	16	0	16	0	0	16	0	0
6	32549649	.	G	T	1	13	14	0	0	14	0	0
6	32549663	.	G	T	18	0	18	0	0	18	0	0
6	32549667	.	C	G	19	1	20	0	0	20	0	0
6	32549670	.	G	T	1	19	20	0	0	20	0	0
6	32549675	.	G	T	19	0	19	0	1	20	0	0
6	32549677	.	C	G	20	0	20	0	0	20	0	0
6	32549771	.	T	C	6	9	15	0	0	15	0	0
6	32549878	.	C	T	7	0	7	0	0	7	0	0
6	32550010	.	T	C	23	8	31	0	0	31	0	0
6	32550011	.	A	C	24	7	31	0	0	31	0	0
6	32550012	.	C	T	8	23	31	0	0	31	0	0
6	32550047	.	G	A	6	19	25	0	0	25	0	0
6	32550064	.	G	T	18	0	18	0	0	18	0	0
6	32550065	.	C	T	18	0	18	0	0	18	0	0
6	32550076	.	T	C	9	0	9	0	0	9	0	0
6	32550141	.	T	C	5	1	6	0	0	6	0	0
6	32550144	.	G	A	5	1	6	0	0	6	0	0
6	32550203	.	T	G	28	9	37	0	2	39	0	0
6	32550213	.	A	T	9	17	26	0	0	26	0	0
6	32550226	.	G	A	8	7	15	0	0	15	0	0
6	32550384	.	T	G	42	4	46	0	0	46	0	0
6	32550389	.	T	C	4	27	31	0	0	31	0	0
6	32550405	.	C	A	3	21	24	0	0	24	0	0
6	32550415	.	G	C	25	0	25	0	0	25	0	0
6	32550425	.	A	T	20	0	20	0	0	20	0	0
6	32550430	.	A	G	17	0	17	0	1	18	0	0
6	32550462	.	A	T	32	0	32	0	0	32	0	0
6	32550467	.	T	C	32	0	32	0	1	33	0	0
6	32550473	.	A	C	33	0	33	0	0	33	0	0
6	32550480	.	C	T	33	0	33	0	0	33	0	0
6	32550484	.	T	C	34	0	34	0	0	34	0	0
6	32550488	.	G	A	0	29	29	0	1	30	0	0
6	32550501	.	A	T	0	33	33	0	0	33	0	0
6	32550502	.	T	G	37	0	37	0	0	37	0	0
6	32550512	.	T	C	39	0	39	0	0	39	0	0
6	32550569	.	T	G	39	0	39	0	0	39	0	0
6	32550576	.	G	A	36	0	36	0	0	36	0	0
6	32550581	.	G	A	34	0	34	0	0	34	0	0
6	32550583	.	T	C	0	29	29	0	0	29	0	0
6	32550589	.	G	T	28	0	28	0	0	28	0	0
6	32550591	.	G	A	28	0	28	0	0	28	0	0
6	32550614	.	C	T	0	12	12	0	0	12	0	0
6	32550615	.	G	A	0	12	12	0	0	12	0	0
6	32550619	.	C	T	12	0	12	0	0	12	0	0
6	32550625	.	T	G	0	7	7	0	0	7	0	0
6	32550671	.	G	A	6	0	6	0	0	6	0	0
6	32550679	.	C	A	6	0	6	0	0	6	0	0
6	32551183	.	A	T	8	0	8	0	0	8	0	0
6	32551185	.	T	C	8	0	8	0	0	8	0	0
6	32551227	.	A	T	10	0	10	0	0	10	0	0
6	32551373	.	A	G	6	0	6	0	0	6	0	0
6	32551493	.	A	C	6	0	6	0	0	6	0	0
6	32551911	rs17882028	C	A	1313	777	2090	0	10	2100	0	0
6	32551912	rs17885482	A	C	1251	779	2030	0	14	2044	0	0
6	32551939	.	G	T	956	597	1553	0	12	1565	0	0
6	32551970	.	T	G	872	384	1256	0	7	1263	0	0
6	32552092	rs1059569	A	T	1060	760	1820	0	8	1828	0	0
6	32552395	.	G	A	6	0	6	0	0	6	0	0
6	32553828	.	G	A	4	2	6	0	0	6	0	0
6	32554685	.	C	G	6	1	7	0	0	7	0	0
6	32555522	rs7741969	T	G	5	1	6	0	0	6	0	0
6	32556927	.	A	C	2	4	6	0	0	6	0	0
6	32556929	.	G	A	2	4	6	0	0	6	0	0
6	32557102	.	G	T	1	5	6	0	0	6	0	0
6	32557145	.	C	T	6	0	6	0	0	6	0	0
6	32557423	rs9256943	G	T	5	134	139	0	2	141	0	0
6	32557436	rs201614260	C	G	519	4	523	0	3	526	0	0
6	32557446	.	G	C	652	4	656	0	2	658	0	0
6	32557477	.	G	A	752	1	753	0	6	759	0	0
6	32557478	rs9270301	C	A	4	523	527	0	0	527	0	0
6	32557479	rs9270302	G	A	4	519	523	0	4	527	0	0
6	32557486	rs201540428	T	A	887	2	889	0	5	894	0	0
6	32557489	rs199514452	A	T	901	5	906	0	0	906	0	0
6	32557506	rs707953	T	C	7	890	897	0	1	898	0	0
6	32557529	.	C	G	886	2	888	0	3	891	0	0
6	32557585	rs17211091	A	C	79	0	79	0	0	79	0	0
6	32557595	.	C	T	38	0	38	0	0	38	0	0
6	32557601	.	T	C	26	0	26	0	0	26	0	0
6	32604978	rs374547018	C	G	0	14	14	0	0	14	0	0
6	32604980	rs9272411	T	C	15	0	15	0	0	15	0	0
6	32604987	rs9272413	T	C	16	0	16	0	0	16	0	0
6	32604994	rs9272414	A	T	16	0	16	0	0	16	0	0
6	32605016	.	A	G	24	0	24	0	0	24	0	0
6	32605043	rs9272416	C	T	25	0	25	0	0	25	0	0
6	32605091	rs9272418	A	G	24	0	24	0	0	24	0	0
6	32605097	rs9272419	C	T	28	0	28	0	0	28	0	0
6	32605118	rs9272421	G	A	26	0	26	0	0	26	0	0
6	32605164	rs9272423	T	G	41	0	41	0	0	41	0	0
6	32605173	.	T	C	43	0	43	0	0	43	0	0
6	32605189	rs9272426	A	G	47	0	47	0	0	47	0	0
6	32605197	rs3207966	G	A	67	0	67	0	0	67	0	0
6	32605207	rs3187964	C	G	118	0	118	0	0	118	0	0
6	32605216	rs1047985	G	A	150	0	150	0	0	150	0	0
6	32605257	rs1047989	C	A	231	10	241	0	5	247	1	0
6	32605271	rs1047993	C	T	270	10	280	0	3	283	0	0
6	32605274	rs1130034	T	C	277	11	288	0	3	291	0	0
6	32605325	rs9272434	C	T	49	1	50	0	2	52	0	0
6	32605353	rs9272436	A	G	7	0	7	0	0	7	0	0
6	32605356	rs9272437	A	G	7	0	7	0	0	7	0	0
6	32605358	rs9272438	C	G	6	0	6	0	0	6	0	0
6	32605400	rs9272442	C	T	6	0	6	0	0	6	0	0
6	32605557	rs7771972	C	T	9	0	9	0	0	9	0	0
6	32605578	rs9272459	G	A	9	0	9	0	0	9	0	0
6	32605583	rs9272460	A	G	0	7	7	0	0	7	0	0
6	32605705	rs9272467	G	T	6	0	6	0	1	7	0	0
6	32605708	rs9272468	G	A	6	0	6	0	1	7	0	0
6	32605713	rs9272469	A	C	8	0	8	0	0	8	0	0
6	32605714	rs9272470	T	G	8	0	8	0	0	8	0	0
6	32605723	.	C	G	7	0	7	0	0	7	0	0
6	32605738	rs9272473	G	A	7	0	7	0	0	7	0	0
6	32605754	rs9272474	T	A	6	0	6	0	0	6	0	0
6	32605756	rs9272475	A	G	6	0	6	0	0	6	0	0
6	32605759	rs9272476	T	A	6	0	6	0	0	6	0	0
6	32605761	rs9272477	T	A	6	0	6	0	0	6	0	0
6	32605767	rs9272478	G	T	9	0	9	0	0	10	1	0
6	32605789	rs9272479	C	A	10	0	10	0	0	10	0	0
6	32605800	rs9272480	A	G	10	0	10	0	0	10	0	0
6	32605884	rs2187668	C	T	10	0	10	0	0	10	0	0
6	32606133	rs9272495	C	A	6	0	6	0	0	6	0	0
6	32606324	rs9272507	T	C	6	0	6	0	0	6	0	0
6	32606325	rs9272508	G	A	6	0	6	0	0	6	0	0
6	32606380	rs9272513	T	G	6	0	6	0	0	6	0	0
6	32606443	.	G	A	6	0	6	0	0	6	0	0
6	32606446	rs9272518	G	T	7	0	7	0	0	7	0	0
6	32606756	rs9272535	G	A	33	0	33	0	0	33	0	0
6	32606773	rs9272536	G	T	28	0	28	0	1	29	0	0
6	32606802	.	T	C	30	0	30	0	0	30	0	0
6	32606809	rs9272538	T	C	29	0	29	0	0	29	0	0
6	32606819	rs9272539	G	A	33	0	33	0	0	33	0	0
6	32606834	rs9272540	A	C	35	0	35	0	0	35	0	0
6	32606847	.	G	A	35	0	35	0	0	35	0	0
6	32606849	.	A	G	35	0	35	0	0	35	0	0
6	32606865	rs9272543	G	C	35	0	35	0	1	36	0	0
6	32606885	rs9272545	G	T	32	0	32	0	0	32	0	0
6	32606941	rs9272546	T	C	29	1	30	0	0	30	0	0
6	32606949	rs9272547	T	C	31	1	32	0	0	32	0	0
6	32606962	rs9272548	T	C	34	1	35	0	0	35	0	0
6	32606963	rs4713557	G	A	33	1	34	0	1	35	0	0
6	32606970	rs9272550	G	A	34	0	34	0	1	35	0	0
6	32606976	rs9272551	G	A	34	0	34	0	1	35	0	0
6	32606978	rs9272552	G	A	33	0	33	0	1	34	0	0
6	32607008	rs9272553	G	T	28	0	28	0	0	28	0	0
6	32607026	rs9272554	A	G	19	0	19	0	0	19	0	0
6	32607042	rs9272555	G	A	17	0	17	0	0	17	0	0
6	32607046	rs9272556	A	T	14	0	14	0	0	14	0	0
6	32607048	rs9272557	T	C	12	0	12	0	0	12	0	0
6	32607091	rs9272558	A	G	21	0	21	0	0	21	0	0
6	32607124	rs9272559	T	C	19	0	19	0	0	19	0	0
6	32607140	rs9272560	T	C	20	0	20	0	0	20	0	0
6	32607141	rs9272561	G	A	21	0	21	0	0	21	0	0
6	32607151	rs9272562	A	G	22	0	22	0	0	22	0	0
6	32607158	rs9272563	T	C	17	0	17	0	0	17	0	0
6	32607160	rs9272564	C	A	17	0	17	0	0	17	0	0
6	32607169	rs9272565	A	G	18	0	18	0	0	18	0	0
6	32607175	rs9272566	G	A	19	0	19	0	0	19	0	0
6	32607200	rs9272567	T	C	18	0	18	0	0	18	0	0
6	32607209	rs9272568	A	G	18	0	18	0	0	18	0	0
6	32607225	rs9272569	G	T	20	0	20	0	0	20	0	0
6	32607230	rs9272570	G	A	18	0	18	0	0	18	0	0
6	32607251	rs9272571	C	T	18	0	18	0	0	18	0	0
6	32607254	rs7763805	G	A	17	0	17	0	1	18	0	0
6	32607274	.	G	C	19	0	19	0	0	19	0	0
6	32607281	rs9272574	G	A	17	0	17	0	0	17	0	0
6	32607296	rs9272575	C	A	14	0	14	0	0	14	0	0
6	32607303	rs9272576	T	A	13	0	13	0	0	13	0	0
6	32607325	rs9272577	G	A	13	0	13	0	0	13	0	0
6	32607389	rs9272578	T	C	19	0	19	0	0	19	0	0
6	32607396	rs2284189	T	C	19	0	19	0	0	19	0	0
6	32607403	rs9272580	A	G	22	0	22	0	0	22	0	0
6	32607411	rs9272581	G	A	22	0	22	0	0	22	0	0
6	32607439	rs9272582	G	C	23	0	23	0	0	23	0	0
6	32607453	rs9272583	C	T	23	0	23	0	0	23	0	0
6	32607470	rs9272584	A	T	23	0	23	0	0	23	0	0
6	32607477	rs9272585	G	A	24	0	24	0	0	24	0	0
6	32607492	rs9272586	G	C	24	0	24	0	0	24	0	0
6	32607510	rs9272587	G	A	23	0	23	0	0	23	0	0
6	32607516	rs9272588	T	C	22	0	22	0	0	22	0	0
6	32607524	rs9272589	T	C	22	0	22	0	0	22	0	0
6	32607526	rs116150265	T	C	20	0	20	0	0	20	0	0
6	32607558	rs9272593	A	G	16	0	16	0	0	16	0	0
6	32607561	rs9272594	C	T	16	0	16	0	0	16	0	0
6	32607611	rs9272598	G	T	21	0	21	0	0	21	0	0
6	32607638	rs9272599	A	G	22	0	22	0	0	22	0	0
6	32607650	rs9272600	C	A	23	0	23	0	0	23	0	0
6	32607652	rs9272601	A	T	23	0	23	0	0	23	0	0
6	32607722	rs9272604	G	A	25	0	25	0	1	26	0	0
6	32607728	rs9272605	A	G	27	0	27	0	0	27	0	0
6	32607729	rs9272606	C	T	27	0	27	0	0	27	0	0
6	32607821	rs9272612	G	A	19	0	19	0	0	19	0	0
6	32607829	rs9272613	A	G	16	0	16	0	0	16	0	0
6	32607859	rs9272614	C	T	23	0	23	0	0	23	0	0
6	32607882	rs9272615	G	A	21	0	21	0	0	21	0	0
6	32607890	rs9272616	C	G	20	0	20	0	1	21	0	0
6	32607926	rs9272617	T	G	17	0	17	0	0	17	0	0
6	32607927	rs9272618	C	T	16	0	16	0	1	17	0	0
6	32607945	rs9272619	T	A	13	0	13	0	0	13	0	0
6	32607972	rs9272620	C	T	8	0	8	0	1	9	0	0
6	32608014	rs9272625	T	C	7	0	7	0	1	8	0	0
6	32608041	rs9272626	A	C	10	0	10	0	1	11	0	0
6	32608093	rs9272628	T	C	12	1	13	0	0	13	0	0
6	32608096	rs9272629	G	T	16	1	17	0	0	17	0	0
6	32608150	rs9272630	G	A	18	0	18	0	0	18	0	0
6	32608152	rs9272631	T	C	18	0	18	0	0	18	0	0
6	32608180	rs9272632	A	G	21	0	21	0	0	21	0	0
6	32608181	rs9272633	A	G	21	0	21	0	0	21	0	0
6	32608184	rs9272634	A	T	21	0	21	0	0	21	0	0
6	32608193	rs9272635	T	C	22	0	22	0	0	22	0	0
6	32608211	rs9272636	T	C	21	0	21	0	0	21	0	0
6	32608221	rs9272640	T	C	21	0	21	0	0	21	0	0
6	32608276	rs73729513	A	G	0	18	18	0	0	18	0	0
6	32608294	rs9272641	G	A	25	0	25	0	0	25	0	0
6	32608331	rs9272645	C	G	18	0	18	0	1	19	0	0
6	32608394	rs9272646	T	C	14	2	16	0	0	16	0	0
6	32608435	rs35686990	T	C	2	13	15	0	0	15	0	0
6	32608508	rs9272647	A	T	4	2	6	0	0	6	0	0
6	32608524	rs9272648	T	C	4	2	6	0	0	6	0	0
6	32608550	rs9272649	A	C	6	1	7	0	0	7	0	0
6	32608586	rs9272650	C	T	8	1	9	0	0	9	0	0
6	32608610	rs9272655	T	C	7	0	7	0	0	7	0	0
6	32608629	rs9272656	A	G	8	0	8	0	0	8	0	0
6	32608655	rs9272657	G	A	8	0	8	0	0	8	0	0
6	32608658	rs9272658	G	A	7	0	7	0	1	8	0	0
6	32608661	rs9272659	T	C	7	0	7	0	0	7	0	0
6	32608667	rs9272660	A	G	7	0	7	0	0	7	0	0
6	32608816	rs9272669	A	G	12	0	12	0	1	13	0	0
6	32608820	rs9272670	C	T	13	0	13	0	0	13	0	0
6	32608849	rs9272672	T	C	16	0	16	0	0	16	0	0
6	32608858	rs4455710	C	T	17	0	17	0	0	17	0	0
6	32608885	rs9272674	C	T	19	0	19	0	0	19	0	0
6	32608888	rs9272675	G	T	18	0	18	0	0	18	0	0
6	32608903	rs9272676	T	C	20	0	20	0	0	20	0	0
6	32608907	rs9272677	C	A	24	0	24	0	0	24	0	0
6	32608915	rs9272678	T	C	24	0	24	0	0	24	0	0
6	32608931	rs9272679	T	A	25	0	25	0	0	25	0	0
6	32608932	rs9272680	G	T	25	0	25	0	0	25	0	0
6	32608938	rs6930589	G	T	28	0	28	0	0	28	0	0
6	32608953	rs9272682	C	T	28	0	28	0	0	28	0	0
6	32608969	rs9272683	A	G	29	1	30	0	0	30	0	0
6	32608981	rs115508098	A	G	32	2	34	0	0	34	0	0
6	32608991	rs9272685	A	G	29	4	33	0	0	33	0	0
6	32609009	rs34130005	T	G	4	27	31	0	1	32	0	0
6	32609015	rs9272686	C	T	33	5	38	0	0	38	0	0
6	32609047	rs34857804	C	T	7	30	37	0	1	38	0	0
6	32609057	rs9272687	G	A	32	8	40	0	0	40	0	0
6	32609097	rs1129738	T	C	264	22	286	0	1	287	0	0
6	32609105	rs1129740	G	A	273	25	298	0	1	299	0	0
6	32609126	rs1071630	T	C	273	29	302	0	3	305	0	0
6	32609192	rs1142323	A	G	268	21	289	0	1	290	0	0
6	32609207	.	C	T	262	13	275	0	1	276	0	0
6	32609212	rs1142326	C	T	271	1	272	0	1	273	0	0
6	32609214	rs3207984	G	T	269	1	270	0	1	271	0	0
6	32609216	rs1142328	G	T	263	1	264	0	1	266	1	0
6	32609229	rs9272699	C	A	278	0	278	0	1	279	0	0
6	32609230	rs1048052	A	C	272	0	272	0	0	272	0	0
6	32609236	rs4193	G	A	271	0	271	0	0	271	0	0
6	32609253	rs9272702	G	A	256	0	256	0	2	258	0	0
6	32609254	rs1142331	G	T	257	0	257	0	1	258	0	0
6	32609255	rs1142332	G	T	254	0	254	0	2	256	0	0
6	32609264	.	G	C	256	0	256	0	0	256	0	0
6	32609271	.	G	C	251	0	251	0	4	255	0	0
6	32609286	.	C	T	251	0	251	0	1	252	0	0
6	32609312	rs1129808	A	C	265	7	272	0	3	275	0	0
6	32609341	rs9272712	C	T	24	4	28	0	0	28	0	0
6	32609345	rs9272713	C	A	25	4	29	0	0	29	0	0
6	32609348	rs9272714	C	A	22	3	25	0	1	26	0	0
6	32609357	rs9272715	T	C	24	3	27	0	1	28	0	0
6	32609371	rs4467816	T	C	0	25	25	0	0	25	0	0
6	32609379	rs9272718	C	T	27	0	27	0	0	27	0	0
6	32609387	rs9272719	G	A	25	3	28	0	1	29	0	0
6	32609389	rs9272720	G	T	25	3	28	0	1	29	0	0
6	32609401	rs9272721	C	A	24	3	27	0	1	28	0	0
6	32609404	.	C	T	26	5	31	0	0	31	0	0
6	32609425	rs4457200	C	G	10	27	37	0	1	38	0	0
6	32609427	.	T	C	27	11	38	0	0	38	0	0
6	32609506	rs9272724	G	C	23	4	27	0	0	27	0	0
6	32609513	rs9272725	G	T	23	4	27	0	0	27	0	0
6	32609514	rs34719927	C	T	23	4	27	0	0	27	0	0
6	32609525	rs35344500	A	C	20	7	27	0	2	29	0	0
6	32609593	rs9272728	A	G	17	5	22	0	0	22	0	0
6	32609594	rs9272729	G	A	17	5	22	0	0	22	0	0
6	32609873	rs707950	G	C	280	7	287	0	1	288	0	0
6	32610044	rs9272755	T	C	18	3	21	0	0	21	0	0
6	32610047	rs9272756	T	C	18	4	22	0	0	22	0	0
6	32610050	rs111625346	T	C	18	6	24	0	0	24	0	0
6	32610059	rs34843907	T	G	17	7	24	0	0	24	0	0
6	32610109	rs34826728	A	C	14	6	20	0	0	20	0	0
6	32610213	.	C	T	8	0	8	0	0	8	0	0
6	32610214	rs114816840	T	C	10	0	10	0	0	10	0	0
6	32610220	rs116613962	A	G	12	0	12	0	0	12	0	0
6	32610226	rs9272770	G	A	13	0	13	0	0	13	0	0
6	32610227	.	T	C	13	0	13	0	0	13	0	0
6	32610270	rs9272776	T	C	20	0	20	0	0	20	0	0
6	32610314	rs9272779	T	C	18	1	19	0	0	19	0	0
6	32610357	rs9272781	A	T	21	1	22	0	0	22	0	0
6	32610371	rs9272782	A	G	40	1	41	0	0	41	0	0
6	32610378	rs9272783	C	T	40	1	41	0	0	41	0	0
6	32610379	rs9272784	T	A	35	1	36	0	4	40	0	0
6	32610436	rs1048372	T	C	182	6	188	0	3	191	0	0
6	32610445	rs1048381	G	A	190	6	196	0	1	197	0	0
6	32610461	rs9260	A	G	182	7	189	0	2	191	0	0
6	32610495	rs1048439	A	G	197	10	207	0	6	213	0	0
6	32610535	rs1130116	A	C	189	18	207	0	3	210	0	0
6	32610556	rs1130117	G	T	189	15	204	0	1	205	0	0
6	32610574	rs9272798	C	T	7	0	7	0	0	7	0	0
6	32610576	rs9272799	G	T	7	0	7	0	0	7	0	0
6	32610581	rs9272800	C	G	6	0	6	0	0	6	0	0
6	32610584	rs9272801	T	C	6	0	6	0	0	6	0	0
6	32610589	rs9272802	G	T	7	0	7	0	0	7	0	0
6	32610591	rs9272803	G	C	8	0	8	0	0	8	0	0
6	32610601	.	A	G	7	0	7	0	0	7	0	0
6	32610683	rs9272840	C	T	6	1	7	0	0	7	0	0
6	32610718	.	C	T	6	0	6	0	0	6	0	0
6	32610757	rs8227	A	G	170	5	175	0	3	178	0	0
6	32610769	rs7600	A	C	161	5	166	0	0	166	0	0
6	32610781	rs1048643	C	T	172	2	174	0	0	174	0	0
6	32610786	rs1048645	C	T	180	2	182	0	0	182	0	0
6	32610795	rs1130126	G	C	186	2	188	0	0	188	0	0
6	32610825	rs7142	A	G	217	0	217	0	0	217	0	0
6	32610841	rs1130139	T	C	217	0	217	0	4	221	0	0
6	32610846	rs1130142	C	G	219	0	219	0	1	220	0	0
6	32610857	rs1130144	G	A	221	0	221	0	0	221	0	0
6	32610858	rs1130145	C	T	220	0	220	0	0	220	0	0
6	32610868	rs1130148	C	T	207	0	207	0	0	207	0	0
6	32610869	rs1142414	C	G	209	0	209	0	2	211	0	0
6	32610892	rs9272917	A	G	187	0	187	0	3	190	0	0
6	32610893	rs9272918	C	A	189	0	189	0	1	190	0	0
6	32610897	rs1142422	C	A	192	0	192	0	2	194	0	0
6	32610908	rs1142429	C	T	161	0	161	0	2	163	0	0
6	32610922	.	T	C	160	0	160	0	0	160	0	0
6	32610935	rs1130151	A	G	156	0	156	0	1	157	0	0
6	32610946	rs1130152	A	T	135	0	135	0	1	136	0	0
6	32610947	rs1130153	A	C	0	125	125	0	1	126	0	0
6	32610951	rs1130155	C	G	124	0	124	0	0	125	1	0
6	32610952	.	A	T	120	0	120	0	1	121	0	0
6	32610960	.	G	A	98	1	99	0	0	99	0	0
6	32610972	rs1130158	G	A	88	1	89	0	0	89	0	0
6	32611003	.	A	T	45	1	46	0	0	46	0	0
6	32611012	rs1048726	A	T	38	0	38	0	0	38	0	0
6	32611021	.	T	C	11	0	11	0	0	11	0	0
6	32611029	rs1065036	T	C	10	0	10	0	0	10	0	0
6	32611040	.	C	A	7	0	7	0	0	7	0	0
6	32611083	.	T	C	8	0	8	0	0	8	0	0
6	32611084	.	A	G	7	0	7	0	1	8	0	0
6	32611092	rs9272943	T	G	8	0	8	0	0	8	0	0
6	32611100	rs540435913	G	A	7	0	7	0	0	7	0	0
6	32611101	rs707945	T	G	7	0	7	0	0	7	0	0
6	32611107	rs9272948	T	C	8	0	8	0	0	8	0	0
6	32611108	rs707944	A	T	8	0	8	0	0	8	0	0
6	32611117	rs9272950	T	G	8	0	8	0	0	8	0	0
6	32611128	.	C	A	7	0	7	0	1	8	0	0
6	32611135	.	C	A	8	0	8	0	0	8	0	0
6	32611147	.	T	G	9	0	9	0	0	9	0	0
6	32611170	rs9272958	C	A	9	0	9	0	0	9	0	0
6	32611176	rs1064991	G	C	10	0	10	0	0	10	0	0
6	32611195	rs1064994	T	C	10	0	10	0	0	10	0	0
6	32611229	rs9272962	G	T	7	0	7	0	0	7	0	0
6	32611275	rs1065049	C	A	7	0	7	0	0	7	0	0
6	32611590	rs5002178	G	A	5	1	6	0	0	6	0	0
6	32611611	rs9273011	T	C	7	1	8	0	0	8	0	0
6	32611641	rs9273012	A	G	8	0	8	0	0	8	0	0
6	32611649	rs9273013	C	T	9	0	9	0	0	9	0	0
6	32611662	.	C	T	8	0	8	0	0	8	0	0
6	32611663	.	A	G	6	0	6	0	0	6	0	0
6	32611694	rs4526236	G	A	8	0	8	0	0	8	0	0
6	32611704	rs9273018	T	C	7	0	7	0	0	7	0	0
6	32611713	rs9273019	G	C	6	0	6	0	0	6	0	0
6	32611723	rs9273020	G	T	6	0	6	0	0	6	0	0
6	32611725	rs9273021	A	G	6	0	6	0	0	6	0	0
6	32611756	rs9273023	C	G	9	1	10	0	0	10	0	0
6	32611757	rs9273024	T	C	9	1	10	0	0	10	0	0
6	32611783	rs9273027	A	G	9	1	10	0	0	10	0	0
6	32611792	rs9273028	A	G	8	0	8	0	0	8	0	0
6	32611795	rs9273029	G	A	7	0	7	0	0	7	0	0
6	32611805	rs9273030	T	A	8	0	8	0	0	8	0	0
6	32611873	rs9273033	T	C	8	0	8	0	0	8	0	0
6	32611874	rs9273034	G	T	8	0	8	0	0	8	0	0
6	32611886	rs9273035	G	A	8	0	8	0	0	8	0	0
6	32611912	rs9273037	G	A	8	0	8	0	0	8	0	0
6	32611931	rs9273038	A	T	8	0	8	0	0	8	0	0
6	32611951	rs9273039	C	T	9	0	9	0	0	9	0	0
6	32611963	rs9273041	T	A	8	0	8	0	0	8	0	0
6	32611968	rs9273043	G	T	8	0	8	0	0	8	0	0
6	32612003	rs9273046	C	T	6	1	7	0	0	7	0	0
6	32612006	rs9273047	C	T	6	1	7	0	0	7	0	0
6	32612050	rs9273053	A	T	7	0	7	0	0	7	0	0
6	32612079	rs9273054	T	C	7	1	8	0	0	8	0	0
6	32612088	rs9273055	G	T	7	1	8	0	0	8	0	0
6	32612097	rs9273056	T	G	5	1	6	0	0	6	0	0
6	32612114	rs9273060	A	G	5	1	6	0	0	6	0	0
6	32612548	rs9273097	A	G	6	0	6	0	1	7	0	0
6	32612556	rs9273098	C	G	7	0	7	0	0	7	0	0
6	32612559	rs9273100	T	G	7	0	7	0	0	7	0	0
6	32612564	rs9273101	G	A	7	0	7	0	0	7	0	0
6	32612601	rs9273105	G	A	7	1	8	0	0	8	0	0
6	32612627	rs9273109	A	G	9	1	10	0	0	10	0	0
6	32612648	rs9273112	A	T	11	0	11	0	0	11	0	0
6	32612655	rs9273113	A	G	11	0	11	0	0	11	0	0
6	32612664	rs9273114	C	G	11	0	11	0	0	11	0	0
6	32612672	rs9273115	C	A	12	0	12	0	0	12	0	0
6	32612686	rs9273116	G	A	10	0	10	0	0	10	0	0
6	32612688	rs9273117	A	G	10	0	10	0	0	10	0	0
6	32612691	rs9273118	A	G	10	0	10	0	0	10	0	0
6	32612699	rs9273119	T	A	10	0	10	0	0	10	0	0
6	32612701	rs9273120	G	T	10	0	10	0	0	10	0	0
6	32612725	rs9273121	C	T	7	0	7	0	0	7	0	0
6	32612726	rs9273122	A	G	6	0	6	0	0	6	0	0
6	32612733	rs9273123	G	A	6	0	6	0	0	6	0	0
6	32612952	rs9273145	T	A	6	0	6	0	0	6	0	0
6	32612979	rs9273146	A	T	8	0	8	0	0	8	0	0
6	32612981	rs9273147	A	G	8	0	8	0	0	8	0	0
6	32613010	rs9273150	T	C	7	0	7	0	0	7	0	0
6	32613011	rs9273151	G	A	7	0	7	0	0	7	0	0
6	32613025	rs9273152	A	C	7	0	7	0	0	7	0	0
6	32613026	rs6932167	G	A	7	0	7	0	0	7	0	0
6	32613163	rs9273167	C	A	7	0	7	0	0	7	0	0
6	32613173	rs9273168	T	C	6	0	6	0	0	6	0	0
6	32613177	rs9273170	A	G	6	0	6	0	0	6	0	0
6	32613224	rs9273172	A	C	7	1	8	0	0	8	0	0
6	32613231	rs9273173	G	A	6	1	7	0	1	8	0	0
6	32613273	rs9273175	G	A	7	0	7	0	0	7	0	0
6	32613300	rs9273176	G	A	9	0	9	0	0	9	0	0
6	32613301	.	G	A	9	0	9	0	0	9	0	0
6	32613305	rs9273179	A	G	9	0	9	0	0	9	0	0
6	32613313	.	C	T	10	0	10	0	0	10	0	0
6	32613318	rs9273183	T	C	10	0	10	0	0	10	0	0
6	32613322	rs9273184	G	A	10	0	10	0	0	10	0	0
6	32613340	rs9273185	A	G	10	1	11	0	1	12	0	0
6	32613362	rs28633411	G	A	1	9	10	0	0	10	0	0
6	32613372	rs9273186	A	T	7	1	8	0	0	8	0	0
6	32613384	rs9273188	C	T	6	1	7	0	0	7	0	0
6	32627250	rs9273410	C	A	91	0	91	0	1	92	0	0
6	32627260	rs9273411	G	A	89	0	89	0	0	89	0	0
6	32627263	rs9273412	T	C	87	0	87	0	0	87	0	0
6	32627292	rs9273413	A	G	123	0	123	0	1	124	0	0
6	32627299	rs9273414	A	T	122	0	122	0	0	122	0	0
6	32627310	rs9273415	C	T	144	0	144	0	1	145	0	0
6	32627321	rs9273416	T	G	175	0	175	0	1	176	0	0
6	32627352	rs9273417	A	G	167	0	167	0	1	168	0	0
6	32627362	rs9273418	A	C	167	0	167	0	1	168	0	0
6	32627365	rs9273419	T	C	173	0	173	0	0	173	0	0
6	32627367	rs1130457	T	C	200	0	200	0	1	201	0	0
6	32627379	rs1130456	T	C	201	0	201	0	1	203	1	0
6	32627386	rs12918	C	T	241	0	241	0	3	244	0	0
6	32627390	rs9273423	T	C	242	0	242	0	1	243	0	0
6	32627394	rs9273424	C	T	241	0	241	0	4	245	0	0
6	32627396	rs9273425	C	T	244	0	244	0	1	245	0	0
6	32627434	rs9273426	A	C	229	0	229	0	3	232	0	0
6	32627441	rs9273427	A	C	239	0	239	0	2	241	0	0
6	32627450	rs1056318	G	A	234	0	234	0	3	237	0	0
6	32627456	rs9273429	G	A	227	0	227	0	1	228	0	0
6	32627460	rs9273430	T	G	227	0	227	0	1	228	0	0
6	32627480	rs1064173	G	A	232	0	232	0	0	232	0	0
6	32627485	rs9273432	T	C	214	0	214	0	3	217	0	0
6	32627489	rs9273433	A	G	213	0	213	0	1	214	0	0
6	32627515	rs1056315	C	A	228	0	228	0	4	232	0	0
6	32627517	rs9273436	T	G	227	0	227	0	3	230	0	0
6	32627522	.	C	T	222	0	222	0	2	224	0	0
6	32627523	rs9273438	A	G	213	0	213	0	3	217	1	0
6	32627535	rs28724234	G	T	299	0	299	0	1	300	0	0
6	32627561	rs9273440	T	C	322	1	323	0	3	326	0	0
6	32627573	rs9273441	C	G	341	0	341	0	3	344	0	0
6	32627582	rs9273442	T	G	348	0	348	0	1	349	0	0
6	32627600	rs9273443	G	T	338	1	339	0	3	342	0	0
6	32627635	rs9273444	T	G	307	2	309	0	1	310	0	0
6	32627646	rs9273445	A	G	289	3	292	0	0	292	0	0
6	32627700	rs6689	A	G	19	550	569	0	3	572	0	0
6	32627714	rs1063355	T	G	717	26	743	0	4	747	0	0
6	32627747	rs1049225	A	G	1081	35	1116	0	19	1135	0	0
6	32627773	rs1049213	A	G	1210	30	1240	0	2	1242	0	0
6	32627784	rs4993988	C	T	1334	26	1360	0	3	1363	0	0
6	32627812	rs9273453	C	G	1427	12	1439	0	4	1445	2	0
6	32627830	rs9273455	C	T	1562	2	1564	0	5	1570	1	0
6	32627833	rs1770	A	G	1542	0	1542	0	4	1546	0	0
6	32627844	.	G	C	1621	0	1621	0	5	1626	0	0
6	32627850	rs3210176	T	C	1674	5	1679	0	25	1705	1	0
6	32627851	.	G	A	1730	4	1734	0	4	1738	0	0
6	32627852	rs1130420	G	A	1727	4	1731	0	7	1738	0	0
6	32627906	rs1063349	T	C	1711	29	1740	0	12	1752	0	0
6	32627923	rs1063348	A	G	1887	27	1914	0	9	1923	0	0
6	32627934	rs9273463	G	A	1815	27	1842	0	4	1847	1	0
6	32627956	rs1063347	C	G	1703	4	1707	0	6	1714	1	0
6	32627967	rs1063346	A	G	1598	6	1604	0	2	1606	0	0
6	32627969	rs3204428	C	T	1600	6	1606	0	4	1610	0	0
6	32627976	rs1063345	G	A	1613	31	1644	0	6	1650	0	0
6	32627992	rs1063343	T	C	1544	44	1588	0	17	1605	0	0
6	32628022	.	A	G	1429	45	1474	0	7	1481	0	0
6	32628030	rs9273471	G	A	122	0	122	0	0	122	0	0
6	32628045	rs9273472	C	G	122	0	122	0	0	122	0	0
6	32628046	.	A	G	119	0	119	0	1	120	0	0
6	32628047	.	T	A	118	0	118	0	0	118	0	0
6	32628064	.	T	C	112	0	112	0	0	112	0	0
6	32628065	rs281864453	C	G	112	0	112	0	0	112	0	0
6	32628084	rs2854277	C	T	97	0	97	0	0	97	0	0
6	32628093	rs9273479	T	C	91	0	91	0	2	93	0	0
6	32628098	rs28703037	G	C	1	83	84	0	0	84	0	0
6	32628103	rs9273480	C	T	95	1	96	0	0	96	0	0
6	32628122	rs9273481	G	C	91	3	94	0	0	94	0	0
6	32628127	rs9273482	T	C	96	3	99	0	0	99	0	0
6	32628138	rs9273483	G	A	99	4	103	0	0	103	0	0
6	32628193	rs9273490	G	A	110	4	114	0	1	115	0	0
6	32628224	rs41270871	T	A	4	111	115	0	0	115	0	0
6	32628247	rs9273493	T	C	118	0	118	0	1	119	0	0
6	32628256	rs9273494	G	T	128	0	128	0	0	128	0	0
6	32628273	rs9273495	G	A	128	2	130	0	0	130	0	0
6	32628297	rs9273497	T	C	131	2	133	0	0	133	0	0
6	32628301	rs9273498	T	A	117	2	119	0	9	128	0	0
6	32628306	.	G	T	125	3	128	0	0	129	1	0
6	32628407	rs9273504	T	C	108	6	114	0	1	115	0	0
6	32628428	rs2854275	C	A	106	3	109	0	0	109	0	0
6	32628432	rs9273507	A	G	103	2	105	0	0	105	0	0
6	32628439	rs9273508	G	A	92	4	96	0	0	96	0	0
6	32628473	rs9273509	T	C	101	5	106	0	0	106	0	0
6	32628474	rs9273510	G	C	100	5	105	0	1	106	0	0
6	32628505	.	T	A	110	7	117	0	0	117	0	0
6	32628538	rs9273514	G	T	109	1	110	0	0	110	0	0
6	32628539	rs9273515	G	A	110	1	111	0	0	111	0	0
6	32628549	.	T	G	100	1	101	0	1	102	0	0
6	32628550	.	G	A	101	1	102	0	0	102	0	0
6	32628558	rs9273519	G	A	105	1	106	0	0	106	0	0
6	32628559	rs281875165	T	C	101	1	102	0	2	104	0	0
6	32628560	rs398122357	G	T	105	1	106	0	0	106	0	0
6	32628595	rs9273524	T	C	130	5	135	0	1	136	0	0
6	32628606	rs201049473	C	A	7	123	130	0	0	130	0	0
6	32628621	rs9273527	T	C	123	7	130	0	0	130	0	0
6	32628698	rs9273529	C	T	105	9	114	0	1	115	0	0
6	32628699	rs9273530	A	G	105	9	114	0	1	115	0	0
6	32628736	.	C	T	105	1	106	0	2	108	0	0
6	32628737	.	A	G	105	1	106	0	4	110	0	0
6	32628751	rs9273534	C	T	104	0	104	0	0	104	0	0
6	32628764	rs9273536	C	T	104	0	104	0	1	105	0	0
6	32628765	rs9273537	C	T	103	0	103	0	1	104	0	0
6	32628776	rs2854273	C	A	105	1	106	0	0	106	0	0
6	32628779	rs9273539	G	T	101	1	102	0	2	104	0	0
6	32628784	rs3020628	C	A	100	1	101	0	1	102	0	0
6	32628812	rs9273542	C	T	111	3	114	0	1	115	0	0
6	32628833	rs9273544	A	G	107	3	110	0	2	112	0	0
6	32628835	rs3020625	A	C	107	3	110	0	1	111	0	0
6	32628841	rs9273546	A	G	108	3	111	0	2	113	0	0
6	32628843	rs73729445	C	T	6	104	110	0	0	110	0	0
6	32628844	rs9273547	T	C	104	6	110	0	2	112	0	0
6	32628873	rs9273549	C	T	99	6	105	0	2	107	0	0
6	32628953	rs9273556	C	G	91	6	97	0	0	97	0	0
6	32628960	rs2515895	T	C	92	1	93	0	0	93	0	0
6	32628965	rs9273558	A	G	91	1	92	0	0	92	0	0
6	32628967	rs9273559	C	T	91	1	92	0	0	92	0	0
6	32628996	rs9273560	C	A	97	0	97	0	0	97	0	0
6	32628998	rs9273561	T	C	96	0	96	0	0	96	0	0
6	32629015	rs281864341	G	T	92	0	92	0	1	93	0	0
6	32629032	rs73729446	C	G	1	87	88	0	1	89	0	0
6	32629053	.	C	G	93	2	95	0	1	96	0	0
6	32629064	rs9273584	A	T	88	2	90	0	1	91	0	0
6	32629091	rs9273595	C	G	77	4	81	0	0	81	0	0
6	32629141	rs1140342	C	T	960	6	966	0	9	976	1	0
6	32629271	.	C	T	169	0	169	0	0	169	0	0
6	32629281	rs9273695	C	T	162	0	162	0	0	162	0	0
6	32629282	rs9273696	A	T	158	0	158	0	2	160	0	0
6	32629289	rs9273698	C	A	155	0	155	0	1	156	0	0
6	32629297	rs9273704	T	C	156	0	156	0	1	157	0	0
6	32629314	rs9273710	G	A	156	3	159	0	0	159	0	0
6	32629320	rs9273713	A	G	159	7	166	0	0	166	0	0
6	32629341	.	C	A	9	161	170	0	0	170	0	0
6	32629371	rs867983601	A	G	154	4	158	0	0	158	0	0
6	32629372	rs9273736	G	A	154	4	158	0	0	158	0	0
6	32629380	.	A	G	146	4	150	0	0	150	0	0
6	32629409	rs9273754	A	G	147	0	147	0	1	148	0	0
6	32629417	rs9273757	G	C	143	0	143	0	1	144	0	0
6	32629432	rs9273767	A	G	141	0	141	0	2	143	0	0
6	32629438	rs9273772	T	C	139	0	139	0	1	140	0	0
6	32629439	.	G	A	140	0	140	0	1	141	0	0
6	32629443	rs9273777	T	C	139	0	139	0	1	140	0	0
6	32629447	rs9273781	A	G	134	0	134	0	1	135	0	0
6	32629462	rs9273786	C	A	134	0	134	0	0	134	0	0
6	32629496	rs9273800	G	T	107	3	110	0	1	111	0	0
6	32629504	rs9273803	C	T	99	3	102	0	0	102	0	0
6	32629514	rs9273807	T	A	91	3	94	0	0	94	0	0
6	32629529	rs9273817	T	C	90	3	93	0	0	93	0	0
6	32629545	rs79603908	T	C	8	84	92	0	0	92	0	0
6	32629582	rs9273841	C	T	116	6	122	0	0	122	0	0
6	32629603	rs9273852	T	C	123	6	129	0	0	129	0	0
6	32629612	rs9273855	G	A	133	5	138	0	2	140	0	0
6	32629614	rs9273857	A	T	134	6	140	0	0	140	0	0
6	32629650	rs9273873	T	C	169	8	177	0	1	178	0	0
6	32629680	rs2854272	A	G	147	3	150	0	1	151	0	0
6	32629716	rs9273902	T	C	150	14	164	0	4	168	0	0
6	32629802	rs1049092	A	G	1342	70	1412	0	9	1421	0	0
6	32629847	rs1049133	A	G	1185	70	1255	0	4	1259	0	0
6	32629889	rs1049087	G	A	1483	27	1510	0	8	1518	0	0
6	32629904	rs1049086	A	G	1529	11	1540	0	4	1544	0	0
6	32629920	rs41544112	C	T	11	1471	1482	0	14	1496	0	0
6	32630543	.	C	T	128	0	128	0	1	129	0	0
6	32630557	rs9274187	G	A	113	0	113	0	1	114	0	0
6	32630617	.	A	T	110	0	110	0	0	110	0	0
6	32630619	.	G	A	122	0	122	0	1	124	1	0
6	32630660	.	T	C	141	0	141	0	4	145	0	0
6	32630661	.	T	C	145	0	145	0	1	146	0	0
6	32630674	rs1143089	C	G	156	0	156	0	0	156	0	0
6	32630687	rs17613549	G	C	155	0	155	0	3	158	0	0
6	32630700	rs17843715	A	G	156	0	156	0	0	156	0	0
6	32630707	rs17843716	C	T	156	0	156	0	2	158	0	0
6	32630708	rs9274196	G	A	158	0	158	0	1	159	0	0
6	32630722	.	C	T	166	0	166	0	0	166	0	0
6	32630741	.	C	T	180	0	180	0	0	180	0	0
6	32630748	.	A	T	186	0	186	0	0	186	0	0
6	32630755	.	C	T	186	0	186	0	0	186	0	0
6	32630761	rs9274205	C	T	184	0	184	0	4	188	0	0
6	32630768	.	G	T	181	0	181	0	1	182	0	0
6	32630784	rs17613570	T	C	185	0	185	0	2	187	0	0
6	32630788	.	C	A	180	0	180	0	0	180	0	0
6	32630794	rs9274207	A	G	182	0	182	0	2	185	1	0
6	32630814	.	G	C	185	0	185	0	1	186	0	0
6	32630843	rs17843719	T	A	179	0	179	0	2	181	0	0
6	32630856	.	C	T	164	0	164	0	1	165	0	0
6	32630862	.	G	A	168	0	168	0	1	169	0	0
6	32630868	rs9274211	T	C	166	0	166	0	4	170	0	0
6	32630916	.	G	T	156	0	156	0	1	157	0	0
6	32630922	.	T	A	147	0	147	0	1	148	0	0
6	32630928	.	C	A	137	0	137	0	1	138	0	0
6	32630930	.	G	C	137	0	137	0	1	138	0	0
6	32630967	.	C	A	109	2	111	0	2	113	0	0
6	32630974	.	C	T	100	2	102	0	0	102	0	0
6	32630996	rs17613599	C	T	97	2	99	0	1	100	0	0
6	32631029	rs58770498	T	C	1	64	65	0	0	65	0	0
6	32631038	rs17613606	A	G	85	1	86	0	0	86	0	0
6	32631039	.	A	G	84	1	85	0	1	86	0	0
6	32631057	.	T	C	81	1	82	0	3	85	0	0
6	32631065	.	C	T	85	1	86	0	2	88	0	0
6	32631086	.	G	A	125	1	126	0	1	127	0	0
6	32631107	.	G	A	128	1	129	0	3	132	0	0
6	32631109	.	A	T	131	1	132	0	0	132	0	0
6	32631113	.	C	T	132	0	132	0	0	132	0	0
6	32631122	.	A	G	134	0	134	0	1	135	0	0
6	32631129	rs17613629	T	C	130	0	130	0	1	131	0	0
6	32631130	rs17613636	G	A	131	0	131	0	0	131	0	0
6	32631205	.	G	A	161	0	161	0	1	162	0	0
6	32631210	.	A	C	163	0	163	0	2	165	0	0
6	32631256	.	A	G	197	0	197	0	1	198	0	0
6	32631261	rs9274240	C	T	184	0	184	0	2	186	0	0
6	32631266	rs9274242	A	G	178	0	178	0	3	181	0	0
6	32631295	rs9274247	G	A	174	0	174	0	2	176	0	0
6	32631301	.	T	A	166	0	166	0	2	168	0	0
6	32631332	.	A	G	177	0	177	0	1	178	0	0
6	32631343	.	T	C	158	0	158	0	1	159	0	0
6	32631348	.	G	A	155	1	156	0	2	158	0	0
6	32631418	rs17613643	A	G	124	0	124	0	0	124	0	0
6	32631426	.	G	A	109	0	109	0	1	110	0	0
6	32631430	.	G	A	103	0	103	0	1	104	0	0
6	32631434	.	T	C	1	99	100	0	1	101	0	0
6	32631448	.	A	G	107	1	108	0	0	108	0	0
6	32631452	.	C	T	2	97	99	0	1	100	0	0
6	32631490	.	G	A	129	2	131	0	0	131	0	0
6	32631495	.	T	C	128	2	130	0	1	131	0	0
6	32631496	.	C	A	129	2	131	0	2	133	0	0
6	32631499	.	G	A	130	2	132	0	0	132	0	0
6	32631547	.	G	C	118	2	120	0	1	121	0	0
6	32631554	.	G	A	26	97	123	0	2	125	0	0
6	32631563	.	T	G	117	2	119	0	0	119	0	0
6	32631584	.	T	C	106	2	108	0	0	108	0	0
6	32632310	rs9274338	G	A	117	0	117	0	0	117	0	0
6	32632326	.	G	A	103	0	103	0	0	103	0	0
6	32632336	.	G	A	94	0	94	0	0	94	0	0
6	32632342	.	G	T	83	0	83	0	0	83	0	0
6	32632353	.	G	C	68	0	68	0	0	68	0	0
6	32632381	rs9274348	T	C	35	0	35	0	0	35	0	0
6	32632445	.	C	T	6	0	6	0	0	6	0	0
6	32632453	.	T	G	14	0	14	0	0	14	0	0
6	32632457	rs9274357	C	T	24	0	24	0	0	24	0	0
6	32632469	rs9274358	T	C	39	0	39	0	0	39	0	0
6	32632470	rs9274359	G	A	39	0	39	0	0	39	0	0
6	32632474	.	T	G	38	0	38	0	0	38	0	0
6	32632483	rs9274361	A	G	54	0	54	0	0	54	0	0
6	32632486	rs9274362	T	C	54	0	54	0	0	54	0	0
6	32632492	.	A	G	54	0	54	0	0	54	0	0
6	32632495	rs9274364	T	A	55	0	55	0	0	55	0	0
6	32632499	.	C	A	58	0	58	0	0	58	0	0
6	32632503	rs28746792	A	T	59	0	59	0	0	59	0	0
6	32632514	rs185812018	C	T	59	0	59	0	0	59	0	0
6	32632518	rs9274368	A	G	59	0	59	0	0	59	0	0
6	32632527	rs9274370	C	T	60	0	60	0	0	60	0	0
6	32632547	rs73729452	G	C	0	47	47	0	0	47	0	0
6	32632553	rs9274371	A	G	60	0	60	0	0	60	0	0
6	32632555	rs9274372	G	A	60	0	60	0	0	60	0	0
6	32632567	.	A	C	50	0	50	0	0	50	0	0
6	32632775	.	G	C	920	17	937	0	3	940	0	0
6	32632777	rs1049068	C	T	27	875	902	0	5	907	0	0
6	32632795	.	C	T	964	29	993	0	4	997	0	0
6	32632850	rs9274408	G	A	47	0	47	0	0	47	0	0
6	32632864	rs9274409	G	A	44	0	44	0	0	44	0	0
6	32632885	.	G	T	40	0	40	0	0	40	0	0
6	32632903	.	G	A	26	0	26	0	0	26	0	0
6	32633034	.	T	G	44	0	44	0	1	45	0	0
6	32633041	rs9274428	T	C	47	0	47	0	0	47	0	0
6	32633053	.	T	G	45	0	45	0	0	45	0	0
6	32633054	rs9274430	C	G	45	0	45	0	0	45	0	0
6	32633083	.	C	T	60	0	60	0	0	60	0	0
6	32633086	.	G	C	60	0	60	0	0	60	0	0
6	32633087	.	A	G	59	0	59	0	0	59	0	0
6	32633099	.	C	A	72	0	72	0	0	72	0	0
6	32633102	.	C	T	72	0	72	0	0	72	0	0
6	32633131	rs9274436	C	G	76	0	76	0	0	76	0	0
6	32633174	.	C	T	99	0	99	0	0	99	0	0
6	32633181	rs9274438	T	C	102	0	102	0	0	102	0	0
6	32633186	.	A	G	101	0	101	0	0	101	0	0
6	32633196	rs9274440	A	G	103	0	103	0	0	103	0	0
6	32633226	.	T	C	116	0	116	0	1	117	0	0
6	32633231	rs9274442	G	C	120	0	120	0	0	120	0	0
6	32633239	rs9274443	C	G	113	0	113	0	0	113	0	0
6	32633252	.	T	C	118	0	118	0	0	118	0	0
6	32633268	.	G	A	108	0	108	0	0	108	0	0
6	32633273	.	G	T	108	0	108	0	1	109	0	0
6	32633282	rs9274447	T	C	115	0	115	0	1	116	0	0
6	32633285	.	C	T	121	0	121	0	0	121	0	0
6	32633290	rs9274449	G	C	128	0	128	0	1	129	0	0
6	32633334	rs9274450	A	G	114	0	114	0	0	114	0	0
6	32633355	.	G	T	123	0	123	0	0	123	0	0
6	32633356	.	T	G	123	0	123	0	0	123	0	0
6	32633369	rs9274453	C	A	115	0	115	0	2	117	0	0
6	32633371	rs9274454	T	G	115	0	115	0	0	115	0	0
6	32633375	rs9274455	A	G	111	0	111	0	1	112	0	0
6	32633380	rs281861581	G	A	113	0	113	0	1	114	0	0
6	32633392	rs9274457	C	G	111	0	111	0	0	111	0	0
6	32633394	.	C	T	111	0	111	0	0	111	0	0
6	32633409	rs9274459	T	A	120	1	121	0	0	121	0	0
6	32633413	.	G	A	120	1	121	0	0	121	0	0
6	32633425	rs9274461	T	C	110	1	111	0	0	111	0	0
6	32633426	.	G	C	111	1	112	0	2	114	0	0
6	32633466	.	A	C	99	1	100	0	0	100	0	0
6	32633489	rs9274464	T	C	95	1	96	0	0	96	0	0
6	32633490	rs9274465	T	C	94	1	95	0	0	95	0	0
6	32633491	.	T	C	95	1	96	0	0	96	0	0
6	32633498	.	G	T	91	1	92	0	0	92	0	0
6	32633590	.	G	T	75	1	76	0	0	76	0	0
6	32633595	.	A	G	74	0	74	0	1	75	0	0
6	32633617	rs9274470	G	A	94	0	94	0	0	94	0	0
6	32633632	rs9274471	A	G	92	0	92	0	1	93	0	0
6	32633665	.	C	T	111	0	111	0	0	111	0	0
6	32633676	rs9274473	C	T	118	0	118	0	0	118	0	0
6	32633683	rs9274474	C	T	124	0	124	0	0	124	0	0
6	32633687	.	T	C	126	0	126	0	2	128	0	0
6	32633697	.	C	A	131	0	131	0	0	131	0	0
6	32633713	rs9274477	A	G	127	0	127	0	3	130	0	0
6	32633744	rs9274478	C	T	149	0	149	0	0	149	0	0
6	32633749	.	A	G	138	0	138	0	1	139	0	0
6	32633753	.	C	T	151	0	151	0	0	151	0	0
6	32633756	.	C	T	146	0	146	0	3	149	0	0
6	32633786	.	C	T	136	0	136	0	2	138	0	0
6	32633809	.	T	C	160	0	160	0	1	161	0	0
6	32633818	rs9274484	C	G	150	0	150	0	0	150	0	0
6	32633830	.	G	C	147	0	147	0	3	150	0	0
6	32633837	.	A	C	148	0	148	0	0	148	0	0
6	32633844	rs9274487	T	C	144	0	144	0	0	144	0	0
6	32633852	rs9274488	A	G	138	0	138	0	1	139	0	0
6	32633855	rs28534808	G	A	0	134	134	0	3	137	0	0
6	32633878	.	C	T	137	0	137	0	0	137	0	0
6	32633879	rs9274490	A	G	135	0	135	0	1	136	0	0
6	32633885	.	T	C	130	0	130	0	0	130	0	0
6	32633897	.	T	A	122	0	122	0	1	123	0	0
6	32633898	.	C	A	120	0	120	0	3	123	0	0
6	32633906	.	C	A	130	0	130	0	3	133	0	0
6	32633907	.	C	T	131	0	131	0	2	133	0	0
6	32633909	.	A	T	126	0	126	0	3	129	0	0
6	32633928	rs9274497	G	A	121	2	123	0	1	124	0	0
6	32633941	rs9274498	A	G	130	2	132	0	2	134	0	0
6	32634010	rs3830058	G	A	158	6	164	0	2	166	0	0
6	32634024	rs9274500	T	A	150	5	155	0	0	155	0	0
6	32634032	rs9274501	A	G	141	4	145	0	1	146	0	0
6	32634103	rs796429679	T	C	140	4	144	0	0	144	0	0
6	32634104	rs9274503	C	T	138	4	142	0	2	144	0	0
6	32634111	rs9274504	C	T	93	0	93	0	1	94	0	0
6	32634126	rs9274505	G	A	84	0	84	0	1	85	0	0
6	32634141	rs9274506	T	C	73	0	73	0	0	73	0	0
6	32634152	rs9274507	G	A	62	0	62	0	1	63	0	0
6	32634154	.	G	C	62	0	62	0	0	62	0	0
6	32634170	rs9274509	G	A	70	0	70	0	0	70	0	0
6	32634184	rs9274510	A	G	78	0	78	0	1	79	0	0
6	32634189	.	C	T	73	0	73	0	0	73	0	0
6	32634192	.	A	G	74	0	74	0	1	75	0	0
6	32634209	.	A	G	75	3	78	0	1	79	0	0
6	32634243	rs9274514	G	A	74	3	77	0	0	77	0	0
6	32634300	.	G	C	1463	3	1466	0	3	1469	0	0
6	32634302	.	A	G	1419	3	1422	0	17	1440	1	0
6	32634306	.	A	T	1411	2	1413	0	3	1417	1	0
6	32634318	rs3891176	C	A	1477	2	1479	0	5	1484	0	0
6	32634331	.	G	C	1521	2	1523	0	5	1528	0	0
6	32634341	rs3189152	A	G	1444	1	1445	0	7	1452	0	0
6	32634350	rs1049057	T	C	1391	3	1394	0	0	1394	0	0
6	32634373	rs9274522	C	T	1108	4	1112	0	7	1119	0	0
6	32634387	rs1049055	C	T	956	5	961	0	7	968	0	0
6	32713487	.	G	A	9	0	9	0	0	9	0	0
6	32725619	rs9276570	T	C	76	0	76	0	1	77	0	0
6	32725620	rs9276571	G	A	74	0	74	0	1	75	0	0
6	32725625	.	T	C	74	0	74	0	0	74	0	0
6	32726803	.	C	T	81	1	82	0	2	84	0	0
6	32726966	.	C	T	0	8	8	0	0	8	0	0
6	32786068	rs17429444	A	G	3	3	6	0	0	6	0	0
6	32795706	rs55781756	G	A	30	23	53	0	0	53	0	0
6	32800224	rs2228397	C	A	47	35	82	0	0	82	0	0
6	32806461	rs2071552	A	G	13	18	31	0	0	31	0	0
6	32809223	rs2071627	C	A	5	2	7	0	0	7	0	0
6	32810443	rs9276810	G	A	6	16	22	0	0	22	0	0
6	32811383	rs6924102	A	G	11	4	15	0	0	15	0	0
6	32813768	rs116827595	G	A	16	4	20	0	0	20	0	0
6	32814127	rs1053752	G	A	8	5	13	0	0	13	0	0
6	32814447	rs6457684	T	C	3	3	6	0	0	6	0	0
6	32816054	rs735883	G	A	6	6	12	0	0	12	0	0
6	32816958	rs4148882	G	A	10	9	19	0	0	19	0	0
6	32818678	rs2071538	G	A	13	6	19	0	0	19	0	0
6	32825090	rs17587	G	A	56	48	104	0	1	105	0	0
6	32903637	rs23544	C	T	20	5	25	0	0	25	0	0
6	32903724	rs68600	C	T	14	12	26	0	0	26	0	0
6	32904039	rs77318243	T	A	15	19	34	0	0	34	0	0
6	32904051	rs75301392	C	T	14	18	32	0	0	32	0	0
6	32904661	rs171329	G	A	10	7	17	0	0	17	0	0
6	32919524	rs150358	G	A	25	32	57	0	0	57	0	0
6	32937901	rs683208	T	C	5	5	10	0	1	11	0	0
6	32941910	rs620202	G	T	8	2	10	0	0	10	0	0
6	32944746	rs11908	G	A	79	105	184	0	1	185	0	0
6	32945466	rs73409631	A	G	26	28	54	0	0	54	0	0
6	32946133	rs206781	T	C	387	555	942	0	3	946	1	0
6	32946322	rs76088152	G	A	71	87	158	0	0	158	0	0
6	32946511	rs73409636	G	A	40	74	114	0	0	114	0	0
6	32946964	rs206778	G	A	70	38	108	0	0	108	0	0
6	32948607	rs1049414	C	T	518	639	1157	0	127	1295	11	0
6	32972642	rs1044429	C	T	17	17	34	0	2	36	0	0
6	32972690	rs592625	T	C	17	16	33	0	1	34	0	0
6	32973263	rs3128936	A	T	14	10	24	0	0	24	0	0
6	32973281	rs416622	T	C	14	11	25	0	0	25	0	0
6	32973841	rs9276977	G	A	15	21	36	0	1	37	0	0
6	32974268	rs408036	T	C	14	22	36	0	0	36	0	0
6	32974551	rs2582	G	T	16	17	33	0	2	35	0	0
6	33250084	rs147173514	G	A	2	7	9	0	0	9	0	0
6	33647853	rs111882381	C	T	2	4	6	0	1	7	0	0
6	33647871	rs41271253	C	T	4	4	8	0	0	8	0	0
6	33660021	rs112677714	G	A	4	3	7	0	0	7	0	0
6	33660597	rs2229643	C	T	5	6	11	0	0	11	0	0
6	33662256	rs866899	G	A	3	3	6	0	0	6	0	0
6	33662295	rs3227	G	C	4	6	10	0	0	10	0	0
6	33663330	rs149064207	C	T	4	2	6	0	0	6	0	0
6	33740025	rs2296743	C	T	12	21	33	0	0	33	0	0
6	33740382	rs2296744	G	A	96	88	184	0	1	185	0	0
6	33740592	rs4711349	C	T	14	11	25	0	0	25	0	0
6	33741289	rs6904716	A	G	20	20	40	0	0	40	0	0
6	33741347	rs115738704	G	A	8	13	21	0	0	21	0	0
6	33741716	rs4711350	A	G	8	15	23	0	0	23	0	0
6	33742280	rs147139722	T	C	4	4	8	0	0	8	0	0
6	33742403	rs4713679	C	T	8	8	16	0	0	16	0	0
6	33742501	rs114597815	C	T	10	11	21	0	0	21	0	0
6	33742838	rs751096	T	C	10	8	18	0	0	18	0	0
6	33743264	rs2395446	C	T	5	8	13	0	1	14	0	0
6	33744337	rs139292922	A	G	8	4	12	0	0	12	0	0
6	33744711	rs2296746	C	T	13	7	20	0	0	20	0	0
6	33751784	rs55775340	C	G	3	3	6	0	0	6	0	0
6	33752559	rs113837604	C	T	5	6	11	0	1	12	0	0
6	33753673	rs2395402	G	A	1	9	10	0	0	10	0	0
6	33754396	rs9394167	A	G	6	7	13	0	0	13	0	0
6	33754423	rs144605130	T	G	9	4	13	0	0	13	0	0
6	33754592	rs4711351	G	A	8	6	14	0	0	14	0	0
6	33754817	rs4713681	T	C	15	5	20	0	0	20	0	0
6	33755890	rs756137	T	C	5	8	13	0	0	13	0	0
6	33756026	rs6457741	C	T	5	6	11	0	0	11	0	0
6	34204854	.	C	T	17	18	35	0	0	35	0	0
6	34252352	rs6691	C	T	3	5	8	0	3	11	0	0
6	34501262	rs148709618	C	A	4	6	10	0	0	10	0	0
6	34501529	rs913014	G	A	2	4	6	0	0	6	0	0
6	34555709	rs1201872	G	A	69	98	167	0	1	168	0	0
6	34556889	rs72900436	G	A	48	46	94	0	1	95	0	0
6	34557846	.	C	G	70	58	128	0	0	128	0	0
6	34561136	rs73409987	C	T	2	4	6	0	0	6	0	0
6	34561585	rs205265	A	G	1	6	7	0	0	7	0	0
6	34562196	rs205264	A	G	2	6	8	0	0	8	0	0
6	34569485	rs79316477	C	G	1	5	6	0	0	7	1	0
6	34569814	rs9469813	T	C	5	1	6	0	0	6	0	0
6	34573940	rs36032186	A	G	5	5	10	0	0	10	0	0
6	34760702	rs138593660	C	G	3	4	7	0	0	7	0	0
6	34803947	rs4259246	C	T	37	50	87	0	1	88	0	0
6	34804204	rs7761391	C	T	39	26	65	0	0	65	0	0
6	34804515	rs7743949	T	C	29	14	43	0	0	43	0	0
6	34804553	rs144394138	C	G	10	13	23	0	1	24	0	0
6	34827085	rs9469913	A	T	45	51	96	0	0	96	0	0
6	34831856	rs13205210	T	C	19	22	41	0	1	42	0	0
6	34840398	rs3734261	G	A	46	37	83	0	0	83	0	0
6	34845648	rs2985	T	C	78	52	130	0	0	130	0	0
6	34846832	rs4646944	G	A	16	10	26	0	0	26	0	0
6	34847229	rs4646940	T	C	9	4	13	0	0	13	0	0
6	34850660	rs4646933	G	A	8	2	10	0	0	10	0	0
6	34851134	rs2273006	T	C	8	8	16	0	0	16	0	0
6	34855748	rs1051115	G	C	42	47	89	0	1	90	0	0
6	34949607	rs2293242	C	T	13	10	23	0	0	23	0	0
6	34966288	rs9784818	G	A	10	12	22	0	0	22	0	0
6	34966449	rs10807143	A	G	7	8	15	0	0	15	0	0
6	34985563	rs41270044	G	A	12	15	27	0	0	27	0	0
6	35023714	rs820091	A	G	4	4	8	0	0	8	0	0
6	35026767	rs820088	G	A	8	8	16	0	0	16	0	0
6	35026774	rs820087	G	A	7	6	13	0	0	13	0	0
6	35027814	rs820086	G	C	2	6	8	0	0	8	0	0
6	35040079	rs820068	G	A	4	2	6	0	0	6	0	0
6	35043059	rs820062	G	A	3	3	6	0	0	6	0	0
6	35046154	rs820100	T	C	3	3	6	0	0	6	0	0
6	35050506	rs2177382	G	A	23	21	44	0	0	44	0	0
6	35056862	rs57111149	T	C	20	27	47	0	1	48	0	0
6	35057479	rs17610836	C	T	32	27	59	0	0	59	0	0
6	35058117	rs707968	A	G	33	17	50	0	0	50	0	0
6	35058531	rs11552398	C	T	37	35	72	0	0	72	0	0
6	35088381	rs2234045	C	G	1	6	7	0	0	7	0	0
6	35259646	rs9366883	G	C	3	7	10	0	0	10	0	0
6	35260503	rs1557567	C	T	25	31	56	0	0	56	0	0
6	35260530	.	C	T	33	32	65	0	1	66	0	0
6	35263555	rs1194	A	G	34	27	61	0	0	61	0	0
6	35263677	rs8205	T	A	21	10	31	0	0	31	0	0
6	35278796	rs10755687	A	C	5	12	17	0	0	17	0	0
6	35280697	rs6938946	C	T	17	12	29	0	0	29	0	0
6	35282090	rs6906987	C	T	6	5	11	0	0	11	0	0
6	35282375	rs6907364	A	G	4	4	8	0	0	8	0	0
6	35282463	rs6907573	C	G	4	7	11	0	0	11	0	0
6	35282993	rs2183834	A	G	9	15	24	0	0	24	0	0
6	35283958	rs13197551	T	C	12	6	18	0	1	20	1	0
6	35285543	rs6937088	G	C	25	38	63	0	1	64	0	0
6	35285720	rs2395617	A	C	95	95	190	0	0	190	0	0
6	35324894	rs73745198	T	C	3	10	13	0	0	13	0	0
6	35395010	rs3734254	C	T	6	5	11	0	0	11	0	0
6	35395578	rs1053046	G	A	5	4	9	0	0	9	0	0
6	35395618	rs1053049	C	T	4	3	7	0	0	7	0	0
6	35436195	rs41271257	G	A	201	97	298	0	2	300	0	0
6	35436571	rs11553979	C	T	24	50	74	0	3	77	0	0
6	35437451	rs41271261	T	C	25	24	49	0	0	49	0	0
6	35702748	rs75640107	T	C	3	3	6	0	0	6	0	0
6	35803283	rs2859420	C	T	11	10	21	0	0	21	0	0
6	35824684	rs115361589	A	G	4	2	6	0	0	6	0	0
6	36053802	rs1100859	G	A	2	4	6	0	0	6	0	0
6	36058814	.	C	G	23	16	39	0	0	39	0	0
6	36063119	rs851008	A	G	4	5	9	0	1	10	0	0
6	36065185	rs851006	T	C	3	4	7	0	0	7	0	0
6	36069489	rs851005	A	G	6	7	13	0	0	13	0	0
6	36069972	rs851004	G	T	11	5	16	0	0	16	0	0
6	36070671	rs3752525	G	T	5	4	9	0	0	9	0	0
6	36070955	rs2815806	G	A	3	3	6	0	0	6	0	0
6	36075219	rs9470219	A	C	3	3	6	0	0	6	0	0
6	36198577	rs3748045	G	C	16	30	46	0	0	46	0	0
6	36458864	rs138941886	G	C	13	21	34	0	0	34	0	0
6	36645696	rs2395655	A	G	3	3	6	0	0	6	0	0
6	36646807	rs3176321	C	T	16	19	35	0	0	35	0	0
6	36646849	rs3176323	T	C	21	14	35	0	0	35	0	0
6	36647490	rs3176330	G	A	7	6	13	0	0	13	0	0
6	36647525	rs3176331	C	T	5	4	9	0	0	9	0	0
6	36648364	rs3176334	T	C	9	19	28	0	1	29	0	0
6	36648816	rs3176336	A	T	6	2	8	0	0	8	0	0
6	36648920	rs3176337	A	C	6	5	11	0	1	12	0	0
6	36652339	rs3176352	C	G	16	9	25	0	0	25	0	0
6	36936771	rs7772210	A	G	118	98	216	0	3	219	0	0
6	36937500	.	G	C	165	119	284	0	5	289	0	0
6	36939213	rs3778027	C	T	15	12	27	0	0	27	0	0
6	36939279	rs3778026	C	A	16	20	36	0	1	37	0	0
6	36939528	rs9462250	C	G	27	31	58	0	0	58	0	0
6	36940273	rs6918432	G	A	28	20	48	0	0	48	0	0
6	36940343	rs2293383	G	C	13	23	36	0	1	37	0	0
6	36940805	rs831506	T	C	15	23	38	0	1	39	0	0
6	36941816	rs17624546	C	T	18	6	24	0	0	24	0	0
6	36942232	rs76813240	T	C	20	14	34	0	0	34	0	0
6	36942265	rs76137088	T	A	24	16	40	0	1	41	0	0
6	36942274	rs748409	C	G	26	16	42	0	0	42	0	0
6	36942417	rs748406	G	A	18	12	30	0	0	30	0	0
6	36942481	rs748407	A	G	14	14	28	0	0	28	0	0
6	36942746	rs748408	C	T	9	8	17	0	0	17	0	0
6	36942928	rs745506	A	G	21	20	41	0	0	41	0	0
6	36942979	rs745505	T	C	22	19	41	0	0	41	0	0
6	36943513	rs2293385	G	C	5	3	8	0	0	8	0	0
6	36943573	rs2293386	A	G	5	8	13	0	0	13	0	0
6	36943605	rs2293387	A	G	4	8	12	0	0	12	0	0
6	36943691	rs6927651	T	C	3	5	8	0	0	8	0	0
6	36943787	rs6905093	A	G	3	4	7	0	0	7	0	0
6	36943911	rs6909984	G	A	5	8	13	0	0	13	0	0
6	36943923	rs6909991	G	C	6	8	14	0	0	14	0	0
6	36944554	rs3778024	C	T	1	6	7	0	0	7	0	0
6	36945062	rs2293388	G	C	7	9	16	0	1	17	0	0
6	36945282	rs2293389	C	A	6	3	9	0	1	10	0	0
6	36946632	rs553024937	T	C	6	1	7	0	0	7	0	0
6	36946948	rs3798478	C	T	7	3	10	0	0	10	0	0
6	36948035	rs17624895	A	T	5	8	13	0	0	13	0	0
6	36948246	rs3778022	C	T	5	2	7	0	0	7	0	0
6	36948805	rs3778021	A	G	4	5	9	0	0	9	0	0
6	37142192	rs34698101	C	T	102	82	184	0	0	184	0	0
6	37252210	rs3818136	C	T	23	21	44	0	1	45	0	0
6	37299956	rs195410	C	T	19	15	34	0	0	34	0	0
6	37300149	rs2295244	C	T	24	28	52	0	1	53	0	0
6	37349066	rs34150698	G	A	3	5	8	0	0	8	0	0
6	37623566	rs3846874	C	T	5	10	15	0	0	15	0	0
6	37876386	rs171831	G	T	2	12	14	0	0	14	0	0
6	38031802	rs34038972	T	C	4	5	9	0	0	9	0	0
6	38033324	rs2645102	G	A	3	4	7	0	0	7	0	0
6	38136321	rs3801	C	T	10	4	14	0	0	14	0	0
6	38138333	rs2092426	G	A	13	15	28	0	0	28	0	0
6	38138378	rs742539	G	A	12	14	26	0	0	26	0	0
6	38139482	rs13198420	T	C	11	24	35	0	0	35	0	0
6	38139500	rs13212638	A	G	9	19	28	0	0	28	0	0
6	38139653	.	A	T	1	5	6	0	1	7	0	0
6	38139748	rs12206712	T	C	8	6	14	0	0	14	0	0
6	38139938	rs9470806	G	A	28	22	50	0	0	50	0	0
6	38139945	rs9470807	A	G	24	25	49	0	0	49	0	0
6	38140503	rs737170	C	T	16	19	35	0	0	35	0	0
6	38140505	rs737171	A	G	16	19	35	0	0	35	0	0
6	38140658	rs909998	C	T	15	22	37	0	0	37	0	0
6	38140755	rs761153	C	G	9	12	21	0	0	21	0	0
6	38141022	rs735117	G	A	15	12	27	0	0	27	0	0
6	38142004	rs3800358	G	T	16	12	28	0	0	28	0	0
6	41034858	rs11280	T	C	35	51	86	0	0	86	0	0
6	41038845	rs13191323	C	T	4	11	15	0	0	15	0	0
6	41041742	rs4140580	C	T	3	3	6	0	0	6	0	0
6	41042993	rs2268187	G	A	12	3	15	0	0	15	0	0
6	41049895	rs6918969	T	C	2	7	9	0	0	9	0	0
6	41058317	rs9471474	A	T	3	3	6	0	0	6	0	0
6	41058490	rs9471475	A	G	1	5	6	0	0	6	0	0
6	41058913	rs9296353	A	T	3	6	9	0	0	9	0	0
6	41058968	rs9296354	G	A	1	5	6	0	0	6	0	0
6	41059169	rs10080924	G	A	3	7	10	0	0	10	0	0
6	41065744	.	C	G	136	138	274	0	1	275	0	0
6	41158132	rs2038568	G	C	3	3	6	0	0	6	0	0
6	41158856	rs9462677	T	A	3	5	8	0	0	8	0	0
6	41159076	rs9471497	A	C	7	2	9	0	0	9	0	0
6	41159222	rs7754593	G	T	8	6	14	0	0	14	0	0
6	41243189	rs16894390	C	T	14	9	23	0	0	23	0	0
6	41248752	rs2234240	A	G	38	42	80	0	0	80	0	0
6	41250466	rs2234237	T	A	27	37	64	0	0	64	0	0
6	41533579	rs2104506	C	A	9	11	20	0	0	20	0	0
6	41567128	rs9471607	C	T	21	20	41	0	0	41	0	0
6	41568064	rs3747745	G	A	21	14	35	0	0	35	0	0
6	41568906	rs913075	G	A	4	4	8	0	0	8	0	0
6	41569118	rs913076	T	G	3	7	10	0	0	10	0	0
6	41569157	rs913077	G	A	2	7	9	0	0	9	0	0
6	41732151	rs6458240	A	G	5	3	8	0	0	8	0	0
6	41738158	rs1057227	C	T	19	15	34	0	1	35	0	0
6	41739173	rs35310379	C	T	6	11	17	0	1	18	0	0
6	41755708	rs41273794	C	T	2	8	10	0	0	10	0	0
6	41757836	rs8393	C	A	8	4	12	0	0	12	0	0
6	41760990	rs6938966	T	G	5	6	11	0	0	11	0	0
6	41761495	rs12202219	T	C	9	6	15	0	0	15	0	0
6	41762808	rs2282444	C	G	4	7	11	0	0	11	0	0
6	41764080	rs6902650	G	A	3	4	7	0	0	7	0	0
6	41773576	rs2185798	G	C	4	8	12	0	0	12	0	0
6	41773735	rs6926173	G	A	9	10	19	0	0	19	0	0
6	41873961	rs4714518	T	A	5	6	11	0	0	11	0	0
6	41898096	rs2479726	A	G	2	4	6	0	0	6	0	0
6	41903007	rs9529	T	C	362	357	719	0	10	729	0	0
6	41903782	rs1051130	A	C	447	360	807	0	4	811	0	0
6	41989249	rs55834072	G	A	2	4	6	0	0	6	0	0
6	41989718	rs6901077	A	G	3	4	7	0	0	7	0	0
6	41989828	rs9471733	G	C	3	3	6	0	0	6	0	0
6	41990941	rs4714551	T	A	3	3	6	0	0	6	0	0
6	41991061	rs4714552	A	G	3	4	7	0	0	7	0	0
6	41991133	rs9471734	T	A	3	4	7	0	0	7	0	0
6	41993229	rs4714556	A	G	5	3	8	0	0	8	0	0
6	41995496	rs10948006	G	T	3	3	6	0	0	6	0	0
6	42007248	.	C	A	2	4	6	0	0	6	0	0
6	42018883	rs11967378	G	T	5	7	12	0	0	12	0	0
6	42025402	rs1134218	A	G	14	21	35	0	0	35	0	0
6	42031098	rs2492941	G	A	3	4	7	0	0	7	0	0
6	42045364	rs73735020	G	A	23	40	63	0	0	63	0	0
6	42047994	rs6906808	G	T	76	69	145	0	1	146	0	0
6	42048690	rs7745547	A	G	5	6	11	0	0	11	0	0
6	42049183	rs4711705	C	T	7	5	12	0	1	13	0	0
6	42049535	rs4711706	C	T	7	3	10	0	0	10	0	0
6	42049598	rs6936467	T	G	4	3	7	0	0	7	0	0
6	42049900	rs6918636	G	C	4	9	13	0	0	13	0	0
6	42050170	rs6919008	G	A	5	2	7	0	0	7	0	0
6	42050359	rs9381134	G	C	3	13	16	0	0	16	0	0
6	42050823	rs9381135	C	T	6	4	10	0	0	10	0	0
6	42052751	rs16895221	G	A	5	8	13	0	0	13	0	0
6	42052817	rs73735023	G	T	4	4	8	0	0	8	0	0
6	42053778	rs2492935	G	A	3	3	6	0	0	6	0	0
6	42054346	rs2492937	G	A	6	3	9	0	0	9	0	0
6	42054380	rs2492938	G	T	6	6	12	0	0	12	0	0
6	42054832	rs12524651	A	G	3	3	6	0	1	7	0	0
6	42174558	rs4714580	A	G	8	8	16	0	0	16	0	0
6	42185564	rs9471809	A	C	20	26	46	0	0	46	0	0
6	42194286	rs60843126	C	T	15	20	35	0	0	35	0	0
6	42205050	rs9462789	C	G	3	3	6	0	0	6	0	0
6	42217537	rs142541864	G	A	5	4	9	0	0	9	0	0
6	42217538	rs186796991	C	A	4	4	8	0	0	8	0	0
6	42219294	rs6907771	A	G	1	5	6	0	0	6	0	0
6	42219296	rs11751949	G	A	1	5	6	0	0	6	0	0
6	42220117	rs9394891	G	T	5	3	8	0	0	8	0	0
6	42220472	rs12194245	C	T	2	5	7	0	0	7	0	0
6	42224546	rs2295275	A	T	45	40	85	0	0	85	0	0
6	42231220	rs141140394	G	A	5	12	17	0	0	17	0	0
6	42232475	rs2295274	G	A	36	31	67	0	0	67	0	0
6	42232509	rs61758087	T	C	38	34	72	0	0	72	0	0
6	42233583	.	G	A	6	5	11	0	0	11	0	0
6	42541802	rs16895843	G	C	14	11	25	0	0	25	0	0
6	42571346	rs16895863	A	T	9	12	21	0	0	21	0	0
6	42630107	rs3736745	A	G	6	1	7	0	0	7	0	0
6	42630486	rs761539	T	C	6	12	18	0	0	18	0	0
6	42659533	rs56270565	C	T	0	25	25	0	2	27	0	0
6	42660017	rs9394917	A	G	30	22	52	0	0	52	0	0
6	42852357	rs16896142	C	T	105	41	146	0	0	146	0	0
6	42855043	rs113105795	G	A	58	71	129	0	1	130	0	0
6	42856124	rs141655858	G	T	33	37	70	0	0	70	0	0
6	42856502	rs9462844	T	G	99	67	166	0	0	166	0	0
6	42858524	rs61732354	C	T	27	19	46	0	0	46	0	0
6	42897074	rs2234185	T	C	7	4	11	0	1	12	0	0
6	42897956	rs12529169	T	G	3	7	10	0	0	10	0	0
6	42900149	rs3793024	G	A	1	5	6	0	0	6	0	0
6	42902508	rs3763236	T	C	11	3	14	0	0	14	0	0
6	42903763	rs1053538	C	G	119	80	199	0	0	199	0	0
6	42903766	rs1053539	T	G	118	74	192	0	0	192	0	0
6	42904948	rs12525851	G	A	0	7	7	0	0	7	0	0
6	42908124	rs112786661	G	A	18	14	32	0	0	32	0	0
6	42909099	rs112836440	A	T	15	4	19	0	0	19	0	0
6	42913974	rs76590663	C	G	3	3	6	0	0	6	0	0
6	42915361	rs142793391	A	G	9	10	19	0	0	19	0	0
6	42931754	rs736158	G	A	7	3	10	0	0	10	0	0
6	42933526	rs2274515	C	T	13	30	43	0	0	43	0	0
6	42979301	rs41274906	A	G	76	62	138	0	5	143	0	0
6	43155718	rs145911635	G	A	25	16	41	0	1	42	0	0
6	43323852	rs34541323	C	A	32	34	66	0	0	66	0	0
6	43412865	rs2125739	T	C	15	4	19	0	0	19	0	0
6	43423779	rs3734688	A	G	4	3	7	0	0	7	0	0
6	43472708	rs3734689	T	C	41	37	78	0	1	79	0	0
6	43473884	rs72857288	A	C	48	38	86	0	0	87	1	0
6	43480307	rs2231770	A	G	2	5	7	0	0	7	0	0
6	43482765	rs12664665	T	C	3	5	8	0	0	8	0	0
6	43483538	rs2231766	C	T	6	4	10	0	0	10	0	0
6	43483539	rs2231765	C	G	6	4	10	0	0	10	0	0
6	43484532	rs2231763	G	A	129	152	281	0	3	284	0	0
6	43484643	rs2231759	G	A	87	75	162	0	0	162	0	0
6	43484844	rs2231756	G	A	6	2	8	0	0	8	0	0
6	43486125	rs80339878	G	T	1	5	6	0	0	6	0	0
6	43487363	rs9472069	A	C	16	10	26	0	1	27	0	0
6	43490809	rs7755135	C	T	21	21	42	0	0	42	0	0
6	43490947	rs11077	T	G	18	16	34	0	1	35	0	0
6	43496662	rs1106841	A	C	23	23	46	0	0	46	0	0
6	43497064	rs1111785	G	A	1	5	6	0	0	6	0	0
6	43498381	rs115112548	A	G	4	3	7	0	0	7	0	0
6	43582091	rs6941583	A	T	3	7	10	0	0	10	0	0
6	43582584	rs6899628	C	T	4	5	9	0	0	9	0	0
6	43590408	rs16896609	G	A	44	45	89	0	1	90	0	0
6	43605219	rs7749866	G	A	9	6	15	0	0	15	0	0
6	43607074	rs142704507	C	T	4	7	11	0	0	11	0	0
6	43738350	rs2010963	C	G	34	27	61	0	0	61	0	0
6	43745577	rs3024998	C	T	4	4	8	0	0	8	0	0
6	43746169	rs3025000	C	T	3	5	8	0	0	8	0	0
6	43747248	rs3025006	C	T	2	4	6	0	0	6	0	0
6	43747371	rs3025007	C	T	3	5	8	0	0	8	0	0
6	43747450	rs3025009	G	A	7	5	12	0	0	12	0	0
6	43749163	rs3025021	T	C	5	6	11	0	0	11	0	0
6	43749230	rs3025022	C	T	8	6	14	0	0	14	0	0
6	43750551	rs3025028	C	G	8	5	13	0	0	13	0	0
6	43750556	rs3025029	G	A	8	5	13	0	0	13	0	0
6	43750587	rs3025030	G	C	10	5	15	0	0	15	0	0
6	43751037	rs3025032	T	C	9	3	12	0	0	12	0	0
6	43751075	rs3025033	A	G	8	5	13	0	0	13	0	0
6	43751669	rs3025036	G	C	4	5	9	0	0	9	0	0
6	43752536	rs3025039	C	T	71	69	140	0	0	140	0	0
6	43753051	rs3025040	C	T	63	95	158	0	1	159	0	0
6	43753212	rs10434	A	G	87	98	185	0	0	185	0	0
6	43753722	rs41282644	G	A	41	37	78	0	0	78	0	0
6	44081510	rs700006	C	T	15	11	26	0	0	26	0	0
6	44115169	rs4714759	G	A	14	23	37	0	0	37	0	0
6	44117664	rs4714762	C	T	12	13	25	0	0	25	0	0
6	44119125	rs6912142	C	T	7	3	10	0	1	11	0	0
6	44119676	rs3734697	A	G	13	8	21	0	0	21	0	0
6	44122879	rs3087926	C	A	25	16	41	0	0	41	0	0
6	44147821	rs34710081	A	G	7	3	10	0	0	10	0	0
6	44151765	rs13209117	G	A	6	4	10	0	0	10	0	0
6	44215784	rs34124063	A	T	11	6	17	0	0	17	0	0
6	44215785	rs34789835	G	C	11	5	16	0	1	17	0	0
6	44215786	rs34451930	A	G	11	6	17	0	0	17	0	0
6	44218120	rs13296	A	G	1150	1082	2232	0	42	2275	1	0
6	44219710	rs2070695	A	C	3	9	12	0	0	12	0	0
6	44221404	rs11538984	G	C	1647	1569	3216	0	16	3232	0	0
6	44223010	rs1875324	G	T	72	79	151	0	1	152	0	0
6	44224924	rs575034	C	A	6	0	6	0	0	6	0	0
6	44226195	rs2282151	T	C	129	100	229	0	2	231	0	0
6	44228162	rs2233437	G	A	14	11	25	0	0	25	0	0
6	44228452	rs3799962	A	G	12	12	24	0	0	24	0	0
6	44232074	rs730775	A	G	56	48	104	0	0	104	0	0
6	45389234	rs7751427	A	G	37	16	53	0	1	54	0	0
6	45389289	rs7771980	T	C	38	16	54	0	0	54	0	0
6	45390511	rs6921145	G	A	3	4	7	0	0	7	0	0
6	45390733	rs3749864	G	C	8	8	16	0	0	16	0	0
6	45390949	rs11498195	G	C	8	7	15	0	0	15	0	0
6	45390962	rs11498196	C	T	6	7	13	0	0	13	0	0
6	45391654	rs3805811	G	C	1	7	8	0	0	8	0	0
6	45391971	rs3792952	C	T	16	31	47	0	0	47	0	0
6	45392982	rs3828722	A	G	3	3	6	0	0	6	0	0
6	45393010	rs3828723	A	G	4	2	6	0	0	6	0	0
6	45396297	rs2819859	A	C	3	3	6	0	0	6	0	0
6	45396319	rs2819858	A	T	3	3	6	0	0	6	0	0
6	45400940	rs1406846	T	A	2	6	8	0	0	8	0	0
6	45405134	rs17288411	C	A	4	4	8	0	1	9	0	0
6	45406914	rs115354589	G	C	2	6	8	0	0	8	0	0
6	45412657	rs2819853	G	A	3	4	7	0	0	7	0	0
6	45418402	rs2256819	C	T	6	1	7	0	0	7	0	0
6	45419110	rs2820339	C	G	6	4	10	0	0	10	0	0
6	45420847	rs2677100	C	T	5	1	6	0	0	6	0	0
6	45424498	rs2820340	G	A	2	4	6	0	0	6	0	0
6	45424940	rs2819861	A	G	6	7	13	0	0	13	0	0
6	45438472	rs2790094	A	G	10	8	18	0	0	18	0	0
6	45439307	rs2790095	C	G	5	3	8	0	0	8	0	0
6	45451632	.	A	G	6	4	10	0	0	10	0	0
6	45456564	rs12215249	G	T	5	8	13	0	0	13	0	0
6	45458903	rs73737435	C	T	5	5	10	0	0	10	0	0
6	45481266	rs58268689	G	A	41	17	58	0	0	58	0	0
6	45481873	rs62400367	A	G	36	35	71	0	0	71	0	0
6	45488475	rs58977496	T	G	4	2	6	0	0	6	0	0
6	45488930	rs6911664	A	T	3	3	6	0	0	6	0	0
6	45492963	rs10223365	C	T	3	5	8	0	0	8	0	0
6	45493237	rs61243460	T	C	3	5	8	0	0	8	0	0
6	45493682	rs4714859	T	C	2	7	9	0	0	9	0	0
6	45495748	rs4438954	C	G	4	2	6	0	0	6	0	0
6	45497527	rs116788323	G	A	1	5	6	0	0	6	0	0
6	45507755	rs62400375	G	A	3	4	7	0	0	7	0	0
6	45509857	rs112819862	C	T	2	5	7	0	0	7	0	0
6	45511239	.	G	A	4	7	11	0	0	11	0	0
6	45518202	rs1200428	G	T	153	138	291	0	1	292	0	0
6	46097758	rs3734208	C	G	15	5	20	0	0	20	0	0
6	46107312	rs11752816	G	A	51	16	67	0	0	67	0	0
6	46107752	rs7451713	C	G	146	57	203	0	0	203	0	0
6	46109576	rs9395158	G	T	17	6	23	0	0	23	0	0
6	46110405	rs9472698	G	A	13	5	18	0	0	18	0	0
6	46110726	rs7769738	A	G	25	25	50	0	0	50	0	0
6	46110821	rs7769902	A	G	18	17	35	0	0	35	0	0
6	46112372	rs1048076	T	C	97	68	165	0	1	166	0	0
6	46112389	rs1048077	A	G	105	65	170	0	2	172	0	0
6	46112887	rs3777632	A	G	117	47	164	0	0	164	0	0
6	46113221	rs1048082	A	T	24	13	37	0	0	37	0	0
6	46113552	rs1048083	T	G	31	22	53	0	0	53	0	0
6	47277569	rs6458555	G	A	8	6	14	0	0	14	0	0
6	47445540	rs111766401	C	G	6	9	15	0	0	15	0	0
6	47445789	rs1056434	A	C	5	5	10	0	0	10	0	0
6	47502037	rs7754290	G	C	10	8	18	0	0	18	0	0
6	47503540	rs9349412	C	T	6	4	10	0	0	10	0	0
6	47503654	.	G	C	4	3	7	0	0	7	0	0
6	47503709	rs9369711	A	G	3	4	7	0	0	7	0	0
6	47577064	rs9395287	G	A	12	4	16	0	0	16	0	0
6	47592459	.	A	G	14	13	27	0	1	28	0	0
6	47594002	rs1043276	T	C	36	37	73	0	0	73	0	0
6	49398861	rs11757098	T	C	3	3	6	0	0	6	0	0
6	49403282	rs8589	T	C	10	19	29	0	1	30	0	0
6	49425521	rs2229384	C	T	4	4	8	0	0	8	0	0
6	49444951	rs9349492	C	T	4	2	6	0	0	6	0	0
6	49695232	rs510770	A	G	0	6	6	0	0	6	0	0
6	52133494	rs17246556	A	G	2	4	6	0	0	6	0	0
6	52358010	rs78956562	C	G	3	3	6	0	0	6	0	0
6	52362405	rs6778	G	A	23	17	40	0	2	42	0	0
6	52362844	rs1056709	T	A	21	23	44	0	0	44	0	0
6	52362865	rs7746960	A	T	27	18	45	0	0	45	0	0
6	52363728	rs1056706	T	C	15	15	30	0	0	30	0	0
6	52363833	rs1064229	C	T	17	15	32	0	0	32	0	0
6	52365432	rs17652536	G	C	15	8	23	0	0	23	0	0
6	52366206	rs12189880	C	T	18	10	28	0	0	28	0	0
6	52444283	rs67996766	G	A	12	12	24	0	0	24	0	0
6	52447807	rs78240184	A	G	6	9	15	0	0	15	0	0
6	52448435	rs75670316	G	A	8	12	20	0	1	21	0	0
6	52878637	rs2297211	T	C	5	4	9	0	0	9	0	0
6	52963071	rs2876	A	G	12	18	30	0	1	31	0	0
6	53133008	rs1048706	G	A	59	66	125	0	1	126	0	0
6	53133234	rs41273874	T	G	35	39	74	0	2	76	0	0
6	53142662	rs72938770	T	A	7	7	14	0	0	14	0	0
6	53143554	rs2281274	T	C	5	6	11	0	0	11	0	0
6	53153111	rs10484662	T	G	9	9	18	0	0	18	0	0
6	53157214	rs2294852	C	G	5	2	7	0	0	7	0	0
6	53170288	.	A	G	7	3	10	0	0	10	0	0
6	53174448	rs209485	T	C	5	4	9	0	0	9	0	0
6	53179047	rs209490	C	T	4	2	6	0	0	6	0	0
6	53374696	rs12528679	T	C	4	3	7	0	0	7	0	0
6	54074940	.	G	T	0	8	8	0	0	8	0	0
6	54074945	.	G	T	0	8	8	0	0	8	0	0
6	57393125	.	A	G	0	12	12	0	0	12	0	0
6	57467175	.	A	G	0	7	7	0	0	7	0	0
6	64384645	.	T	C	1	6	7	0	0	7	0	0
6	64394066	rs41271581	A	G	178	158	336	0	1	337	0	0
6	70455995	rs3778241	T	G	2	5	7	0	1	8	0	0
6	71570641	rs9680	A	G	22	17	39	0	0	40	1	0
6	71999145	rs76452774	G	C	9	5	14	0	0	14	0	0
6	71999404	rs1885674	T	G	15	8	23	0	0	23	0	0
6	72001156	rs1407595	C	T	2	4	6	0	0	6	0	0
6	72005794	rs9354987	T	C	2	5	7	0	1	8	0	0
6	72012652	rs1056849	C	T	53	49	102	0	0	102	0	0
6	72012881	rs7773129	G	C	17	21	38	0	0	38	0	0
6	72014050	rs4707908	C	T	28	29	57	0	3	60	0	0
6	72016407	rs7753063	C	A	7	4	11	0	0	11	0	0
6	72017333	rs4707909	C	T	2	4	6	0	0	6	0	0
6	72017853	rs1044762	T	C	25	23	48	0	0	48	0	0
6	73905819	rs35522191	A	G	19	18	37	0	0	37	0	0
6	73906746	rs10943078	A	T	30	25	55	0	0	55	0	0
6	73907138	rs10455270	T	C	16	18	34	0	0	34	0	0
6	73907763	rs12215980	A	G	41	34	75	0	0	75	0	0
6	74019376	rs16883573	T	C	3	3	6	0	0	6	0	0
6	74079024	rs496530	A	G	5	1	6	0	0	6	0	0
6	74126941	rs311683	G	A	10	0	10	0	0	10	0	0
6	74128062	rs76568536	A	G	5	4	9	0	0	9	0	0
6	74128119	rs311682	G	T	6	3	9	0	0	9	0	0
6	74130680	rs149429174	C	T	7	2	9	0	0	9	0	0
6	74133712	rs4032696	T	A	20	35	55	0	1	56	0	0
6	74133896	rs12528418	A	G	82	89	171	0	0	171	0	0
6	74134143	rs7754197	C	T	78	37	115	0	1	116	0	0
6	74134592	rs45501398	T	A	83	65	148	0	1	149	0	0
6	74135016	rs311678	C	T	84	74	158	0	5	163	0	0
6	74155346	rs610913	G	T	89	83	172	0	1	173	0	0
6	74181194	rs6453676	G	A	7	6	13	0	0	13	0	0
6	74190448	rs2036039	T	C	35	42	77	0	1	78	0	0
6	74194506	rs62438381	C	T	3	3	6	0	0	6	0	0
6	74208171	rs7754947	T	C	3	3	6	0	0	6	0	0
6	74212081	rs7765670	C	T	5	6	11	0	0	11	0	0
6	74226245	rs1128073	G	T	169	117	286	0	5	291	0	0
6	74226318	rs1390082	T	A	121	78	199	0	0	199	0	0
6	74226353	rs11755449	C	T	76	113	189	0	4	193	0	0
6	74228006	rs1874229	A	G	153	133	286	0	2	288	0	0
6	74228049	rs1874230	A	G	139	134	273	0	1	274	0	0
6	74229258	rs2073466	G	T	68	77	145	0	2	147	0	0
6	74229792	rs2073465	A	G	102	111	213	0	1	214	0	0
6	74230528	rs2291719	A	G	249	262	511	0	8	519	0	0
6	74230859	rs3822960	C	T	3	4	7	0	0	7	0	0
6	74303829	rs670248	C	T	4	6	10	0	0	10	0	0
6	74304415	rs3734518	G	C	3	9	12	0	0	12	0	0
6	74413069	rs62438662	A	C	3	5	8	0	0	8	0	0
6	74414352	rs35579376	T	C	3	6	9	0	1	10	0	0
6	74414610	rs7774274	G	T	3	3	6	0	0	6	0	0
6	74416137	.	G	A	5	6	11	0	0	11	0	0
6	74416327	rs76342929	C	T	10	8	18	0	0	18	0	0
6	74416538	rs45620342	G	C	3	5	8	0	0	8	0	0
6	74418140	rs9446990	G	C	3	4	7	0	0	7	0	0
6	74423994	rs72953389	C	T	3	3	6	0	0	6	0	0
6	74424028	rs72953390	C	T	5	2	7	0	0	7	0	0
6	74424069	rs9293937	G	A	2	4	6	0	0	6	0	0
6	74430495	rs9446996	A	G	3	5	8	0	0	8	0	0
6	74431027	rs72953401	C	T	4	2	6	0	2	8	0	0
6	74432636	rs9442951	C	T	8	5	13	0	0	13	0	0
6	74432663	rs9446997	A	C	5	10	15	0	0	15	0	0
6	74434519	rs6933300	T	C	5	6	11	0	0	11	0	0
6	74476100	rs55860270	G	A	17	16	33	0	0	33	0	0
6	74490694	rs7776411	C	T	8	6	14	0	0	14	0	0
6	74490836	rs7742435	G	A	6	1	7	0	0	7	0	0
6	74490863	rs7762433	T	A	5	1	6	0	0	6	0	0
6	74492199	rs2033736	C	T	6	2	8	0	0	8	0	0
6	74497009	rs2351528	A	G	34	18	52	0	1	53	0	0
6	74497152	rs5023688	G	A	58	35	93	0	0	93	0	0
6	74498685	rs9447025	T	C	17	11	28	0	0	28	0	0
6	74498753	rs72957350	A	G	10	11	21	0	0	21	0	0
6	74498829	rs4708082	A	G	9	7	16	0	0	16	0	0
6	74499908	rs7762080	A	C	9	6	15	0	0	15	0	0
6	74499991	rs4706556	A	G	6	6	12	0	0	12	0	0
6	74500009	rs7762638	G	T	6	7	13	0	0	13	0	0
6	74500851	.	C	T	2	4	6	0	0	6	0	0
6	74501170	rs9447027	C	G	14	9	23	0	0	23	0	0
6	74501747	rs9447029	G	A	24	12	36	0	0	36	0	0
6	74502791	rs4708083	G	A	7	3	10	0	0	10	0	0
6	74533983	rs3751645	T	G	17	10	27	0	0	27	0	0
6	74534086	rs3012518	A	G	28	49	77	0	0	77	0	0
6	74535163	rs72959386	T	A	12	13	25	0	2	27	0	0
6	75323038	.	T	G	24	0	24	0	5	29	0	0
6	75323059	.	C	T	0	18	18	0	6	24	0	0
6	75951719	rs240419	A	C	10	10	20	0	0	20	0	0
6	75953220	rs240422	A	T	11	4	15	0	0	15	0	0
6	75962890	rs397039	T	C	12	9	21	0	0	21	0	0
6	75963248	rs117512	G	C	6	6	12	0	0	12	0	0
6	75963751	rs654428	C	T	67	78	145	0	0	145	0	0
6	75963951	rs381141	G	A	77	76	153	0	3	156	0	0
6	75964642	rs15616	A	G	5	5	10	0	0	10	0	0
6	75964688	rs414624	T	C	3	11	14	0	0	14	0	0
6	75964976	rs638590	C	T	46	48	94	0	0	94	0	0
6	75966269	rs418485	A	G	5	5	10	0	0	10	0	0
6	75967898	rs240381	G	A	6	2	8	0	0	8	0	0
6	75967939	rs240382	G	A	4	3	7	0	0	7	0	0
6	75968720	rs147523	G	A	10	6	16	0	1	17	0	0
6	75982280	rs240401	T	C	6	2	8	0	0	8	0	0
6	75982351	rs429746	A	G	5	2	7	0	0	7	0	0
6	76344431	rs17414086	C	T	45	27	72	0	2	74	0	0
6	76350718	rs45497991	T	A	4	2	6	0	0	6	0	0
6	76352510	rs2784730	A	G	9	5	14	0	0	14	0	0
6	76353052	rs2647401	A	G	7	4	11	0	0	11	0	0
6	76353870	rs111813622	A	G	12	9	21	0	0	21	0	0
6	76355289	rs13214795	C	T	8	4	12	0	0	12	0	0
6	76355729	rs2647402	A	G	5	13	18	0	0	18	0	0
6	76355758	rs72886846	A	T	9	3	12	0	0	12	0	0
6	76356335	rs55839204	G	A	3	4	7	0	0	7	0	0
6	76356424	rs56105244	C	T	9	4	13	0	0	13	0	0
6	76356846	rs6902058	C	G	6	9	15	0	0	15	0	0
6	76363864	rs2784733	C	T	6	2	8	0	0	8	0	0
6	76376552	rs17414687	G	A	92	68	160	0	1	161	0	0
6	76380397	.	A	C	76	83	159	0	2	161	0	0
6	76388989	rs1018103	T	G	43	39	82	0	0	82	0	0
6	76425288	rs9250	A	G	58	44	102	0	0	102	0	0
6	79912189	rs2236543	A	G	16	5	21	0	0	21	0	0
6	79922007	rs75029659	G	A	8	2	10	0	0	10	0	0
6	82412998	rs194879	A	G	3	3	6	0	0	6	0	0
6	82413767	rs194882	A	G	3	3	6	0	0	6	0	0
6	82457147	rs194607	C	G	221	243	464	0	2	466	0	0
6	82458639	rs7742628	G	T	61	59	120	0	1	121	0	0
6	82459034	rs78707197	T	C	100	129	229	0	1	230	0	0
6	82461520	rs3186631	A	G	43	33	76	0	0	76	0	0
6	82900811	rs9449444	G	A	16	11	27	0	0	27	0	0
6	82933309	rs9361904	C	T	4	5	9	0	0	9	0	0
6	83602353	rs6454308	A	G	1	6	7	0	0	7	0	0
6	83847305	.	C	A	5	4	9	0	1	10	0	0
6	83885724	.	T	A	7	6	13	0	0	13	0	0
6	84631831	rs9359574	C	G	4	5	9	0	0	9	0	0
6	84642362	rs10080466	C	T	10	11	21	0	0	21	0	0
6	84642688	rs9344378	G	A	5	2	7	0	0	7	0	0
6	84646426	rs1325468	C	T	6	7	13	0	0	13	0	0
6	84647485	rs9362021	G	A	5	2	7	0	0	7	0	0
6	84649137	rs1325469	A	G	10	6	16	0	0	16	0	0
6	84650364	rs965208	G	T	10	11	21	0	0	21	0	0
6	84650829	rs6454347	T	A	7	13	20	0	0	20	0	0
6	84650841	rs9359575	C	A	8	16	24	0	0	24	0	0
6	84670233	rs2179568	G	C	8	5	13	0	0	13	0	0
6	86221586	rs9450288	A	T	6	5	11	0	0	11	0	0
6	86221771	rs6911143	C	T	1	5	6	0	1	7	0	0
6	86302034	rs2842611	A	G	9	3	12	0	0	12	0	0
6	86318599	rs6902638	T	C	94	92	186	0	1	187	0	0
6	86329859	rs9450304	G	A	21	20	41	0	0	41	0	0
6	86331949	rs111533912	C	T	6	12	18	0	1	19	0	0
6	86334090	rs7749600	G	A	4	6	10	0	0	10	0	0
6	86334961	rs9344538	C	T	16	9	25	0	0	25	0	0
6	86335150	rs2842605	A	T	5	8	13	0	1	14	0	0
6	86340848	rs2842615	G	C	3	7	10	0	0	10	0	0
6	86344296	rs2758849	G	A	9	1	10	0	0	10	0	0
6	86344351	rs9450307	G	A	7	1	8	0	0	8	0	0
6	86387888	rs1059307	G	T	687	2206	2893	0	8	2902	1	0
6	86388223	rs3087978	C	T	227	297	524	0	6	530	0	0
6	87879712	rs9353462	C	T	12	19	31	0	0	31	0	0
6	87930462	rs73483790	T	A	4	3	7	0	0	7	0	0
6	87930777	rs3904088	C	A	3	3	6	0	0	6	0	0
6	87932948	rs7752882	A	G	23	21	44	0	0	44	0	0
6	87933239	rs9353464	C	G	9	18	27	0	0	27	0	0
6	87933404	rs73483796	A	C	10	11	21	0	1	22	0	0
6	87938232	rs73483799	T	C	5	5	10	0	0	10	0	0
6	87938363	rs6926831	T	C	7	9	16	0	0	16	0	0
6	87939637	rs9344693	C	A	3	3	6	0	0	6	0	0
6	87939964	rs9444484	A	G	8	6	14	0	0	14	0	0
6	87941980	rs73485808	A	G	7	7	14	0	0	14	0	0
6	87943281	rs16878734	A	T	3	3	6	0	0	6	0	0
6	87943955	rs16878736	G	A	6	3	9	0	0	9	0	0
6	87945858	rs73485811	A	T	16	16	32	0	0	32	0	0
6	87946124	rs11968184	A	T	7	3	10	0	0	10	0	0
6	87946125	rs11968185	A	T	7	3	10	0	0	10	0	0
6	87947383	rs73485815	A	G	2	4	6	0	0	6	0	0
6	87948572	rs9344694	A	G	11	1	12	0	0	12	0	0
6	87948730	rs138871492	C	T	7	10	17	0	0	17	0	0
6	87949470	rs138533207	T	C	3	4	7	0	1	8	0	0
6	87949515	rs9450641	A	G	9	4	13	0	0	13	0	0
6	87949639	rs9359740	A	G	7	11	18	0	0	18	0	0
6	87950339	rs112764154	A	G	1	8	9	0	0	9	0	0
6	87950713	rs73485820	T	C	11	11	22	0	0	22	0	0
6	87951272	rs7755244	A	G	5	3	8	0	0	8	0	0
6	87951336	rs59150116	C	T	5	1	6	0	0	6	0	0
6	87953637	rs58327183	T	C	3	3	6	0	0	6	0	0
6	87969341	rs16878809	G	A	98	81	179	0	1	180	0	0
6	87970301	rs3812132	C	G	116	114	230	0	1	231	0	0
6	88051262	rs398140	T	C	2	7	9	0	0	9	0	0
6	88109304	rs1051550	G	A	4	3	7	0	0	7	0	0
6	88385033	.	T	G	216	207	423	0	0	423	0	0
6	89793894	rs1130809	G	C	1627	1496	3123	0	13	3136	0	0
6	90036677	.	C	G	34	36	70	0	0	70	0	0
6	90043137	rs1998576	G	A	37	48	85	0	0	85	0	0
6	90043721	rs9451203	T	G	22	26	48	0	0	48	0	0
6	90044014	rs10944444	G	A	13	16	29	0	0	29	0	0
6	90044743	rs12206024	G	A	17	18	35	0	3	38	0	0
6	90046021	rs9451204	G	T	5	4	9	0	0	9	0	0
6	90046404	rs12189673	T	C	9	5	14	0	1	15	0	0
6	90075359	rs1062108	A	G	58	59	117	0	2	119	0	0
6	90076384	rs1555402	C	T	32	19	51	0	1	52	0	0
6	90076670	rs1555403	A	T	24	42	66	0	0	66	0	0
6	90079214	rs1321821	C	T	8	7	15	0	0	15	0	0
6	90081130	rs12199343	C	T	31	51	82	0	0	82	0	0
6	90086009	rs6454754	A	G	6	7	13	0	0	13	0	0
6	90092802	rs55650455	T	C	7	1	8	0	0	8	0	0
6	90315789	rs3748085	A	G	4	4	8	0	0	8	0	0
6	90333624	.	G	A	10	7	17	0	2	19	0	0
6	90340446	rs61739327	C	T	5	13	18	0	0	18	0	0
6	90344300	rs13191342	C	T	15	4	19	0	0	19	0	0
6	90344869	rs6905628	C	G	9	0	9	0	0	9	0	0
6	90352862	rs7682	G	A	56	49	105	0	1	106	0	0
6	90368380	rs34732313	G	A	33	26	59	0	1	60	0	0
6	90371202	rs9444701	G	A	29	38	67	0	0	67	0	0
6	90372574	rs36040566	A	C	6	6	12	0	0	12	0	0
6	90379311	rs17292768	T	C	2	5	7	0	0	7	0	0
6	90390443	rs9353689	C	A	10	13	23	0	0	23	0	0
6	90397132	rs34766278	G	C	17	19	36	0	1	37	0	0
6	90402482	rs9294445	G	A	22	24	46	0	0	46	0	0
6	90408589	rs3736984	A	G	18	19	37	0	0	37	0	0
6	90436877	rs2748298	A	C	11	10	21	0	0	21	0	0
6	90499502	rs1036853	G	A	4	2	6	0	0	6	0	0
6	90957463	rs3757247	C	T	1	5	6	0	0	6	0	0
6	91225135	rs157705	C	T	3	4	7	0	0	7	0	0
6	91255334	rs1145729	G	A	7	5	12	0	1	13	0	0
6	91255370	rs205348	G	A	4	5	9	0	0	9	0	0
6	91295964	rs12209549	G	C	2	4	6	0	0	6	0	0
6	91295984	rs282069	G	A	5	4	9	0	0	9	0	0
6	96054935	rs9387522	C	A	5	2	7	0	0	7	0	0
6	96987884	rs12207570	T	G	10	3	13	0	0	13	0	0
6	96988696	rs2475025	A	T	1	6	7	0	0	7	0	0
6	96999725	rs1127175	C	T	18	7	25	0	0	25	0	0
6	97002300	.	T	G	14	9	23	0	0	23	0	0
6	97339078	rs6684	A	G	20	25	45	0	0	45	0	0
6	97339088	rs11402	C	T	23	28	51	0	1	52	0	0
6	99819379	rs6925344	T	C	3	3	6	0	0	6	0	0
6	99847260	rs4144165	G	T	8	6	14	0	0	14	0	0
6	99847586	rs12191620	A	T	14	16	30	0	0	30	0	0
6	99848256	rs1128347	A	T	21	27	48	0	0	48	0	0
6	99850730	rs9389328	C	T	37	46	83	0	0	83	0	0
6	99851977	rs3811072	T	C	10	8	18	0	0	18	0	0
6	99852267	rs11154824	T	C	6	1	7	0	0	7	0	0
6	99856341	rs1135676	A	G	22	23	45	0	0	45	0	0
6	99857773	rs9321534	T	G	18	18	36	0	0	36	0	0
6	99859675	rs9321538	T	G	260	189	449	0	10	459	0	0
6	99863847	rs7769516	G	A	5	5	10	0	0	10	0	0
6	99866415	rs12207531	T	A	4	2	6	0	0	6	0	0
6	99873069	rs3811073	A	G	2	5	7	0	0	7	0	0
6	99878619	rs7745110	G	C	4	2	6	0	0	6	0	0
6	99994764	rs330808	G	A	3	10	13	0	0	13	0	0
6	99995053	rs170710	C	T	14	15	29	0	0	29	0	0
6	99995523	rs330809	T	G	6	6	12	0	0	12	0	0
6	99996416	rs330810	T	C	5	7	12	0	0	12	0	0
6	99996648	rs330811	C	T	2	5	7	0	1	8	0	0
6	100001973	rs330814	T	A	6	2	8	0	0	8	0	0
6	100003394	rs639488	G	A	7	1	8	0	0	8	0	0
6	100005379	rs550369	G	C	4	2	6	0	0	6	0	0
6	100964147	rs240780	G	C	8	4	12	0	0	12	0	0
6	101094554	rs239239	A	G	6	3	9	0	0	9	0	0
6	101166095	rs41288423	G	A	3	4	7	0	0	7	0	0
6	101296389	rs9390698	G	A	14	15	29	0	0	29	0	0
6	101304889	rs9377237	G	C	5	6	11	0	0	11	0	0
6	101308421	rs11963911	T	C	4	2	6	0	0	6	0	0
6	101327153	rs34555037	G	C	3	7	10	0	0	10	0	0
6	101329173	rs12530388	A	C	9	1	10	0	0	10	0	0
6	101330188	rs4840159	C	T	2	4	6	0	0	6	0	0
6	105728518	rs12212712	A	G	3	6	9	0	0	9	0	0
6	105770186	rs11883	G	C	4	3	7	0	0	7	0	0
6	105776792	rs6902415	G	A	52	58	110	0	1	111	0	0
6	105776866	rs12192054	A	C	49	53	102	0	0	102	0	0
6	105821449	rs9486069	A	G	45	34	79	0	0	79	0	0
6	106537354	rs1984224	G	T	7	5	12	0	0	12	0	0
6	106540276	rs4946725	G	A	5	4	9	0	0	9	0	0
6	106555025	rs1010273	G	A	155	121	276	0	8	284	0	0
6	106636902	rs9386514	T	C	4	3	7	0	0	7	0	0
6	106637999	rs9486301	T	C	2	4	6	0	0	6	0	0
6	107018195	.	G	C	56	45	101	0	1	102	0	0
6	107349913	rs6904668	G	A	4	4	8	0	0	8	0	0
6	107363093	rs13217360	C	T	3	3	6	0	0	6	0	0
6	107386793	rs1060369	C	T	4	6	10	0	0	10	0	0
6	107388504	rs3749872	C	T	5	3	8	0	0	8	0	0
6	107390955	rs75435915	G	A	2	6	8	0	0	8	0	0
6	108190203	rs687374	A	G	4	11	15	0	0	15	0	0
6	108210445	rs6931221	G	C	7	3	10	0	0	10	0	0
6	108211100	rs550101	C	A	4	6	10	0	0	10	0	0
6	108228852	rs485736	C	T	4	3	7	0	0	7	0	0
6	108230566	rs115564597	G	A	5	3	8	0	0	8	0	0
6	108232373	rs114269865	G	A	2	4	6	0	0	6	0	0
6	108247116	rs2818196	C	T	4	2	6	0	0	6	0	0
6	108250074	rs115080326	G	A	5	2	7	0	0	7	0	0
6	108250130	rs7764235	C	T	5	2	7	0	0	7	0	0
6	108275859	rs9486754	C	T	5	1	6	0	0	6	0	0
6	108582362	rs140180323	T	G	20	11	31	0	0	31	0	0
6	108882830	rs111556510	C	T	33	37	70	0	0	70	0	0
6	108888530	rs17532174	G	T	5	4	9	0	0	9	0	0
6	108889020	rs113412119	T	C	5	4	9	0	0	9	0	0
6	108889064	rs112704843	A	G	8	3	11	0	0	11	0	0
6	108889822	rs9372190	T	G	7	1	8	0	0	8	0	0
6	108917688	rs17069647	T	A	8	6	14	0	0	14	0	0
6	108917783	rs17532643	G	A	4	6	10	0	0	10	0	0
6	108988184	rs2153960	G	A	6	3	9	0	0	9	0	0
6	108988595	rs3800226	T	C	3	3	6	0	0	6	0	0
6	108991686	rs73763159	G	T	3	4	7	0	0	7	0	0
6	108994161	rs3800227	A	G	2	5	7	0	0	7	0	0
6	108994433	rs35396874	C	T	4	4	8	0	0	8	0	0
6	108994826	rs9398172	G	A	7	3	10	0	1	11	0	0
6	108995187	rs61192764	A	G	3	4	7	0	0	7	0	0
6	108997435	rs9374040	G	A	4	3	7	0	0	7	0	0
6	108997611	rs9400240	G	A	2	6	8	0	0	8	0	0
6	108998266	rs3800231	A	G	3	4	7	0	0	7	0	0
6	108998905	rs1935952	G	C	4	4	8	0	0	8	0	0
6	108998953	rs3800232	C	T	3	4	7	0	0	7	0	0
6	108999101	rs1935951	G	A	4	4	8	0	0	8	0	0
6	108999287	rs1935949	A	G	7	6	13	0	0	13	0	0
6	109000742	rs4946935	A	G	6	15	21	0	1	22	0	0
6	109002042	rs4945816	C	T	113	98	211	0	1	212	0	0
6	109003321	rs4946936	T	C	111	124	235	0	1	236	0	0
6	109003989	rs9400241	C	A	138	155	293	0	0	293	0	0
6	109005588	rs1062034	A	G	79	101	180	0	1	181	0	0
6	110465383	rs12662013	C	T	13	4	17	0	0	17	0	0
6	110465886	rs201823837	G	T	5	8	13	0	0	13	0	0
6	110466274	rs117333232	C	T	7	3	10	0	0	10	0	0
6	110498209	rs4257894	C	A	16	1	17	0	1	18	0	0
6	110500658	rs115691185	C	T	91	33	124	0	3	127	0	0
6	110500724	rs6913554	G	A	67	27	94	0	0	94	0	0
6	110511674	rs61494781	A	G	2	4	6	0	0	6	0	0
6	110537685	rs4947058	A	G	24	18	42	0	0	42	0	0
6	110539889	rs6938106	A	G	30	24	54	0	1	55	0	0
6	110539958	rs6938139	A	G	18	16	34	0	0	34	0	0
6	110540098	rs6938653	C	T	10	13	23	0	0	23	0	0
6	110544368	rs9487317	G	A	10	6	16	0	0	16	0	0
6	110544395	rs7766850	G	C	9	8	17	0	0	17	0	0
6	110550611	rs77839024	A	C	7	1	8	0	0	8	0	0
6	110552576	rs9487320	G	A	152	116	268	0	0	268	0	0
6	110746526	rs7756222	T	C	2	5	7	0	0	7	0	0
6	110777962	rs6907567	A	G	7	9	16	0	0	16	0	0
6	110778128	rs714368	T	C	57	33	90	0	0	90	0	0
6	110797214	rs2428188	C	G	6	4	10	0	0	10	0	0
6	110797563	rs2494551	A	C	2	8	10	0	0	10	0	0
6	111134940	rs9487532	T	C	1	5	6	0	0	6	0	0
6	111135373	rs3749865	G	C	14	4	18	0	0	18	0	0
6	111179618	rs1775125	T	C	6	12	18	0	0	18	0	0
6	111180172	rs17090851	C	T	14	24	38	0	0	38	0	0
6	111180235	rs1704716	C	T	16	14	30	0	0	30	0	0
6	111197466	rs9487544	A	G	5	6	11	0	0	11	0	0
6	111199032	rs1008155	A	G	11	5	16	0	0	16	0	0
6	111200485	rs9487547	G	A	5	8	13	0	0	13	0	0
6	111201244	rs2012303	C	T	5	8	13	0	0	13	0	0
6	111201427	rs1279598	C	G	11	1	12	0	0	12	0	0
6	111201783	rs80098969	C	A	2	6	8	0	0	8	0	0
6	111204046	rs867374	A	G	6	13	19	0	1	20	0	0
6	111206583	rs144847970	T	C	4	5	9	0	0	9	0	0
6	111206845	rs4947087	C	A	9	11	20	0	0	20	0	0
6	111207805	rs7775512	G	A	9	11	20	0	0	20	0	0
6	111211974	rs12660659	G	A	7	12	19	0	0	19	0	0
6	111284129	rs149175063	G	A	5	3	8	0	0	8	0	0
6	111288941	rs41289884	T	C	92	82	174	0	0	174	0	0
6	111317071	rs3904926	A	G	7	7	14	0	0	14	0	0
6	111317111	rs3904927	T	G	7	13	20	0	0	20	0	0
6	111318193	rs3763193	T	C	11	11	22	0	0	22	0	0
6	111318294	rs3763194	G	A	14	10	24	0	1	25	0	0
6	111324557	rs6930559	G	A	7	2	9	0	0	9	0	0
6	111326272	rs12215675	T	C	4	3	7	0	0	7	0	0
6	111587266	rs11153279	T	C	4	6	10	0	0	10	0	0
6	111620758	rs465646	G	A	13	2	15	0	0	15	0	0
6	111695073	rs455645	C	T	3	13	16	0	0	16	0	0
6	111695268	rs455732	C	T	6	9	15	0	0	15	0	0
6	111695887	rs462779	G	A	6	5	11	0	0	11	0	0
6	111696257	rs461646	G	A	5	2	7	0	0	7	0	0
6	111696852	rs458486	T	C	8	11	19	0	0	19	0	0
6	111783414	rs7764591	G	C	3	3	6	0	0	6	0	0
6	111822447	rs12529158	A	G	5	1	6	0	1	7	0	0
6	111897578	rs2235175	A	C	11	7	18	0	0	18	0	0
6	111897852	rs9320367	A	G	9	6	15	0	0	15	0	0
6	111916910	rs6905520	A	C	7	5	12	0	0	12	0	0
6	111919108	rs6941014	T	C	4	6	10	0	0	10	0	0
6	111983038	rs28763975	G	C	10	18	28	0	0	28	0	0
6	114181933	rs537535746	T	C	78	62	140	0	26	166	0	0
6	114265287	rs9481408	C	T	12	12	24	0	0	24	0	0
6	114267377	rs6908846	T	A	4	6	10	0	0	10	0	0
6	114270928	rs6568819	C	T	20	12	32	0	0	32	0	0
6	114272701	rs34789089	G	A	67	61	128	0	2	130	0	0
6	114274848	rs13204434	A	G	10	9	19	0	0	19	0	0
6	114275969	rs57386637	T	C	12	5	17	0	0	17	0	0
6	114275971	rs6907834	C	T	12	5	17	0	0	17	0	0
6	114276024	rs13194921	T	C	10	17	27	0	0	27	0	0
6	114276069	rs13209064	A	C	16	29	45	0	0	45	0	0
6	114276581	rs1964139	T	G	8	15	23	0	0	23	0	0
6	114276810	rs12660832	T	C	14	9	23	0	0	23	0	0
6	114276867	rs12665116	G	A	11	12	23	0	0	23	0	0
6	114278805	rs13191525	C	A	5	2	7	0	0	7	0	0
6	116574002	rs2232473	C	T	35	29	64	0	0	64	0	0
6	116598853	rs1128261	A	G	389	406	795	0	3	798	0	0
6	116600453	rs3749894	C	T	323	239	562	0	3	565	0	0
6	116600774	rs3749895	C	G	270	338	608	0	1	610	1	0
6	116692795	rs2640873	A	G	12	12	24	0	0	24	0	0
6	116694829	rs9488915	C	G	7	3	10	0	0	10	0	0
6	116783330	rs1057192	G	A	6	6	12	0	0	12	0	0
6	116893146	rs11961321	C	A	5	1	6	0	0	6	0	0
6	116893524	rs151313073	A	G	9	5	14	0	0	14	0	0
6	116895562	rs3798402	C	T	2	4	6	0	1	7	0	0
6	116912837	rs10457308	C	T	3	5	8	0	0	8	0	0
6	116913257	rs372182894	A	G	6	2	8	0	0	8	0	0
6	116967657	rs57991738	T	C	2	5	7	0	0	7	0	0
6	116968213	rs9488996	T	C	4	4	8	0	1	9	0	0
6	116968513	rs6568959	T	C	5	7	12	0	0	12	0	0
6	116973182	rs4946188	T	C	7	11	18	0	0	18	0	0
6	116989767	rs73765829	A	G	8	8	16	0	0	16	0	0
6	117016287	rs11969763	G	C	3	5	8	0	0	8	0	0
6	117024508	rs1165368	T	C	9	11	20	0	0	20	0	0
6	117045690	rs60931389	C	T	5	2	7	0	0	7	0	0
6	117053071	rs598405	G	A	5	1	6	0	0	6	0	0
6	117055276	.	A	C	9	8	17	0	0	17	0	0
6	117055764	rs13590	A	T	1	6	7	0	0	7	0	0
6	117923599	rs3752848	T	C	8	5	13	0	0	13	0	0
6	118320108	rs9387532	A	G	0	35	35	0	3	38	0	0
6	118320165	rs111683441	C	T	169	0	169	0	20	189	0	0
6	118320365	rs12212953	A	G	63	0	63	0	11	74	0	0
6	118320595	rs6928714	C	A	11	0	11	0	0	11	0	0
6	118847586	.	T	C	2	4	6	0	0	6	0	0
6	118886615	rs763254	T	C	5	1	6	0	0	6	0	0
6	119135426	rs2000110	A	T	15	21	36	0	0	36	0	0
6	119215801	rs36193145	G	T	11	19	30	0	0	30	0	0
6	119216057	rs74184761	G	C	10	8	18	0	0	18	0	0
6	119217940	rs4946367	G	A	2	4	6	0	0	6	0	0
6	119229562	rs9372516	C	T	3	4	7	0	0	7	0	0
6	119256079	rs1885125	A	G	18	9	27	0	0	27	0	0
6	119499566	rs1046226	G	C	273	278	551	0	2	553	0	0
6	119500239	rs3798602	G	A	350	251	601	0	5	606	0	0
6	119500674	rs2558	G	A	92	83	175	0	1	176	0	0
6	119506064	rs916471	T	A	29	16	45	0	0	45	0	0
6	119506104	rs760785	C	T	37	22	59	0	0	59	0	0
6	119506995	rs2005984	A	C	11	8	19	0	0	19	0	0
6	119507973	rs3819726	T	A	14	37	51	0	1	52	0	0
6	119507997	rs3819727	G	T	34	14	48	0	0	48	0	0
6	119508342	rs62418805	T	C	16	14	30	0	0	30	0	0
6	119508421	rs62418806	C	T	10	6	16	0	0	16	0	0
6	119508871	rs9387640	C	T	16	35	51	0	0	51	0	0
6	119517199	.	C	T	8	6	14	0	0	14	0	0
6	119517593	rs932337	G	C	14	16	30	0	0	30	0	0
6	119517983	rs4590306	G	A	12	8	20	0	1	21	0	0
6	119518918	rs62418808	G	A	6	6	12	0	0	12	0	0
6	119519476	rs11752568	G	A	7	4	11	0	0	11	0	0
6	119520051	rs6923555	T	C	1	7	8	0	0	8	0	0
6	119521149	rs6907205	C	T	7	4	11	0	0	11	0	0
6	119522306	rs9387641	T	C	5	5	10	0	0	10	0	0
6	119522353	rs9481890	T	C	7	7	14	0	0	14	0	0
6	119524684	rs9489621	T	C	7	1	8	0	0	8	0	0
6	119526350	rs9489622	G	A	9	14	23	0	1	24	0	0
6	119527411	rs909714	T	C	15	13	28	0	0	28	0	0
6	119528316	rs909715	C	T	4	5	9	0	0	9	0	0
6	119530059	rs10872173	A	G	3	5	8	0	0	8	0	0
6	119531049	rs2267673	C	A	9	4	13	0	0	13	0	0
6	119531053	rs2267674	T	C	8	4	12	0	1	13	0	0
6	119531328	rs1028327	C	T	14	4	18	0	1	19	0	0
6	119531339	rs1028328	C	T	14	6	20	0	0	20	0	0
6	119531416	rs2267675	G	T	7	9	16	0	0	16	0	0
6	119533226	rs7743299	C	T	11	5	16	0	0	16	0	0
6	119533266	rs6569056	A	G	6	6	12	0	1	13	0	0
6	119535257	rs11153796	G	C	5	4	9	0	0	9	0	0
6	119535275	rs9489625	G	A	3	5	8	0	0	8	0	0
6	119535376	rs7754289	A	G	4	3	7	0	0	7	0	0
6	119537523	rs2299876	A	G	9	4	13	0	0	13	0	0
6	119584495	rs9489637	A	G	3	3	6	0	0	6	0	0
6	119585189	rs11153802	G	A	42	31	73	0	1	74	0	0
6	119585566	rs12210002	A	G	11	10	21	0	0	21	0	0
6	119586804	rs12205826	T	C	23	15	38	0	0	38	0	0
6	119587529	rs6569061	C	T	6	4	10	0	0	10	0	0
6	119587569	rs6915957	A	C	6	4	10	0	0	10	0	0
6	119588664	rs1408492	A	G	3	7	10	0	0	10	0	0
6	119588794	rs1408493	A	T	12	20	32	0	0	32	0	0
6	119589284	rs2299881	A	G	11	15	26	0	1	27	0	0
6	119589751	rs1104741	T	C	9	9	18	0	0	18	0	0
6	119590489	rs12211868	T	C	11	17	28	0	0	28	0	0
6	119590609	rs1076656	T	G	20	13	33	0	0	33	0	0
6	119590869	rs11153803	T	C	11	9	20	0	1	21	0	0
6	119591307	rs11962211	A	C	13	24	37	0	0	37	0	0
6	119591779	rs7775421	G	T	16	13	29	0	0	29	0	0
6	119593100	rs2299884	C	G	12	24	36	0	0	36	0	0
6	119593506	rs2299886	T	C	19	25	44	0	0	44	0	0
6	119594032	rs4946406	T	C	11	15	26	0	0	26	0	0
6	119596282	rs4945633	T	A	77	23	100	0	1	101	0	0
6	119596948	rs6569063	A	G	40	32	72	0	0	72	0	0
6	119597455	rs2142885	G	T	20	17	37	0	1	38	0	0
6	119597683	rs2357375	C	T	11	13	24	0	0	24	0	0
6	119598586	rs144765958	C	A	12	15	27	0	0	27	0	0
6	119598726	rs4945634	T	C	48	57	105	0	1	106	0	0
6	119600041	rs2142886	A	G	3	4	7	0	0	7	0	0
6	119602991	rs6903249	G	A	3	3	6	0	0	6	0	0
6	119605006	rs9489664	T	C	4	2	6	0	1	7	0	0
6	119606084	rs4409209	G	A	2	4	6	0	0	6	0	0
6	119611660	rs11153805	G	C	2	6	8	0	0	8	0	0
6	119611708	rs9489670	C	T	1	5	6	0	0	6	0	0
6	119633625	rs10485001	T	C	6	6	12	0	1	13	0	0
6	119634780	rs6914447	C	T	5	2	7	0	0	7	0	0
6	119636088	rs11153810	C	T	4	5	9	0	0	9	0	0
6	119636100	rs11153811	G	A	4	2	6	0	0	6	0	0
6	119637160	rs195048	T	C	3	5	8	0	0	8	0	0
6	119639545	rs11961647	T	A	5	2	7	0	0	7	0	0
6	119640890	rs6918913	C	A	16	18	34	0	0	34	0	0
6	119641060	rs11962938	T	G	30	13	43	0	0	43	0	0
6	119642700	rs10872177	C	T	15	14	29	0	0	29	0	0
6	119644204	rs3798644	T	C	15	17	32	0	0	32	0	0
6	119645519	rs926859	T	G	3	9	12	0	0	12	0	0
6	119648593	rs6569073	C	T	6	4	10	0	0	10	0	0
6	119649165	rs9489686	A	G	23	27	50	0	1	51	0	0
6	119649491	rs195058	G	T	21	16	37	0	0	37	0	0
6	119650386	rs195062	C	T	20	22	42	0	0	42	0	0
6	119650965	rs11755967	T	C	17	18	35	0	0	35	0	0
6	119652404	rs195071	T	C	6	2	8	0	0	8	0	0
6	119653186	rs7754482	G	A	5	3	8	0	0	8	0	0
6	119656946	rs195078	G	T	24	13	37	0	0	37	0	0
6	119657175	rs6932241	T	C	5	8	13	0	0	13	0	0
6	119657640	rs195079	C	T	9	8	17	0	0	17	0	0
6	119662754	rs195083	G	C	5	7	12	0	0	12	0	0
6	119667377	rs1295386	C	T	15	14	29	0	0	29	0	0
6	119668299	rs3778111	A	G	12	9	21	0	1	22	0	0
6	119670457	rs1295388	G	C	9	24	33	0	0	33	0	0
6	122735183	rs12213993	T	G	28	24	52	0	0	52	0	0
6	122735690	rs6909985	G	T	11	12	23	0	0	23	0	0
6	122736242	rs17259607	A	T	9	2	11	0	0	11	0	0
6	122736426	rs9388072	T	C	5	6	11	0	0	11	0	0
6	122737104	rs9401538	A	G	23	24	47	0	0	47	0	0
6	122742033	rs9375135	A	T	4	3	7	0	0	7	0	0
6	122748114	rs3799540	G	A	5	1	6	0	0	6	0	0
6	122752447	rs12192360	C	T	11	11	22	0	0	22	0	0
6	122752471	rs12205759	A	G	7	10	17	0	0	17	0	0
6	122767193	rs520046	G	A	4	5	9	0	0	9	0	0
6	122768953	rs9320873	C	T	5	5	10	0	0	10	0	0
6	122770779	rs10457433	G	A	1	5	6	0	0	6	0	0
6	122771805	rs9375137	C	T	2	4	6	0	0	6	0	0
6	122776720	rs77211380	T	G	13	15	28	0	0	28	0	0
6	122776800	rs11154081	C	T	8	5	13	0	2	15	0	0
6	122777185	rs7341197	C	T	8	6	14	0	0	14	0	0
6	122778818	rs573709	T	C	2	4	6	0	0	6	0	0
6	122780216	rs2301511	A	C	3	4	7	0	0	7	0	0
6	122781522	rs483933	G	C	5	1	6	0	0	6	0	0
6	122786835	rs693669	T	C	4	2	6	0	0	6	0	0
6	122792768	rs3752574	C	T	1	5	6	0	0	6	0	0
6	125284457	rs9401790	T	C	26	28	54	0	0	54	0	0
6	125289879	rs12660986	G	A	4	2	6	0	0	6	0	0
6	126210395	rs6919947	T	G	21	29	50	0	0	50	0	0
6	126230445	rs6911452	C	T	3	4	7	0	0	7	0	0
6	126233691	rs7769687	G	A	3	4	7	0	0	7	0	0
6	126233810	rs6934967	G	A	3	4	7	0	0	7	0	0
6	126244682	rs1322755	T	C	2	4	6	0	0	6	0	0
6	126248596	rs6918302	G	A	6	5	11	0	1	12	0	0
6	126250396	rs1062718	T	A	13	25	38	0	0	38	0	0
6	126250397	rs1138820	T	A	12	24	36	0	2	38	0	0
6	126250398	rs57519248	T	A	11	26	37	0	1	38	0	0
6	126278230	rs2295005	G	C	31	32	63	0	0	63	0	0
6	130374102	rs9388768	C	A	15	11	26	0	2	28	0	0
6	130381246	rs7451021	T	C	15	13	28	0	0	28	0	0
6	131160876	rs6536	G	T	36	29	65	0	0	65	0	0
6	131161504	rs1043596	T	C	19	37	56	0	1	57	0	0
6	131180122	rs2039509	C	T	5	3	8	0	0	8	0	0
6	131181271	rs77155753	A	G	5	1	6	0	0	6	0	0
6	131190838	rs17059736	G	A	34	44	78	0	0	78	0	0
6	131193098	rs2027117	G	T	2	4	6	0	0	6	0	0
6	131197990	rs7741462	T	C	4	4	8	0	0	8	0	0
6	131199903	rs9321256	A	T	3	6	9	0	0	9	0	0
6	131203804	rs76557359	C	A	3	6	9	0	0	9	0	0
6	131537597	rs187248257	G	A	11	2	13	0	0	13	0	0
6	131895144	rs2781667	C	T	8	4	12	0	0	12	0	0
6	131900060	rs144544360	T	C	9	17	26	0	0	26	0	0
6	131917958	rs116563325	C	T	15	15	30	0	0	30	0	0
6	131927007	rs2749924	C	G	2	11	13	0	0	13	0	0
6	131929751	rs2608911	T	G	7	3	10	0	0	10	0	0
6	131930124	rs114910899	C	T	11	4	15	0	0	15	0	0
6	131930712	rs144097210	G	A	5	4	9	0	0	9	0	0
6	132792800	rs145451057	G	A	3	5	8	0	0	8	0	0
6	133003344	rs2745426	C	T	19	12	31	0	0	31	0	0
6	133003356	rs530708559	A	G	14	19	33	0	0	33	0	0
6	133003865	rs1044593	A	T	9	15	24	0	0	24	0	0
6	133005817	rs2840813	T	G	14	14	28	0	0	28	0	0
6	133006059	rs2745427	C	A	73	71	144	0	1	145	0	0
6	133006626	rs2251455	C	A	23	20	43	0	0	43	0	0
6	133006740	rs2251449	C	T	60	44	104	0	0	104	0	0
6	133008190	rs2745429	T	A	15	18	33	0	0	33	0	0
6	133008971	rs2745430	C	T	12	8	20	0	0	20	0	0
6	133010525	rs2745432	G	A	40	61	101	0	0	101	0	0
6	133012926	rs35228045	G	C	20	17	37	0	0	37	0	0
6	133013008	rs2840814	A	G	20	9	29	0	2	31	0	0
6	133035098	rs2294757	G	A	36	47	83	0	0	83	0	0
6	133135886	rs9483504	A	G	3205	3185	6390	0	63	6454	1	0
6	133137111	rs3778174	C	T	2	5	7	0	0	7	0	0
6	133138010	rs9389034	T	C	4	7	11	0	1	12	0	0
6	133138249	rs2236381	T	C	6	19	25	0	0	25	0	0
6	135287533	rs13064	A	G	118	91	209	0	1	210	0	0
6	135288663	rs12664898	T	C	5	5	10	0	0	10	0	0
6	135291293	rs11757723	C	T	4	5	9	0	0	9	0	0
6	135292118	rs9376074	T	C	12	3	15	0	0	15	0	0
6	135293512	rs4896120	C	G	4	6	10	0	0	10	0	0
6	135296073	rs4407732	C	A	3	3	6	0	0	6	0	0
6	135296963	rs9376075	A	G	5	1	6	0	0	6	0	0
6	135299959	rs13214669	T	C	2	4	6	0	0	6	0	0
6	135302740	rs35123050	G	A	4	2	6	0	0	6	0	0
6	135306980	rs56358308	A	T	4	3	7	0	0	7	0	0
6	135353851	rs7766189	A	C	45	26	71	0	1	72	0	0
6	135354094	rs4134030	G	T	15	6	21	0	0	21	0	0
6	135355118	rs4896130	C	T	14	8	22	0	1	23	0	0
6	135355507	rs9402676	C	T	41	27	68	0	0	68	0	0
6	135355723	rs7748274	A	G	26	26	52	0	0	52	0	0
6	135356216	rs11754265	G	C	59	39	98	0	1	99	0	0
6	135356501	rs181736640	T	C	31	13	44	0	1	45	0	0
6	135358567	rs7742542	T	G	19	23	42	0	1	43	0	0
6	135622819	rs4896142	T	G	2	4	6	0	0	6	0	0
6	136579063	rs41288949	T	C	41	66	107	0	1	108	0	0
6	136693745	.	A	T	61	70	131	0	2	133	0	0
6	136901944	rs9389408	A	C	4	2	6	0	0	6	0	0
6	136902785	.	A	T	5	8	13	0	0	13	0	0
6	136957574	rs9376218	T	A	5	7	12	0	0	12	0	0
6	136957575	rs2179347	C	T	5	7	12	0	0	12	0	0
6	136957664	rs2064205	T	C	7	8	15	0	0	15	0	0
6	136990283	rs3765259	T	C	14	20	34	0	3	37	0	0
6	137026266	rs9321567	T	G	75	92	167	0	0	167	0	0
6	137102365	rs9376230	C	A	7	6	13	0	0	13	0	0
6	137105400	rs9483947	C	T	13	11	24	0	0	24	0	0
6	137110016	rs9402848	G	A	11	9	20	0	1	21	0	0
6	137110188	rs6899530	T	C	9	4	13	0	0	13	0	0
6	137113137	rs55666429	G	A	13	17	30	0	0	30	0	0
6	137519588	rs11914	A	C	170	117	287	0	4	291	0	0
6	137540423	rs17181471	C	T	69	35	104	0	2	106	0	0
6	138732756	rs9495079	G	C	12	6	18	0	0	18	0	0
6	138734029	rs2076279	A	C	515	254	769	0	6	775	0	0
6	138734422	rs1053657	C	T	31	4	35	0	0	35	0	0
6	138740001	rs6570234	G	A	4	7	11	0	0	11	0	0
6	138740182	rs6930305	G	C	3	8	11	0	0	11	0	0
6	138740439	rs6570235	C	T	8	7	15	0	1	16	0	0
6	138742782	rs9484162	C	G	5	3	8	0	0	8	0	0
6	138745299	rs9495082	G	A	3	4	7	0	0	7	0	0
6	139104092	rs4896401	A	T	2	5	7	0	0	7	0	0
6	139225925	rs12619	G	T	6	7	13	0	0	13	0	0
6	139234163	rs1188862	C	T	5	3	8	0	0	8	0	0
6	139234355	rs1188863	A	C	2	5	7	0	0	7	0	0
6	139237444	rs1143203	G	A	9	4	13	0	0	13	0	0
6	139237644	rs2698741	G	A	3	14	17	0	0	17	0	0
6	139237959	rs1741645	C	A	17	17	34	0	0	34	0	0
6	139238198	rs1730377	G	C	15	12	27	0	0	27	0	0
6	139240166	rs139202397	A	C	3	4	7	0	0	7	0	0
6	139240378	rs1358637	T	C	13	13	26	0	0	26	0	0
6	139244774	rs1188877	C	T	5	1	6	0	0	6	0	0
6	139250519	rs1188893	G	T	4	5	9	0	0	9	0	0
6	139351479	rs7746774	A	G	2	4	6	0	0	6	0	0
6	139353785	rs9495316	A	T	5	1	6	0	0	6	0	0
6	139358208	rs4896421	A	G	2	5	7	0	0	7	0	0
6	139361073	rs2498643	G	A	0	6	6	0	0	6	0	0
6	139361937	rs2504377	C	T	6	6	12	0	0	12	0	0
6	139362045	rs9484230	T	G	5	5	10	0	0	10	0	0
6	139487394	rs7768941	T	C	1	5	6	0	0	6	0	0
6	139488160	rs34476011	C	T	194	151	345	0	1	346	0	0
6	139488959	rs72980682	C	G	45	51	96	0	0	96	0	0
6	139489710	rs72980683	C	T	42	41	83	0	1	84	0	0
6	139491700	rs7774899	G	A	10	11	21	0	1	22	0	0
6	139491806	rs78697103	G	A	8	6	14	0	0	14	0	0
6	139491807	rs78511673	G	A	8	6	14	0	0	14	0	0
6	139493038	rs117984918	G	A	3	5	8	0	0	8	0	0
6	139493742	rs75925486	G	C	5	2	7	0	0	7	0	0
6	139494800	rs6938506	T	C	4	6	10	0	0	10	0	0
6	139496471	rs9689163	T	C	3	4	7	0	0	7	0	0
6	139496800	rs9688825	C	T	9	14	23	0	0	23	0	0
6	139499547	rs72980699	T	C	11	23	34	0	0	34	0	0
6	139500135	rs7745259	T	C	81	112	193	0	4	197	0	0
6	139501104	rs9689738	T	C	76	90	166	0	2	168	0	0
6	139561731	rs138957599	T	C	11	8	19	0	0	19	0	0
6	139562440	rs10499208	G	C	4	5	9	0	0	9	0	0
6	139563937	rs142843391	G	A	8	3	11	0	0	11	0	0
6	139564101	rs12529180	C	T	4	10	14	0	0	14	0	0
6	139576736	rs17068451	C	T	5	4	9	0	0	9	0	0
6	139607998	rs4530878	A	G	6	0	6	0	0	6	0	0
6	139659441	.	T	C	4	3	7	0	0	7	0	0
6	139695061	rs1131400	G	T	457	407	864	0	5	869	0	0
6	139695565	rs1131399	T	A	407	366	773	0	4	777	0	0
6	142533064	rs225701	C	T	2	4	6	0	0	6	0	0
6	142533622	rs225702	A	G	5	6	11	0	0	11	0	0
6	142533999	rs225704	A	G	5	2	7	0	0	7	0	0
6	142535403	rs225705	G	A	7	7	14	0	0	14	0	0
6	142538102	rs225708	G	A	6	3	9	0	0	9	0	0
6	142538279	rs225709	C	T	3	5	8	0	0	8	0	0
6	142541259	rs225710	C	T	12	8	20	0	0	20	0	0
6	143747270	rs1061220	T	C	3	5	8	0	0	8	0	0
6	143748686	rs9496618	A	T	4	6	10	0	0	10	0	0
6	143748722	rs3088203	T	C	2	7	9	0	0	9	0	0
6	143748801	rs9496619	A	G	2	7	9	0	0	9	0	0
6	143765329	rs72988638	G	T	2	6	8	0	0	8	0	0
6	143793364	.	G	A	7	3	10	0	0	10	0	0
6	143825104	rs11155297	G	T	33	29	62	0	0	62	0	0
6	144144875	rs41285027	G	A	6	7	13	0	0	13	0	0
6	144145282	rs11969396	T	A	7	1	8	0	0	8	0	0
6	144145797	rs1082	A	C	6	3	9	0	0	9	0	0
6	144145951	rs11963739	C	G	7	4	11	0	0	11	0	0
6	144148874	rs34853285	A	G	4	7	11	0	0	11	0	0
6	144149009	rs1061690	G	A	3	3	6	0	0	6	0	0
6	144149889	rs10447447	A	G	7	5	12	0	0	12	0	0
6	144151026	rs117010774	T	A	5	6	11	0	0	11	0	0
6	144170503	rs4140442	T	A	5	1	6	0	0	6	0	0
6	144177146	rs147118940	A	G	5	1	6	0	0	6	0	0
6	144181952	rs1884089	C	T	5	6	11	0	0	11	0	0
6	144182969	rs17073137	T	A	6	5	11	0	0	11	0	0
6	144489706	rs77790824	A	G	15	19	34	0	0	34	0	0
6	145132575	rs4143181	C	T	6	7	13	0	0	13	0	0
6	145143435	rs9497093	A	C	6	0	6	0	0	6	0	0
6	146128580	rs35807318	A	G	5	7	12	0	0	12	0	0
6	146130055	rs9376965	G	A	5	3	8	0	0	8	0	0
6	147526156	rs78929375	C	G	51	38	89	0	4	93	0	0
6	147685480	rs6924763	A	G	4	5	9	0	0	9	0	0
6	147704113	rs34677388	A	G	16	12	28	0	0	28	0	0
6	149693534	rs182527288	C	A	10	0	10	0	0	10	0	0
6	149795522	rs7747948	G	A	4	9	13	0	0	13	0	0
6	149899916	rs147513433	G	A	8	7	15	0	0	15	0	0
6	149909491	rs9322188	C	T	7	4	11	0	0	11	0	0
6	149912199	rs9322191	T	G	72	94	166	0	2	168	0	0
6	149920748	rs117937568	G	A	3	4	7	0	0	7	0	0
6	150005250	rs56246065	A	G	44	33	77	0	0	77	0	0
6	151413717	rs11558820	G	T	24	28	52	0	0	52	0	0
6	152443389	rs12681	C	T	25	41	66	0	1	67	0	0
6	152443744	rs2295190	G	T	28	29	57	0	1	58	0	0
6	152453291	rs35591210	G	A	21	14	35	0	0	35	0	0
6	152464839	rs2256135	A	G	17	10	27	0	0	27	0	0
6	152469496	.	G	A	21	15	36	0	0	36	0	0
6	152570334	.	C	A	11	6	17	0	0	17	0	0
6	153296541	rs2073260	G	C	9	4	13	0	0	13	0	0
6	153304588	rs2073262	C	T	4	4	8	0	0	8	0	0
6	153306749	rs3757063	T	G	4	2	6	0	0	6	0	0
6	153323594	.	C	T	96	20	116	0	0	116	0	0
6	153323709	rs3818125	T	C	36	4	40	0	3	43	0	0
6	153603373	rs9371678	T	C	26	0	26	0	0	26	0	0
6	154727408	rs9397716	T	C	2	10	12	0	0	12	0	0
6	154829511	rs62432728	G	C	5	6	11	0	0	11	0	0
6	154829835	rs60707704	A	G	13	4	17	0	0	17	0	0
6	154830044	rs62432729	T	C	12	2	14	0	0	14	0	0
6	154830717	rs62432730	G	A	13	1	14	0	0	14	0	0
6	154830816	rs57619897	A	G	7	1	8	0	0	8	0	0
6	155141313	rs17552819	C	T	169	150	319	0	3	322	0	0
6	155162621	rs4870315	T	C	32	28	60	0	1	61	0	0
6	155163201	rs7750126	G	A	8	4	12	0	0	12	0	0
6	155311390	rs12528718	G	C	4	2	6	0	0	6	0	0
6	155606325	rs324356	C	T	9	6	15	0	0	15	0	0
6	157222817	rs79498233	T	C	8	15	23	0	0	23	0	0
6	157257373	rs7742283	T	G	5	7	12	0	0	12	0	0
6	157259958	rs2282075	G	T	7	5	12	0	0	12	0	0
6	157261473	rs6901717	C	G	3	3	6	0	0	6	0	0
6	157261832	rs6906602	C	T	3	3	6	0	0	6	0	0
6	157262028	rs6906983	C	T	3	4	7	0	0	7	0	0
6	157262423	rs62434290	G	A	4	2	6	0	0	6	0	0
6	157264716	rs2236421	G	A	4	4	8	0	0	8	0	0
6	157336610	rs6557519	C	T	2	4	6	0	0	6	0	0
6	157337720	rs4870505	A	C	3	5	8	0	0	8	0	0
6	157360754	rs72501758	T	A	7	0	7	0	1	8	0	0
6	157361137	rs4501442	T	G	5	1	6	0	0	6	0	0
6	157371657	rs1977129	G	A	7	14	21	0	0	21	0	0
6	157379318	rs62424288	T	C	3	16	19	0	0	19	0	0
6	157379554	rs62424289	A	G	3	9	12	0	0	12	0	0
6	157379845	rs62424290	C	G	3	14	17	0	0	17	0	0
6	157380253	rs11961696	G	A	3	5	8	0	0	8	0	0
6	157381025	rs62424291	T	A	1	11	12	0	0	12	0	0
6	157711777	rs6605502	C	T	10	10	20	0	0	20	0	0
6	157712088	rs6916984	C	T	7	7	14	0	0	14	0	0
6	157713662	rs1136157	T	C	59	56	115	0	2	117	0	0
6	157963743	rs2365611	G	A	6	4	10	0	0	10	0	0
6	158294184	rs9355424	G	C	63	64	127	0	1	128	0	0
6	158294878	rs3805770	A	G	3	3	6	0	0	6	0	0
6	158295690	rs7768913	T	C	7	12	19	0	0	19	0	0
6	158296022	rs17455079	C	G	3	6	9	0	0	9	0	0
6	158299500	rs3792936	C	T	4	4	8	0	1	9	0	0
6	158299952	rs9356100	C	T	7	6	13	0	0	13	0	0
6	158302369	rs6455870	G	A	11	14	25	0	1	26	0	0
6	158302599	rs140680533	A	C	14	8	22	0	0	22	0	0
6	158302745	rs9346953	G	T	12	16	28	0	0	28	0	0
6	158303455	rs2092562	T	G	9	10	19	0	0	19	0	0
6	158303588	rs2746219	G	A	18	13	31	0	0	31	0	0
6	158304083	rs7741141	A	G	12	27	39	0	0	39	0	0
6	158304651	rs3828706	C	A	21	18	39	0	1	40	0	0
6	158304915	rs2746217	A	G	5	4	9	0	0	9	0	0
6	158305737	rs4352704	T	C	18	18	36	0	0	36	0	0
6	158307549	rs1883823	G	A	11	9	20	0	0	20	0	0
6	158307715	rs9347731	C	T	13	17	30	0	0	30	0	0
6	158307760	rs9347732	C	A	12	16	28	0	0	28	0	0
6	158308997	rs17651914	A	G	24	27	51	0	0	51	0	0
6	158310198	rs117854441	C	T	24	21	45	0	0	45	0	0
6	158310260	rs142982499	C	T	15	15	30	0	0	30	0	0
6	158310594	rs16900493	T	C	18	16	34	0	0	34	0	0
6	158311274	rs3805772	T	C	4	3	7	0	0	7	0	0
6	158311620	rs117675311	T	G	3	4	7	0	0	7	0	0
6	158312783	rs3805773	G	A	2	7	9	0	0	9	0	0
6	158315408	rs9365549	G	C	0	6	6	0	0	6	0	0
6	158316153	rs9356106	T	A	3	3	6	0	0	6	0	0
6	158317132	rs6924813	T	C	4	6	10	0	0	10	0	0
6	158323089	rs149013129	G	A	7	4	11	0	0	11	0	0
6	158327269	rs9365567	T	C	7	6	13	0	0	13	0	0
6	158328607	rs6903697	C	T	10	11	21	0	1	22	0	0
6	158328695	rs3828709	C	T	7	9	16	0	0	16	0	0
6	158328887	rs3805779	T	C	7	7	14	0	0	14	0	0
6	158329202	rs3792938	G	A	6	13	19	0	0	19	0	0
6	158329546	rs3792939	G	A	13	12	25	0	1	26	0	0
6	158329598	rs3792940	A	G	15	16	31	0	0	31	0	0
6	158329975	rs3805780	G	A	18	11	29	0	0	29	0	0
6	158330149	rs6928703	T	C	8	11	19	0	0	19	0	0
6	158330478	rs2235843	T	C	8	7	15	0	0	15	0	0
6	158330765	rs3211067	G	A	67	75	142	0	1	143	0	0
6	158331150	rs2076573	G	A	4	7	11	0	0	11	0	0
6	158331681	rs9458832	C	T	5	3	8	0	0	8	0	0
6	158333069	rs3805781	C	T	3	3	6	0	0	6	0	0
6	158333117	rs3805782	G	A	4	4	8	0	0	8	0	0
6	158333660	rs3805783	T	C	4	6	10	0	0	10	0	0
6	158334600	rs73026690	T	C	4	4	8	0	0	8	0	0
6	158335336	rs9458847	T	G	3	5	8	0	0	8	0	0
6	158337350	rs6908794	G	A	3	3	6	0	1	7	0	0
6	158337471	rs6925907	C	G	7	9	16	0	0	16	0	0
6	158338166	rs9365576	C	T	7	4	11	0	0	11	0	0
6	158338656	rs73026699	T	G	2	4	6	0	0	6	0	0
6	158339208	rs9364693	C	T	5	2	7	0	0	7	0	0
6	158339491	rs9356118	T	C	5	1	6	0	0	6	0	0
6	158339516	rs9355429	G	A	5	1	6	0	0	6	0	0
6	158340209	rs34414553	G	C	5	6	11	0	0	11	0	0
6	158340849	rs11753210	T	C	4	2	6	0	0	6	0	0
6	158342286	rs2235841	C	T	6	3	9	0	0	9	0	0
6	158343394	rs3792941	C	T	5	2	7	0	0	7	0	0
6	158345082	rs4709729	T	G	6	0	6	0	0	6	0	0
6	158346263	rs9355434	A	G	4	5	9	0	0	9	0	0
6	158346935	rs9347771	A	G	4	6	10	0	0	10	0	0
6	158347579	rs11753803	T	C	5	2	7	0	0	7	0	0
6	158357201	rs724897	T	G	6	4	10	0	0	10	0	0
6	158357463	rs6940339	C	T	7	11	18	0	0	18	0	0
6	158357542	rs6923192	G	A	8	14	22	0	0	22	0	0
6	158357585	rs6940527	C	G	9	6	15	0	0	15	0	0
6	158359003	rs6916934	A	C	25	33	58	0	0	58	0	0
6	158359064	rs6455918	T	C	30	34	64	0	0	64	0	0
6	158359475	rs6455919	A	G	20	23	43	0	0	43	0	0
6	158359817	rs113710023	T	G	27	7	34	0	0	34	0	0
6	158360495	rs3805784	G	A	26	30	56	0	0	56	0	0
6	158360507	rs117960778	G	A	27	25	52	0	0	52	0	0
6	158361823	rs1077649	G	C	25	13	38	0	2	40	0	0
6	158361899	rs912879	C	T	29	22	51	0	0	51	0	0
6	158363064	rs117692239	G	C	6	5	11	0	0	11	0	0
6	158363602	rs3749843	G	A	25	26	51	0	0	51	0	0
6	158363647	rs3749844	T	C	24	22	46	0	0	46	0	0
6	158364760	rs1043864	A	G	54	83	137	0	0	137	0	0
6	158364982	rs9365617	C	G	69	67	136	0	1	138	1	0
6	158365035	rs577	C	T	74	99	173	0	0	173	0	0
6	158448559	rs9456988	C	G	2	4	6	0	0	6	0	0
6	158507981	rs2296506	G	A	10	6	16	0	1	17	0	0
6	158517308	rs2502601	A	G	7	12	19	0	0	19	0	0
6	158517451	rs2502600	A	G	12	10	22	0	0	22	0	0
6	158518507	rs1048394	T	C	8	6	14	0	0	14	0	0
6	158518639	rs17490133	A	G	7	7	14	0	0	14	0	0
6	158519155	rs2502599	T	C	4	17	21	0	0	21	0	0
6	158519189	rs2502598	C	G	6	16	22	0	0	22	0	0
6	158532187	rs2502606	A	G	6	9	15	0	0	15	0	0
6	159031370	rs55844923	C	T	2	4	6	0	0	6	0	0
6	159038759	rs552418507	C	T	6	5	11	0	0	11	0	0
6	159054127	rs73016232	T	C	5	2	7	0	0	7	0	0
6	159091331	rs317802	C	T	4	2	6	0	0	6	0	0
6	159094023	rs2583078	T	C	3	5	8	0	0	8	0	0
6	159094294	.	G	C	4	8	12	0	0	12	0	0
6	159094468	rs2919753	T	C	1	7	8	0	1	9	0	0
6	159096496	rs935094	A	G	8	13	21	0	1	22	0	0
6	159109681	rs11753677	A	C	3	4	7	0	0	7	0	0
6	159111402	.	G	A	11	7	18	0	0	18	0	0
6	159124476	rs9457443	A	G	2	4	6	0	0	6	0	0
6	159184507	rs2291386	C	T	63	51	114	0	1	115	0	0
6	159184677	rs2291385	C	T	4	2	6	0	0	6	0	0
6	159185293	rs74966713	C	T	4	4	8	0	0	8	0	0
6	159185563	rs3123101	T	A	48	59	107	0	0	107	0	0
6	159187074	.	A	C	313	276	589	0	5	594	0	0
6	159187331	rs3205303	A	C	305	247	552	0	10	562	0	0
6	159187347	rs3734470	A	T	344	236	580	0	23	613	10	0
6	159187355	rs1057038	A	T	304	282	586	0	16	602	0	0
6	159188128	rs2242318	A	G	22	26	48	0	0	48	0	0
6	159190019	rs3102976	T	G	21	32	53	0	0	53	0	0
6	159190184	rs3102975	G	A	27	35	62	0	0	62	0	0
6	159191422	rs112579396	G	A	8	7	15	0	1	16	0	0
6	159191533	rs12201279	C	T	6	7	13	0	0	13	0	0
6	159191788	rs3212308	C	T	5	1	6	0	0	6	0	0
6	159192045	rs1038537	A	G	5	7	12	0	0	12	0	0
6	159192119	rs6942167	C	T	2	5	7	0	0	7	0	0
6	159192807	rs79373377	A	G	36	31	67	0	3	70	0	0
6	159192919	rs3102974	G	T	43	33	76	0	0	76	0	0
6	159193395	rs3127182	A	G	39	23	62	0	0	62	0	0
6	159193759	rs77940498	T	G	54	37	91	0	1	92	0	0
6	159193884	rs113361312	G	A	45	43	88	0	0	88	0	0
6	159195184	rs3123102	A	T	32	33	65	0	1	66	0	0
6	159195743	rs3123104	A	G	41	42	83	0	2	85	0	0
6	159195781	rs3102972	G	T	28	51	79	0	4	83	0	0
6	159196044	rs9347252	G	T	34	22	56	0	6	62	0	0
6	159196128	rs9347253	G	A	21	16	37	0	0	37	0	0
6	159196150	rs3123105	T	C	24	17	41	0	1	42	0	0
6	159197371	rs9346767	T	C	61	47	108	0	1	109	0	0
6	159198260	rs3127203	C	T	3	9	12	0	0	12	0	0
6	159198266	rs3127204	G	A	3	8	11	0	0	11	0	0
6	159198380	rs3123106	C	G	5	8	13	0	0	13	0	0
6	159198730	rs3102971	T	C	9	7	16	0	0	16	0	0
6	159199219	rs6909643	C	T	9	4	13	0	0	13	0	0
6	159199286	rs3123107	C	G	7	4	11	0	0	11	0	0
6	159199519	rs3102970	G	C	6	3	9	0	0	9	0	0
6	159199751	rs3127206	G	A	8	3	11	0	0	11	0	0
6	159199763	rs11967637	C	G	5	8	13	0	0	13	0	0
6	159199778	rs3127207	G	C	8	6	14	0	0	14	0	0
6	159200846	rs9346768	G	A	2	6	8	0	0	8	0	0
6	159201400	rs7758516	C	T	4	4	8	0	0	8	0	0
6	159201609	rs80097945	C	T	14	9	23	0	0	23	0	0
6	159201833	rs3123108	C	T	10	10	20	0	0	20	0	0
6	159202184	rs3123109	C	T	7	16	23	0	0	23	0	0
6	159202988	rs1077202	C	T	9	9	18	0	0	18	0	0
6	159207331	rs3127218	A	G	4	2	6	0	0	6	0	0
6	159207590	rs756144	G	A	8	2	10	0	0	10	0	0
6	159208627	rs3123113	G	C	5	4	9	0	0	9	0	0
6	159208777	rs3799193	G	A	2	4	6	0	0	6	0	0
6	159209010	rs3123114	T	C	3	5	8	0	0	8	0	0
6	159209917	rs3123115	T	C	4	3	7	0	0	7	0	0
6	159209935	rs3127220	G	T	3	5	8	0	0	8	0	0
6	159211242	rs3127222	A	C	3	3	6	0	0	6	0	0
6	159211444	rs3127223	C	G	4	3	7	0	0	7	0	0
6	159214003	rs9347254	C	A	9	4	13	0	0	13	0	0
6	159216771	rs9364500	C	G	0	7	7	0	0	7	0	0
6	159224935	rs3127193	T	C	4	2	6	0	0	6	0	0
6	159229016	rs75124571	G	A	7	0	7	0	0	7	0	0
6	159230633	rs3123131	T	C	10	11	21	0	0	21	0	0
6	159231948	rs3123133	C	T	3	7	10	0	0	10	0	0
6	159233043	rs9347258	C	T	3	3	6	0	0	6	0	0
6	159233190	rs3102965	G	A	3	3	6	0	0	6	0	0
6	159235343	rs7761544	G	T	5	2	7	0	0	7	0	0
6	159236384	rs3102967	T	C	3	3	6	0	0	6	0	0
6	159237209	rs1486322	G	A	6	2	8	0	0	8	0	0
6	159237889	rs2171208	A	G	7	2	9	0	0	9	0	0
6	159238666	rs1872611	C	T	3	4	7	0	0	7	0	0
6	159239004	rs1994350	G	T	3	4	7	0	0	7	0	0
6	159239703	rs9457475	G	C	7	10	17	0	0	17	0	0
6	159239813	rs9457476	G	A	6	6	12	0	0	12	0	0
6	159462896	rs16889420	C	T	6	7	13	0	0	13	0	0
6	159463452	rs926657	C	T	3	4	7	0	0	7	0	0
6	159463605	rs75290071	C	G	5	1	6	0	0	6	0	0
6	159463964	rs9295089	T	C	8	7	15	0	0	15	0	0
6	159465977	rs1738074	T	C	120	120	240	0	1	241	0	0
6	160101532	rs10370	T	G	89	100	189	0	5	194	0	0
6	160101746	rs5746148	T	C	113	102	215	0	2	217	0	0
6	160101778	rs5746147	G	A	117	85	202	0	0	202	0	0
6	160103084	rs5746136	C	T	165	121	286	0	2	288	0	0
6	160104086	rs55642860	G	A	34	33	67	0	0	67	0	0
6	160104838	rs3798215	T	C	41	26	67	0	0	67	0	0
6	160104844	rs2758330	G	T	41	29	70	0	2	72	0	0
6	160106235	rs4523113	T	A	5	7	12	0	0	12	0	0
6	160106421	rs2758333	C	T	17	22	39	0	0	39	0	0
6	160106463	rs2842956	A	G	20	18	38	0	0	38	0	0
6	160108286	rs5746118	G	A	21	14	35	0	1	36	0	0
6	160108425	rs2842958	A	G	6	10	16	0	0	16	0	0
6	160108549	rs9456442	T	C	15	6	21	0	0	21	0	0
6	160110140	rs1800666	C	T	6	4	10	0	0	10	0	0
6	160110160	rs9456443	T	C	10	5	15	0	1	16	0	0
6	160111011	rs2758335	G	A	7	5	12	0	0	12	0	0
6	160111081	rs2758337	T	C	10	5	15	0	1	16	0	0
6	160111473	rs1570318	C	T	8	1	9	0	0	9	0	0
6	160112638	rs5746105	A	G	32	36	68	0	1	69	0	0
6	160114168	rs5746094	T	C	14	7	21	0	0	21	0	0
6	160114311	rs5746092	G	C	17	12	29	0	0	29	0	0
6	160147441	rs1853259	A	G	3	3	6	0	0	6	0	0
6	160147507	rs1048021	T	C	3	3	6	0	0	6	0	0
6	160147630	rs1048019	A	G	2	6	8	0	0	8	0	0
6	160148935	rs1535475	T	C	9	11	20	0	0	20	0	0
6	160149000	rs1322429	C	G	14	10	24	0	0	24	0	0
6	160150279	rs963800	C	T	4	4	8	0	0	8	0	0
6	160152776	rs7770630	T	C	24	23	47	0	1	48	0	0
6	160153452	rs2758312	G	A	159	159	318	0	0	318	0	0
6	160153919	.	G	T	11	3	14	0	3	17	0	0
6	160153920	.	T	A	12	5	17	0	0	17	0	0
6	160154099	rs2758313	G	C	12	21	33	0	0	33	0	0
6	160155558	.	C	G	9	19	28	0	0	28	0	0
6	160156266	rs7745398	A	G	6	22	28	0	1	29	0	0
6	160156633	rs2758314	G	T	8	11	19	0	0	19	0	0
6	160161225	rs4709364	C	T	20	27	47	0	0	47	0	0
6	160161628	rs6899987	T	C	30	42	72	0	1	73	0	0
6	160162836	rs4708844	G	A	45	53	98	0	2	100	0	0
6	160165779	rs911846	G	A	5	6	11	0	0	11	0	0
6	160168161	rs3798213	T	C	5	9	14	0	0	14	0	0
6	160168907	rs9347338	T	A	6	2	8	0	0	8	0	0
6	160169258	rs7766006	G	T	437	555	992	0	8	1000	0	0
6	160171608	rs6928450	T	A	11	12	23	0	0	23	0	0
6	160174303	rs3822849	A	G	33	63	96	0	0	96	0	0
6	160192928	rs9365095	T	G	2	4	6	0	0	6	0	0
6	160193049	rs9347341	A	C	3	3	6	0	0	6	0	0
6	160193129	rs9347342	T	C	3	3	6	0	0	6	0	0
6	160195205	rs9355749	G	C	3	8	11	0	0	11	0	0
6	160198359	rs3464	C	T	47	57	104	0	0	104	0	0
6	160199687	rs15982	T	C	67	58	125	0	2	127	0	0
6	160200026	rs4832	A	C	132	132	264	0	1	265	0	0
6	160200781	.	T	C	683	609	1292	0	8	1300	0	0
6	160201295	rs2295901	C	A	18	19	37	0	0	37	0	0
6	160201677	rs3818300	G	A	37	20	57	0	3	60	0	0
6	160201895	rs2295900	C	T	24	16	40	0	0	40	0	0
6	160202282	rs2295898	C	G	12	7	19	0	0	19	0	0
6	160202860	rs4235925	C	T	13	2	15	0	0	15	0	0
6	160204127	rs4709368	T	C	21	10	31	0	0	31	0	0
6	160204356	rs7764326	G	A	15	9	24	0	2	26	0	0
6	160204624	.	A	G	13	10	23	0	0	23	0	0
6	160205991	rs1547093	C	A	18	16	34	0	0	34	0	0
6	160206115	rs1547094	A	C	13	7	20	0	0	20	0	0
6	160206716	rs3818298	T	C	30	25	55	0	1	56	0	0
6	160207570	rs4709369	A	G	7	5	12	0	0	12	0	0
6	160210061	rs4709370	A	G	57	51	108	0	2	110	0	0
6	160211039	rs6929124	C	T	9	8	17	0	0	17	0	0
6	160211215	rs6929510	C	G	8	11	19	0	0	19	0	0
6	160211259	rs9365097	G	A	8	10	18	0	0	18	0	0
6	160211339	rs2273827	C	A	14	8	22	0	0	22	0	0
6	160211421	rs2273826	A	G	11	6	17	0	0	17	0	0
6	160211424	rs2273825	A	C	11	8	19	0	0	19	0	0
6	160211441	rs16890798	T	C	10	8	18	0	0	18	0	0
6	160211445	rs2273824	C	T	10	9	19	0	0	19	0	0
6	160211485	rs2273823	T	C	8	8	16	0	0	16	0	0
6	160211554	rs1128661	T	G	67	52	119	0	0	119	0	0
6	160211636	rs1128670	G	A	151	152	303	0	1	304	0	0
6	160211700	rs9355278	C	G	2	5	7	0	0	7	0	0
6	160214487	rs10945635	C	A	6	1	7	0	1	8	0	0
6	160216182	rs9347348	C	T	3	3	6	0	0	6	0	0
6	160216577	rs2093480	A	G	6	2	8	0	0	8	0	0
6	160216634	rs182993861	A	G	3	5	8	0	0	8	0	0
6	160217433	rs6930904	T	A	3	3	6	0	0	6	0	0
6	160239835	rs9347350	T	C	3	4	7	0	0	7	0	0
6	160468278	rs998075	A	G	15	14	29	0	0	29	0	0
6	160469510	rs8191808	C	G	18	11	29	0	0	29	0	0
6	160514283	rs80254170	A	G	3	4	7	0	0	7	0	0
6	161551218	rs9458136	G	A	21	13	34	0	0	34	0	0
6	161555226	rs41268549	G	A	5	3	8	0	0	8	0	0
6	161555840	rs10945713	C	T	7	6	13	0	0	13	0	0
6	161556159	rs3798225	A	G	3	3	6	0	0	6	0	0
6	163879296	rs2759394	G	A	7	8	15	0	0	15	0	0
6	163880506	rs2759395	C	T	13	11	24	0	0	24	0	0
6	163880516	.	A	G	13	11	24	0	0	24	0	0
6	163913182	rs1744924	C	T	3	5	8	0	0	8	0	0
6	163914457	rs1614795	A	G	8	0	8	0	0	8	0	0
6	163965150	rs13199835	G	C	9	4	13	0	0	13	0	0
6	163966098	rs9347763	G	A	6	7	13	0	0	13	0	0
6	163966888	rs1238371	A	C	5	2	7	0	0	7	0	0
6	163969279	rs4709722	A	G	2	6	8	0	0	8	0	0
6	163980882	rs7769145	G	C	7	2	9	0	0	9	0	0
6	163986482	rs715020	A	G	14	14	28	0	0	28	0	0
6	163987389	rs9456869	T	A	9	7	16	0	0	16	0	0
6	166734745	rs1599841	T	C	1	6	7	0	0	7	0	0
6	166736518	rs12191010	G	C	8	31	39	0	0	39	0	0
6	166737132	rs1610311	C	G	7	5	12	0	0	12	0	0
6	166737688	.	T	C	1	6	7	0	0	7	0	0
6	166737980	rs4710041	G	A	5	7	12	0	0	12	0	0
6	166745394	rs6927168	C	G	89	87	176	0	1	177	0	0
6	166747512	rs4144887	G	A	1	11	12	0	0	12	0	0
6	166747572	rs4144886	A	G	3	5	8	0	0	8	0	0
6	166747796	rs4144888	C	T	5	4	9	0	0	9	0	0
6	166748622	rs10455976	A	C	4	7	11	0	0	11	0	0
6	166750452	rs7771603	A	G	2	9	11	0	0	11	0	0
6	166750597	rs10455977	A	G	4	3	7	0	0	7	0	0
6	166751416	rs9356478	C	T	68	65	133	0	1	134	0	0
6	166755975	rs10862	T	C	66	98	164	0	3	167	0	0
6	166755979	rs11168	A	C	63	95	158	0	1	159	0	0
6	166778679	rs3728	T	G	25	19	44	0	0	44	0	0
6	166795621	rs1569459	A	C	7	1	8	0	0	8	0	0
6	166795986	rs1546855	C	T	5	2	7	0	0	7	0	0
6	166796433	rs1546854	C	A	30	12	42	0	1	43	0	0
6	166826021	rs2984	C	T	77	67	144	0	3	147	0	0
6	166826255	rs909631	G	A	47	34	81	0	0	81	0	0
6	166826304	rs760670	T	C	59	46	105	0	1	106	0	0
6	166827436	rs2235295	T	C	12	6	18	0	0	18	0	0
6	166829151	rs6934944	C	A	2	6	8	0	0	8	0	0
6	166830696	rs6925364	A	C	5	7	12	0	0	12	0	0
6	166830978	rs6925920	A	G	6	4	10	0	0	10	0	0
6	166875795	rs3817797	A	C	2	7	9	0	0	9	0	0
6	166880294	rs12200581	A	T	6	3	9	0	0	9	0	0
6	166924671	rs13195698	G	A	4	3	7	0	0	7	0	0
6	166996728	rs733591	T	C	5	3	8	0	0	8	0	0
6	167000171	.	C	G	4	7	11	0	0	11	0	0
6	167000486	rs7742514	A	G	8	1	9	0	0	9	0	0
6	167000602	rs9457187	A	G	12	4	16	0	0	16	0	0
6	167001024	rs6928849	G	A	6	2	8	0	0	8	0	0
6	167001646	rs3799602	A	G	8	1	9	0	0	9	0	0
6	167001913	rs3799600	C	T	5	3	8	0	0	8	0	0
6	167002252	rs3799598	A	G	4	3	7	0	1	8	0	0
6	167002326	rs3799597	A	C	6	2	8	0	0	8	0	0
6	167003381	rs3778385	C	T	4	3	7	0	0	7	0	0
6	167005259	rs12190451	A	G	5	1	6	0	0	6	0	0
6	167005335	rs35501888	A	G	9	3	12	0	0	12	0	0
6	167006078	rs113866698	C	T	8	1	9	0	0	9	0	0
6	167028063	rs58727224	C	T	2	8	10	0	0	10	0	0
6	167028134	rs6923603	G	C	5	9	14	0	0	14	0	0
6	167028309	rs60145177	T	C	2	4	6	0	0	6	0	0
6	167028547	rs12204787	A	T	1	5	6	0	2	8	0	0
6	167029860	rs916389	G	A	4	5	9	0	0	9	0	0
6	167030062	rs916388	G	A	4	4	8	0	0	8	0	0
6	167030577	rs3799571	T	C	5	5	10	0	0	10	0	0
6	167030620	rs3799570	G	A	4	4	8	0	0	8	0	0
6	167031487	rs3778373	G	A	3	4	7	0	0	7	0	0
6	167032325	rs3778372	T	C	12	18	30	0	0	30	0	0
6	167032343	rs75422652	C	T	12	20	32	0	0	32	0	0
6	167032656	rs72503823	G	A	8	9	17	0	0	17	0	0
6	167040463	rs10946179	A	G	41	38	79	0	2	81	0	0
6	167333231	rs148944387	T	C	3	3	6	0	0	6	0	0
6	167355083	.	A	C	2	12	14	0	0	14	0	0
6	167359345	rs3777727	A	G	2	33	35	0	5	40	0	0
6	167359558	rs2769343	C	T	12	48	60	0	0	60	0	0
6	167360104	rs2236312	G	A	6	54	60	0	0	60	0	0
6	167360724	rs1079145	G	A	1	6	7	0	0	7	0	0
6	167366394	rs2769345	T	C	0	7	7	0	0	7	0	0
6	167369897	rs1044059	C	A	45	235	280	0	0	280	0	0
6	167369992	rs2247325	A	G	37	97	134	0	0	134	0	0
6	167430186	rs4710171	A	G	6	1	7	0	0	7	0	0
6	167431829	rs9459839	T	C	4	2	6	0	0	6	0	0
6	167435325	rs7749278	T	C	5	2	7	0	0	7	0	0
6	167435582	rs62436763	T	C	2	4	6	0	0	6	0	0
6	167441624	rs2181059	T	C	4	2	6	0	0	6	0	0
6	167443402	rs6456146	C	T	3	3	6	0	0	6	0	0
6	167444160	rs9459849	G	T	3	3	6	0	0	6	0	0
6	167451129	rs10946204	T	C	3	3	6	0	0	6	0	0
6	167451775	rs162294	C	T	2	4	6	0	0	6	0	0
6	167455139	rs162297	A	G	2	12	14	0	0	14	0	0
6	170063806	rs4236175	T	C	4	5	9	0	1	10	0	0
6	170106827	.	C	T	3	5	8	0	0	8	0	0
6	170114004	.	G	A	5	1	6	0	0	6	0	0
6	170620320	rs10946256	C	G	5	4	9	0	0	9	0	0
6	170627651	rs9460113	G	A	21	15	36	0	4	40	0	0
6	170667673	rs3734772	A	G	2	5	7	0	0	7	0	0
6	170679596	rs9460126	A	C	4	3	7	0	0	7	0	0
6	170681747	rs3734766	G	A	14	16	30	0	0	30	0	0
6	170715419	rs3734764	C	T	4	5	9	0	0	9	0	0
6	170844605	rs3823299	C	T	8	3	11	0	0	11	0	0
6	170845933	rs742348	C	G	10	7	17	0	0	17	0	0
6	170846902	rs6456228	C	G	14	4	18	0	0	18	0	0
6	170847498	rs12207807	C	T	14	2	16	0	0	16	0	0
6	170849476	rs2056970	T	C	7	4	11	0	0	11	0	0
6	170850157	rs2223474	G	A	11	4	15	0	0	15	0	0
6	170850278	rs2206284	G	A	5	8	13	0	0	13	0	0
6	170850862	rs756519	G	A	2	4	6	0	0	6	0	0
6	170853550	rs6932750	T	C	14	8	22	0	0	22	0	0
6	170853686	rs6919159	C	T	22	11	33	0	0	33	0	0
6	170854203	rs2038093	G	C	9	6	15	0	1	16	0	0
6	170854754	rs4579340	G	A	14	9	23	0	0	23	0	0
6	170856880	rs760909	A	C	5	2	7	0	0	7	0	0
6	170858332	rs17860779	G	A	16	21	37	0	0	37	0	0
6	170858520	rs6914744	A	C	11	12	23	0	0	23	0	0
6	170858780	rs9356663	C	T	12	10	22	0	1	23	0	0
6	170859715	rs3778589	T	C	12	13	25	0	0	25	0	0
6	170859902	rs7758044	A	G	6	7	13	0	1	14	0	0
6	170860549	rs3800236	A	T	11	4	15	0	0	15	0	0
6	170862051	rs4710839	G	C	15	5	20	0	0	20	0	0
6	170862300	rs12717	G	C	422	278	700	0	7	707	0	0
6	170867205	rs74723330	A	C	6	2	8	0	0	8	0	0
6	170869433	rs9366157	T	A	2	4	6	0	0	6	0	0
6	170871040	.	A	G	24	19	43	0	0	43	0	0
6	170871046	.	A	G	22	18	40	0	3	43	0	0
6	170871049	.	G	A	24	17	41	0	3	44	0	0
6	170871055	.	G	A	21	13	34	0	1	35	0	0
6	170878793	rs1042327	T	C	3	6	9	0	0	9	0	0
6	170881130	rs2072916	T	C	3	3	6	0	0	6	0	0
6	170886531	rs8770	T	C	52	43	95	0	1	96	0	0
6	170887693	rs3173219	G	C	16	19	35	0	0	35	0	0
6	170891493	rs2066954	G	T	6	5	11	0	0	11	0	0
6	170891856	rs2072917	C	A	8	4	12	0	0	12	0	0
6	170892100	rs9295417	T	C	9	5	14	0	0	14	0	0
7	164835	rs74915383	G	C	0	14	14	0	0	14	0	0
7	198401	rs4075862	C	T	5	5	10	0	0	10	0	0
7	645851	.	G	A	21	15	36	0	0	36	0	0
7	804082	rs112452291	A	G	3	4	7	0	0	7	0	0
7	804434	rs4720893	G	A	6	5	11	0	0	11	0	0
7	805363	rs35928068	G	C	4	2	6	0	0	6	0	0
7	805430	rs34086011	C	T	5	4	9	0	0	9	0	0
7	805837	rs35410966	T	C	3	4	7	0	1	8	0	0
7	808835	rs140560123	G	A	1	5	6	0	0	6	0	0
7	814788	rs3922641	G	A	17	20	37	0	0	37	0	0
7	822712	rs111817573	C	T	6	1	7	0	0	7	0	0
7	825494	rs9458	G	A	16	20	36	0	2	38	0	0
7	825786	rs9195	T	C	10	12	22	0	0	22	0	0
7	889358	rs12669325	T	C	5	5	10	0	0	10	0	0
7	930608	rs11543223	G	A	80	82	162	0	0	162	0	0
7	932977	.	G	T	5	5	10	0	0	10	0	0
7	936043	.	G	A	28	23	51	0	2	53	0	0
7	940181	rs10256887	C	T	54	38	92	0	1	93	0	0
7	942327	rs6461807	T	A	7	1	8	0	0	8	0	0
7	968554	rs10240265	G	T	12	6	18	0	0	18	0	0
7	969164	.	A	C	14	3	17	0	1	18	0	0
7	969694	rs36020954	T	C	6	4	10	0	0	10	0	0
7	971124	rs6956301	G	A	5	2	7	0	0	7	0	0
7	1005436	rs6462223	A	G	9	6	15	0	0	16	1	0
7	1006573	rs7792825	T	C	26	26	52	0	0	52	0	0
7	1009337	rs10264122	T	C	2	4	6	0	0	6	0	0
7	1012006	rs35588238	G	A	9	11	20	0	0	20	0	0
7	1012103	rs10499317	C	G	4	9	13	0	1	14	0	0
7	1036799	rs8591	G	A	13	49	62	0	3	65	0	0
7	1097183	rs11761941	G	A	2	7	9	0	0	9	0	0
7	1097394	rs11767527	T	C	5	8	13	0	0	13	0	0
7	1097895	rs61910751	A	G	3	5	8	0	1	9	0	0
7	1098404	rs1047302	C	T	10	10	20	0	0	20	0	0
7	1098405	rs77434655	G	A	11	10	21	0	0	21	0	0
7	1098414	rs75398423	T	G	11	10	21	0	0	21	0	0
7	1098518	rs2293523	G	A	6	4	10	0	0	10	0	0
7	1192572	rs1133122	C	A	105	65	170	0	0	170	0	0
7	1193378	rs13245024	C	T	7	5	12	0	1	13	0	0
7	1194274	rs11763865	G	A	8	7	15	0	0	15	0	0
7	1194526	rs12532101	C	T	4	13	17	0	0	17	0	0
7	1194543	rs10279766	G	C	17	10	27	0	0	27	0	0
7	1195215	rs1133116	A	C	509	531	1040	0	5	1045	0	0
7	1196403	rs147071751	G	A	12	7	19	0	0	19	0	0
7	1196665	rs6945392	C	G	11	11	22	0	0	22	0	0
7	1196675	rs12666678	G	C	11	11	22	0	0	22	0	0
7	1478495	rs4492283	A	G	17	7	24	0	0	24	0	0
7	1480285	rs118132501	C	T	15	9	24	0	1	25	0	0
7	1489684	rs186620500	G	A	5	2	7	0	0	7	0	0
7	1510834	rs149670463	C	T	256	214	470	0	5	475	0	0
7	1511504	rs57790608	A	G	13	11	24	0	0	24	0	0
7	1511589	rs62435331	A	G	6	8	14	0	0	14	0	0
7	1519361	rs9692164	A	G	2	4	6	0	0	6	0	0
7	1521875	rs4560715	T	C	5	3	8	0	0	8	0	0
7	1522157	rs10227674	T	C	8	4	12	0	0	12	0	0
7	1522607	rs11971663	A	G	7	2	9	0	0	9	0	0
7	1522884	rs10952126	G	C	6	1	7	0	0	7	0	0
7	1522988	rs1137532	C	T	5	6	11	0	0	11	0	0
7	1523559	rs10235180	T	C	7	3	10	0	0	10	0	0
7	1525563	rs10280410	T	G	8	5	13	0	0	13	0	0
7	1525761	rs10277028	A	G	4	4	8	0	0	8	0	0
7	1525769	rs6946371	C	T	4	4	8	0	0	8	0	0
7	1533513	rs2251226	A	G	66	42	108	0	0	108	0	0
7	1538614	rs2289035	G	A	67	55	122	0	0	122	0	0
7	1540535	rs56173921	A	C	0	8	8	0	0	8	0	0
7	1542697	rs3752714	G	A	59	42	101	0	1	102	0	0
7	1542814	rs3752715	T	C	23	20	43	0	0	43	0	0
7	1543981	rs1369011	C	A	7	3	10	0	0	10	0	0
7	1544128	rs2278460	G	T	5	1	6	0	0	6	0	0
7	1574402	rs116844385	C	T	30	26	56	0	0	56	0	0
7	1855531	rs7680	G	A	16	13	29	0	0	29	0	0
7	1937261	rs10267593	G	A	3	4	7	0	0	7	0	0
7	1976457	rs1801368	C	T	25	27	52	0	0	52	0	0
7	1979741	rs11557347	G	A	11	5	16	0	0	16	0	0
7	1979750	rs10950456	G	A	5	11	16	0	0	16	0	0
7	2149947	rs7809320	G	A	6	3	9	0	0	9	0	0
7	2149967	rs10224497	A	G	5	5	10	0	0	10	0	0
7	2151178	rs3778973	C	T	5	1	6	0	0	6	0	0
7	2257612	rs6951493	G	A	51	47	98	0	0	98	0	0
7	2278103	rs11547270	C	G	6	5	11	0	0	11	0	0
7	2278183	rs34418140	C	T	4	6	10	0	0	10	0	0
7	2278226	rs7799006	C	T	4	8	12	0	0	12	0	0
7	2290522	rs1799832	C	T	271	320	591	0	6	598	1	0
7	2290685	rs1062492	C	T	186	239	425	0	0	425	0	0
7	2291910	rs62442512	G	A	5	5	10	0	0	10	0	0
7	2291943	rs2256545	G	A	7	7	14	0	0	14	0	0
7	2294123	rs12534131	C	T	6	11	17	0	0	17	0	0
7	2294712	rs144465573	C	T	31	35	66	0	0	66	0	0
7	2298227	rs2398668	C	T	6	6	12	0	1	13	0	0
7	2301484	rs10447540	A	G	2	4	6	0	0	6	0	0
7	2302382	rs140095697	G	A	2	5	7	0	0	7	0	0
7	2304275	rs34262822	C	T	5	2	7	0	0	7	0	0
7	2314652	rs878534	G	A	7	4	11	0	0	11	0	0
7	2410151	rs4721650	A	G	11	13	24	0	0	24	0	0
7	2410482	rs4721651	G	A	3	3	6	0	0	6	0	0
7	2410567	rs4721652	G	T	2	7	9	0	0	9	0	0
7	2410677	rs7804900	A	G	5	7	12	0	0	12	0	0
7	2411644	rs6958478	C	T	27	25	52	0	1	53	0	0
7	2411685	rs6978000	A	T	25	23	48	0	0	48	0	0
7	2411768	rs4719519	G	A	31	26	57	0	0	57	0	0
7	2412032	rs1010303	G	A	29	31	60	0	0	60	0	0
7	2412493	rs1548595	C	T	27	34	61	0	0	61	0	0
7	2413258	rs1419722	T	C	22	28	50	0	0	50	0	0
7	2413329	rs3807432	G	T	23	22	45	0	0	45	0	0
7	2413948	rs883667	C	T	35	19	54	0	0	54	0	0
7	2414550	rs884566	C	A	8	9	17	0	0	17	0	0
7	2414567	rs1010302	G	A	8	10	18	0	0	18	0	0
7	2414587	rs1010301	T	C	11	10	21	0	0	21	0	0
7	2414757	rs1010300	C	T	9	6	15	0	0	15	0	0
7	2415771	rs4721656	T	C	37	45	82	0	0	82	0	0
7	2415905	rs4721657	A	G	31	31	62	0	1	63	0	0
7	2415948	rs4721658	A	G	28	20	48	0	3	51	0	0
7	2416203	rs12669470	C	T	31	26	57	0	1	58	0	0
7	2416822	rs2240347	A	G	5	4	9	0	0	9	0	0
7	2486969	.	C	G	8	3	11	0	0	11	0	0
7	2487174	.	C	G	6	2	8	0	0	8	0	0
7	2577781	rs1043291	T	C	69	82	151	0	5	156	0	0
7	2578237	rs4719552	T	C	38	22	60	0	0	60	0	0
7	2578434	rs4721763	G	T	9	9	18	0	0	18	0	0
7	2579691	rs77056351	C	G	9	8	17	0	0	17	0	0
7	2579757	rs77651117	G	A	11	6	17	0	0	17	0	0
7	2580070	rs1061545	T	C	2	10	12	0	1	13	0	0
7	2580275	rs6461429	A	G	7	8	15	0	0	15	0	0
7	2581994	rs3735104	T	C	7	8	15	0	0	15	0	0
7	2582233	rs3735106	A	G	7	9	16	0	0	16	0	0
7	2582381	rs61673178	T	A	6	10	16	0	0	16	0	0
7	2582452	rs6972204	T	C	4	9	13	0	0	13	0	0
7	2588551	rs7804517	A	C	6	1	7	0	0	7	0	0
7	2613062	rs61739566	T	C	16	17	33	0	1	34	0	0
7	2613424	rs2917750	T	G	2	4	6	0	0	6	0	0
7	2614082	rs62442628	G	C	3	3	6	0	1	7	0	0
7	2644519	rs2293404	C	T	7	8	15	0	1	16	0	0
7	2644607	rs2293405	G	T	9	10	19	0	0	19	0	0
7	2645552	rs2293407	A	G	9	9	18	0	0	18	0	0
7	2646796	rs61729413	G	A	13	7	20	0	0	20	0	0
7	2646950	rs1056568	T	G	4	2	6	0	2	8	0	0
7	2647007	rs17833498	G	A	8	0	8	0	0	8	0	0
7	2649765	rs77267206	C	T	9	10	19	0	0	19	0	0
7	2649777	rs1061566	C	T	9	9	18	0	0	18	0	0
7	2650076	rs55958164	G	T	12	5	17	0	0	17	0	0
7	2650223	rs3823603	G	C	15	5	20	0	0	20	0	0
7	2651421	rs3735112	G	C	3	6	9	0	0	9	0	0
7	2651563	rs3735113	G	A	3	3	6	0	0	6	0	0
7	2652838	rs11771873	C	T	6	6	12	0	0	12	0	0
7	2652877	rs11771877	C	T	8	6	14	0	0	14	0	0
7	2653028	rs3203952	G	A	5	6	11	0	0	11	0	0
7	2653792	rs2272287	C	A	6	13	19	0	1	20	0	0
7	2673858	rs10228022	G	A	5	6	11	0	0	11	0	0
7	2684070	rs62439524	C	G	5	2	7	0	0	7	0	0
7	2687228	rs62439525	G	T	68	65	133	0	1	134	0	0
7	2688190	rs35850636	C	T	13	16	29	0	0	29	0	0
7	2690166	rs10950816	C	T	11	7	18	0	0	18	0	0
7	2691610	rs13225657	G	A	8	15	23	0	0	23	0	0
7	2691736	rs35868808	A	G	11	15	26	0	0	26	0	0
7	2692200	rs12671118	G	A	14	11	25	0	0	25	0	0
7	2692806	rs6461505	C	T	3	10	13	0	0	13	0	0
7	2693922	rs7793015	A	G	4	17	21	0	1	22	0	0
7	2694343	rs10950818	C	G	8	1	9	0	0	9	0	0
7	2694528	rs10279297	C	T	6	5	11	0	0	11	0	0
7	2694788	rs10249262	G	T	4	5	9	0	0	9	0	0
7	2696655	rs12670817	G	A	7	3	10	0	0	10	0	0
7	2696940	rs6461508	C	T	8	9	17	0	0	17	0	0
7	2702316	rs72570997	C	T	140	171	311	0	2	313	0	0
7	2747852	rs34774255	T	C	2	5	7	0	0	7	0	0
7	2748451	rs77345769	C	G	5	3	8	0	0	8	0	0
7	2748487	rs13235873	A	G	2	4	6	0	0	6	0	0
7	2748758	rs59438885	G	C	3	4	7	0	0	7	0	0
7	2748803	rs58726146	C	T	3	3	6	0	1	7	0	0
7	2750450	rs61128220	G	C	0	6	6	0	0	6	0	0
7	2750918	rs10252130	T	C	5	1	6	0	0	6	0	0
7	2752487	rs7776970	G	A	9	7	16	0	1	17	0	0
7	2752932	rs7778736	C	T	14	16	30	0	0	30	0	0
7	2753498	rs10245798	C	T	14	7	21	0	0	21	0	0
7	2753725	rs11976039	C	T	15	7	22	0	0	22	0	0
7	2753929	rs10950842	A	C	8	4	12	0	0	12	0	0
7	2754085	rs9648271	G	A	24	12	36	0	0	36	0	0
7	2754625	rs4719646	A	G	16	8	24	0	0	24	0	0
7	2754753	rs10228264	C	T	19	13	32	0	0	32	0	0
7	2755114	rs10257124	G	A	2	5	7	0	0	7	0	0
7	2755237	rs7797295	G	C	6	2	8	0	0	8	0	0
7	2755372	rs13438342	G	T	2	5	7	0	0	7	0	0
7	2755594	.	G	A	5	3	8	0	0	8	0	0
7	2755916	rs7802871	C	A	5	2	7	0	0	7	0	0
7	2757420	rs6965989	T	C	7	2	9	0	1	10	0	0
7	2757534	rs6979597	G	A	6	3	9	0	0	9	0	0
7	2758158	rs1184662	G	A	7	6	13	0	0	13	0	0
7	2758224	rs798561	T	C	5	9	14	0	0	14	0	0
7	2758607	rs61265604	A	G	7	1	8	0	1	9	0	0
7	2763440	rs798543	G	A	40	22	62	0	1	63	0	0
7	2763534	rs798542	A	T	44	14	58	0	0	58	0	0
7	2764665	rs798539	A	G	30	16	46	0	0	46	0	0
7	2765455	rs78468528	C	T	28	18	46	0	1	47	0	0
7	2765723	rs4722006	C	T	31	24	55	0	0	55	0	0
7	2765786	rs798538	T	C	28	21	49	0	0	49	0	0
7	2766104	rs798537	C	T	35	17	52	0	1	53	0	0
7	2766877	rs6944607	A	G	20	15	35	0	0	35	0	0
7	2766935	rs6461550	C	T	44	15	59	0	1	60	0	0
7	2767077	rs798535	G	A	59	18	77	0	1	78	0	0
7	2767605	rs7800633	C	T	33	5	38	0	0	38	0	0
7	2767607	rs798534	T	C	7	28	35	0	0	35	0	0
7	2767939	rs798533	T	C	56	71	127	0	4	131	0	0
7	2768561	rs11354	C	T	462	729	1191	0	5	1196	0	0
7	2768626	rs12484	C	T	455	681	1136	0	22	1158	0	0
7	2768864	rs798532	T	C	503	735	1238	0	3	1241	0	0
7	2768897	rs4722008	C	T	714	720	1434	0	11	1445	0	0
7	2768935	rs7805092	G	T	713	696	1409	0	8	1417	0	0
7	2773605	rs208358	A	G	37	27	64	0	1	65	0	0
7	2774789	rs208357	T	G	9	7	16	0	0	16	0	0
7	2775178	rs2266920	C	T	15	17	32	0	0	32	0	0
7	2776908	.	G	T	3	4	7	0	0	7	0	0
7	2780863	rs208354	C	A	7	2	9	0	0	9	0	0
7	2783344	rs208352	G	A	4	3	7	0	0	7	0	0
7	2797948	.	A	G	2	5	7	0	0	7	0	0
7	2800126	rs208345	A	G	5	1	6	0	0	6	0	0
7	2962014	rs1636173	G	A	5	7	12	0	0	12	0	0
7	2969680	rs1621509	G	A	13	12	25	0	0	25	0	0
7	4780514	rs3087749	G	T	71	56	127	0	5	132	0	0
7	4795600	rs73674092	T	C	0	7	7	0	0	7	0	0
7	4795710	rs7777890	T	A	5	5	10	0	0	10	0	0
7	4795800	rs7778055	T	C	5	4	9	0	0	9	0	0
7	4796286	rs113351665	G	C	5	2	7	0	0	7	0	0
7	4799655	rs11978727	T	C	10	14	24	0	0	24	0	0
7	4799694	rs6463034	T	C	10	21	31	0	1	32	0	0
7	4799951	rs56101000	A	G	16	23	39	0	0	39	0	0
7	4800010	rs10268723	G	C	18	24	42	0	1	43	0	0
7	4800351	rs10258654	A	G	6	2	8	0	0	8	0	0
7	4802035	rs1053753	A	G	60	49	109	0	0	109	0	0
7	4802442	rs11727	C	T	60	52	112	0	0	112	0	0
7	4804137	rs118108927	G	A	66	61	127	0	3	130	0	0
7	4804720	rs11763090	T	C	44	53	97	0	4	101	0	0
7	4806032	rs117593597	A	C	63	69	132	0	0	132	0	0
7	4807953	.	C	T	4	3	7	0	0	7	0	0
7	4808678	rs3750019	A	T	49	48	97	0	0	97	0	0
7	4808692	rs3750018	C	T	52	49	101	0	1	102	0	0
7	4809003	rs3750016	A	G	44	50	94	0	1	95	0	0
7	4809336	rs113297525	T	C	13	28	41	0	1	42	0	0
7	4809437	rs13224156	T	G	32	28	60	0	0	60	0	0
7	4809660	rs17135096	G	T	37	52	89	0	1	90	0	0
7	4810801	rs11628	A	G	57	59	116	0	0	116	0	0
7	4821555	rs76826075	G	A	11	6	17	0	0	17	0	0
7	4823178	rs11764272	G	T	0	9	9	0	0	9	0	0
7	4823186	rs11764275	G	T	1	11	12	0	0	12	0	0
7	4823971	rs17135121	C	T	55	40	95	0	0	95	0	0
7	4824887	rs73671922	A	G	6	7	13	0	0	13	0	0
7	4825307	rs11772411	T	A	69	51	120	0	1	122	1	0
7	4825314	rs11768079	C	T	63	50	113	0	0	113	0	0
7	4825686	rs7801122	G	T	14	7	21	0	0	21	0	0
7	4826339	rs12701943	T	C	3	3	6	0	1	7	0	0
7	4827330	rs17135128	C	T	68	52	120	0	0	120	0	0
7	4827480	rs59441267	T	C	19	15	34	0	0	34	0	0
7	4827972	rs3816851	G	A	4	11	15	0	0	15	0	0
7	4828077	rs17829969	C	T	7	12	19	0	0	19	0	0
7	4828405	rs3750013	G	A	4	4	8	0	0	8	0	0
7	4828593	rs3750012	T	C	4	3	7	0	0	7	0	0
7	4828628	rs7803727	T	C	5	5	10	0	0	10	0	0
7	4829113	.	C	T	3	4	7	0	0	7	0	0
7	4829449	rs118139547	C	T	4	6	10	0	0	10	0	0
7	4829741	rs749404	T	C	28	19	47	0	2	49	0	0
7	4833639	rs2880933	A	C	1	11	12	0	0	12	0	0
7	4839882	rs3816854	T	C	4	5	9	0	0	9	0	0
7	4841313	rs6966329	A	G	5	2	7	0	0	7	0	0
7	4845312	rs2306919	T	G	5	1	6	0	0	6	0	0
7	5037483	rs7826	G	A	62	49	111	0	1	112	0	0
7	5236263	rs66613915	C	G	2	4	6	0	0	6	0	0
7	5236698	rs6954461	G	A	2	7	9	0	0	9	0	0
7	5252038	rs13227919	G	A	4	2	6	0	0	6	0	0
7	5259719	rs4720534	A	C	16	12	28	0	0	28	0	0
7	5260351	rs6951007	C	A	11	10	21	0	0	21	0	0
7	5261147	rs75825124	A	G	7	3	10	0	0	10	0	0
7	5261225	rs73328755	C	T	4	6	10	0	0	10	0	0
7	5261772	rs28434488	G	C	11	17	28	0	0	28	0	0
7	5261875	rs13246512	C	T	16	13	29	0	1	30	0	0
7	5262385	rs4720537	G	A	32	45	77	0	1	78	0	0
7	5262450	rs41280681	G	A	47	41	88	0	1	89	0	0
7	5262602	rs4724462	G	A	42	39	81	0	1	82	0	0
7	5263194	rs13223581	C	T	62	43	105	0	0	105	0	0
7	5265322	rs34429686	G	A	54	35	89	0	1	90	0	0
7	5266157	rs4072666	A	T	30	37	67	0	0	67	0	0
7	5267524	rs4720539	C	T	12	23	35	0	0	35	0	0
7	5267670	rs184548747	C	T	22	15	37	0	0	37	0	0
7	5268438	rs13225483	C	A	14	18	32	0	2	34	0	0
7	5269983	rs13229920	C	T	29	32	61	0	0	61	0	0
7	5272927	rs6949942	C	T	19	16	35	0	0	35	0	0
7	5273121	rs7904	C	T	11	14	25	0	0	25	0	0
7	5347446	rs62441156	A	G	147	132	279	0	1	280	0	0
7	5347746	rs62441157	C	T	124	116	240	0	2	242	0	0
7	5347749	rs9639976	G	A	118	124	242	0	0	242	0	0
7	5353974	rs10268669	C	T	6	11	17	0	0	17	0	0
7	5354011	rs113224031	C	G	12	12	24	0	0	24	0	0
7	5365952	rs12532382	T	C	15	15	30	0	0	30	0	0
7	5366033	rs74200696	G	A	22	17	39	0	1	40	0	0
7	5366348	rs4512302	T	G	6	13	19	0	0	20	1	0
7	5366935	rs10278799	C	T	8	12	20	0	1	21	0	0
7	5367013	.	T	C	22	9	31	0	1	32	0	0
7	5394722	rs61056534	T	G	7	4	11	0	0	11	0	0
7	5396246	rs10274937	C	A	4	3	7	0	0	7	0	0
7	5396715	rs35508364	T	C	340	337	677	0	6	683	0	0
7	5398902	rs12534467	T	C	6	7	13	0	0	13	0	0
7	5429212	rs67800908	G	A	5	5	10	0	0	10	0	0
7	5430283	rs67295626	G	A	8	2	10	0	0	10	0	0
7	5430375	rs10233187	T	C	4	2	6	0	0	6	0	0
7	5431621	rs13243906	C	G	5	1	6	0	0	6	0	0
7	5432361	rs6957458	G	A	6	2	8	0	0	8	0	0
7	5432672	rs7791057	G	A	7	2	9	0	0	9	0	0
7	5433165	rs7791840	G	C	8	3	11	0	0	11	0	0
7	5433248	rs66460815	A	G	5	1	6	0	0	6	0	0
7	5433709	rs13223697	G	C	34	56	90	0	1	91	0	0
7	5434135	rs4724668	A	G	118	128	246	0	1	247	0	0
7	5434549	rs12533110	G	A	2	4	6	0	0	6	0	0
7	5434598	rs13234328	G	A	3	4	7	0	0	7	0	0
7	5515624	rs7789129	T	G	5	3	8	0	0	8	0	0
7	5516797	rs4724696	C	T	3	4	7	0	0	7	0	0
7	5516940	rs7808325	C	T	3	4	7	0	0	7	0	0
7	5520929	rs10046575	T	C	5	2	7	0	0	7	0	0
7	5534598	rs4320462	C	T	3	4	7	0	0	7	0	0
7	5535967	rs145062513	C	A	2	4	6	0	0	6	0	0
7	5535993	rs188919779	T	G	2	4	6	0	0	6	0	0
7	5567112	rs7612	C	T	2246	1786	4032	0	43	4075	0	0
7	5567596	rs852424	C	T	9	2	11	0	0	11	0	0
7	5568366	rs852423	A	G	27	35	62	0	0	62	0	0
7	5569327	rs2908425	G	A	7	13	20	0	0	20	0	0
7	5569715	rs2966450	G	A	7	4	11	0	0	11	0	0
7	5635404	rs55718102	C	G	4	5	9	0	0	9	0	0
7	5636610	rs56113524	G	T	4	2	6	0	0	6	0	0
7	5637725	rs852481	T	G	2	5	7	0	0	7	0	0
7	5642631	rs1640235	G	A	1	7	8	0	0	8	0	0
7	5643145	rs1640233	T	C	246	204	450	0	2	452	0	0
7	5643479	rs1725183	C	T	10	10	20	0	0	20	0	0
7	5644693	rs7782428	T	C	14	9	23	0	0	23	0	0
7	5645116	rs116036920	T	C	241	86	327	0	0	327	0	0
7	5674369	rs56391533	C	G	5	6	11	0	0	11	0	0
7	5760844	rs191479357	T	C	2	6	8	0	0	8	0	0
7	5760860	rs2302907	G	A	7	2	9	0	0	9	0	0
7	5812868	rs7808644	C	T	8	1	9	0	0	9	0	0
7	5814689	rs12538870	T	C	22	3	25	0	0	25	0	0
7	5814783	rs61344986	C	T	3	18	21	0	0	21	0	0
7	5817186	rs76343407	T	C	1	12	13	0	2	15	0	0
7	5949726	rs1138495	T	C	61	0	61	0	0	61	0	0
7	5959485	.	G	A	17	16	33	0	0	33	0	0
7	5965288	.	G	A	14	6	20	0	0	20	0	0
7	5965334	.	C	T	23	10	33	0	0	33	0	0
7	5965381	.	G	A	17	40	57	0	1	58	0	0
7	5965398	.	G	A	19	41	60	0	0	60	0	0
7	6026988	rs1805321	G	A	13	6	19	0	0	19	0	0
7	6062229	rs3801030	T	C	16	14	30	0	0	30	0	0
7	6063620	.	A	G	315	342	657	0	4	661	0	0
7	6069331	rs187467155	C	T	2	4	6	0	0	6	0	0
7	6069349	rs11766390	C	G	3	3	6	0	0	6	0	0
7	6070278	rs62456189	C	T	2	4	6	0	0	6	0	0
7	6155166	rs62454267	G	T	10	5	15	0	0	15	0	0
7	6198202	rs62454274	G	A	3	4	7	0	0	7	0	0
7	6438217	rs35761891	A	G	19	25	44	0	0	44	0	0
7	6439134	.	C	T	17	12	29	0	0	29	0	0
7	6442148	rs1059223	A	C	394	84	478	0	92	570	0	0
7	6455271	rs112001377	C	T	6	4	10	0	0	10	0	0
7	6458720	rs561939134	T	C	15	19	34	0	0	34	0	0
7	6556488	rs143100662	C	G	4	3	7	0	0	7	0	0
7	6621277	rs11559146	G	A	84	77	161	0	1	162	0	0
7	6639953	rs34300529	G	A	48	36	84	0	1	85	0	0
7	6739995	rs145491218	G	A	7	15	22	0	0	22	0	0
7	6790900	.	T	C	32	0	32	0	0	32	0	0
7	6792621	.	C	T	19	1	20	0	0	20	0	0
7	6844574	.	C	G	73	63	136	0	0	136	0	0
7	6859453	rs145992513	C	G	16	9	25	0	0	25	0	0
7	7284936	rs150516740	G	A	10	8	18	0	0	18	0	0
7	7286198	rs5010183	C	T	15	14	29	0	1	30	0	0
7	7286445	rs10246303	A	T	12	11	23	0	1	24	0	0
7	7607261	rs79680893	A	G	23	33	56	0	1	57	0	0
7	7607667	rs3757528	A	C	33	29	62	0	0	62	0	0
7	7609162	rs12530635	G	C	3	3	6	0	0	6	0	0
7	7613039	rs61744397	C	T	36	37	73	0	1	74	0	0
7	7637511	.	G	C	5	4	9	0	1	10	0	0
7	7641103	rs192570366	A	G	1	5	6	0	0	6	0	0
7	7643041	rs11771272	C	G	4	2	6	0	0	6	0	0
7	7643266	.	A	G	2	4	6	0	0	6	0	0
7	7643581	rs7385346	A	G	4	4	8	0	0	8	0	0
7	7646687	rs4222	A	G	31	45	76	0	1	77	0	0
7	8125964	rs929509	C	T	7	3	10	0	0	10	0	0
7	11676377	rs2074598	G	A	4	2	6	0	0	6	0	0
7	12251671	rs1019309	T	A	5	2	7	0	0	7	0	0
7	12253050	rs6460899	A	C	3	3	6	0	0	6	0	0
7	12253880	rs2043539	G	A	3	5	8	0	0	8	0	0
7	12253893	rs2043538	T	C	5	5	10	0	0	10	0	0
7	12269417	rs3173615	C	G	5	10	15	0	1	16	0	0
7	12271666	rs1042946	G	T	2	10	12	0	0	12	0	0
7	12271997	rs12669919	G	A	1	5	6	0	0	6	0	0
7	12272568	rs3800841	A	T	2	5	7	0	0	7	0	0
7	12274208	rs13309255	G	T	7	5	12	0	0	12	0	0
7	12275508	rs1468804	T	C	4	4	8	0	0	8	0	0
7	12726508	rs13227930	C	T	14	11	25	0	0	25	0	0
7	12727379	rs71536895	G	A	8	3	11	0	0	11	0	0
7	12727826	rs2280633	G	C	369	326	695	0	10	705	0	0
7	12730362	rs35689560	A	G	8	7	15	0	0	15	0	0
7	16655387	rs11540037	C	T	40	37	77	0	1	78	0	0
7	16666741	rs11532682	T	G	28	32	60	0	0	60	0	0
7	16666759	rs11531477	G	C	30	33	63	0	1	64	0	0
7	16725904	rs55919881	A	C	2	5	7	0	0	7	0	0
7	16821355	rs3807496	G	A	7	8	15	0	0	15	0	0
7	16822753	rs12112188	C	T	14	6	20	0	0	20	0	0
7	16822816	rs4517018	C	T	7	12	19	0	0	19	0	0
7	16822875	rs10499475	C	G	7	9	16	0	1	17	0	0
7	16823095	rs11491	G	A	45	39	84	0	2	86	0	0
7	16834597	rs6842	A	G	1	7	8	0	0	8	0	0
7	17345614	rs2282885	A	G	1	7	8	0	0	8	0	0
7	17365574	rs73079677	A	G	19	13	32	0	0	32	0	0
7	17368501	rs73079679	A	G	33	28	61	0	0	61	0	0
7	17379098	.	T	C	284	255	539	0	4	543	0	0
7	17379110	rs2066853	G	A	273	266	539	0	1	540	0	0
7	17380662	rs2040623	A	C	4	3	7	0	0	7	0	0
7	17381740	rs2106728	T	C	4	4	8	0	0	8	0	0
7	17854532	rs2723501	G	T	13	23	36	0	0	36	0	0
7	17879484	rs35507251	T	C	17	19	36	0	1	37	0	0
7	18333181	rs62449144	C	A	2	5	7	0	0	7	0	0
7	18370606	rs62449151	C	T	3	4	7	0	0	7	0	0
7	21495886	rs76033005	A	C	2	4	6	0	0	6	0	0
7	21496397	rs6461563	G	T	2	7	9	0	0	9	0	0
7	21496427	rs6461564	T	C	2	7	9	0	0	9	0	0
7	21496465	rs6461565	A	G	3	9	12	0	0	12	0	0
7	21496496	rs6461566	T	C	3	9	12	0	0	12	0	0
7	21522480	rs34538325	A	G	7	4	11	0	0	11	0	0
7	21551070	rs3735440	G	A	5	3	8	0	0	8	0	0
7	21941439	rs12700325	A	G	51	62	113	0	1	114	0	0
7	22550476	rs13247348	G	A	87	0	87	0	9	96	0	0
7	22894487	rs717624	T	C	6	6	12	0	0	12	0	0
7	22897195	rs113952113	G	A	5	2	7	0	0	7	0	0
7	22900078	rs13221012	A	T	3	4	7	0	0	7	0	0
7	22982207	rs2286495	T	C	3	5	8	0	0	8	0	0
7	22983702	rs4607514	A	T	5	2	7	0	0	7	0	0
7	22983890	rs1583511	T	C	4	5	9	0	0	9	0	0
7	22984772	rs10085448	A	C	9	12	21	0	0	21	0	0
7	22984773	rs10085739	G	A	9	12	21	0	0	21	0	0
7	22984824	rs2286494	T	C	8	15	23	0	0	23	0	0
7	22985694	.	G	T	13	0	13	0	0	13	0	0
7	23015831	rs3735231	T	C	7	5	12	0	0	12	0	0
7	23339460	rs149821	T	C	4	2	6	0	0	6	0	0
7	23347410	.	C	A	4	8	12	0	0	12	0	0
7	23357321	rs156414	C	T	23	24	47	0	0	47	0	0
7	23545627	rs117192443	C	T	14	13	27	0	0	27	0	0
7	23550719	.	G	A	4	3	7	0	0	7	0	0
7	23552278	.	C	T	5	1	6	0	0	6	0	0
7	23565822	rs17778698	T	A	11	7	18	0	0	18	0	0
7	23566896	rs182416610	A	G	19	17	36	0	0	36	0	0
7	25181912	rs2285738	T	C	11	10	21	0	0	21	0	0
7	25182405	rs11984293	G	T	9	8	17	0	0	17	0	0
7	26248490	.	G	A	10	3	13	0	0	13	0	0
7	26252204	rs12532361	G	T	284	205	489	0	7	496	0	0
7	26413423	rs3193526	C	T	9	8	17	0	0	17	0	0
7	26707657	rs13186	C	A	18	20	38	0	2	40	0	0
7	26722010	rs212847	G	A	8	4	12	0	0	12	0	0
7	26722155	rs212848	G	T	7	3	10	0	0	10	0	0
7	27151188	rs10085570	G	A	0	6	6	0	0	6	0	0
7	27168264	rs4722660	G	T	0	72	72	0	0	72	0	0
7	27168512	rs4722661	C	G	0	103	103	0	0	103	0	0
7	27168719	rs4722662	C	T	0	120	120	0	2	122	0	0
7	27169093	rs2158218	T	G	2	60	62	0	0	62	0	0
7	27171588	rs1859166	G	A	0	8	8	0	1	9	0	0
7	27173743	rs6944900	A	G	0	22	22	0	0	22	0	0
7	27175295	rs12533947	G	A	0	8	8	0	0	8	0	0
7	27182245	rs3757640	C	T	0	8	8	0	0	8	0	0
7	27183468	rs3735528	G	T	0	15	15	0	0	15	0	0
7	27184842	rs7341470	T	C	0	64	64	0	1	65	0	0
7	27188379	rs983184	C	T	0	16	16	0	0	16	0	0
7	27188659	rs983186	G	A	0	12	12	0	1	13	0	0
7	27189001	rs10256787	C	T	25	0	25	0	0	25	0	0
7	27189982	rs3735530	C	T	0	15	15	0	0	15	0	0
7	27191447	rs530714073	T	A	12	0	12	0	0	12	0	0
7	27193600	rs17500925	A	T	34	1	35	0	1	36	0	0
7	27194096	rs17500932	G	T	75	0	75	0	1	76	0	0
7	27195857	rs35510017	T	C	36	0	36	0	0	36	0	0
7	27196113	rs2301721	C	T	0	38	38	0	0	38	0	0
7	27204653	.	C	T	0	212	212	0	1	213	0	0
7	27206467	rs6461991	G	C	0	16	16	0	0	16	0	0
7	27565161	rs1052741	A	G	5	2	7	0	0	7	0	0
7	27565206	rs1052724	A	T	5	3	8	0	0	8	0	0
7	27797682	rs79805575	G	A	180	151	331	0	2	333	0	0
7	27822184	rs7800116	T	C	5	2	7	0	0	7	0	0
7	27866231	rs2051829	G	T	4	4	8	0	0	8	0	0
7	28449965	rs12538330	T	C	4	3	7	0	0	7	0	0
7	28862660	rs79083008	C	T	1	5	6	0	0	6	0	0
7	28865188	rs148153767	G	C	4	2	6	0	0	6	0	0
7	29070209	rs7313	G	A	89	48	137	0	0	137	0	0
7	29160604	rs34219043	C	T	72	47	119	0	0	119	0	0
7	29440511	rs13246507	A	G	2	4	6	0	0	6	0	0
7	29685569	rs35074048	G	C	4	3	7	0	0	7	0	0
7	29685827	rs34251700	C	T	10	14	24	0	0	24	0	0
7	29686808	rs1641205	C	T	9	17	26	0	0	26	0	0
7	29686814	rs1641206	G	A	9	18	27	0	0	27	0	0
7	29686829	rs1641207	C	T	7	15	22	0	0	22	0	0
7	29686834	rs1728637	G	A	7	15	22	0	0	22	0	0
7	29687420	rs1728639	T	C	8	6	14	0	0	14	0	0
7	29687927	rs1728641	T	C	12	3	15	0	0	15	0	0
7	29690658	rs1728537	A	C	7	7	14	0	0	14	0	0
7	29690705	rs1641211	C	A	9	8	17	0	0	17	0	0
7	29723986	rs12535190	G	C	4	3	7	0	0	7	0	0
7	29960211	rs9912	C	A	144	117	261	0	1	262	0	0
7	29960315	rs1049395	C	T	165	128	293	0	1	294	0	0
7	29960462	rs13834	G	A	125	122	247	0	0	247	0	0
7	29960519	rs4662	C	A	105	84	189	0	1	190	0	0
7	29960804	rs1049394	C	T	109	97	206	0	2	208	0	0
7	29960812	rs1049393	T	A	111	99	210	0	2	212	0	0
7	29961659	rs2269978	C	G	109	72	181	0	1	182	0	0
7	29961884	rs2269977	C	G	64	49	113	0	0	114	1	0
7	29961939	rs11540584	G	T	60	47	107	0	3	110	0	0
7	29962282	rs2269976	G	C	98	58	156	0	0	156	0	0
7	29962427	rs11540586	A	G	94	80	174	0	0	174	0	0
7	29962586	rs6976421	G	A	78	53	131	0	2	133	0	0
7	29962663	rs6958587	T	C	67	67	134	0	0	134	0	0
7	29962934	rs6976789	C	T	77	54	131	0	1	132	0	0
7	29963082	rs10479824	G	A	63	55	118	0	2	120	0	0
7	29963115	rs10480087	A	C	70	63	133	0	3	136	0	0
7	29964028	rs28737403	C	A	4	2	6	0	0	6	0	0
7	29977683	rs3793248	C	T	10	5	15	0	0	15	0	0
7	30028953	rs11975724	C	A	6	6	12	0	1	13	0	0
7	30053679	rs3793247	G	A	8	5	13	0	0	13	0	0
7	30122033	rs11766749	T	C	2	7	9	0	0	9	0	0
7	30122425	rs17449371	C	A	1	7	8	0	0	8	0	0
7	30174773	rs73689406	C	G	26	17	43	0	0	43	0	0
7	30182184	rs4364546	T	A	2	4	6	0	0	6	0	0
7	30182704	rs73079727	C	T	2	4	6	0	0	6	0	0
7	30185353	rs74516169	T	A	6	5	11	0	0	11	0	0
7	30186589	rs59058929	T	C	6	6	12	0	1	13	0	0
7	30187056	rs12532582	G	A	6	5	11	0	0	11	0	0
7	30188593	rs12539071	A	G	7	7	14	0	0	14	0	0
7	30188962	rs66868839	G	A	9	7	16	0	0	16	0	0
7	30189003	rs68182804	G	A	11	7	18	0	0	18	0	0
7	30189136	rs73305192	A	G	7	9	16	0	1	17	0	0
7	30189280	rs73305194	G	A	5	9	14	0	0	14	0	0
7	30190851	rs59953239	C	A	5	9	14	0	0	14	0	0
7	30191030	rs56377213	T	C	10	13	23	0	0	23	0	0
7	30191786	rs73079741	T	C	5	4	9	0	0	9	0	0
7	30191788	rs10255480	C	T	4	5	9	0	0	9	0	0
7	30191970	rs73079743	A	G	10	6	16	0	0	16	0	0
7	30192198	rs67759737	G	C	5	7	12	0	0	12	0	0
7	30192332	rs67920764	T	C	8	10	18	0	0	18	0	0
7	30194107	rs7811101	G	A	4	6	10	0	0	10	0	0
7	30194317	rs7811155	C	A	6	14	20	0	0	20	0	0
7	30195058	rs7780166	G	A	2	5	7	0	0	7	0	0
7	30195496	rs12539048	G	T	5	6	11	0	1	12	0	0
7	30195632	rs12533810	A	G	6	9	15	0	0	15	0	0
7	30195668	rs12531426	T	A	5	10	15	0	0	15	0	0
7	30196340	rs113414971	T	C	4	2	6	0	0	6	0	0
7	30196456	rs73305201	G	A	3	3	6	0	1	7	0	0
7	30198093	rs11696	A	G	6	1	7	0	0	7	0	0
7	30198259	rs1558579	G	A	25	21	46	0	1	47	0	0
7	30198960	rs57549526	C	T	46	35	81	0	0	82	1	0
7	30199150	rs702829	A	G	18	23	41	0	0	41	0	0
7	30199153	rs73079761	G	C	22	17	39	0	0	39	0	0
7	30199627	rs28364759	C	T	37	50	87	0	0	87	0	0
7	30199797	rs17547923	T	C	64	66	130	0	2	132	0	0
7	30201663	rs11156	C	T	26	12	38	0	1	39	0	0
7	30347071	rs190357773	A	T	4	4	8	0	0	8	0	0
7	30364111	rs34294791	G	A	4	4	8	0	0	8	0	0
7	30413724	rs34904575	G	A	12	10	22	0	0	22	0	0
7	30661369	.	C	T	13	8	21	0	0	21	0	0
7	30831082	rs12701034	C	T	3	4	7	0	0	7	0	0
7	30831263	rs62446940	T	A	4	3	7	0	0	7	0	0
7	30964578	rs28362743	C	A	5	1	6	0	0	6	0	0
7	32908135	rs1045530	C	G	164	162	326	0	3	329	0	0
7	32908704	rs1045477	T	C	23	30	53	0	1	54	0	0
7	32908945	rs62467365	T	C	154	165	319	0	2	321	0	0
7	32912910	rs13244998	T	C	4	5	9	0	0	9	0	0
7	32912965	rs13230763	C	T	9	3	12	0	1	13	0	0
7	32913395	rs9639669	T	C	9	8	17	0	0	17	0	0
7	32913612	rs9638884	T	C	18	23	41	0	0	41	0	0
7	32914922	rs62467366	C	T	1	11	12	0	0	12	0	0
7	32914965	rs4437549	C	T	1	5	6	0	0	6	0	0
7	32915204	rs7785065	C	A	8	3	11	0	0	11	0	0
7	32917550	rs7808664	G	A	3	3	6	0	0	6	0	0
7	32929628	rs62467370	C	A	2	4	6	0	0	6	0	0
7	32930597	rs7811609	C	T	5	1	6	0	0	6	0	0
7	32956504	.	T	C	4	3	7	0	0	7	0	0
7	33137868	rs73093571	G	A	3	10	13	0	0	13	0	0
7	33137960	rs6947994	C	T	6	5	11	0	0	11	0	0
7	33138299	rs6948361	A	G	4	2	6	0	0	6	0	0
7	33138875	rs11771864	A	T	5	5	10	0	0	10	0	0
7	33644941	rs1050719	T	C	5	8	13	0	0	13	0	0
7	33644948	rs1050721	C	T	5	9	14	0	0	14	0	0
7	35677521	rs10280032	G	C	3	5	8	0	0	8	0	0
7	35709842	rs3779234	C	T	89	59	148	0	1	149	0	0
7	35723925	rs34022676	G	A	2	5	7	0	0	7	0	0
7	35730332	rs12532178	T	C	13	27	40	0	2	42	0	0
7	35732032	rs17766969	C	T	8	13	21	0	0	21	0	0
7	35732656	rs1450892	C	T	5	6	11	0	0	11	0	0
7	35732879	rs2392382	G	A	14	23	37	0	1	38	0	0
7	35733321	rs10229772	C	A	33	53	86	0	0	86	0	0
7	35734243	rs62454607	C	A	51	19	70	0	12	82	0	0
7	35734529	rs78381277	C	G	31	23	54	0	0	54	0	0
7	35943053	rs191952599	T	C	7	1	8	0	0	8	0	0
7	36193025	rs11537599	G	A	3	3	6	0	0	6	0	0
7	36195050	rs10247827	T	C	12	22	34	0	1	35	0	0
7	36197050	.	C	T	7	9	16	0	0	16	0	0
7	36200849	rs61632633	C	T	6	2	8	0	0	8	0	0
7	36201102	rs4720197	A	G	4	7	11	0	0	11	0	0
7	36201175	rs4723483	C	T	2	5	7	0	0	7	0	0
7	36203997	rs2700910	A	T	1	5	6	0	0	6	0	0
7	36206815	rs2700911	C	T	7	3	10	0	0	10	0	0
7	36206938	rs146529651	G	A	7	2	9	0	0	9	0	0
7	36327317	rs196594	C	T	21	34	55	0	1	56	0	0
7	36338841	rs196614	T	C	20	26	46	0	0	46	0	0
7	36339126	rs10848	A	G	13	21	34	0	0	34	0	0
7	36339630	rs13224904	G	A	3	3	6	0	0	6	0	0
7	36340675	rs1046455	C	T	3	4	7	0	0	7	0	0
7	36445855	rs61737563	A	C	6	2	8	0	0	8	0	0
7	36445856	rs197367	G	A	6	2	8	0	0	8	0	0
7	36492609	rs79021133	C	T	10	5	15	0	0	15	0	0
7	36552656	rs7986	G	A	8	1	9	0	0	9	0	0
7	36763672	rs2228410	C	T	27	7	34	0	0	34	0	0
7	36901043	rs117950694	C	T	12	8	20	0	0	20	0	0
7	36901579	rs7785934	T	C	6	3	9	0	0	9	0	0
7	37205464	rs563400485	G	C	12	8	20	0	0	20	0	0
7	37205639	rs145531695	C	A	14	17	31	0	1	32	0	0
7	37253931	rs6944624	T	C	8	8	16	0	0	16	0	0
7	37256750	rs2287126	G	A	8	6	14	0	0	14	0	0
7	37309390	rs117191551	T	C	4	5	9	0	0	9	0	0
7	37338247	rs111826510	T	C	7	6	13	0	0	13	0	0
7	37338340	.	C	T	4	5	9	0	0	9	0	0
7	37339009	.	T	C	6	0	6	0	0	6	0	0
7	37340398	rs61897209	G	T	10	9	19	0	0	19	0	0
7	37340648	rs2724009	G	C	4	3	7	0	0	7	0	0
7	37340658	rs2717991	G	A	4	3	7	0	0	7	0	0
7	37341477	rs2701004	A	G	5	7	12	0	0	12	0	0
7	37341576	rs2724008	T	C	4	3	7	0	0	7	0	0
7	37342250	rs2717992	T	A	7	5	12	0	0	12	0	0
7	37342701	rs2723998	C	T	5	3	8	0	0	8	0	0
7	37344703	rs2723995	T	C	4	3	7	0	0	7	0	0
7	37348222	rs2701003	T	C	7	2	9	0	0	9	0	0
7	37462086	rs28429674	G	A	1	6	7	0	0	7	0	0
7	37468889	rs28628397	C	A	46	72	118	0	6	124	0	0
7	37469158	rs1647795	T	C	33	68	101	0	0	101	0	0
7	38237370	rs4723737	C	T	2	4	6	0	0	6	0	0
7	38247721	rs2075009	G	A	106	96	202	0	1	203	0	0
7	38249253	rs112176932	G	A	7	2	9	0	0	9	0	0
7	38252964	rs78092191	G	A	10	7	17	0	0	17	0	0
7	38253526	rs141832763	A	G	9	13	22	0	0	22	0	0
7	38253641	rs12671662	A	G	8	7	15	0	0	15	0	0
7	38261072	rs76378027	C	A	5	1	6	0	0	6	0	0
7	38269668	rs8163	G	A	85	93	178	0	0	178	0	0
7	38269675	rs9490	T	C	89	75	164	0	1	165	0	0
7	38270115	rs10945	C	G	43	42	85	0	0	85	0	0
7	38279663	.	T	C	81	49	130	0	0	130	0	0
7	38279725	rs1053763	G	A	101	56	157	0	0	157	0	0
7	38289121	rs1053756	C	T	45	30	75	0	2	77	0	0
7	38297566	rs7781243	A	C	6	9	15	0	0	15	0	0
7	38297721	.	A	G	11	9	20	0	0	20	0	0
7	38298285	rs28677126	A	G	10	34	44	0	0	44	0	0
7	38299579	.	G	A	57	110	167	0	1	168	0	0
7	38301274	rs2893553	G	A	5	4	9	0	0	9	0	0
7	38301741	rs2392542	T	A	4	6	10	0	0	10	0	0
7	38302466	rs79155798	C	G	7	7	14	0	0	14	0	0
7	38302568	rs80059094	T	C	7	4	11	0	0	11	0	0
7	38303120	rs2109365	T	C	6	3	9	0	0	9	0	0
7	38303485	rs145193375	C	A	8	8	16	0	0	16	0	0
7	38303536	rs143197571	T	C	1	8	9	0	0	9	0	0
7	38305083	rs2007081	G	A	107	163	270	0	0	270	0	0
7	38305142	rs113809137	G	C	97	131	228	0	2	230	0	0
7	38309102	.	A	C	8	4	12	0	0	12	0	0
7	38357075	rs11769443	T	C	15	8	23	0	0	23	0	0
7	38357323	rs11765884	C	T	2	8	10	0	0	10	0	0
7	38384841	rs12532845	G	A	2	40	42	0	1	43	0	0
7	38389410	rs140194030	G	C	44	5	49	0	0	49	0	0
7	38393319	rs201871758	A	G	6	0	6	0	0	6	0	0
7	38393343	rs77429066	T	C	5	1	6	0	0	6	0	0
7	38393390	rs73357290	T	G	5	4	9	0	0	9	0	0
7	38393403	rs2017501	G	A	5	5	10	0	0	10	0	0
7	38393424	rs73357292	G	A	6	4	10	0	0	10	0	0
7	38393448	rs78292907	G	C	6	6	12	0	0	12	0	0
7	38393524	rs73357293	C	T	5	7	12	0	1	13	0	0
7	38393534	rs74465876	C	T	6	8	14	0	0	14	0	0
7	38393592	rs34822522	C	A	10	7	17	0	0	17	0	0
7	38393654	rs147704672	T	G	3	6	9	0	0	9	0	0
7	38393713	rs2215952	A	G	7	5	12	0	0	12	0	0
7	38393798	.	A	G	12	2	14	0	0	14	0	0
7	38393857	.	C	T	14	3	17	0	0	17	0	0
7	38393858	rs2392549	C	T	14	3	17	0	0	17	0	0
7	38393989	rs3956754	A	G	9	5	14	0	0	14	0	0
7	38394040	rs79119940	C	A	8	7	15	0	0	15	0	0
7	38398564	rs1810377	A	G	2	5	7	0	0	7	0	0
7	38398610	rs1808313	C	G	7	1	8	0	0	8	0	0
7	38398653	rs75695637	C	T	6	2	8	0	0	8	0	0
7	38429552	rs36122520	T	A	5	9	14	0	0	14	0	0
7	38429584	rs34824107	C	G	4	8	12	0	0	12	0	0
7	39669693	rs141409383	G	A	66	31	97	0	0	97	0	0
7	39737574	.	A	G	12	9	21	0	0	21	0	0
7	39991673	rs9655407	G	A	24	24	48	0	0	48	0	0
7	39992280	rs10239324	T	G	7	12	19	0	0	19	0	0
7	39993073	rs10227726	C	G	3	4	7	0	0	7	0	0
7	39993262	rs3847018	C	G	14	20	34	0	0	34	0	0
7	39994122	rs12701787	C	G	10	13	23	0	1	24	0	0
7	40004490	rs149935795	C	T	8	1	9	0	0	9	0	0
7	40006056	rs4481477	C	A	3	3	6	0	0	6	0	0
7	40008949	rs2329611	C	T	6	5	11	0	0	11	0	0
7	40135344	rs17538349	C	T	14	7	21	0	0	21	0	0
7	40308401	rs6944348	T	C	1	5	6	0	0	6	0	0
7	41739628	.	T	C	9	3	12	0	0	12	0	0
7	42949038	rs1048434	G	A	3	6	9	0	0	9	0	0
7	42949101	rs1048423	C	T	8	6	14	0	0	14	0	0
7	42956933	rs1060304	G	A	12	14	26	0	1	27	0	0
7	42958570	rs640456	G	A	11	7	18	0	0	18	0	0
7	42958847	rs652130	G	A	14	4	18	0	0	18	0	0
7	42959199	rs653853	G	C	8	8	16	0	0	17	1	0
7	42959220	rs653881	T	C	9	10	19	0	0	19	0	0
7	42959956	rs667209	A	G	4	5	9	0	0	9	0	0
7	42960618	rs591875	C	A	7	7	14	0	0	14	0	0
7	42962527	rs591740	A	G	6	5	11	0	0	11	0	0
7	42965141	rs650786	G	A	4	2	6	0	0	6	0	0
7	42965638	rs653079	T	C	6	6	12	0	0	12	0	0
7	42965733	rs653517	A	G	3	3	6	0	0	6	0	0
7	42968639	rs589584	C	G	3	3	6	0	0	6	0	0
7	42974827	rs601057	A	C	7	10	17	0	0	17	0	0
7	42975857	rs615770	A	G	10	11	21	0	0	21	0	0
7	42976135	rs627435	G	C	4	4	8	0	0	8	0	0
7	42976789	rs630191	A	G	25	44	69	0	1	70	0	0
7	42977091	rs631132	G	A	103	85	188	0	7	195	0	0
7	42977243	rs631928	T	C	31	20	51	0	1	52	0	0
7	43622806	rs10251937	T	C	29	23	52	0	0	52	0	0
7	43623123	rs2241738	C	G	4	4	8	0	0	8	0	0
7	43623463	rs73102722	G	C	20	7	27	0	0	27	0	0
7	43623493	rs73102723	C	T	9	3	12	0	0	12	0	0
7	43647879	rs11555026	C	T	77	84	161	0	0	161	0	0
7	43648303	rs35535441	G	C	5	4	9	0	0	9	0	0
7	43648480	rs1054923	G	A	13	7	20	0	0	20	0	0
7	43648574	rs34794727	G	A	15	2	17	0	0	17	0	0
7	43648723	rs36113818	G	A	13	8	21	0	0	21	0	0
7	43648749	rs34235717	A	G	13	6	19	0	0	19	0	0
7	43649141	rs10252175	A	G	8	8	16	0	0	16	0	0
7	43649248	rs10282065	G	A	3	5	8	0	0	8	0	0
7	43650583	rs10227730	G	A	3	3	6	0	0	6	0	0
7	43653316	rs10215302	G	A	2	5	7	0	1	8	0	0
7	43654932	rs34064273	G	A	4	3	7	0	0	7	0	0
7	43655211	rs10215478	C	T	4	3	7	0	0	7	0	0
7	43657875	rs12702054	T	A	3	5	8	0	0	8	0	0
7	43657927	rs9655446	C	G	6	3	9	0	1	10	0	0
7	43659764	rs4077435	G	C	6	7	13	0	0	13	0	0
7	43659921	rs28406682	T	A	6	3	9	0	0	9	0	0
7	43660469	rs10247197	G	A	9	8	17	0	0	17	0	0
7	43660893	rs1053080	T	A	4	6	10	0	0	10	0	0
7	43661151	rs6463199	C	G	0	7	7	0	0	7	0	0
7	43662311	rs115665767	T	G	2	5	7	0	0	7	0	0
7	43662443	rs35974484	G	C	4	11	15	0	0	15	0	0
7	43664198	rs10233697	A	G	105	111	216	0	1	217	0	0
7	43664280	rs1044141	A	G	107	119	226	0	2	228	0	0
7	43667576	rs2330917	C	T	2	6	8	0	1	9	0	0
7	43667792	rs28403460	T	C	3	3	6	0	0	6	0	0
7	43668087	rs67873618	C	T	4	2	6	0	0	6	0	0
7	43669666	rs2051969	A	C	3	4	7	0	0	7	0	0
7	43671232	rs2330918	C	T	7	6	13	0	0	13	0	0
7	43678997	rs1044039	T	C	31	32	63	0	0	63	0	0
7	43685150	rs10263142	T	C	5	3	8	0	0	8	0	0
7	43686194	rs970134	G	A	3	4	7	0	1	8	0	0
7	43690243	rs3180524	C	T	8	14	22	0	0	22	0	0
7	43810764	rs699512	G	A	37	44	81	0	0	81	0	0
7	43906513	rs670573	A	G	273	224	497	0	19	516	0	0
7	43916009	rs73108116	G	A	66	66	132	0	0	132	0	0
7	43916199	rs28461223	C	T	78	82	160	0	2	162	0	0
7	43916727	rs2232108	T	G	60	62	122	0	1	123	0	0
7	43917013	rs2232105	G	A	61	54	115	0	0	115	0	0
7	43923477	rs73108122	A	G	3	5	8	0	0	8	0	0
7	43965747	rs2528382	A	G	6	5	11	0	0	11	0	0
7	43982139	rs929380	C	T	3	3	6	0	0	6	0	0
7	43994687	rs3812252	C	T	9	21	30	0	1	31	0	0
7	44000584	rs7807759	G	A	20	6	26	0	0	26	0	0
7	44001162	rs2595732	C	T	7	0	7	0	0	7	0	0
7	44005513	rs2595699	G	A	10	16	26	0	0	26	0	0
7	44012847	rs144729196	G	A	9	9	18	0	2	20	0	0
7	44027348	rs2330943	A	G	9	13	22	0	0	22	0	0
7	44038903	rs2330962	T	C	4	5	9	0	0	9	0	0
7	44054352	rs56000326	T	C	21	12	33	0	0	33	0	0
7	44084292	rs4430012	C	G	6	4	10	0	0	10	0	0
7	44105678	rs55905449	T	A	2	6	8	0	0	8	0	0
7	44248828	rs2908282	G	A	15	14	29	0	0	29	0	0
7	44419673	rs73101788	T	A	2	4	6	0	0	6	0	0
7	44419701	rs73101790	C	T	3	4	7	0	0	7	0	0
7	44422018	rs73101799	C	T	4	2	6	0	0	6	0	0
7	44422188	.	G	A	6	7	13	0	0	13	0	0
7	44424211	rs17172872	T	C	21	14	35	0	1	36	0	0
7	44424253	rs1043084	C	T	23	17	40	0	0	40	0	0
7	44424600	rs189741497	G	C	21	26	47	0	0	47	0	0
7	44507884	rs113966537	G	A	13	0	13	0	1	14	0	0
7	44530193	rs307007	T	G	16	15	31	0	0	31	0	0
7	44606098	rs6656	C	T	48	47	95	0	2	97	0	0
7	44606339	rs217380	C	T	5	1	6	0	0	6	0	0
7	44618448	rs217363	A	G	25	31	56	0	0	56	0	0
7	44618599	rs217362	T	A	50	48	98	0	1	99	0	0
7	44619302	rs217361	T	C	3	4	7	0	0	7	0	0
7	44620362	rs217360	G	A	20	18	38	0	0	38	0	0
7	44620836	rs8580	C	A	154	124	278	0	3	282	1	0
7	44646763	rs732797	G	A	10	13	23	0	0	23	0	0
7	44748477	rs78889688	C	T	30	25	55	0	1	56	0	0
7	44790807	rs55812947	T	C	6	8	14	0	0	14	0	0
7	44790988	rs799451	G	A	7	3	10	0	0	10	0	0
7	44791135	rs56258112	T	C	5	9	14	0	0	14	0	0
7	44799347	rs73109470	T	C	11	8	19	0	0	19	0	0
7	44800176	rs3735478	G	T	89	79	168	0	1	169	0	0
7	44806135	.	C	T	101	102	203	0	6	209	0	0
7	44808223	rs1050338	G	A	55	68	123	0	1	124	0	0
7	44808416	rs3812257	A	G	9	3	12	0	0	12	0	0
7	44808650	rs56077345	G	C	8	8	16	0	1	17	0	0
7	44837322	rs3735481	C	A	40	31	71	0	1	72	0	0
7	44839616	rs6463247	C	T	43	49	92	0	1	93	0	0
7	44839989	rs17860070	A	G	29	32	61	0	6	67	0	0
7	44840259	rs12702088	A	G	21	14	35	0	2	37	0	0
7	44840638	rs17860080	G	A	12	14	26	0	0	26	0	0
7	44840864	rs10249442	G	A	33	27	60	0	1	61	0	0
7	44841924	rs17860094	T	G	49	32	81	0	1	82	0	0
7	44842421	rs6904	A	G	77	88	165	0	4	169	0	0
7	44866633	rs2898	A	G	24	38	62	0	0	62	0	0
7	44866704	rs2897	A	G	47	68	115	0	0	115	0	0
7	44868379	rs1058056	A	G	127	126	253	0	3	256	0	0
7	44870813	rs6959442	G	A	11	17	28	0	0	28	0	0
7	44870933	rs10267576	T	C	21	30	51	0	0	51	0	0
7	44871948	rs1054214	G	A	91	85	176	0	1	177	0	0
7	44872977	rs12155038	G	A	33	31	64	0	0	64	0	0
7	44873125	rs12155039	C	A	67	71	138	0	0	138	0	0
7	44873982	rs56252693	G	A	490	352	842	0	9	851	0	0
7	44876747	rs62460519	C	T	6	6	12	0	0	12	0	0
7	44878274	rs12536807	C	T	8	5	13	0	0	13	0	0
7	44879329	rs117833461	C	T	2	6	8	0	0	8	0	0
7	44881364	rs62460521	C	T	5	6	11	0	0	11	0	0
7	44881603	rs55751098	G	T	4	11	15	0	0	15	0	0
7	44882104	rs3801403	C	T	12	15	27	0	0	27	0	0
7	44887076	rs714543	A	G	3	4	7	0	0	7	0	0
7	44887294	rs28739398	A	G	8	3	11	0	0	11	0	0
7	44917040	rs8840	A	G	92	105	197	0	1	198	0	0
7	44920707	rs13221185	T	A	32	29	61	0	0	61	0	0
7	44922737	rs56066170	T	C	120	125	245	0	3	248	0	0
7	44925674	rs73102133	G	T	47	23	70	0	0	70	0	0
7	44925896	rs1990053	G	A	13	14	27	0	0	27	0	0
7	44998714	rs6946581	G	A	29	39	68	0	1	69	0	0
7	44998748	rs62461371	T	C	45	38	83	0	1	84	0	0
7	44999424	rs10807921	G	A	30	15	45	0	0	45	0	0
7	45000102	rs3812261	T	C	33	35	68	0	1	69	0	0
7	45000143	.	G	A	27	26	53	0	0	53	0	0
7	45005795	rs2269969	G	A	326	369	695	0	7	702	0	0
7	45008228	rs11763365	C	T	12	10	22	0	0	22	0	0
7	45009325	rs3735484	G	A	415	340	755	0	4	759	0	0
7	45009723	rs11555636	G	A	269	208	477	0	4	481	0	0
7	45010371	rs62461372	C	G	3	8	11	0	1	12	0	0
7	45010734	rs7789375	G	A	7	5	12	0	0	12	0	0
7	45012557	rs7799043	C	T	6	11	17	0	0	17	0	0
7	45012761	rs7799222	A	G	10	9	19	0	0	19	0	0
7	45012958	rs7803335	G	C	7	12	19	0	0	19	0	0
7	45013535	rs62461373	C	G	3	6	9	0	2	11	0	0
7	45013652	rs10274554	T	C	4	3	7	0	0	7	0	0
7	45013996	rs34764303	G	A	7	2	9	0	1	10	0	0
7	45014304	rs6976664	C	T	6	2	8	0	1	9	0	0
7	45015107	rs61738857	G	A	292	308	600	0	7	608	1	0
7	45016621	rs61739531	C	T	165	172	337	0	3	340	0	0
7	45763615	rs76975443	T	G	18	18	36	0	0	36	0	0
7	45763754	rs2461125	T	A	9	2	11	0	0	11	0	0
7	45763875	rs59922821	A	G	7	3	10	0	0	10	0	0
7	45763915	rs60923628	A	G	3	4	7	0	0	7	0	0
7	45764220	rs66666251	A	G	16	20	36	0	1	37	0	0
7	45764959	rs2471265	C	T	9	7	16	0	0	16	0	0
7	45765234	rs2960287	G	T	13	7	20	0	0	20	0	0
7	45766747	rs11981650	C	T	9	3	12	0	0	12	0	0
7	45766896	rs9993	A	G	8	11	19	0	0	19	0	0
7	45767124	rs8932	C	T	12	9	21	0	0	21	0	0
7	45767682	rs59412459	G	A	3	5	8	0	0	8	0	0
7	45769921	rs11983848	T	C	2	9	11	0	0	11	0	0
7	45776474	rs143565372	C	T	23	22	45	0	0	45	0	0
7	45808432	rs2974729	A	G	10	6	16	0	0	16	0	0
7	45854242	rs35454292	G	A	11	1	12	0	0	12	0	0
7	45854254	rs2471247	T	C	10	1	11	0	0	11	0	0
7	45854471	rs34739864	G	C	8	4	12	0	0	12	0	0
7	45854589	rs60784924	A	G	11	4	15	0	0	15	0	0
7	45854635	rs35129027	C	T	12	4	16	0	0	16	0	0
7	47315291	rs9876	G	A	140	147	287	0	0	287	0	0
7	47316586	rs3184329	A	C	81	120	201	0	1	202	0	0
7	47317324	rs3210894	G	A	78	87	165	0	3	168	0	0
7	47317510	rs3750163	G	A	97	112	209	0	2	211	0	0
7	47318083	rs868701	G	A	8	5	13	0	0	13	0	0
7	47318132	rs885519	G	A	6	4	10	0	0	10	0	0
7	47318276	rs6463407	C	T	4	5	9	0	0	9	0	0
7	47319027	rs6463408	A	G	5	3	8	0	0	8	0	0
7	47320783	rs12702332	A	G	5	3	8	0	0	8	0	0
7	47321402	rs7777752	A	G	2	4	6	0	0	6	0	0
7	47321410	rs7778157	G	A	2	5	7	0	0	7	0	0
7	47326070	rs17172846	C	T	11	3	14	0	0	14	0	0
7	47328908	rs7790819	A	T	4	3	7	0	0	7	0	0
7	47328967	rs7791236	G	A	1	5	6	0	0	6	0	0
7	47337014	rs2293364	G	A	8	5	13	0	1	14	0	0
7	47553603	rs687280	G	C	4	2	6	0	0	6	0	0
7	47554514	rs643676	A	G	4	2	6	0	0	6	0	0
7	47568718	rs10261525	C	T	55	41	96	0	1	97	0	0
7	47611962	rs117870331	C	T	4	2	6	0	0	6	0	0
7	47995621	rs2708897	A	G	21	16	37	0	0	37	0	0
7	47995628	rs2708898	G	A	21	16	37	0	0	37	0	0
7	47995764	rs34016848	A	T	20	11	31	0	1	32	0	0
7	47995877	rs2686833	C	T	17	14	31	0	0	31	0	0
7	47996232	rs1879834	G	T	9	11	20	0	0	20	0	0
7	47996278	rs79969910	G	A	10	8	18	0	1	19	0	0
7	47996513	rs77454313	T	C	2	5	7	0	0	7	0	0
7	47998472	rs35245832	G	A	6	2	8	0	1	9	0	0
7	47999656	rs13309127	A	G	12	10	22	0	0	22	0	0
7	47999680	rs2952720	C	T	9	7	16	0	1	17	0	0
7	48000081	rs13229586	G	C	2	4	6	0	0	6	0	0
7	48001054	rs2708877	C	T	3	4	7	0	0	7	0	0
7	48003364	rs2708902	G	A	17	13	30	0	0	30	0	0
7	48003627	rs35796271	C	T	9	17	26	0	0	26	0	0
7	48003665	rs2686835	T	C	21	8	29	0	1	30	0	0
7	48003767	rs2686836	G	A	25	12	37	0	1	38	0	0
7	48004524	.	A	C	5	3	8	0	0	8	0	0
7	48004962	rs1056663	C	T	52	32	84	0	0	84	0	0
7	48011198	rs3176559	T	C	1	8	9	0	0	9	0	0
7	48012361	rs953572	A	G	3	3	6	0	0	6	0	0
7	48016717	rs2708861	T	G	11	7	18	0	0	18	0	0
7	48017549	rs2708859	A	G	8	9	17	0	0	17	0	0
7	48017552	rs2708858	C	T	8	9	17	0	0	17	0	0
7	48017965	rs2242477	C	T	34	34	68	0	0	68	0	0
7	48017989	rs2242478	T	C	40	44	84	0	0	84	0	0
7	48128558	rs7458962	A	T	2	4	6	0	0	6	0	0
7	48128596	rs7459020	G	A	1	5	6	0	0	6	0	0
7	48128850	rs3763505	G	A	16	22	38	0	1	39	0	0
7	48128901	rs3763504	T	C	35	32	67	0	1	68	0	0
7	48131546	rs13240650	C	T	6	8	14	0	0	14	0	0
7	48131580	rs13227958	T	C	7	7	14	0	0	14	0	0
7	48132391	rs9639019	C	T	3	3	6	0	1	7	0	0
7	48134719	rs11768083	A	C	5	8	13	0	0	13	0	0
7	48135306	rs7341532	G	T	5	8	13	0	0	13	0	0
7	48136339	rs7385009	T	C	4	6	10	0	0	10	0	0
7	48137413	rs7341420	C	T	5	7	12	0	0	12	0	0
7	48140529	rs6974256	C	G	2	8	10	0	1	11	0	0
7	48140799	rs13228276	G	T	4	10	14	0	0	14	0	0
7	48142194	rs6463462	G	T	10	12	22	0	0	22	0	0
7	48145136	.	T	C	24	17	41	0	0	41	0	0
7	50364626	rs10230193	G	A	3	3	6	0	0	6	0	0
7	50442917	rs55826129	G	A	7	0	7	0	0	7	0	0
7	50445412	rs6976046	A	G	1	5	6	0	0	6	0	0
7	50461684	rs10248903	G	A	3	3	6	0	0	6	0	0
7	50467767	rs61731355	C	A	57	45	102	0	1	103	0	0
7	50468952	rs10278451	G	T	80	62	142	0	0	142	0	0
7	50469551	rs11552047	C	T	92	78	170	0	1	171	0	0
7	50469981	rs11980379	T	C	143	143	286	0	2	288	0	0
7	50470138	rs62447207	G	T	162	174	336	0	2	338	0	0
7	50470156	rs62447208	G	C	167	168	335	0	3	338	0	0
7	50470604	rs4132601	T	G	155	140	295	0	1	296	0	0
7	50471613	rs11980407	G	A	82	87	169	0	2	171	0	0
7	50472324	rs62445866	G	A	27	25	52	0	1	53	0	0
7	50512929	rs10230343	C	A	4	2	6	0	0	6	0	0
7	50514577	rs10235371	C	T	5	4	9	0	0	9	0	0
7	50665364	rs113122625	T	G	3	3	6	0	0	6	0	0
7	50665654	rs6593030	A	G	5	2	7	0	0	7	0	0
7	54820396	rs17172381	A	G	11	10	21	0	0	21	0	0
7	54820896	rs35830108	G	A	6	8	14	0	0	14	0	0
7	54821581	rs7782367	C	T	6	7	13	0	0	13	0	0
7	54822152	rs2699214	T	C	6	12	18	0	0	18	0	0
7	54822290	rs73122019	C	A	6	7	13	0	0	13	0	0
7	54822852	rs7791547	C	T	4	4	8	0	0	8	0	0
7	54826187	rs73122025	T	A	1	5	6	0	0	6	0	0
7	55433880	rs2272262	G	C	26	50	76	0	0	76	0	0
7	55433884	rs2272263	A	C	27	50	77	0	0	77	0	0
7	55459563	rs2049497	A	G	51	41	92	0	0	92	0	0
7	55462951	rs12718963	G	A	3	3	6	0	0	6	0	0
7	55463517	rs9649858	A	G	9	5	14	0	0	14	0	0
7	55464067	rs6977524	C	T	11	4	15	0	0	15	0	0
7	55464361	rs10224201	A	G	5	4	9	0	0	9	0	0
7	55464820	rs13224261	A	G	5	1	6	0	0	6	0	0
7	55465598	rs6965302	A	G	10	4	14	0	1	15	0	0
7	55467923	rs2272226	G	C	3	3	6	0	0	6	0	0
7	55478313	rs4948025	C	G	4	4	8	0	0	8	0	0
7	55499641	rs12718965	T	C	9	11	20	0	0	20	0	0
7	55499723	rs3823584	G	A	13	13	26	0	0	26	0	0
7	55521962	rs815941	T	C	9	5	14	0	0	14	0	0
7	55524402	rs1093251	G	A	3	4	7	0	0	7	0	0
7	55538544	rs3211244	T	C	26	36	62	0	0	62	0	0
7	55540707	rs815957	G	A	46	23	69	0	1	70	0	0
7	55550693	rs6957545	T	C	3	3	6	0	0	6	0	0
7	56022981	rs15892	T	C	23	19	42	0	0	42	0	0
7	56023486	rs7794115	T	C	9	12	21	0	0	21	0	0
7	56055459	rs62456653	G	A	5	5	10	0	0	10	0	0
7	56055863	rs7784730	G	A	10	5	15	0	0	15	0	0
7	56056145	rs62456654	A	C	10	15	25	0	0	25	0	0
7	56060101	rs56351949	C	T	4	5	9	0	0	9	0	0
7	56062289	rs112851611	C	A	6	10	16	0	0	16	0	0
7	56064433	rs73140745	A	G	9	12	21	0	0	21	0	0
7	56065735	rs7808487	G	A	7	12	19	0	0	19	0	0
7	56119944	rs7779821	G	A	1	9	10	0	0	10	0	0
7	56129511	rs4927	A	G	330	294	624	0	3	627	0	0
7	56136194	rs7808729	C	T	191	169	360	0	1	361	0	0
7	56146310	rs11765364	T	C	7	1	8	0	0	8	0	0
7	56149410	rs12538444	G	A	0	6	6	0	0	6	0	0
7	56169419	rs8406	C	T	1197	881	2078	0	8	2086	0	0
7	56171489	rs816411	C	T	25	12	37	0	0	37	0	0
7	56171760	rs6593298	A	C	28	22	50	0	0	50	0	0
7	56172361	rs816410	T	C	5	1	6	0	0	6	0	0
7	56173229	rs115074419	G	A	3	3	6	0	0	6	0	0
7	56173407	rs4948107	C	T	7	5	12	0	0	12	0	0
7	56173435	rs816409	A	G	8	4	12	0	0	12	0	0
7	56173628	rs4948108	C	G	4	4	8	0	0	8	0	0
7	56173970	rs816408	A	G	11	5	16	0	0	16	0	0
7	56174115	rs10043	A	C	833	605	1438	0	19	1457	0	0
7	56174140	rs816407	G	T	528	286	814	0	2	816	0	0
7	63796744	rs58656578	T	C	26	13	39	0	0	39	0	0
7	63802021	rs10271301	G	A	4	4	8	0	0	8	0	0
7	63802129	rs79526791	T	C	5	7	12	0	0	12	0	0
7	63802516	rs1404678	A	G	3	3	6	0	0	6	0	0
7	63803889	rs1871246	A	G	9	7	16	0	0	16	0	0
7	63808867	rs11976837	C	A	24	14	38	0	0	38	0	0
7	63810219	rs663305	C	A	5	3	8	0	0	8	0	0
7	63810268	rs2618250	C	A	11	4	15	0	0	15	0	0
7	63810359	rs2692111	C	T	18	11	29	0	1	30	0	0
7	63810376	rs4718066	T	C	13	19	32	0	1	33	0	0
7	63810976	rs74298822	C	G	26	29	55	0	1	56	0	0
7	63811263	rs117800590	A	G	30	35	65	0	1	66	0	0
7	63812129	rs10949900	A	G	52	42	94	0	1	95	0	0
7	63812244	rs1589848	A	G	40	34	74	0	0	74	0	0
7	63812774	rs10949901	G	A	43	38	81	0	0	81	0	0
7	63813230	rs10239221	G	A	31	33	64	0	0	64	0	0
7	63814103	rs79142797	G	A	41	58	99	0	0	99	0	0
7	63814749	rs2293344	G	A	6	5	11	0	0	11	0	0
7	63981563	rs10243954	A	G	4	8	12	0	0	12	0	0
7	64021507	rs7804897	G	A	6	8	14	0	0	14	0	0
7	64021578	rs7788788	A	G	7	4	11	0	0	11	0	0
7	64022084	rs113722384	G	A	5	1	6	0	0	6	0	0
7	64022268	rs187993433	G	T	6	1	7	0	0	7	0	0
7	64023371	rs6969879	T	C	5	3	8	0	1	9	0	0
7	64140347	rs73361894	C	T	3	5	8	0	0	8	0	0
7	64140807	rs34676383	C	T	4	2	6	0	0	6	0	0
7	64142365	rs56955205	C	G	8	5	13	0	0	13	0	0
7	64144096	rs73136786	T	C	11	10	21	0	0	21	0	0
7	64145824	rs28879694	G	A	54	38	92	0	1	93	0	0
7	64146378	rs12154763	C	T	60	77	137	0	0	137	0	0
7	64146496	rs6973346	C	T	75	52	127	0	3	130	0	0
7	64147169	rs2529	C	T	59	100	159	0	0	159	0	0
7	64147935	rs66509430	C	T	17	14	31	0	0	31	0	0
7	64149621	rs2862799	A	G	2	5	7	0	0	7	0	0
7	64149928	rs3750029	C	T	4	2	6	0	0	6	0	0
7	64150010	rs2862798	C	T	4	3	7	0	0	7	0	0
7	64150267	rs2862797	A	G	3	7	10	0	0	10	0	0
7	64150341	rs17779736	T	C	5	2	7	0	0	7	0	0
7	64150849	rs6460178	C	T	8	0	8	0	0	8	0	0
7	64152353	rs4718101	A	G	11	11	22	0	1	23	0	0
7	64154685	rs7802372	A	G	2	5	7	0	0	7	0	0
7	64156387	rs6651044	G	A	4	2	6	0	0	6	0	0
7	64168806	rs4718103	T	C	18	16	34	0	0	34	0	0
7	64254901	rs11983033	T	C	28	20	48	0	0	48	0	0
7	64257382	rs1608899	C	T	4	2	6	0	0	6	0	0
7	64291976	rs10949946	G	A	19	14	33	0	0	33	0	0
7	64292695	rs6460195	G	A	5	8	13	0	0	13	0	0
7	64293217	rs3763506	T	C	6	7	13	0	0	13	0	0
7	64452738	rs67047829	G	A	13	14	27	0	0	27	0	0
7	64459809	rs73141516	C	T	4	6	10	0	0	10	0	0
7	64459869	rs117992925	G	C	7	8	15	0	0	15	0	0
7	64498787	.	G	C	2	6	8	0	0	8	0	0
7	64841217	rs13241243	G	T	5	2	7	0	0	7	0	0
7	64864894	rs7796776	C	T	92	83	175	0	1	176	0	0
7	64865881	rs3910126	G	C	30	26	56	0	0	56	0	0
7	65227913	.	T	C	10	1	11	0	0	11	0	0
7	65228128	.	C	T	4	5	9	0	0	9	0	0
7	65867485	.	C	T	4	4	8	0	0	8	0	0
7	66421880	rs150789844	T	C	13	15	28	0	0	28	0	0
7	66648157	.	C	T	21	15	36	0	0	36	0	0
7	66648199	.	G	A	16	14	30	0	0	30	0	0
7	66660242	.	A	G	9	8	17	0	0	17	0	0
7	66660247	.	T	C	9	7	16	0	0	16	0	0
7	66703328	rs28450001	G	A	12	7	19	0	0	19	0	0
7	66703636	rs1045053	G	A	20	18	38	0	1	39	0	0
7	66703652	rs2041576	T	C	19	13	32	0	0	32	0	0
7	66703653	rs2041577	G	A	19	13	32	0	1	33	0	0
7	66703655	rs2041578	A	G	19	13	32	0	1	33	0	0
7	66703869	rs1045064	G	A	23	23	46	0	3	49	0	0
7	66704200	rs17726	A	G	28	31	59	0	0	59	0	0
7	66704407	rs1045174	A	C	14	10	24	0	0	24	0	0
7	66760636	.	T	C	17	6	23	0	0	23	0	0
7	66762277	.	C	T	17	8	25	0	0	25	0	0
7	66769189	.	A	G	22	1	23	0	0	23	0	0
7	66769194	rs370292714	C	T	20	1	21	0	0	21	0	0
7	66769198	.	A	G	18	1	19	0	1	20	0	0
7	66769241	rs377105733	T	C	13	0	13	0	0	13	0	0
7	66769242	rs370471568	G	A	13	0	13	0	0	13	0	0
7	66769761	rs28615085	C	T	4	2	6	0	0	6	0	0
7	66770705	rs11763928	A	G	6	7	13	0	0	13	0	0
7	66773109	rs10807709	T	G	10	3	13	0	0	13	0	0
7	66773745	rs7791853	G	T	18	8	26	0	0	26	0	0
7	66774604	rs1045513	G	C	85	65	150	0	2	152	0	0
7	66785137	rs9443	C	A	71	53	124	0	0	124	0	0
7	66785634	rs3864408	T	A	6	7	13	0	0	13	0	0
7	66785714	rs1808293	A	G	6	9	15	0	0	15	0	0
7	69064637	rs3735260	A	G	5	2	7	0	0	7	0	0
7	71248966	rs10225199	C	G	6	6	12	0	0	12	0	0
7	72300571	rs148103177	G	A	28	23	51	0	0	51	0	0
7	72413036	.	C	T	3	5	8	0	0	8	0	0
7	72413443	.	G	A	70	73	143	0	3	146	0	0
7	72413581	.	G	A	196	0	196	0	4	200	0	0
7	72419402	rs116864609	C	A	5	4	9	0	0	9	0	0
7	72422456	.	C	T	11	11	22	0	0	22	0	0
7	72430357	.	G	A	7	2	9	0	0	9	0	0
7	72452141	.	T	G	24	13	37	0	0	37	0	0
7	72468030	.	A	T	36	15	51	0	1	52	0	0
7	72719019	rs35747107	G	A	36	43	79	0	0	79	0	0
7	72855346	.	G	C	32	0	32	0	19	51	0	0
7	72891754	rs2074754	C	T	44	46	90	0	1	91	0	0
7	72912257	rs77557126	G	A	14	22	36	0	1	37	0	0
7	72951095	rs35107030	C	G	352	376	728	0	2	730	0	0
7	73096993	rs8891	T	C	20	22	42	0	0	42	0	0
7	73097238	rs1569062	G	A	24	20	44	0	0	44	0	0
7	73097654	rs1128349	C	T	16	31	47	0	0	47	0	0
7	73100724	rs2141167	A	G	2	5	7	0	0	7	0	0
7	73100788	rs2141166	G	A	5	8	13	0	0	13	0	0
7	73107003	rs2293490	C	A	4	6	10	0	0	10	0	0
7	73107279	rs2293489	C	T	5	4	9	0	0	9	0	0
7	73108205	rs2293488	G	A	2	7	9	0	0	9	0	0
7	73108310	rs2293487	T	C	6	7	13	0	1	14	0	0
7	73110603	rs1001220	C	T	11	20	31	0	0	31	0	0
7	73110832	rs7778762	C	T	14	15	29	0	0	29	0	0
7	73150511	rs1059779	T	C	10	6	16	0	0	16	0	0
7	73610632	.	G	T	1166	1023	2189	0	13	2202	0	0
7	73780812	rs512023	C	G	3	7	10	0	0	10	0	0
7	73785170	rs2528994	G	C	6	3	9	0	0	9	0	0
7	73810663	rs34965815	G	A	3	3	6	0	0	6	0	0
7	74169405	.	G	A	16	9	25	0	0	25	0	0
7	74173182	.	T	A	82	22	104	0	1	105	0	0
7	74193668	rs10614	G	A	17	19	36	0	0	36	0	0
7	74201598	.	T	C	5	1	6	0	0	6	0	0
7	74212036	rs707394	C	G	2	4	6	0	1	7	0	0
7	74212048	rs707395	C	T	2	4	6	0	0	6	0	0
7	74274926	.	G	A	6	0	6	0	0	6	0	0
7	74282675	rs801075	G	A	3	4	7	0	0	7	0	0
7	74286262	rs111433198	T	G	3	3	6	0	0	6	0	0
7	74294440	.	G	T	54	26	80	0	1	81	0	0
7	74294925	rs2529275	C	T	26	3	29	0	0	29	0	0
7	74296375	rs1362139	G	A	48	6	54	0	0	54	0	0
7	74296716	rs183251357	T	C	6	3	9	0	0	9	0	0
7	74297306	rs2530478	C	T	22	9	31	0	0	31	0	0
7	74297551	rs2108321	T	A	59	9	68	0	1	69	0	0
7	74297827	rs1635765	G	A	23	12	35	0	0	35	0	0
7	74298377	rs1062273	T	C	128	14	142	0	0	142	0	0
7	74299726	.	C	G	28	5	33	0	0	33	0	0
7	74306596	rs71558560	G	A	51	37	88	0	2	90	0	0
7	74312339	rs201815917	C	T	26	9	35	0	0	35	0	0
7	74312340	rs200011387	G	A	26	9	35	0	0	35	0	0
7	74322012	.	A	G	10	1	11	0	0	11	0	0
7	74322474	.	C	T	5	3	8	0	0	8	0	0
7	74335845	rs1637339	C	T	3	3	6	0	0	6	0	0
7	74563753	.	G	A	4	2	6	0	0	6	0	0
7	75042154	.	C	T	6	16	22	0	0	22	0	0
7	75044830	rs236651	G	A	8	3	11	0	0	11	0	0
7	75046566	rs150748305	C	T	56	51	107	0	1	108	0	0
7	75046896	rs11538595	G	A	78	74	152	0	3	155	0	0
7	75047944	rs376495903	G	A	29	32	61	0	1	62	0	0
7	75048320	rs116287082	C	T	31	36	67	0	0	67	0	0
7	75049298	rs118077968	A	T	21	23	44	0	2	46	0	0
7	75049460	rs236658	A	G	8	11	19	0	0	19	0	0
7	75049730	.	A	G	19	15	34	0	0	34	0	0
7	75050086	rs236660	T	C	9	8	17	0	0	17	0	0
7	75051324	rs117499978	G	C	96	67	163	0	0	163	0	0
7	75051368	rs398003	T	C	72	49	121	0	0	121	0	0
7	75053431	rs416185	T	G	112	51	163	0	2	165	0	0
7	75054156	rs142931484	T	C	7	8	15	0	0	15	0	0
7	75070642	rs61091455	C	T	13	6	19	0	1	20	0	0
7	75115226	rs55838432	G	A	3	4	7	0	0	7	0	0
7	75145495	rs794377	G	A	15	8	23	0	0	23	0	0
7	75163169	rs1167827	A	G	59	53	112	0	1	113	0	0
7	75166401	rs1167830	C	T	17	21	38	0	0	38	0	0
7	75441108	rs11465315	C	T	3	3	6	0	0	6	0	0
7	75441111	rs11465314	G	T	2	4	6	0	0	6	0	0
7	75609677	rs1135612	A	G	39	32	71	0	0	71	0	0
7	75615287	rs1057870	G	A	44	54	98	0	0	98	0	0
7	75616778	rs11767816	A	T	13	10	23	0	0	23	0	0
7	75616779	rs11766464	C	A	14	10	24	0	0	24	0	0
7	75634687	rs1044484	G	A	40	44	84	0	1	85	0	0
7	75686792	.	T	G	341	324	665	0	2	667	0	0
7	76054372	rs2286428	G	A	11	16	27	0	1	28	0	0
7	76069629	.	G	A	99	18	117	0	0	117	0	0
7	76069811	rs2906999	T	C	37	134	171	0	0	171	0	0
7	76069902	.	G	C	73	186	259	0	0	259	0	0
7	76071228	rs143649134	A	G	105	9	114	0	1	115	0	0
7	76111994	rs1638075	C	G	8	7	15	0	0	15	0	0
7	76112060	rs1638074	C	T	7	3	10	0	0	10	0	0
7	76247668	.	G	A	10	17	27	0	0	27	0	0
7	76255373	.	A	G	146	122	268	0	1	269	0	0
7	76745045	rs57395069	T	C	13	4	17	0	0	17	0	0
7	76745119	rs2539357	A	G	9	5	14	0	0	14	0	0
7	76745193	rs56171003	G	C	9	7	16	0	0	16	0	0
7	76746216	rs117784642	C	T	4	3	7	0	0	7	0	0
7	76751305	rs3114350	C	T	9	12	21	0	1	22	0	0
7	76751357	rs3095481	G	A	12	14	26	0	0	26	0	0
7	76984572	rs2037753	G	A	20	7	27	0	0	27	0	0
7	76990178	rs4727366	C	G	23	2	25	0	0	25	0	0
7	76991935	rs1527263	C	T	26	1	27	0	0	27	0	0
7	77197632	rs4729540	T	C	4	2	6	0	0	6	0	0
7	77247821	rs9640663	G	A	87	73	160	0	1	161	0	0
7	77265140	rs2230602	G	A	117	94	211	0	3	214	0	0
7	77314644	rs7810273	G	A	19	19	38	0	0	38	0	0
7	77314818	rs12113119	T	G	4	2	6	0	1	7	0	0
7	77332058	rs10239156	G	C	3	7	10	0	0	10	0	0
7	77333267	rs11764879	G	A	1	5	6	0	0	6	0	0
7	77365770	rs3764824	A	G	12	12	24	0	1	25	0	0
7	77368080	rs4729668	G	C	6	12	18	0	0	18	0	0
7	77371829	rs62460713	A	G	3	5	8	0	0	8	0	0
7	77410314	rs6954671	G	C	5	3	8	0	0	8	0	0
7	77423152	rs1045463	C	T	19	4	23	0	0	23	0	0
7	77423574	rs7953	G	A	22	17	39	0	0	39	0	0
7	77426482	rs6970595	T	C	2	4	6	0	0	6	0	0
7	77547198	rs848483	T	C	3	6	9	0	0	9	0	0
7	77552127	rs848486	G	A	11	6	17	0	0	17	0	0
7	77554414	rs848487	C	T	6	2	8	0	0	8	0	0
7	77554477	rs848488	A	T	6	2	8	0	0	8	0	0
7	77557718	rs848492	G	A	6	3	9	0	0	9	0	0
7	79789180	rs2714454	T	C	5	10	15	0	0	15	0	0
7	79816338	rs7808119	T	G	3	3	6	0	0	6	0	0
7	79829844	rs10272499	T	C	4	12	16	0	0	16	0	0
7	79843342	rs56387878	C	A	4	2	6	0	0	6	0	0
7	79844110	rs3890739	C	A	5	3	8	0	0	8	0	0
7	79847565	rs17153599	C	T	2	9	11	0	0	11	0	0
7	79848093	rs56284710	G	C	4	13	17	0	0	17	0	0
7	79848272	rs17153603	G	A	35	80	115	0	2	117	0	0
7	79848294	rs11767465	G	A	84	37	121	0	2	123	0	0
7	81346292	rs5745725	A	G	8	7	15	0	0	15	0	0
7	81386048	.	A	G	38	33	71	0	0	71	0	0
7	86413597	rs727989	G	A	0	8	8	0	0	8	0	0
7	86514608	rs79225790	C	T	15	1	16	0	0	16	0	0
7	87138645	rs1045642	A	G	9	6	15	0	0	15	0	0
7	87160618	rs2032582	A	C	8	7	15	0	0	15	0	0
7	87179601	rs1128503	A	G	9	8	17	0	0	17	0	0
7	87835469	rs1063964	G	A	10	5	15	0	0	15	0	0
7	87839690	rs17150369	T	C	2	4	6	0	0	6	0	0
7	87839779	rs75358192	T	C	10	4	14	0	0	14	0	0
7	90015835	rs189238020	G	A	2	4	6	0	0	6	0	0
7	90251607	rs11563416	A	G	4	2	6	0	0	6	0	0
7	91502407	rs9008	C	G	1	8	9	0	0	9	0	0
7	91502535	rs62466814	T	C	2	14	16	0	0	16	0	0
7	91503228	rs10266424	C	T	0	12	12	0	0	12	0	0
7	91570290	rs4727267	G	C	6	6	12	0	0	12	0	0
7	91630620	rs6964587	G	T	15	16	31	0	1	32	0	0
7	91632306	rs1989779	C	T	15	21	36	0	0	36	0	0
7	91641928	rs13245393	A	G	21	20	41	0	0	41	0	0
7	91657116	rs112006729	A	G	5	1	6	0	0	6	0	0
7	91668365	rs34548928	G	A	5	2	7	0	0	7	0	0
7	91691601	rs10236397	C	T	19	22	41	0	0	41	0	0
7	91708898	rs35759833	A	G	22	22	44	0	0	44	0	0
7	91712698	rs6960867	A	G	29	27	56	0	0	56	0	0
7	91713972	rs10228334	C	T	35	23	58	0	0	58	0	0
7	91715662	rs28927678	C	T	27	41	68	0	0	68	0	0
7	91719168	rs28584017	G	A	3	3	6	0	0	6	0	0
7	91721581	rs12537846	A	G	5	4	9	0	0	9	0	0
7	91726927	rs1063243	A	C	42	46	88	0	0	88	0	0
7	91741971	rs1135217	C	T	89	77	166	0	1	167	0	0
7	91742187	rs11459	A	G	60	51	111	0	8	119	0	0
7	91742348	rs57122389	C	A	30	19	49	0	2	51	0	0
7	91742602	rs6465348	A	G	80	70	150	0	0	150	0	0
7	91742728	rs7793861	C	G	60	54	114	0	0	114	0	0
7	91743150	rs7797834	A	G	84	78	162	0	0	162	0	0
7	91757393	rs12533199	C	T	2	4	6	0	0	6	0	0
7	91757479	rs12538325	A	G	5	4	9	0	0	9	0	0
7	91757773	rs12112262	C	T	2	4	6	0	0	6	0	0
7	91758422	rs4729021	C	A	2	5	7	0	0	7	0	0
7	91759597	rs4644173	A	G	5	2	7	0	0	7	0	0
7	91761565	rs182610111	T	C	4	2	6	0	0	6	0	0
7	91762629	rs55801687	C	A	2	4	6	0	1	7	0	0
7	91840724	rs4727268	T	C	3	5	8	0	0	8	0	0
7	92028039	rs38794	C	A	16	11	27	0	0	27	0	0
7	92029302	rs12740	G	A	9	4	13	0	0	13	0	0
7	92236164	rs8179	T	C	188	204	392	0	5	398	1	0
7	92236421	rs42030	G	A	329	320	649	0	2	651	0	0
7	92236829	rs4272	A	G	90	119	209	0	3	212	0	0
7	92237396	rs42031	A	T	259	228	487	0	5	492	0	0
7	92237426	rs42032	G	A	255	223	478	0	2	480	0	0
7	92237533	rs42033	A	T	318	338	656	0	1	657	0	0
7	92239144	rs42034	A	G	74	103	177	0	0	177	0	0
7	92239531	rs42035	A	G	249	291	540	0	1	541	0	0
7	92241451	rs42036	C	G	436	437	873	0	5	878	0	0
7	92243672	rs42377	G	A	42	26	68	0	1	69	0	0
7	92243719	rs42038	C	T	29	25	54	0	0	54	0	0
7	92244422	rs42039	C	T	379	273	652	0	1	653	0	0
7	92253972	rs10269774	G	A	10	6	16	0	0	16	0	0
7	92256905	rs2040494	C	T	13	14	27	0	0	27	0	0
7	92260161	rs11771637	G	A	3	3	6	0	0	6	0	0
7	92434754	rs560628028	T	C	4	4	8	0	0	8	0	0
7	92485039	rs7793983	A	G	2	8	10	0	0	10	0	0
7	92985252	rs2374639	T	C	6	4	10	0	0	10	0	0
7	94152988	rs10267474	A	G	2	4	6	0	0	6	0	0
7	94173803	rs13242090	T	C	13	25	38	0	0	38	0	0
7	94185888	rs3763464	G	A	13	16	29	0	0	29	0	0
7	94186068	rs1133700	A	G	4	3	7	0	0	7	0	0
7	94263180	rs34646287	G	A	8	6	14	0	0	14	0	0
7	94295183	rs72615135	T	A	7	0	7	0	0	7	0	0
7	95034775	rs7493	G	C	47	40	87	0	0	87	0	0
7	95041016	rs12026	G	C	30	20	50	0	1	51	0	0
7	95043523	rs6973380	C	T	3	4	7	0	0	7	0	0
7	96335887	.	A	C	7	0	7	0	4	11	0	0
7	96335888	.	A	C	7	2	9	0	2	11	0	0
7	97483921	rs1049677	G	C	12	4	16	0	0	16	0	0
7	97488569	rs1049674	A	T	12	9	21	0	0	21	0	0
7	97595942	rs2894158	T	C	14	13	27	0	0	27	0	0
7	97596092	rs3957046	T	A	12	19	31	0	0	31	0	0
7	97599772	rs11982759	G	C	7	2	9	0	0	9	0	0
7	97599980	rs11982770	C	G	8	6	14	0	0	14	0	0
7	97845431	rs6969321	G	A	21	30	51	0	0	51	0	0
7	97873994	rs1874344	G	A	13	9	22	0	0	22	0	0
7	97911883	rs4448203	C	T	5	3	8	0	0	8	0	0
7	97913196	rs4506131	G	C	5	4	9	0	0	9	0	0
7	97914164	rs10277669	C	T	11	7	18	0	0	18	0	0
7	97914305	rs10953254	A	G	7	7	14	0	0	14	0	0
7	97915685	rs10226454	C	A	14	7	21	0	0	21	0	0
7	97915758	rs35658212	G	A	12	10	22	0	0	22	0	0
7	97916903	rs10267597	C	T	5	7	12	0	0	12	0	0
7	97918321	rs4075058	A	G	9	3	12	0	0	12	0	0
7	97919173	rs76446760	C	A	12	10	22	0	0	22	0	0
7	97919974	rs117066569	C	G	17	11	28	0	0	28	0	0
7	97938443	rs1006169	G	A	6	0	6	0	0	6	0	0
7	97938618	rs1985593	C	T	10	5	15	0	0	15	0	0
7	97939222	rs6951286	T	C	8	9	17	0	0	17	0	0
7	98015435	rs62478228	C	T	159	0	159	0	15	174	0	0
7	98015868	rs9641237	G	A	134	0	134	0	8	142	0	0
7	98253847	rs1681248	G	C	10	0	10	0	0	10	0	0
7	98258608	rs2642895	G	A	72	0	72	0	0	72	0	0
7	98258736	rs705315	G	A	87	0	87	0	2	89	0	0
7	98495954	rs2074730	G	A	9	0	9	0	0	9	0	0
7	98497746	rs73155610	C	T	7	6	13	0	1	14	0	0
7	98506441	rs35310331	C	T	20	12	32	0	0	32	0	0
7	98526421	rs73155631	G	A	7	2	9	0	0	9	0	0
7	98550445	rs3815231	C	A	4	3	7	0	0	7	0	0
7	98551152	rs3815232	C	T	4	4	8	0	0	8	0	0
7	98563065	rs41640	C	G	3	4	7	0	0	7	0	0
7	98563144	rs41641	T	C	4	4	8	0	0	8	0	0
7	98565443	rs117969010	C	A	4	4	8	0	0	8	0	0
7	98594844	rs219834	G	A	4	2	6	0	0	6	0	0
7	98596408	rs219831	G	A	4	2	6	0	0	6	0	0
7	98598640	rs219829	C	T	4	5	9	0	0	9	0	0
7	98599534	rs59095965	C	T	4	4	8	0	0	8	0	0
7	98601244	rs73161950	T	C	3	3	6	0	0	6	0	0
7	98602990	rs219838	G	C	3	4	7	0	0	7	0	0
7	98604126	rs219839	A	G	5	2	7	0	0	7	0	0
7	98607587	rs147157367	C	T	3	3	6	0	0	6	0	0
7	98610587	rs73145606	G	A	87	117	204	0	0	204	0	0
7	98610595	rs219816	T	C	85	114	199	0	3	202	0	0
7	98610684	rs219815	C	T	77	72	149	0	1	150	0	0
7	98611561	rs170185	C	G	6	7	13	0	0	13	0	0
7	98625556	rs73145619	C	G	110	133	243	0	0	243	0	0
7	98626347	rs73145620	C	T	78	72	150	0	1	151	0	0
7	98630143	.	T	C	21	19	40	0	0	40	0	0
7	98630165	rs145470615	G	A	20	22	42	0	1	43	0	0
7	98631546	rs73145621	C	T	7	4	11	0	0	11	0	0
7	98634147	rs73145623	G	A	2	6	8	0	0	8	0	0
7	98636918	rs73145624	G	A	12	18	30	0	1	31	0	0
7	98645180	rs73145626	G	A	3	4	7	0	0	7	0	0
7	98648069	rs219827	G	A	3	5	8	0	0	8	0	0
7	98650051	rs219797	G	C	43	45	88	0	0	88	0	0
7	98716813	rs1128097	A	G	5	10	15	0	0	15	0	0
7	98961738	rs10263954	C	T	3	8	11	0	0	11	0	0
7	98962115	rs10264582	G	C	19	11	30	0	0	30	0	0
7	98963155	rs10225529	T	C	7	7	14	0	0	14	0	0
7	98963340	rs10268984	C	T	6	4	10	0	0	10	0	0
7	98984399	rs4765	C	T	556	498	1054	0	13	1067	0	0
7	98987580	.	G	T	600	538	1138	0	11	1149	0	0
7	98989626	rs10953288	G	A	2	4	6	0	0	6	0	0
7	98991944	rs10243678	C	T	6	6	12	0	0	12	0	0
7	98992253	rs704798	G	T	361	317	678	0	7	685	0	0
7	98997549	.	G	A	7	7	14	0	0	14	0	0
7	98998471	rs2072181	T	C	3	3	6	0	0	6	0	0
7	99005695	rs6960810	G	A	4	3	7	0	0	7	0	0
7	99006763	rs10277447	T	C	69	60	129	0	1	130	0	0
7	99009924	.	G	A	4	2	6	0	0	6	0	0
7	99012885	rs10953289	G	C	7	2	9	0	0	9	0	0
7	99014984	rs2003499	T	C	6	2	8	0	0	8	0	0
7	99015791	rs2003498	T	C	10	13	23	0	0	23	0	0
7	99016683	rs28495024	G	C	18	14	32	0	0	32	0	0
7	99017281	rs60577432	G	A	13	6	19	0	0	19	0	0
7	99032593	rs11555142	G	T	4	7	11	0	0	11	0	0
7	99047978	rs883403	T	C	51	72	123	0	0	123	0	0
7	99048432	rs2280600	T	C	3	4	7	0	0	7	0	0
7	99049403	rs13227795	A	G	4	2	6	0	0	6	0	0
7	99054289	rs1043466	T	G	56	66	122	0	2	124	0	0
7	99056099	rs2280601	T	C	18	12	30	0	0	30	0	0
7	99060603	rs1980307	A	G	5	8	13	0	0	13	0	0
7	99070884	rs10808111	T	A	6	10	16	0	0	16	0	0
7	99070988	rs10808112	C	T	5	11	16	0	1	17	0	0
7	99078251	.	T	C	6	8	14	0	0	14	0	0
7	99081730	rs6962772	A	G	8	11	19	0	0	19	0	0
7	99091608	.	G	A	366	460	826	0	5	831	0	0
7	99094423	.	G	A	20	21	41	0	0	41	0	0
7	99130834	rs34670419	G	T	4	6	10	0	0	10	0	0
7	99130875	rs3137	G	A	6	6	12	0	0	12	0	0
7	99156446	rs6947941	G	T	23	18	41	0	1	42	0	0
7	99156506	rs6947974	G	A	27	13	40	0	4	44	0	0
7	99156520	rs6947826	C	T	33	17	50	0	1	51	0	0
7	99156934	rs17161761	C	T	17	12	29	0	0	29	0	0
7	99166544	rs36104094	A	G	2	6	8	0	0	8	0	0
7	99171449	rs952319	C	T	20	11	31	0	0	31	0	0
7	99498875	.	C	T	7	5	12	0	0	12	0	0
7	99718755	.	T	A	7	0	7	0	2	9	0	0
7	99811765	rs181256968	G	C	6	6	12	0	0	12	0	0
7	99917237	rs200892093	A	T	22	15	37	0	0	37	0	0
7	99936557	rs201656849	A	G	9	9	18	0	0	18	0	0
7	99958654	rs181625554	G	A	3	3	6	0	0	6	0	0
7	99965370	rs140686128	C	T	47	63	110	0	2	112	0	0
7	99973347	rs113202779	T	G	5	6	11	0	0	11	0	0
7	99998607	rs11769886	G	A	4	2	6	0	0	6	0	0
7	100026780	rs60257855	G	C	5	5	10	0	0	10	0	0
7	100027339	rs74460138	C	G	5	13	18	0	1	19	0	0
7	100028187	rs6975729	C	T	22	27	49	0	1	50	0	0
7	100028484	rs6962151	T	C	51	53	104	0	2	106	0	0
7	100031612	rs1073	G	A	83	81	164	0	1	165	0	0
7	100064719	rs7806537	A	G	231	200	431	0	5	436	0	0
7	100065443	rs7811142	A	T	8	10	18	0	0	18	0	0
7	100068936	rs7794485	T	C	5	3	8	0	0	8	0	0
7	100069088	rs111972532	T	C	6	8	14	0	1	15	0	0
7	100070758	rs4472444	T	C	6	12	18	0	0	18	0	0
7	100072031	rs7809801	T	C	329	345	674	0	4	678	0	0
7	100072767	rs1962269	C	T	4	4	8	0	0	8	0	0
7	100073069	rs11773661	G	C	3	4	7	0	0	7	0	0
7	100073292	rs11766752	A	G	5	2	7	0	0	7	0	0
7	100076614	rs11559117	A	G	182	203	385	0	3	388	0	0
7	100178084	.	G	A	8	4	12	0	0	12	0	0
7	100178177	rs35061193	C	T	9	4	13	0	0	13	0	0
7	100410597	rs2230585	G	A	18	19	37	0	0	37	0	0
7	100411278	rs314359	T	C	18	8	26	0	1	27	0	0
7	100416250	rs144173	A	G	14	6	20	0	0	20	0	0
7	100416332	rs314364	T	A	4	2	6	0	0	6	0	0
7	100416354	rs314365	G	C	4	3	7	0	0	7	0	0
7	100452524	rs314369	A	G	5	6	11	0	0	11	0	0
7	100453208	rs314370	T	C	9	12	21	0	0	21	0	0
7	100455700	rs314371	C	T	5	1	6	0	0	6	0	0
7	100458795	rs314378	T	C	102	77	179	0	3	182	0	0
7	100468284	rs1054391	A	G	24	24	48	0	1	49	0	0
7	100471044	rs6706	C	T	3	9	12	0	0	12	0	0
7	100474289	rs12667888	T	C	2	7	9	0	0	9	0	0
7	100482026	rs15624	T	C	152	92	244	0	0	244	0	0
7	100482526	rs6942607	C	G	13	14	27	0	0	27	0	0
7	100483731	rs12672665	A	G	2	6	8	0	0	8	0	0
7	100484381	rs12705095	T	G	4	4	8	0	0	8	0	0
7	100486035	rs2720392	C	A	47	35	82	0	0	82	0	0
7	100486088	rs3087504	C	T	48	56	104	0	0	104	0	0
7	100774516	rs2227662	C	T	3	4	7	0	0	7	0	0
7	100777267	rs2070682	T	C	5	1	6	0	0	6	0	0
7	100781084	rs11178	T	C	64	30	94	0	1	95	0	0
7	100781408	rs1050766	C	T	33	19	52	0	0	52	0	0
7	100781445	rs7242	T	G	38	20	58	0	0	58	0	0
7	100781615	rs1050813	G	A	18	38	56	0	0	56	0	0
7	100860636	rs1056678	T	C	49	50	99	0	1	100	0	0
7	100861452	rs11769624	T	C	3	5	8	0	0	8	0	0
7	100861870	rs2072168	G	T	6	10	16	0	0	16	0	0
7	100862264	rs2074685	T	C	5	11	16	0	0	16	0	0
7	100862392	rs35094522	A	G	7	11	18	0	1	19	0	0
7	100862501	rs78380557	C	T	4	10	14	0	0	14	0	0
7	100862738	rs7784229	T	C	11	11	22	0	0	22	0	0
7	100864711	rs35082269	C	T	11	14	25	0	1	26	0	0
7	100865847	rs10953329	T	C	11	5	16	0	0	16	0	0
7	100875772	rs1047319	T	G	39	44	83	0	0	83	0	0
7	100881429	rs3757459	C	T	34	39	73	0	0	73	0	0
7	100881640	rs3757460	A	G	33	32	65	0	1	66	0	0
7	101896232	rs2529113	A	G	52	53	105	0	0	105	0	0
7	101897982	rs11771091	G	A	66	77	143	0	0	143	0	0
7	101898037	rs11771127	G	C	69	82	151	0	0	151	0	0
7	101926817	rs147926104	G	A	255	251	506	0	11	517	0	0
7	102065651	rs1047998	C	T	101	73	174	0	1	175	0	0
7	102104494	.	C	G	3	3	6	0	0	6	0	0
7	102107371	rs56308176	G	A	4	2	6	0	0	6	0	0
7	102111936	rs60871950	G	A	7	7	14	0	1	15	0	0
7	102114631	rs56273862	A	G	10	9	19	0	0	20	1	0
7	102119343	.	C	G	56	51	107	0	0	107	0	0
7	102147148	rs545298889	T	C	42	44	86	0	0	86	0	0
7	102168493	.	A	C	10	2	12	0	0	12	0	0
7	102172741	.	C	T	7	13	20	0	0	20	0	0
7	102184740	.	G	A	7	0	7	0	2	9	0	0
7	102184779	.	T	C	6	0	6	0	0	6	0	0
7	102185815	.	G	T	16	1	17	0	0	17	0	0
7	102221792	.	A	G	28	6	34	0	0	34	0	0
7	102235769	.	T	C	73	0	73	0	1	74	0	0
7	102246311	.	T	C	5	2	7	0	0	7	0	0
7	102246394	rs11547191	A	G	32	2	34	0	0	34	0	0
7	102274758	.	C	T	9	1	10	0	0	10	0	0
7	102274796	rs77602985	T	C	13	0	13	0	0	13	0	0
7	102396043	rs9690473	C	T	5	3	8	0	0	8	0	0
7	102732933	rs146105958	A	G	29	3	32	0	0	32	0	0
7	102739188	rs1061844	C	T	8	6	14	0	0	14	0	0
7	102950099	rs117949792	C	T	5	7	12	0	0	12	0	0
7	102962215	rs145470711	G	A	5	5	10	0	0	10	0	0
7	104581691	rs115581730	G	A	157	151	308	0	9	318	1	0
7	104587683	.	T	C	8	3	11	0	0	11	0	0
7	104591379	rs11972126	G	C	4	3	7	0	0	7	0	0
7	104592210	rs139091277	T	A	5	7	12	0	0	12	0	0
7	104595664	rs2428162	T	C	6	4	10	0	0	10	0	0
7	104596248	rs56016333	T	C	5	2	7	0	0	7	0	0
7	104624312	rs3735377	C	G	3	5	8	0	0	8	0	0
7	104652671	rs6950894	G	A	2	4	6	0	0	6	0	0
7	104656042	rs2216107	C	G	11	8	19	0	1	20	0	0
7	104657444	rs67739707	C	A	7	7	14	0	0	14	0	0
7	104658904	rs10245676	A	G	6	4	10	0	0	10	0	0
7	104659216	rs12532062	T	G	8	9	17	0	0	17	0	0
7	104660672	rs10224526	G	A	7	5	12	0	0	12	0	0
7	104662382	rs10261573	A	G	3	5	8	0	0	8	0	0
7	104678877	rs7800233	G	T	19	25	44	0	0	44	0	0
7	104694921	.	A	G	6	0	6	0	0	6	0	0
7	104696188	rs2240453	T	C	6	4	10	0	0	10	0	0
7	104697085	rs76642151	G	T	3	3	6	0	0	6	0	0
7	104697286	rs4730069	C	T	4	2	6	0	0	6	0	0
7	104697512	rs10260346	A	T	4	6	10	0	0	10	0	0
7	104698109	rs10231782	C	A	8	5	13	0	0	13	0	0
7	104698848	rs1029596	C	G	3	5	8	0	0	8	0	0
7	104700760	rs6952534	C	A	4	4	8	0	0	8	0	0
7	104704314	rs7805792	G	C	8	10	18	0	0	18	0	0
7	104704837	rs12671368	G	A	7	11	18	0	0	18	0	0
7	104707360	rs12705297	C	T	5	4	9	0	0	9	0	0
7	104709086	.	G	T	3	4	7	0	2	9	0	0
7	104709946	rs10808139	G	A	6	10	16	0	0	16	0	0
7	104710135	rs10808140	G	A	4	7	11	0	0	11	0	0
7	104713915	rs999895	T	C	4	5	9	0	0	9	0	0
7	104717517	rs2240455	C	T	359	343	702	0	6	708	0	0
7	104723881	rs10245589	A	C	6	5	11	0	0	11	0	0
7	104725851	rs12705299	C	T	6	5	11	0	0	11	0	0
7	104726211	rs28434158	G	A	6	1	7	0	0	7	0	0
7	104726627	rs28489493	A	G	4	6	10	0	0	10	0	0
7	104728607	rs3213676	C	T	16	9	25	0	0	25	0	0
7	104729315	rs12540007	G	C	12	13	25	0	0	25	0	0
7	104731338	rs7784126	T	A	7	10	17	0	0	17	0	0
7	104733504	rs10953467	T	C	4	6	10	0	0	10	0	0
7	104733538	rs12667625	G	A	4	6	10	0	0	10	0	0
7	104741062	rs35418021	G	A	5	6	11	0	0	11	0	0
7	104751419	rs2299299	C	T	12	7	19	0	1	20	0	0
7	104755816	rs1013016	G	T	5	3	8	0	0	8	0	0
7	104879459	rs2237618	A	G	3	3	6	0	0	6	0	0
7	104959297	rs17708070	G	A	5	1	6	0	0	6	0	0
7	105148593	rs61741425	G	A	20	7	27	0	0	27	0	0
7	105246821	rs12154239	C	T	13	6	19	0	1	20	0	0
7	105247470	rs7777200	A	C	7	6	13	0	0	13	0	0
7	105254085	rs57819574	T	C	5	10	15	0	0	15	0	0
7	105254577	.	G	A	6	6	12	0	0	12	0	0
7	105263342	rs1706925	C	T	4	3	7	0	0	7	0	0
7	105734803	rs1024562	A	C	1	5	6	0	0	6	0	0
7	105735042	rs10953491	A	G	6	7	13	0	0	13	0	0
7	105735118	rs6960866	A	G	5	7	12	0	0	12	0	0
7	105737166	rs16872056	A	G	6	8	14	0	0	14	0	0
7	105737628	rs143350416	G	A	5	2	7	0	0	7	0	0
7	105751781	rs3801274	G	A	5	7	12	0	0	12	0	0
7	105752113	rs141711077	C	T	4	5	9	0	0	9	0	0
7	105889169	.	C	T	41	22	63	0	0	63	0	0
7	105906576	.	C	T	51	53	104	0	0	104	0	0
7	105908010	rs116021871	G	A	33	21	54	0	0	54	0	0
7	105910061	rs10487818	A	T	27	25	52	0	0	52	0	0
7	105911178	.	T	C	66	68	134	0	1	135	0	0
7	106297831	rs7808289	G	A	6	9	15	0	0	15	0	0
7	106522592	rs28763991	A	G	59	57	116	0	1	117	0	0
7	106523446	rs849397	A	G	26	35	61	0	1	62	0	0
7	106524411	rs849398	T	G	5	3	8	0	0	8	0	0
7	106525356	rs76849038	G	C	2	4	6	0	1	7	0	0
7	106532617	rs849405	A	G	3	3	6	0	0	6	0	0
7	106532885	rs75322739	C	G	3	3	6	0	0	6	0	0
7	106546304	rs849410	T	G	37	56	93	0	1	94	0	0
7	106685448	rs75385144	G	T	11	11	22	0	0	22	0	0
7	106799997	rs257376	G	A	34	36	70	0	1	71	0	0
7	106801088	rs257377	G	T	11	19	30	0	0	30	0	0
7	106801395	rs257378	C	G	14	28	42	0	0	42	0	0
7	106810107	rs61014091	A	C	2	7	9	0	0	9	0	0
7	106810293	rs4730222	G	C	3	3	6	0	0	6	0	0
7	106810997	rs12536574	A	T	7	3	10	0	0	10	0	0
7	106811222	rs113878583	C	T	7	8	15	0	1	16	0	0
7	106814234	rs4730223	A	T	2	18	20	0	0	20	0	0
7	106814543	rs75007274	G	A	3	9	12	0	0	12	0	0
7	106814574	rs76933738	T	C	4	11	15	0	0	15	0	0
7	106815754	rs77727587	C	G	5	7	12	0	0	12	0	0
7	106817100	rs77150993	G	T	7	8	15	0	0	15	0	0
7	106817184	rs6947675	T	C	2	5	7	0	0	7	0	0
7	106817639	rs6951639	A	G	6	6	12	0	0	12	0	0
7	106817721	rs6971864	T	C	8	16	24	0	0	24	0	0
7	106818731	rs75035695	T	C	12	16	28	0	0	28	0	0
7	106819255	rs4730224	A	T	5	4	9	0	0	9	0	0
7	106821925	.	A	T	3	3	6	0	0	6	0	0
7	106826381	rs7794598	C	T	225	239	464	0	3	467	0	0
7	106827512	rs10953529	G	A	10	11	21	0	0	21	0	0
7	106827796	rs10953530	A	C	4	3	7	0	0	7	0	0
7	106827867	rs10953531	C	T	10	7	17	0	0	17	0	0
7	106829223	rs7798223	T	C	7	13	20	0	0	20	0	0
7	106832361	rs1002935	G	A	25	32	57	0	0	57	0	0
7	106833797	rs6971675	G	A	24	13	37	0	1	38	0	0
7	106834139	rs6971774	A	G	11	9	20	0	0	20	0	0
7	106834437	rs2395839	A	G	20	21	41	0	0	41	0	0
7	106843133	rs7981	G	C	2	4	6	0	0	6	0	0
7	106844694	rs75932578	C	T	3	5	8	0	0	8	0	0
7	106875965	rs4727670	C	T	4	3	7	0	0	7	0	0
7	106897237	rs17349904	A	C	16	19	35	0	0	35	0	0
7	107002806	rs2269970	A	G	19	18	37	0	0	37	0	0
7	107156669	rs62483685	C	T	9	3	12	0	0	12	0	0
7	107158162	rs60490203	T	A	4	3	7	0	0	7	0	0
7	107161391	rs7807154	T	G	3	6	9	0	0	9	0	0
7	107259721	rs68170813	T	C	7	6	13	0	0	13	0	0
7	107544208	rs2108222	C	G	27	21	48	0	0	48	0	0
7	107544531	rs66999558	G	A	16	13	29	0	0	29	0	0
7	107544742	rs13226236	T	C	16	16	32	0	0	32	0	0
7	107545586	rs17412104	G	A	4	2	6	0	1	7	0	0
7	107545799	rs10263341	T	C	10	6	16	0	0	16	0	0
7	107559137	rs2237683	A	G	6	5	11	0	0	11	0	0
7	107559722	rs8721	A	T	114	84	198	0	0	198	0	0
7	107559911	rs4564	G	A	55	50	105	0	1	106	0	0
7	107560191	rs4518	C	T	31	32	63	0	0	63	0	0
7	107561155	rs2108223	T	C	7	4	11	0	0	11	0	0
7	107561392	rs8440	G	A	5	1	6	0	0	6	0	0
7	107574784	rs2237685	G	A	5	1	6	0	0	6	0	0
7	108116793	rs10215195	C	T	16	17	33	0	0	33	0	0
7	108117088	rs10215206	C	T	7	11	18	0	0	18	0	0
7	108117283	rs60426977	C	T	11	15	26	0	0	26	0	0
7	108117636	rs67694466	G	C	3	4	7	0	0	7	0	0
7	108121463	rs11981670	C	T	28	22	50	0	0	50	0	0
7	108122243	rs6950872	G	A	13	8	21	0	0	21	0	0
7	108122744	rs6955152	A	G	16	11	27	0	0	27	0	0
7	108123257	rs34887057	C	A	11	4	15	0	0	15	0	0
7	108124713	rs34814097	G	A	5	8	13	0	2	15	0	0
7	108124908	rs3202837	G	T	8	8	16	0	0	17	1	0
7	108132412	rs40843	C	T	13	4	17	0	1	18	0	0
7	108132691	rs10265338	A	G	1	5	6	0	0	6	0	0
7	108166553	.	A	T	18	28	46	0	0	46	0	0
7	108203050	rs40942	T	C	3	6	9	0	0	9	0	0
7	108213926	rs3763457	A	G	38	33	71	0	3	74	0	0
7	108214712	.	C	T	26	18	44	0	0	44	0	0
7	111984211	rs60317474	G	A	6	4	10	0	0	10	0	0
7	111987553	rs886353	T	C	6	3	9	0	0	9	0	0
7	111987554	rs2396532	G	C	6	3	9	0	0	9	0	0
7	111987598	rs2396533	T	C	6	4	10	0	0	10	0	0
7	111987670	rs4425678	T	C	4	2	6	0	0	6	0	0
7	112104134	.	C	G	11	0	11	0	0	11	0	0
7	112406507	rs1227176	C	T	4	2	6	0	0	6	0	0
7	112459652	rs1044262	T	A	0	10	10	0	0	10	0	0
7	112555078	rs1976897	G	C	8	1	9	0	0	9	0	0
7	114658220	rs1055521	A	G	6	7	13	0	1	14	0	0
7	115577662	rs4730700	T	A	10	3	13	0	1	14	0	0
7	115578104	rs17241507	T	C	13	7	20	0	1	21	0	0
7	115624288	rs4730703	T	C	4	12	16	0	0	16	0	0
7	115850675	rs11549785	C	T	110	171	281	0	1	282	0	0
7	115850937	rs1866961	T	C	1	9	10	0	0	10	0	0
7	115884078	rs2204678	G	C	5	3	8	0	0	8	0	0
7	115886007	rs4730718	A	C	7	7	14	0	0	14	0	0
7	115890187	rs73222310	A	G	139	102	241	0	2	243	0	0
7	115898710	rs9777	A	G	19	25	44	0	0	44	0	0
7	116146074	rs8940	C	G	7	6	13	0	0	13	0	0
7	116199695	rs1049314	C	A	1	5	6	0	0	6	0	0
7	116199797	rs8713	A	C	3	4	7	0	0	7	0	0
7	116200523	rs6867	G	A	5	7	12	0	0	12	0	0
7	116200587	rs1049337	C	T	11	6	17	0	0	17	0	0
7	116534820	rs964449	A	G	1	7	8	0	0	8	0	0
7	116542861	rs60899920	G	A	8	6	14	0	0	14	0	0
7	116554656	rs7778381	T	C	4	3	7	0	0	7	0	0
7	116558716	rs1049618	G	A	37	29	66	0	2	68	0	0
7	116863631	.	C	T	16	8	24	0	1	25	0	0
7	116863789	rs12532165	G	A	5	7	12	0	0	12	0	0
7	117824239	rs2896242	G	C	60	40	100	0	1	101	0	0
7	117825297	rs6466648	C	G	8	12	20	0	2	22	0	0
7	117825549	rs9655829	T	G	13	13	26	0	1	27	0	0
7	117825681	rs45604739	A	G	17	16	33	0	0	33	0	0
7	117826664	rs6948096	A	G	3	4	7	0	0	7	0	0
7	117827994	rs2402322	A	C	7	1	8	0	0	8	0	0
7	117828003	rs992035	C	T	7	1	8	0	0	8	0	0
7	117829908	rs62466471	T	C	2	11	13	0	0	13	0	0
7	117830566	rs2286863	C	T	5	8	13	0	0	13	0	0
7	117832138	rs1061731	G	A	43	38	81	0	0	81	0	0
7	120994673	rs2536180	T	C	7	4	11	0	0	11	0	0
7	120996595	rs2270215	C	T	4	3	7	0	0	7	0	0
7	123181272	rs6737	C	G	202	216	418	0	2	420	0	0
7	123187030	rs73222278	T	C	13	15	28	0	0	28	0	0
7	123187409	rs77427581	C	A	19	14	33	0	0	33	0	0
7	123187410	rs7785188	T	A	14	19	33	0	0	33	0	0
7	123188369	rs4147631	C	G	14	15	29	0	0	29	0	0
7	123188822	rs73222280	C	T	7	18	25	0	0	25	0	0
7	123190740	rs34034388	T	G	5	3	8	0	0	8	0	0
7	123190928	rs34225533	C	T	6	0	6	0	0	6	0	0
7	123191183	rs10241050	A	G	4	3	7	0	0	7	0	0
7	123193136	rs7792671	A	G	7	8	15	0	0	15	0	0
7	123194917	rs10264986	G	A	4	7	11	0	0	11	0	0
7	123195790	rs1404903	C	T	7	2	9	0	0	9	0	0
7	123322716	rs13044	T	A	8	4	12	0	0	12	0	0
7	123323428	rs3802009	T	A	17	10	27	0	0	27	0	0
7	123325391	rs2109724	C	T	2	4	6	0	0	6	0	0
7	123325459	rs2109725	C	T	4	3	7	0	0	7	0	0
7	123343947	rs17146253	A	G	5	1	6	0	0	6	0	0
7	123361773	rs6950373	C	T	3	3	6	0	1	7	0	0
7	123371026	rs13225220	C	A	5	2	7	0	0	7	0	0
7	123388732	rs1054706	G	A	15	13	28	0	0	28	0	0
7	126988290	rs17862359	C	T	4	5	9	0	0	9	0	0
7	127007985	rs2285337	G	A	3	3	6	0	0	6	0	0
7	127010336	rs17862367	C	A	30	23	53	0	0	53	0	0
7	127021651	rs17866346	T	C	6	2	8	0	0	8	0	0
7	127032453	rs11539276	G	A	11	13	24	0	0	24	0	0
7	127220827	rs989099	A	G	97	90	187	0	1	188	0	0
7	127220918	rs989100	T	C	110	83	193	0	2	195	0	0
7	127221134	rs3752619	T	C	82	91	173	0	0	173	0	0
7	127222157	rs3735644	G	A	71	61	132	0	0	132	0	0
7	127224286	rs3735642	A	G	58	67	125	0	1	126	0	0
7	127669584	rs73238074	T	C	4	3	7	0	0	7	0	0
7	127719243	rs322829	A	G	2	5	7	0	0	7	0	0
7	127721507	rs322825	T	C	223	177	400	0	0	400	0	0
7	127722719	rs322824	T	C	6	4	10	0	0	10	0	0
7	127723313	rs124756	A	G	4	4	8	0	0	8	0	0
7	127723868	rs55995107	G	C	6	6	12	0	0	12	0	0
7	127725243	rs55726025	A	G	2	5	7	0	0	7	0	0
7	127728251	rs143578858	G	A	4	3	7	0	0	7	0	0
7	127729173	rs322822	A	C	5	2	7	0	0	7	0	0
7	127730616	rs112048577	G	A	3	4	7	0	0	7	0	0
7	127731618	rs322820	T	C	2	4	6	0	0	6	0	0
7	127732380	.	T	A	192	147	339	0	4	343	0	0
7	127944314	rs11069	C	G	21	9	30	0	0	30	0	0
7	127945168	rs6467170	T	C	5	1	6	0	0	6	0	0
7	127946072	rs6952533	A	G	8	2	10	0	0	10	0	0
7	127946108	rs17151983	C	T	14	4	18	0	0	18	0	0
7	127946173	rs3750035	T	C	6	18	24	0	0	24	0	0
7	127947299	rs73230631	G	A	7	4	11	0	0	11	0	0
7	127947917	rs73230632	G	T	5	3	8	0	0	8	0	0
7	127948025	rs73721355	C	T	9	4	13	0	0	13	0	0
7	127950414	rs17151987	T	C	4	4	8	0	0	8	0	0
7	127953243	rs7804796	T	C	14	30	44	0	0	44	0	0
7	128033869	.	G	A	4	4	8	0	0	8	0	0
7	128034629	rs2228075	C	T	206	222	428	0	2	430	0	0
7	128035895	rs11766743	A	G	2	6	8	0	0	8	0	0
7	128038555	rs2288550	C	G	128	113	241	0	2	243	0	0
7	128040699	rs2278294	C	T	14	15	29	0	0	29	0	0
7	128040752	rs2278293	C	T	16	13	29	0	0	29	0	0
7	128047147	rs34848853	C	A	3	3	6	0	0	6	0	0
7	128098071	rs1048531	G	A	119	91	210	0	2	212	0	0
7	128103062	rs143687079	C	T	8	1	9	0	0	9	0	0
7	128123451	rs62481136	A	G	2	6	8	0	0	8	0	0
7	128142023	rs12539729	A	T	6	4	10	0	0	10	0	0
7	128143617	rs62481142	T	C	10	11	21	0	0	21	0	0
7	128143860	rs1137306	C	T	2	5	7	0	0	7	0	0
7	128144374	rs12671633	A	G	5	10	15	0	0	15	0	0
7	128167879	rs62483269	C	T	5	4	9	0	0	9	0	0
7	128168694	rs62483270	A	G	6	3	9	0	0	9	0	0
7	128169084	rs62483273	G	A	9	2	11	0	0	11	0	0
7	128169115	rs113585571	A	G	7	2	9	0	1	10	0	0
7	128169884	rs3802004	C	A	8	11	19	0	0	19	0	0
7	128170327	rs62483276	G	A	8	6	14	0	1	15	0	0
7	128173720	rs62483278	A	G	30	25	55	0	0	55	0	0
7	128220111	rs4294131	G	T	52	37	89	0	0	89	0	0
7	128266517	rs200659083	C	T	60	63	123	0	0	123	0	0
7	128268335	rs62481887	C	T	1	5	6	0	0	6	0	0
7	128291286	rs62481913	A	G	154	113	267	0	5	272	0	0
7	128292036	rs62481923	G	C	193	155	348	0	0	348	0	0
7	128292108	rs62481924	G	T	169	140	309	0	1	310	0	0
7	128293187	rs3213979	C	T	199	203	402	0	3	405	0	0
7	128293873	rs141332315	G	A	83	93	176	0	2	178	0	0
7	128294349	rs10227728	T	C	194	214	408	0	4	412	0	0
7	128294406	rs60117311	G	A	248	181	429	0	2	431	0	0
7	128294437	rs58123072	C	T	153	188	341	0	10	352	1	0
7	128294449	rs60229418	G	A	135	157	292	0	3	295	0	0
7	128297422	rs62481936	A	G	9	11	20	0	0	20	0	0
7	128298370	rs62481937	C	G	25	34	59	0	0	59	0	0
7	128298600	rs73723614	T	A	21	18	39	0	0	39	0	0
7	128407169	rs17475638	C	A	1	5	6	0	0	6	0	0
7	128410012	rs1043595	G	A	66	64	130	0	7	137	0	0
7	128503543	rs1472147	T	C	8	7	15	0	0	15	0	0
7	128504285	rs28584751	G	C	9	9	18	0	0	18	0	0
7	128504529	rs13225751	A	G	5	11	16	0	0	16	0	0
7	128504575	rs13226115	G	C	6	11	17	0	0	17	0	0
7	128504788	rs67476247	A	G	6	5	11	0	0	11	0	0
7	128588475	rs75282194	C	A	10	3	13	0	0	13	0	0
7	128589633	rs10954214	C	T	86	54	140	0	0	140	0	0
7	128612552	rs11538884	C	T	42	33	75	0	1	76	0	0
7	128614990	rs2293493	G	A	38	35	73	0	1	74	0	0
7	128668952	rs75456523	A	G	3	5	8	0	0	8	0	0
7	128845223	rs111482521	C	T	1	6	7	0	0	7	0	0
7	129346290	rs17556430	C	T	6	4	10	0	0	10	0	0
7	129363917	rs13239011	C	T	4	5	9	0	0	9	0	0
7	129364184	rs10243809	C	G	1	5	6	0	0	6	0	0
7	129364890	rs73159640	A	T	7	2	9	0	0	9	0	0
7	129395751	rs11557287	A	G	49	64	113	0	0	113	0	0
7	129396174	rs11557288	C	G	51	44	95	0	0	95	0	0
7	129396342	rs13241028	T	C	52	43	95	0	1	96	0	0
7	129475323	rs2727500	G	A	11	8	19	0	0	19	0	0
7	129477458	rs2727499	G	A	6	4	10	0	4	14	0	0
7	129486868	rs62491494	A	T	3	4	7	0	0	7	0	0
7	129491691	rs923231	G	T	3	4	7	0	0	7	0	0
7	129710488	rs3734928	C	T	9	3	12	0	0	12	0	0
7	129762004	rs78696877	G	T	28	27	55	0	0	55	0	0
7	129771144	rs13241007	G	A	15	12	27	0	0	27	0	0
7	129774080	rs35585693	T	C	30	41	71	0	0	71	0	0
7	129774714	rs6821	C	T	56	45	101	0	1	102	0	0
7	129774948	.	A	C	23	12	35	0	1	36	0	0
7	130036691	rs73152868	C	T	1	5	6	0	0	6	0	0
7	130144943	rs1050582	G	C	171	38	209	0	2	211	0	0
7	130587295	rs73159900	G	A	8	6	14	0	0	14	0	0
7	130589791	rs205761	G	A	3	8	11	0	0	11	0	0
7	130629493	rs2293748	T	C	38	29	67	0	1	68	0	0
7	130629772	rs2293750	A	T	31	24	55	0	0	55	0	0
7	130629901	rs3823556	C	T	41	30	71	0	1	72	0	0
7	130631413	rs13225471	G	A	4	7	11	0	0	11	0	0
7	130632125	rs10808245	C	T	4	5	9	0	1	10	0	0
7	130632141	rs10808246	G	A	5	5	10	0	0	10	0	0
7	130634476	rs6959008	G	T	6	9	15	0	0	15	0	0
7	130635617	rs6967767	A	C	10	12	22	0	0	22	0	0
7	130635875	rs6968337	C	A	8	21	29	0	0	29	0	0
7	130636150	rs6968681	C	T	8	20	28	0	0	28	0	0
7	130639140	rs11760691	T	C	11	13	24	0	0	24	0	0
7	130640391	rs79189750	A	T	10	3	13	0	0	13	0	0
7	130640611	rs969827	C	T	3	10	13	0	1	14	0	0
7	130641067	rs205772	G	A	7	6	13	0	0	13	0	0
7	130641203	rs205773	A	G	9	3	12	0	0	12	0	0
7	130641577	rs205774	G	A	8	15	23	0	0	23	0	0
7	130641610	rs17738934	T	C	11	5	16	0	0	16	0	0
7	130641742	rs17687785	G	A	9	16	25	0	0	25	0	0
7	130643067	rs75742090	C	T	17	6	23	0	0	23	0	0
7	130643318	rs205775	C	T	6	2	8	0	0	8	0	0
7	130643328	rs205776	G	A	6	2	8	0	0	8	0	0
7	130643855	rs205777	C	G	3	4	7	0	0	7	0	0
7	130644664	rs205779	C	T	25	10	35	0	0	35	0	0
7	130650716	rs186738104	G	T	3	6	9	0	0	9	0	0
7	130676942	rs28651880	C	T	4	2	6	0	0	6	0	0
7	130677807	rs62471587	C	T	11	2	13	0	0	13	0	0
7	130677808	rs111819262	G	A	2	10	12	0	1	13	0	0
7	130686988	rs1877727	G	A	12	1	13	0	0	13	0	0
7	130716633	rs11976649	A	C	5	2	7	0	0	7	0	0
7	130716685	rs11983470	C	T	5	3	8	0	0	8	0	0
7	130717474	rs350651	A	T	0	6	6	0	0	6	0	0
7	130717723	rs350650	C	T	24	37	61	0	0	61	0	0
7	130718028	rs10239777	T	C	14	39	53	0	2	55	0	0
7	130718414	rs6965560	A	C	7	7	14	0	0	14	0	0
7	130720805	rs10265693	A	G	6	0	6	0	0	6	0	0
7	130720896	rs6942985	C	T	6	1	7	0	0	7	0	0
7	130722927	rs10281967	G	A	7	5	12	0	0	12	0	0
7	130723981	rs10227171	C	A	3	5	8	0	0	8	0	0
7	130727436	rs11978185	T	C	14	6	20	0	0	20	0	0
7	130727562	rs11975417	G	A	7	4	11	0	0	11	0	0
7	130727998	rs28544999	G	C	2	7	9	0	0	9	0	0
7	130732552	rs17165389	T	C	6	4	10	0	0	10	0	0
7	130737570	rs754861	T	A	5	4	9	0	0	9	0	0
7	130739800	rs12531300	T	C	3	3	6	0	0	6	0	0
7	130744560	rs115094676	C	T	6	0	6	0	0	6	0	0
7	130744576	rs12672658	C	G	0	7	7	0	0	7	0	0
7	130744665	rs7781933	C	T	8	3	11	0	0	11	0	0
7	130744700	rs10808247	G	A	3	6	9	0	0	9	0	0
7	130744738	rs10808248	A	G	4	4	8	0	0	8	0	0
7	130744925	rs10808250	T	C	4	3	7	0	0	7	0	0
7	130760559	rs78033884	A	T	33	21	54	0	1	55	0	0
7	130761017	rs4731746	C	T	21	20	41	0	0	41	0	0
7	130761235	rs10954300	G	A	7	14	21	0	0	21	0	0
7	133580447	rs2042456	G	A	35	34	69	0	0	69	0	0
7	133589145	rs6955061	C	T	2	4	6	0	0	6	0	0
7	133591071	rs10224828	G	A	3	6	9	0	0	9	0	0
7	133749889	rs3735048	C	G	88	68	156	0	0	156	0	0
7	133749964	rs3735047	G	A	91	63	154	0	1	155	0	0
7	134870613	rs140693007	C	T	33	34	67	0	1	68	0	0
7	134872968	rs2303403	T	C	24	39	63	0	2	65	0	0
7	134873038	rs74995987	G	A	27	24	51	0	0	51	0	0
7	134873925	rs117568275	T	C	15	11	26	0	0	26	0	0
7	134873964	rs292566	G	C	15	18	33	0	0	33	0	0
7	134879530	.	C	G	10	4	14	0	0	14	0	0
7	134889264	rs17233604	T	C	21	25	46	0	1	47	0	0
7	134890585	rs117058343	G	A	11	12	23	0	0	23	0	0
7	135266380	rs145234712	G	A	7	1	8	0	1	9	0	0
7	135266405	rs74876016	G	T	7	3	10	0	0	10	0	0
7	135266913	rs77566207	C	A	5	5	10	0	0	10	0	0
7	135266968	rs80160867	A	G	1	6	7	0	0	7	0	0
7	135269638	rs144217755	C	T	3	10	13	0	0	13	0	0
7	135269655	rs58392569	T	C	10	4	14	0	0	14	0	0
7	135269656	rs61459701	G	A	10	4	14	0	1	15	0	0
7	135285088	rs73725168	C	T	6	2	8	0	0	8	0	0
7	135287226	rs57263269	G	A	3	4	7	0	0	7	0	0
7	135287241	rs59843543	C	T	3	4	7	0	0	7	0	0
7	135292080	rs61734146	G	A	9	12	21	0	0	21	0	0
7	135292098	rs61734151	G	A	11	13	24	0	0	24	0	0
7	135304215	rs11550518	C	T	14	14	28	0	0	28	0	0
7	135310581	rs6973002	A	G	3	11	14	0	1	15	0	0
7	135323042	rs7800189	T	G	4	2	6	0	1	7	0	0
7	135329690	rs12540688	T	C	34	26	60	0	0	60	0	0
7	135333172	rs61740269	C	T	40	36	76	0	0	76	0	0
7	135347601	rs3800762	T	A	8	13	21	0	0	21	0	0
7	135359102	rs11538324	A	G	157	136	293	0	6	299	0	0
7	135360029	rs59400686	A	G	3	4	7	0	0	7	0	0
7	135360106	rs3110778	G	A	4	2	6	0	0	6	0	0
7	135360118	rs3110779	T	C	4	2	6	0	0	6	0	0
7	135615568	rs34466594	A	C	3	7	10	0	0	10	0	0
7	135637264	rs12531496	T	C	5	1	6	0	0	6	0	0
7	137600690	rs273957	C	T	176	124	300	0	2	302	0	0
7	137605247	rs273952	A	G	3	3	6	0	0	6	0	0
7	137611296	rs273946	G	A	6	12	18	0	0	18	0	0
7	137612571	rs273972	A	G	4	6	10	0	0	10	0	0
7	137618171	rs10224250	T	G	3	3	6	0	0	6	0	0
7	137618322	rs273980	G	A	3	3	6	0	0	6	0	0
7	137618431	rs12533090	A	T	10	6	16	0	0	16	0	0
7	137684551	rs56122646	A	G	8	19	27	0	0	27	0	0
7	137686684	.	C	A	34	99	133	0	3	136	0	0
7	138147523	rs62487613	C	A	6	2	8	0	1	9	0	0
7	138147621	rs9655908	A	T	5	5	10	0	0	10	0	0
7	138150817	rs6467775	T	C	4	3	7	0	0	7	0	0
7	138152431	rs1077772	G	T	5	9	14	0	0	14	0	0
7	138155473	rs118072617	G	C	16	22	38	0	1	39	0	0
7	138191656	rs3807156	G	A	7	2	9	0	0	9	0	0
7	138193848	rs58562866	C	T	12	5	17	0	1	18	0	0
7	138194806	rs12112459	T	A	15	6	21	0	0	21	0	0
7	138264552	rs12666310	C	G	4	3	7	0	0	7	0	0
7	138266009	rs2353354	C	A	3	3	6	0	0	6	0	0
7	138270657	rs1673203	G	A	6	2	8	0	0	8	0	0
7	138270838	rs1673204	T	C	2	5	7	0	0	7	0	0
7	138305806	rs3734944	T	C	5	1	6	0	0	6	0	0
7	138728378	rs187854085	C	T	60	25	85	0	0	85	0	0
7	138730361	rs7803490	T	C	87	96	183	0	0	183	0	0
7	138731343	rs3187141	G	A	56	52	108	0	0	108	0	0
7	138732274	rs3087999	C	G	47	49	96	0	2	98	0	0
7	138732497	rs3735007	G	A	61	52	113	0	0	113	0	0
7	138738204	rs11977775	G	A	53	43	96	0	1	97	0	0
7	138740037	rs2297236	G	C	44	33	77	0	1	78	0	0
7	138755938	rs139639981	G	A	5	4	9	0	0	9	0	0
7	138761088	rs116955781	C	T	289	277	566	0	4	570	0	0
7	138946363	rs140343844	C	T	9	15	24	0	0	24	0	0
7	138988250	rs77110946	C	G	13	6	19	0	0	19	0	0
7	138990552	rs118039860	C	T	2	4	6	0	0	6	0	0
7	139054107	rs6949890	G	A	15	7	22	0	0	22	0	0
7	139079160	rs147839767	A	G	4	4	8	0	0	8	0	0
7	139415775	rs7456421	G	C	21	24	45	0	0	45	0	0
7	139448373	rs11972982	T	C	4	3	7	0	1	8	0	0
7	139448995	rs12674180	A	G	3	4	7	0	0	7	0	0
7	139653196	rs5768	A	C	164	154	318	0	2	320	0	0
7	139662586	rs41726	T	C	22	15	37	0	0	37	0	0
7	139662643	rs41725	T	C	12	9	21	0	1	22	0	0
7	139724169	rs13760	A	G	6	22	28	0	1	29	0	0
7	139724358	rs2269996	G	A	16	32	48	0	0	48	0	0
7	139724555	rs3735352	C	T	19	29	48	0	0	48	0	0
7	139727135	rs2286196	G	A	18	23	41	0	0	41	0	0
7	139727670	rs2040969	T	C	3	4	7	0	0	7	0	0
7	139728552	rs79917840	G	C	5	6	11	0	0	11	0	0
7	139728584	rs2286195	A	C	4	4	8	0	0	8	0	0
7	139757712	rs61729681	C	A	17	17	34	0	0	34	0	0
7	140080087	rs62490396	C	G	5	9	14	0	0	14	0	0
7	140082363	rs6968618	G	A	6	2	8	0	0	8	0	0
7	140155800	rs17621014	C	T	7	3	10	0	0	10	0	0
7	140158851	rs2272095	C	G	212	205	417	0	5	422	0	0
7	140159389	rs80206917	T	C	9	11	20	0	0	20	0	0
7	140159798	rs11763850	A	G	4	5	9	0	0	9	0	0
7	140373326	rs2968558	A	G	9	9	18	0	1	19	0	0
7	140374049	rs1140034	T	C	39	17	56	0	0	56	0	0
7	140400670	rs7803697	C	G	2	11	13	0	1	14	0	0
7	140420509	rs2968546	T	C	24	37	61	0	0	61	0	0
7	140421027	rs2930323	T	C	9	4	13	0	0	13	0	0
7	140426257	rs3829814	A	G	19	18	37	0	0	37	0	0
7	141358606	rs149055232	C	T	50	49	99	0	1	100	0	0
7	141362753	rs140788982	T	C	10	5	15	0	0	15	0	0
7	141443187	.	A	G	5	7	12	0	0	12	0	0
7	142334648	rs17210	A	T	37	32	69	0	1	70	0	0
7	142334744	rs17211	C	A	57	48	105	0	0	105	0	0
7	142498735	.	A	C	93	26	119	0	0	119	0	0
7	142498738	.	C	G	100	26	126	0	0	126	0	0
7	142498833	.	A	T	122	36	158	0	2	160	0	0
7	142498837	.	C	T	123	36	159	0	0	159	0	0
7	142498897	.	A	G	90	39	129	0	0	129	0	0
7	142499071	.	T	C	131	15	146	0	2	148	0	0
7	142500409	rs11327	T	G	5	9	14	0	0	14	0	0
7	142561747	rs56087487	C	T	24	35	59	0	0	59	0	0
7	142986684	rs3181165	G	A	74	89	163	0	0	163	0	0
7	142993983	rs4647311	G	A	11	2	13	0	1	14	0	0
7	143081833	rs7787179	A	G	16	4	20	0	0	20	0	0
7	143081942	rs11772895	G	C	36	21	57	0	0	58	1	0
7	143082027	rs9640381	T	C	45	34	79	0	2	81	0	0
7	143082534	rs71552657	G	A	36	27	63	0	0	63	0	0
7	143083411	rs4725616	G	A	38	31	69	0	0	69	0	0
7	143083497	rs4726616	A	G	29	32	61	0	0	61	0	0
7	143083661	rs6464547	A	C	22	19	41	0	2	43	0	0
7	143083839	rs6464548	T	C	16	10	26	0	0	26	0	0
7	143084574	rs36107836	G	A	48	41	89	0	1	90	0	0
7	143087432	rs34824368	G	A	16	15	31	0	0	31	0	0
7	143088085	rs4859	G	A	851	581	1432	0	6	1438	0	0
7	143599197	rs3735381	G	A	18	13	31	0	1	32	0	0
7	143599247	rs3735383	A	G	9	3	12	0	0	12	0	0
7	144344228	rs4726719	C	T	6	0	6	0	1	7	0	0
7	144378851	rs41414146	T	C	5	4	9	0	0	9	0	0
7	151927025	.	A	G	33	0	33	0	0	33	0	0
7	151932908	.	T	C	40	0	40	0	0	40	0	0
7	151941664	rs62478310	G	T	7	0	7	0	0	7	0	0
7	151941798	rs2360890	G	A	14	0	14	0	0	14	0	0
7	151941917	rs4024448	T	C	6	0	6	0	0	6	0	0
7	151941919	rs4024447	G	C	6	0	6	0	0	6	0	0
7	151941955	.	C	A	6	0	6	0	0	6	0	0
7	151942061	.	G	C	6	0	6	0	0	6	0	0
7	151942108	.	C	T	7	0	7	0	0	7	0	0
7	151942182	.	A	G	11	0	11	0	0	11	0	0
7	151942190	.	A	T	10	0	10	0	0	10	0	0
7	151942201	rs2770457	A	T	8	0	8	0	0	8	0	0
7	151945007	.	C	T	62	0	62	0	0	62	0	0
7	151945140	.	C	T	68	0	68	0	2	70	0	0
7	151945167	.	G	T	63	0	63	0	0	63	0	0
7	151945204	.	G	A	61	0	61	0	0	61	0	0
7	151945334	.	T	C	57	0	57	0	0	57	0	0
7	151970856	.	T	A	38	0	38	0	0	38	0	0
7	151970931	rs56850341	G	A	50	0	50	0	1	51	0	0
7	158180251	.	C	T	4	2	6	0	0	6	0	0
8	163370	rs7844253	C	G	3	5	8	0	0	8	0	0
8	163387	rs3008286	C	T	4	9	13	0	0	13	0	0
8	163438	rs7844396	C	T	7	6	13	0	0	13	0	0
8	163550	rs7816944	A	G	8	4	12	0	0	12	0	0
8	363192	rs10090550	G	A	21	31	52	0	0	52	0	0
8	418993	rs8049	G	C	15	17	32	0	0	32	0	0
8	564957	rs715806	C	G	1	6	7	0	0	7	0	0
8	582577	rs13282859	T	C	8	0	8	0	0	8	0	0
8	582915	rs1046060	C	T	18	0	18	0	0	18	0	0
8	583130	rs6559031	T	A	21	1	22	0	0	22	0	0
8	583187	rs12547918	G	A	23	1	24	0	0	24	0	0
8	583248	rs12549884	C	T	19	1	20	0	0	20	0	0
8	583650	rs34116671	G	C	19	2	21	0	0	21	0	0
8	584598	rs1703929	T	C	5	1	6	0	0	6	0	0
8	584601	rs1703930	G	A	5	1	6	0	0	6	0	0
8	584642	rs233695	G	A	5	1	6	0	0	6	0	0
8	585060	rs11136940	C	A	5	2	7	0	0	7	0	0
8	585702	rs35544426	A	G	13	2	15	0	0	15	0	0
8	585730	rs34983919	T	G	10	1	11	0	1	12	0	0
8	585737	rs34162131	C	A	12	1	13	0	0	13	0	0
8	585869	rs35170578	A	G	12	2	14	0	0	14	0	0
8	586951	rs12542241	C	T	14	2	16	0	0	16	0	0
8	587474	rs336418	A	G	6	1	7	0	0	7	0	0
8	587498	rs1669669	C	G	9	1	10	0	0	10	0	0
8	587654	.	C	T	6	1	7	0	0	7	0	0
8	588332	rs4735893	T	G	6	0	6	0	0	6	0	0
8	590542	rs3735926	G	A	10	2	12	0	0	12	0	0
8	590816	rs906891	C	T	12	1	13	0	0	13	0	0
8	606452	rs1703937	T	A	5	1	6	0	0	6	0	0
8	617587	rs12547333	G	A	5	1	6	0	0	6	0	0
8	621658	rs75318483	C	T	3	5	8	0	0	8	0	0
8	622078	rs10103269	C	A	9	1	10	0	0	10	0	0
8	622781	rs1020566	T	C	3	3	6	0	0	6	0	0
8	622880	rs1020565	T	A	1	11	12	0	0	12	0	0
8	623593	rs55783038	G	A	79	64	143	0	7	151	1	0
8	623604	.	C	A	72	75	147	0	2	149	0	0
8	642076	rs13251790	G	A	6	0	6	0	0	6	0	0
8	642291	rs10112680	C	T	74	3	77	0	1	78	0	0
8	659533	rs3779742	C	T	5	1	6	0	0	6	0	0
8	660479	rs28455516	T	C	6	1	7	0	1	8	0	0
8	660984	.	T	A	1	5	6	0	0	6	0	0
8	665858	rs1869074	C	T	5	1	6	0	0	6	0	0
8	1499222	rs117175403	G	A	4	9	13	0	0	13	0	0
8	1616640	rs4565482	G	A	23	18	41	0	0	41	0	0
8	1616718	rs2235112	A	G	18	19	37	0	3	40	0	0
8	1626906	rs2293906	G	T	2	11	13	0	0	13	0	0
8	1626908	rs2293907	G	A	2	11	13	0	0	13	0	0
8	1627174	rs2293908	G	A	9	6	15	0	0	15	0	0
8	1627998	rs6558509	G	T	9	12	21	0	1	22	0	0
8	1630005	rs6981746	G	A	8	2	10	0	0	10	0	0
8	1630141	rs62483128	C	T	6	6	12	0	0	12	0	0
8	1630940	rs116940769	A	G	4	3	7	0	0	7	0	0
8	1649145	rs73549762	A	T	4	4	8	0	0	8	0	0
8	1709593	rs6558532	C	G	24	27	51	0	0	51	0	0
8	1710404	rs4876133	G	C	20	13	33	0	1	34	0	0
8	1710632	rs6558535	T	C	26	25	51	0	0	51	0	0
8	1710977	rs9022	A	C	89	104	193	0	1	194	0	0
8	1720364	rs113243095	A	C	5	8	13	0	0	13	0	0
8	1721090	rs4875958	G	A	7	11	18	0	0	18	0	0
8	1721352	rs113067642	A	G	10	12	22	0	0	22	0	0
8	1721643	rs7341635	G	A	8	9	17	0	0	17	0	0
8	1722322	rs56255752	C	G	9	6	15	0	0	15	0	0
8	1722323	rs55634012	T	C	8	6	14	0	1	15	0	0
8	1722495	rs55991725	T	C	2	5	7	0	0	7	0	0
8	1723749	rs10100341	A	G	4	3	7	0	0	7	0	0
8	1723896	rs56147268	T	C	7	3	10	0	0	10	0	0
8	1724052	rs7014327	G	A	10	6	16	0	0	16	0	0
8	1724307	rs7015858	C	T	3	12	15	0	0	15	0	0
8	1725004	rs13256424	G	A	4	7	11	0	0	11	0	0
8	1726809	rs10097891	C	A	8	11	19	0	0	19	0	0
8	1727437	rs74621323	T	A	3	6	9	0	0	9	0	0
8	1728292	rs12546965	T	C	6	6	12	0	0	12	0	0
8	1729514	rs1137514	A	G	6	9	15	0	2	17	0	0
8	1730228	rs112688948	T	C	43	23	66	0	2	68	0	0
8	1730694	rs78155116	A	C	59	22	81	0	1	82	0	0
8	1731502	rs111988802	A	T	16	6	22	0	0	22	0	0
8	1731855	rs10089616	C	T	10	14	24	0	0	24	0	0
8	1732125	rs112397747	G	C	13	14	27	0	0	27	0	0
8	1732224	rs10089222	G	C	6	13	19	0	0	19	0	0
8	1732407	rs55742804	C	T	12	6	18	0	0	18	0	0
8	1733055	rs118000123	C	T	15	12	27	0	0	27	0	0
8	1733124	rs117588996	G	A	7	5	12	0	0	12	0	0
8	1733528	.	G	A	4	2	6	0	0	6	0	0
8	1734452	rs3812477	C	G	6	15	21	0	0	21	0	0
8	1922093	rs111971949	C	A	8	2	10	0	0	10	0	0
8	1951747	rs115036778	G	C	34	6	40	0	0	40	0	0
8	1953223	rs1043223	C	T	13	62	75	0	0	75	0	0
8	1953485	rs17064491	T	A	55	13	68	0	0	68	0	0
8	1953536	rs142465617	C	G	48	8	56	0	0	56	0	0
8	1953567	rs1043225	C	A	7	38	45	0	1	46	0	0
8	1953620	rs114558766	G	A	56	12	68	0	0	68	0	0
8	1953759	rs1043226	A	T	22	70	92	0	2	94	0	0
8	1954464	rs17064496	G	T	45	14	59	0	0	59	0	0
8	1954587	rs4288423	G	A	7	29	36	0	2	38	0	0
8	2584602	rs4602917	G	A	0	6	6	0	0	6	0	0
8	6263326	rs2243662	C	T	4	2	6	0	0	6	0	0
8	6263816	rs2243675	G	C	4	3	7	0	0	7	0	0
8	6264130	rs2305023	G	C	2	4	6	0	0	6	0	0
8	6266693	rs1550698	C	T	5	8	13	0	0	13	0	0
8	6272399	rs2305022	G	T	95	99	194	0	0	194	0	0
8	6290206	rs2440423	T	C	4	2	6	0	0	6	0	0
8	6290228	rs2442522	A	C	4	2	6	0	0	6	0	0
8	6290914	rs2442520	A	G	4	6	10	0	0	10	0	0
8	6292370	rs17609194	G	A	4	3	7	0	0	7	0	0
8	6292473	rs6559162	A	G	4	4	8	0	0	8	0	0
8	6299532	rs2053618	A	G	3	4	7	0	0	7	0	0
8	6302154	rs2083914	G	T	129	95	224	0	2	226	0	0
8	6302183	rs930557	G	C	115	135	250	0	0	250	0	0
8	6303409	rs2916750	T	G	80	57	137	0	0	137	0	0
8	6303434	rs2515570	T	A	45	64	109	0	1	110	0	0
8	6303511	rs1054073	T	A	21	13	34	0	0	34	0	0
8	6303614	rs1054074	A	C	9	7	16	0	0	16	0	0
8	6303859	rs2440415	C	T	59	40	99	0	0	99	0	0
8	6304185	rs2916749	T	G	8	11	19	0	0	19	0	0
8	6304259	rs2515571	G	A	21	19	40	0	2	42	0	0
8	6304348	rs2166006	C	T	38	31	69	0	1	70	0	0
8	6304693	rs79143742	T	A	61	66	127	0	3	130	0	0
8	6304694	rs1129703	A	G	66	62	128	0	3	131	0	0
8	6304730	rs1129704	A	C	73	69	142	0	0	142	0	0
8	6304814	rs1129706	A	G	77	69	146	0	2	148	0	0
8	6304848	rs17076930	T	C	45	61	106	0	1	107	0	0
8	6313900	rs3020275	A	G	1	5	6	0	0	6	0	0
8	6314333	rs2440408	C	T	4	2	6	0	0	6	0	0
8	6315292	rs74607633	A	T	5	5	10	0	0	10	0	0
8	6315347	rs2979647	G	C	5	6	11	0	0	11	0	0
8	6315448	rs2979648	T	C	3	6	9	0	0	9	0	0
8	6315900	rs2515579	G	A	9	0	9	0	0	9	0	0
8	6338306	rs12674488	C	A	34	45	79	0	1	80	0	0
8	6338664	rs12677501	T	G	17	9	26	0	0	26	0	0
8	6478986	rs2912010	C	T	39	13	52	0	0	52	0	0
8	6479042	rs1057090	C	T	25	11	36	0	0	36	0	0
8	6479178	rs2912016	C	A	28	7	35	0	0	35	0	0
8	6483482	rs2912057	C	T	5	3	8	0	1	9	0	0
8	6500544	rs1057091	C	T	13	12	25	0	1	26	0	0
8	6500751	rs2433149	C	G	20	10	30	0	0	30	0	0
8	6501378	rs11994063	G	A	8	10	18	0	0	18	0	0
8	6502152	rs2433150	G	A	5	2	7	0	0	7	0	0
8	6503870	rs7838511	A	G	3	7	10	0	0	10	0	0
8	6505705	rs1055749	A	T	4	5	9	0	0	9	0	0
8	6604618	rs74390307	A	G	4	6	10	0	0	10	0	0
8	8101641	rs10092295	T	C	5	12	17	0	0	17	0	0
8	8193785	rs2976963	T	G	9	4	13	0	0	13	0	0
8	8196189	rs2980491	T	C	14	7	21	0	0	21	0	0
8	8234113	rs2921005	G	A	9	7	16	0	0	16	0	0
8	8235523	rs55993234	G	A	7	9	16	0	0	16	0	0
8	8641145	rs2428	C	T	29	29	58	0	3	61	0	0
8	8642480	rs4841038	G	A	19	6	25	0	0	25	0	0
8	8748877	.	G	C	9	12	21	0	1	22	0	0
8	8862521	rs6987558	G	C	5	1	6	0	0	6	0	0
8	8866661	rs9329175	G	A	3	5	8	0	0	8	0	0
8	8867411	rs2915251	G	C	6	1	7	0	0	7	0	0
8	8867471	rs17701980	C	T	5	4	9	0	0	9	0	0
8	8867523	rs76904717	G	A	5	2	7	0	0	7	0	0
8	8869199	rs9650616	T	G	15	28	43	0	0	43	0	0
8	8890041	rs1045527	A	G	7	9	16	0	0	16	0	0
8	8890098	rs1045529	C	T	16	11	27	0	0	27	0	0
8	8890802	rs6748	C	T	6	0	6	0	0	6	0	0
8	8994512	rs9949	A	G	50	44	94	0	1	95	0	0
8	8994936	rs12785	A	T	131	124	255	0	3	258	0	0
8	8995166	rs330908	A	G	167	192	359	0	1	360	0	0
8	8995387	rs330909	A	G	156	136	292	0	1	294	1	0
8	8995755	rs330910	T	A	151	144	295	0	1	296	0	0
8	8996273	rs330911	C	T	65	75	140	0	2	142	0	0
8	8996294	rs330912	C	T	47	71	118	0	12	130	0	0
8	8996490	rs330913	G	A	133	134	267	0	1	268	0	0
8	8996695	rs330914	A	G	69	84	153	0	0	153	0	0
8	8997344	rs149993245	C	A	103	77	180	0	0	180	0	0
8	8999187	rs330924	G	C	33	4	37	0	0	37	0	0
8	9000941	rs330925	G	A	20	2	22	0	0	22	0	0
8	9000965	rs330926	C	A	16	2	18	0	0	18	0	0
8	9002233	rs76545655	A	T	3	10	13	0	0	13	0	0
8	9002248	rs330927	T	C	18	3	21	0	0	21	0	0
8	9002545	rs330928	T	C	11	0	11	0	0	11	0	0
8	9007273	rs330929	C	A	26	7	33	0	0	33	0	0
8	9414049	rs33945943	G	A	45	49	94	0	0	94	0	0
8	9519123	rs192946350	C	T	4	2	6	0	0	6	0	0
8	9543080	rs12679180	G	A	5	1	6	0	0	6	0	0
8	9543632	rs13260526	G	A	8	3	11	0	1	12	0	0
8	9543651	rs13270801	A	T	9	4	13	0	0	13	0	0
8	9543878	rs75465360	G	A	5	4	9	0	0	9	0	0
8	9544549	rs4535744	G	C	9	6	15	0	0	15	0	0
8	9544786	rs11249938	A	G	7	4	11	0	0	11	0	0
8	9545167	rs11776236	T	C	40	18	58	0	0	58	0	0
8	9545368	rs7003791	T	C	23	9	32	0	0	32	0	0
8	9545542	rs10081565	C	T	41	14	55	0	1	56	0	0
8	9545570	rs10081478	T	G	34	9	43	0	1	44	0	0
8	9564437	rs7006985	A	G	12	21	33	0	0	33	0	0
8	9564485	rs33944167	G	A	22	14	36	0	0	36	0	0
8	9567700	rs35052906	C	A	28	18	46	0	0	46	0	0
8	9627791	rs35420737	A	G	5	2	7	0	0	7	0	0
8	9630145	rs78665383	A	C	18	10	28	0	0	28	0	0
8	9634874	rs7010154	T	C	9	7	16	0	1	17	0	0
8	9634944	rs74384847	A	G	14	13	27	0	0	27	0	0
8	9638308	rs4841215	C	T	6	3	9	0	0	9	0	0
8	10006664	rs4840464	T	A	6	3	9	0	0	9	0	0
8	10691034	rs66844016	A	G	0	6	6	0	0	6	0	0
8	10691073	rs67211633	G	C	0	6	6	0	0	6	0	0
8	10692158	rs2271355	C	T	5	5	10	0	0	10	0	0
8	11156120	rs4410870	G	C	0	6	6	0	0	6	0	0
8	11180608	rs1036383	C	G	12	17	29	0	1	30	0	0
8	11182183	rs2736261	C	A	14	11	25	0	1	26	0	0
8	11182334	rs12545783	C	G	22	13	35	0	0	35	0	0
8	11183075	rs2736262	A	G	2	5	7	0	0	7	0	0
8	11183704	rs2572401	A	C	7	10	17	0	0	17	0	0
8	11184862	rs61762306	G	A	10	7	17	0	0	17	0	0
8	11352056	rs2250788	A	G	4	3	7	0	0	7	0	0
8	11405576	rs55758736	G	A	9	2	11	0	0	11	0	0
8	11406593	rs3816668	T	C	4	4	8	0	0	8	0	0
8	11416171	rs7011778	T	C	2	4	6	0	0	6	0	0
8	11416885	rs4841559	C	T	3	3	6	0	0	6	0	0
8	11416897	.	C	G	3	3	6	0	0	6	0	0
8	11416905	.	G	C	3	5	8	0	0	8	0	0
8	11421709	rs14053	G	C	7	6	13	0	0	13	0	0
8	11421955	rs1042695	T	G	4	7	11	0	0	11	0	0
8	11637276	rs8191613	G	A	13	11	24	0	0	24	0	0
8	11638823	rs8191617	C	T	5	1	6	0	1	7	0	0
8	11638988	rs8191618	T	C	3	4	7	0	0	7	0	0
8	11643553	rs8191664	G	T	20	22	42	0	0	42	0	0
8	11643803	rs1534862	C	T	16	22	38	0	0	38	0	0
8	11644647	rs2740438	T	G	22	13	35	0	0	35	0	0
8	11644648	rs2740439	C	G	19	13	32	0	2	34	0	0
8	11653155	rs7824202	C	T	0	7	7	0	0	7	0	0
8	11653292	rs2686186	G	A	1	15	16	0	0	16	0	0
8	11653334	rs7823420	G	C	1	18	19	0	0	19	0	0
8	11665704	rs1293301	C	T	22	11	33	0	0	33	0	0
8	11677644	rs7839083	A	C	17	4	21	0	0	21	0	0
8	11680535	rs10097887	C	T	8	9	17	0	1	18	0	0
8	11681825	rs17756892	C	T	2	10	12	0	0	12	0	0
8	11681838	rs17149412	T	C	3	12	15	0	0	15	0	0
8	11682267	rs34015932	C	T	6	7	13	0	0	13	0	0
8	11682448	rs2686202	C	G	7	2	9	0	0	9	0	0
8	11682476	rs2740591	T	C	7	3	10	0	1	11	0	0
8	11682566	rs2645427	C	A	7	3	10	0	1	11	0	0
8	11682771	rs2645426	G	C	7	7	14	0	0	14	0	0
8	11683818	rs2294136	T	C	5	1	6	0	0	6	0	0
8	11684071	rs35383383	C	A	5	5	10	0	0	10	0	0
8	11684403	rs962366	G	A	5	9	14	0	0	14	0	0
8	11684463	rs2645424	A	G	8	8	16	0	0	16	0	0
8	11685342	rs1692799	A	G	8	6	14	0	0	14	0	0
8	11685409	rs1692798	C	A	8	6	14	0	0	14	0	0
8	11685536	rs2409835	C	T	4	15	19	0	0	19	0	0
8	11685744	rs35787968	C	T	13	8	21	0	0	21	0	0
8	11685809	rs59697975	C	G	13	7	20	0	0	20	0	0
8	11685981	rs7009302	C	G	6	7	13	0	0	13	0	0
8	11686419	rs2686204	A	G	3	3	6	0	0	6	0	0
8	11686835	rs1123141	G	C	3	3	6	0	0	6	0	0
8	11687518	rs3779662	G	A	2	5	7	0	0	7	0	0
8	11687959	rs2294137	C	T	6	7	13	0	0	13	0	0
8	11688485	rs1298295	A	C	8	8	16	0	0	16	0	0
8	11689119	rs9205	G	C	411	463	874	0	7	881	0	0
8	11689763	rs34120986	G	A	6	17	23	0	1	24	0	0
8	11690170	rs76237518	C	T	19	10	29	0	1	30	0	0
8	11690422	rs1293315	G	A	7	21	28	0	0	28	0	0
8	11691310	rs1293318	T	G	13	12	25	0	0	25	0	0
8	11691393	rs61452742	C	T	7	8	15	0	0	15	0	0
8	11692128	rs17757392	T	C	11	16	27	0	0	27	0	0
8	11693048	rs3735809	A	G	10	17	27	0	1	28	0	0
8	11693171	.	A	C	10	13	23	0	0	23	0	0
8	11700705	rs148669985	C	T	85	62	147	0	4	151	0	0
8	11701278	rs2645425	G	A	41	41	82	0	1	83	0	0
8	11701288	.	C	T	45	31	76	0	1	77	0	0
8	11702122	rs1065712	G	C	566	551	1117	0	20	1138	1	0
8	11707800	rs2645419	T	C	3	3	6	0	0	6	0	0
8	11722877	rs113448138	C	G	20	11	31	0	1	32	0	0
8	12282174	.	G	A	4	3	7	0	0	7	0	0
8	12580292	rs3802267	C	G	44	55	99	0	2	101	0	0
8	12581780	rs117655621	G	C	6	4	10	0	0	10	0	0
8	12602541	rs4831784	G	C	6	5	11	0	0	11	0	0
8	12602644	rs78406573	C	T	4	5	9	0	0	9	0	0
8	12603189	rs6985289	C	G	4	3	7	0	0	7	0	0
8	12604051	rs7832448	T	C	3	5	8	0	0	8	0	0
8	12604409	rs9325792	C	G	5	4	9	0	0	9	0	0
8	12606760	rs4437649	T	C	3	4	7	0	0	7	0	0
8	12610630	rs117359211	T	C	8	9	17	0	0	17	0	0
8	12610776	rs6530970	T	C	12	6	18	0	1	19	0	0
8	12610812	rs76940926	C	T	7	10	17	0	0	17	0	0
8	12613515	rs3802271	T	G	8	5	13	0	0	13	0	0
8	17079358	rs3750249	A	G	28	27	55	0	0	55	0	0
8	17081010	rs2285268	A	G	7	3	10	0	0	10	0	0
8	17086990	rs6837	C	T	157	153	310	0	2	312	0	0
8	17087420	rs113540305	A	C	102	105	207	0	2	209	0	0
8	17089564	rs2904696	T	C	34	31	65	0	0	65	0	0
8	17090968	rs7828439	G	A	7	3	10	0	0	10	0	0
8	17098564	rs971574	G	C	2	4	6	0	0	6	0	0
8	17125768	rs11555738	T	C	53	32	85	0	0	85	0	0
8	17142065	rs2285269	C	T	77	85	162	0	0	162	0	0
8	17144020	rs3793428	C	A	9	6	15	0	0	15	0	0
8	17145484	rs9325807	G	A	3	3	6	0	0	6	0	0
8	17146298	rs28787950	A	G	6	1	7	0	0	7	0	0
8	17148509	rs7011061	G	A	3	3	6	0	0	6	0	0
8	17149429	rs10096891	A	G	8	6	14	0	0	14	0	0
8	17151670	rs11774813	G	A	9	3	12	0	0	12	0	0
8	17152369	rs145897040	G	C	10	8	18	0	0	18	0	0
8	17156293	rs2246121	G	C	8	7	15	0	0	15	0	0
8	17156298	rs2285271	A	G	7	8	15	0	0	15	0	0
8	17156904	rs6981281	T	C	8	11	19	0	0	19	0	0
8	17158312	rs4921744	T	G	7	2	9	0	0	9	0	0
8	17161244	rs7816975	G	A	4	2	6	0	0	6	0	0
8	17161501	rs7837869	A	T	2	7	9	0	0	9	0	0
8	17164074	rs11779713	T	C	4	4	8	0	0	8	0	0
8	17796382	rs412750	A	G	68	56	124	0	2	126	0	0
8	17796383	rs454755	C	T	69	57	126	0	0	126	0	0
8	17798515	rs7843729	C	G	3	3	6	0	0	6	0	0
8	17814425	rs13253463	A	G	6	6	12	0	0	12	0	0
8	17814915	rs208753	A	G	61	56	117	0	1	118	0	0
8	17815705	rs4570198	G	A	3	3	6	0	0	6	0	0
8	17815823	rs6997328	A	G	5	5	10	0	1	11	0	0
8	17817553	rs17635381	G	T	75	70	145	0	0	145	0	0
8	17820714	rs6991775	A	T	50	52	102	0	2	104	0	0
8	17825327	rs208053	G	A	7	3	10	0	0	10	0	0
8	17825559	rs208052	G	C	5	10	15	0	1	16	0	0
8	17826196	rs6989255	T	C	6	0	6	0	0	6	0	0
8	17826543	rs2285307	G	A	5	1	6	0	0	6	0	0
8	17835315	rs3824320	G	A	5	5	10	0	0	10	0	0
8	17844201	rs373886	T	C	15	10	25	0	0	25	0	0
8	17844353	rs17126060	T	C	8	10	18	0	0	18	0	0
8	17844370	rs17635520	A	G	7	13	20	0	0	20	0	0
8	17854779	rs35935919	C	A	12	8	20	0	0	20	0	0
8	17855983	rs28839855	T	C	9	6	15	0	0	15	0	0
8	17856014	rs11780813	T	C	12	7	19	0	0	19	0	0
8	17857348	rs13266666	T	C	10	4	14	0	0	14	0	0
8	17857416	rs13256296	G	C	11	7	18	0	0	18	0	0
8	17857937	rs7829650	T	C	6	6	12	0	0	12	0	0
8	17858297	rs34975555	G	C	17	8	25	0	0	25	0	0
8	17860863	rs12056629	T	C	17	17	34	0	0	34	0	0
8	17860966	rs3898982	T	G	24	30	54	0	1	55	0	0
8	17864985	rs376771	G	A	13	5	18	0	0	18	0	0
8	17865696	rs383297	C	T	23	18	41	0	1	42	0	0
8	17866649	rs378443	T	A	3	11	14	0	0	14	0	0
8	17869835	rs433387	T	C	6	9	15	0	0	15	0	0
8	17876833	rs2427741	G	T	2	4	6	0	0	6	0	0
8	17877824	rs2237852	G	A	3	6	9	0	0	9	0	0
8	17877880	rs2237853	G	A	6	1	7	0	0	7	0	0
8	17878155	rs208026	A	G	4	4	8	0	0	8	0	0
8	17878170	rs208025	A	G	3	4	7	0	0	7	0	0
8	17878727	rs208024	T	C	3	4	7	0	0	7	0	0
8	17879028	rs208022	T	G	2	4	6	0	0	6	0	0
8	17879392	rs208021	A	C	7	9	16	0	0	16	0	0
8	17880243	rs2283113	C	A	5	6	11	0	0	11	0	0
8	17881835	rs379066	T	C	3	3	6	0	0	6	0	0
8	17882304	rs410445	C	T	6	3	9	0	0	9	0	0
8	17882483	rs2299603	C	T	7	5	12	0	0	12	0	0
8	17885406	rs10283	C	G	8	8	16	0	1	17	0	0
8	17913940	rs28393365	G	A	4	3	7	0	0	7	0	0
8	17913970	rs7508	G	A	16	6	22	0	0	22	0	0
8	17914305	rs6769	G	C	122	137	259	0	4	263	0	0
8	17914314	rs6770	A	G	130	148	278	0	2	280	0	0
8	17914356	rs6771	G	C	119	128	247	0	2	249	0	0
8	17914919	rs417661	A	T	142	180	322	0	5	327	0	0
8	17915620	rs413531	C	A	1	7	8	0	0	8	0	0
8	17915621	rs431719	A	C	1	7	8	0	0	8	0	0
8	17918986	rs17515291	A	G	7	9	16	0	1	17	0	0
8	17919470	rs17692671	A	C	5	3	8	0	0	8	0	0
8	17920337	rs7387912	C	T	10	7	17	0	0	17	0	0
8	17920359	rs7387916	C	A	6	5	11	0	1	12	0	0
8	17920361	rs7386629	A	G	7	4	11	0	1	12	0	0
8	17920567	rs7387930	C	T	11	2	13	0	0	13	0	0
8	17920623	rs6586683	C	T	12	3	15	0	0	15	0	0
8	17920940	rs77933176	G	A	11	14	25	0	0	25	0	0
8	17921230	rs13280	G	A	19	20	39	0	0	39	0	0
8	17921666	rs2073572	C	T	14	19	33	0	0	33	0	0
8	17921673	rs2073573	G	T	14	16	30	0	0	30	0	0
8	17921810	rs4921565	G	C	3	13	16	0	0	16	0	0
8	17921921	rs2073574	T	C	4	4	8	0	0	8	0	0
8	17922396	rs7834136	T	C	8	20	28	0	1	29	0	0
8	17922414	rs7830490	A	G	7	18	25	0	0	25	0	0
8	17922885	rs4288422	G	T	5	2	7	0	0	7	0	0
8	17923142	rs2410446	G	A	4	2	6	0	0	6	0	0
8	17923147	rs2410447	T	C	4	2	6	0	0	6	0	0
8	17923421	rs28479568	A	G	2	5	7	0	0	7	0	0
8	17923499	rs12541181	C	G	3	7	10	0	0	10	0	0
8	17924645	.	G	T	141	60	201	0	6	207	0	0
8	17925151	rs12155668	C	T	5	7	12	0	1	13	0	0
8	17925155	rs12155885	A	G	5	8	13	0	0	13	0	0
8	17925331	rs6586684	A	G	6	2	8	0	0	8	0	0
8	17925986	rs2299606	C	A	5	9	14	0	0	14	0	0
8	17926081	rs62497632	C	A	3	3	6	0	0	6	0	0
8	17926357	rs13278381	G	A	4	6	10	0	0	10	0	0
8	17926790	rs12548139	G	A	7	5	12	0	0	12	0	0
8	17927006	rs4921832	A	G	4	3	7	0	0	7	0	0
8	17927327	rs1049874	T	C	331	393	724	0	6	730	0	0
8	17928811	rs1071645	C	T	295	335	630	0	4	634	0	0
8	17928920	rs12547845	T	C	4	2	6	0	0	6	0	0
8	17928999	rs12549594	G	A	5	1	6	0	0	6	0	0
8	17929404	rs966118	C	T	3	3	6	0	0	6	0	0
8	17929475	rs7460992	C	T	5	2	7	0	0	7	0	0
8	17929522	rs11779147	T	C	6	2	8	0	0	8	0	0
8	17929698	rs7460890	G	T	4	5	9	0	0	9	0	0
8	17930354	rs7388380	A	C	4	6	10	0	0	10	0	0
8	17930435	rs7387072	C	T	3	4	7	0	0	7	0	0
8	17930605	rs6586686	A	C	3	3	6	0	0	6	0	0
8	17930772	rs3753115	C	T	27	10	37	0	0	37	0	0
8	17930999	rs3753116	A	G	7	1	8	0	0	8	0	0
8	17931091	rs3753117	C	T	4	5	9	0	0	9	0	0
8	17931117	rs35573135	C	T	4	5	9	0	0	9	0	0
8	17935642	rs7833836	A	C	3	4	7	0	0	7	0	0
8	17935951	rs7460605	G	A	6	0	6	0	0	6	0	0
8	18385056	rs9741	A	G	12	15	27	0	0	27	0	0
8	18385221	rs3087875	T	A	26	27	53	0	0	53	0	0
8	18386236	rs3739399	G	A	47	53	100	0	0	100	0	0
8	18386237	rs3739398	C	T	48	52	100	0	0	100	0	0
8	18387374	rs13275817	A	G	27	23	50	0	1	51	0	0
8	18388177	rs3758144	T	G	15	18	33	0	0	33	0	0
8	18388254	rs8695	G	A	25	19	44	0	1	45	0	0
8	18390691	rs901933	T	G	39	30	69	0	1	70	0	0
8	18391332	rs901935	T	C	33	25	58	0	0	58	0	0
8	18448570	rs4457370	A	G	6	0	6	0	0	6	0	0
8	18448771	rs2035685	G	A	4	8	12	0	1	13	0	0
8	18621009	rs79673068	C	T	6	2	8	0	0	8	0	0
8	18657247	.	G	A	5	4	9	0	0	9	0	0
8	18657953	rs2632850	C	T	6	2	8	0	0	8	0	0
8	18659269	rs2638625	C	T	7	1	8	0	0	8	0	0
8	18659324	rs2638626	T	C	9	0	9	0	0	9	0	0
8	18659422	rs11994526	T	C	10	1	11	0	0	11	0	0
8	18659475	rs2469947	T	A	5	2	7	0	0	7	0	0
8	18729817	rs7016219	G	A	51	53	104	0	0	104	0	0
8	18729818	rs7003060	T	G	49	53	102	0	1	103	0	0
8	19263003	rs3802330	G	A	19	21	40	0	0	40	0	0
8	19295831	rs11985575	A	G	7	2	9	0	0	9	0	0
8	19363484	.	G	A	12	12	24	0	0	24	0	0
8	19457330	rs60426542	A	C	3	4	7	0	0	7	0	0
8	19459325	rs28558562	G	C	28	12	40	0	0	40	0	0
8	20070941	rs150337939	C	T	61	80	141	0	1	142	0	0
8	21767275	rs2242240	C	G	44	41	85	0	0	85	0	0
8	21770372	rs4872083	C	T	14	14	28	0	0	28	0	0
8	21905772	rs3176304	G	C	6	5	11	0	0	11	0	0
8	21952226	rs1456	T	C	4	5	9	0	0	9	0	0
8	21955116	rs11352	C	T	18	28	46	0	0	46	0	0
8	21956108	rs35497596	A	G	19	23	42	0	0	42	0	0
8	21961834	rs7490	G	A	29	20	49	0	2	51	0	0
8	21964561	rs1005900	A	G	15	3	18	0	0	18	0	0
8	21965113	rs3739435	T	C	7	2	9	0	0	9	0	0
8	21997738	rs35574275	A	T	52	61	113	0	1	114	0	0
8	22059323	rs61729094	C	T	29	17	46	0	1	47	0	0
8	22067022	rs77242743	C	A	26	20	46	0	0	46	0	0
8	22108347	rs2645	C	T	22	40	62	0	0	62	0	0
8	22108611	rs9173	A	C	27	25	52	0	0	52	0	0
8	22278781	rs1051638	G	A	5	5	10	0	0	10	0	0
8	22279863	rs1051708	A	C	11	7	18	0	0	18	0	0
8	22298627	rs2272081	C	T	2	7	9	0	0	9	0	0
8	22298657	rs1049437	C	A	2	10	12	0	0	12	0	0
8	22430238	rs2469766	G	C	4	7	11	0	0	11	0	0
8	22432377	rs710098	C	A	236	199	435	0	23	458	0	0
8	22436681	rs11545016	C	T	8	5	13	0	0	13	0	0
8	22442661	rs2294047	A	G	66	62	128	0	3	131	0	0
8	22451688	rs3064	G	C	62	63	125	0	0	126	1	0
8	22462755	rs11777808	A	C	10	9	19	0	0	19	0	0
8	22462852	rs11778693	T	C	11	11	22	0	0	22	0	0
8	22463623	rs7843828	C	T	92	62	154	0	0	154	0	0
8	22464064	rs2291232	T	C	5	1	6	0	0	6	0	0
8	22466488	rs11136092	T	G	7	7	14	0	1	15	0	0
8	22466541	rs7843616	T	C	10	9	19	0	0	19	0	0
8	22466784	rs77062779	C	G	11	6	17	0	0	17	0	0
8	22467760	rs13271626	C	G	9	11	20	0	1	21	0	0
8	22467870	rs6986550	T	A	17	13	30	0	0	30	0	0
8	22469492	rs55776566	T	C	12	13	25	0	2	27	0	0
8	22470308	rs2306518	A	G	9	18	27	0	0	27	0	0
8	22470710	rs1871902	G	A	25	24	49	0	1	50	0	0
8	22471147	rs720745	G	T	31	37	68	0	0	68	0	0
8	22471399	rs720746	T	C	24	21	45	0	0	45	0	0
8	22471824	rs3736147	G	A	130	67	197	0	1	198	0	0
8	22472051	rs17060939	G	A	41	35	76	0	0	76	0	0
8	22473158	rs11781149	C	T	4	5	9	0	0	9	0	0
8	22473465	rs7843128	T	C	4	2	6	0	0	6	0	0
8	22475627	rs751680	G	A	10	6	16	0	0	16	0	0
8	22475657	rs57594397	T	C	8	6	14	0	0	14	0	0
8	22477227	.	G	A	84	94	178	0	1	179	0	0
8	22477585	rs1869	C	T	145	173	318	0	1	319	0	0
8	22477778	rs1059592	G	A	187	114	301	0	2	303	0	0
8	22477807	rs1545837	T	C	193	132	325	0	0	325	0	0
8	22480519	rs11780207	G	A	3	5	8	0	1	9	0	0
8	22481449	rs1871900	A	G	96	87	183	0	1	184	0	0
8	22482799	rs876714	A	G	24	21	45	0	0	45	0	0
8	22483836	rs878051	T	C	5	8	13	0	0	13	0	0
8	22483849	rs878053	T	C	7	12	19	0	2	21	0	0
8	22484268	rs10099266	G	C	4	15	19	0	0	19	0	0
8	22484296	rs10110443	C	G	3	12	15	0	0	15	0	0
8	22484949	rs2404654	T	C	8	8	16	0	0	16	0	0
8	22485258	rs900267	T	C	8	8	16	0	0	16	0	0
8	22485295	rs900266	A	T	11	9	20	0	0	20	0	0
8	22485375	rs7830206	C	T	8	6	14	0	0	14	0	0
8	22485934	rs10113779	G	C	7	13	20	0	0	20	0	0
8	22486612	rs11785031	A	G	8	12	20	0	0	20	0	0
8	22486951	rs3758042	T	C	3	8	11	0	0	11	0	0
8	22486987	rs3758041	A	G	2	6	8	0	0	8	0	0
8	22488750	rs13269603	C	T	3	4	7	0	0	7	0	0
8	22489089	rs146165232	C	T	6	11	17	0	0	17	0	0
8	22491397	rs1809452	G	A	12	9	21	0	0	21	0	0
8	22491622	rs35952885	T	G	5	7	12	0	1	13	0	0
8	22491880	rs17088488	A	G	4	8	12	0	0	12	0	0
8	22492103	rs6558173	G	T	7	6	13	0	0	13	0	0
8	22492143	rs7838146	C	T	8	8	16	0	0	16	0	0
8	22492708	rs4872525	C	A	5	2	7	0	0	7	0	0
8	22492828	rs77486104	G	A	9	3	12	0	0	12	0	0
8	22493124	rs11776549	C	T	5	1	6	0	0	6	0	0
8	22495966	rs4872526	T	C	5	2	7	0	0	7	0	0
8	22496048	rs4872527	G	A	1	5	6	0	0	6	0	0
8	22547052	rs11136094	G	A	6	6	12	0	0	12	0	0
8	22880162	rs1047275	G	C	48	42	90	0	0	90	0	0
8	22885153	rs2293402	G	A	13	5	18	0	0	18	0	0
8	22885154	rs1105945	G	A	13	5	18	0	0	18	0	0
8	22887608	rs4460370	G	A	5	4	9	0	0	9	0	0
8	22900701	rs1047266	G	A	39	33	72	0	0	72	0	0
8	22993760	rs80325473	C	T	29	33	62	0	0	62	0	0
8	23049292	rs2230229	C	T	7	10	17	0	0	17	0	0
8	23103873	rs4563894	G	A	5	3	8	0	0	8	0	0
8	23103911	rs4581062	T	A	4	2	6	0	0	6	0	0
8	23118443	rs12155720	C	T	16	5	21	0	1	22	0	0
8	23152117	rs112448720	G	A	4	12	16	0	0	16	0	0
8	23288346	rs61744075	C	A	19	23	42	0	0	42	0	0
8	23289901	rs1061293	G	A	24	17	41	0	0	41	0	0
8	23290080	rs1138445	C	T	18	7	25	0	0	25	0	0
8	23291244	rs12549539	G	A	6	1	7	0	0	7	0	0
8	23291835	rs1142283	T	C	22	17	39	0	2	41	0	0
8	23295026	rs4571739	C	T	3	4	7	0	0	7	0	0
8	23296826	rs17089262	C	G	5	1	6	0	0	6	0	0
8	25053092	rs73556394	T	C	5	1	6	0	0	6	0	0
8	25054726	rs2320887	G	A	3	3	6	0	0	6	0	0
8	25159885	rs907157	G	A	27	29	56	0	0	56	0	0
8	25222165	rs2271111	A	G	19	24	43	0	0	43	0	0
8	25227689	.	C	T	3	3	6	0	0	6	0	0
8	25230168	rs2271108	C	T	17	28	45	0	0	45	0	0
8	25240437	rs11779690	A	G	7	2	9	0	0	9	0	0
8	25270116	rs73218199	A	G	54	60	114	0	2	116	0	0
8	25281329	rs17790824	A	G	7	5	12	0	0	12	0	0
8	26169423	rs73215699	G	A	3	4	7	0	0	7	0	0
8	26170621	rs34469936	C	T	3	4	7	0	0	7	0	0
8	26171145	rs56147604	A	G	3	3	6	0	0	6	0	0
8	26172277	rs75610662	G	A	4	6	10	0	0	10	0	0
8	26176292	rs77033143	T	A	15	11	26	0	0	26	0	0
8	26178438	rs17174717	A	G	14	17	31	0	1	32	0	0
8	26180541	rs75667440	G	A	19	37	56	0	0	56	0	0
8	26207791	.	G	A	4	9	13	0	0	13	0	0
8	26209954	rs73217720	T	G	7	4	11	0	0	11	0	0
8	26210178	rs2046223	A	G	4	7	11	0	0	11	0	0
8	26220442	rs17309592	A	G	2	5	7	0	0	7	0	0
8	26220600	rs17309613	T	C	7	10	17	0	0	17	0	0
8	26220923	rs114304086	T	G	8	8	16	0	0	16	0	0
8	26223857	rs34109536	C	T	89	57	146	0	1	147	0	0
8	26225608	rs76202302	C	T	4	2	6	0	0	6	0	0
8	26225612	rs17055172	G	A	4	2	6	0	0	6	0	0
8	26240646	rs1055479	A	G	72	83	155	0	0	155	0	0
8	26246761	rs117276527	C	A	7	5	12	0	0	12	0	0
8	26250047	rs3808581	G	A	8	8	16	0	0	16	0	0
8	26250906	rs3779916	C	A	8	11	19	0	0	19	0	0
8	26257692	rs200644633	T	C	4	2	6	0	0	6	0	0
8	26260584	rs77740335	A	G	1	8	9	0	0	9	0	0
8	26264624	rs141228204	C	T	2	4	6	0	0	6	0	0
8	26266345	rs147506820	G	A	12	8	20	0	1	21	0	0
8	26269032	rs17310286	C	T	105	141	246	0	2	248	0	0
8	26269191	rs1042992	C	T	110	108	218	0	0	218	0	0
8	26269412	rs12165	C	T	64	44	108	0	2	110	0	0
8	26514293	rs1058332	G	A	4	5	9	0	0	9	0	0
8	26514316	rs11863	C	T	3	5	8	0	0	8	0	0
8	26515458	rs17666	T	C	9	11	20	0	1	21	0	0
8	27144732	rs4279551	C	G	4	5	9	0	0	9	0	0
8	27184341	rs2322720	C	T	3	4	7	0	0	7	0	0
8	27293865	rs7005936	C	T	216	134	350	0	5	355	0	0
8	27297202	rs11995441	T	C	25	18	43	0	0	43	0	0
8	27297594	rs2241655	G	A	17	17	34	0	0	34	0	0
8	27297625	rs2241656	G	C	19	18	37	0	0	37	0	0
8	27299087	rs10091396	C	A	16	12	28	0	0	28	0	0
8	27299411	rs3736527	A	T	19	17	36	0	1	37	0	0
8	27299469	rs3736526	A	G	15	19	34	0	1	35	0	0
8	27299553	rs3736525	C	T	13	23	36	0	1	37	0	0
8	27299653	rs3736524	G	C	10	5	15	0	0	15	0	0
8	27299935	rs9657294	A	G	19	13	32	0	0	32	0	0
8	27300088	rs2241659	T	C	24	16	40	0	1	41	0	0
8	27300121	rs2241660	A	G	17	14	31	0	0	31	0	0
8	27301160	rs10113756	A	G	4	2	6	0	0	6	0	0
8	27301491	rs1991570	A	G	4	4	8	0	0	8	0	0
8	27302433	rs9657295	G	A	46	41	87	0	0	87	0	0
8	27302885	rs4733063	A	G	25	28	53	0	0	53	0	0
8	27303015	rs11135993	T	C	52	47	99	0	1	100	0	0
8	27306103	rs10098202	C	T	14	8	22	0	0	22	0	0
8	27306159	rs11776693	G	A	15	17	32	0	0	32	0	0
8	27306551	rs7000364	T	A	21	21	42	0	0	42	0	0
8	27307072	rs1019832	G	A	22	34	56	0	1	57	0	0
8	27307275	rs7846626	G	C	28	19	47	0	0	47	0	0
8	27307522	rs7831523	A	G	6	11	17	0	1	18	0	0
8	27308004	rs4733065	G	A	26	29	55	0	0	55	0	0
8	27308585	rs751019	A	C	241	275	516	0	2	518	0	0
8	27308961	rs2278319	C	T	6	1	7	0	0	7	0	0
8	27309339	rs1106359	T	C	9	12	21	0	0	21	0	0
8	27312040	rs10093964	C	T	13	11	24	0	0	24	0	0
8	27312687	rs752994	T	A	4	2	6	0	0	6	0	0
8	27313085	rs919494	G	T	4	2	6	0	0	6	0	0
8	27316117	rs2271920	G	A	301	268	569	0	7	576	0	0
8	27591849	rs9797	G	A	6	8	14	0	1	15	0	0
8	27592002	rs73231085	T	C	7	6	13	0	0	13	0	0
8	27593215	rs4732601	A	G	7	25	32	0	0	32	0	0
8	27593267	.	C	T	4	28	32	0	0	32	0	0
8	27593650	rs10081527	T	C	7	7	14	0	0	14	0	0
8	28204264	rs351779	G	A	153	133	286	0	13	299	0	0
8	28206275	rs1046511	G	C	100	113	213	0	2	215	0	0
8	28384712	rs2241802	A	G	12	8	20	0	0	20	0	0
8	28574803	rs240951	G	A	5	14	19	0	0	19	0	0
8	28609136	rs10091907	G	A	13	18	31	0	0	31	0	0
8	28609769	rs9183	C	T	24	27	51	0	0	51	0	0
8	28626418	rs241178	C	T	3	3	6	0	0	6	0	0
8	28626470	rs241177	G	A	5	5	10	0	0	10	0	0
8	28910315	rs56896853	C	T	21	26	47	0	0	47	0	0
8	28910397	rs7004667	G	A	13	16	29	0	0	29	0	0
8	28913888	rs2279442	T	C	34	32	66	0	1	67	0	0
8	28917368	rs6558091	T	G	22	17	39	0	0	39	0	0
8	28922100	rs148451152	C	T	33	28	61	0	0	61	0	0
8	28926240	.	G	A	37	25	62	0	0	62	0	0
8	29091635	rs2925210	T	C	2	5	7	0	0	7	0	0
8	29091900	rs117845037	G	A	2	4	6	0	0	6	0	0
8	29207845	rs3182143	C	T	4	5	9	0	0	9	0	0
8	29207872	rs2637819	G	A	5	5	10	0	0	10	0	0
8	29208142	rs3757999	A	G	7	1	8	0	0	8	0	0
8	29921177	rs180860092	C	G	309	243	552	0	11	564	1	0
8	29940823	.	G	C	6	4	10	0	0	10	0	0
8	30410521	rs6993983	T	C	5	3	8	0	0	8	0	0
8	30410538	rs6981987	C	T	6	4	10	0	0	10	0	0
8	30419548	rs112261638	G	T	7	5	12	0	0	12	0	0
8	30419742	rs555186944	G	A	4	3	7	0	0	7	0	0
8	30421455	rs3779641	C	T	6	4	10	0	0	10	0	0
8	30425907	.	G	A	13	9	22	0	0	22	0	0
8	30427612	rs2280912	G	A	8	8	16	0	0	16	0	0
8	30428758	rs34437419	C	T	11	5	16	0	0	16	0	0
8	30536581	rs1138054	A	G	27	33	60	0	0	60	0	0
8	30973957	rs1800392	G	T	10	6	16	0	0	16	0	0
8	30974792	rs4037084	T	C	6	1	7	0	0	7	0	0
8	30975000	rs11574309	G	A	5	6	11	0	0	11	0	0
8	30977490	rs4733069	C	T	1	5	6	0	0	6	0	0
8	30977717	rs2725352	T	C	6	2	8	0	0	8	0	0
8	30999280	rs1801195	G	T	16	16	32	0	0	32	0	0
8	31016282	rs16877794	A	G	6	9	15	0	0	15	0	0
8	31023660	rs1997591	C	T	7	3	10	0	0	10	0	0
8	31024638	rs1801196	C	T	23	23	46	0	0	46	0	0
8	31032490	rs2553252	C	T	5	1	6	0	0	6	0	0
8	33246538	rs16880849	A	G	1	11	12	0	0	12	0	0
8	33246591	rs17855838	G	C	3	15	18	0	0	18	0	0
8	33246685	rs16880852	G	A	5	12	17	0	0	17	0	0
8	33330612	rs2676415	T	C	10	6	16	0	0	16	0	0
8	33356074	rs6468171	A	G	25	14	39	0	0	39	0	0
8	33358162	rs10644	A	T	14	10	24	0	2	26	0	0
8	33358270	rs8685	G	A	20	14	34	0	0	34	0	0
8	33369944	rs2304748	T	C	21	30	51	0	0	51	0	0
8	33369994	rs3098657	A	G	26	37	63	0	0	64	1	0
8	33370261	rs34226219	G	A	8	11	19	0	0	19	0	0
8	33407341	rs7812958	T	G	4	5	9	0	0	9	0	0
8	33416189	rs3735950	G	A	65	66	131	0	1	132	0	0
8	33416222	rs3735951	C	T	63	73	136	0	0	136	0	0
8	33424546	rs3735952	T	G	26	15	41	0	0	41	0	0
8	37604443	rs138288797	A	G	3	4	7	0	0	7	0	0
8	37609118	rs150816707	C	A	8	3	11	0	0	11	0	0
8	37737034	rs4976895	C	T	8	5	13	0	0	13	0	0
8	38299419	rs6983315	G	A	6	7	13	0	0	13	0	0
8	38299715	rs6987534	G	C	4	3	7	0	0	7	0	0
8	38303979	rs11784905	T	A	5	2	7	0	0	7	0	0
8	38311001	rs4733930	C	T	7	7	14	0	1	15	0	0
8	38656250	rs13252897	C	T	7	4	11	0	0	11	0	0
8	38656301	rs13260356	G	A	6	6	12	0	1	13	0	0
8	38677932	rs2013586	A	G	205	274	479	0	10	489	0	0
8	38678477	rs11781693	A	G	9	16	25	0	1	26	0	0
8	38683736	rs7815289	A	G	80	65	145	0	0	145	0	0
8	38684853	rs2037204	T	C	64	81	145	0	0	145	0	0
8	38685298	rs7821004	A	G	17	17	34	0	1	35	0	0
8	38685601	rs12674997	A	G	17	10	27	0	0	27	0	0
8	38686045	rs2037203	G	A	24	24	48	0	0	48	0	0
8	38687230	rs7005388	T	C	23	22	45	0	0	45	0	0
8	38687972	rs7839310	T	C	18	25	43	0	0	43	0	0
8	38690457	rs6474506	G	A	8	4	12	0	0	12	0	0
8	38691139	rs10808998	A	G	3	4	7	0	0	7	0	0
8	38693262	rs6474507	A	G	2	4	6	0	0	6	0	0
8	38694383	rs869471	T	G	4	7	11	0	0	11	0	0
8	38694715	rs189121275	C	G	7	13	20	0	0	20	0	0
8	38695996	rs2292741	T	C	95	180	275	0	0	275	0	0
8	38696868	rs17514531	A	G	10	59	69	0	1	70	0	0
8	38697603	rs13275095	C	T	4	3	7	0	1	8	0	0
8	38697649	rs13262797	T	C	6	4	10	0	0	10	0	0
8	38701329	rs7009521	A	G	15	18	33	0	0	33	0	0
8	38702278	rs16887795	A	T	4	7	11	0	1	12	0	0
8	38703797	rs10282935	A	G	10	4	14	0	0	14	0	0
8	38706397	rs3802249	G	C	122	113	235	0	0	235	0	0
8	38707452	rs3739251	A	T	64	62	126	0	2	128	0	0
8	38828850	rs76315340	G	A	134	132	266	0	1	267	0	0
8	38853269	rs7006414	C	T	14	16	30	0	0	30	0	0
8	38853983	rs7840270	C	A	10	4	14	0	1	15	0	0
8	41348534	rs3780023	C	T	4	5	9	0	0	9	0	0
8	41349333	rs4736989	T	G	3	5	8	0	0	8	0	0
8	41356017	rs7844820	C	T	7	4	11	0	0	11	0	0
8	41356386	rs17598565	T	C	3	3	6	0	0	6	0	0
8	41357139	rs13249388	C	T	2	6	8	0	0	8	0	0
8	41363149	rs4736814	A	G	5	2	7	0	0	7	0	0
8	41365491	rs28478173	G	C	8	6	14	0	0	14	0	0
8	41365660	rs12545679	A	G	7	12	19	0	0	19	0	0
8	41367608	rs1043869	T	C	87	69	156	0	2	158	0	0
8	41367882	rs7442	A	G	107	75	182	0	0	182	0	0
8	41401851	rs62507829	G	A	4	2	6	0	0	6	0	0
8	41435795	rs999188	T	G	34	20	54	0	0	54	0	0
8	41457697	rs34709394	A	G	6	7	13	0	0	13	0	0
8	41459421	rs35698806	C	T	7	11	18	0	0	18	0	0
8	41460004	rs35222983	G	T	12	18	30	0	1	31	0	0
8	41460083	rs13256154	G	C	7	13	20	0	0	20	0	0
8	41460187	rs11996226	C	T	16	8	24	0	0	24	0	0
8	41460275	rs13267399	T	G	7	15	22	0	0	22	0	0
8	41460789	rs13275940	T	C	14	8	22	0	0	22	0	0
8	41462638	rs755552	T	C	13	6	19	0	1	20	0	0
8	41465812	rs62509817	C	T	13	16	29	0	0	29	0	0
8	41466789	rs12708212	T	C	20	15	35	0	0	35	0	0
8	41467827	rs919035	C	T	7	12	19	0	0	19	0	0
8	41468608	rs7841392	G	A	7	0	7	0	0	7	0	0
8	41468809	rs11990028	T	A	5	5	10	0	0	10	0	0
8	41469042	rs11775059	C	T	11	15	26	0	0	26	0	0
8	41472845	rs12677439	C	T	5	4	9	0	0	9	0	0
8	41473417	rs55812128	G	A	6	2	8	0	0	8	0	0
8	41475688	rs60344866	T	C	6	5	11	0	0	11	0	0
8	41476003	rs6988044	G	A	6	16	22	0	0	22	0	0
8	41477684	rs34181101	C	T	5	7	12	0	0	12	0	0
8	41478569	rs11545514	A	G	96	76	172	0	3	175	0	0
8	41479293	rs36068895	T	C	97	83	180	0	0	180	0	0
8	41481036	rs890221	A	T	3	4	7	0	0	7	0	0
8	41481037	rs890222	G	T	3	4	7	0	0	7	0	0
8	41481224	rs749541	G	A	3	3	6	0	0	6	0	0
8	41525914	rs750625	C	T	2	4	6	0	0	6	0	0
8	41547751	.	G	A	3	3	6	0	0	6	0	0
8	41585438	rs2304871	G	A	4	4	8	0	0	8	0	0
8	41804009	rs62508251	T	C	7	3	10	0	0	10	0	0
8	41831612	.	G	A	4	3	7	0	0	7	0	0
8	41831672	.	T	G	3	5	8	0	1	9	0	0
8	42010602	rs7000567	G	A	8	16	24	0	0	24	0	0
8	42013295	rs11778382	A	G	8	6	14	0	0	14	0	0
8	42013778	rs6474378	T	C	7	5	12	0	1	13	0	0
8	42026968	rs34361836	A	T	5	10	15	0	0	15	0	0
8	42026987	rs1050262	C	T	7	9	16	0	0	16	0	0
8	42028077	rs10958709	G	A	7	5	12	0	0	12	0	0
8	42222502	rs3136783	G	A	2	6	8	0	0	8	0	0
8	42392942	rs1901282	C	G	5	1	6	0	0	6	0	0
8	42394425	rs2923431	G	C	5	3	8	0	0	8	0	0
8	42762860	rs144661472	T	G	15	27	42	0	0	42	0	0
8	42853271	rs708190	A	G	3	5	8	0	0	8	0	0
8	42916320	rs35601968	A	C	3	3	6	0	0	6	0	0
8	43056163	.	C	G	15	6	21	0	0	21	0	0
8	48006920	rs36178745	C	T	5	1	6	0	0	6	0	0
8	48235279	rs6990123	A	G	6	3	9	0	0	9	0	0
8	48316140	rs4873292	T	C	7	3	10	0	0	10	0	0
8	48316543	rs4873293	G	A	5	4	9	0	0	9	0	0
8	48317711	rs72646317	C	T	5	2	7	0	0	7	0	0
8	48359042	rs10808752	C	T	6	4	10	0	0	10	0	0
8	48538035	rs140361599	C	T	5	1	6	0	0	6	0	0
8	48538943	rs149062103	A	G	4	2	6	0	0	6	0	0
8	48539710	.	G	A	2	4	6	0	0	6	0	0
8	48598738	rs16930163	A	G	5	1	6	0	0	6	0	0
8	48648690	rs3614	A	T	89	77	166	0	2	168	0	0
8	48710955	rs7830743	A	G	24	38	62	0	2	64	0	0
8	48882899	rs9657054	C	T	4	2	6	0	0	6	0	0
8	48889409	rs17334535	C	A	37	47	84	0	0	84	0	0
8	52731018	.	C	T	27	0	27	0	2	29	0	0
8	52731092	.	T	A	14	0	14	0	0	14	0	0
8	52731250	.	A	G	24	0	24	0	0	24	0	0
8	53537316	rs1129660	A	G	109	89	198	0	0	198	0	0
8	53538495	rs7825939	A	G	8	4	12	0	0	12	0	0
8	53555069	rs2305427	A	G	86	81	167	0	4	171	0	0
8	53556296	rs4873670	T	C	4	2	6	0	0	6	0	0
8	53560980	rs17336810	A	G	9	6	15	0	0	15	0	0
8	53561892	rs964785	T	C	14	19	33	0	0	33	0	0
8	53586706	rs17337252	A	G	82	62	144	0	0	144	0	0
8	53592184	rs13249260	C	T	4	2	6	0	0	6	0	0
8	53598961	rs2016314	A	C	6	4	10	0	0	10	0	0
8	53602831	rs13270654	A	G	8	5	13	0	0	13	0	0
8	53603032	rs7838517	C	A	5	2	7	0	0	7	0	0
8	53604445	rs117499094	T	A	8	2	10	0	0	10	0	0
8	53606775	rs56103407	A	G	6	7	13	0	0	13	0	0
8	54879283	rs1050523	T	C	204	225	429	0	2	431	0	0
8	54879407	rs147680453	C	T	145	147	292	0	1	293	0	0
8	54880468	rs1050471	A	C	101	2	103	0	5	108	0	0
8	54881757	rs59630555	G	C	14	21	35	0	0	35	0	0
8	54887286	rs77730036	C	T	3	3	6	0	0	6	0	0
8	54892988	rs4515510	T	C	6	1	7	0	0	7	0	0
8	54897459	rs72614665	T	A	6	3	9	0	0	9	0	0
8	54899192	rs146067374	A	G	3	10	13	0	0	13	0	0
8	54899849	rs11997954	T	C	10	5	15	0	0	15	0	0
8	54901348	rs12674671	T	C	7	11	18	0	0	18	0	0
8	54901591	rs12676510	G	A	4	3	7	0	0	7	0	0
8	54961512	rs57872947	T	G	4	8	12	0	0	12	0	0
8	54962327	rs4506187	G	C	3	4	7	0	0	7	0	0
8	54992301	rs7011379	A	G	4	5	9	0	0	9	0	0
8	54993159	rs35292579	G	A	6	0	6	0	0	6	0	0
8	54999795	rs4737479	T	C	2	5	7	0	0	7	0	0
8	55013947	rs11994629	G	A	0	6	6	0	0	6	0	0
8	55048118	rs12679542	G	T	2	6	8	0	0	8	0	0
8	55048922	rs6473911	G	C	3	4	7	0	0	7	0	0
8	55058591	rs11993959	G	A	3	5	8	0	0	8	0	0
8	56845478	rs139473254	A	T	19	18	37	0	0	37	0	0
8	56892347	.	C	T	2	4	6	0	0	6	0	0
8	56918562	rs73590374	G	A	3	6	9	0	0	9	0	0
8	57129291	rs62515433	A	T	19	26	45	0	1	46	0	0
8	59329438	rs13277646	A	G	17	13	30	0	0	30	0	0
8	59362624	rs1057067	T	C	11	7	18	0	1	19	0	0
8	59363853	rs7958	A	G	11	8	19	0	0	19	0	0
8	59468401	rs112682968	C	G	13	16	29	0	0	29	0	0
8	59468464	rs7843989	T	G	11	8	19	0	0	19	0	0
8	59468651	rs7825996	A	T	6	5	11	0	0	11	0	0
8	59468842	rs6471731	A	G	22	13	35	0	0	35	0	0
8	59469275	rs72647435	G	T	5	4	9	0	0	9	0	0
8	59470992	rs9297996	T	C	2	5	7	0	0	7	0	0
8	59471187	rs9297997	C	T	2	5	7	0	0	7	0	0
8	59471332	rs10104292	T	C	2	4	6	0	0	6	0	0
8	59473630	rs72647437	T	C	5	7	12	0	0	12	0	0
8	59473938	rs12676593	A	G	2	6	8	0	0	8	0	0
8	59478423	rs10111052	T	G	31	73	104	0	0	104	0	0
8	59478980	rs10099912	G	T	8	9	17	0	0	17	0	0
8	59479767	rs10504256	G	A	4	2	6	0	0	6	0	0
8	59481292	rs10094910	T	C	14	24	38	0	1	39	0	0
8	59481895	rs28711402	G	T	13	21	34	0	0	34	0	0
8	59482041	rs4400366	C	G	10	14	24	0	0	24	0	0
8	59487176	rs10090425	T	A	5	3	8	0	0	8	0	0
8	59487656	rs10085973	C	G	7	5	12	0	0	12	0	0
8	59489542	rs4282557	C	T	9	15	24	0	1	25	0	0
8	59489549	rs4400367	A	G	7	19	26	0	0	26	0	0
8	59490197	.	C	T	6	11	17	0	0	17	0	0
8	59494089	rs28656336	G	T	62	47	109	0	0	109	0	0
8	59496416	rs1050504	C	T	95	127	222	0	0	222	0	0
8	59496490	rs1050488	A	G	68	103	171	0	0	171	0	0
8	59497371	rs72647443	G	A	8	3	11	0	0	11	0	0
8	59498190	rs12677290	G	A	9	6	15	0	0	15	0	0
8	59498614	rs6995115	A	G	4	6	10	0	0	10	0	0
8	59498685	rs12679938	T	G	4	4	8	0	0	8	0	0
8	59499237	rs3816846	G	A	5	1	6	0	0	6	0	0
8	59507950	rs2279462	A	C	3	4	7	0	0	7	0	0
8	59508375	rs2279460	C	T	5	5	10	0	0	10	0	0
8	59542732	rs113847133	G	A	3	4	7	0	0	7	0	0
8	61462223	rs11778115	A	G	5	4	9	0	0	9	0	0
8	61481614	rs10098769	T	G	1	7	8	0	0	8	0	0
8	61501156	rs58916286	A	G	2	6	8	0	0	8	0	0
8	61503450	rs13278228	A	G	6	4	10	0	0	10	0	0
8	61511366	rs6995515	A	C	10	11	21	0	0	21	0	0
8	61515656	rs73261277	C	A	4	2	6	0	0	6	0	0
8	61516808	rs113435324	C	G	3	4	7	0	0	7	0	0
8	61521929	rs603239	C	T	5	3	8	0	0	8	0	0
8	61526953	rs625850	A	G	3	3	6	0	0	6	0	0
8	61532461	rs7846100	G	A	2	7	9	0	0	9	0	0
8	61534428	rs7413	A	G	45	80	125	0	1	126	0	0
8	61534895	rs629268	C	T	93	80	173	0	4	177	0	0
8	61535125	rs649634	C	G	48	44	92	0	1	93	0	0
8	61535417	rs9437	G	A	56	47	103	0	1	104	0	0
8	61660163	rs11775560	A	G	9	0	9	0	0	9	0	0
8	61662294	rs7816419	A	G	3	3	6	0	0	6	0	0
8	61662348	rs28710955	T	A	5	1	6	0	0	6	0	0
8	61664214	rs876957	G	A	9	7	16	0	0	16	0	0
8	61665577	rs1473446	T	G	8	7	15	0	0	15	0	0
8	61670476	rs1038353	A	G	2	8	10	0	0	10	0	0
8	61765560	rs2068096	G	A	28	21	49	0	0	49	0	0
8	61766968	.	T	C	35	24	59	0	0	59	0	0
8	61878921	rs35585682	T	A	7	5	12	0	0	12	0	0
8	62537309	rs6549	A	G	4	4	8	0	0	8	0	0
8	62571619	rs72659032	T	C	5	8	13	0	0	13	0	0
8	62626962	rs3829051	C	T	3	11	14	0	0	14	0	0
8	62627004	rs3750279	A	G	9	9	18	0	0	18	0	0
8	64123218	rs187682591	T	G	163	158	321	0	1	322	0	0
8	67341938	rs3739336	G	T	11	14	25	0	0	25	0	0
8	67380528	rs1060242	T	C	3	4	7	0	0	7	0	0
8	67380677	rs13682	C	T	3	7	10	0	0	10	0	0
8	67380737	rs12265	C	A	8	4	12	0	0	12	0	0
8	67380863	rs1108	T	C	12	2	14	0	0	14	0	0
8	67973984	rs7812572	C	A	4	3	7	0	0	7	0	0
8	68028252	rs146431326	C	G	7	12	19	0	0	19	0	0
8	68118795	rs7002622	G	A	4	2	6	0	0	6	0	0
8	68127243	rs1471084	C	T	4	3	7	0	0	7	0	0
8	68203197	rs13249349	T	A	13	19	32	0	0	32	0	0
8	68207909	rs12682412	G	A	3	5	8	0	2	10	0	0
8	68223106	rs76650391	G	A	5	5	10	0	1	11	0	0
8	68224291	rs13280556	C	T	4	11	15	0	0	15	0	0
8	68224493	.	A	C	4	2	6	0	0	6	0	0
8	68225858	rs12675528	T	C	12	6	18	0	0	18	0	0
8	68229299	rs7812887	G	C	3	4	7	0	0	7	0	0
8	68347055	rs11781908	G	A	27	0	27	0	1	28	0	0
8	68396915	rs17343819	T	C	8	12	20	0	0	20	0	0
8	68536470	rs10957393	A	G	20	14	34	0	0	34	0	0
8	70588878	rs10448034	T	C	4	14	18	0	0	18	0	0
8	70743930	rs76904139	C	T	5	3	8	0	0	8	0	0
8	70744167	rs118016633	G	A	84	36	120	0	0	120	0	0
8	70744812	rs3750266	G	A	60	46	106	0	1	107	0	0
8	70744972	rs77679341	G	C	35	23	58	0	2	61	1	0
8	71120213	rs4737301	G	A	15	24	39	0	0	39	0	0
8	71120277	rs4737302	A	G	16	22	38	0	0	38	0	0
8	71121143	rs11775170	T	C	11	12	23	0	0	23	0	0
8	71486085	rs8993	A	C	30	38	68	0	3	71	0	0
8	71486199	rs185442564	G	T	31	20	51	0	0	51	0	0
8	71486568	rs268566	G	C	31	17	48	0	0	48	0	0
8	71489085	rs372170	A	G	9	6	15	0	0	15	0	0
8	71489200	rs2622653	A	G	10	6	16	0	0	16	0	0
8	71489682	rs368854	C	A	6	5	11	0	1	12	0	0
8	71490050	rs146151909	C	T	4	8	12	0	0	12	0	0
8	71491396	rs268560	C	T	2	5	7	0	0	7	0	0
8	71494114	rs13276058	T	G	3	5	8	0	0	8	0	0
8	71507697	rs7015434	C	T	7	8	15	0	0	15	0	0
8	71508905	rs268624	A	C	2	6	8	0	0	8	0	0
8	73944064	rs139693922	C	T	16	10	26	0	0	26	0	0
8	73946664	rs117840977	G	A	6	2	8	0	0	8	0	0
8	73954272	.	A	T	5	8	13	0	0	13	0	0
8	74203722	rs58328254	G	A	9	9	18	0	0	18	0	0
8	74204653	rs2070764	A	T	10	6	16	0	0	16	0	0
8	74205609	rs62509785	C	A	20	21	41	0	0	41	0	0
8	74702487	rs16938729	A	T	8	3	11	0	1	12	0	0
8	74703133	rs17224289	C	T	4	6	10	0	0	10	0	0
8	74788975	rs7817393	A	G	4	8	12	0	0	12	0	0
8	74868593	rs117190982	C	T	14	10	24	0	0	24	0	0
8	74917084	rs6472812	A	G	3	6	9	0	0	9	0	0
8	75274141	rs11554166	T	G	2	4	6	0	1	7	0	0
8	75276959	rs1135715	A	G	6	5	11	0	0	11	0	0
8	75277432	rs4737414	C	G	5	10	15	0	0	15	0	0
8	81448919	rs62515080	C	T	3	4	7	0	0	7	0	0
8	81907995	rs117664636	T	C	3	4	7	0	0	7	0	0
8	81909076	rs16908275	C	G	3	4	7	0	0	7	0	0
8	81956152	rs2705499	G	T	1	8	9	0	0	9	0	0
8	81956197	rs2623024	T	C	2	10	12	0	0	12	0	0
8	81997301	rs7834107	A	G	5	2	7	0	0	7	0	0
8	82016991	.	G	C	4	5	9	0	0	9	0	0
8	82017932	rs4500045	G	A	5	4	9	0	0	9	0	0
8	82018406	rs55873741	G	A	2	4	6	0	0	6	0	0
8	82018861	rs28683599	A	G	14	2	16	0	0	16	0	0
8	82019541	rs17571404	C	G	6	13	19	0	0	19	0	0
8	82020095	rs4237094	T	C	9	10	19	0	0	19	0	0
8	82020528	rs4445178	G	A	15	6	21	0	0	21	0	0
8	82020700	rs4377918	A	G	6	7	13	0	0	13	0	0
8	82020820	rs4739614	G	A	7	5	12	0	0	12	0	0
8	82022059	rs4739788	T	A	9	7	16	0	0	16	0	0
8	82590861	rs2991004	G	A	2	4	6	0	0	6	0	0
8	82738651	.	A	G	5	3	8	0	0	8	0	0
8	82738807	rs4739628	C	G	2	5	7	0	0	7	0	0
8	82741020	rs61366694	C	T	8	3	11	0	0	11	0	0
8	82751822	rs1814534	T	G	15	16	31	0	0	31	0	0
8	82752291	rs12056632	A	G	43	36	79	0	0	79	0	0
8	82753350	rs111801710	T	C	8	3	11	0	0	11	0	0
8	82754118	rs4431552	A	C	4	2	6	0	0	6	0	0
8	82754365	rs4316108	C	A	28	24	52	0	0	52	0	0
8	86127464	rs4150974	C	A	5	3	8	0	0	8	0	0
8	86127598	rs4150977	G	A	5	3	8	0	0	8	0	0
8	86128284	rs28377260	G	T	8	1	9	0	0	9	0	0
8	86128621	rs16913681	A	G	2	5	7	0	0	7	0	0
8	86130623	rs6990449	A	G	6	8	14	0	0	14	0	0
8	86130628	rs6990452	A	G	6	9	15	0	0	15	0	0
8	86131463	rs67573812	A	T	9	11	20	0	0	20	0	0
8	86255023	rs550123087	C	T	10	8	18	0	0	18	0	0
8	86389403	rs703	T	C	36	90	126	0	0	126	0	0
8	87485483	rs6471354	G	C	13	24	37	0	1	38	0	0
8	87519315	rs6980476	T	G	32	43	75	0	1	76	0	0
8	87540872	rs10956871	G	A	37	27	64	0	0	64	0	0
8	90797331	rs40546	A	G	17	11	28	0	0	28	0	0
8	90954481	rs6470522	A	G	6	6	12	0	0	12	0	0
8	91653325	.	A	G	7	1	8	0	1	9	0	0
8	91894812	rs4735428	G	C	1	6	7	0	0	7	0	0
8	91897549	rs1352159	T	C	2	9	11	0	0	11	0	0
8	91969669	rs1055146	C	T	28	30	58	0	0	58	0	0
8	92075904	rs10942	T	C	7	5	12	0	0	12	0	0
8	92080407	rs8081	C	T	3	4	7	0	0	7	0	0
8	92080575	rs1138489	G	A	15	9	24	0	0	24	0	0
8	92083424	rs11557571	A	G	5	11	16	0	0	16	0	0
8	94741752	rs2914952	A	C	4	3	7	0	0	7	0	0
8	94744813	rs10504930	C	T	6	2	8	0	0	8	0	0
8	94745386	rs16916186	G	T	4	2	6	0	0	6	0	0
8	94746698	rs3133974	G	T	10	9	19	0	0	19	0	0
8	94749565	rs16916191	C	T	10	5	15	0	0	15	0	0
8	94750826	rs55987902	G	A	5	1	6	0	0	6	0	0
8	94752754	rs3813853	G	A	7	3	10	0	0	10	0	0
8	94935937	rs4735258	T	C	24	36	60	0	1	61	0	0
8	94936532	rs911	G	C	16	21	37	0	0	37	0	0
8	95261955	rs17036	T	C	6	5	11	0	0	11	0	0
8	95271195	rs2445714	C	T	2	4	6	0	0	6	0	0
8	95522377	rs1048029	G	C	6	11	17	0	0	17	0	0
8	95523038	rs1055800	A	G	31	31	62	0	0	62	0	0
8	95523113	rs55895446	T	C	57	58	115	0	3	118	0	0
8	95523233	rs1055797	G	T	40	44	84	0	1	85	0	0
8	95525948	rs78027502	C	T	3	5	8	0	0	8	0	0
8	95531419	rs1866844	T	C	77	64	141	0	1	142	0	0
8	95538468	rs2890827	T	C	74	89	163	0	1	164	0	0
8	95541302	rs957448	A	G	57	51	108	0	0	108	0	0
8	95547119	rs2304764	T	G	49	29	78	0	4	82	0	0
8	95550474	rs1866846	T	C	3	4	7	0	0	7	0	0
8	96063988	rs76847527	G	A	17	9	26	0	0	26	0	0
8	97316821	rs938828	T	G	5	7	12	0	0	12	0	0
8	97317409	rs3808480	G	A	3	4	7	0	0	7	0	0
8	97332168	rs11782711	G	A	2	4	6	0	0	6	0	0
8	97332661	rs3735987	A	G	4	2	6	0	0	6	0	0
8	97334850	rs7821730	A	T	4	5	9	0	0	9	0	0
8	97335067	rs13262071	C	T	4	5	9	0	1	10	0	0
8	97337513	rs4734338	C	T	4	3	7	0	0	7	0	0
8	97337656	rs17781008	A	G	8	4	12	0	0	12	0	0
8	97338270	rs9886402	G	T	3	3	6	0	1	7	0	0
8	97338296	rs7837387	G	C	3	7	10	0	0	10	0	0
8	97338835	rs28368495	C	T	4	5	9	0	0	9	0	0
8	97338931	rs17781044	A	G	7	2	9	0	1	10	0	0
8	97340116	rs9886481	C	G	3	3	6	0	1	7	0	0
8	97340925	rs6985074	A	T	7	7	14	0	0	14	0	0
8	97341390	rs11784595	A	C	7	4	11	0	1	12	0	0
8	97341406	rs11777772	G	A	7	7	14	0	0	14	0	0
8	97342090	rs2280264	A	G	7	7	14	0	0	14	0	0
8	97342536	rs2280263	A	G	3	5	8	0	0	8	0	0
8	97342582	rs7001397	C	T	7	1	8	0	0	8	0	0
8	97343176	rs2271775	G	T	4	9	13	0	0	13	0	0
8	97345590	rs3735986	A	G	6	3	9	0	0	9	0	0
8	97347625	rs4734340	G	A	6	2	8	0	0	8	0	0
8	97347637	rs1400914	C	T	6	2	8	0	0	8	0	0
8	97551112	rs2589201	G	A	3	3	6	0	0	6	0	0
8	97605800	rs1126681	C	T	8	1	9	0	0	9	0	0
8	98658215	rs76222758	C	G	3	3	6	0	0	6	0	0
8	98667777	rs16896060	C	T	4	3	7	0	0	7	0	0
8	98725970	rs2331652	G	A	344	306	650	0	21	671	0	0
8	98788261	rs2449508	G	T	9	0	9	0	0	9	0	0
8	98863876	rs1136594	G	A	14	0	14	0	0	14	0	0
8	98863930	rs1136595	T	C	14	3	17	0	0	17	0	0
8	98864102	rs8796	G	T	7	1	8	0	2	10	0	0
8	99054796	rs1599909	C	T	4	4	8	0	0	8	0	0
8	99055222	rs2877453	C	A	69	53	122	0	2	124	0	0
8	99055939	rs1466428	A	T	64	73	137	0	3	140	0	0
8	99056051	rs1965914	A	G	46	29	75	0	0	75	0	0
8	99057150	rs11777189	C	A	292	406	698	0	1	700	1	0
8	99057526	rs812	G	A	241	160	401	0	4	405	0	0
8	99058055	rs55698139	T	G	6	4	10	0	0	10	0	0
8	99202587	rs1129891	G	A	4	4	8	0	0	8	0	0
8	100076537	rs6992480	T	C	3	3	6	0	0	6	0	0
8	100077093	rs6468656	C	T	3	4	7	0	0	7	0	0
8	100077692	rs4461878	G	C	6	6	12	0	0	12	0	0
8	100078926	rs11988731	C	T	3	7	10	0	0	10	0	0
8	100079537	rs10103431	A	G	6	12	18	0	0	18	0	0
8	100110510	rs6468663	T	C	2	4	6	0	0	6	0	0
8	100111912	rs6468665	A	G	3	6	9	0	0	9	0	0
8	100133706	rs7460625	T	G	10	4	14	0	0	14	0	0
8	100215391	rs4307310	G	C	11	18	29	0	0	29	0	0
8	100216264	rs13256012	G	A	7	15	22	0	0	22	0	0
8	100216840	rs10107358	T	A	12	11	23	0	0	23	0	0
8	100306534	rs75520770	C	T	6	0	6	0	0	6	0	0
8	100417942	rs3105185	G	A	2	6	8	0	0	8	0	0
8	100884457	rs117383310	T	C	2	5	7	0	0	7	0	0
8	101266554	rs1613189	C	T	8	5	13	0	0	13	0	0
8	101562197	rs2154640	A	G	3	3	6	0	0	6	0	0
8	101709124	rs7837886	G	A	13	8	21	0	0	21	0	0
8	101709538	rs1693543	C	T	3	4	7	0	0	7	0	0
8	101709680	rs10435530	C	T	9	9	18	0	0	18	0	0
8	101710686	rs1693542	A	G	4	2	6	0	1	7	0	0
8	101714378	rs12541568	G	A	7	1	8	0	0	8	0	0
8	101714394	rs1693547	C	T	5	1	6	0	0	6	0	0
8	101714780	rs7837110	A	G	11	7	18	0	0	18	0	0
8	101715395	.	A	G	2587	0	2587	0	11	2598	0	0
8	101715404	.	C	T	2523	0	2523	0	19	2542	0	0
8	101718352	rs1693553	G	C	3	7	10	0	0	10	0	0
8	101718768	rs1693555	A	G	10	4	14	0	0	14	0	0
8	101719436	rs1786321	C	G	27	11	38	0	0	38	0	0
8	101720062	rs1786320	T	C	32	37	69	0	1	70	0	0
8	101722092	rs1693557	T	C	34	52	86	0	0	86	0	0
8	101725251	rs3133575	G	C	58	62	120	0	1	121	0	0
8	101725925	rs75799715	G	A	152	73	225	0	2	227	0	0
8	101726408	rs3133580	T	C	50	52	102	0	1	103	0	0
8	101726477	rs3115894	C	T	43	43	86	0	2	88	0	0
8	101726490	rs3133526	T	A	35	42	77	0	1	78	0	0
8	101727388	rs3133528	T	C	73	63	136	0	5	141	0	0
8	101728948	rs1693558	C	T	81	93	174	0	1	175	0	0
8	101732348	rs2132853	T	G	22	29	51	0	0	51	0	0
8	101732447	rs1976322	T	C	28	33	61	0	1	62	0	0
8	101732506	rs2226712	T	C	20	29	49	0	0	49	0	0
8	101733229	rs3133548	C	T	25	41	66	0	1	67	0	0
8	101733263	rs1786316	G	A	28	39	67	0	1	68	0	0
8	101733285	rs189281419	C	T	27	39	66	0	0	66	0	0
8	101929722	rs34061524	C	T	8	13	21	0	1	22	0	0
8	101930297	rs41408945	G	A	9	8	17	0	0	17	0	0
8	101934435	rs3134377	T	C	21	27	48	0	0	48	0	0
8	101934971	rs4734497	T	C	43	37	80	0	1	81	0	0
8	101936283	rs41507849	G	A	6	8	14	0	0	14	0	0
8	101946112	rs34540560	C	T	3	10	13	0	0	13	0	0
8	101950115	rs3134355	T	C	3	6	9	0	0	9	0	0
8	101961511	rs34072712	T	C	6	3	9	0	0	9	0	0
8	103270312	.	C	T	11	26	37	0	0	37	0	0
8	103274006	rs2853236	G	T	1	5	6	0	0	6	0	0
8	103284357	.	G	A	5	1	6	0	0	6	0	0
8	103662219	rs3191333	G	A	1216	988	2204	0	14	2218	0	0
8	103662852	rs13275089	T	C	81	33	114	0	0	114	0	0
8	103838876	rs6921	T	A	254	524	778	0	4	782	0	0
8	103839164	rs1062315	A	T	159	311	470	0	2	472	0	0
8	103841861	rs2304346	G	A	2	4	6	0	0	6	0	0
8	103844702	rs34655485	C	G	2	6	8	0	0	8	0	0
8	103844988	rs2513936	C	T	5	3	8	0	0	8	0	0
8	103847247	rs79031142	A	G	6	4	10	0	0	10	0	0
8	103848263	rs2256440	T	C	6	8	14	0	0	14	0	0
8	103850092	rs2436844	C	T	1	7	8	0	0	8	0	0
8	103850232	rs2513898	G	C	5	13	18	0	0	18	0	0
8	103851052	rs1062048	T	C	268	477	745	0	4	749	0	0
8	103854033	.	T	A	1	11	12	0	0	12	0	0
8	103854874	rs2436847	G	A	2	10	12	0	1	13	0	0
8	103855106	rs2513913	G	A	3	10	13	0	0	13	0	0
8	103856775	rs2679746	C	G	7	5	12	0	0	12	0	0
8	103857042	rs2570939	A	G	2	8	10	0	0	10	0	0
8	103858114	rs2679747	A	T	3	4	7	0	1	8	0	0
8	103858308	rs2679748	C	T	6	5	11	0	0	11	0	0
8	103858488	rs2679749	C	T	8	9	17	0	0	17	0	0
8	103858748	rs1991927	G	T	1	5	6	0	0	6	0	0
8	103861040	rs2570942	T	G	5	8	13	0	0	13	0	0
8	103861302	rs557086879	G	A	6	3	9	0	0	9	0	0
8	103861436	rs2679751	A	G	5	15	20	0	0	20	0	0
8	103876325	rs2679745	G	A	162	282	444	0	4	448	0	0
8	103876362	rs76513872	A	C	187	94	281	0	4	285	0	0
8	103877434	rs1055376	G	A	6	6	12	0	0	12	0	0
8	103879532	rs1982111	T	A	4	2	6	0	0	6	0	0
8	103997610	rs72667281	T	C	6	1	7	0	0	7	0	0
8	104001079	rs2679738	G	C	5	1	6	0	0	6	0	0
8	104004553	rs57059899	A	G	2	8	10	0	0	10	0	0
8	104004628	rs72667289	T	C	2	8	10	0	0	10	0	0
8	104004663	rs72667290	C	T	3	8	11	0	0	11	0	0
8	104006887	rs73288580	T	C	7	11	18	0	0	18	0	0
8	104007013	rs600667	C	A	4	5	9	0	0	9	0	0
8	104009564	rs515024	G	A	4	2	6	0	1	7	0	0
8	104010694	rs2679734	G	T	7	4	11	0	0	11	0	0
8	104011771	rs582100	C	G	4	6	10	0	0	10	0	0
8	104081996	rs1158921	C	T	10	5	15	0	0	15	0	0
8	104082307	rs2248718	C	T	16	8	24	0	0	24	0	0
8	104082411	rs4734684	G	A	9	18	27	0	0	27	0	0
8	104083651	rs2453994	C	T	41	19	60	0	0	60	0	0
8	104083888	rs2453995	A	G	50	14	64	0	0	64	0	0
8	104083993	rs2515205	T	C	42	20	62	0	0	62	0	0
8	104084137	rs2453996	G	A	40	11	51	0	2	53	0	0
8	104084584	rs17200931	A	G	4	6	10	0	0	10	0	0
8	104150586	.	T	C	12	20	32	0	0	32	0	0
8	104151381	rs2256164	A	C	215	340	555	0	2	557	0	0
8	104154713	rs2454013	T	G	4	4	8	0	0	8	0	0
8	104154965	rs2454014	T	C	2	4	6	0	0	6	0	0
8	104155852	rs1391118	C	T	6	8	14	0	0	14	0	0
8	104155996	rs1353629	C	T	2	9	11	0	0	11	0	0
8	104156603	rs2515190	A	G	1	5	6	0	0	6	0	0
8	104157531	rs2935579	A	G	3	7	10	0	0	10	0	0
8	104162480	rs12545903	G	A	7	1	8	0	0	8	0	0
8	104163759	rs13259545	T	C	7	1	8	0	0	8	0	0
8	104164162	rs12056711	C	T	5	2	7	0	0	7	0	0
8	104175396	rs72671383	A	G	5	3	8	0	0	8	0	0
8	104182847	rs72671394	C	T	7	7	14	0	0	14	0	0
8	104183205	rs10955312	C	T	23	7	30	0	0	30	0	0
8	104183657	rs34765095	T	G	14	5	19	0	0	19	0	0
8	104183661	rs2388495	A	G	14	5	19	0	1	20	0	0
8	104183856	rs61607037	C	T	32	13	45	0	0	45	0	0
8	104186211	rs1000461	G	A	6	1	7	0	0	7	0	0
8	104189144	rs12543973	C	A	31	28	59	0	0	59	0	0
8	104191077	rs13275933	T	C	5	1	6	0	0	6	0	0
8	104194973	rs1494272	A	G	6	4	10	0	0	10	0	0
8	104196139	rs3956319	C	T	5	7	12	0	0	12	0	0
8	104196713	rs713368	T	C	7	2	9	0	0	9	0	0
8	104199633	rs1032470	A	G	3	3	6	0	0	6	0	0
8	104204858	rs16870245	C	T	8	8	16	0	0	16	0	0
8	104204876	rs34337822	A	G	10	8	18	0	0	18	0	0
8	104205431	rs16870249	T	C	3	10	13	0	0	13	0	0
8	104205763	rs13275173	G	A	5	12	17	0	0	17	0	0
8	104206113	rs11784151	C	A	6	6	12	0	1	13	0	0
8	104207581	rs17204757	C	T	4	10	14	0	0	14	0	0
8	104208963	rs4510824	T	A	9	5	14	0	0	14	0	0
8	104212210	rs34185273	A	G	7	10	17	0	0	17	0	0
8	104214902	rs1353213	C	T	11	0	11	0	0	11	0	0
8	104215583	rs11777754	T	C	6	7	13	0	0	13	0	0
8	104216746	rs2220825	C	T	4	4	8	0	1	9	0	0
8	104217953	rs13439041	C	T	7	9	16	0	0	16	0	0
8	104218818	rs1353212	G	T	17	4	21	0	0	21	0	0
8	104221137	rs10110129	A	G	9	18	27	0	1	28	0	0
8	104222938	rs10097018	C	T	4	8	12	0	0	12	0	0
8	104224116	rs34602800	G	A	19	25	44	0	0	45	1	0
8	104225536	rs2201370	T	C	5	43	48	0	2	50	0	0
8	104225846	rs16870264	C	A	7	37	44	0	0	44	0	0
8	104228230	rs10089245	G	C	88	180	268	0	0	268	0	0
8	104229244	rs35710705	C	A	15	63	78	0	0	78	0	0
8	104229533	rs17799574	G	T	24	74	98	0	0	98	0	0
8	104231944	rs9656787	C	A	131	40	171	0	1	172	0	0
8	104232037	rs17205332	T	C	113	39	152	0	1	153	0	0
8	104234332	rs34893881	T	C	17	36	53	0	0	53	0	0
8	104234512	rs34111666	A	G	28	55	83	0	0	83	0	0
8	104235227	rs7844873	G	A	10	36	46	0	0	46	0	0
8	104236746	rs10100382	A	G	10	28	38	0	0	38	0	0
8	104236925	rs10103573	G	A	21	53	74	0	2	76	0	0
8	104238182	rs10107615	A	G	30	43	73	0	1	74	0	0
8	104241994	rs1032471	A	T	49	84	133	0	0	133	0	0
8	104312432	rs827528	A	G	6	2	8	0	0	8	0	0
8	104410928	rs1061196	C	T	23	23	46	0	0	46	0	0
8	104411282	rs1061195	T	C	50	40	90	0	0	90	0	0
8	104412517	rs35225263	A	T	74	129	203	0	3	206	0	0
8	104416693	rs1865853	C	T	16	10	26	0	0	26	0	0
8	104416785	rs1865854	C	T	15	7	22	0	0	22	0	0
8	104416801	rs71520812	C	T	7	10	17	0	0	17	0	0
8	104416833	rs1865855	A	C	12	7	19	0	0	19	0	0
8	104417350	rs3133811	A	G	19	6	25	0	1	26	0	0
8	104419442	rs3133813	T	C	6	5	11	0	1	12	0	0
8	104421720	rs3133814	A	G	3	3	6	0	0	6	0	0
8	104427541	rs3134296	C	T	19	11	30	0	1	31	0	0
8	104432545	rs3134253	A	G	128	46	174	0	1	175	0	0
8	104435022	rs3098236	A	C	16	7	23	0	0	23	0	0
8	104440751	rs3098227	C	T	6	1	7	0	0	7	0	0
8	104442666	rs7816297	G	A	6	0	6	0	0	6	0	0
8	104452281	rs3098217	A	G	5	3	8	0	0	8	0	0
8	104453603	rs3098215	G	A	5	2	7	0	0	7	0	0
8	107669928	rs2282509	C	T	5	3	8	0	0	8	0	0
8	107684532	rs10102112	T	C	5	2	7	0	0	7	0	0
8	107697807	rs10089890	A	G	8	6	14	0	0	14	0	0
8	107704286	.	T	C	5	3	8	0	0	8	0	0
8	107705688	rs10100839	G	A	5	2	7	0	0	7	0	0
8	107708167	rs12548149	T	C	7	5	12	0	1	13	0	0
8	107710044	rs2627788	T	A	25	9	34	0	1	35	0	0
8	107711452	rs28422868	G	A	28	14	42	0	0	42	0	0
8	107712456	rs35919651	C	G	9	4	13	0	2	15	0	0
8	107713883	rs776944	A	T	30	17	47	0	0	48	1	0
8	107721116	rs725906	G	A	17	5	22	0	0	22	0	0
8	107754473	rs1681904	G	A	16	32	48	0	0	48	0	0
8	108263203	rs144923790	A	G	12	9	21	0	0	21	0	0
8	108263871	rs144478184	G	A	128	82	210	0	6	216	0	0
8	108266007	rs41466146	C	T	4	8	12	0	1	13	0	0
8	108270401	rs2022960	T	C	1	6	7	0	1	8	0	0
8	108306367	rs10110459	T	C	8	4	12	0	0	12	0	0
8	108307325	rs148240770	G	A	35	19	54	0	0	54	0	0
8	108308764	rs73701072	A	G	16	10	26	0	0	26	0	0
8	108309239	rs10107444	C	T	7	6	13	0	1	14	0	0
8	108309253	rs10107638	G	A	8	11	19	0	0	19	0	0
8	108334162	rs141029929	G	T	68	53	121	0	0	121	0	0
8	108358009	rs2043339	G	A	7	3	10	0	0	10	0	0
8	109213893	rs603571	A	C	2	7	9	0	0	9	0	0
8	109215368	rs630492	T	C	8	17	25	0	0	25	0	0
8	109215910	rs617285	T	C	0	6	6	0	0	6	0	0
8	109223210	rs702804	T	C	3	4	7	0	0	7	0	0
8	109227570	rs859788	A	G	3	5	8	0	0	8	0	0
8	109227585	rs859787	C	T	4	8	12	0	0	12	0	0
8	109227822	rs651951	C	G	4	5	9	0	0	9	0	0
8	109227826	rs610873	A	G	4	5	9	0	0	9	0	0
8	109229243	rs635219	C	T	2	7	9	0	0	9	0	0
8	109230140	rs641721	G	A	5	4	9	0	0	9	0	0
8	109230383	rs653081	G	T	3	8	11	0	1	12	0	0
8	109230722	rs536860	A	C	3	5	8	0	0	8	0	0
8	109233433	rs559089	A	G	2	4	6	0	0	6	0	0
8	109234035	rs609197	G	A	0	7	7	0	0	7	0	0
8	109234825	rs639746	T	C	3	4	7	0	0	7	0	0
8	109235929	rs702805	G	A	2	4	6	0	0	6	0	0
8	109244742	rs679077	G	T	2	8	10	0	0	10	0	0
8	109245497	rs585077	C	T	0	6	6	0	0	6	0	0
8	109252554	rs702808	T	C	2	5	7	0	0	7	0	0
8	109254677	rs627392	C	T	4	9	13	0	0	13	0	0
8	109254842	rs579162	A	G	6	20	26	0	0	26	0	0
8	109255032	rs681963	C	A	5	10	15	0	2	17	0	0
8	109255206	rs629996	C	T	11	19	30	0	0	30	0	0
8	109255727	rs678820	G	A	0	21	21	0	0	21	0	0
8	109255732	rs639609	C	T	0	20	20	0	1	21	0	0
8	109255989	rs2594357	A	G	2	5	7	0	0	7	0	0
8	109256014	rs2597658	C	T	3	4	7	0	0	7	0	0
8	109256018	rs2594358	A	G	3	4	7	0	0	7	0	0
8	109260581	rs9969614	A	G	3	12	15	0	0	15	0	0
8	109260776	rs4735053	A	G	6	11	17	0	0	17	0	0
8	109920383	rs6994308	A	T	2	4	6	0	0	6	0	0
8	109920418	rs7014672	T	C	2	5	7	0	0	7	0	0
8	116561793	.	A	G	2	4	6	0	0	6	0	0
8	117656741	rs16888613	G	A	16	25	41	0	0	41	0	0
8	117665191	rs1436767	G	A	6	2	8	0	0	8	0	0
8	117669202	rs10808483	C	T	8	2	10	0	0	10	0	0
8	117670802	rs4602925	A	G	36	66	102	0	0	102	0	0
8	117779875	rs6995838	A	G	3	3	6	0	0	6	0	0
8	117783914	rs1133950	A	C	44	102	146	0	2	148	0	0
8	117783975	rs16888728	C	T	37	87	124	0	1	125	0	0
8	117786658	.	T	G	26	4	30	0	0	30	0	0
8	118532964	rs6469696	A	G	5	8	13	0	0	13	0	0
8	118544801	rs112648315	G	A	12	4	16	0	0	16	0	0
8	118547247	rs73707606	T	A	8	3	11	0	0	11	0	0
8	118547521	rs187357994	T	C	4	2	6	0	1	7	0	0
8	120429024	rs2279112	G	A	3	13	16	0	1	17	0	0
8	120435468	rs17187676	C	T	14	18	32	0	0	32	0	0
8	120435561	rs16892531	T	G	5	21	26	0	0	26	0	0
8	120435812	rs2071518	C	T	14	20	34	0	0	34	0	0
8	120435962	rs1057722	A	T	17	29	46	0	1	47	0	0
8	120575184	rs1058913	G	A	5	1	6	0	0	6	0	0
8	121021305	.	G	A	36	66	102	0	3	105	0	0
8	121408195	rs6650	T	C	34	44	78	0	0	78	0	0
8	121428190	rs6980923	G	A	2	4	6	0	0	6	0	0
8	121428590	rs13278704	C	T	5	3	8	0	0	8	0	0
8	121528385	rs35511242	T	C	4	5	9	0	0	9	0	0
8	121530190	rs13258848	A	G	7	2	9	0	0	9	0	0
8	121549677	rs3924784	A	C	147	63	210	0	4	214	0	0
8	121549719	rs3924785	A	T	107	52	159	0	0	159	0	0
8	121550719	rs7003420	G	A	268	125	393	0	4	397	0	0
8	121552540	rs72680536	G	A	3	3	6	0	0	6	0	0
8	121583488	rs72680558	T	C	8	2	10	0	0	10	0	0
8	121583603	rs72680561	G	A	8	1	9	0	0	9	0	0
8	121734695	rs77222499	G	C	6	0	6	0	0	6	0	0
8	121948124	rs78325540	C	T	3	3	6	0	0	6	0	0
8	122055715	rs2043374	A	G	0	22	22	0	0	22	0	0
8	123801257	rs4871304	T	C	2	4	6	0	0	6	0	0
8	123964011	rs61752912	G	A	1	17	18	0	0	18	0	0
8	123964431	rs3204141	G	A	12	7	19	0	0	19	0	0
8	123965193	rs111726812	C	T	6	12	18	0	0	18	0	0
8	123965432	.	G	A	20	6	26	0	0	26	0	0
8	123966159	rs3802265	G	C	11	21	32	0	0	32	0	0
8	123985708	rs3802266	A	G	22	8	30	0	1	31	0	0
8	123986649	rs2833	A	G	13	4	17	0	1	18	0	0
8	124025682	rs7160	C	A	9	15	24	0	0	24	0	0
8	124027628	rs7159	T	C	267	401	668	0	6	674	0	0
8	124028479	rs11781842	G	A	31	43	74	0	1	75	0	0
8	124028757	.	T	C	37	65	102	0	2	104	0	0
8	124032259	rs4871338	G	A	49	62	111	0	0	111	0	0
8	124033034	.	C	A	5	12	17	0	2	19	0	0
8	124033036	.	C	A	15	5	20	0	1	21	0	0
8	124035564	rs12547932	G	A	9	9	18	0	0	18	0	0
8	124037435	rs3765210	A	T	2	5	7	0	0	7	0	0
8	124038045	rs12677755	A	G	1	6	7	0	0	7	0	0
8	124038055	rs13271447	T	A	1	5	6	0	0	6	0	0
8	124040062	rs12674841	G	A	2	4	6	0	1	7	0	0
8	124041083	rs10092216	A	G	1	6	7	0	0	7	0	0
8	124042065	rs6470129	T	C	3	3	6	0	1	7	0	0
8	124235891	rs531593139	A	G	6	5	11	0	0	11	0	0
8	124263429	.	G	A	4	2	6	0	0	6	0	0
8	124345904	.	T	C	0	6	6	0	0	6	0	0
8	124440174	rs6999234	A	G	21	22	43	0	0	43	0	0
8	124448736	rs7014678	A	G	18	23	41	0	1	42	0	0
8	124448804	rs6470147	T	A	29	24	53	0	1	54	0	0
8	124453662	rs13269287	T	C	30	46	76	0	0	76	0	0
8	124453799	rs1045270	A	G	10	18	28	0	0	28	0	0
8	124453979	rs1045284	T	C	24	24	48	0	0	48	0	0
8	124454007	rs1045291	T	C	16	19	35	0	0	35	0	0
8	124460483	rs12675493	A	G	0	6	6	0	0	6	0	0
8	124460512	rs12679590	C	T	0	6	6	0	0	6	0	0
8	124460513	rs12675497	A	G	0	6	6	0	0	6	0	0
8	124513978	rs6990407	C	G	11	17	28	0	0	28	0	0
8	124514183	rs3739286	T	C	6	3	9	0	0	9	0	0
8	124514261	rs3739285	C	G	11	11	22	0	0	22	0	0
8	124514716	rs4871383	T	C	15	20	35	0	0	35	0	0
8	124514769	rs1048515	A	G	13	16	29	0	0	29	0	0
8	124795861	rs17259704	G	A	5	2	7	0	0	7	0	0
8	125319976	rs4592012	G	A	5	2	7	0	0	7	0	0
8	125463090	rs77055381	T	C	5	4	9	0	0	9	0	0
8	125463544	rs11556913	T	C	9	11	20	0	0	20	0	0
8	125485201	rs1128757	T	C	5	2	7	0	0	7	0	0
8	125485728	rs10956185	T	G	2	4	6	0	1	7	0	0
8	125495619	rs191997048	T	C	2	9	11	0	0	11	0	0
8	125552276	rs7007115	T	C	3	4	7	0	0	7	0	0
8	125559807	rs6987343	C	A	5	1	6	0	0	6	0	0
8	125563695	.	C	T	9	15	24	0	0	24	0	0
8	125568623	rs3829036	A	G	25	30	55	0	0	55	0	0
8	125570144	rs4870903	G	A	5	3	8	0	1	9	0	0
8	125572577	rs3763539	G	C	7	4	11	0	0	11	0	0
8	125576082	rs10099056	A	G	2	4	6	0	0	6	0	0
8	125576094	rs10099060	A	G	2	6	8	0	0	8	0	0
8	125576228	rs139867272	C	T	1	5	6	0	0	6	0	0
8	125579973	rs6470251	C	T	4	3	7	0	0	7	0	0
8	125580338	rs7834261	C	T	6	2	8	0	0	8	0	0
8	125622532	rs4464955	A	C	5	1	6	0	0	6	0	0
8	125640964	rs4870915	G	A	3	3	6	0	0	6	0	0
8	125715572	rs140449972	C	T	2	5	7	0	0	7	0	0
8	126017572	rs55670884	T	C	10	13	23	0	0	23	0	0
8	126018285	rs7815636	C	T	1	7	8	0	0	8	0	0
8	126022485	rs79595312	G	A	4	4	8	0	0	8	0	0
8	126030809	rs966946	T	C	2	11	13	0	0	13	0	0
8	126031454	rs9297707	A	T	7	6	13	0	0	13	0	0
8	126031471	rs9297708	C	G	7	13	20	0	0	20	0	0
8	126031646	rs77493571	G	C	11	26	37	0	0	37	0	0
8	126033783	.	A	G	4	7	11	0	4	15	0	0
8	126037033	rs17398450	A	G	2	4	6	0	0	6	0	0
8	126040625	rs57886679	G	A	4	3	7	0	0	7	0	0
8	126043020	rs76375119	T	C	3	6	9	0	0	9	0	0
8	126044437	rs17398660	G	A	5	4	9	0	0	9	0	0
8	126054350	rs138314292	G	A	7	1	8	0	0	8	0	0
8	126083193	rs3860845	A	G	3	9	12	0	0	12	0	0
8	126085363	rs10102230	T	C	2	6	8	0	0	8	0	0
8	126442726	rs3201475	C	T	71	128	199	0	0	199	0	0
8	126442934	rs2280826	T	C	27	46	73	0	0	73	0	0
8	126443348	rs2385113	C	T	2	4	6	0	0	6	0	0
8	126444788	rs2980874	G	A	4	2	6	0	0	6	0	0
8	126445505	rs13277396	G	C	1	7	8	0	0	8	0	0
8	126447308	rs2385114	C	T	18	20	38	0	0	38	0	0
8	126447473	rs12546944	G	A	8	13	21	0	0	21	0	0
8	126447840	rs10094698	C	G	10	23	33	0	0	33	0	0
8	126448845	rs62521034	C	T	300	129	429	0	2	431	0	0
8	126449406	rs17405319	C	T	203	370	573	0	1	574	0	0
8	128826352	rs12216822	C	T	5	1	6	0	0	6	0	0
8	128903273	rs17189681	G	T	9	2	11	0	0	11	0	0
8	129009010	rs2303490	C	T	1	8	9	0	0	9	0	0
8	129009401	rs62512839	A	G	6	2	8	0	0	8	0	0
8	129009814	rs34575579	C	T	2	12	14	0	0	14	0	0
8	129011513	rs11781967	T	C	2	7	9	0	0	9	0	0
8	129014238	rs1426512	G	A	3	6	9	0	0	9	0	0
8	129026653	rs10956406	T	C	2	4	6	0	0	6	0	0
8	129102511	rs2720676	C	G	6	9	15	0	0	15	0	0
8	130365025	rs13258902	C	T	6	1	7	0	0	7	0	0
8	130411664	rs2568407	A	G	1	9	10	0	0	10	0	0
8	130411831	rs2579863	C	T	6	8	14	0	0	14	0	0
8	130898478	rs10103677	A	G	9	2	11	0	0	11	0	0
8	132980709	rs6471017	G	A	8	3	11	0	0	11	0	0
8	132980781	rs2270879	C	T	4	2	6	0	0	6	0	0
8	132980954	rs6471018	T	C	16	2	18	0	0	18	0	0
8	132982824	rs1051221	A	G	34	16	50	0	0	50	0	0
8	133002834	rs7826719	A	G	3	7	10	0	0	10	0	0
8	133003243	rs78556407	G	C	7	1	8	0	0	8	0	0
8	133003305	rs2012653	T	G	8	0	8	0	0	8	0	0
8	133006926	rs6471021	C	T	9	5	14	0	0	14	0	0
8	133011174	rs9656822	C	T	4	3	7	0	1	8	0	0
8	133018115	rs7011244	G	A	8	1	9	0	0	9	0	0
8	133018329	rs13278882	A	G	7	0	7	0	0	7	0	0
8	133020382	rs6993606	A	C	8	3	11	0	1	12	0	0
8	133020677	rs6471022	A	C	7	3	10	0	0	10	0	0
8	133023163	rs4736529	G	C	72	47	119	0	0	119	0	0
8	133023595	rs3763568	A	G	40	18	58	0	0	58	0	0
8	133024838	rs1051257	A	T	68	24	92	0	1	93	0	0
8	133821199	rs28409859	A	C	4	4	8	0	0	8	0	0
8	133858712	rs4736611	G	A	27	8	35	0	0	35	0	0
8	134048135	rs77272183	C	A	3	9	12	0	0	12	0	0
8	134049175	rs56229608	A	G	27	10	37	0	0	37	0	0
8	134049878	rs10106075	C	T	11	6	17	0	1	18	0	0
8	134254797	rs2929978	C	G	16	28	44	0	0	44	0	0
8	134256117	rs146750842	G	A	6	13	19	0	0	19	0	0
8	134258711	rs2233339	A	G	3	3	6	0	0	6	0	0
8	134260174	rs2227262	G	A	17	1	18	0	0	18	0	0
8	134263453	rs3779939	G	A	5	2	7	0	0	7	0	0
8	134264646	rs62514042	C	T	7	4	11	0	0	11	0	0
8	134265131	rs62514043	T	C	6	3	9	0	0	9	0	0
8	134265495	rs3779938	C	T	0	6	6	0	0	6	0	0
8	134265748	rs3779936	A	G	4	2	6	0	0	6	0	0
8	134266585	rs2233334	A	G	3	3	6	0	0	6	0	0
8	134266970	rs2272650	C	G	58	37	95	0	1	96	0	0
8	134267721	rs16904874	C	T	65	33	98	0	0	98	0	0
8	134267762	rs3824240	T	C	69	36	105	0	2	107	0	0
8	134267886	rs3808599	C	G	63	27	90	0	0	90	0	0
8	134268306	rs3779935	G	C	60	33	93	0	2	95	0	0
8	134470467	.	C	T	109	192	301	0	5	306	0	0
8	134470533	rs72718252	A	C	95	155	250	0	1	251	0	0
8	134470631	rs2142306	T	C	120	181	301	0	2	303	0	0
8	134474148	rs1048479	C	T	158	82	240	0	5	245	0	0
8	134487288	rs4736677	C	G	94	14	108	0	0	108	0	0
8	134487632	rs9642912	T	A	54	7	61	0	0	61	0	0
8	134487723	rs2737429	T	G	8	44	52	0	0	52	0	0
8	134487803	rs9643299	G	A	44	8	52	0	1	53	0	0
8	134488007	rs2230542	G	A	120	196	316	0	0	316	0	0
8	134488549	rs1048471	T	C	49	169	218	0	1	219	0	0
8	134489546	rs72718272	A	G	2	4	6	0	0	6	0	0
8	134490400	rs55888378	C	T	6	1	7	0	0	7	0	0
8	134494574	rs10110481	T	C	1	5	6	0	0	6	0	0
8	134501041	rs4736681	T	G	3	11	14	0	0	14	0	0
8	134501111	rs4736682	A	G	5	11	16	0	0	16	0	0
8	134507838	rs535421976	G	C	4	3	7	0	0	7	0	0
8	134509522	rs4736684	G	C	11	8	19	0	0	19	0	0
8	134509844	rs11783220	T	C	4	8	12	0	0	12	0	0
8	134579763	.	G	A	36	10	46	0	0	46	0	0
8	135490303	.	C	T	20	25	45	0	1	46	0	0
8	135809782	rs190663561	T	C	13	2	15	0	1	16	0	0
8	141106204	rs4289794	T	C	0	6	6	0	0	6	0	0
8	141516724	rs11774952	A	G	6	3	9	0	0	9	0	0
8	141516993	rs11775712	A	G	4	3	7	0	0	7	0	0
8	141525465	rs2231527	T	C	289	143	432	0	9	441	0	0
8	141526231	rs4961323	C	T	74	42	116	0	6	122	0	0
8	141526985	rs10216653	G	C	40	14	54	0	0	54	0	0
8	141533818	rs11595	A	G	53	33	86	0	0	86	0	0
8	141534840	rs3735794	A	G	26	33	59	0	0	59	0	0
8	141537241	rs6578113	G	A	28	33	61	0	0	61	0	0
8	141537406	rs2235117	T	C	31	28	59	0	0	59	0	0
8	141538846	rs2977453	T	C	11	30	41	0	0	41	0	0
8	141539182	rs28390280	C	T	22	24	46	0	1	48	1	0
8	141541288	rs2977461	C	T	5	6	11	0	1	12	0	0
8	141541888	rs1060832	C	T	99	183	282	0	3	285	0	0
8	141543037	rs62527823	C	T	3	8	11	0	0	11	0	0
8	141543380	rs2977463	T	C	3	7	10	0	0	10	0	0
8	141544459	rs3889329	G	C	18	6	24	0	0	24	0	0
8	141544472	rs3889330	G	C	19	6	25	0	0	25	0	0
8	141544748	rs3889488	A	G	4	5	9	0	0	9	0	0
8	141545193	rs2977464	C	T	3	15	18	0	0	18	0	0
8	141546602	rs2977466	T	C	3	15	18	0	0	18	0	0
8	141546623	rs11774884	A	G	18	6	24	0	0	24	0	0
8	141547226	rs10096598	T	C	9	7	16	0	0	16	0	0
8	141547352	rs67892703	G	A	17	10	27	0	0	27	0	0
8	141547712	rs2977467	T	C	8	12	20	0	0	20	0	0
8	141548419	rs2944772	C	G	9	15	24	0	0	24	0	0
8	141549383	rs13252337	A	G	4	6	10	0	0	10	0	0
8	141551407	rs2293939	G	A	202	111	313	0	2	315	0	0
8	141552183	rs2977474	C	T	3	4	7	0	0	7	0	0
8	141557880	rs2944767	G	A	3	10	13	0	0	13	0	0
8	141558632	rs2977479	G	C	3	9	12	0	2	14	0	0
8	141558980	rs2944766	C	T	4	12	16	0	0	16	0	0
8	141565396	rs2977483	T	C	0	12	12	0	0	12	0	0
8	141565764	rs2977484	T	C	4	6	10	0	0	10	0	0
8	141568622	rs2292778	G	A	83	166	249	0	1	250	0	0
8	141582896	rs13276958	T	C	84	64	148	0	0	148	0	0
8	141590355	rs7828287	C	T	0	6	6	0	0	6	0	0
8	141591893	rs11776034	C	G	6	2	8	0	0	8	0	0
8	141598947	rs62529971	C	T	14	19	33	0	0	33	0	0
8	141601128	rs62529972	T	C	3	8	11	0	1	12	0	0
8	141604230	rs11997990	A	G	5	5	10	0	0	10	0	0
8	141606345	rs6987875	G	A	3	3	6	0	0	6	0	0
8	141607050	rs80206530	C	T	24	12	36	0	0	36	0	0
8	141608273	rs62529975	C	T	4	5	9	0	0	9	0	0
8	141608786	rs62529976	T	C	2	5	7	0	0	7	0	0
8	141609046	rs4961274	C	T	1	5	6	0	0	6	0	0
8	141624719	rs4961277	T	C	4	3	7	0	0	7	0	0
8	141629397	rs13261055	A	G	6	0	6	0	0	6	0	0
8	141639628	rs7004365	G	A	6	1	7	0	0	7	0	0
8	141640294	rs10088596	T	C	4	3	7	0	0	7	0	0
8	141640382	rs11776968	G	T	7	2	9	0	0	9	0	0
8	142156032	rs565431142	C	G	8	5	13	0	0	13	0	0
8	142176507	rs412706	T	C	20	62	82	0	2	84	0	0
8	142176584	rs62522182	C	T	12	36	48	0	0	48	0	0
8	142182644	rs4961333	C	T	14	20	34	0	0	34	0	0
8	142182667	rs57258815	G	A	16	23	39	0	0	39	0	0
8	142183625	rs79150017	C	T	29	21	50	0	0	50	0	0
8	142185580	rs12675070	G	A	19	26	45	0	0	45	0	0
8	142185718	rs307733	T	C	22	38	60	0	1	61	0	0
8	142186573	rs307732	A	G	27	37	64	0	0	64	0	0
8	142186963	rs2241734	G	A	55	86	141	0	1	142	0	0
8	142188039	rs307731	C	T	42	66	108	0	0	108	0	0
8	142188707	rs12674965	A	T	58	109	167	0	1	168	0	0
8	142191032	rs2278448	T	G	11	31	42	0	0	42	0	0
8	142191748	rs10104549	T	G	21	15	36	0	0	36	0	0
8	142192648	rs10090848	C	T	39	23	62	0	0	62	0	0
8	142197681	rs3922678	G	A	9	40	49	0	0	49	0	0
8	142198270	rs12547067	G	A	38	21	59	0	0	59	0	0
8	142198596	rs7001673	G	T	95	34	129	0	0	130	1	0
8	142198682	rs6988366	T	C	86	40	126	0	0	126	0	0
8	142199400	rs3739226	G	A	29	12	41	0	0	41	0	0
8	142200467	rs1045303	G	A	289	154	443	0	6	449	0	0
8	142200731	rs2288997	C	T	95	42	137	0	1	138	0	0
8	142202856	rs6990186	C	T	81	36	117	0	0	117	0	0
8	142202884	rs7014062	T	C	80	33	113	0	1	114	0	0
8	142205132	rs11579	G	A	399	137	536	0	4	540	0	0
8	142205149	rs67745429	C	T	366	159	525	0	5	530	0	0
8	142205237	rs9792	A	G	378	178	556	0	10	566	0	0
8	142221032	rs13724	C	T	33	24	57	0	4	61	0	0
8	142221361	rs3739241	C	G	20	15	35	0	0	35	0	0
8	142221414	rs3739240	G	A	27	13	40	0	0	40	0	0
8	142222374	rs7017848	A	G	32	11	43	0	0	43	0	0
8	142222445	rs3739238	T	C	29	15	44	0	0	44	0	0
8	142227592	rs10107024	T	C	9	2	11	0	0	11	0	0
8	142227854	rs9324542	T	A	3	3	6	0	0	6	0	0
8	142228809	rs753779	T	C	10	7	17	0	0	17	0	0
8	142228909	rs753778	G	A	7	4	11	0	0	11	0	0
8	142229891	rs2304279	A	G	6	4	10	0	0	10	0	0
8	142232878	rs4961258	G	A	3	3	6	0	0	6	0	0
8	142252580	rs13257363	G	A	1	10	11	0	0	11	0	0
8	142252758	rs67811951	C	T	4	2	6	0	0	6	0	0
8	142259829	rs2060357	G	A	3	10	13	0	0	13	0	0
8	142260162	rs12543661	C	T	10	2	12	0	0	12	0	0
8	142260880	rs12375300	C	T	14	1	15	0	0	15	0	0
8	142260995	rs10093988	T	C	4	4	8	0	0	8	0	0
8	142261621	rs11778579	C	T	3	10	13	0	0	13	0	0
8	142261967	rs28506950	C	T	2	8	10	0	1	11	0	0
8	142262081	rs4961343	G	A	7	1	8	0	0	8	0	0
8	142263074	rs72681579	G	A	5	17	22	0	0	22	0	0
8	142263171	rs28643551	C	T	7	13	20	0	0	20	0	0
8	142263264	rs72681581	G	A	21	2	23	0	0	23	0	0
8	142263891	rs7812916	T	C	16	8	24	0	0	24	0	0
8	142277820	.	G	A	1	5	6	0	0	6	0	0
8	142317365	rs35583962	T	C	10	11	21	0	0	21	0	0
8	142317560	rs7008089	C	T	11	8	19	0	0	19	0	0
8	142317608	rs59295278	A	G	10	10	20	0	1	21	0	0
8	143351567	rs12675715	T	G	22	13	35	0	0	35	0	0
8	143352206	rs28472969	T	C	60	33	93	0	1	94	0	0
8	143352528	rs7014279	A	C	57	24	81	0	1	82	0	0
8	143352779	rs34066697	T	C	40	15	55	0	3	58	0	0
8	143352805	rs55667547	T	C	49	19	68	0	2	70	0	0
8	143357960	rs6983847	T	C	2	4	6	0	0	6	0	0
8	143358225	rs72687360	A	G	3	3	6	0	0	6	0	0
8	143358316	rs72687362	C	A	4	7	11	0	0	11	0	0
8	143361267	rs4976990	A	G	8	6	14	0	0	14	0	0
8	143381810	rs7822013	T	C	31	23	54	0	1	55	0	0
8	143404680	.	G	A	3	3	6	0	0	6	0	0
8	144103467	rs11547124	C	T	555	1063	1618	0	12	1630	0	0
8	144333315	rs4570175	G	A	9	7	16	0	0	16	0	0
8	144333434	rs4348512	G	A	6	9	15	0	1	16	0	0
8	144342831	rs3750212	G	A	3	10	13	0	0	13	0	0
8	144343133	rs7388478	T	C	0	8	8	0	0	8	0	0
8	144344456	rs1056449	T	C	2	6	8	0	0	8	0	0
8	144346229	rs3750216	C	T	2	5	7	0	0	7	0	0
8	144352116	rs7387960	G	A	3	3	6	0	0	6	0	0
8	144356442	rs4487796	C	G	3	3	6	0	0	6	0	0
8	144356714	rs34602612	C	T	7	1	8	0	0	8	0	0
8	144357720	rs3829017	C	T	5	4	9	0	0	9	0	0
8	144357992	rs2293923	A	G	1	8	9	0	0	9	0	0
8	144358381	rs1056148	G	A	5	9	14	0	0	14	0	0
8	144362674	rs1063753	C	G	2	5	7	0	0	7	0	0
8	144378184	rs2235115	C	G	3	5	8	0	0	8	0	0
8	144379689	rs7387702	G	A	2	5	7	0	0	7	0	0
8	144379934	rs7386378	C	T	4	4	8	0	0	8	0	0
8	144392368	rs2293925	G	A	110	494	604	0	9	614	1	0
8	144394845	rs12156025	A	T	1	12	13	0	0	13	0	0
8	144394912	rs66613637	T	A	11	1	12	0	0	12	0	0
8	144394987	rs34589890	T	C	13	0	13	0	0	13	0	0
8	144396620	rs34719060	C	T	48	5	53	0	0	53	0	0
8	144397044	rs13274702	T	C	1	7	8	0	0	8	0	0
8	144397065	rs57383258	A	G	7	1	8	0	0	8	0	0
8	144397097	rs13265898	A	G	1	8	9	0	0	9	0	0
8	144397558	rs13260981	G	A	3	11	14	0	0	14	0	0
8	144397570	rs13260989	G	A	3	11	14	0	0	14	0	0
8	144397688	rs28437861	C	T	12	1	13	0	0	13	0	0
8	144397696	rs28432960	A	G	11	1	12	0	0	12	0	0
8	144398396	rs2293926	C	T	1	16	17	0	0	17	0	0
8	144403449	rs61631623	G	A	362	74	436	0	3	439	0	0
8	144413416	rs2450772	G	A	372	70	442	0	5	447	0	0
8	144449708	rs4874104	G	A	3	11	14	0	0	14	0	0
8	144457746	rs34876718	C	A	26	3	29	0	0	30	1	0
8	144462169	rs3812440	A	G	5	2	7	0	0	7	0	0
8	144463267	rs13275994	C	T	0	10	10	0	0	10	0	0
8	144463686	rs3817720	C	T	3	17	20	0	0	20	0	0
8	144465285	rs3814772	C	A	24	1	25	0	0	25	0	0
8	144465385	rs3814770	G	C	2	15	17	0	0	17	0	0
8	144465614	rs3814769	G	A	0	19	19	0	0	19	0	0
8	144465902	rs111379476	G	A	0	16	16	0	0	16	0	0
8	144520147	rs2294117	G	A	140	271	411	0	2	413	0	0
8	144522387	rs2272754	G	T	86	183	269	0	1	270	0	0
8	144522388	rs2272753	A	T	86	182	268	0	2	270	0	0
8	144551142	rs2294118	G	T	23	11	34	0	0	34	0	0
8	144552610	rs28549005	C	T	26	13	39	0	2	41	0	0
8	144554143	rs59809057	G	A	14	12	26	0	0	26	0	0
8	144554746	rs2004099	G	T	9	29	38	0	0	38	0	0
8	144555482	rs403939	T	C	5	19	24	0	0	24	0	0
8	144556836	rs61251648	G	A	9	23	32	0	0	32	0	0
8	144561970	.	G	C	1	6	7	0	0	7	0	0
8	144565421	rs61206940	C	T	5	1	6	0	0	6	0	0
8	144620342	rs1318196	T	C	175	97	272	0	5	277	0	0
8	144620855	rs4873802	C	A	178	59	237	0	1	238	0	0
8	144621084	rs3750207	T	G	147	72	219	0	2	221	0	0
8	144624438	rs6991958	C	T	33	3	36	0	0	36	0	0
8	144635394	rs34146789	T	C	9	2	11	0	0	11	0	0
8	144639537	.	C	A	104	0	104	0	2	106	0	0
8	144639548	rs374284757	G	A	104	2	106	0	4	110	0	0
8	144639552	.	A	C	103	7	110	0	4	114	0	0
8	144639553	.	G	A	107	7	114	0	2	116	0	0
8	144639952	rs7813970	C	T	23	77	100	0	0	100	0	0
8	144641313	rs7840166	G	A	43	12	55	0	0	55	0	0
8	144641753	rs4874151	A	C	28	84	112	0	0	113	1	0
8	144642244	rs73375262	A	G	119	36	155	0	0	155	0	0
8	144642490	rs73375263	G	A	281	90	371	0	3	374	0	0
8	144642854	rs11551202	G	A	221	96	317	0	1	318	0	0
8	144643321	rs12541790	A	G	155	56	211	0	3	214	0	0
8	144643603	rs2290414	G	A	44	10	54	0	0	54	0	0
8	144643815	rs13255282	G	C	57	23	80	0	0	80	0	0
8	144644405	rs11551198	G	A	151	315	466	0	4	470	0	0
8	144644583	rs1349806	G	C	49	12	61	0	0	61	0	0
8	144644787	rs1377663	T	A	91	39	130	0	0	130	0	0
8	144648509	rs12168	C	T	63	134	197	0	1	198	0	0
8	144648642	rs896946	A	G	194	102	296	0	0	296	0	0
8	144649156	rs10102146	G	A	48	66	114	0	2	116	0	0
8	144649157	rs10097065	T	A	47	63	110	0	5	115	0	0
8	144649192	rs11775744	A	G	65	43	108	0	2	110	0	0
8	144650503	rs13271361	G	A	23	11	34	0	0	34	0	0
8	144650925	rs13279011	A	T	2	12	14	0	0	14	0	0
8	144651062	rs80190095	A	G	14	2	16	0	0	16	0	0
8	144652281	rs11990325	T	A	6	7	13	0	0	13	0	0
8	144654249	rs10866911	G	A	9	25	34	0	0	34	0	0
8	144654255	rs4874153	A	G	9	24	33	0	0	33	0	0
8	144654594	rs4873803	G	T	10	14	24	0	0	24	0	0
8	144656187	rs12546272	C	T	6	20	26	0	0	26	0	0
8	144656344	rs4873805	T	C	14	17	31	0	0	31	0	0
8	144656754	rs4606077	T	C	8	10	18	0	0	18	0	0
8	144656765	rs1869434	G	A	8	12	20	0	0	20	0	0
8	144657269	rs2290417	G	C	41	129	170	0	2	172	0	0
8	144657801	rs9771743	G	A	552	180	732	0	8	740	0	0
8	144658711	rs872935	G	A	197	414	611	0	1	612	0	0
8	144659608	rs12678314	A	G	3	5	8	0	0	8	0	0
8	144660046	rs896954	G	A	107	41	148	0	0	148	0	0
8	144660189	rs896953	A	G	26	84	110	0	12	122	0	0
8	144662353	rs1062391	G	A	2100	4327	6427	0	19	6446	0	0
8	144663661	rs2123758	G	A	20	55	75	0	0	75	0	0
8	144663945	rs141919824	C	T	66	19	85	0	2	87	0	0
8	144664319	rs1563148	C	G	23	40	63	0	1	64	0	0
8	144664594	rs3793368	C	T	36	75	111	0	2	113	0	0
8	144664624	rs3793367	C	T	30	60	90	0	1	91	0	0
8	144664808	rs10099131	C	T	29	46	75	0	0	75	0	0
8	144664818	rs10099134	C	T	29	45	74	0	1	75	0	0
8	144665111	rs73379021	G	A	59	25	84	0	1	85	0	0
8	144665680	rs28606985	C	A	33	13	46	0	0	47	1	0
8	144668811	rs113484128	T	A	26	13	39	0	1	40	0	0
8	144669636	rs6996863	A	C	13	5	18	0	0	18	0	0
8	144678874	rs2242095	C	T	7	2	9	0	0	9	0	0
8	144682004	rs111956838	C	T	24	36	60	0	0	60	0	0
8	144682428	rs112637095	C	T	14	8	22	0	0	22	0	0
8	144684514	rs73367293	C	T	19	8	27	0	0	27	0	0
8	144684702	rs73718114	C	T	11	5	16	0	0	16	0	0
8	144718254	rs1540558	G	C	2	7	9	0	0	9	0	0
8	144775871	rs6987308	C	A	29	11	40	0	0	40	0	0
8	144776713	rs7464270	A	C	27	5	32	0	0	32	0	0
8	144777073	rs61348167	C	T	3	19	22	0	0	22	0	0
8	144777242	rs3204170	T	C	9	22	31	0	0	31	0	0
8	144777366	rs3204171	T	C	27	11	38	0	0	38	0	0
8	144777521	rs11136316	G	A	10	2	12	0	1	13	0	0
8	144807456	rs4072459	C	T	2	6	8	0	0	8	0	0
8	144807744	rs3934952	G	A	2	5	7	0	0	7	0	0
8	144886628	rs34099611	C	T	5	9	14	0	0	14	0	0
8	144893084	rs6558394	G	A	114	44	158	0	2	160	0	0
8	144902246	rs7835924	C	T	29	13	42	0	0	42	0	0
8	144917790	rs11774027	A	G	12	14	26	0	0	26	0	0
8	144989462	rs7155	A	G	173	116	289	0	3	292	0	0
8	144995736	rs11777402	G	A	41	42	83	0	1	84	0	0
8	144996029	rs7833924	A	G	33	52	85	0	0	85	0	0
8	144996408	rs11778026	T	G	40	39	79	0	2	81	0	0
8	144997656	rs7016416	C	T	5	6	11	0	0	11	0	0
8	144997927	rs7002002	G	A	12	8	20	0	0	20	0	0
8	144999621	rs55646585	C	T	3	6	9	0	0	9	0	0
8	144999642	rs56117011	A	C	2	5	7	0	1	8	0	0
8	144999684	rs35916068	A	G	3	5	8	0	0	8	0	0
8	145000221	rs7016860	G	A	1	5	6	0	0	6	0	0
8	145000602	rs7006770	T	C	6	5	11	0	0	11	0	0
8	145000740	rs7017644	G	A	4	5	9	0	0	9	0	0
8	145000809	rs7017789	G	A	5	2	7	0	0	7	0	0
8	145000898	rs56401829	A	G	3	4	7	0	0	7	0	0
8	145001031	rs55895668	T	C	48	73	121	0	0	121	0	0
8	145001784	rs3135109	A	G	6	7	13	0	0	13	0	0
8	145002283	rs11993233	A	G	8	7	15	0	0	15	0	0
8	145002431	rs62522555	C	G	10	8	18	0	0	18	0	0
8	145002536	rs72693398	G	A	7	4	11	0	0	11	0	0
8	145002832	.	C	T	11	3	14	0	1	15	0	0
8	145007187	rs11136336	G	A	18	28	46	0	0	46	0	0
8	145008560	rs11783799	A	G	21	29	50	0	2	52	0	0
8	145008931	rs6994460	G	C	4	6	10	0	0	10	0	0
8	145010752	rs11784417	C	T	5	3	8	0	0	8	0	0
8	145011204	rs6993938	A	G	29	16	45	0	0	45	0	0
8	145051414	rs1134027	G	A	27	40	67	0	3	70	0	0
8	145051478	rs1134029	G	A	25	39	64	0	2	66	0	0
8	145051484	rs1134030	C	T	26	39	65	0	3	68	0	0
8	145055677	.	G	A	6	4	10	0	1	11	0	0
8	145057868	rs11544989	A	G	70	104	174	0	1	175	0	0
8	145058037	rs11989052	A	G	18	17	35	0	0	35	0	0
8	145058986	rs11136343	A	G	62	87	149	0	0	149	0	0
8	145059425	rs11136344	T	C	57	62	119	0	1	120	0	0
8	145060112	rs11136345	G	A	37	55	92	0	0	92	0	0
8	145066853	rs56261297	C	T	20	29	49	0	0	49	0	0
8	145067467	rs9100	G	T	146	162	308	0	1	310	1	0
8	145137569	.	C	G	23	7	30	0	0	30	0	0
8	145538010	.	G	A	227	478	705	0	10	716	1	0
8	145541766	rs55962377	G	T	58	129	187	0	1	188	0	0
8	145580984	rs2272666	A	G	7	1	8	0	0	8	0	0
8	145581005	rs115001185	G	T	5	1	6	0	0	6	0	0
8	145581024	rs116687799	C	T	7	1	8	0	0	8	0	0
8	145603114	rs6599528	A	C	11	1	12	0	1	13	0	0
8	145621556	rs2280836	A	G	26	2	28	0	1	29	0	0
8	145622923	rs2977835	T	C	4	2	6	0	0	6	0	0
8	145623098	rs2977834	T	C	8	1	9	0	0	9	0	0
8	145649531	rs186367372	C	T	25	10	35	0	1	36	0	0
8	145654297	rs185364624	G	C	20	19	39	0	1	40	0	0
8	145659553	rs139227363	G	A	11	11	22	0	0	22	0	0
8	145661320	rs2721140	G	A	5	11	16	0	0	16	0	0
8	145661675	rs7830832	G	A	7	8	15	0	0	15	0	0
8	145662377	rs2242270	A	C	4	3	7	0	0	7	0	0
8	145665407	rs2229315	C	T	6	6	12	0	0	12	0	0
8	145665761	rs2229313	G	A	4	7	11	0	0	11	0	0
8	145675164	rs2620654	T	C	3	17	20	0	0	20	0	0
8	145675491	rs2721193	G	T	9	20	29	0	1	30	0	0
8	145677469	rs2245052	A	G	40	53	93	0	1	94	0	0
8	145679080	rs2620656	C	T	11	21	32	0	1	33	0	0
8	145680456	rs13251458	G	A	4	15	19	0	0	19	0	0
8	145681395	rs115128138	C	A	18	8	26	0	0	26	0	0
8	145681952	rs113957849	A	G	18	4	22	0	0	22	0	0
8	145682115	rs748193	C	T	11	7	18	0	1	19	0	0
8	145682375	rs748194	T	A	10	21	31	0	2	33	0	0
8	145683465	rs11993220	G	A	12	6	18	0	0	18	0	0
8	145683750	rs56741258	C	T	15	9	24	0	0	24	0	0
8	145684012	rs57560374	T	C	11	11	22	0	0	22	0	0
8	145684031	rs1985022	C	T	16	11	27	0	0	27	0	0
8	145684678	rs2620658	A	C	5	14	19	0	0	19	0	0
8	145684679	rs2620659	A	C	5	14	19	0	0	19	0	0
8	145684900	.	C	T	16	5	21	0	0	21	0	0
8	145685515	rs111503277	G	A	13	10	23	0	0	23	0	0
8	145686261	rs2620662	C	T	11	6	17	0	0	17	0	0
8	145686313	rs4925809	C	T	10	5	15	0	0	15	0	0
8	145687118	rs2620663	C	G	4	7	11	0	0	11	0	0
8	145687475	rs10108150	G	A	4	4	8	0	0	8	0	0
8	145689597	rs77204173	C	G	37	16	53	0	0	53	0	0
8	145689915	rs2721167	G	A	29	34	63	0	1	64	0	0
8	145690308	rs2721166	C	T	40	33	73	0	1	74	0	0
8	145690348	rs2620644	G	A	32	32	64	0	2	66	0	0
8	145690960	rs189769605	G	T	11	7	18	0	0	18	0	0
8	145690987	rs180700374	G	T	11	6	17	0	1	18	0	0
8	145692385	rs2250891	C	T	4	3	7	0	0	7	0	0
8	145724450	rs115230836	G	A	4	3	7	0	0	7	0	0
8	145737816	rs4251691	C	T	16	23	39	0	0	39	0	0
8	145741702	rs4244612	C	G	14	16	30	0	0	30	0	0
8	145741765	rs4244613	G	A	10	14	24	0	0	24	0	0
8	145747597	rs3757965	G	A	28	16	44	0	0	44	0	0
8	145748753	rs2620651	A	C	22	13	35	0	0	35	0	0
8	145946773	.	T	A	40	16	56	0	1	57	0	0
8	145947131	rs113275959	T	C	46	16	62	0	0	62	0	0
8	146016250	.	G	A	14	12	26	0	0	26	0	0
8	146017032	rs2954657	C	T	16	6	22	0	0	22	0	0
8	146032685	rs113318407	G	C	13	8	21	0	0	21	0	0
8	146034379	rs2954668	T	C	7	3	10	0	1	11	0	0
8	146034733	rs2954669	T	C	13	9	22	0	0	22	0	0
8	146054703	rs1735157	C	T	1	7	8	0	0	8	0	0
8	146063569	.	G	A	39	35	74	0	1	75	0	0
8	146063649	.	C	T	40	29	69	0	1	70	0	0
8	146063854	rs7839569	A	G	21	24	45	0	1	46	0	0
8	146064103	rs2727230	G	A	22	20	42	0	0	42	0	0
8	146064154	rs2722490	T	C	15	11	26	0	0	26	0	0
8	146064157	rs1810387	G	C	15	11	26	0	1	27	0	0
8	146065452	rs1735167	C	T	10	7	17	0	0	17	0	0
8	146066031	rs1618523	C	T	17	22	39	0	0	39	0	0
8	146066053	rs1625919	T	C	17	21	38	0	0	38	0	0
8	146066491	.	C	T	23	12	35	0	0	35	0	0
8	146066508	rs2242651	T	C	13	19	32	0	0	32	0	0
8	146067054	rs1735169	G	A	33	36	69	0	0	69	0	0
8	146067502	.	G	A	24	21	45	0	1	46	0	0
8	146068322	rs9004	C	T	16	27	43	0	1	44	0	0
8	146072741	.	C	T	3	3	6	0	0	6	0	0
8	146075832	rs1209881	T	G	15	21	36	0	1	37	0	0
8	146076708	rs1209879	C	T	36	90	126	0	1	127	0	0
8	146077942	rs13252601	G	A	4	3	7	0	0	7	0	0
8	146078864	rs1209874	C	T	20	20	40	0	0	40	0	0
8	146156247	rs3735789	C	A	16	12	28	0	0	28	0	0
8	146200438	rs10104365	G	T	7	1	8	0	0	8	0	0
8	146200492	rs2979290	G	A	4	2	6	0	0	6	0	0
8	146203346	rs12678688	T	G	3	3	6	0	0	6	0	0
8	146221893	rs4302882	A	G	5	1	6	0	0	6	0	0
8	146278038	.	G	A	81	52	133	0	0	133	0	0
8	146279480	.	T	G	128	68	196	0	11	207	0	0
8	146279567	.	C	T	156	67	223	0	1	224	0	0
8	146279994	.	A	G	112	84	196	0	1	197	0	0
8	146280113	.	A	C	87	53	140	0	1	141	0	0
8	146280471	rs7828404	T	C	128	62	190	0	1	191	0	0
8	146280802	rs6986329	C	T	95	145	240	0	0	240	0	0
9	14810	.	C	G	61	16	77	0	1	78	0	0
9	14926	.	C	T	3	6	9	0	0	9	0	0
9	2016335	.	C	G	2	7	9	0	0	9	0	0
9	2018825	rs10964427	A	C	5	4	9	0	0	9	0	0
9	2021655	rs12550848	G	T	6	4	10	0	0	10	0	0
9	2021775	rs116656882	G	C	5	8	13	0	0	13	0	0
9	2021814	rs10081726	C	T	10	6	16	0	0	16	0	0
9	2023174	rs112859330	A	G	6	4	10	0	0	10	0	0
9	2024076	rs6475412	T	C	4	2	6	0	0	6	0	0
9	2029454	rs7864163	C	A	3	3	6	0	0	6	0	0
9	2034273	.	C	A	16	0	16	0	4	21	1	0
9	2039213	rs12347430	A	G	3	5	8	0	0	8	0	0
9	2039411	rs73377070	T	C	16	18	34	0	0	34	0	0
9	2039973	rs10964527	C	T	166	235	401	0	3	404	0	0
9	2039983	rs10964528	A	C	175	240	415	0	1	416	0	0
9	2040625	rs3793481	A	T	123	151	274	0	1	276	1	0
9	2040973	rs7865562	G	A	308	213	521	0	3	524	0	0
9	2041317	rs10964532	T	A	269	197	466	0	2	468	0	0
9	2041588	rs10964533	T	G	366	432	798	0	5	803	0	0
9	2043096	rs60117554	T	G	73	74	147	0	3	150	0	0
9	2043406	rs12552433	C	T	159	156	315	0	2	317	0	0
9	2044606	rs12005594	G	T	192	184	376	0	1	377	0	0
9	2044655	rs12003764	A	G	241	203	444	0	4	448	0	0
9	2045653	rs7045571	A	G	82	96	178	0	1	179	0	0
9	2073292	rs13288443	A	G	75	65	140	0	0	140	0	0
9	2171906	rs10965084	G	T	7	1	8	0	0	8	0	0
9	2172103	rs10965085	C	T	6	2	8	0	0	8	0	0
9	2173296	rs7048976	G	T	2	4	6	0	0	6	0	0
9	2179882	rs56340549	G	C	3	3	6	0	0	6	0	0
9	2180098	rs56047307	G	C	2	4	6	0	0	6	0	0
9	2180149	rs1547635	G	A	3	4	7	0	0	7	0	0
9	2180510	rs10965112	A	G	3	5	8	0	0	8	0	0
9	2180603	rs10122778	T	C	8	2	10	0	0	10	0	0
9	2183663	rs1324198	C	T	10	1	11	0	0	11	0	0
9	2184200	rs117036926	C	T	11	0	11	0	0	11	0	0
9	2184863	rs7870792	G	T	7	0	7	0	0	7	0	0
9	2192405	rs7868088	A	G	4	4	8	0	0	8	0	0
9	2644954	rs11789583	C	T	4	3	7	0	0	7	0	0
9	2648773	rs6148	A	G	5	14	19	0	0	19	0	0
9	2650804	rs191283726	C	T	4	2	6	0	0	6	0	0
9	2650914	rs36036004	G	A	5	1	6	0	0	6	0	0
9	2651962	rs6145	G	T	3	4	7	0	0	7	0	0
9	2652589	rs35075133	C	T	4	3	7	0	0	7	0	0
9	2654419	rs8210	T	C	7	2	9	0	0	9	0	0
9	2654778	rs183154872	A	T	3	3	6	0	0	6	0	0
9	2655702	rs35456336	T	C	5	4	9	0	0	9	0	0
9	2801706	rs12001327	T	C	2	5	7	0	0	7	0	0
9	3527105	rs117170685	T	G	5	3	8	0	0	8	0	0
9	3530375	rs7042747	A	G	6	2	8	0	0	8	0	0
9	3532309	rs74690135	C	G	6	7	13	0	0	13	0	0
9	3532437	rs1133463	A	G	3	3	6	0	0	6	0	0
9	4654730	rs6476882	G	A	5	1	6	0	0	6	0	0
9	4664836	rs2295962	A	T	1	6	7	0	0	7	0	0
9	4664852	rs2295963	A	G	1	6	7	0	0	7	0	0
9	4676745	rs184205	G	C	6	3	9	0	0	9	0	0
9	4679906	rs2295964	A	G	2	5	7	0	0	7	0	0
9	4680014	rs2295965	A	G	1	5	6	0	0	6	0	0
9	4693368	rs7039213	A	G	2	6	8	0	0	8	0	0
9	4706214	rs2181341	C	T	19	22	41	0	0	41	0	0
9	4706366	rs3174298	T	C	4	8	12	0	0	12	0	0
9	4726228	rs7033866	T	C	6	1	7	0	0	7	0	0
9	4726267	rs116891836	T	G	6	1	7	0	0	7	0	0
9	4726269	rs439835	T	C	6	1	7	0	0	7	0	0
9	4726367	rs10974751	A	G	4	2	6	0	0	6	0	0
9	4726478	rs7034145	T	C	3	8	11	0	0	11	0	0
9	4726759	rs62544266	G	A	4	2	6	0	0	6	0	0
9	4727113	rs7862134	A	C	2	4	6	0	0	6	0	0
9	4727423	rs4442190	T	C	5	4	9	0	0	9	0	0
9	4727562	rs4615631	C	T	3	3	6	0	0	6	0	0
9	4727775	rs4394450	T	C	5	3	8	0	0	8	0	0
9	4740128	rs12349358	T	C	3	4	7	0	0	7	0	0
9	4740520	rs1756865	C	G	5	2	7	0	0	7	0	0
9	4818167	rs10815090	C	T	8	3	11	0	1	12	0	0
9	4852599	rs10758656	A	G	3	3	6	0	1	7	0	0
9	4853198	rs462409	C	T	2	4	6	0	0	6	0	0
9	4858694	rs62543480	A	G	4	2	6	0	1	7	0	0
9	4860300	rs15583	A	G	115	97	212	0	5	217	0	0
9	4860569	rs1260073	G	A	35	33	68	0	0	68	0	0
9	4860964	rs10072	T	C	20	23	43	0	0	43	0	0
9	4860980	rs1053889	G	A	15	22	37	0	0	37	0	0
9	5021140	rs12346093	T	A	4	3	7	0	0	7	0	0
9	5025746	rs10124627	T	G	3	3	6	0	0	6	0	0
9	5050369	rs1028912	G	C	7	2	9	0	0	9	0	0
9	5050706	rs2230722	C	T	31	29	60	0	0	60	0	0
9	5068520	rs3780365	T	C	3	6	9	0	0	9	0	0
9	5081780	rs2230724	G	A	26	24	50	0	0	50	0	0
9	5103450	rs7022333	A	G	9	2	11	0	0	11	0	0
9	5104402	rs11506663	T	C	5	4	9	0	0	9	0	0
9	5106610	rs7019858	C	T	4	6	10	0	0	10	0	0
9	5106648	rs10974964	C	T	10	6	16	0	0	16	0	0
9	5106775	rs12340894	C	A	12	5	17	0	0	17	0	0
9	5126913	rs41314565	G	A	18	14	32	0	1	33	0	0
9	5136434	rs2094393	G	A	5	2	7	0	0	7	0	0
9	5137893	rs10283582	A	G	4	3	7	0	0	7	0	0
9	5138404	rs12336875	C	A	3	4	7	0	0	7	0	0
9	5630344	rs10815254	C	T	44	51	95	0	1	96	0	0
9	5710774	rs7872200	G	A	5	7	12	0	0	12	0	0
9	5710789	rs146005027	G	A	7	6	13	0	0	13	0	0
9	5711731	rs10123593	C	T	5	10	15	0	0	15	0	0
9	5711744	rs10117273	G	A	5	10	15	0	1	16	0	0
9	5711847	rs10123610	C	T	7	8	15	0	0	15	0	0
9	5757363	.	G	A	50	28	78	0	0	78	0	0
9	5805741	rs35643913	C	T	41	36	77	0	2	79	0	0
9	5832928	rs13283149	G	C	7	8	15	0	0	15	0	0
9	5969249	rs10739080	A	G	14	25	39	0	0	39	0	0
9	6011335	rs7425	T	C	12	20	32	0	2	34	0	0
9	6011757	rs10758736	G	A	48	58	106	0	1	107	0	0
9	6012734	rs106033	A	C	62	55	117	0	1	118	0	0
9	6488807	rs118135606	T	G	4	4	8	0	0	8	0	0
9	6806920	.	G	C	1	7	8	0	0	8	0	0
9	6984172	rs10815499	G	A	33	20	53	0	0	53	0	0
9	6986464	rs35826653	G	C	17	36	53	0	0	53	0	0
9	7013909	rs35389625	A	G	16	24	40	0	0	40	0	0
9	7077514	rs16925292	T	C	3	4	7	0	0	7	0	0
9	7103816	rs3763651	C	T	12	12	24	0	0	24	0	0
9	7172754	rs78047002	G	C	2	5	7	0	0	7	0	0
9	7174673	rs913588	G	A	20	25	45	0	0	45	0	0
9	7174773	rs913589	G	A	34	33	67	0	1	68	0	0
9	7174813	rs10976088	T	A	21	21	42	0	1	43	0	0
9	7174898	rs913590	C	A	17	31	48	0	0	48	0	0
9	7477728	rs12683102	T	C	10	0	10	0	1	11	0	0
9	15464743	rs2665515	G	A	69	55	124	0	1	125	0	0
9	15466337	rs1882939	T	C	2	6	8	0	0	8	0	0
9	15467175	rs909323	T	G	4	9	13	0	0	13	0	0
9	15467817	rs2665512	A	G	7	6	13	0	0	13	0	0
9	15467902	rs2665511	A	C	6	11	17	0	0	17	0	0
9	15467950	rs2821533	G	C	7	9	16	0	0	16	0	0
9	15467963	rs2665510	A	G	7	10	17	0	0	17	0	0
9	15468174	rs2795124	G	A	7	6	13	0	0	13	0	0
9	15468480	rs4741507	T	C	12	4	16	0	0	16	0	0
9	15472056	rs2795125	G	C	5	7	12	0	0	12	0	0
9	15472139	rs2777950	C	T	10	13	23	0	0	23	0	0
9	15476524	rs741930	G	A	3	8	11	0	0	11	0	0
9	15486870	rs2821529	A	G	136	171	307	0	1	308	0	0
9	15487248	.	G	A	3	5	8	0	0	8	0	0
9	15488633	rs2737840	C	T	5	4	9	0	0	9	0	0
9	15492061	rs10738398	C	T	14	9	23	0	0	23	0	0
9	15492720	rs12350062	C	T	5	15	20	0	0	20	0	0
9	15500150	rs10283923	C	G	4	2	6	0	0	6	0	0
9	15500315	rs10283927	C	T	3	3	6	0	0	6	0	0
9	15501422	rs2175257	G	A	5	4	9	0	0	9	0	0
9	15501439	rs76963301	G	A	5	4	9	0	0	9	0	0
9	15501713	rs12336503	C	T	3	3	6	0	0	6	0	0
9	15501753	rs12336509	C	T	12	4	16	0	0	16	0	0
9	15571630	rs443563	T	A	4	15	19	0	0	19	0	0
9	15744297	.	C	A	3	5	8	0	0	8	0	0
9	15784631	rs1539172	A	G	12	4	16	0	0	16	0	0
9	15922110	.	A	T	0	7	7	0	0	7	0	0
9	15922137	rs1328285	A	G	7	2	9	0	0	9	0	0
9	19109494	rs143187871	G	C	6	6	12	0	0	12	0	0
9	19200511	rs10811136	C	T	31	1	32	0	2	34	0	0
9	19200530	rs13289762	A	G	1	23	24	0	14	38	0	0
9	19230739	rs10481512	C	T	20	16	36	0	0	36	0	0
9	19234908	rs1329731	A	G	4	8	12	0	0	12	0	0
9	19235047	rs1854552	C	T	17	9	26	0	0	26	0	0
9	19241791	rs67295891	C	T	5	2	7	0	0	7	0	0
9	19287707	rs118065356	C	T	16	12	28	0	0	28	0	0
9	19308145	rs10757052	G	T	7	1	8	0	0	8	0	0
9	19333480	rs118115338	C	T	6	9	15	0	0	15	0	0
9	19341045	rs928128	A	G	20	24	44	0	0	44	0	0
9	19343346	rs6475321	T	C	10	1	11	0	0	11	0	0
9	19376408	rs2277151	A	G	1	6	7	0	0	7	0	0
9	19380239	rs41270113	A	T	5	11	16	0	0	16	0	0
9	20658518	rs12336224	C	A	19	0	19	0	0	19	0	0
9	20875453	rs12377926	G	A	3	5	8	0	0	8	0	0
9	21004244	rs55992749	G	A	36	33	69	0	1	70	0	0
9	21005422	rs59467007	G	A	41	35	76	0	1	77	0	0
9	21816758	rs7023954	G	A	10	11	21	0	0	21	0	0
9	21864098	rs10117507	G	A	5	2	7	0	0	7	0	0
9	21864535	rs3802394	A	G	5	2	7	0	0	7	0	0
9	21865106	rs4977735	T	C	7	4	11	0	0	11	0	0
9	21931642	rs4977570	G	T	2	5	7	0	0	7	0	0
9	21931896	rs7869004	G	T	3	5	8	0	0	8	0	0
9	21934805	rs55697236	T	C	2	4	6	0	0	6	0	0
9	25677215	rs12348	T	C	45	41	86	0	1	87	0	0
9	25677257	rs1128957	C	G	48	46	94	0	2	96	0	0
9	25677349	rs1128953	A	C	68	65	133	0	3	136	0	0
9	25677588	rs10812300	A	C	28	21	49	0	0	49	0	0
9	25677698	rs72631815	A	C	10	16	26	0	0	26	0	0
9	25677933	rs35110225	T	C	16	13	29	0	0	29	0	0
9	26904699	rs16910873	T	G	3	7	10	0	0	10	0	0
9	26910951	rs10967594	G	T	5	3	8	0	0	8	0	0
9	26911237	rs62544439	A	G	7	5	12	0	0	12	0	0
9	26912521	rs77921995	C	T	6	11	17	0	0	17	0	0
9	26915001	rs7034670	A	G	4	7	11	0	0	11	0	0
9	26915211	.	G	A	6	14	20	0	2	22	0	0
9	26915925	rs7863476	G	A	22	17	39	0	2	41	0	0
9	26916070	rs17694324	C	T	21	15	36	0	0	36	0	0
9	26917691	rs7871097	A	G	7	5	12	0	0	12	0	0
9	26917718	rs7871286	C	T	5	5	10	0	0	10	0	0
9	27329622	rs1984007	T	C	5	15	20	0	0	20	0	0
9	27330031	rs1885380	G	C	9	5	14	0	0	14	0	0
9	27330514	rs3739530	G	A	9	20	29	0	0	29	0	0
9	27454173	rs10511817	G	T	2	4	6	0	0	6	0	0
9	27529316	rs903603	G	A	3	5	8	0	0	8	0	0
9	27529666	rs77812016	C	T	9	11	20	0	0	20	0	0
9	27529700	rs3202600	C	T	7	11	18	0	0	18	0	0
9	27546828	rs9103	A	G	17	25	42	0	1	43	0	0
9	27547313	rs3739526	G	T	7	4	11	0	0	11	0	0
9	27555817	rs10967983	T	A	2	4	6	0	0	6	0	0
9	27555836	rs10967984	C	T	4	2	6	0	0	6	0	0
9	27556780	rs10122902	G	A	24	14	38	0	0	38	0	0
9	27558918	rs2297694	C	G	7	3	10	0	0	10	0	0
9	27560965	rs12347222	G	T	11	7	18	0	0	18	0	0
9	27561628	rs17769294	T	C	57	79	136	0	3	139	0	0
9	27567145	rs10757668	C	T	50	34	84	0	0	84	0	0
9	27572255	rs2282241	C	A	3	3	6	0	0	6	0	0
9	27573213	rs117462033	C	T	3	4	7	0	0	7	0	0
9	32425910	rs3780473	A	G	6	8	14	0	0	14	0	0
9	32450187	rs12985	T	C	17	8	25	0	0	25	0	0
9	32456017	rs12006123	G	A	3	9	12	0	1	13	0	0
9	32456656	rs12555727	G	A	1	5	6	0	0	6	0	0
9	32459450	rs3205166	T	G	8	5	13	0	0	13	0	0
9	32541532	rs12348918	A	G	192	182	374	0	1	375	0	0
9	32542204	rs10971019	A	G	195	170	365	0	2	367	0	0
9	32973777	rs34683066	C	T	1	7	8	0	0	8	0	0
9	33026572	rs20583	T	C	490	492	982	0	6	989	1	0
9	33026638	rs2274769	G	A	10	9	19	0	0	19	0	0
9	33029015	rs4879658	C	T	26	27	53	0	1	54	0	0
9	33029468	rs4879659	G	C	45	22	67	0	0	67	0	0
9	33032833	rs4879660	A	G	6	2	8	0	0	8	0	0
9	33035114	rs7469374	A	G	3	9	12	0	0	12	0	0
9	33035246	rs4879661	A	G	3	10	13	0	0	13	0	0
9	33035480	rs112359565	T	A	4	7	11	0	0	11	0	0
9	33035566	rs4879662	C	T	6	7	13	0	0	13	0	0
9	33036550	rs2297215	A	G	2	6	8	0	0	8	0	0
9	33037349	rs7861851	T	A	11	6	17	0	3	20	0	0
9	33037350	rs7875733	C	A	10	6	16	0	4	20	0	0
9	33038049	rs10971358	G	C	26	35	61	0	1	62	0	0
9	33039024	rs7296	T	A	257	221	478	0	2	480	0	0
9	33042562	rs10971361	C	A	7	1	8	0	0	8	0	0
9	33045147	rs10758180	A	G	38	14	52	0	0	52	0	0
9	33045161	rs10758181	C	T	31	17	48	0	0	48	0	0
9	33045276	rs1537042	G	C	26	19	45	0	0	45	0	0
9	33045664	rs1970027	A	G	16	11	27	0	0	27	0	0
9	33045810	.	T	C	18	9	27	0	0	27	0	0
9	33046969	rs10971363	G	C	47	46	93	0	0	93	0	0
9	33047398	rs2274767	T	C	5	3	8	0	0	8	0	0
9	33048584	rs72720973	T	C	18	17	35	0	0	35	0	0
9	33049601	rs13297493	A	C	11	7	18	0	0	18	0	0
9	33050717	rs13293660	G	A	11	10	21	0	1	22	0	0
9	33051540	rs7846968	T	C	11	17	28	0	0	28	0	0
9	33053430	rs7041702	A	G	23	32	55	0	1	56	0	0
9	33054162	rs7872744	C	T	12	7	19	0	1	20	0	0
9	33055082	rs10758182	T	C	24	30	54	0	0	54	0	0
9	33055471	rs10758183	G	A	4	6	10	0	0	10	0	0
9	33118111	rs4879665	T	C	15	10	25	0	0	25	0	0
9	33118387	rs34420698	G	C	6	6	12	0	0	12	0	0
9	33118904	rs1137642	A	G	5	6	11	0	0	11	0	0
9	33119241	rs6476398	C	T	6	0	6	0	0	6	0	0
9	33119583	rs7859454	T	A	5	7	12	0	0	12	0	0
9	33119818	rs10121987	A	G	8	5	13	0	0	13	0	0
9	33120203	rs1969977	A	G	11	8	19	0	0	19	0	0
9	33120204	rs1969976	A	G	10	8	18	0	0	18	0	0
9	33120706	rs3818593	A	G	5	7	12	0	0	12	0	0
9	33122024	rs10971418	C	A	12	5	17	0	0	17	0	0
9	33122370	rs10116966	T	A	2	4	6	0	0	6	0	0
9	33122626	rs10117038	T	C	7	7	14	0	0	14	0	0
9	33122645	rs10113903	G	C	6	6	12	0	0	12	0	0
9	33123013	rs6476399	A	G	3	3	6	0	0	6	0	0
9	33123106	rs6476400	T	A	5	2	7	0	0	7	0	0
9	33123464	rs10813949	G	A	7	6	13	0	0	13	0	0
9	33123627	rs10738905	A	G	6	9	15	0	0	15	0	0
9	33124042	rs7029897	T	C	11	3	14	0	0	14	0	0
9	33124161	rs10971419	T	C	3	4	7	0	0	7	0	0
9	33124872	rs12342831	T	C	7	3	10	0	0	10	0	0
9	33125000	rs10971420	T	C	4	3	7	0	0	7	0	0
9	33125279	rs4879666	G	A	9	6	15	0	0	15	0	0
9	33125804	rs10758189	T	C	4	5	9	0	0	9	0	0
9	33128021	rs10813951	A	G	4	3	7	0	1	8	0	0
9	33128076	rs10813952	G	A	11	14	25	0	0	25	0	0
9	33129607	rs3780491	A	G	3	4	7	0	0	7	0	0
9	33129839	rs3780490	A	G	6	7	13	0	0	13	0	0
9	33129844	rs3780489	G	T	6	7	13	0	0	13	0	0
9	33131651	rs10758192	G	A	4	7	11	0	0	11	0	0
9	33132492	rs73484568	G	A	2	4	6	0	0	6	0	0
9	33133812	rs3780488	T	C	9	7	16	0	0	16	0	0
9	33135085	rs913214	G	A	1	5	6	0	0	6	0	0
9	33141752	rs2770807	G	A	6	2	8	0	0	8	0	0
9	33141791	rs10813955	C	T	4	2	6	0	0	6	0	0
9	33166234	rs10813959	T	C	2	4	6	0	1	7	0	0
9	33442952	rs2228332	G	A	7	15	22	0	0	22	0	0
9	33447424	rs591810	C	G	0	8	8	0	1	9	0	0
9	33447547	rs12555686	G	T	1	5	6	0	2	8	0	0
9	33461567	rs678859	A	G	22	26	48	0	0	48	0	0
9	33473893	rs2777744	T	G	4	4	8	0	0	8	0	0
9	33506670	rs10813990	C	T	0	7	7	0	0	7	0	0
9	33817272	rs369142877	C	A	5	4	9	0	0	9	0	0
9	33817617	rs855719	T	C	32	34	66	0	0	66	0	0
9	33817964	rs2734603	C	T	21	25	46	0	0	46	0	0
9	33818257	rs216364	T	C	13	18	31	0	0	31	0	0
9	33819365	rs216366	A	G	56	67	123	0	0	123	0	0
9	33819555	rs216367	A	T	24	27	51	0	1	52	0	0
9	33819955	rs216368	A	G	63	60	123	0	1	124	0	0
9	33825490	rs2790737	C	T	2	4	6	0	0	6	0	0
9	33917498	rs4817	T	C	100	114	214	0	0	214	0	0
9	33918786	rs79583803	C	G	13	17	30	0	0	30	0	0
9	33919176	rs16935278	A	C	11	14	25	0	0	25	0	0
9	33921907	rs73492956	G	C	39	31	70	0	5	75	0	0
9	33921933	rs2277178	G	A	40	51	91	0	0	91	0	0
9	33921977	rs2781	G	C	68	70	138	0	2	140	0	0
9	33941759	rs307658	T	C	24	16	40	0	0	40	0	0
9	33942665	rs307659	T	C	3	4	7	0	0	7	0	0
9	34017106	rs1785506	C	T	6	11	17	0	0	17	0	0
9	34087360	rs1052656	T	C	7	12	19	0	1	20	0	0
9	34098452	.	G	A	8	16	24	0	0	24	0	0
9	34181554	rs62556562	C	T	2	4	6	0	0	6	0	0
9	34181651	rs2769705	C	T	5	1	6	0	0	6	0	0
9	34189254	rs143774760	T	G	3	13	16	0	0	16	0	0
9	34189483	rs62556564	G	A	2	14	16	0	0	16	0	0
9	34189833	rs7849334	C	T	19	2	21	0	0	21	0	0
9	34215234	rs10972005	C	T	3	3	6	0	0	6	0	0
9	34215270	rs7341762	T	C	3	4	7	0	0	7	0	0
9	34223937	rs4242691	A	G	6	7	13	0	0	13	0	0
9	34224091	rs17349430	G	A	9	12	21	0	0	21	0	0
9	34224285	rs17258212	C	T	7	8	15	0	0	15	0	0
9	34232465	rs7025829	T	A	10	9	19	0	0	19	0	0
9	34243377	rs17349871	C	G	11	13	24	0	1	25	0	0
9	34243975	rs34223057	G	A	9	12	21	0	0	21	0	0
9	34244092	rs10972017	C	T	8	13	21	0	0	21	0	0
9	34244124	rs4008744	T	C	10	14	24	0	1	25	0	0
9	34246134	rs35971466	G	A	10	18	28	0	0	28	0	0
9	34247622	rs528549052	G	A	30	32	62	0	0	62	0	0
9	34249143	rs7470345	T	C	37	32	69	0	1	70	0	0
9	34249204	rs2380925	G	A	30	24	54	0	0	54	0	0
9	34249354	rs2380926	T	C	43	37	80	0	2	82	0	0
9	34250580	.	A	G	3	6	9	0	0	9	0	0
9	34251952	rs3135929	G	T	175	175	350	0	3	353	0	0
9	34252127	rs1049567	T	C	365	373	738	0	0	738	0	0
9	34669005	rs13299387	A	C	7	4	11	0	0	11	0	0
9	34997569	rs885451	C	G	5	2	7	0	0	7	0	0
9	35060302	rs684562	T	C	20	28	48	0	0	48	0	0
9	35068640	rs2073575	A	T	5	4	9	0	0	10	1	0
9	35069608	rs489922	C	A	2	4	6	0	0	6	0	0
9	35071773	rs7871782	G	A	5	3	8	0	0	8	0	0
9	35071774	rs7871544	C	A	4	2	6	0	2	8	0	0
9	35078067	.	T	A	4	6	10	0	0	10	0	0
9	35079913	rs10972302	T	C	3	7	10	0	0	10	0	0
9	35089403	rs2298314	G	A	31	22	53	0	0	53	0	0
9	35089498	rs10972310	G	A	7	3	10	0	0	10	0	0
9	35105257	rs7030595	G	A	26	19	45	0	0	45	0	0
9	35107765	rs13287211	C	A	8	11	19	0	0	19	0	0
9	35398633	rs139577182	G	A	5	5	10	0	0	10	0	0
9	35491883	rs7846774	C	T	4	5	9	0	0	9	0	0
9	35555823	rs946483	T	C	7	14	21	0	0	21	0	0
9	35556250	rs870978	G	C	5	12	17	0	0	17	0	0
9	35557696	rs1890590	G	T	5	9	14	0	0	14	0	0
9	35559213	rs2295842	C	T	14	6	20	0	1	21	0	0
9	35606738	rs7028425	C	G	26	8	34	0	0	34	0	0
9	35606884	rs2275422	G	A	150	148	298	0	2	300	0	0
9	35608672	rs148304678	A	G	4	6	10	0	0	10	0	0
9	35610912	rs4879913	A	G	9	2	11	0	0	11	0	0
9	35616583	rs2095858	A	T	25	13	38	0	1	39	0	0
9	35637121	rs114289683	C	T	4	4	8	0	0	8	0	0
9	35640945	rs10814264	C	T	35	52	87	0	0	87	0	0
9	35641213	rs55667103	G	A	34	38	72	0	0	72	0	0
9	35641438	rs76808158	T	C	13	7	20	0	0	20	0	0
9	35641859	rs10972540	C	T	5	6	11	0	0	11	0	0
9	35642473	rs12684943	A	G	7	5	12	0	1	13	0	0
9	35643206	rs10972541	G	A	2	7	9	0	1	10	0	0
9	35643211	rs78616042	T	C	7	2	9	0	0	9	0	0
9	35643363	rs10972542	C	T	8	10	18	0	0	18	0	0
9	35645120	rs1832537	C	T	6	5	11	0	0	11	0	0
9	35645595	.	C	A	3	8	11	0	1	12	0	0
9	35645597	rs12379668	A	C	4	8	12	0	0	12	0	0
9	35645880	rs7851329	G	C	13	5	18	0	0	18	0	0
9	35646570	rs12377368	G	C	23	29	52	0	4	56	0	0
9	35659902	rs10972553	C	T	3	3	6	0	0	6	0	0
9	35690310	rs2756892	C	T	9	4	13	0	1	14	0	0
9	35705086	rs867194	A	G	5	7	12	0	1	13	0	0
9	35705759	rs11541908	G	A	172	172	344	0	2	346	0	0
9	35711806	rs2249250	G	T	8	2	10	0	0	10	0	0
9	35712003	rs2295795	G	A	110	116	226	0	2	229	1	0
9	35725985	rs1985474	C	T	7	7	14	0	0	14	0	0
9	35726397	rs2737275	C	G	6	10	16	0	0	16	0	0
9	35731004	rs3763630	C	T	9	0	9	0	0	9	0	0
9	35748806	rs1570246	G	T	10	10	20	0	0	20	0	0
9	35749845	rs2236288	G	C	13	11	24	0	0	24	0	0
9	35753822	.	T	A	21	6	27	0	0	28	1	0
9	35753898	rs34478611	G	A	2	13	15	0	0	15	0	0
9	35810245	rs61758536	G	A	5	3	8	0	0	8	0	0
9	36037065	rs201017437	G	T	10	16	26	0	0	26	0	0
9	36085563	rs10814327	T	A	35	27	62	0	2	64	0	0
9	36105264	rs11788747	A	G	5	2	7	0	0	7	0	0
9	36110063	rs10972727	T	A	3	3	6	0	0	6	0	0
9	36144632	rs41277091	C	T	5	2	7	0	0	7	0	0
9	36160040	rs17778964	A	G	3	3	6	0	0	6	0	0
9	36163002	rs11588	C	T	50	37	87	0	1	88	0	0
9	36163563	rs6610	G	A	108	112	220	0	1	221	0	0
9	36191004	rs2274523	C	T	45	57	102	0	1	103	0	0
9	36191149	rs2274524	T	C	36	30	66	0	1	67	0	0
9	36207127	rs7850868	G	T	3	3	6	0	0	6	0	0
9	36207522	rs7851157	C	G	1	7	8	0	0	8	0	0
9	36207877	rs10046825	A	C	1	7	8	0	0	8	0	0
9	36218018	rs615108	C	G	7	4	11	0	0	11	0	0
9	36220134	rs2296818	T	C	4	3	7	0	0	7	0	0
9	36220436	rs623166	G	A	10	5	15	0	0	15	0	0
9	36221134	rs626259	G	A	4	3	7	0	0	7	0	0
9	36222649	rs10972795	C	G	6	3	9	0	0	9	0	0
9	36240445	rs4879962	C	G	3	3	6	0	0	6	0	0
9	36240516	rs10123243	A	T	3	3	6	0	0	6	0	0
9	36251301	rs10758353	G	A	2	4	6	0	0	6	0	0
9	36303536	rs10972835	G	A	3	4	7	0	0	7	0	0
9	36345151	rs7042226	C	T	6	5	11	0	0	11	0	0
9	36346305	rs10972863	C	T	8	9	17	0	0	17	0	0
9	36351694	rs10972866	G	A	4	4	8	0	0	8	0	0
9	36351800	rs10814377	C	T	2	5	7	0	0	7	0	0
9	36480532	rs74307337	T	C	8	5	13	0	2	15	0	0
9	36480711	rs71531226	G	C	6	3	9	0	0	9	0	0
9	36481150	rs74193050	T	C	2	5	7	0	0	7	0	0
9	36837983	rs12552392	G	A	26	17	43	0	1	44	0	0
9	37080310	.	C	T	34	32	66	0	0	66	0	0
9	37081270	rs7034763	G	C	5	6	11	0	0	11	0	0
9	37082786	rs10973198	T	C	6	1	7	0	0	7	0	0
9	37085226	rs72737706	A	G	2	6	8	0	0	8	0	0
9	37086996	rs2279557	A	G	81	73	154	0	0	154	0	0
9	37087064	rs2279556	A	G	113	89	202	0	1	203	0	0
9	37160344	rs10973235	T	G	4	6	10	0	0	10	0	0
9	37166400	rs12380367	T	C	5	5	10	0	0	10	0	0
9	37429497	rs309460	C	T	4	7	11	0	0	11	0	0
9	37441650	rs17502738	T	C	63	59	122	0	0	122	0	0
9	37464106	rs1410018	C	T	7	11	18	0	0	18	0	0
9	37489378	rs11542231	C	T	55	50	105	0	1	106	0	0
9	37521777	rs35979885	G	A	6	5	11	0	0	11	0	0
9	37774893	rs10973537	G	A	4	4	8	0	0	8	0	0
9	37775177	rs10973538	C	T	2	6	8	0	0	8	0	0
9	37778206	rs117790370	A	C	10	7	17	0	0	17	0	0
9	37779623	rs6476661	G	A	9	3	12	0	0	12	0	0
9	37782111	rs7158	C	T	10	2	12	0	0	12	0	0
9	37801651	rs185214483	A	G	29	25	54	0	0	54	0	0
9	41954776	.	C	G	0	7	7	0	0	7	0	0
9	44401960	.	G	A	5	7	12	0	0	12	0	0
9	66457388	.	T	G	2	6	8	0	0	8	0	0
9	66457475	.	C	T	2	10	12	0	0	12	0	0
9	66458087	rs2321646	C	G	2	7	9	0	0	9	0	0
9	66463565	rs1826436	C	G	5	1	6	0	0	6	0	0
9	66463960	.	C	T	6	4	10	0	0	10	0	0
9	66464188	.	G	A	3	10	13	0	0	13	0	0
9	66465331	.	A	C	3	8	11	0	0	11	0	0
9	66465614	.	A	G	1	26	27	0	0	27	0	0
9	66466650	.	G	C	3	8	11	0	0	11	0	0
9	67327883	rs76733484	C	G	0	15	15	0	0	15	0	0
9	67331056	.	A	T	42	0	42	0	0	42	0	0
9	67334928	.	G	A	19	0	19	0	0	19	0	0
9	67334949	.	T	C	17	0	17	0	0	17	0	0
9	68401291	.	C	G	11	0	11	0	0	11	0	0
9	68413581	.	G	C	3	5	8	0	0	8	0	0
9	68413791	.	G	C	5	3	8	0	0	8	0	0
9	68415386	.	G	A	0	7	7	0	0	7	0	0
9	68741534	.	A	G	4	2	6	0	0	6	0	0
9	68742952	rs62554359	T	C	4	2	6	0	0	6	0	0
9	68743221	rs199977881	C	T	35	23	58	0	0	58	0	0
9	68746242	.	A	C	6	2	8	0	0	8	0	0
9	69066506	.	G	A	16	0	16	0	0	16	0	0
9	69082235	rs71269705	G	A	22	0	22	0	1	23	0	0
9	69206924	.	T	A	8	4	12	0	0	12	0	0
9	70483186	.	A	G	0	9	9	0	0	9	0	0
9	71396426	rs12349968	A	G	1	5	6	0	0	6	0	0
9	71397187	rs75064770	G	A	3	7	10	0	0	10	0	0
9	71397747	rs2017	T	C	9	5	14	0	1	15	0	0
9	71398086	rs12006032	A	G	7	4	11	0	0	11	0	0
9	71687924	rs10890	C	T	14	25	39	0	1	40	0	0
9	71688101	rs4745577	A	G	8	13	21	0	0	21	0	0
9	71688218	rs4744806	T	C	3	6	9	0	0	9	0	0
9	71688300	rs4744807	A	G	3	5	8	0	0	8	0	0
9	71688476	rs11145043	T	G	5	7	12	0	0	12	0	0
9	71688993	rs4745578	T	C	5	4	9	0	0	9	0	0
9	71689004	rs4744810	A	G	5	3	8	0	0	8	0	0
9	71689045	rs2871218	A	G	5	2	7	0	0	7	0	0
9	71689375	rs1984004	A	G	4	3	7	0	1	8	0	0
9	71689415	rs1888334	G	A	4	2	6	0	0	6	0	0
9	72328727	rs7857137	A	G	13	23	36	0	1	37	0	0
9	72328979	rs11139928	A	T	11	9	20	0	1	21	0	0
9	72331806	rs1411410	G	A	30	27	57	0	0	57	0	0
9	72339483	rs7032552	A	G	3	6	9	0	0	9	0	0
9	72345603	rs10511968	G	C	1	5	6	0	0	6	0	0
9	72348308	rs10867996	C	T	3	4	7	0	0	7	0	0
9	72372106	rs1536992	G	A	7	4	11	0	0	11	0	0
9	72372829	rs2150045	T	C	23	23	46	0	1	47	0	0
9	72374304	rs10118222	T	A	5	5	10	0	0	10	0	0
9	72741247	rs2296772	C	T	93	90	183	0	2	185	0	0
9	72741298	rs2296773	G	A	92	86	178	0	0	178	0	0
9	72758742	rs12683706	C	T	13	1	14	0	0	14	0	0
9	72758785	rs12684987	T	A	8	0	8	0	0	8	0	0
9	72759292	rs1927116	G	T	10	0	10	0	0	10	0	0
9	72790705	rs1927137	C	T	57	7	64	0	0	64	0	0
9	72790896	rs1887452	C	T	123	11	134	0	2	136	0	0
9	72790922	rs75142295	G	C	19	115	134	0	0	134	0	0
9	72790949	rs79224096	G	A	19	118	137	0	3	140	0	0
9	72800582	rs4744986	C	T	0	6	6	0	0	6	0	0
9	72801919	rs1927142	A	G	10	3	13	0	0	13	0	0
9	72820511	rs12685534	T	C	3	3	6	0	0	6	0	0
9	72820633	rs1927091	T	C	4	3	7	0	0	7	0	0
9	72822863	rs6560059	T	G	4	2	6	0	0	6	0	0
9	72823041	rs144364307	G	T	3	3	6	0	0	6	0	0
9	72823293	rs144811375	T	G	3	3	6	0	0	6	0	0
9	72823336	rs4378025	T	G	4	4	8	0	0	8	0	0
9	72825122	rs57477024	C	T	4	5	9	0	0	9	0	0
9	72825922	rs151229075	G	A	3	3	6	0	0	6	0	0
9	72826054	rs146492606	G	A	5	6	11	0	0	11	0	0
9	72826330	rs4410968	G	A	4	4	8	0	0	8	0	0
9	72827074	rs4439194	C	G	4	2	6	0	0	6	0	0
9	72827297	rs7857214	C	T	3	7	10	0	0	10	0	0
9	72827301	rs7875514	T	C	2	7	9	0	0	9	0	0
9	72828932	rs75276993	G	T	6	7	13	0	0	13	0	0
9	72829804	rs75052855	C	T	3	5	8	0	0	8	0	0
9	72829814	rs1073540	A	C	4	4	8	0	0	8	0	0
9	72829976	rs79443596	G	T	4	4	8	0	0	8	0	0
9	72830321	rs10868720	C	G	7	8	15	0	1	16	0	0
9	72830532	rs7034322	T	C	10	5	15	0	0	15	0	0
9	72831808	rs716535	A	T	10	1	11	0	0	11	0	0
9	72832626	rs74659674	A	T	5	6	11	0	0	11	0	0
9	72833057	rs77501100	A	C	4	3	7	0	0	7	0	0
9	72834327	rs79324330	C	T	9	9	18	0	1	19	0	0
9	72834342	rs2182736	G	A	11	9	20	0	1	21	0	0
9	72834525	rs117787294	C	T	6	9	15	0	0	15	0	0
9	72834826	rs79551211	C	T	8	10	18	0	0	18	0	0
9	72835205	rs1927098	G	C	16	5	21	0	0	21	0	0
9	72835473	rs76102143	T	C	9	9	18	0	0	18	0	0
9	72835575	rs1927099	A	G	9	9	18	0	0	18	0	0
9	72836019	rs7041843	T	C	11	4	15	0	0	15	0	0
9	72839397	rs10868741	G	A	17	12	29	0	0	29	0	0
9	72839786	rs13293554	A	T	4	12	16	0	0	16	0	0
9	72841360	rs4744994	A	T	12	33	45	0	0	45	0	0
9	72885465	rs76742954	G	C	8	7	15	0	1	16	0	0
9	72885809	rs12344645	C	T	8	7	15	0	0	15	0	0
9	72887410	rs10868797	T	A	8	10	18	0	0	18	0	0
9	72887456	rs75315926	C	T	12	11	23	0	0	23	0	0
9	72890421	rs4599878	T	G	11	15	26	0	0	26	0	0
9	72897440	rs1180117	T	C	156	115	271	0	4	275	0	0
9	72898893	rs1180118	T	G	2	5	7	0	0	7	0	0
9	72900289	rs943536	A	T	4	3	7	0	0	7	0	0
9	72917149	rs7036205	G	C	12	12	24	0	0	24	0	0
9	72917420	rs7853742	T	A	7	6	13	0	0	13	0	0
9	72917810	rs12006212	T	G	10	15	25	0	1	26	0	0
9	72918167	rs10125617	T	C	5	8	13	0	0	13	0	0
9	72918891	rs11998951	T	C	4	4	8	0	0	8	0	0
9	72919329	rs2183362	A	G	9	12	21	0	1	22	0	0
9	72934090	rs78164291	T	C	2	4	6	0	0	6	0	0
9	72939702	rs11142368	C	T	2	8	10	0	1	11	0	0
9	72939906	rs58879007	G	A	5	6	11	0	0	11	0	0
9	72940085	rs117227151	G	A	6	2	8	0	0	8	0	0
9	72940495	rs7858389	T	A	5	3	8	0	0	8	0	0
9	72942236	rs11142370	A	T	10	17	27	0	0	27	0	0
9	72957356	rs79826261	C	T	3	3	6	0	0	6	0	0
9	72969517	rs1052684	A	T	46	54	100	0	0	100	0	0
9	73001489	rs10868816	T	C	402	285	687	0	1	688	0	0
9	73001523	rs78561832	T	A	248	319	567	0	8	575	0	0
9	73028766	rs1056448	T	C	170	106	276	0	2	278	0	0
9	74298720	rs6560226	A	G	5	3	8	0	0	8	0	0
9	74312741	rs1294	T	G	23	22	45	0	0	45	0	0
9	74314210	rs4263836	A	T	5	1	6	0	0	6	0	0
9	74319576	rs25696	A	T	24	22	46	0	0	46	0	0
9	74319677	rs17057133	T	C	17	28	45	0	0	45	0	0
9	74327419	rs7037458	C	A	3	3	6	0	0	6	0	0
9	74360096	rs25689	C	T	19	17	36	0	0	36	0	0
9	74360209	rs3739783	G	C	14	15	29	0	0	29	0	0
9	74483633	rs7023190	C	T	2	6	8	0	0	8	0	0
9	74523838	rs72739874	G	A	27	21	48	0	0	48	0	0
9	74967616	rs3012516	T	C	2	5	7	0	0	7	0	0
9	74967637	rs3012517	C	T	3	5	8	0	0	8	0	0
9	74969076	rs3398	G	A	4	6	10	0	0	10	0	0
9	74969864	rs969	T	C	863	796	1659	0	4	1663	0	0
9	74971291	rs2975099	T	C	11	12	23	0	0	23	0	0
9	74972347	rs3012503	A	G	11	9	20	0	1	21	0	0
9	74973348	rs3012504	A	G	23	20	43	0	0	43	0	0
9	74974534	rs3012505	C	T	20	11	31	0	1	32	0	0
9	74974744	rs3012506	C	T	36	51	87	0	0	87	0	0
9	74975007	rs145539714	C	G	23	24	47	0	0	47	0	0
9	74975492	rs2146184	T	C	782	753	1535	0	5	1540	0	0
9	74976347	rs1322482	G	A	192	143	335	0	1	336	0	0
9	74976595	rs3012507	A	G	23	34	57	0	0	57	0	0
9	74977457	rs909174	A	C	79	81	160	0	2	162	0	0
9	74977980	rs909172	G	A	35	34	69	0	0	69	0	0
9	74978563	rs2975098	A	G	91	93	184	0	4	188	0	0
9	74979966	rs2859766	G	A	26	37	63	0	0	63	0	0
9	75768094	rs10869229	A	G	4	3	7	0	0	7	0	0
9	75782131	rs1342018	A	G	45	36	81	0	1	82	0	0
9	75782510	rs1342017	G	A	23	30	53	0	1	54	0	0
9	75782655	rs1981288	T	C	29	51	80	0	2	82	0	0
9	75783937	rs3739959	A	G	68	77	145	0	1	146	0	0
9	75784264	rs2811226	G	A	6	3	9	0	0	9	0	0
9	75784327	rs10869231	G	A	9	5	14	0	0	14	0	0
9	77676278	rs41287433	A	G	13	13	26	0	0	26	0	0
9	77684690	rs3752955	A	C	7	14	21	0	0	21	0	0
9	77702631	rs11144224	T	C	12	12	24	0	1	25	0	0
9	79001829	rs2501927	G	A	61	61	122	0	0	122	0	0
9	79001904	rs1129399	C	A	45	39	84	0	0	84	0	0
9	79002061	rs3187236	T	C	19	13	32	0	0	32	0	0
9	79009204	rs11548954	C	T	5	8	13	0	0	13	0	0
9	79079167	rs11144917	C	G	2	4	6	0	0	6	0	0
9	79082677	.	A	T	5	5	10	0	0	10	0	0
9	79083072	rs113389841	C	T	7	2	9	0	0	9	0	0
9	79083103	rs73650224	G	A	5	2	7	0	0	7	0	0
9	79083773	rs73449881	A	T	6	2	8	0	0	8	0	0
9	79084321	rs143851447	A	G	6	2	8	0	0	8	0	0
9	79084653	rs111663350	G	C	5	6	11	0	0	11	0	0
9	79117751	rs2282683	A	G	58	49	107	0	1	108	0	0
9	79118329	rs1057406	G	A	72	57	129	0	0	129	0	0
9	79118903	rs707739	A	C	37	34	71	0	0	71	0	0
9	79119752	rs683969	C	T	14	12	26	0	0	26	0	0
9	79120475	rs589561	A	T	11	3	14	0	0	14	0	0
9	79121380	rs11144931	A	G	14	6	20	0	0	20	0	0
9	79121384	rs56097164	G	A	12	6	18	0	1	19	0	0
9	79121906	rs1130268	C	T	9	9	18	0	2	20	0	0
9	79908273	.	G	A	5	4	9	0	1	10	0	0
9	79946961	rs17424026	C	T	12	16	28	0	0	28	0	0
9	79952961	rs72746015	A	G	6	3	9	0	0	9	0	0
9	80031487	rs989391	G	A	4	6	10	0	0	10	0	0
9	80031946	rs9186	C	T	21	8	29	0	0	29	0	0
9	80333407	rs11546845	G	A	157	163	320	0	0	320	0	0
9	80334981	rs2026000	A	G	137	133	270	0	1	272	1	0
9	80335076	rs3858119	C	T	142	136	278	0	0	278	0	0
9	80335288	rs2025999	C	T	110	109	219	0	2	221	0	0
9	80579382	rs11145635	T	C	4	2	6	0	0	6	0	0
9	80582223	rs4097404	C	T	107	82	189	0	1	190	0	0
9	80863254	.	A	G	1	9	10	0	1	11	0	0
9	82187095	rs2807303	G	A	141	160	301	0	2	303	0	0
9	82189416	rs60790901	T	C	10	8	18	0	0	18	0	0
9	82258301	rs4877145	A	G	2	4	6	0	0	6	0	0
9	82259537	rs7019624	C	T	4	3	7	0	0	7	0	0
9	82267732	rs2297499	C	G	19	22	41	0	0	41	0	0
9	82279449	rs4339716	T	G	4	3	7	0	0	7	0	0
9	82279542	rs7029826	C	T	2	6	8	0	0	8	0	0
9	82279767	rs13294683	C	T	4	2	6	0	0	6	0	0
9	82289153	rs1475676	G	T	3	3	6	0	0	6	0	0
9	82290959	rs10867409	A	C	3	3	6	0	0	6	0	0
9	82295998	rs11138327	A	C	4	3	7	0	0	7	0	0
9	82297990	rs10867411	A	G	5	7	12	0	0	12	0	0
9	82298288	rs7859802	A	G	5	1	6	0	0	6	0	0
9	82299047	rs7863550	A	G	5	7	12	0	0	12	0	0
9	82299596	rs9722721	T	A	8	3	11	0	0	11	0	0
9	82299972	rs11138331	A	C	5	9	14	0	0	14	0	0
9	82301228	rs10867412	T	G	4	5	9	0	0	9	0	0
9	82301340	rs10867413	C	A	11	9	20	0	0	20	0	0
9	82301792	rs2151147	A	G	11	6	17	0	0	17	0	0
9	82301795	rs1316823	A	G	6	11	17	0	0	17	0	0
9	82302985	rs12349682	G	A	5	1	6	0	0	6	0	0
9	82304992	rs6559491	A	T	5	1	6	0	0	6	0	0
9	82308390	rs11138336	G	A	5	1	6	0	0	6	0	0
9	82308881	.	C	T	2	6	8	0	0	8	0	0
9	82312046	rs7039267	G	A	7	2	9	0	0	9	0	0
9	82316853	rs11138338	G	A	16	16	32	0	0	32	0	0
9	82319250	rs28488183	G	C	11	16	27	0	1	28	0	0
9	82321106	.	C	T	5	5	10	0	0	10	0	0
9	82332147	rs117191677	C	T	46	35	81	0	0	81	0	0
9	82332595	rs74972941	G	A	25	23	48	0	0	48	0	0
9	82333505	rs74917162	A	G	17	11	28	0	0	28	0	0
9	82335300	.	T	G	72	14	86	0	2	88	0	0
9	86275559	rs1044214	C	A	17	23	40	0	0	40	0	0
9	86278817	rs7866234	C	A	265	278	543	0	2	545	0	0
9	86279025	rs2781002	T	C	95	75	170	0	2	172	0	0
9	86279814	rs10868037	G	A	15	22	37	0	1	38	0	0
9	86280482	rs11140202	C	T	48	49	97	0	1	98	0	0
9	86280710	rs10125987	C	T	58	36	94	0	2	96	0	0
9	86281195	rs12344615	A	G	38	60	98	0	2	100	0	0
9	86281745	rs10114717	G	A	42	52	94	0	1	95	0	0
9	86282341	rs4877791	G	A	53	38	91	0	0	91	0	0
9	86283648	rs10512137	A	C	22	25	47	0	0	47	0	0
9	86289243	rs4877794	T	C	2	7	9	0	1	10	0	0
9	86289460	rs7045761	T	C	8	11	19	0	1	20	0	0
9	86289874	rs11140209	T	G	9	14	23	0	1	24	0	0
9	86290530	rs10121045	T	C	5	12	17	0	0	17	0	0
9	86290731	rs10746717	C	A	7	3	10	0	0	10	0	0
9	86290835	rs10780622	A	C	7	4	11	0	0	11	0	0
9	86291679	rs10868038	T	C	101	95	196	0	4	200	0	0
9	86292425	rs7863266	T	C	86	71	157	0	8	165	0	0
9	86293795	rs10481738	G	A	5	2	7	0	0	7	0	0
9	86319690	rs7860614	G	A	7	0	7	0	0	7	0	0
9	86322740	rs1056073	C	G	85	80	165	0	0	165	0	0
9	86354511	rs4750	G	C	4	3	7	0	1	8	0	0
9	86409718	rs10453251	C	A	2	4	6	0	0	6	0	0
9	86409851	rs55881223	A	T	0	9	9	0	0	9	0	0
9	86431653	rs295271	T	C	2	4	6	0	0	6	0	0
9	86468715	rs295274	A	T	4	8	12	0	1	13	0	0
9	86495276	.	C	T	4	2	6	0	0	6	0	0
9	86504005	rs13289566	C	T	5	8	13	0	0	13	0	0
9	86583076	rs696825	C	T	84	56	140	0	0	140	0	0
9	86584903	rs296885	A	G	59	62	121	0	0	121	0	0
9	86591704	rs192705	G	A	71	58	129	0	4	133	0	0
9	86593314	rs167203	G	C	2055	1921	3976	0	28	4004	0	0
9	86594798	rs796004	C	T	4	4	8	0	0	8	0	0
9	86595070	rs296887	C	T	620	663	1283	0	5	1288	0	0
9	86595498	rs296888	G	A	382	343	725	0	3	728	0	0
9	86595801	rs796003	G	T	0	8	8	0	0	8	0	0
9	88248029	.	T	C	62	48	110	0	2	112	0	0
9	88456282	.	G	A	12	0	12	0	0	12	0	0
9	88456293	.	C	T	12	0	12	0	0	12	0	0
9	88456359	rs74877298	C	T	8	0	8	0	0	8	0	0
9	88456363	rs77693173	C	T	8	0	8	0	0	8	0	0
9	88456364	rs78218309	A	G	8	0	8	0	0	8	0	0
9	88456638	.	C	T	8	0	8	0	0	8	0	0
9	88456658	.	T	C	7	0	7	0	0	7	0	0
9	88456681	.	G	A	7	0	7	0	0	7	0	0
9	88456697	.	G	A	6	0	6	0	0	6	0	0
9	88456815	.	G	A	6	0	6	0	0	6	0	0
9	88456825	.	T	G	7	0	7	0	0	7	0	0
9	88456843	.	T	G	7	0	7	0	0	7	0	0
9	88879525	rs1059144	G	A	13	9	22	0	0	22	0	0
9	88881000	rs61743948	G	A	196	115	311	0	0	311	0	0
9	88881410	rs9695849	A	G	2	9	11	0	0	11	0	0
9	88881510	rs10780754	C	T	6	8	14	0	1	15	0	0
9	88883182	rs62573370	T	C	8	9	17	0	0	17	0	0
9	88884584	rs28768502	T	C	8	6	14	0	0	14	0	0
9	88884702	rs77868554	G	A	9	3	12	0	0	12	0	0
9	88884893	rs7033798	C	T	2	9	11	0	1	12	0	0
9	88884938	rs7019244	T	C	3	10	13	0	0	13	0	0
9	88886247	rs59614505	G	A	4	12	16	0	0	16	0	0
9	88886830	rs12351992	C	T	0	6	6	0	0	6	0	0
9	88903367	rs4440696	T	A	7	11	18	0	0	18	0	0
9	88910259	rs10868407	G	A	13	5	18	0	0	18	0	0
9	88911408	rs7874500	C	G	94	82	176	0	2	178	0	0
9	88913111	rs2031263	T	C	72	53	125	0	0	125	0	0
9	88914003	rs12099	G	A	39	42	81	0	1	82	0	0
9	88928561	rs734519	G	C	4	3	7	0	0	7	0	0
9	88937427	rs41283661	C	T	11	12	23	0	0	23	0	0
9	88937617	rs700768	T	A	20	18	38	0	2	40	0	0
9	88959938	rs791323	C	T	79	61	140	0	1	141	0	0
9	88966092	rs791222	T	C	43	47	90	0	0	90	0	0
9	88966434	rs791325	C	T	18	17	35	0	0	35	0	0
9	88967300	rs700776	A	G	114	73	187	0	0	187	0	0
9	90114746	rs2058882	A	G	5	2	7	0	0	7	0	0
9	90116494	rs1329599	T	C	2	4	6	0	0	6	0	0
9	90118253	rs78360735	C	T	5	4	9	0	0	9	0	0
9	90118809	rs1468931	G	A	2	5	7	0	0	7	0	0
9	90119906	rs140991458	G	A	10	12	22	0	0	22	0	0
9	90120379	rs11790186	C	T	10	10	20	0	0	20	0	0
9	90298531	rs2889982	C	A	1	9	10	0	0	10	0	0
9	90298628	rs3128481	G	C	2	5	7	0	0	7	0	0
9	90298918	rs3128484	G	A	4	6	10	0	0	10	0	0
9	90299027	rs3128485	C	T	5	9	14	0	0	14	0	0
9	90312577	rs3128494	A	G	3	4	7	0	0	7	0	0
9	90321583	rs3118863	C	T	72	74	146	0	0	146	0	0
9	90322023	rs1056719	G	A	113	97	210	0	2	212	0	0
9	91035298	rs144761518	C	T	2	5	7	0	0	7	0	0
9	91090674	rs1186392	C	A	53	37	90	0	1	91	0	0
9	91927022	rs3211669	T	C	7	5	12	0	0	12	0	0
9	91931058	rs3211690	T	A	3	6	9	0	0	9	0	0
9	91931433	rs14867	T	C	142	128	270	0	0	270	0	0
9	91936801	rs144563142	A	G	8	2	10	0	0	10	0	0
9	91938504	rs74458996	G	C	3	5	8	0	0	8	0	0
9	91938657	rs78972824	G	A	4	6	10	0	0	10	0	0
9	91953672	rs80298072	T	C	12	7	19	0	0	19	0	0
9	91961380	rs79942489	A	G	5	8	13	0	0	13	0	0
9	91977107	rs117120897	A	T	12	9	21	0	0	21	0	0
9	91978397	rs13295305	C	T	13	11	24	0	0	24	0	0
9	91978783	rs45515192	G	A	9	5	14	0	0	14	0	0
9	91992573	rs9445	A	T	88	86	174	0	2	176	0	0
9	91996079	.	C	T	4	5	9	0	0	9	0	0
9	91997405	rs7048501	C	T	5	6	11	0	0	11	0	0
9	91997486	rs3922885	C	T	2	7	9	0	1	10	0	0
9	91997687	rs7036818	G	A	5	9	14	0	0	14	0	0
9	91997938	rs7469438	G	T	9	6	15	0	1	16	0	0
9	91998062	rs7469453	G	A	11	11	22	0	0	22	0	0
9	91998121	rs7469476	G	A	8	13	21	0	0	21	0	0
9	92003749	rs7465881	A	G	4	3	7	0	0	7	0	0
9	92089100	rs9410490	T	C	4	2	6	0	0	6	0	0
9	93581182	rs1333630	C	T	3	3	6	0	0	6	0	0
9	93581821	rs290983	G	A	2	4	6	0	0	6	0	0
9	93601368	rs7852876	A	T	2	5	7	0	0	7	0	0
9	93604190	rs28972166	G	T	2	9	11	0	1	12	0	0
9	93604906	rs112827704	A	G	3	4	7	0	0	7	0	0
9	93604926	rs62559143	T	C	4	3	7	0	0	7	0	0
9	93606309	rs35758162	G	A	207	165	372	0	7	379	0	0
9	93606676	rs2278275	A	G	82	85	167	0	0	167	0	0
9	93606831	rs12555502	C	T	141	91	232	0	2	234	0	0
9	93609066	rs7030222	C	T	4	2	6	0	0	6	0	0
9	93611084	rs3789897	G	A	9	2	11	0	0	11	0	0
9	93624896	rs10821515	G	A	64	31	95	0	1	96	0	0
9	93625326	rs117626018	A	C	27	74	101	0	0	101	0	0
9	93625745	rs1572104	C	G	36	13	49	0	2	51	0	0
9	93636664	rs290227	G	A	6	2	8	0	0	8	0	0
9	93654697	rs1172663	A	G	1	6	7	0	0	7	0	0
9	93658952	rs12344755	T	C	96	82	178	0	0	178	0	0
9	93923153	rs73494920	G	C	1	5	6	0	0	6	0	0
9	94037842	rs2482340	A	G	2	8	10	0	0	10	0	0
9	94037873	rs2482338	T	C	1	8	9	0	0	9	0	0
9	94056558	.	G	A	11	15	26	0	0	26	0	0
9	94056586	rs298729	C	T	17	8	25	0	0	25	0	0
9	94102269	.	A	T	13	14	27	0	0	27	0	0
9	94103290	rs1757648	T	C	10	5	15	0	0	15	0	0
9	94105263	rs10739914	G	A	11	3	14	0	1	15	0	0
9	94105457	rs7856089	G	A	15	19	34	0	0	34	0	0
9	94174123	rs9409419	A	G	3	9	12	0	0	12	0	0
9	94176261	rs7021746	G	A	11	5	16	0	0	16	0	0
9	94177640	rs10991925	T	C	6	9	15	0	0	15	0	0
9	94178371	rs2482356	T	C	3	7	10	0	0	10	0	0
9	94178987	rs2440589	C	T	10	3	13	0	0	13	0	0
9	94179978	rs2482357	G	A	5	6	11	0	0	11	0	0
9	94180627	rs7869771	A	C	4	2	6	0	1	7	0	0
9	94182363	rs2482704	G	T	7	18	25	0	0	25	0	0
9	94835146	.	A	C	6	1	7	0	0	7	0	0
9	94835926	rs117444668	C	T	0	7	7	0	0	7	0	0
9	94972712	.	T	G	17	21	38	0	2	40	0	0
9	95015236	rs7024190	T	C	7	8	15	0	0	15	0	0
9	95016215	rs10820960	C	T	12	9	21	0	1	22	0	0
9	95016799	rs1447114	A	G	9	9	18	0	0	18	0	0
9	95017208	rs504708	G	A	13	14	27	0	0	27	0	0
9	95017588	rs2236341	C	T	4	15	19	0	0	19	0	0
9	95018903	rs9299403	A	G	4	3	7	0	0	7	0	0
9	95020590	rs10820961	C	T	16	16	32	0	0	32	0	0
9	95020914	rs10120980	A	G	14	11	25	0	0	25	0	0
9	95059790	rs710162	T	A	6	4	10	0	0	10	0	0
9	95059804	rs710163	A	G	6	5	11	0	0	11	0	0
9	95068046	rs1133908	C	T	28	30	58	0	0	58	0	0
9	95381334	.	C	T	1	5	6	0	0	6	0	0
9	95395545	rs7863755	A	G	3	3	6	0	0	6	0	0
9	95396409	rs7852698	C	T	4	3	7	0	0	7	0	0
9	95475647	rs10992429	G	T	52	41	93	0	0	93	0	0
9	95481121	.	C	T	13	14	27	0	1	28	0	0
9	95493279	rs912260	C	G	3	3	6	0	0	6	0	0
9	95512070	.	G	A	3	4	7	0	0	7	0	0
9	95512216	rs4743876	C	G	4	6	10	0	0	10	0	0
9	95768448	rs3802384	G	A	97	96	193	0	3	196	0	0
9	95780570	rs75300361	A	G	8	12	20	0	0	20	0	0
9	95874559	.	T	C	926	905	1831	0	8	1839	0	0
9	96209943	rs10821128	T	C	49	54	103	0	1	104	0	0
9	96214928	rs1055710	G	A	4	7	11	0	0	11	0	0
9	96234505	rs34866682	G	C	3	7	10	0	0	10	0	0
9	96234692	rs4743922	A	G	8	30	38	0	0	38	0	0
9	96235585	rs10761228	G	A	11	25	36	0	1	38	1	0
9	96238578	rs10821135	C	T	164	156	320	0	0	320	0	0
9	96263813	rs10821143	G	C	5	2	7	0	0	7	0	0
9	96264911	rs952288	T	C	6	1	7	0	0	7	0	0
9	96265258	rs10821144	C	T	6	4	10	0	0	10	0	0
9	96267271	rs10821145	T	C	28	28	56	0	1	57	0	0
9	96314397	rs10821159	A	T	26	54	80	0	1	81	0	0
9	96326127	rs10821160	T	C	1	5	6	0	0	6	0	0
9	96328303	rs564	T	C	194	177	371	0	0	371	0	0
9	96427505	rs10992839	C	T	4	5	9	0	0	9	0	0
9	96440328	rs1140722	A	G	48	57	105	0	0	105	0	0
9	96440808	rs1132004	C	A	57	60	117	0	0	117	0	0
9	97055310	rs1536690	C	T	5	11	16	0	0	16	0	0
9	97489444	rs10993329	A	G	1	5	6	0	0	6	0	0
9	98638242	rs141071823	T	G	10	13	23	0	0	23	0	0
9	99148649	rs118047818	T	C	3	4	7	0	0	7	0	0
9	100008390	rs7020002	G	A	6	2	8	0	0	8	0	0
9	100038858	rs7867330	A	G	3	3	6	0	0	6	0	0
9	100070351	rs12683119	G	C	4	3	7	0	0	7	0	0
9	100087345	rs3747496	A	G	7	6	13	0	1	14	0	0
9	100105735	rs1947717	T	C	9	13	22	0	0	22	0	0
9	100105782	rs2061634	C	G	9	14	23	0	0	23	0	0
9	100107950	rs71501812	C	T	5	2	7	0	0	7	0	0
9	100337474	rs113960559	C	G	4	2	6	0	0	6	0	0
9	100362582	rs41274250	T	C	24	27	51	0	0	51	0	0
9	100672338	rs2282192	C	T	15	17	32	0	0	32	0	0
9	100772120	rs112915767	G	A	2	5	7	0	0	7	0	0
9	100830129	rs10984930	A	G	5	8	13	0	0	13	0	0
9	100834447	rs76692437	G	A	8	5	13	0	0	13	0	0
9	100962504	rs10046819	G	C	10	5	15	0	0	15	0	0
9	100963977	rs79987207	C	T	4	4	8	0	0	8	0	0
9	100964651	rs3780453	C	T	6	2	8	0	0	8	0	0
9	100964701	rs3780452	T	C	3	4	7	0	0	7	0	0
9	100965451	rs12342968	G	A	6	2	8	0	0	8	0	0
9	100967561	rs10985425	A	G	4	5	9	0	0	9	0	0
9	100968882	rs59673472	C	T	4	4	8	0	0	8	0	0
9	100969483	rs12339078	T	G	3	3	6	0	0	6	0	0
9	100970136	rs3780448	C	A	4	5	9	0	0	9	0	0
9	100970560	rs72603687	C	T	2	4	6	0	0	6	0	0
9	100970606	rs72603688	G	A	2	6	8	0	0	8	0	0
9	100972040	rs7870180	T	C	4	3	7	0	0	7	0	0
9	100976240	rs28930669	A	G	9	13	22	0	1	23	0	0
9	100976608	rs113712634	C	T	7	2	9	0	1	10	0	0
9	100976818	.	C	G	6	2	8	0	1	9	0	0
9	100978083	rs55637063	T	C	5	5	10	0	0	10	0	0
9	100978663	rs12347046	G	T	7	10	17	0	0	17	0	0
9	100979762	rs2900464	G	A	5	3	8	0	0	8	0	0
9	100995721	rs879369	A	G	39	36	75	0	2	77	0	0
9	100995758	rs879368	G	T	37	43	80	0	0	80	0	0
9	101010542	rs80313733	C	T	6	23	29	0	0	29	0	0
9	101010704	rs12349672	G	T	16	3	19	0	0	19	0	0
9	101011129	rs16914199	T	G	8	19	27	0	0	27	0	0
9	101012594	rs7042576	A	G	7	4	11	0	0	11	0	0
9	101894361	rs10819639	T	G	3	4	7	0	0	7	0	0
9	101908365	rs334353	T	G	4	7	11	0	0	11	0	0
9	101911656	rs868	A	G	94	92	186	0	1	187	0	0
9	101912471	rs334348	A	G	14	9	23	0	0	23	0	0
9	101914387	rs334349	G	A	142	146	288	0	6	294	0	0
9	101914873	rs420549	G	C	132	142	274	0	3	277	0	0
9	101916165	rs1590	T	G	16	15	31	0	0	31	0	0
9	101984936	rs170623	C	G	82	86	168	0	0	168	0	0
9	102592688	rs7022059	G	A	3	3	6	0	0	6	0	0
9	102593690	rs7020207	A	G	4	3	7	0	0	7	0	0
9	102595069	rs41274654	G	A	37	16	53	0	2	55	0	0
9	102595685	rs10988904	C	T	42	53	95	0	1	96	0	0
9	102626434	rs141819687	C	T	16	10	26	0	0	26	0	0
9	102677502	.	T	A	6	7	13	0	0	13	0	0
9	102713758	rs1997367	A	G	5	1	6	0	0	6	0	0
9	102714466	rs10512268	G	A	5	1	6	0	0	6	0	0
9	102732237	rs9556	T	C	16	17	33	0	0	33	0	0
9	102787364	rs10760712	A	C	9	4	13	0	0	13	0	0
9	102842941	rs7018981	T	C	3	10	13	0	0	13	0	0
9	102844842	rs1342147	C	A	4	2	6	0	0	6	0	0
9	102850865	rs16918892	T	C	2	4	6	0	0	6	0	0
9	102860928	rs6479001	G	A	3	6	9	0	0	9	0	0
9	102892742	rs2787361	C	T	3	7	10	0	0	10	0	0
9	103054951	rs2787374	T	C	17	13	30	0	0	30	0	0
9	103064530	rs7472	G	A	24	28	52	0	0	52	0	0
9	103065265	rs10124893	G	A	11	11	22	0	1	23	0	0
9	103065884	rs3923501	C	T	3	3	6	0	0	6	0	0
9	103067106	rs7020988	T	C	7	10	17	0	0	17	0	0
9	103068905	rs4743392	T	C	3	8	11	0	0	11	0	0
9	103103347	rs7036570	G	C	24	23	47	0	1	48	0	0
9	103103399	rs7025891	T	C	33	21	54	0	0	54	0	0
9	103105429	rs2417083	T	A	5	8	13	0	0	13	0	0
9	103106944	.	T	C	12	6	18	0	0	18	0	0
9	103106997	rs10118398	G	A	11	8	19	0	0	19	0	0
9	103111965	rs10989064	C	T	9	12	21	0	0	21	0	0
9	103112459	rs944710	C	T	5	12	17	0	0	17	0	0
9	103207170	.	A	G	9	4	13	0	0	13	0	0
9	103213947	rs1556487	A	G	10	17	27	0	1	28	0	0
9	104170350	rs1047968	A	G	2	8	10	0	0	10	0	0
9	104171523	rs45455902	A	G	10	11	21	0	0	21	0	0
9	104171856	rs17772514	C	T	5	10	15	0	0	15	0	0
9	104171995	rs79645744	G	A	3	6	9	0	0	9	0	0
9	104172443	rs1047971	G	T	8	6	14	0	1	15	0	0
9	104302625	rs16920477	A	G	18	18	36	0	0	36	0	0
9	104309445	rs2273976	T	C	11	23	34	0	0	34	0	0
9	104324545	rs10521057	G	A	15	25	40	0	0	40	0	0
9	105968672	rs12337347	C	T	40	0	40	0	0	40	0	0
9	106856691	rs10820599	T	G	6	3	9	0	0	9	0	0
9	106856692	rs10820600	T	C	6	3	9	0	0	9	0	0
9	106896809	rs7872034	G	A	4	4	8	0	0	8	0	0
9	107624029	rs2230805	C	T	3	3	6	0	0	6	0	0
9	108147763	rs3199966	T	G	13	6	19	0	0	19	0	0
9	108152199	rs2771040	G	A	14	13	27	0	0	27	0	0
9	108456888	rs2271247	A	C	7	9	16	0	0	16	0	0
9	108469306	rs10115634	G	A	18	12	30	0	1	31	0	0
9	110091451	.	A	G	5	1	6	0	0	6	0	0
9	110092207	.	G	T	115	71	186	0	2	188	0	0
9	110249505	rs2236599	C	T	11	10	21	0	0	21	0	0
9	111633619	rs7026030	G	C	6	3	9	0	0	9	0	0
9	111641825	rs1538660	G	A	25	28	53	0	0	53	0	0
9	111688828	rs2230788	C	T	15	11	26	0	0	26	0	0
9	111727386	.	C	A	3	8	11	0	0	11	0	0
9	111844246	rs7470160	C	A	6	11	17	0	0	17	0	0
9	111845455	rs7034615	T	C	8	5	13	0	0	13	0	0
9	111845503	rs7049112	C	G	13	8	21	0	1	22	0	0
9	111845637	rs79215781	C	T	16	11	27	0	0	27	0	0
9	111848819	rs11792635	A	G	2	8	10	0	1	11	0	0
9	111868885	rs2271878	G	A	44	58	102	0	1	103	0	0
9	111881856	rs1051474	T	C	3	6	9	0	0	9	0	0
9	111881927	rs6825	T	C	10	8	18	0	0	18	0	0
9	112811038	rs78923754	C	T	16	13	29	0	1	30	0	0
9	112900199	rs914358	T	C	51	42	93	0	1	94	0	0
9	112932329	rs11681	G	A	20	27	47	0	0	47	0	0
9	113006420	rs5843	A	G	391	515	906	0	1	908	1	0
9	113007289	rs4135220	T	G	10	8	18	0	0	18	0	0
9	113007361	rs4135218	T	C	12	19	31	0	0	31	0	0
9	113007796	rs10980284	C	T	6	7	13	0	0	13	0	0
9	113009246	rs4135208	A	G	12	20	32	0	0	32	0	0
9	113009345	rs1344428	C	G	14	10	24	0	1	25	0	0
9	113009446	rs1964889	G	T	10	17	27	0	0	27	0	0
9	113011549	rs7864667	G	A	5	2	7	0	0	7	0	0
9	113015001	.	A	T	10	0	10	0	0	10	0	0
9	113015602	rs4135183	C	T	11	10	21	0	0	21	0	0
9	113016885	rs4135168	T	C	7	8	15	0	0	15	0	0
9	114124693	rs12342050	C	G	31	26	57	0	0	57	0	0
9	114125835	rs2297524	A	G	14	8	22	0	0	22	0	0
9	114126119	rs1060736	T	C	11	16	27	0	0	27	0	0
9	114136169	rs7029123	A	G	3	4	7	0	0	7	0	0
9	114139164	rs12340342	G	A	4	2	6	0	0	6	0	0
9	114174415	rs2418163	T	C	51	61	112	0	0	112	0	0
9	114359624	rs1053959	C	A	5	9	14	0	0	14	0	0
9	114402208	.	C	G	5	18	23	0	1	24	0	0
9	114798037	rs10125054	G	A	9	1	10	0	0	10	0	0
9	114798340	rs118053303	G	C	5	3	8	0	0	8	0	0
9	114798940	rs3739699	G	A	7	2	9	0	0	9	0	0
9	114803286	rs2281788	C	T	27	45	72	0	1	73	0	0
9	114804173	rs3849117	G	A	36	76	112	0	0	112	0	0
9	114916960	rs10981287	T	C	3	5	8	0	0	8	0	0
9	114929943	rs10759528	G	T	7	0	7	0	0	7	0	0
9	114981378	.	T	G	345	320	665	0	0	665	0	0
9	114985497	rs1534069	T	C	45	41	86	0	0	86	0	0
9	114985985	rs10817292	T	A	49	28	77	0	0	77	0	0
9	115052581	rs10981344	A	C	10	2	12	0	0	12	0	0
9	115052981	.	T	C	6	1	7	0	0	7	0	0
9	115052983	.	T	C	6	1	7	0	0	7	0	0
9	115052985	.	T	C	5	1	6	0	1	7	0	0
9	115052987	.	T	C	5	1	6	0	1	7	0	0
9	115054134	rs10981346	A	G	15	2	17	0	0	17	0	0
9	115054554	rs7048383	C	G	11	5	16	0	1	17	0	0
9	115054714	rs7020880	C	A	15	1	16	0	1	17	0	0
9	115056776	rs7857247	A	C	7	3	10	0	0	10	0	0
9	115057257	rs7857973	C	T	7	1	8	0	0	8	0	0
9	115057813	rs10981347	T	G	5	2	7	0	0	7	0	0
9	115058931	rs7852058	T	C	5	3	8	0	0	8	0	0
9	115083875	rs10733587	A	C	5	1	6	0	0	6	0	0
9	115095743	rs7040447	T	C	2	4	6	0	0	6	0	0
9	115234611	rs7096	G	A	11	11	22	0	0	22	0	0
9	115446965	rs1135178	A	T	9	6	15	0	0	15	0	0
9	115631897	.	G	T	2	10	12	0	0	12	0	0
9	115632898	rs16917417	G	A	27	15	42	0	1	43	0	0
9	115636588	rs7026148	T	C	48	43	91	0	1	92	0	0
9	115916255	rs7856379	A	G	3	4	7	0	0	7	0	0
9	115920913	rs7854808	A	G	5	5	10	0	0	10	0	0
9	115921168	rs3935394	G	C	4	6	10	0	0	10	0	0
9	115921204	rs3935395	T	C	4	5	9	0	0	9	0	0
9	115922941	rs10981659	G	A	3	7	10	0	0	10	0	0
9	115923098	rs10981660	C	T	4	6	10	0	0	10	0	0
9	115924278	rs12378957	C	T	10	13	23	0	0	23	0	0
9	115924388	rs4073133	C	T	8	8	16	0	0	16	0	0
9	115924973	rs10817449	A	G	6	5	11	0	0	11	0	0
9	115925104	rs3810906	C	T	95	142	237	0	1	238	0	0
9	115925998	rs12982	T	A	129	147	276	0	3	279	0	0
9	115926203	rs10603	G	T	155	122	277	0	1	278	0	0
9	115927152	rs10817450	C	T	5	10	15	0	0	15	0	0
9	115927857	rs1128150	A	G	20	20	40	0	1	41	0	0
9	115929141	rs12352536	C	T	10	14	24	0	1	25	0	0
9	115930158	rs12340409	T	C	7	11	18	0	0	18	0	0
9	115931210	rs57247612	A	T	8	11	19	0	0	19	0	0
9	115931593	rs1128122	G	A	25	45	70	0	0	70	0	0
9	115932012	rs57348436	G	T	21	27	48	0	0	48	0	0
9	115933885	rs1128118	A	C	20	29	49	0	0	49	0	0
9	115933978	rs1128117	G	A	20	25	45	0	0	45	0	0
9	115933980	rs1128116	C	A	19	24	43	0	1	44	0	0
9	115934698	rs11506774	C	A	5	1	6	0	0	6	0	0
9	115936903	rs3827673	A	G	4	2	6	0	0	6	0	0
9	115938318	rs10981669	T	C	3	4	7	0	0	7	0	0
9	115950156	rs10465129	G	A	14	8	22	0	1	23	0	0
9	115950706	rs10435864	A	C	22	13	35	0	0	35	0	0
9	115983540	rs2233914	G	A	7	6	13	0	0	13	0	0
9	115989723	rs10121845	G	A	8	2	10	0	0	10	0	0
9	116025847	rs75939479	C	T	3	4	7	0	1	8	0	0
9	116037697	rs12343330	T	C	11	9	20	0	0	20	0	0
9	116044998	rs11552582	A	G	28	30	58	0	0	58	0	0
9	116055076	rs11789755	G	A	7	6	13	0	0	13	0	0
9	116122954	rs752757	A	G	74	56	130	0	1	131	0	0
9	116132275	rs3750529	G	A	95	42	137	0	1	138	0	0
9	116132670	rs818712	A	C	60	33	93	0	0	93	0	0
9	116136198	rs1043836	C	T	38	58	96	0	0	96	0	0
9	116138136	rs61467910	G	A	13	9	22	0	0	22	0	0
9	116138612	rs563877631	C	T	2	4	6	0	0	6	0	0
9	116153891	rs1800435	C	G	34	39	73	0	0	73	0	0
9	116153900	rs1139488	A	G	38	37	75	0	0	75	0	0
9	116191667	rs41276817	G	C	32	14	46	0	0	46	0	0
9	116269892	rs36062487	C	T	12	11	23	0	0	23	0	0
9	116346510	.	C	T	8	4	12	0	0	12	0	0
9	116780314	rs4979325	T	C	4	2	6	0	0	6	0	0
9	116815148	rs12003412	C	G	16	9	25	0	0	25	0	0
9	116816581	rs13302015	G	A	26	27	53	0	0	53	0	0
9	116816582	rs55994673	A	T	25	27	52	0	0	52	0	0
9	116816880	rs36118163	G	A	32	33	65	0	0	65	0	0
9	116817346	rs72759047	C	T	15	14	29	0	1	30	0	0
9	116817668	rs13287555	C	T	21	11	32	0	0	32	0	0
9	117097755	rs10739407	C	T	3	3	6	0	0	6	0	0
9	117164878	.	C	T	2	5	7	0	0	7	0	0
9	117266965	rs2297815	C	T	2	4	6	0	0	6	0	0
9	117267472	rs4527950	G	T	5	12	17	0	0	17	0	0
9	117267591	rs10759714	C	T	9	9	18	0	0	18	0	0
9	120845262	rs2722863	A	C	0	23	23	0	8	31	0	0
9	123152241	rs2297456	A	C	1	5	6	0	0	6	0	0
9	123156790	rs77100552	A	G	40	45	85	0	2	87	0	0
9	123166583	rs3780673	C	G	6	5	11	0	0	11	0	0
9	123166919	rs3780674	C	T	5	7	12	0	0	12	0	0
9	123170167	rs914592	G	A	3	5	8	0	0	8	0	0
9	123170210	rs914593	G	C	2	5	7	0	0	7	0	0
9	123170733	rs4837768	C	G	27	22	49	0	1	50	0	0
9	123220829	rs2501727	A	G	17	17	34	0	0	34	0	0
9	123291036	rs4836822	C	G	7	16	23	0	0	23	0	0
9	123301346	rs3750494	T	G	8	11	19	0	0	19	0	0
9	123365678	rs55720411	C	T	10	8	18	0	0	18	0	0
9	123618971	rs914842	A	G	32	24	56	0	0	56	0	0
9	123638269	rs2297574	T	C	5	3	8	0	0	8	0	0
9	123666569	rs139890149	C	A	22	19	41	0	0	41	0	0
9	123671520	rs2239657	G	A	14	15	29	0	1	30	0	0
9	123675801	rs3747841	G	A	11	9	20	0	0	20	0	0
9	123676699	rs758959	C	T	2	4	6	0	0	6	0	0
9	123681116	rs1008381	T	C	6	8	14	0	0	14	0	0
9	123681255	rs1008382	C	G	4	6	10	0	0	10	0	0
9	123682472	rs2269059	T	A	3	3	6	0	0	6	0	0
9	123683106	rs2109896	C	T	3	3	6	0	0	6	0	0
9	123683579	rs1008383	C	G	1	7	8	0	0	8	0	0
9	123683834	rs2191959	T	A	5	8	13	0	0	13	0	0
9	123684157	rs7021206	G	A	5	1	6	0	0	6	0	0
9	123684943	rs1014529	C	G	6	4	10	0	0	10	0	0
9	123685213	rs2269062	C	T	2	4	6	0	0	6	0	0
9	123685280	rs1548784	T	C	3	4	7	0	0	7	0	0
9	123686731	rs2284926	A	T	4	2	6	0	0	6	0	0
9	123687372	rs7034653	G	A	5	2	7	0	0	7	0	0
9	123687513	rs7045264	C	T	2	4	6	0	0	6	0	0
9	123716840	rs2300929	T	C	0	6	6	0	0	6	0	0
9	123725971	rs12237774	C	T	6	7	13	0	0	13	0	0
9	123783934	rs10985126	T	C	5	2	7	0	0	7	0	0
9	123842873	rs6478499	A	G	4	3	7	0	0	7	0	0
9	123847781	rs12237512	A	G	3	4	7	0	0	7	0	0
9	123909363	rs7870738	T	C	5	2	7	0	0	7	0	0
9	123909744	rs78175730	T	C	3	4	7	0	0	7	0	0
9	123914874	rs9408926	C	T	30	24	54	0	3	57	0	0
9	123929710	rs10818513	A	G	6	0	6	0	0	6	0	0
9	123937156	rs10985171	A	G	6	8	14	0	0	14	0	0
9	123941085	rs2057469	A	G	6	8	14	0	0	14	0	0
9	123941122	rs2057470	A	G	11	7	18	0	0	18	0	0
9	123946947	rs7047038	T	G	15	13	28	0	0	28	0	0
9	123947985	rs10760152	A	C	12	13	25	0	0	25	0	0
9	123949635	rs147629476	A	G	16	14	30	0	0	30	0	0
9	123951206	rs1535657	G	A	37	45	82	0	1	83	0	0
9	123951685	rs942152	C	T	36	30	66	0	0	66	0	0
9	123951732	rs942153	A	G	33	35	68	0	0	68	0	0
9	123951917	rs9408928	T	C	26	25	51	0	2	53	0	0
9	123952654	rs10760157	T	C	10	15	25	0	0	25	0	0
9	123954325	rs77375833	A	G	5	4	9	0	0	9	0	0
9	123956335	rs75673233	T	C	2	5	7	0	0	7	0	0
9	123956492	rs111701599	T	C	7	6	13	0	0	13	0	0
9	124046691	rs55716465	G	T	4	2	6	0	0	6	0	0
9	124083614	rs2304393	C	T	488	628	1116	0	4	1120	0	0
9	124088359	rs10985209	C	T	3	5	8	0	0	8	0	0
9	124094590	rs7039494	A	T	5	3	8	0	0	8	0	0
9	124101563	rs442472	C	T	417	369	786	0	2	788	0	0
9	124102896	rs1135387	C	T	177	178	355	0	0	355	0	0
9	124580040	rs4837891	G	A	3	3	6	0	0	6	0	0
9	125000860	rs1044680	G	C	23	15	38	0	0	38	0	0
9	125002218	rs10818654	G	C	15	6	21	0	1	22	0	0
9	125002246	rs10760214	G	A	6	14	20	0	0	20	0	0
9	125002275	rs10818655	T	C	15	4	19	0	0	19	0	0
9	125003196	rs3829097	T	A	103	71	174	0	1	175	0	0
9	125003679	rs1060586	G	A	80	61	141	0	2	143	0	0
9	125003751	rs10739606	T	C	43	62	105	0	1	106	0	0
9	125005105	rs10760215	T	C	3	5	8	0	0	8	0	0
9	125008524	rs12343970	C	T	7	6	13	0	0	13	0	0
9	125008911	rs12553258	C	A	7	1	8	0	0	8	0	0
9	125011156	rs117687670	T	C	7	1	8	0	0	8	0	0
9	125011197	rs10818659	C	T	5	1	6	0	0	6	0	0
9	125013084	rs10760219	G	T	2	6	8	0	0	8	0	0
9	125016348	rs10121876	C	A	5	2	7	0	0	7	0	0
9	125023974	rs2297177	G	A	1	5	6	0	0	6	0	0
9	125026162	rs10760220	A	G	2	4	6	0	0	6	0	0
9	125607011	rs12981	T	C	41	22	63	0	2	65	0	0
9	125608627	rs10818754	T	C	9	17	26	0	0	26	0	0
9	125652757	rs10818759	G	A	120	130	250	0	2	252	0	0
9	125653645	rs4838019	G	C	7	5	12	0	0	12	0	0
9	125660970	rs10985810	G	C	2	10	12	0	0	12	0	0
9	125673051	rs1147321	T	G	4	7	11	0	0	11	0	0
9	125675559	rs2239539	G	A	6	0	6	0	0	6	0	0
9	125678603	rs2793008	G	A	6	6	12	0	0	12	0	0
9	125680547	rs2241064	C	T	30	27	57	0	0	57	0	0
9	125813505	rs10985875	T	G	12	0	12	0	3	15	0	0
9	125813506	rs10985876	T	G	14	0	14	0	1	15	0	0
9	125855711	rs12351386	C	T	3	3	6	0	0	6	0	0
9	125865980	.	G	T	8	9	17	0	0	17	0	0
9	125866070	rs700082	G	C	20	17	37	0	0	37	0	0
9	125866772	rs9032	C	G	21	24	45	0	2	47	0	0
9	125920376	rs803736	G	A	60	57	117	0	0	118	1	0
9	125999117	rs72616646	G	A	12	4	16	0	0	16	0	0
9	126150830	rs2797945	G	A	9	5	14	0	0	14	0	0
9	126152256	rs1891639	G	A	4	3	7	0	0	7	0	0
9	126152433	rs2416906	T	C	2	5	7	0	1	8	0	0
9	126152911	rs1891640	T	C	3	4	7	0	0	7	0	0
9	126153084	rs10818813	C	T	3	5	8	0	0	8	0	0
9	126153265	rs12347368	C	T	4	7	11	0	0	11	0	0
9	126153310	rs2491351	A	G	7	1	8	0	0	8	0	0
9	126154354	rs872863	C	T	4	2	6	0	0	6	0	0
9	126154629	rs144995419	A	C	7	5	12	0	0	12	0	0
9	126154776	rs1891642	G	A	9	5	14	0	0	14	0	0
9	126155550	rs2808413	A	C	8	4	12	0	0	12	0	0
9	126155803	rs2051075	G	T	5	4	9	0	0	10	1	0
9	126156092	rs7045176	C	G	4	5	9	0	0	9	0	0
9	126156931	rs12686320	C	T	5	5	10	0	0	10	0	0
9	126157360	rs4838057	A	C	8	5	13	0	0	13	0	0
9	126157854	rs7858443	G	C	5	8	13	0	0	13	0	0
9	126158026	rs7858474	C	G	1	5	6	0	0	6	0	0
9	126158278	rs7858738	A	G	7	4	11	0	0	11	0	0
9	126158644	rs10217135	G	A	3	4	7	0	0	7	0	0
9	126162985	rs10986006	G	A	6	1	7	0	0	7	0	0
9	126451986	rs58097039	C	T	3	5	8	0	0	8	0	0
9	126452004	rs57299923	T	C	2	5	7	0	0	7	0	0
9	126520068	rs9785285	T	C	82	86	168	0	1	169	0	0
9	127047434	rs11794587	G	A	8	5	13	0	1	14	0	0
9	127052467	rs4838152	A	G	4	2	6	0	0	6	0	0
9	127566378	rs7874348	A	G	18	21	39	0	0	39	0	0
9	127620945	rs3818761	C	G	3	3	6	0	0	6	0	0
9	127622073	rs2067553	G	A	8	5	13	0	0	13	0	0
9	127632067	rs6478689	G	C	23	10	33	0	0	33	0	0
9	127634429	rs1999589	G	T	35	37	72	0	0	72	0	0
9	127635406	rs10819001	T	C	42	43	85	0	0	85	0	0
9	127635713	rs10986471	A	G	48	59	107	0	0	107	0	0
9	127639695	rs1051358	C	T	265	259	524	0	3	527	0	0
9	127641764	rs1058540	G	A	6	5	11	0	0	11	0	0
9	127643456	rs687434	T	C	6	7	13	0	0	13	0	0
9	127661645	rs634710	G	A	7	3	10	0	0	10	0	0
9	127711321	rs7040520	A	G	8	9	17	0	0	17	0	0
9	127713062	rs12344394	T	G	4	3	7	0	0	7	0	0
9	127713478	rs10819014	G	T	2	4	6	0	0	6	0	0
9	127713741	rs7850205	C	G	3	3	6	0	1	7	0	0
9	127818276	rs589292	C	T	86	72	158	0	1	159	0	0
9	127903013	rs7042065	T	C	4	5	9	0	1	10	0	0
9	127909069	rs6744	C	T	13	5	18	0	0	18	0	0
9	127909622	rs2535	G	C	17	27	44	0	1	45	0	0
9	127910307	rs1549314	T	G	16	26	42	0	0	43	1	0
9	127910498	rs1048251	G	T	28	21	49	0	0	49	0	0
9	127911135	rs4838250	C	A	4	5	9	0	0	9	0	0
9	127912316	rs7869453	G	A	3	3	6	0	0	6	0	0
9	127913764	rs7019234	A	G	17	14	31	0	0	31	0	0
9	127913837	rs7019470	C	T	13	13	26	0	0	26	0	0
9	127914865	rs10819037	C	T	2	4	6	0	1	7	0	0
9	127915210	rs7867749	T	C	4	3	7	0	1	8	0	0
9	127915289	rs7852420	C	T	3	12	15	0	1	16	0	0
9	127915421	rs7855700	G	A	5	7	12	0	0	12	0	0
9	127916457	rs1517411	G	A	7	3	10	0	0	10	0	0
9	127917257	rs12378015	G	A	3	5	8	0	0	8	0	0
9	127917311	rs7846942	T	G	4	4	8	0	0	9	1	0
9	127923013	rs4837010	T	C	6	7	13	0	0	13	0	0
9	127923014	rs4837011	G	T	6	7	13	0	0	13	0	0
9	127924012	rs4837012	G	T	5	4	9	0	0	9	0	0
9	127926497	.	C	T	2	5	7	0	0	7	0	0
9	127927316	rs7851132	G	A	3	3	6	0	0	6	0	0
9	127928735	rs10986600	T	C	4	3	7	0	0	7	0	0
9	127929132	rs12380566	C	T	4	4	8	0	0	8	0	0
9	127939471	rs360005	A	G	11	3	14	0	0	14	0	0
9	127951582	rs460269	G	C	3	9	12	0	0	12	0	0
9	127951583	rs459941	C	T	3	9	12	0	0	12	0	0
9	127951863	rs466994	G	A	11	11	22	0	1	23	0	0
9	127952210	rs459311	G	T	4	2	6	0	0	6	0	0
9	127975583	rs359588	T	C	4	2	6	0	0	6	0	0
9	127983226	rs359578	G	A	6	4	10	0	0	10	0	0
9	127997303	rs12009	G	A	18	10	28	0	0	28	0	0
9	127997592	rs1140763	G	A	15	9	24	0	0	24	0	0
9	128070227	rs1333055	G	C	8	3	11	0	0	11	0	0
9	128070510	rs2184062	T	A	15	5	20	0	0	20	0	0
9	128070609	.	T	A	10	0	10	0	0	10	0	0
9	128070754	rs521308	C	T	3	3	6	0	0	6	0	0
9	128070792	rs492843	A	G	5	3	8	0	0	8	0	0
9	128071017	rs16928051	G	A	24	32	56	0	0	56	0	0
9	128074807	rs432757	T	C	25	20	45	0	0	45	0	0
9	128076069	rs2009570	G	A	4	4	8	0	0	8	0	0
9	128078896	rs7389288	G	A	3	5	8	0	0	8	0	0
9	128078916	rs513228	T	C	3	3	6	0	0	6	0	0
9	128104105	rs828290	A	C	1	12	13	0	0	13	0	0
9	128107885	rs10986716	A	G	1	5	6	0	0	6	0	0
9	128110553	rs13291655	C	T	2	4	6	0	0	6	0	0
9	128110852	rs3104550	T	C	11	2	13	0	0	13	0	0
9	128126647	rs2841333	G	C	39	38	77	0	0	77	0	0
9	128127412	rs10819047	A	G	16	5	21	0	0	21	0	0
9	128128782	rs2291858	A	G	11	12	23	0	1	24	0	0
9	128199873	rs1129	C	T	52	40	92	0	0	92	0	0
9	128200299	rs12202	C	G	37	54	91	0	1	92	0	0
9	128233506	rs7018948	G	A	8	0	8	0	0	8	0	0
9	128234347	rs10986772	T	C	5	1	6	0	0	6	0	0
9	128237178	rs10819050	G	T	3	3	6	0	0	6	0	0
9	128511236	rs12347819	G	A	72	53	125	0	3	128	0	0
9	129102840	rs1888156	G	A	40	65	105	0	2	107	0	0
9	129158002	rs722538	G	A	8	28	36	0	0	36	0	0
9	129159558	rs2241011	G	T	13	24	37	0	0	37	0	0
9	129217525	rs4546753	G	C	2	11	13	0	0	13	0	0
9	129265612	rs3814128	C	A	39	28	67	0	0	67	0	0
9	129265797	rs3814126	G	C	56	25	81	0	0	81	0	0
9	129266187	rs3739566	G	A	58	46	104	0	0	104	0	0
9	129267150	rs56320611	A	G	36	64	100	0	0	100	0	0
9	129267975	rs3814124	A	G	71	42	113	0	0	113	0	0
9	129268204	rs10739677	T	G	79	50	129	0	0	129	0	0
9	129268676	rs3814123	C	G	100	38	138	0	0	138	0	0
9	129453229	rs2277158	A	G	44	19	63	0	1	64	0	0
9	129455587	rs13295990	G	C	30	14	44	0	2	46	0	0
9	129459314	rs34200683	C	T	14	5	19	0	0	19	0	0
9	129459438	rs10987413	G	A	20	2	22	0	0	22	0	0
9	129459478	rs10987414	C	T	15	1	16	0	0	16	0	0
9	129460312	rs10987415	A	G	11	5	16	0	0	16	0	0
9	129460396	rs10987416	C	T	9	2	11	0	1	12	0	0
9	129460914	rs10733682	A	G	7	25	32	0	0	32	0	0
9	129461124	rs10760451	G	C	12	24	36	0	0	36	0	0
9	129461714	rs4083644	C	T	14	11	25	0	0	25	0	0
9	129461912	rs3861878	A	G	20	6	26	0	0	26	0	0
9	129462072	rs4083645	T	C	13	5	18	0	0	18	0	0
9	129462076	rs7023938	G	A	11	6	17	0	1	18	0	0
9	129462501	rs10987417	G	T	18	5	23	0	0	23	0	0
9	129462563	rs10987418	A	G	13	4	17	0	1	18	0	0
9	129462594	rs10987419	T	C	13	4	17	0	0	17	0	0
9	129462687	rs10987422	C	A	21	2	23	0	0	23	0	0
9	129462901	rs3814119	T	C	30	4	34	0	1	35	0	0
9	129570158	rs10819235	A	T	6	3	9	0	0	9	0	0
9	129595895	rs3118994	T	C	53	46	99	0	1	100	0	0
9	129645708	.	G	A	19	11	30	0	0	30	0	0
9	130129443	rs3802369	C	T	2	4	6	0	0	6	0	0
9	130164376	rs182999007	G	A	4	3	7	0	0	7	0	0
9	130165973	rs34064803	T	C	8	17	25	0	0	25	0	0
9	130169874	rs6635	A	G	10	14	24	0	0	24	0	0
9	130170000	rs3088163	A	T	4	6	10	0	0	10	0	0
9	130191186	rs13292096	C	T	3	5	8	0	0	8	0	0
9	130197414	rs4504745	A	G	3	5	8	0	0	8	0	0
9	130206762	rs2248025	C	T	3	5	8	0	0	8	0	0
9	130210111	rs1139400	T	C	8	3	11	0	0	11	0	0
9	130210946	rs2247573	A	G	5	1	6	0	0	6	0	0
9	130213508	rs2244624	A	G	189	140	329	0	2	332	1	0
9	130219669	rs2243906	C	T	17	8	25	0	0	25	0	0
9	130221388	rs2243767	T	C	0	6	6	0	0	6	0	0
9	130494667	rs534652	G	A	16	9	25	0	1	26	0	0
9	130494811	rs515182	T	C	11	10	21	0	1	22	0	0
9	130495259	rs41316956	C	T	28	28	56	0	0	56	0	0
9	130495633	rs564754	C	G	12	22	34	0	0	34	0	0
9	130495890	rs3739812	A	C	4	2	6	0	0	6	0	0
9	130504070	rs514024	G	A	39	34	73	0	0	73	0	0
9	130504348	rs568577446	G	A	11	10	21	0	0	21	0	0
9	130528548	rs4836579	C	T	9	2	11	0	0	11	0	0
9	130536484	rs55932444	C	T	24	25	49	0	0	49	0	0
9	130536717	rs10760500	G	A	21	16	37	0	1	38	0	0
9	130578404	rs10760503	A	G	3	5	8	0	0	8	0	0
9	130579810	rs1330683	C	G	7	4	11	0	0	11	0	0
9	130580093	rs10987746	T	C	7	1	8	0	0	8	0	0
9	130581723	rs10819309	A	G	7	7	14	0	0	14	0	0
9	130594064	rs142511536	G	A	5	2	7	0	0	7	0	0
9	130596452	rs111472164	A	G	18	9	27	0	0	27	0	0
9	130597223	rs17557600	T	C	4	3	7	0	0	7	0	0
9	130629139	rs913987	T	G	6	3	9	0	0	9	0	0
9	130630233	rs4226	G	T	19	21	40	0	1	41	0	0
9	130671599	rs10819319	T	C	12	3	15	0	0	15	0	0
9	130671617	rs12552745	A	G	4	10	14	0	0	14	0	0
9	130698029	rs7997	G	C	60	32	92	0	1	93	0	0
9	130698043	rs6781	A	G	60	31	91	0	2	93	0	0
9	130699917	rs2274424	G	A	5	3	8	0	0	8	0	0
9	130703565	rs7859	A	G	21	22	43	0	0	43	0	0
9	130703789	rs6478803	G	A	26	20	46	0	0	46	0	0
9	130704975	rs3818510	T	C	21	24	45	0	0	45	0	0
9	130705120	rs1043060	C	T	28	17	45	0	0	45	0	0
9	130707081	rs2274426	A	G	26	17	43	0	0	43	0	0
9	131346224	.	A	T	79	30	109	0	0	109	0	0
9	131418899	rs375929394	C	A	11	12	23	0	0	23	0	0
9	131457272	.	G	C	1947	0	1947	0	6	1953	0	0
9	131671561	rs35266233	C	G	75	106	181	0	0	181	0	0
9	131689361	rs751340	G	A	14	13	27	0	0	27	0	0
9	131700051	.	G	A	3	4	7	0	0	7	0	0
9	131702891	rs2273866	A	G	6	3	9	0	0	9	0	0
9	131710847	rs72758897	A	G	4	4	8	0	0	8	0	0
9	131767668	rs2287363	A	C	45	42	87	0	0	87	0	0
9	131771505	rs1129098	C	T	84	76	160	0	1	161	0	0
9	131846957	rs11541836	T	C	5	8	13	0	0	13	0	0
9	131852565	.	T	A	4	5	9	0	0	9	0	0
9	132268255	rs1780457	T	C	25	31	56	0	1	57	0	0
9	132268357	rs2091116	C	T	20	34	54	0	0	54	0	0
9	132268806	rs11793805	C	T	17	5	22	0	1	23	0	0
9	132397166	rs9691	A	G	44	32	76	0	0	76	0	0
9	132399200	rs1045647	T	C	18	21	39	0	1	40	0	0
9	132400480	rs3739851	G	A	77	81	158	0	1	159	0	0
9	132401129	rs73670149	C	T	16	20	36	0	0	36	0	0
9	132403241	rs2241246	T	A	2	5	7	0	0	7	0	0
9	132566666	rs7029757	G	A	5	6	11	0	0	11	0	0
9	132568500	rs10116248	C	T	9	5	14	0	0	14	0	0
9	132569442	rs2302820	G	A	4	6	10	0	0	10	0	0
9	132569750	rs11789668	C	G	8	7	15	0	0	15	0	0
9	132570602	rs146693094	C	G	5	7	12	0	0	12	0	0
9	132570924	rs13290805	A	G	5	3	8	0	0	8	0	0
9	132572625	rs71481355	T	G	7	0	7	0	2	9	0	0
9	132572627	rs553747620	T	G	8	0	8	0	2	10	0	0
9	132572793	rs2287367	A	C	16	16	32	0	0	32	0	0
9	132573290	rs1043186	C	T	13	20	33	0	0	33	0	0
9	132575797	rs1045441	A	T	17	15	32	0	1	33	0	0
9	132576037	rs1183	G	C	78	40	118	0	0	118	0	0
9	132576060	rs1182	C	A	55	73	128	0	2	130	0	0
9	132576427	.	T	C	45	74	119	0	2	121	0	0
9	132578949	rs3780696	G	A	1	10	11	0	0	11	0	0
9	132579110	rs3780697	T	C	3	6	9	0	0	9	0	0
9	132579111	rs3780698	T	G	3	6	9	0	0	9	0	0
9	132580686	rs13297609	G	C	4	2	6	0	0	6	0	0
9	132583891	rs12002810	G	A	5	3	8	0	0	8	0	0
9	132583929	rs34429226	C	T	4	8	12	0	1	13	0	0
9	132584048	rs71481356	C	T	5	8	13	0	0	13	0	0
9	132585058	rs2296793	G	A	38	50	88	0	0	88	0	0
9	132589606	rs8113	T	C	14	11	25	0	0	25	0	0
9	132589633	rs8719	T	A	43	44	87	0	1	88	0	0
9	132590070	rs543640902	T	C	270	70	340	0	10	350	0	0
9	132590159	rs11789220	T	C	322	309	631	0	6	637	0	0
9	132590352	rs1806988	A	G	433	340	773	0	2	775	0	0
9	132590353	rs1806989	G	T	433	338	771	0	4	775	0	0
9	132590431	rs732074	C	G	434	456	890	0	3	894	1	0
9	132590837	rs35168956	G	A	4	2	6	0	0	6	0	0
9	132590843	rs45441205	C	T	5	1	6	0	0	6	0	0
9	132590860	rs45562032	A	G	3	5	8	0	0	8	0	0
9	132590912	rs45581233	G	C	3	7	10	0	0	10	0	0
9	132590997	rs35075313	T	C	3	4	7	0	0	7	0	0
9	132591272	rs55962905	T	C	7	12	19	0	1	20	0	0
9	132591372	rs7032945	T	G	4	9	13	0	0	13	0	0
9	132591425	rs7047271	C	T	3	5	8	0	0	8	0	0
9	132591509	rs3818553	A	G	535	481	1016	0	1	1017	0	0
9	132591992	rs41278732	T	C	2	5	7	0	0	7	0	0
9	132592115	rs35632463	T	C	7	4	11	0	0	11	0	0
9	132592211	rs13290140	A	G	5	6	11	0	0	11	0	0
9	132593982	rs2062801	T	C	11	8	19	0	0	19	0	0
9	132596031	rs2274507	T	C	19	11	30	0	0	30	0	0
9	132596071	rs2274508	C	T	12	15	27	0	1	28	0	0
9	132596159	rs67061074	C	T	8	17	25	0	0	25	0	0
9	132596899	rs3814548	G	A	12	7	19	0	0	19	0	0
9	132597021	rs3814547	C	T	443	404	847	0	17	864	0	0
9	132597774	rs3758334	T	C	23	19	42	0	0	42	0	0
9	132605582	rs57312895	T	G	5	6	11	0	0	11	0	0
9	132605703	rs72755265	T	C	8	3	11	0	0	11	0	0
9	132605704	rs72755266	G	A	8	3	11	0	0	11	0	0
9	132614481	rs62586274	T	C	4	2	6	0	0	6	0	0
9	132614540	rs62586275	T	G	3	3	6	0	0	6	0	0
9	132614557	rs62586276	A	G	3	3	6	0	0	6	0	0
9	132620364	rs10819568	T	C	37	34	71	0	0	71	0	0
9	132623293	rs1503375	C	T	26	27	53	0	0	53	0	0
9	132623868	rs10115249	T	C	36	52	88	0	0	88	0	0
9	132626599	rs7023940	T	C	4	2	6	0	0	6	0	0
9	132626976	rs1809961	T	C	5	1	6	0	0	6	0	0
9	132627324	rs913318	C	T	4	3	7	0	0	7	0	0
9	132627723	rs913320	G	A	6	1	7	0	0	7	0	0
9	132628677	rs871170	G	C	4	4	8	0	0	8	0	0
9	132629386	rs1108533	A	T	4	2	6	0	1	7	0	0
9	132630231	rs913325	A	G	8	3	11	0	0	11	0	0
9	132630822	rs4258092	C	T	7	6	13	0	0	13	0	0
9	132630866	rs7033280	C	T	6	7	13	0	0	13	0	0
9	132631680	rs6478920	T	C	35	24	59	0	0	59	0	0
9	132632178	rs62583580	C	T	8	5	13	0	0	13	0	0
9	132632367	rs2039025	A	G	5	8	13	0	0	13	0	0
9	132632653	rs41279154	A	G	5	2	7	0	0	7	0	0
9	132636920	rs35899714	C	T	45	37	82	0	0	82	0	0
9	132637712	rs735115	G	A	62	48	110	0	1	111	0	0
9	132651576	rs116529814	C	T	125	117	242	0	1	243	0	0
9	132652699	rs114483837	G	T	30	27	57	0	0	57	0	0
9	132656130	rs147706265	G	T	29	36	65	0	1	66	0	0
9	132663445	rs35582437	G	A	5	3	8	0	0	8	0	0
9	132664382	rs62583606	A	G	5	5	10	0	0	10	0	0
9	132671873	rs10819574	A	G	3	6	9	0	0	9	0	0
9	132672077	rs10819576	C	G	3	3	6	0	0	6	0	0
9	132672962	rs10465144	T	C	10	13	23	0	0	23	0	0
9	132673694	rs10739766	C	T	14	12	26	0	0	26	0	0
9	132674926	rs7025726	T	C	5	3	8	0	0	8	0	0
9	132678013	rs62583608	C	T	6	7	13	0	0	13	0	0
9	132678428	rs71499495	T	C	14	6	20	0	0	20	0	0
9	132718074	rs72757267	G	A	12	5	17	0	1	18	0	0
9	132839747	rs41301535	T	C	5	7	12	0	0	12	0	0
9	132895542	rs2417171	C	G	5	2	7	0	0	7	0	0
9	132896979	rs10988600	C	T	3	3	6	0	0	6	0	0
9	132897231	rs1003416	G	A	5	4	9	0	1	10	0	0
9	132898193	rs2240913	G	A	56	54	110	0	1	111	0	0
9	132900076	rs1306	T	C	93	98	191	0	2	193	0	0
9	134020086	rs61751470	A	G	30	29	59	0	0	59	0	0
9	134020092	rs103612	C	T	30	29	59	0	0	59	0	0
9	134078843	rs35834418	A	T	4	4	8	0	0	8	0	0
9	134079935	.	T	C	4	5	9	0	0	9	0	0
9	134353513	rs4587373	C	T	2	4	6	0	0	6	0	0
9	134366109	rs45538742	T	C	71	97	168	0	2	170	0	0
9	134452423	.	G	A	41	33	74	0	0	74	0	0
9	134453976	rs3739497	G	A	154	128	282	0	4	286	0	0
9	134467754	rs11794623	T	A	5	8	13	0	0	13	0	0
9	134468872	rs3780267	C	T	6	4	10	0	0	10	0	0
9	134468903	rs3780266	G	C	5	4	9	0	0	9	0	0
9	134469913	rs3780264	G	A	10	9	19	0	0	19	0	0
9	134471153	rs3808803	C	T	12	5	17	0	1	18	0	0
9	134471264	rs875968	C	T	5	6	11	0	0	11	0	0
9	134473517	rs2296950	T	C	4	2	6	0	0	6	0	0
9	134607703	rs76487528	C	T	2	4	6	0	0	6	0	0
9	135109869	rs1999391	T	C	2	4	6	0	0	6	0	0
9	135110034	rs10901140	G	A	5	1	6	0	0	6	0	0
9	135110456	rs1810887	C	T	5	4	9	0	0	9	0	0
9	135118000	.	A	T	58	13	71	0	1	72	0	0
9	135138258	rs7025	C	T	31	27	58	0	1	59	0	0
9	135138777	rs74975459	C	A	30	28	58	0	2	60	0	0
9	135139000	rs11795382	G	A	25	32	57	0	0	57	0	0
9	135139064	rs11787894	G	T	19	36	55	0	0	55	0	0
9	135139901	rs1056899	T	C	190	166	356	0	2	358	0	0
9	135141282	rs10901150	C	T	9	1	10	0	0	10	0	0
9	135145623	rs7045098	T	C	5	2	7	0	0	7	0	0
9	135145804	rs10793909	A	G	3	3	6	0	0	6	0	0
9	135230228	.	G	T	1	8	9	0	0	9	0	0
9	135257019	rs12685766	A	G	2	4	6	0	0	6	0	0
9	135277007	rs3739916	C	T	7	7	14	0	0	14	0	0
9	135494669	rs306568	T	C	2	5	7	0	0	7	0	0
9	135554566	rs371169	G	A	86	61	147	0	2	149	0	0
9	135554687	.	T	C	58	58	116	0	3	119	0	0
9	135555341	rs424416	G	A	2	4	6	0	0	6	0	0
9	135561770	rs567423	T	C	5	1	6	0	0	6	0	0
9	135562339	rs458035	T	C	4	2	6	0	0	6	0	0
9	135564734	rs462791	T	C	93	103	196	0	2	198	0	0
9	135564946	rs708616	A	G	40	47	87	0	0	87	0	0
9	135565657	rs441953	T	C	104	68	172	0	1	173	0	0
9	135565670	rs371222	C	A	101	68	169	0	0	169	0	0
9	135566174	rs459751	A	G	13	13	26	0	1	27	0	0
9	135566518	rs505086	G	A	14	5	19	0	0	19	0	0
9	135567064	rs2769950	G	A	9	9	18	0	0	18	0	0
9	135567388	rs2772006	T	G	4	5	9	0	0	9	0	0
9	135567493	rs12683918	G	A	13	15	28	0	0	28	0	0
9	135567850	rs2772005	C	G	11	7	18	0	0	18	0	0
9	135569543	rs302919	C	T	6	5	11	0	0	11	0	0
9	135569919	rs1045740	A	G	13	13	26	0	0	26	0	0
9	135569995	rs3087825	G	C	10	6	16	0	0	16	0	0
9	135767185	rs11553763	C	T	26	36	62	0	0	62	0	0
9	135770134	rs739442	G	A	8	6	14	0	0	14	0	0
9	135770250	rs58612431	A	C	5	15	20	0	0	20	0	0
9	135772717	rs4962081	G	A	8	20	28	0	0	28	0	0
9	135866871	rs142402098	G	A	14	6	20	0	1	21	0	0
9	135974079	rs1062356	G	C	350	445	795	0	4	799	0	0
9	135974100	rs886017	G	A	391	449	840	0	7	848	1	0
9	135975356	rs2773828	A	C	261	221	482	0	3	485	0	0
9	135976664	rs34018822	C	T	66	64	130	0	3	133	0	0
9	135976698	rs35108384	G	A	67	58	125	0	1	126	0	0
9	135977586	rs76832424	C	T	6	6	12	0	0	12	0	0
9	135985796	rs3761824	C	T	253	223	476	0	2	478	0	0
9	135988962	rs11244001	C	G	5	8	13	0	0	13	0	0
9	135995166	rs10901235	A	G	5	3	8	0	0	8	0	0
9	136126129	rs10901251	A	C	36	0	36	0	0	36	0	0
9	136126495	rs34266669	C	T	26	0	26	0	0	26	0	0
9	136126498	rs199969472	G	A	25	0	25	0	0	25	0	0
9	136126499	rs76700116	A	C	24	0	24	0	1	25	0	0
9	136135108	rs8176707	G	T	0	26	26	0	0	26	0	0
9	136197834	rs12335	G	A	18	15	33	0	0	33	0	0
9	136199466	rs886089	G	A	68	29	97	0	0	97	0	0
9	136199503	rs886090	G	A	63	31	94	0	0	94	0	0
9	136200810	rs120858	G	A	15	17	32	0	0	32	0	0
9	136208044	rs621907	C	T	25	27	52	0	0	52	0	0
9	136213521	rs616836	T	C	9	9	18	0	0	18	0	0
9	136215356	rs28613394	C	G	7	4	11	0	0	11	0	0
9	136215400	rs28538967	G	C	6	10	16	0	0	16	0	0
9	136223043	rs59358281	C	G	7	8	15	0	0	15	0	0
9	136227260	rs12763	A	G	28	37	65	0	1	66	0	0
9	136228865	rs1059773	C	A	352	311	663	0	2	665	0	0
9	136229833	rs2494	C	G	418	350	768	0	7	776	1	0
9	136232758	rs2269894	T	C	17	9	26	0	0	26	0	0
9	136235100	rs28374096	G	C	15	12	27	0	0	27	0	0
9	136237672	rs56343119	C	A	11	11	22	0	0	22	0	0
9	136238509	rs1179037	G	A	22	13	35	0	0	35	0	0
9	136239399	rs3758348	G	C	20	21	41	0	0	41	0	0
9	136241189	rs1179038	C	T	10	6	16	0	0	16	0	0
9	136241639	rs1179040	C	T	11	20	31	0	0	31	0	0
9	136277480	rs2285486	A	G	33	41	74	0	0	74	0	0
9	136281753	rs3118663	G	A	5	8	13	0	0	13	0	0
9	136281917	rs3118664	A	C	4	5	9	0	0	9	0	0
9	136281925	rs3124780	A	G	4	5	9	0	0	9	0	0
9	136281966	rs3124779	A	G	3	3	6	0	0	6	0	0
9	136324239	rs1055432	C	A	2	4	6	0	1	7	0	0
9	136328657	rs3124765	T	C	6	7	13	0	0	13	0	0
9	136338580	rs41297217	G	A	4	4	8	0	0	8	0	0
9	136340200	rs2073935	T	G	4	7	11	0	0	11	0	0
9	136520282	rs2073833	G	C	4	2	6	0	0	6	0	0
9	136520662	rs732833	T	C	0	7	7	0	0	7	0	0
9	136534834	.	G	C	7	1	8	0	0	8	0	0
9	136536793	rs2519123	C	G	2	14	16	0	0	16	0	0
9	136559460	rs2073817	C	T	0	9	9	0	1	10	0	0
9	136561367	.	G	A	9	1	10	0	0	10	0	0
9	136628770	rs509590	T	C	41	32	73	0	0	73	0	0
9	136643994	rs602990	T	C	32	35	67	0	0	67	0	0
9	136903056	rs372993564	G	A	3	5	8	0	0	8	0	0
9	136918025	rs17737081	G	A	13	6	19	0	0	19	0	0
9	137809685	rs10858293	C	A	12	18	30	0	1	31	0	0
9	138908250	rs2275107	C	T	9	6	15	0	0	15	0	0
9	139235415	rs60980157	C	T	81	66	147	0	2	149	0	0
9	139235526	rs59873903	C	A	9	8	17	0	1	18	0	0
9	139236763	rs28507319	C	T	5	9	14	0	0	14	0	0
9	139237902	rs28624681	T	C	5	7	12	0	0	12	0	0
9	139238824	rs3935875	A	G	9	4	13	0	0	13	0	0
9	139239585	rs28641468	T	C	9	10	19	0	0	19	0	0
9	139239807	rs28610213	G	A	9	5	14	0	0	14	0	0
9	139239901	rs28562613	G	C	9	5	14	0	0	14	0	0
9	139241030	rs28505901	A	G	10	10	20	0	0	20	0	0
9	139241481	rs28715547	T	C	8	11	19	0	0	19	0	0
9	139241595	rs28562046	C	G	16	17	33	0	1	34	0	0
9	139241828	rs28533815	T	C	6	9	15	0	1	16	0	0
9	139243226	rs78298678	C	T	25	29	54	0	0	54	0	0
9	139243334	rs28429551	T	A	20	32	52	0	2	54	0	0
9	139243790	rs28439345	A	C	20	37	57	0	0	57	0	0
9	139244376	rs28445975	T	G	16	26	42	0	1	43	0	0
9	139244786	rs142189693	G	A	29	31	60	0	1	61	0	0
9	139245194	rs77813615	C	T	8	17	25	0	0	25	0	0
9	139245289	rs28642252	A	G	2	4	6	0	0	6	0	0
9	139245389	rs78270318	G	A	12	10	22	0	0	22	0	0
9	139245460	rs28378473	T	C	18	22	40	0	1	41	0	0
9	139245525	rs28556700	A	C	20	35	55	0	0	55	0	0
9	139247955	rs55880213	T	C	35	24	59	0	1	60	0	0
9	139248082	rs28642213	A	G	36	27	63	0	1	64	0	0
9	139248897	rs28628657	G	C	51	54	105	0	0	105	0	0
9	139250046	rs78503878	T	C	20	30	50	0	0	50	0	0
9	139251006	rs11145776	G	A	6	3	9	0	0	9	0	0
9	139251945	rs7853207	T	C	39	37	76	0	1	77	0	0
9	139252148	rs11787792	G	A	22	36	58	0	0	58	0	0
9	139252495	rs3812547	G	A	111	116	227	0	3	230	0	0
9	139252878	rs3812549	C	G	103	87	190	0	1	191	0	0
9	139253068	rs10870125	C	T	172	175	347	0	4	351	0	0
9	139256495	rs3812553	G	T	42	334	376	0	1	377	0	0
9	139256766	rs3829109	G	A	7	2	9	0	0	9	0	0
9	139270876	rs3812561	G	A	54	51	105	0	1	106	0	0
9	139271461	rs10781506	C	T	4	2	6	0	0	6	0	0
9	139272502	rs3812565	T	C	20	17	37	0	0	37	0	0
9	139273288	rs3829112	C	T	25	26	51	0	1	52	0	0
9	139296485	rs563	A	G	9	13	22	0	0	22	0	0
9	139298593	rs1051957	A	G	36	35	71	0	0	71	0	0
9	139299673	rs3812578	G	C	5	4	9	0	0	9	0	0
9	139300484	rs59257707	C	T	3	4	7	0	0	7	0	0
9	139300494	rs11145910	T	C	4	2	6	0	0	6	0	0
9	139301960	rs3812580	G	A	22	25	47	0	1	48	0	0
9	139311284	rs11145960	A	G	12	16	28	0	0	28	0	0
9	139311970	rs113033008	G	A	2	9	11	0	0	11	0	0
9	139314625	rs11145971	T	G	7	12	19	0	1	20	0	0
9	139315594	rs10870163	G	A	35	32	67	0	0	67	0	0
9	139316459	rs11145972	C	T	21	13	34	0	1	35	0	0
9	139316744	rs11145974	C	T	21	21	42	0	0	42	0	0
9	139317979	rs1130640	C	T	84	87	171	0	0	171	0	0
9	139318080	rs10870168	G	A	81	105	186	0	0	186	0	0
9	139323311	rs8413	T	C	26	25	51	0	0	51	0	0
9	139323424	rs1128874	T	C	22	32	54	0	0	54	0	0
9	139323799	rs35763810	A	G	35	23	58	0	0	58	0	0
9	139324029	rs35873563	C	T	30	19	49	0	0	49	0	0
9	139324737	rs33982662	C	A	21	22	43	0	0	43	0	0
9	139327034	rs10870194	A	G	12	12	24	0	0	24	0	0
9	139327439	rs10781542	A	G	5	5	10	0	2	12	0	0
9	139331221	rs3923776	G	C	5	4	9	0	0	9	0	0
9	139335599	rs1127152	A	G	82	84	166	0	2	168	0	0
9	139336813	rs7874956	T	G	22	16	38	0	0	38	0	0
9	139339247	rs148845458	C	T	6	0	6	0	0	6	0	0
9	139339877	.	C	T	5	2	7	0	0	7	0	0
9	139340351	rs36066734	A	G	5	4	9	0	0	9	0	0
9	139341612	rs3812591	T	C	3	3	6	0	0	6	0	0
9	139364585	rs11145756	A	G	4	3	7	0	0	7	0	0
9	139364940	rs35526483	G	A	7	5	12	0	0	12	0	0
9	139368953	rs3812594	G	A	43	19	62	0	2	64	0	0
9	139369062	rs3812595	C	T	46	25	71	0	0	71	0	0
9	139371342	rs11999525	G	A	47	47	94	0	0	94	0	0
9	139371405	rs11999532	G	C	27	41	68	0	0	68	0	0
9	139371786	rs6560632	A	C	50	40	90	0	0	90	0	0
9	139389184	rs6563	A	G	186	124	310	0	1	311	0	0
9	139390397	rs3124591	C	T	115	144	259	0	2	261	0	0
9	139391636	rs2229974	G	A	96	162	258	0	1	259	0	0
9	139393067	rs7852557	C	T	13	17	30	0	0	30	0	0
9	139393162	rs3124592	G	A	15	15	30	0	0	30	0	0
9	139393175	rs3124593	A	G	13	19	32	0	0	32	0	0
9	139394107	rs150732334	G	A	9	12	21	0	0	21	0	0
9	139394573	rs4880054	T	G	7	11	18	0	0	18	0	0
9	139397707	rs10521	G	A	52	87	139	0	2	141	0	0
9	139398663	rs3124595	A	T	1	5	6	0	0	6	0	0
9	139418260	rs4489420	A	G	57	28	85	0	0	85	0	0
9	139427066	rs11145770	C	T	4	2	6	0	0	6	0	0
9	139437410	rs3013305	G	A	4	4	8	0	0	8	0	0
9	139553865	rs4880062	C	T	28	3	31	0	0	31	0	0
9	139562460	rs73668352	G	C	6	2	8	0	0	8	0	0
9	139564668	rs2297538	G	A	102	392	494	0	1	495	0	0
9	139566020	rs117729430	C	T	5	9	14	0	0	14	0	0
9	139566996	rs1051851	G	A	160	651	811	0	5	816	0	0
9	139567687	rs10320	G	A	119	130	249	0	0	249	0	0
9	139567762	rs6951	G	C	194	177	371	0	1	372	0	0
9	139568047	rs4880119	G	A	158	188	346	0	3	350	1	0
9	139573977	rs12002299	C	T	4	6	10	0	0	10	0	0
9	139574616	rs12553230	C	T	4	2	6	0	0	6	0	0
9	139576526	rs1999495	G	C	3	5	8	0	0	8	0	0
9	139577244	rs62580385	C	T	4	3	7	0	0	7	0	0
9	139579250	rs79349832	C	G	3	3	6	0	0	6	0	0
9	139615969	rs148083547	A	T	3	6	9	0	0	9	0	0
9	139693596	rs945386	T	C	6	2	8	0	0	8	0	0
9	139694521	rs4546744	T	G	2	4	6	0	0	6	0	0
9	139724272	rs56133623	C	T	20	19	39	0	1	40	0	0
9	139725120	rs2811750	C	T	17	33	50	0	0	50	0	0
9	139725227	rs2811749	C	T	18	19	37	0	0	37	0	0
9	139726239	rs2811748	A	G	106	153	259	0	1	260	0	0
9	139727188	rs2811747	A	G	10	11	21	0	2	23	0	0
9	139730129	rs2811744	T	C	7	7	14	0	0	14	0	0
9	139730720	rs2811743	T	C	6	11	17	0	0	17	0	0
9	139730730	rs2784083	C	A	6	11	17	0	1	18	0	0
9	139731969	rs2811742	C	T	45	54	99	0	3	103	1	0
9	139732331	rs2811741	G	C	127	162	289	0	2	291	0	0
9	139759648	rs116924614	G	A	4	2	6	0	0	6	0	0
9	139811482	rs7039663	G	A	2	4	6	0	0	6	0	0
9	139811585	rs7027246	A	G	6	6	12	0	0	12	0	0
9	139811991	rs7034762	T	C	5	5	10	0	0	10	0	0
9	139813855	rs7048940	G	A	2	4	6	0	0	6	0	0
9	139820421	rs7852970	G	A	59	45	104	0	2	106	0	0
9	139836362	rs7040705	G	A	35	31	66	0	1	67	0	0
9	139837990	rs2271872	G	C	6	3	9	0	0	9	0	0
9	139838690	rs28578007	T	C	3	5	8	0	0	8	0	0
9	139876141	rs6926	A	C	4	6	10	0	0	10	0	0
9	139887042	rs10870159	G	C	0	6	6	0	0	6	0	0
9	139902166	rs41306732	G	A	82	80	162	0	2	164	0	0
9	139904037	rs7048567	A	G	57	73	130	0	1	131	0	0
9	139906359	rs2271862	G	A	53	50	103	0	6	109	0	0
9	139927206	rs116861357	G	A	32	25	57	0	0	57	0	0
9	139973582	rs75127829	C	G	2	8	10	0	0	10	0	0
9	139973820	rs7037849	C	T	10	4	14	0	0	14	0	0
9	139998042	rs28373932	C	T	5	1	6	0	0	6	0	0
9	139998480	rs4880206	G	A	5	4	9	0	0	9	0	0
9	139998677	rs11145995	G	A	3	3	6	0	0	6	0	0
9	140000115	rs9411308	C	T	9	13	22	0	0	22	0	0
9	140001978	rs12115325	C	A	1	6	7	0	1	8	0	0
9	140002187	rs12000517	C	T	2	4	6	0	0	6	0	0
9	140002261	rs11790092	A	G	3	5	8	0	0	8	0	0
9	140002754	rs4880090	C	T	11	1	12	0	0	12	0	0
9	140002875	rs34355967	C	T	88	74	162	0	0	162	0	0
9	140003427	rs4567	A	G	97	98	195	0	2	197	0	0
9	140005383	rs117203759	G	A	529	383	912	0	5	917	0	0
9	140005916	rs72763269	G	A	7	8	15	0	0	15	0	0
9	140006202	rs13631	G	A	507	573	1080	0	5	1086	1	0
9	140006491	rs10870180	C	T	9	9	18	0	1	19	0	0
9	140006892	rs10870181	C	G	39	41	80	0	2	82	0	0
9	140008934	rs11145999	A	G	179	147	326	0	1	327	0	0
9	140070612	rs28571106	T	C	28	19	47	0	1	48	0	0
9	140070638	rs4880219	T	C	20	26	46	0	1	47	0	0
9	140079975	rs76044090	C	A	8	3	11	0	0	11	0	0
9	140106538	rs34383296	G	A	5	1	6	0	0	6	0	0
9	140160848	.	C	T	148	116	264	0	1	265	0	0
9	140164689	rs9802915	C	T	3	4	7	0	0	7	0	0
9	140167022	rs3204123	G	A	133	136	269	0	0	269	0	0
9	140167877	rs8281	T	G	100	112	212	0	0	212	0	0
9	140167985	rs28740782	T	A	3	3	6	0	0	6	0	0
9	140176294	rs28455773	G	T	22	34	56	0	2	58	0	0
9	140176814	rs112239920	G	A	34	34	68	0	1	69	0	0
9	140247143	rs7020732	T	G	2	7	9	0	0	9	0	0
9	140250818	rs7389423	C	T	3	3	6	0	0	6	0	0
9	140262426	rs11533158	C	T	14	16	30	0	0	30	0	0
9	140277826	rs13291830	C	T	12	10	22	0	0	22	0	0
9	140327663	rs34155071	C	T	11	8	19	0	0	19	0	0
9	140350287	rs3793468	C	T	8	16	24	0	0	24	0	0
9	140356422	rs28452008	G	C	30	23	53	0	0	53	0	0
9	140395253	rs144383658	G	A	12	5	17	0	0	17	0	0
9	140642331	rs6559221	T	C	38	48	86	0	0	86	0	0
X	200860	rs9785927	T	C	25	18	43	0	0	43	0	0
X	207362	.	C	T	27	16	43	0	0	43	0	0
X	216467	rs34986674	C	A	3	3	6	0	0	10	4	0
X	216910	rs12401270	A	G	11	17	28	0	0	28	0	0
X	217137	rs12401280	G	A	4	8	12	0	1	13	0	0
X	217911	rs73176207	C	G	18	12	30	0	0	30	0	0
X	218671	rs28738901	G	C	32	10	42	0	0	42	0	0
X	219117	rs148465244	A	G	24	9	33	0	0	33	0	0
X	219257	rs58893504	G	C	17	7	24	0	0	24	0	0
X	219261	rs57503874	C	T	21	30	51	0	1	52	0	0
X	219978	rs11019	G	A	18	15	33	0	0	33	0	0
X	220092	rs3209493	A	G	8	7	15	0	0	15	0	0
X	220095	rs3209495	A	G	8	8	16	0	0	16	0	0
X	220116	rs75624403	T	C	10	11	21	0	0	21	0	0
X	220308	rs75523326	A	G	8	0	8	0	0	8	0	0
X	220330	rs79112288	A	G	9	4	13	0	0	13	0	0
X	220344	rs59413380	A	G	9	4	13	0	0	13	0	0
X	220399	rs79937108	C	T	18	4	22	0	0	22	0	0
X	220630	rs28605716	G	A	5	11	16	0	0	16	0	0
X	220632	rs28373734	G	T	5	11	16	0	0	16	0	0
X	220660	rs28517798	T	C	5	5	10	0	0	10	0	0
X	220686	rs28380283	A	G	13	3	16	0	0	16	0	0
X	221081	rs28626930	G	A	7	1	8	0	0	8	0	0
X	221431	rs7209	T	A	30	40	70	0	0	70	0	0
X	229542	rs1140798	G	A	93	109	202	0	1	203	0	0
X	295132	rs1133530	T	C	4	2	6	0	0	6	0	0
X	295231	rs1133523	A	G	11	9	20	0	0	20	0	0
X	1315884	rs9330635	C	T	3	4	7	0	0	7	0	0
X	1331495	rs140859855	G	C	8	16	24	0	0	24	0	0
X	1388232	rs28478213	G	A	4	7	11	0	0	11	0	0
X	1388277	rs28501473	A	G	4	7	11	0	0	11	0	0
X	1391932	rs28857276	C	T	3	3	6	0	0	6	0	0
X	1392205	rs57844650	T	C	9	6	15	0	0	15	0	0
X	1392393	rs58151468	T	G	5	2	7	0	0	7	0	0
X	1392717	rs112215429	T	G	9	3	12	0	2	14	0	0
X	1392751	rs28652759	G	A	9	3	12	0	0	12	0	0
X	1397202	.	G	T	5	2	7	0	0	7	0	0
X	1399651	rs71214319	C	T	4	2	6	0	0	6	0	0
X	1459600	rs7063305	C	T	4	3	7	0	0	7	0	0
X	1460439	rs770836811	G	C	6	0	6	0	0	6	0	0
X	1460441	rs774189467	G	A	6	0	6	0	0	6	0	0
X	1460495	rs3202254	G	A	7	3	10	0	0	10	0	0
X	1460554	rs17879123	A	G	7	5	12	0	1	13	0	0
X	1460617	rs17886180	G	C	3	6	9	0	0	9	0	0
X	1464821	rs17881232	G	C	3	7	10	0	0	10	0	0
X	1465537	rs6603268	A	G	2	7	9	0	0	9	0	0
X	1467506	rs73178940	G	T	3	7	10	0	0	10	0	0
X	1469118	rs1142043	C	T	8	6	14	0	1	15	0	0
X	1469670	rs9803416	C	T	5	5	10	0	0	10	0	0
X	1469894	rs17884216	A	G	9	12	21	0	0	21	0	0
X	1469972	rs17883939	T	C	5	3	8	0	0	8	0	0
X	1471138	rs6603272	G	T	17	15	32	0	1	33	0	0
X	1471542	rs17883192	C	G	23	28	51	0	0	51	0	0
X	1471617	rs17882890	C	T	18	15	33	0	0	33	0	0
X	1471624	rs17879017	T	G	18	16	34	0	1	35	0	0
X	1471714	rs17881263	C	T	11	16	27	0	0	27	0	0
X	1471754	rs17880161	G	A	11	13	24	0	0	24	0	0
X	1472118	rs73178954	C	T	7	3	10	0	0	10	0	0
X	1473247	rs7391312	G	A	30	20	50	0	0	50	0	0
X	1473286	rs6603273	A	C	25	19	44	0	0	44	0	0
X	1473401	rs7060570	A	G	5	1	6	0	0	6	0	0
X	1478468	rs7059370	T	C	19	21	40	0	3	43	0	0
X	1479032	rs7392215	G	A	26	20	46	0	3	49	0	0
X	1481527	rs17883355	T	C	14	24	38	0	0	38	0	0
X	1481583	rs17883151	G	A	19	28	47	0	0	47	0	0
X	1481700	rs7473018	G	A	4	2	6	0	0	6	0	0
X	1482019	rs6603266	T	C	14	22	36	0	0	36	0	0
X	1482387	rs7064638	G	A	9	11	20	0	0	20	0	0
X	1487144	rs17884121	G	A	4	2	6	0	0	6	0	0
X	1487638	rs28780423	G	A	4	2	6	0	0	6	0	0
X	1495955	rs7391600	G	C	5	1	6	0	0	6	0	0
X	1500841	rs28427507	G	T	3	3	6	0	0	6	0	0
X	1500861	rs73178972	C	T	2	4	6	0	0	6	0	0
X	1505265	rs142046504	G	A	1590	1973	3563	0	6	3569	0	0
X	1536985	.	T	G	58	67	125	0	0	125	0	0
X	1550948	rs183090938	C	A	6	11	17	0	0	17	0	0
X	1551653	.	T	C	4	2	6	0	0	6	0	0
X	1551655	.	C	G	4	2	6	0	0	6	0	0
X	1551679	rs28585424	G	A	3	3	6	0	0	6	0	0
X	1551682	.	C	A	3	3	6	0	0	6	0	0
X	1551709	.	G	A	3	5	8	0	0	8	0	0
X	1551848	rs66927753	G	A	6	3	9	0	0	9	0	0
X	1551860	rs28663244	A	G	5	1	6	0	0	6	0	0
X	1552828	rs28616689	G	A	7	2	9	0	0	9	0	0
X	1553252	rs111421872	G	A	1	5	6	0	0	6	0	0
X	1553907	rs28587213	G	A	3	5	8	0	0	8	0	0
X	1554649	rs3183025	T	C	57	127	184	0	0	184	0	0
X	1554655	rs28592995	T	C	4	11	15	0	0	15	0	0
X	1555076	rs6655396	C	T	5	5	10	0	0	10	0	0
X	1555085	rs6644941	G	C	5	6	11	0	0	11	0	0
X	1555153	rs112328103	G	A	1	7	8	0	0	8	0	0
X	1555623	rs28880629	G	A	5	13	18	0	0	18	0	0
X	1556120	rs55708076	A	G	9	3	12	0	0	12	0	0
X	1556135	rs111810539	G	A	9	4	13	0	0	13	0	0
X	1557274	rs28437053	C	G	4	3	7	0	0	7	0	0
X	1562309	rs62604193	T	A	4	2	6	0	0	6	0	0
X	1562500	.	G	A	4	4	8	0	1	9	0	0
X	1564526	rs28442143	T	C	6	6	12	0	0	12	0	0
X	1567640	rs56266768	C	G	5	3	8	0	0	8	0	0
X	1572532	rs187602913	G	T	3	3	6	0	1	7	0	0
X	1583481	rs73182974	C	T	240	152	392	0	5	397	0	0
X	1600266	rs140930859	G	A	1	5	6	0	0	6	0	0
X	1611949	rs5989753	A	G	3	3	6	0	1	7	0	0
X	1624307	rs6645238	A	G	4	2	6	0	0	6	0	0
X	1626168	rs5989777	C	A	3	3	6	0	0	6	0	0
X	1639350	rs190643945	C	T	1	5	6	0	0	6	0	0
X	1720623	rs190684327	C	T	322	349	671	0	5	676	0	0
X	1720821	rs1128551	C	T	386	326	712	0	21	733	0	0
X	1755404	rs4933063	C	T	29	0	29	0	0	29	0	0
X	2138058	rs3936075	A	G	3	3	6	0	0	6	0	0
X	2139186	rs12010	C	T	59	36	95	0	1	96	0	0
X	2224231	rs143362134	T	C	7	0	7	0	1	8	0	0
X	2225970	rs34907592	A	G	8	1	9	0	0	9	0	0
X	2226048	rs34016541	C	T	6	0	6	0	0	6	0	0
X	2404619	rs1044307	G	A	119	115	234	0	3	237	0	0
X	2404691	rs9577	C	G	145	129	274	0	1	275	0	0
X	2405443	rs5983101	G	T	106	95	201	0	3	204	0	0
X	2405539	rs6641862	G	A	84	69	153	0	0	153	0	0
X	2405552	rs5982687	G	C	77	68	145	0	2	147	0	0
X	2405564	rs5983102	T	C	78	68	146	0	0	146	0	0
X	2405576	rs5982688	C	T	88	69	157	0	0	157	0	0
X	2405578	rs5982689	T	C	86	69	155	0	2	157	0	0
X	2406170	rs3203783	C	A	96	88	184	0	11	195	0	0
X	2406373	rs4892841	T	G	79	76	155	0	0	155	0	0
X	2406452	rs4892931	C	T	72	81	153	0	1	154	0	0
X	2406530	rs4892932	A	G	90	106	196	0	0	196	0	0
X	2411384	rs55896289	T	C	3	4	7	0	0	7	0	0
X	2415147	rs4892933	G	A	23	17	40	0	0	40	0	0
X	2415233	rs5939505	T	C	22	14	36	0	0	36	0	0
X	2416792	rs4892935	C	T	5	13	18	0	0	18	0	0
X	2417167	rs5939513	A	G	21	14	35	0	0	35	0	0
X	2417655	rs113794667	T	C	4	2	6	0	0	6	0	0
X	2417970	rs5939517	G	A	7	6	13	0	1	14	0	0
X	2418538	rs5939192	C	T	3	6	9	0	0	9	0	0
X	2533881	rs2316854	C	G	166	188	354	0	6	360	0	0
X	2535527	rs5939244	A	C	8	9	17	0	0	18	1	0
X	2535604	rs5939245	A	G	6	9	15	0	0	15	0	0
X	2540266	rs7879335	A	T	5	12	17	0	0	17	0	0
X	2541735	rs368969269	T	C	8	5	13	0	1	14	0	0
X	2542758	rs5982791	A	G	5	4	9	0	0	9	0	0
X	2543230	rs6420585	C	T	7	9	16	0	0	16	0	0
X	2546305	rs5939096	T	G	3	7	10	0	1	11	0	0
X	2546321	rs5939097	A	G	3	9	12	0	0	12	0	0
X	2547520	rs114284563	C	G	8	5	13	0	0	13	0	0
X	2548083	.	A	G	4	6	10	0	0	10	0	0
X	2548334	.	G	A	9	8	17	0	0	17	0	0
X	2548537	rs60084173	C	T	7	4	11	0	0	11	0	0
X	2548961	rs7392274	C	A	10	7	17	0	0	17	0	0
X	2549696	.	G	A	5	3	8	0	0	8	0	0
X	2550291	.	C	G	16	1	17	0	0	17	0	0
X	2550302	.	G	A	16	1	17	0	0	17	0	0
X	2550305	.	C	T	16	2	18	0	0	18	0	0
X	2550308	.	C	T	16	2	18	0	0	18	0	0
X	2550312	.	A	G	16	2	18	0	0	18	0	0
X	2550460	rs5939253	A	G	9	9	18	0	0	18	0	0
X	2550699	rs5939254	C	T	8	6	14	0	0	14	0	0
X	2551633	rs35339349	A	G	8	7	15	0	0	15	0	0
X	2551712	rs36106350	C	A	5	2	7	0	0	7	0	0
X	2552969	rs7878828	G	A	8	2	10	0	0	10	0	0
X	2553545	rs4892867	T	G	6	4	10	0	0	10	0	0
X	2554073	rs71207031	T	C	9	4	13	0	0	13	0	0
X	2554643	rs28409743	G	A	6	4	10	0	0	10	0	0
X	2554793	rs188111692	C	T	12	6	18	0	0	18	0	0
X	2556426	rs5982795	C	G	3	6	9	0	0	9	0	0
X	2565588	rs5982805	T	C	6	4	10	0	0	10	0	0
X	2565620	rs5982806	A	G	5	1	6	0	1	7	0	0
X	2568609	rs28662272	G	A	2	4	6	0	0	6	0	0
X	2573351	rs138848425	G	A	5	5	10	0	0	10	0	0
X	2573579	rs5939282	C	G	6	8	14	0	0	14	0	0
X	2609303	rs3199720	C	T	68	57	125	0	0	125	0	0
X	2609983	rs2236738	T	C	3	16	19	0	1	20	0	0
X	2610494	rs167453	T	G	7	3	10	0	0	10	0	0
X	2611182	rs1965013	G	T	5	6	11	0	0	11	0	0
X	2611199	rs2109561	T	C	4	4	8	0	1	9	0	0
X	2611245	rs178019	A	G	8	7	15	0	0	15	0	0
X	2613279	rs28693623	C	T	3	6	9	0	0	9	0	0
X	2614112	rs5982572	G	A	36	30	66	0	1	67	0	0
X	2614267	rs28667678	T	C	47	69	116	0	1	117	0	0
X	2615379	rs28373068	C	T	7	4	11	0	0	11	0	0
X	2615523	rs28734886	A	G	8	7	15	0	0	15	0	0
X	2615596	rs311036	C	A	10	8	18	0	1	19	0	0
X	2616780	rs311038	C	T	2	6	8	0	0	8	0	0
X	2619477	rs311042	T	C	2	5	7	0	0	7	0	0
X	2619654	rs311043	T	G	8	4	12	0	0	12	0	0
X	2621120	rs311044	A	G	4	4	8	0	0	8	0	0
X	2621458	rs311045	G	A	4	8	12	0	0	12	0	0
X	2622082	rs311046	T	C	3	11	14	0	0	14	0	0
X	2622260	rs311047	G	A	2	4	6	0	0	6	0	0
X	2622647	rs311048	C	T	7	8	15	0	0	15	0	0
X	2622665	rs311049	T	G	6	4	10	0	0	10	0	0
X	2623043	rs34190580	A	G	3	4	7	0	0	7	0	0
X	2624524	rs5982836	C	T	2	7	9	0	0	9	0	0
X	2627829	rs311060	C	G	9	7	16	0	0	16	0	0
X	2628201	rs311061	A	G	14	1	15	0	0	15	0	0
X	2628416	rs5939112	A	C	12	12	24	0	0	24	0	0
X	2628479	rs5939305	G	T	12	11	23	0	0	23	0	0
X	2628991	rs311064	A	G	6	10	16	0	0	16	0	0
X	2629078	rs812201	A	G	10	12	22	0	0	22	0	0
X	2630381	rs28371882	G	A	16	7	23	0	1	24	0	0
X	2630521	rs55999924	G	A	3	5	8	0	0	8	0	0
X	2631035	rs311067	A	G	17	8	25	0	0	25	0	0
X	2631500	rs311069	T	C	16	10	26	0	0	26	0	0
X	2631632	rs187525073	C	T	13	15	28	0	0	28	0	0
X	2632272	rs311070	A	T	7	1	8	0	0	8	0	0
X	2632482	rs1136447	C	T	3758	3580	7338	0	27	7365	0	0
X	2632822	rs311071	G	A	17	19	36	0	0	36	0	0
X	2633294	rs4892886	G	A	12	41	53	0	1	83	29	0
X	2633474	rs7060867	A	G	17	68	85	0	1	86	0	0
X	2633689	rs28590731	A	C	49	20	69	0	0	69	0	0
X	2633711	rs28377038	G	A	54	21	75	0	0	75	0	0
X	2642566	rs312188	C	T	9	12	21	0	0	21	0	0
X	2643371	rs312190	T	C	4	8	12	0	0	12	0	0
X	2644516	rs312191	G	T	2	4	6	0	0	6	0	0
X	2645366	rs311083	G	C	2	6	8	0	0	8	0	0
X	2647670	rs2267800	A	T	3	4	7	0	0	7	0	0
X	2649961	rs186106161	G	C	5	1	6	0	0	6	0	0
X	2650121	rs137980586	A	G	4	5	9	0	0	9	0	0
X	2651126	rs34504332	C	T	9	7	16	0	0	16	0	0
X	2651566	rs35030269	C	T	9	12	21	0	0	21	0	0
X	2653552	rs311092	C	G	14	13	27	0	0	27	0	0
X	2653913	rs311093	G	A	9	19	28	0	0	28	0	0
X	2655009	rs35939958	T	C	10	8	18	0	0	18	0	0
X	2655132	rs311095	T	C	16	8	24	0	0	24	0	0
X	2655658	rs28659837	C	A	2	4	6	0	0	6	0	0
X	2655703	rs34991201	C	G	6	2	8	0	1	9	0	0
X	2656180	rs35835388	T	C	19	30	49	0	4	53	0	0
X	2656258	rs11556084	G	A	3442	3501	6943	0	37	6980	0	0
X	2656435	rs34174423	G	A	17	12	29	0	0	29	0	0
X	2657236	rs28445675	A	C	11	11	22	0	0	22	0	0
X	2657354	rs28709618	G	T	16	11	27	0	0	27	0	0
X	2657378	rs28369641	A	C	17	9	26	0	0	26	0	0
X	2657486	rs73188889	A	G	5	6	11	0	0	11	0	0
X	2657501	rs73188890	T	A	5	7	12	0	0	12	0	0
X	2658299	rs312259	G	A	16	15	31	0	0	31	0	0
X	2658316	rs312258	G	T	16	17	33	0	0	33	0	0
X	2659232	rs6661	C	T	2148	2044	4192	0	13	4205	0	0
X	55776221	rs3859917	A	C	7	0	7	0	0	7	0	0
X	73802941	.	G	A	33	0	33	0	1	34	0	0
X	73802947	.	A	G	35	0	35	0	0	35	0	0
X	73802967	.	C	A	30	0	30	0	0	30	0	0
X	73802970	.	T	C	23	6	29	0	0	29	0	0
X	73802978	.	G	A	28	0	28	0	0	28	0	0
X	73802983	.	G	A	31	0	31	0	0	31	0	0
X	73802987	.	G	A	29	0	29	0	0	29	0	0
X	73802997	.	C	T	29	0	29	0	1	30	0	0
X	73803042	.	T	C	23	0	23	0	0	23	0	0
X	73803044	.	A	G	23	0	23	0	0	23	0	0
X	73803057	.	G	C	23	0	23	0	0	23	0	0
X	73803082	.	C	T	24	0	24	0	0	24	0	0
X	73803084	.	C	T	23	1	24	0	0	24	0	0
X	73803099	.	C	T	28	0	28	0	0	28	0	0
X	73803100	.	G	A	27	1	28	0	0	28	0	0
X	73803117	.	T	A	22	0	22	0	0	22	0	0
X	73803129	.	G	A	19	0	19	0	1	20	0	0
X	73803149	.	A	G	18	0	18	0	0	18	0	0
X	73803162	.	G	C	19	0	19	0	0	19	0	0
X	73803222	.	T	C	20	0	20	0	0	20	0	0
X	155111005	rs28635379	A	C	0	6	6	0	0	6	0	0
X	155111702	rs28655110	G	C	0	9	9	0	0	9	0	0
X	155111729	rs115808296	A	G	0	6	6	0	0	6	0	0
X	155251698	.	G	A	8	9	17	0	0	17	0	0
X	155251726	.	G	C	24	2	26	0	0	26	0	0
X	155252104	.	T	C	18	4	22	0	0	22	0	0
X	155252475	.	C	T	32	0	32	0	0	32	0	0
X	155252736	.	A	G	3	94	97	0	1	98	0	0
X	155252868	.	T	A	62	41	103	0	0	103	0	0
X	155253489	.	A	G	44	15	59	0	2	61	0	0
X	155253776	.	C	T	27	21	48	0	0	48	0	0
X	155253826	rs779892608	T	C	38	26	64	0	0	64	0	0
