contig	position	variantID	refAllele	altAllele	refCount	altCount	totalCount	lowMAPQDepth	lowBaseQDepth	rawDepth	otherBases	improperPairs
1	14522	.	G	A	5	18	23	0	1	24	0	0
1	14542	.	A	G	4	22	26	0	0	26	0	0
1	14574	.	A	G	15	15	30	0	1	31	0	0
1	14590	.	G	A	20	16	36	0	1	37	0	0
1	14599	rs707680	T	A	21	14	35	0	0	35	0	0
1	14604	rs541940975	A	G	21	13	34	0	1	35	0	0
1	14610	.	T	C	21	14	35	0	1	36	0	0
1	14653	.	C	T	16	137	153	0	3	156	0	0
1	14673	.	G	C	190	7	197	0	1	198	0	0
1	14699	.	C	G	285	5	290	0	1	291	0	0
1	14933	rs199856693	G	A	63	33	96	0	2	98	0	0
1	14976	.	G	A	136	20	156	0	0	156	0	0
1	15118	.	A	G	6	16	22	0	0	22	0	0
1	16949	rs199745162	A	C	61	13	74	0	8	82	0	0
1	17020	.	G	A	110	23	133	0	0	133	0	0
1	17385	.	G	A	18	7	25	0	0	25	0	0
1	137622	.	G	A	6	3	9	0	0	9	0	0
1	741181	rs556976003	T	C	2	4	6	0	0	6	0	0
1	762022	rs186393233	T	C	6	3	9	0	0	9	0	0
1	762320	rs75333668	C	T	5	6	11	0	0	11	0	0
1	777122	rs2980319	A	T	9	4	13	0	0	13	0	0
1	778298	.	A	G	5	2	7	0	0	7	0	0
1	779146	rs140464834	G	C	4	3	7	0	0	7	0	0
1	779286	rs149978434	C	A	4	6	10	0	0	10	0	0
1	790381	rs147035796	G	A	6	5	11	0	1	12	0	0
1	790550	rs141897282	G	C	3	4	7	0	0	7	0	0
1	790667	rs116753918	C	T	6	5	11	0	0	11	0	0
1	791858	rs141858431	G	A	16	18	34	0	0	34	0	0
1	791876	rs146261749	G	A	14	11	25	0	1	26	0	0
1	792263	rs1044922	A	G	9	16	25	0	2	27	0	0
1	879317	rs7523549	C	T	1	5	6	0	0	6	0	0
1	881627	rs2272757	G	A	252	263	515	0	2	517	0	0
1	900427	rs115741058	G	A	5	1	6	0	0	6	0	0
1	949608	rs1921	G	A	100	102	202	0	0	202	0	0
1	957640	rs6657048	C	T	3	3	6	0	0	6	0	0
1	982722	rs142416636	A	G	2	4	6	0	0	6	0	0
1	990839	rs13129	C	T	4	5	9	0	0	9	0	0
1	995481	rs9442393	T	G	5	5	10	0	0	10	0	0
1	998582	rs3813194	G	C	19	13	32	0	0	32	0	0
1	1001290	rs6665667	C	T	37	29	66	0	0	66	0	0
1	1002387	rs74048003	A	G	6	5	11	0	1	12	0	0
1	1002434	rs11260596	C	T	4	8	12	0	0	12	0	0
1	1018105	.	C	G	5	11	16	0	1	17	0	0
1	1018144	rs9442395	T	C	6	9	15	0	0	15	0	0
1	1155238	rs12134035	G	A	3	10	13	0	0	13	0	0
1	1155321	rs79501625	C	T	6	9	15	0	0	15	0	0
1	1155804	rs11809575	T	C	3	4	7	0	0	7	0	0
1	1156429	rs944369	C	G	9	9	18	0	0	18	0	0
1	1156655	rs75998592	G	A	10	7	17	0	1	18	0	0
1	1156735	rs79361728	T	C	9	5	14	0	0	14	0	0
1	1157340	rs56013947	A	G	8	8	16	0	0	16	0	0
1	1157372	rs55683245	G	A	7	6	13	0	1	14	0	0
1	1157547	rs79118541	T	C	4	5	9	0	0	9	0	0
1	1157564	rs75124586	G	A	4	2	6	0	1	7	0	0
1	1157625	rs74374908	C	T	4	3	7	0	0	7	0	0
1	1157631	rs79875872	G	A	3	3	6	0	0	6	0	0
1	1157862	rs78596995	C	T	3	5	8	0	0	8	0	0
1	1157959	rs76502131	C	T	7	4	11	0	0	11	0	0
1	1157960	rs74350546	T	C	7	4	11	0	0	11	0	0
1	1157974	rs76056412	A	G	10	7	17	0	0	17	0	0
1	1157991	rs74930764	G	A	12	8	20	0	0	20	0	0
1	1158020	rs112678550	A	C	11	7	18	0	0	19	1	0
1	1158277	rs3813199	G	A	6	6	12	0	0	12	0	0
1	1158326	rs3813198	G	A	4	4	8	0	0	8	0	0
1	1158357	.	A	G	5	6	11	0	1	12	0	0
1	1166887	rs60252802	T	C	1	29	30	0	0	30	0	0
1	1198736	.	G	A	42	38	80	0	1	81	0	0
1	1221001	rs72896210	A	G	8	9	17	0	0	17	0	0
1	1227090	.	A	G	18	3	21	0	0	21	0	0
1	1407372	rs188574574	T	C	4	3	7	0	0	7	0	0
1	1410774	rs148670635	C	G	8	6	14	0	0	14	0	0
1	1457773	rs183883762	C	T	3	4	7	0	0	7	0	0
1	1469598	rs9439464	C	G	141	22	163	0	1	164	0	0
1	1469599	rs3128343	G	C	140	22	162	0	1	163	0	0
1	1469606	rs35611435	C	T	144	25	169	0	2	171	0	0
1	1497824	rs2296716	C	T	87	61	148	0	1	149	0	0
1	1510801	rs7519837	C	T	1	8	9	0	0	9	0	0
1	1550181	.	G	A	14	19	33	0	0	33	0	0
1	1574019	rs9442412	A	G	7	4	11	0	0	11	0	0
1	1574076	.	G	A	6	4	10	0	0	10	0	0
1	1575836	.	C	G	5	1	6	0	0	6	0	0
1	1576622	rs3765907	C	T	6	1	7	0	0	7	0	0
1	1576636	rs3765908	G	A	1	5	6	0	0	6	0	0
1	1580054	.	C	A	13	29	42	0	0	42	0	0
1	1580738	rs4648767	T	A	12	25	37	0	1	38	0	0
1	1581096	.	C	T	17	49	66	0	0	66	0	0
1	1582202	rs61774918	C	T	26	81	107	0	2	109	0	0
1	1582455	.	G	A	5	10	15	0	0	15	0	0
1	1582880	.	G	C	8	16	24	0	1	25	0	0
1	1582961	.	G	C	24	17	41	0	0	41	0	0
1	1583003	.	C	T	28	30	58	0	0	58	0	0
1	1588717	.	G	A	26	2	28	0	0	28	0	0
1	1588737	.	C	T	20	1	21	0	1	22	0	0
1	1588743	.	A	T	15	1	16	0	1	17	0	0
1	1593812	.	G	A	25	17	42	0	1	43	0	0
1	1599812	.	C	T	3	10	13	0	0	13	0	0
1	1599888	.	A	G	2	18	20	0	1	21	0	0
1	1647555	rs139652090	T	C	17	19	36	0	0	36	0	0
1	1660726	rs1061884	T	C	2	27	29	0	0	29	0	0
1	1660735	.	T	C	2	30	32	0	1	33	0	0
1	1660812	.	A	G	6	14	20	0	0	20	0	0
1	1661253	.	G	A	10	3	13	0	0	13	0	0
1	1682881	.	C	T	9	0	9	0	0	9	0	0
1	1683565	rs17162846	G	A	39	36	75	0	1	76	0	0
1	1687791	rs72634840	C	T	8	7	15	0	1	16	0	0
1	1689556	.	C	T	5	4	9	0	0	9	0	0
1	1991014	rs1878745	A	G	7	10	17	0	0	17	0	0
1	2221273	rs2843166	C	A	7	0	7	0	0	7	0	0
1	2221534	rs903924	A	G	2	4	6	0	0	6	0	0
1	2221838	rs878093	G	A	2	4	6	0	0	6	0	0
1	2222076	rs903921	G	A	7	6	13	0	0	13	0	0
1	2227166	rs2971438	A	G	9	4	13	0	0	13	0	0
1	2229553	rs2843161	C	T	3	3	6	0	0	6	0	0
1	2231567	rs1809823	G	T	3	4	7	0	0	7	0	0
1	2240006	rs2173049	T	C	104	66	170	0	1	171	0	0
1	2240141	rs138562685	G	A	78	76	154	0	0	154	0	0
1	2324008	rs2840533	C	T	6	5	11	0	0	11	0	0
1	2324321	rs68103143	G	T	4	5	9	0	2	11	0	0
1	2324336	rs3820010	T	C	2	5	7	0	0	7	0	0
1	2327815	rs2840532	C	T	6	4	10	0	0	10	0	0
1	2328714	rs2645081	A	G	12	6	18	0	0	18	0	0
1	2329808	rs3001344	A	G	7	6	13	0	0	13	0	0
1	2330002	rs6698978	A	G	6	10	16	0	0	16	0	0
1	2332038	rs55912310	A	G	9	10	19	0	1	20	0	0
1	2332640	rs59940476	T	C	4	2	6	0	0	6	0	0
1	2332988	rs3001337	T	C	2	5	7	0	0	7	0	0
1	2333031	rs3001336	G	A	7	8	15	0	0	15	0	0
1	2334261	rs72642191	G	T	9	9	18	0	0	18	0	0
1	2335676	rs1129333	A	G	27	30	57	0	0	57	0	0
1	2340200	rs2494598	T	C	6	13	19	0	0	19	0	0
1	2983963	rs2297828	G	A	3	4	7	0	1	8	0	0
1	3418428	rs200472001	G	A	33	21	54	0	0	54	0	0
1	3543706	rs4648540	C	T	7	3	10	0	1	11	0	0
1	3543778	rs4648541	T	G	5	2	7	0	0	7	0	0
1	3545612	rs1128474	A	G	27	26	53	0	0	53	0	0
1	3659657	rs2298222	G	A	5	10	15	0	0	15	0	0
1	3662845	rs3737589	A	G	3	5	8	0	1	9	0	0
1	3663057	rs3737590	A	T	4	9	13	0	0	13	0	0
1	3663641	rs75438821	C	T	3	3	6	0	0	6	0	0
1	3696890	rs8379	A	C	71	84	155	0	1	156	0	0
1	3697035	rs17411356	A	G	83	87	170	0	4	174	0	0
1	3697486	rs34286051	C	G	39	49	88	0	1	90	1	0
1	3701089	rs34545744	G	A	4	8	12	0	0	12	0	0
1	3701164	rs34555288	C	T	4	6	10	0	0	10	0	0
1	3701491	rs2996426	A	G	6	1	7	0	0	7	0	0
1	3701580	rs57217928	G	C	7	3	10	0	0	10	0	0
1	3701663	rs2298227	T	C	45	48	93	0	0	93	0	0
1	3701832	rs71634371	C	A	3	4	7	0	0	7	0	0
1	3703337	rs2368537	G	C	4	2	6	0	0	6	0	0
1	3703710	rs2253143	G	A	48	28	76	0	0	76	0	0
1	3729169	rs7528951	C	G	10	6	16	0	0	16	0	0
1	3730435	rs6695834	T	C	7	3	10	0	0	10	0	0
1	3731657	rs34060840	C	T	13	11	24	0	0	24	0	0
1	3731965	rs12728401	G	A	14	7	21	0	0	21	0	0
1	3742179	rs7530291	G	A	5	4	9	0	0	9	0	0
1	3742257	rs12759497	C	T	3	4	7	0	0	7	0	0
1	3753136	rs2275824	A	T	12	14	26	0	0	26	0	0
1	3761479	rs2275822	C	T	11	22	33	0	0	33	0	0
1	3763864	rs12047360	G	A	1	8	9	0	0	9	0	0
1	3764611	rs55873991	T	C	3	4	7	0	0	7	0	0
1	3773588	rs7542369	C	G	3	4	7	0	0	7	0	0
1	3773733	rs13374773	C	A	3	3	6	0	0	6	0	0
1	3801247	rs10909817	T	G	8	22	30	0	0	30	0	0
1	5927169	rs113445782	G	A	6	10	16	0	0	16	0	0
1	5937168	rs3747992	G	A	4	10	14	0	0	14	0	0
1	6125982	rs17029103	A	G	4	2	6	0	0	6	0	0
1	6141325	rs3789541	G	A	5	2	7	0	0	7	0	0
1	6145881	rs3747978	T	C	7	4	11	0	0	11	0	0
1	6154417	rs2294932	C	T	2	10	12	0	0	12	0	0
1	6157282	rs749434	C	T	3	3	6	0	0	6	0	0
1	6157993	rs1883769	T	C	56	44	100	0	1	101	0	0
1	6160870	rs3789527	G	A	356	312	668	0	10	678	0	0
1	6248182	rs114300540	C	T	3	3	6	0	0	6	0	0
1	6257856	rs2294713	G	A	7	4	11	0	0	11	0	0
1	6258147	rs2247392	C	T	3	9	12	0	1	13	0	0
1	6258794	rs3789524	A	G	3	3	6	0	0	6	0	0
1	6259025	rs3789522	C	T	21	28	49	0	0	49	0	0
1	6259090	rs3789520	C	T	21	23	44	0	0	44	0	0
1	6259130	rs3827723	A	G	16	22	38	0	0	38	0	0
1	6260663	rs11121478	A	C	5	3	8	0	0	8	0	0
1	6523430	rs3138156	T	C	7	7	14	0	1	15	0	0
1	6523578	rs3138155	T	A	10	12	22	0	0	22	0	0
1	6523725	rs3138153	G	A	5	7	12	0	0	12	0	0
1	6524501	rs11800462	T	C	17	28	45	0	0	45	0	0
1	6582100	.	C	G	28	25	53	0	1	54	0	0
1	6584807	rs116298941	T	A	7	2	9	0	0	9	0	0
1	6640099	.	C	G	8	9	17	0	0	17	0	0
1	6644723	rs731024	G	A	14	11	25	0	0	25	0	0
1	6645867	rs6682920	G	A	12	6	18	0	0	18	0	0
1	6651728	rs1556036	C	T	60	78	138	0	1	139	0	0
1	6652718	rs2235567	G	A	43	51	94	0	0	94	0	0
1	6652745	rs7513688	G	A	45	56	101	0	1	102	0	0
1	6655053	rs2235566	G	A	5	6	11	0	1	12	0	0
1	6656066	.	C	T	4	2	6	0	0	6	0	0
1	6659505	rs2232460	G	A	39	47	86	0	1	87	0	0
1	6683240	rs14057	G	A	83	68	151	0	0	151	0	0
1	6688358	rs11122109	G	A	5	3	8	0	0	8	0	0
1	6693097	rs3174820	A	G	12	14	26	0	2	28	0	0
1	6694574	rs6804	G	A	34	23	57	0	1	58	0	0
1	6694927	rs2294532	C	T	20	27	47	0	1	48	0	0
1	6695331	rs11892	G	T	33	27	60	0	0	60	0	0
1	6713282	rs200440	A	G	5	5	10	0	0	10	0	0
1	6948204	rs8918	T	C	32	47	79	0	1	80	0	0
1	7832289	rs707459	A	T	57	35	92	0	2	94	0	0
1	7833047	rs539622065	G	A	55	39	94	0	2	96	0	0
1	7834026	rs2071987	G	A	4	6	10	0	0	10	0	0
1	7834858	rs1773157	C	T	4	5	9	0	0	9	0	0
1	7836208	rs228734	G	A	8	7	15	0	1	16	0	0
1	7837676	rs2301489	G	C	5	4	9	0	0	9	0	0
1	7837842	rs697673	T	C	6	3	9	0	0	9	0	0
1	7840926	rs697679	G	C	282	266	548	0	1	549	0	0
1	7887579	rs228697	C	G	7	1	8	0	0	8	0	0
1	7889941	rs2640908	C	T	4	7	11	0	0	11	0	0
1	7890117	rs2640909	T	C	8	3	11	0	0	11	0	0
1	8021778	rs226249	T	C	88	91	179	0	1	180	0	0
1	8037496	rs161807	G	A	1	7	8	0	0	8	0	0
1	8072466	rs9756	C	T	2	5	7	0	0	7	0	0
1	8412935	rs8627	C	T	143	158	301	0	2	303	0	0
1	8412989	rs1064826	A	G	108	128	236	0	3	239	0	0
1	8419629	rs7525559	T	C	1	6	7	0	0	7	0	0
1	8421092	rs2784735	C	T	9	11	20	0	0	20	0	0
1	8421203	rs13596	T	C	31	16	47	0	1	48	0	0
1	8423510	rs10779702	A	G	2	4	6	0	0	6	0	0
1	8925112	rs2765507	T	C	3	4	7	0	0	7	0	0
1	8926868	rs2781064	C	T	4	7	11	0	0	11	0	0
1	8928125	rs2071412	G	T	75	69	144	0	0	144	0	0
1	8928811	rs7540170	C	T	29	9	38	0	1	39	0	0
1	8931149	rs2274971	C	T	50	40	90	0	1	91	0	0
1	8932413	rs4908519	C	T	4	3	7	0	0	7	0	0
1	8937773	rs201853842	A	C	3	3	6	0	0	6	0	0
1	9095444	rs11121304	C	T	11	9	20	0	0	20	0	0
1	9095494	rs10864381	G	A	10	6	16	0	1	17	0	0
1	9095610	rs10864382	T	C	11	6	17	0	0	17	0	0
1	9095847	rs11121305	C	T	4	3	7	0	0	7	0	0
1	9095962	rs12125486	G	C	3	3	6	0	0	6	0	0
1	9096050	rs10864383	C	A	4	3	7	0	0	7	0	0
1	9097241	rs5840	C	T	129	63	192	0	0	193	1	0
1	9097251	rs1063137	A	G	128	58	186	0	1	187	0	0
1	9098272	rs875995	C	T	2	4	6	0	0	6	0	0
1	9100479	rs1060998	G	A	8	4	12	0	0	12	0	0
1	9101155	rs34488100	T	G	4	8	12	0	0	12	0	0
1	9243811	rs797257	G	T	4	2	6	0	0	6	0	0
1	9307033	rs7524046	G	A	5	4	9	0	0	9	0	0
1	9327387	rs1294015	T	G	9	4	13	0	2	15	0	0
1	9329289	rs2071931	C	T	10	7	17	0	0	17	0	0
1	9330740	rs12144045	G	C	11	13	24	0	0	24	0	0
1	9642424	rs61741102	G	C	245	247	492	0	3	495	0	0
1	9643332	rs139722952	C	T	7	10	17	0	0	17	0	0
1	9741193	rs6660363	A	G	14	18	32	0	0	32	0	0
1	9787508	rs1135426	T	C	51	64	115	0	0	115	0	0
1	9908680	rs7225	C	T	97	99	196	0	2	198	0	0
1	9909506	rs1220394	G	A	95	105	200	0	2	202	0	0
1	9910357	rs935072	A	T	140	108	248	0	1	249	0	0
1	9910358	rs72633900	T	C	140	107	247	0	2	249	0	0
1	9987007	rs11828	C	T	6	2	8	0	1	9	0	0
1	10003320	rs1234694	G	A	12	5	17	0	0	17	0	0
1	10093457	rs7528979	C	T	57	69	126	0	1	127	0	0
1	10467456	rs1300646	G	A	8	6	14	0	0	14	0	0
1	10511544	rs628462	C	T	25	23	48	0	1	49	0	0
1	10606787	rs55913143	G	A	7	1	8	0	0	8	0	0
1	10607394	rs710130	C	T	13	9	22	0	0	22	0	0
1	10608398	rs11121583	A	G	1	6	7	0	0	7	0	0
1	10609505	rs12120962	G	A	3	3	6	0	0	6	0	0
1	10637633	.	T	A	8	0	8	0	2	10	0	0
1	10689942	rs11539794	G	T	8	20	28	0	0	28	0	0
1	10720905	rs79792288	C	T	8	3	11	0	0	11	0	0
1	11074250	rs3765895	A	G	17	4	21	0	1	22	0	0
1	11079413	rs7546126	T	A	7	5	12	0	0	12	0	0
1	11079773	rs1967714	A	G	4	2	6	0	0	6	0	0
1	11081210	rs1922991	T	A	16	6	22	0	0	22	0	0
1	11081880	rs1474891	G	T	16	24	40	0	0	40	0	0
1	11086717	rs1033638	A	G	2	4	6	0	0	6	0	0
1	11087835	rs1782454	T	C	2	4	6	0	0	6	0	0
1	11089463	rs1782457	T	A	3	5	8	0	0	8	0	0
1	11131292	rs11583740	C	T	6	9	15	0	0	15	0	0
1	11131433	.	T	C	8	8	16	0	1	17	0	0
1	11132217	rs1130683	G	A	128	112	240	0	2	242	0	0
1	11132541	rs2791650	G	C	5	4	9	0	0	9	0	0
1	11132561	rs2791649	A	G	4	4	8	0	0	8	0	0
1	11132801	rs2791647	G	A	2	4	6	0	0	6	0	0
1	11134157	rs2748876	T	G	6	1	7	0	0	7	0	0
1	11137778	rs2259886	C	T	12	9	21	0	0	21	0	0
1	11141187	rs2258621	C	G	59	49	108	0	1	109	0	0
1	11181327	rs11121691	C	T	38	34	72	0	1	73	0	0
1	11190646	rs2275527	G	A	17	15	32	0	0	32	0	0
1	11205058	rs1057079	C	T	11	11	22	0	0	22	0	0
1	11288758	rs1064261	G	A	16	15	31	0	0	31	0	0
1	11301714	rs1135172	A	G	6	12	18	0	0	18	0	0
1	11733905	rs149211049	C	T	19	29	48	0	0	48	0	0
1	11740812	rs2272981	A	C	4	6	10	0	0	10	0	0
1	11796240	rs6668392	C	T	59	43	102	0	0	102	0	0
1	11812127	rs6661776	G	A	6	4	10	0	0	10	0	0
1	11847759	rs3737966	C	T	15	12	27	0	0	27	0	0
1	11856378	rs1801133	G	A	7	3	10	0	0	10	0	0
1	12009955	rs7529452	C	T	11	19	30	0	0	30	0	0
1	12024235	rs1130529	C	T	20	23	43	0	0	43	0	0
1	12059412	rs2295281	C	T	28	13	41	0	0	41	0	0
1	12060336	rs12066842	A	G	12	2	14	0	0	14	0	0
1	12060565	rs6676963	T	C	12	9	21	0	0	21	0	0
1	12062361	rs2236058	C	G	4	4	8	0	0	8	0	0
1	12062507	rs11121847	T	G	3	3	6	0	0	6	0	0
1	12067044	rs7550536	T	G	14	8	22	0	0	22	0	0
1	12071680	rs1042842	A	G	133	109	242	0	0	242	0	0
1	12072518	rs3088064	G	C	203	118	321	0	0	321	0	0
1	12082926	rs2295283	A	G	80	63	143	0	2	145	0	0
1	12267999	rs1061628	C	T	29	28	57	0	2	59	0	0
1	12268499	rs1061631	G	A	46	48	94	0	4	98	0	0
1	12290145	rs139881781	C	G	3	3	6	0	0	6	0	0
1	12401868	rs28551666	A	C	18	7	25	0	1	26	0	0
1	12405041	rs28558814	A	G	2	7	9	0	1	10	0	0
1	12429611	rs2295338	C	T	21	16	37	0	0	37	0	0
1	12569789	rs9783054	A	T	2	4	6	0	0	6	0	0
1	12630700	rs4846121	C	T	5	3	8	0	0	8	0	0
1	12639018	rs2275874	C	T	4	5	9	0	0	9	0	0
1	12639289	rs12041395	C	T	3	5	8	0	1	9	0	0
1	12639596	rs2358737	C	T	11	13	24	0	0	24	0	0
1	12639875	rs77434180	A	C	12	15	27	0	0	27	0	0
1	12640461	rs2275873	C	G	31	28	59	0	0	59	0	0
1	12660599	rs12711523	C	T	1	5	6	0	0	6	0	0
1	14105139	rs2076324	T	A	5	7	12	0	0	12	0	0
1	14105298	rs1203678	G	A	8	8	16	0	0	16	0	0
1	14109114	rs1203651	A	G	19	15	34	0	0	34	0	0
1	14110417	rs1203649	G	A	2	6	8	0	0	8	0	0
1	14112749	rs1203647	T	C	5	1	6	0	0	6	0	0
1	15546077	rs3753313	G	A	7	8	15	0	0	15	0	0
1	15546761	rs7681	G	A	3	7	10	0	0	10	0	0
1	15546825	rs549	A	G	2	4	6	0	0	6	0	0
1	15755248	rs3765372	C	T	586	656	1242	0	7	1249	0	0
1	15755728	rs112780652	A	T	438	517	955	0	33	989	1	0
1	16451426	.	G	A	20	22	42	0	0	42	0	0
1	16842114	.	G	A	13	5	18	0	0	18	0	0
1	16889158	.	A	C	6	11	17	0	0	17	0	0
1	16889423	.	G	C	19	9	28	0	0	28	0	0
1	16889663	.	A	G	2	7	9	0	0	9	0	0
1	16889985	.	T	C	6	9	15	0	0	15	0	0
1	16890421	.	G	A	18	8	26	0	0	26	0	0
1	16890598	.	T	A	4	5	9	0	0	9	0	0
1	16890639	.	C	T	3	6	9	0	0	9	0	0
1	16918502	rs3925698	A	G	0	6	6	0	0	6	0	0
1	16944809	.	G	C	9	6	15	0	0	15	0	0
1	16945452	.	C	T	30	13	43	0	1	44	0	0
1	16946535	.	T	C	19	1	20	0	0	20	0	0
1	16946562	.	C	A	12	9	21	0	0	21	0	0
1	16946630	.	G	A	15	2	17	0	0	17	0	0
1	16946723	rs375097	G	A	14	10	24	0	1	25	0	0
1	16946740	rs399721	C	T	13	7	20	0	0	20	0	0
1	16946749	rs425424	A	G	10	6	16	0	0	16	0	0
1	16947734	.	T	C	6	1	7	0	0	7	0	0
1	16947803	.	C	T	4	2	6	0	0	6	0	0
1	16948000	.	C	T	4	6	10	0	0	10	0	0
1	16948722	.	C	T	4	3	7	0	0	7	0	0
1	16952481	rs915311	A	G	2	11	13	0	1	14	0	0
1	16958064	rs1622521	A	G	7	8	15	0	0	15	0	0
1	16958833	.	T	A	9	5	14	0	0	14	0	0
1	16961588	.	A	G	6	10	16	0	0	16	0	0
1	17084968	.	G	C	9	0	9	0	0	9	0	0
1	17216080	rs3738618	T	C	29	36	65	0	3	68	0	0
1	17216135	rs6684252	G	C	5	15	20	0	0	20	0	0
1	17221104	.	A	G	5	1	6	0	0	6	0	0
1	17221157	.	G	A	8	2	10	0	0	10	0	0
1	17221240	.	T	C	11	2	13	0	0	13	0	0
1	17221270	.	T	C	10	2	12	0	0	12	0	0
1	17221338	.	C	T	6	0	6	0	0	6	0	0
1	17221632	rs9435768	T	C	7	0	7	0	0	7	0	0
1	17221633	rs77275546	G	A	7	0	7	0	0	7	0	0
1	17231268	.	A	G	7	0	7	0	0	7	0	0
1	17264939	.	T	C	6	2	8	0	0	8	0	0
1	17266536	.	G	C	5	1	6	0	0	6	0	0
1	17295679	rs4920574	T	C	10	21	31	0	0	31	0	0
1	17301448	rs2235933	C	T	3	7	10	0	0	10	0	0
1	17314702	rs3738815	C	T	79	70	149	0	0	149	0	0
1	17324537	rs9435665	G	A	4	2	6	0	0	6	0	0
1	17345877	rs12045097	A	G	4	5	9	0	0	9	0	0
1	17345905	rs2871775	A	G	6	6	12	0	0	12	0	0
1	17349955	rs2235931	G	A	2	4	6	0	0	6	0	0
1	17351096	rs2235929	G	A	3	3	6	0	0	6	0	0
1	17393889	rs7516087	A	G	60	17	77	0	2	79	0	0
1	17394048	rs35058101	T	A	2	34	36	0	0	36	0	0
1	17394374	rs12133334	C	A	1	23	24	0	1	25	0	0
1	17394775	rs2235927	G	A	26	7	33	0	0	33	0	0
1	17395281	rs2235926	T	C	14	6	20	0	0	20	0	0
1	17395480	rs2076599	G	A	2	20	22	0	1	23	0	0
1	17395521	rs2076598	G	A	2	22	24	0	0	24	0	0
1	17396703	rs2076595	T	C	5	26	31	0	0	31	0	0
1	17402255	rs3818032	C	T	5	24	29	0	0	29	0	0
1	17405809	rs2057096	G	A	2	14	16	0	1	17	0	0
1	17413121	rs2076615	A	C	14	6	20	0	0	20	0	0
1	17419024	rs11203297	G	A	12	9	21	0	0	21	0	0
1	17681277	rs6683201	T	C	5	3	8	0	0	8	0	0
1	17681424	rs4920600	A	G	8	4	12	0	0	12	0	0
1	17682100	rs1748012	C	T	5	1	6	0	1	7	0	0
1	17685466	rs34481461	C	A	4	3	7	0	0	7	0	0
1	17733564	rs7191	T	G	303	325	628	0	4	633	1	0
1	17733996	rs3193024	G	A	232	248	480	0	5	485	0	0
1	17736578	rs2762890	A	G	19	25	44	0	0	44	0	0
1	17739313	rs942458	T	G	17	3	20	0	0	20	0	0
1	17739820	rs1075535	T	C	18	29	47	0	0	47	0	0
1	17740357	rs2003871	G	A	10	16	26	0	0	26	0	0
1	17741044	rs2019622	G	A	2	4	6	0	2	9	1	0
1	17742024	rs12093070	T	C	8	8	16	0	0	16	0	0
1	17742209	rs12093155	T	C	8	9	17	0	0	17	0	0
1	17748027	rs1535874	A	G	2	4	6	0	0	6	0	0
1	17765056	.	G	C	4	4	8	0	0	8	0	0
1	17765484	rs3121622	T	C	6	10	16	0	0	16	0	0
1	17765505	rs3094883	G	C	8	9	17	0	0	17	0	0
1	17765756	rs11203388	C	T	8	5	13	0	0	13	0	0
1	19198576	rs1138267	A	G	78	55	133	0	1	134	0	0
1	19198637	rs3202002	G	A	60	54	114	0	1	115	0	0
1	19199221	rs11740	C	T	58	39	97	0	4	101	0	0
1	19201665	rs28481840	A	G	4	2	6	0	0	6	0	0
1	19201675	.	C	A	4	2	6	0	0	6	0	0
1	19201956	rs2230708	A	G	50	21	71	0	0	71	0	0
1	19202917	rs7550938	T	C	33	19	52	0	0	52	0	0
1	19202926	rs2230706	T	C	33	17	50	0	0	50	0	0
1	19203997	rs2230705	C	G	24	30	54	0	0	54	0	0
1	19232467	.	G	C	101	126	227	0	1	228	0	0
1	19401728	rs1886026	G	A	4	6	10	0	0	10	0	0
1	19401814	rs1886025	A	G	5	8	13	0	0	13	0	0
1	19403867	rs2181598	C	G	3	3	6	0	0	6	0	0
1	19405237	rs2146866	A	G	4	10	14	0	0	14	0	0
1	19405284	rs2146865	G	C	5	8	13	0	0	13	0	0
1	19408380	rs12164540	T	C	2	4	6	0	0	6	0	0
1	19411129	rs1043905	A	G	201	158	359	0	2	361	0	0
1	19413261	rs12584	T	A	128	88	216	0	0	216	0	0
1	19413420	rs2274008	T	G	4	3	7	0	0	7	0	0
1	19413926	rs12075030	C	G	4	3	7	0	0	7	0	0
1	19415304	rs1043899	C	T	131	109	240	0	3	243	0	0
1	19420392	rs1106839	G	A	3	4	7	0	0	7	0	0
1	19430008	rs7515874	A	G	3	8	11	0	0	11	0	0
1	19433449	rs6426677	A	G	65	60	125	0	1	126	0	0
1	19437185	rs10916957	G	T	4	6	10	0	0	10	0	0
1	19447843	rs1044010	C	G	30	36	66	0	0	66	0	0
1	19448326	rs6681662	C	T	2	4	6	0	0	6	0	0
1	19499560	rs16862578	T	C	17	17	34	0	0	34	0	0
1	19507751	rs66921123	C	T	4	3	7	0	0	7	0	0
1	19539643	.	C	G	6	4	10	0	0	10	0	0
1	19557713	rs2275403	G	C	3	3	6	0	0	6	0	0
1	19566881	rs12084825	C	T	38	42	80	0	3	83	0	0
1	19578192	rs2294942	G	A	4	5	9	0	0	9	0	0
1	19581543	rs735025	G	A	6	7	13	0	0	13	0	0
1	19583684	rs1774074	C	T	4	5	9	0	0	9	0	0
1	19583725	rs1738017	T	C	5	4	9	0	0	9	0	0
1	19583734	rs4912057	G	A	5	5	10	0	0	10	0	0
1	19584004	rs1042380	G	A	54	55	109	0	0	109	0	0
1	19585903	rs9426684	G	A	42	29	71	0	0	71	0	0
1	19585933	rs9426685	G	A	43	24	67	0	1	68	0	0
1	19586015	rs9426686	G	T	41	17	58	0	0	58	0	0
1	19586294	rs1063984	A	G	63	49	112	0	1	113	0	0
1	19586360	rs1063985	T	C	42	37	79	0	0	79	0	0
1	19586571	rs1063986	T	C	21	6	27	0	1	28	0	0
1	19635011	rs1043657	C	T	154	110	264	0	3	267	0	0
1	19665457	rs3215560	A	C	22	2	24	0	1	25	0	0
1	19665497	rs6889	A	C	25	3	28	0	0	28	0	0
1	19666599	rs2027508	T	C	13	12	25	0	2	27	0	0
1	19666808	rs2268813	C	T	17	8	25	0	0	25	0	0
1	19666928	rs2268812	A	G	12	24	36	0	0	36	0	0
1	19667481	rs2268810	T	G	8	12	20	0	0	20	0	0
1	19667552	rs2268809	C	T	7	9	16	0	0	16	0	0
1	19669117	rs214326	A	G	14	8	22	0	0	22	0	0
1	19669235	rs12124843	A	G	16	11	27	0	0	27	0	0
1	19670273	rs147265492	G	A	13	15	28	0	0	28	0	0
1	19671494	rs114197650	G	A	13	19	32	0	0	32	0	0
1	19672376	rs4912072	G	A	7	3	10	0	0	10	0	0
1	19678347	rs7524423	G	A	2	4	6	0	0	6	0	0
1	19701015	rs3748753	G	A	2	4	6	0	0	6	0	0
1	19950062	rs1737428	T	C	245	315	560	0	5	565	0	0
1	20009790	rs41312012	C	T	8	2	10	0	1	11	0	0
1	20224152	rs61769077	G	A	9	12	21	0	0	21	0	0
1	20233226	rs41264115	A	G	7	3	10	0	0	10	0	0
1	20236027	rs61769079	A	G	6	7	13	0	0	13	0	0
1	20236731	rs17401735	A	G	12	14	26	0	0	26	0	0
1	20238343	rs1046548	A	G	15	11	26	0	0	26	0	0
1	20238373	rs61769080	G	A	12	12	24	0	0	24	0	0
1	20834610	rs6700034	C	A	6	11	17	0	1	18	0	0
1	20915701	rs2072671	A	C	38	27	65	0	0	65	0	0
1	20945055	rs1048977	C	T	47	54	101	0	2	103	0	0
1	20972340	rs3131714	G	A	7	8	15	0	0	15	0	0
1	20972698	rs114806694	G	A	3	5	8	0	0	8	0	0
1	20973368	rs12754803	C	T	3	3	6	0	0	6	0	0
1	20973752	rs7532202	A	G	5	8	13	0	0	13	0	0
1	20973872	rs7532296	A	G	10	3	13	0	0	13	0	0
1	20973892	rs9287034	C	T	5	10	15	0	0	15	0	0
1	20973941	rs12028312	C	T	5	5	10	0	0	10	0	0
1	20974046	rs76953237	C	A	4	6	10	0	0	10	0	0
1	20976163	rs545426	C	T	19	1	20	0	0	20	0	0
1	20976212	rs671312	C	T	8	5	13	0	0	13	0	0
1	20977000	rs1043424	A	C	56	42	98	0	1	99	0	0
1	20977380	rs1043443	T	C	34	44	78	0	0	78	0	0
1	20977449	rs512550	G	T	39	28	67	0	3	70	0	0
1	20977748	rs1043502	T	G	24	21	45	0	0	45	0	0
1	20977856	rs2078073	T	C	10	8	18	0	0	18	0	0
1	20978024	rs1573132	C	A	10	7	17	0	0	17	0	0
1	20978058	rs650616	G	A	6	13	19	0	0	19	0	0
1	20978137	rs10916843	C	T	8	3	11	0	0	11	0	0
1	20978221	rs639455	C	T	3	5	8	0	0	8	0	0
1	20978410	rs559542	T	C	311	253	564	0	2	566	0	0
1	20978415	rs150466875	T	G	290	314	604	0	11	616	1	0
1	20979573	rs36110575	C	T	10	4	14	0	0	14	0	0
1	20979580	rs12410193	T	G	10	4	14	0	0	14	0	0
1	20980450	rs2070660	G	T	8	9	17	0	1	18	0	0
1	20982913	rs61778482	T	C	7	3	10	0	0	10	0	0
1	20983625	rs9662033	C	T	6	2	8	0	0	9	1	0
1	20983863	rs10799657	C	A	5	6	11	0	0	11	0	0
1	20983987	rs589709	G	A	4	4	8	0	0	8	0	0
1	20984254	rs10799658	C	T	6	1	7	0	0	7	0	0
1	20984554	rs640742	A	C	3	3	6	0	0	6	0	0
1	20986078	rs623817	G	A	3	7	10	0	0	10	0	0
1	21671943	rs2072654	T	G	6	2	8	0	0	8	0	0
1	21751142	.	A	G	10	0	10	0	1	11	0	0
1	21751214	.	G	A	11	0	11	0	0	11	0	0
1	21780651	rs2010202	A	G	6	0	6	0	0	6	0	0
1	21904267	rs1697406	A	G	4	3	7	0	0	7	0	0
1	21940555	rs2275363	C	T	1	11	12	0	0	12	0	0
1	21943820	rs2275360	G	A	15	2	17	0	0	17	0	0
1	22005665	rs1059218	C	T	1	8	9	0	0	9	0	0
1	22006579	rs61496627	C	T	6	6	12	0	1	13	0	0
1	22081980	rs12137072	G	A	8	4	12	0	0	12	0	0
1	22201438	rs41307806	C	T	14	11	25	0	0	25	0	0
1	22214046	rs41307868	C	T	6	11	17	0	0	17	0	0
1	22351326	rs3754505	G	C	4	5	9	0	1	10	0	0
1	22352108	rs11801382	C	T	7	7	14	0	0	14	0	0
1	22357229	rs3820687	A	T	35	7	42	0	0	42	0	0
1	22414785	rs2268179	G	T	13	8	21	0	0	21	0	0
1	22415410	rs2268177	A	T	8	4	12	0	0	12	0	0
1	22418284	.	G	T	263	141	404	0	77	481	0	0
1	23367138	rs1984576	A	G	31	34	65	0	0	65	0	0
1	23398065	rs12409321	C	T	8	2	10	0	1	11	0	0
1	23400969	rs1952527	T	C	13	15	28	0	0	28	0	0
1	23401985	rs537536023	A	C	2	4	6	0	0	6	0	0
1	23405872	rs2072944	T	C	10	13	23	0	0	23	0	0
1	23406485	rs2235547	C	G	23	17	40	0	0	40	0	0
1	23407081	rs12751560	C	A	12	17	29	0	0	29	0	0
1	23409538	rs2235546	G	A	18	20	38	0	0	38	0	0
1	23410138	rs12137204	T	G	11	25	36	0	5	41	0	0
1	23631625	rs655600	A	G	4	2	6	0	0	6	0	0
1	23650844	rs686451	A	G	2	4	6	0	0	6	0	0
1	23656285	rs646317	T	C	2	5	7	0	0	7	0	0
1	23670803	rs12409193	G	C	7	3	10	0	0	10	0	0
1	23686777	rs17437528	C	T	18	9	27	0	0	27	0	0
1	23686798	rs601786	A	G	13	11	24	0	1	25	0	0
1	23689083	rs3795308	G	A	6	10	16	0	0	16	0	0
1	23698120	rs754984	C	G	17	9	26	0	0	27	1	0
1	23833611	rs12026768	G	T	29	13	42	0	0	42	0	0
1	23833993	rs12027599	G	A	14	9	23	0	2	25	0	0
1	23834486	rs3820028	G	A	9	24	33	0	0	33	0	0
1	23835794	rs3218211	A	G	8	6	14	0	0	14	0	0
1	23836364	rs2075993	A	G	10	11	21	0	0	21	0	0
1	23847464	rs2075995	C	A	7	14	21	0	0	21	0	0
1	23884762	.	G	A	8	4	12	0	0	12	0	0
1	23884780	rs2920	T	C	6	7	13	0	0	13	0	0
1	24077451	rs2235541	C	T	130	117	247	0	1	248	0	0
1	24077957	rs35797868	A	G	165	174	339	0	3	342	0	0
1	24083494	rs2076345	C	T	261	243	504	0	3	507	0	0
1	24114129	rs4237	G	A	264	223	487	0	4	491	0	0
1	24180962	rs13551	T	C	12	15	27	0	0	27	0	0
1	24200903	rs2229586	G	C	1	5	6	0	0	6	0	0
1	24785393	rs2272935	C	T	6	4	10	0	0	10	0	0
1	24792617	rs195725	T	A	4	7	11	0	0	11	0	0
1	24798383	rs195729	C	T	5	1	6	0	0	6	0	0
1	24977982	.	C	T	226	166	392	0	2	394	0	0
1	24981439	rs56097146	A	G	291	279	570	0	6	576	0	0
1	24992916	rs16829906	C	T	9	7	16	0	1	17	0	0
1	25125162	rs7550184	C	G	7	6	13	0	0	13	0	0
1	25125898	rs4641258	C	G	6	10	16	0	0	16	0	0
1	25168124	rs9259	G	C	141	109	250	0	2	252	0	0
1	25169634	rs12439	A	G	233	222	455	0	1	456	0	0
1	25290763	rs145982216	A	T	7	2	9	0	0	9	0	0
1	25683092	rs3093653	G	A	4	3	7	0	0	7	0	0
1	25777524	.	C	T	4	6	10	0	0	10	0	0
1	25889632	rs6687605	T	C	19	7	26	0	0	26	0	0
1	25890189	rs28969504	A	G	16	11	27	0	0	27	0	0
1	25894853	rs11563	G	T	21	21	42	0	0	42	0	0
1	25895238	rs7491	C	T	8	11	19	0	0	19	0	0
1	26131654	rs7349185	G	A	71	62	133	0	0	133	0	0
1	26138262	rs760597	T	C	87	68	155	0	3	158	0	0
1	26140573	rs2294228	C	A	87	83	170	0	2	172	0	0
1	26143821	rs3203750	T	C	153	107	260	0	4	264	0	0
1	26143931	rs4659383	T	C	140	96	236	0	1	237	0	0
1	26146514	rs1127818	G	C	16	8	24	0	0	24	0	0
1	26148011	rs2049919	G	A	6	5	11	0	2	13	0	0
1	26148662	.	G	C	4	2	6	0	0	6	0	0
1	26148941	rs6598922	T	C	2	4	6	0	0	6	0	0
1	26149183	rs2142623	A	G	3	3	6	0	0	6	0	0
1	26150023	rs11247758	C	T	3	3	6	0	0	6	0	0
1	26152666	rs6598923	T	C	3	3	6	0	0	6	0	0
1	26158962	rs15045	A	G	49	54	103	0	1	104	0	0
1	26161037	rs7555012	G	C	31	21	52	0	3	55	0	0
1	26161086	rs11247767	A	G	29	8	37	0	0	37	0	0
1	26162313	rs34449716	T	G	43	23	66	0	1	67	0	0
1	26188238	rs213638	G	A	46	58	104	0	0	104	0	0
1	26188625	rs213637	G	T	34	38	72	0	0	72	0	0
1	26210791	rs159530	T	C	6	5	11	0	0	11	0	0
1	26211773	rs159528	C	T	4	9	13	0	0	13	0	0
1	26287563	rs2012311	T	C	8	4	12	0	0	12	0	0
1	26496455	rs2232648	C	T	49	35	84	0	0	84	0	0
1	26497636	rs7555877	G	A	5	3	8	0	1	9	0	0
1	26515956	rs1045105	C	A	2	5	7	0	0	7	0	0
1	26560745	rs3795687	G	A	16	13	29	0	0	29	0	0
1	26561220	rs6698557	G	C	5	1	6	0	0	6	0	0
1	26563850	rs11808575	T	G	5	4	9	0	0	9	0	0
1	26582091	rs3795686	G	A	37	25	62	0	2	64	0	0
1	26582686	rs17163770	T	A	5	7	12	0	0	12	0	0
1	26592310	rs7547520	C	T	9	3	12	0	0	12	0	0
1	26598281	rs10902728	T	C	2	5	7	0	0	7	0	0
1	26599489	rs17163808	A	G	2	5	7	0	0	7	0	0
1	26600793	rs10902731	A	G	5	2	7	0	0	7	0	0
1	26601385	rs3795685	G	A	7	3	10	0	0	10	0	0
1	26607123	rs12759434	C	T	9	8	17	0	1	18	0	0
1	26608649	rs12750420	G	A	8	1	9	0	0	9	0	0
1	26608782	rs34209692	C	T	10	6	16	0	0	16	0	0
1	26609259	rs7522905	C	T	92	83	175	0	0	175	0	0
1	26629342	rs117509001	G	A	35	40	75	0	0	75	0	0
1	26786627	rs3816539	G	A	16	12	28	0	0	28	0	0
1	26796391	rs80313266	G	T	18	19	37	0	0	37	0	0
1	26797508	rs2290588	C	T	18	24	42	0	0	42	0	0
1	26800849	rs2445635	A	G	5	5	10	0	0	10	0	0
1	26801753	.	A	T	1499	832	2331	0	33	2364	0	0
1	26884416	rs12726439	T	C	11	0	11	0	0	11	0	0
1	26886114	rs12033185	G	A	6	7	13	0	1	14	0	0
1	26886959	rs10458602	C	G	6	1	7	0	0	7	0	0
1	26887592	rs1064196	T	C	98	114	212	0	0	212	0	0
1	26890648	rs444482	C	G	3	3	6	0	0	6	0	0
1	26891360	rs3127013	T	G	4	6	10	0	0	10	0	0
1	26898956	rs282176	T	C	13	36	49	0	0	49	0	0
1	26899125	rs282177	C	T	3	8	11	0	0	11	0	0
1	26899444	rs190737	C	A	6	5	11	0	0	11	0	0
1	26899687	rs282178	C	A	4	4	8	0	1	9	0	0
1	26900708	rs2229714	G	A	135	178	313	0	2	315	0	0
1	26900805	rs12121702	G	A	114	126	240	0	4	244	0	0
1	26900920	rs12118436	A	T	118	92	210	0	7	217	0	0
1	26901090	rs11113	C	T	220	226	446	0	2	449	1	0
1	26901319	rs7726	G	A	145	172	317	0	3	320	0	0
1	27019131	rs112203773	C	A	1	6	7	0	0	7	0	0
1	27027324	rs78520390	C	T	4	3	7	0	0	7	0	0
1	27097515	rs76490152	A	G	5	4	9	0	0	9	0	0
1	27173449	rs6686271	T	C	1	7	8	0	0	8	0	0
1	27178579	rs78129710	T	C	1	5	6	0	0	6	0	0
1	27181427	rs760093	G	A	172	119	291	0	6	297	0	0
1	27182261	rs12747620	A	G	6	5	11	0	0	11	0	0
1	27183081	rs112320940	G	A	10	2	12	0	0	12	0	0
1	27203873	rs76995736	C	A	30	30	60	0	0	60	0	0
1	27204183	rs34204245	T	C	9	10	19	0	0	19	0	0
1	27209166	rs113240820	G	T	5	9	14	0	1	15	0	0
1	27209439	rs74465889	A	G	8	6	14	0	0	14	0	0
1	27215431	rs185715474	T	A	5	1	6	0	0	6	0	0
1	27270972	rs1187947	A	C	5	2	7	0	0	7	0	0
1	27632690	rs140564293	C	G	51	46	97	0	1	98	0	0
1	27652359	rs55663650	G	A	5	4	9	0	0	9	0	0
1	27660340	rs12758154	T	C	2	4	6	0	0	6	0	0
1	27662235	rs3813792	G	T	77	93	170	0	1	171	0	0
1	27662666	rs9203	A	G	80	73	153	0	0	153	0	0
1	27676925	rs6702341	G	A	183	162	345	0	19	364	0	0
1	27732910	rs11548324	C	T	168	157	325	0	2	327	0	0
1	27796368	rs6598883	A	G	8	5	13	0	0	13	0	0
1	27877418	rs113173951	G	A	1	5	6	0	0	6	0	0
1	27878162	rs112179924	C	T	9	11	20	0	0	20	0	0
1	27942155	rs2231880	T	G	24	16	40	0	0	40	0	0
1	28157446	rs41284290	T	G	38	35	73	0	1	74	0	0
1	28200702	rs11247700	C	T	5	1	6	0	0	6	0	0
1	28200909	rs10902674	T	C	3	4	7	0	0	7	0	0
1	28203653	rs11247703	C	G	2	4	6	0	0	6	0	0
1	28205884	rs12048235	G	A	5	2	7	0	0	7	0	0
1	28206588	rs12568383	T	C	23	27	50	0	0	50	0	0
1	28207052	rs7555608	G	A	36	9	45	0	0	45	0	0
1	28207822	rs35049624	T	C	6	3	9	0	0	9	0	0
1	28208312	rs35250731	C	A	15	6	21	0	1	22	0	0
1	28211384	rs2236074	G	A	7	14	21	0	0	21	0	0
1	28211403	rs1467465	A	G	7	12	19	0	0	19	0	0
1	28211650	rs1467464	T	C	15	10	25	0	0	25	0	0
1	28212975	rs6564	C	T	258	216	474	0	1	475	0	0
1	28213157	rs6565	T	C	31	36	67	0	0	67	0	0
1	28218100	rs7356	T	C	12	41	53	0	0	53	0	0
1	28282206	rs3813804	C	T	31	6	37	0	0	37	0	0
1	28282292	rs3813803	T	C	8	25	33	0	0	33	0	0
1	28476001	rs313152	T	C	48	50	98	0	1	99	0	0
1	28527011	rs1049504	A	G	23	11	34	0	0	34	0	0
1	28535233	rs510379	T	C	11	23	34	0	0	34	0	0
1	28562676	rs12154	A	G	180	198	378	0	2	380	0	0
1	28564252	rs8559	A	G	81	79	160	0	0	160	0	0
1	28564279	rs9508	A	G	108	68	176	0	2	178	0	0
1	28566404	rs518273	T	G	8	3	11	0	0	11	0	0
1	28566740	rs6688791	T	A	3	3	6	0	0	6	0	0
1	28567075	rs529790	C	T	5	3	8	0	0	8	0	0
1	28567101	rs529726	A	G	3	4	7	0	0	7	0	0
1	28573226	rs546415	A	G	24	21	45	0	1	46	0	0
1	28573835	rs492554	C	T	0	9	9	0	0	9	0	0
1	28607800	rs17357180	G	C	221	262	483	0	2	486	1	0
1	28607890	rs1053107	G	T	183	240	423	0	3	426	0	0
1	28608210	rs17163112	C	G	240	294	534	0	2	536	0	0
1	28608798	rs13886	C	A	189	280	469	0	5	474	0	0
1	28800380	rs61785974	C	A	81	58	139	0	0	139	0	0
1	28822129	rs4247163	T	A	16	17	33	0	1	34	0	0
1	28822133	rs78025786	T	A	17	18	35	0	0	35	0	0
1	28822137	rs201956545	T	A	17	17	34	0	0	34	0	0
1	28822140	rs10158577	A	T	15	17	32	0	2	34	0	0
1	28822804	rs10915180	T	G	35	19	54	0	0	54	0	0
1	28823671	rs12139517	T	C	96	71	167	0	2	169	0	0
1	28825523	rs12141672	T	A	42	21	63	0	5	68	0	0
1	28826587	rs9107	G	A	181	122	303	0	4	307	0	0
1	28832923	rs2840757	C	A	6	4	10	0	0	10	0	0
1	28833494	rs2840758	G	A	4	2	6	0	0	6	0	0
1	28836414	rs41266181	G	A	20	13	33	0	0	33	0	0
1	28843318	rs79722995	A	G	20	19	39	0	1	40	0	0
1	28857969	rs4654372	C	G	7	11	18	0	0	18	0	0
1	28861636	rs2066726	G	A	56	50	106	0	2	108	0	0
1	28865710	rs2795321	A	G	2	4	6	0	0	6	0	0
1	28887860	rs76411095	G	A	43	43	86	0	1	87	0	0
1	28905566	rs1342086	G	C	9	5	14	0	0	14	0	0
1	28905649	rs9426360	T	C	7	9	16	0	0	16	0	0
1	29064036	rs61787567	C	T	16	13	29	0	0	29	0	0
1	29444720	rs471099	A	G	46	42	88	0	1	89	0	0
1	29445227	rs12120422	T	C	59	60	119	0	1	120	0	0
1	29445598	rs9578	A	G	102	116	218	0	0	218	0	0
1	29475341	rs2230678	C	T	119	130	249	0	2	251	0	0
1	29475394	rs2230677	C	G	120	117	237	0	0	237	0	0
1	29476316	rs3738061	G	T	2	5	7	0	0	7	0	0
1	29488290	rs471895	T	C	5	2	7	0	0	7	0	0
1	29494019	rs548960	C	T	6	14	20	0	0	20	0	0
1	29494507	rs7544720	C	T	8	4	12	0	0	12	0	0
1	29497250	rs2452787	T	C	10	12	22	0	0	22	0	0
1	29497820	rs1994859	C	T	7	13	20	0	0	20	0	0
1	29500995	rs2486204	T	C	3	3	6	0	0	6	0	0
1	29501248	rs113758223	C	T	4	2	6	0	0	6	0	0
1	29503214	rs547976	G	A	3	6	9	0	0	9	0	0
1	29503757	rs1389268	G	A	9	6	15	0	0	15	0	0
1	29507116	rs12401521	G	A	3	8	11	0	1	12	0	0
1	29507647	rs3094740	G	C	3	4	7	0	0	7	0	0
1	31192304	rs1149040	G	T	5	2	7	0	0	7	0	0
1	31198733	rs1149048	A	G	6	5	11	0	0	11	0	0
1	31205796	rs8048	T	C	3600	3366	6966	0	69	7035	0	0
1	31206637	rs3795438	C	T	1045	1078	2123	0	16	2139	0	0
1	31206806	rs3795437	T	C	6	8	14	0	0	14	0	0
1	31206957	rs12404920	T	C	9	9	18	0	0	18	0	0
1	31207256	rs55748171	G	T	19	13	32	0	0	32	0	0
1	31207781	rs10914189	C	T	8	12	20	0	1	21	0	0
1	31208042	rs35351292	C	T	2613	2550	5163	0	13	5176	0	0
1	31210200	rs115211698	C	A	12	5	17	0	0	17	0	0
1	31213574	rs1078609	A	G	31	27	58	0	1	59	0	0
1	31214820	rs12754344	T	C	45	38	83	0	1	84	0	0
1	31216969	rs11585511	G	A	12	7	19	0	0	19	0	0
1	31222316	rs1188350	A	G	86	120	206	0	1	207	0	0
1	31222317	rs61767295	T	C	122	84	206	0	1	207	0	0
1	31222491	rs1920420	A	C	91	120	211	0	0	211	0	0
1	31224396	rs111495917	G	T	3	3	6	0	0	6	0	0
1	31225271	rs77970901	C	A	0	6	6	0	0	6	0	0
1	31226340	rs1188347	T	C	7	13	20	0	0	20	0	0
1	31226375	rs1188346	A	T	7	13	20	0	1	21	0	0
1	31226381	rs111914912	C	G	8	9	17	0	0	17	0	0
1	31227441	rs1951782	C	T	3	4	7	0	0	7	0	0
1	31229075	rs3790503	A	G	2	5	7	0	0	7	0	0
1	31229883	rs1407885	A	G	7	8	15	0	0	15	0	0
1	31230126	rs1407883	C	T	3	5	8	0	0	8	0	0
1	31230195	rs1407882	T	C	6	5	11	0	0	11	0	0
1	31898234	rs4949402	T	C	3	3	6	0	0	6	0	0
1	31907102	rs7417775	A	G	2	14	16	0	0	16	0	0
1	32372022	rs188491297	G	C	8	0	8	0	0	8	0	0
1	32566109	.	C	T	24	18	42	0	0	42	0	0
1	32639057	rs35378339	G	C	23	42	65	0	1	66	0	0
1	32682255	.	A	G	12	8	20	0	0	20	0	0
1	32700631	.	C	T	1	5	6	0	0	6	0	0
1	32831543	rs476153	C	T	173	189	362	0	4	366	0	0
1	32844672	rs572484137	A	G	6	9	15	0	0	15	0	0
1	32859800	rs115917043	C	A	6	1	7	0	0	7	0	0
1	33068754	rs422215	T	C	7	6	13	0	0	13	0	0
1	33086809	rs3737997	A	G	5	9	14	0	0	14	0	0
1	33145742	rs9851	A	G	132	128	260	0	6	266	0	0
1	33148935	rs16835131	G	A	4	5	9	0	0	9	0	0
1	33402515	rs35462688	C	T	329	296	625	0	5	630	0	0
1	33402542	rs35756506	G	C	334	284	618	0	1	619	0	0
1	33407447	rs72654074	C	A	9	2	11	0	0	11	0	0
1	33475426	rs998664	C	T	212	182	394	0	6	400	0	0
1	33475750	.	A	G	758	0	758	0	4	763	1	0
1	33475767	.	G	A	802	0	802	0	3	805	0	0
1	33475791	.	A	G	396	359	755	0	4	759	0	0
1	33475879	.	C	T	672	0	672	0	15	687	0	0
1	33476239	.	T	C	262	0	262	0	0	262	0	0
1	33476292	.	A	G	169	0	169	0	1	170	0	0
1	33476353	.	C	T	171	0	171	0	2	173	0	0
1	33476385	.	C	G	289	0	289	0	1	293	3	0
1	33476387	.	C	T	297	2	299	0	0	299	0	0
1	33479861	rs2075986	T	C	9	1	10	0	0	10	0	0
1	33482864	rs75221737	G	A	3	3	6	0	0	6	0	0
1	33484220	rs2268692	C	A	4	2	6	0	0	6	0	0
1	33798824	rs4653050	C	T	3	3	6	0	0	6	0	0
1	33798928	rs4653051	G	A	3	3	6	0	0	6	0	0
1	35319550	rs11263953	C	T	12	10	22	0	0	22	0	0
1	35319610	rs7547768	A	C	11	19	30	0	0	30	0	0
1	35323395	rs7515410	T	G	8	9	17	0	0	17	0	0
1	35323550	rs7548854	C	T	5	7	12	0	0	12	0	0
1	35479295	rs71648001	G	A	7	4	11	0	0	11	0	0
1	35654477	rs112255064	G	A	5	6	11	0	0	11	0	0
1	36322426	.	A	T	21	8	29	0	0	29	0	0
1	36387788	.	G	A	12	8	20	0	0	20	0	0
1	36535757	.	T	G	5	3	8	0	0	8	0	0
1	37948164	rs201050265	C	G	11	28	39	0	0	39	0	0
1	37959450	rs215210	T	C	174	198	372	0	0	372	0	0
1	37959470	rs215211	C	G	177	191	368	0	0	368	0	0
1	37963541	rs4653294	A	G	5	4	9	0	0	9	0	0
1	38000185	rs7515306	G	A	2	6	8	0	0	8	0	0
1	38006359	rs2174769	A	G	18	16	34	0	0	34	0	0
1	38007770	rs4652958	A	G	12	5	17	0	0	17	0	0
1	38012706	rs6662367	C	G	2	8	10	0	0	10	0	0
1	38013346	rs7518026	C	T	5	7	12	0	0	12	0	0
1	38014478	rs11264069	A	G	8	23	31	0	0	31	0	0
1	38019747	rs2273013	C	T	35	24	59	0	0	59	0	0
1	38046920	rs2360010	G	T	4	3	7	0	0	7	0	0
1	38049373	rs3753372	C	T	9	4	13	0	1	14	0	0
1	38149076	rs34250208	G	A	5	2	7	0	0	7	0	0
1	38158211	rs2306625	C	T	8	8	16	0	0	16	0	0
1	38158258	rs11558851	C	T	15	17	32	0	0	32	0	0
1	38174366	rs7526362	G	T	37	28	65	0	1	66	0	0
1	38268836	rs12395	T	C	105	118	223	0	2	225	0	0
1	38276997	rs28411034	G	A	12	18	30	0	0	30	0	0
1	38278579	rs28411352	C	T	22	11	33	0	0	33	0	0
1	38279987	rs3748682	T	C	13	9	22	0	0	22	0	0
1	38289383	rs12751325	T	C	15	21	36	0	0	36	0	0
1	38327384	rs12729989	A	G	35	27	62	0	2	64	0	0
1	38331912	rs28525112	G	C	6	4	10	0	0	10	0	0
1	38334317	rs2306425	T	A	4	7	11	0	0	11	0	0
1	38334318	rs2306426	C	A	4	7	11	0	0	11	0	0
1	38454567	rs35348386	A	T	5	7	12	0	0	12	0	0
1	38480105	rs6688755	G	T	6	5	11	0	1	12	0	0
1	38482356	rs11211383	T	G	3	3	6	0	0	6	0	0
1	38486480	rs12737643	T	C	7	7	14	0	0	14	0	0
1	38488170	rs35867479	C	T	6	10	16	0	0	16	0	0
1	39460354	.	T	A	6	0	6	0	0	6	0	0
1	39671492	rs12023553	C	A	15	9	24	0	0	24	0	0
1	39672545	rs17491275	T	G	2	4	6	0	0	6	0	0
1	39748921	rs2275188	G	A	8	7	15	0	0	15	0	0
1	39835817	rs2296172	A	G	21	21	42	0	0	42	0	0
1	39908506	rs587404	G	A	73	58	131	0	1	132	0	0
1	39914363	rs668556	G	C	76	103	179	0	5	184	0	0
1	39924398	rs2296175	G	A	4	8	12	0	0	12	0	0
1	39951501	.	T	G	195	167	362	0	2	364	0	0
1	39988145	.	T	C	15	25	40	0	1	41	0	0
1	39989327	rs1727098	C	T	0	15	15	0	0	15	0	0
1	39992878	rs1180342	T	G	0	7	7	0	0	7	0	0
1	39995074	rs755249	C	T	6	1	7	0	0	7	0	0
1	40028180	rs4660293	A	G	11	8	19	0	0	19	0	0
1	40032239	rs3768320	T	C	11	11	22	0	0	22	0	0
1	40033934	rs4660836	A	G	35	13	48	0	6	54	0	0
1	40036847	rs2293476	G	C	146	134	280	0	2	282	0	0
1	40037354	rs41264487	C	G	10	3	13	0	0	13	0	0
1	40214648	rs112803459	C	T	61	102	163	0	0	163	0	0
1	40221497	rs76046361	G	C	3	3	6	0	0	6	0	0
1	40766484	.	C	T	51	52	103	0	0	103	0	0
1	40768191	rs117337557	G	A	2	4	6	0	0	6	0	0
1	40844036	rs209577	A	G	6	0	6	0	0	6	0	0
1	40845981	rs209580	T	C	5	3	8	0	0	8	0	0
1	40845992	rs209581	C	T	5	2	7	0	0	7	0	0
1	40846705	rs2221056	T	C	4	2	6	0	0	6	0	0
1	40847491	rs209583	A	C	5	5	10	0	0	10	0	0
1	40848830	rs1909074	T	A	9	7	16	0	0	16	0	0
1	40853331	rs10437077	G	A	15	10	25	0	0	25	0	0
1	40855590	rs3766413	C	T	8	4	12	0	0	12	0	0
1	40855604	rs432240	C	T	8	7	15	0	0	15	0	0
1	40862831	rs209598	G	A	2	6	8	0	0	8	0	0
1	40923019	rs2272994	G	A	3	4	7	0	0	7	0	0
1	40944704	rs41268065	G	C	3	4	7	0	0	7	0	0
1	40960619	rs41301076	G	A	3	4	7	0	0	7	0	0
1	40980559	rs1134586	G	A	18	20	38	0	1	39	0	0
1	40997453	rs41268071	G	T	12	36	48	0	0	48	0	0
1	41010149	rs7545749	G	A	49	3	52	0	1	53	0	0
1	41010230	rs41268077	G	C	3	24	27	0	0	27	0	0
1	41012847	rs41268081	A	G	12	10	22	0	0	22	0	0
1	41204569	rs1057925	C	T	36	21	57	0	0	57	0	0
1	41204615	.	A	G	43	33	76	0	1	77	0	0
1	41327281	rs1057635	C	A	12	12	24	0	0	24	0	0
1	41327746	rs141320252	C	A	5	3	8	0	0	8	0	0
1	41327873	rs12081504	G	C	22	15	37	0	0	37	0	0
1	41466472	rs12731155	A	G	9	17	26	0	1	27	0	0
1	41466550	rs12735455	T	A	8	7	15	0	0	15	0	0
1	41493111	rs3157	A	G	131	98	229	0	0	229	0	0
1	41493749	rs11555079	G	A	71	40	111	0	0	111	0	0
1	41504195	rs9326087	G	T	3	3	6	0	0	6	0	0
1	41504442	rs10489522	T	A	0	6	6	0	0	6	0	0
1	41976217	rs72669005	G	A	16	4	20	0	2	22	0	0
1	41976529	rs11809423	C	T	3	7	10	0	0	10	0	0
1	42045747	rs35730380	T	C	8	11	19	0	0	19	0	0
1	42046491	rs35624100	A	G	4	11	15	0	0	15	0	0
1	42047208	rs17363472	C	G	4	7	11	0	1	12	0	0
1	42094498	rs2038976	A	G	9	5	14	0	0	14	0	0
1	43212111	rs6882	C	T	30	29	59	0	0	59	0	0
1	43212680	rs80296318	G	A	16	7	23	0	0	23	0	0
1	43212869	rs3738496	A	T	19	13	32	0	0	32	0	0
1	43213610	rs7552138	T	C	3	4	7	0	0	7	0	0
1	43214683	rs1006518	C	T	4	6	10	0	0	10	0	0
1	43227418	rs2760069	A	G	2	6	8	0	0	8	0	0
1	43245324	rs1570431	A	G	3	6	9	0	1	10	0	0
1	43245427	rs1570432	C	G	5	5	10	0	0	10	0	0
1	43245778	rs192847362	G	T	5	2	7	0	0	7	0	0
1	43247192	rs2760076	T	C	5	4	9	0	0	9	0	0
1	43279094	rs323714	T	C	19	16	35	0	0	35	0	0
1	43305713	rs139619405	G	A	7	8	15	0	0	15	0	0
1	43632536	rs7163	C	T	283	234	517	0	7	524	0	0
1	43636484	rs1049276	C	G	321	254	575	0	5	581	1	0
1	43637932	rs9519	T	C	49	30	79	0	0	79	0	0
1	43779564	rs3120276	T	C	6	7	13	0	0	13	0	0
1	43784956	rs1199039	A	G	2	7	9	0	0	9	0	0
1	43825644	rs839763	T	C	64	31	95	0	0	95	0	0
1	43831518	rs72671107	T	A	5	7	12	0	1	13	0	0
1	43850473	rs11172	A	G	36	67	103	0	0	103	0	0
1	43858637	rs999288	A	G	5	1	6	0	0	6	0	0
1	43886494	rs2782643	C	T	4	4	8	0	0	8	0	0
1	43892189	rs2782646	G	A	9	3	12	0	0	12	0	0
1	43898013	.	C	T	7	11	18	0	0	18	0	0
1	43906896	rs2027130	A	G	8	13	21	0	0	21	0	0
1	43916642	rs6954	T	C	47	38	85	0	1	86	0	0
1	43917409	rs2251804	T	C	10	14	24	0	0	24	0	0
1	43917637	rs2251802	G	A	86	58	144	0	2	146	0	0
1	43919413	rs6692611	A	G	7	3	10	0	0	10	0	0
1	44083507	rs641365	T	C	1	5	6	0	0	6	0	0
1	44083519	rs641351	G	A	1	5	6	0	0	6	0	0
1	44129099	rs656131	T	C	5	5	10	0	0	10	0	0
1	44129209	rs6658300	T	C	4	4	8	0	0	8	0	0
1	44129779	rs669446	A	G	5	5	10	0	0	10	0	0
1	44131313	.	T	G	1	6	7	0	0	7	0	0
1	44137257	rs586339	C	A	15	24	39	0	1	40	0	0
1	44172458	rs34550543	C	T	4	2	6	0	0	6	0	0
1	44174081	rs7528454	G	A	3	16	19	0	2	21	0	0
1	44382524	rs4660262	G	A	5	3	8	0	0	8	0	0
1	44396646	rs6801	C	G	46	38	84	0	1	85	0	0
1	44401384	rs2242637	A	G	4	2	6	0	0	6	0	0
1	44402565	rs12127737	G	A	6	3	9	0	1	10	0	0
1	44414156	rs3791116	T	A	2	4	6	0	0	6	0	0
1	44415415	rs2240447	C	T	9	7	16	0	0	16	0	0
1	44431362	rs3791119	C	G	5	1	6	0	0	6	0	0
1	44431715	rs3791120	T	C	6	1	7	0	0	7	0	0
1	44433466	.	C	T	10	27	37	0	2	39	0	0
1	44438974	rs7161	C	T	11	16	27	0	0	27	0	0
1	44442521	rs12410334	A	C	19	19	38	0	0	38	0	0
1	44456742	rs7555	C	T	21	27	48	0	0	48	0	0
1	44505646	rs10157253	C	G	3	3	6	0	0	6	0	0
1	44681483	rs709267	C	G	7	5	12	0	0	12	0	0
1	44682084	rs709268	A	T	6	5	11	0	0	11	0	0
1	44684084	.	C	T	75	88	163	0	0	163	0	0
1	44686322	rs12419	T	C	14	23	37	0	0	37	0	0
1	44820248	rs226066	G	A	7	2	9	0	0	9	0	0
1	44878464	rs12131249	G	A	51	47	98	0	1	99	0	0
1	44878738	rs76638263	G	A	78	69	147	0	0	147	0	0
1	45045989	rs16832091	A	G	2	4	6	0	0	6	0	0
1	45092439	rs57291201	A	G	4	2	6	0	0	6	0	0
1	45093174	rs78826764	T	C	3	3	6	0	0	6	0	0
1	45094551	rs77206682	G	A	4	2	6	0	0	6	0	0
1	45096541	rs78654740	T	C	1	5	6	0	0	6	0	0
1	45096760	rs11588956	C	G	10	5	15	0	0	15	0	0
1	45097317	rs74554154	C	T	4	9	13	0	0	13	0	0
1	45097639	rs115428399	T	C	5	3	8	0	0	8	0	0
1	45098461	rs995089	C	T	9	2	11	0	0	11	0	0
1	45100320	rs4660283	G	C	6	2	8	0	0	8	0	0
1	45100903	rs74793076	C	G	5	4	9	0	0	9	0	0
1	45100927	rs77778246	T	C	3	4	7	0	0	7	0	0
1	45101478	rs2236219	T	C	13	11	24	0	1	25	0	0
1	45104978	rs4660816	A	G	4	5	9	0	0	9	0	0
1	45105899	rs75213740	T	G	5	12	17	0	1	18	0	0
1	45107251	rs74828386	G	C	3	6	9	0	0	9	0	0
1	45107742	rs76328205	C	T	8	6	14	0	0	14	0	0
1	45109055	rs2018706	T	A	8	10	18	0	0	18	0	0
1	45109101	rs2355365	A	G	9	14	23	0	0	23	0	0
1	45109456	rs876512	T	C	5	8	13	0	0	13	0	0
1	45109582	rs876511	T	C	9	5	14	0	0	14	0	0
1	45112892	rs4660284	T	G	5	1	6	0	0	6	0	0
1	45116935	rs1051648	C	T	179	169	348	0	6	354	0	0
1	45116985	rs1051664	C	T	220	206	426	0	2	428	0	0
1	45117300	rs2822	G	A	119	110	229	0	4	233	0	0
1	45187500	rs76782695	C	T	17	10	27	0	0	27	0	0
1	45187511	rs10127448	T	C	10	16	26	0	1	27	0	0
1	45196748	rs76973380	C	T	6	6	12	0	0	12	0	0
1	45196770	rs7536146	A	G	5	5	10	0	1	11	0	0
1	45205529	.	G	A	5	5	10	0	0	10	0	0
1	45233421	rs140246765	C	T	5	3	8	0	0	8	0	0
1	45241113	rs11211031	T	C	5	3	8	0	0	8	0	0
1	45241374	rs3806398	G	A	13	19	32	0	0	32	0	0
1	45268032	rs17883304	A	C	2	8	10	0	0	10	0	0
1	45268382	rs12404160	G	A	5	11	16	0	0	16	0	0
1	45270733	rs4520451	G	T	88	32	120	0	0	120	0	0
1	45274841	rs3923304	T	C	4	2	6	0	0	6	0	0
1	45275339	rs12407290	C	G	6	2	8	0	0	8	0	0
1	45275551	rs11211037	A	C	3	3	6	0	0	6	0	0
1	45277144	rs59803789	C	T	3	5	8	0	0	8	0	0
1	45279716	rs11584031	G	C	4	4	8	0	0	8	0	0
1	45452227	rs489676	G	C	8	9	17	0	0	17	0	0
1	45475881	rs146960255	T	C	21	22	43	0	0	43	0	0
1	45810230	rs78798665	T	A	20	17	37	0	0	37	0	0
1	46081330	.	C	T	3	3	6	0	0	6	0	0
1	46655645	rs74374973	C	T	16	23	39	0	1	40	0	0
1	46806242	rs67545510	G	T	16	8	24	0	0	24	0	0
1	46806393	rs41293273	T	C	4	3	7	0	0	7	0	0
1	46806429	rs41293275	A	T	7	3	10	0	0	10	0	0
1	46806480	rs17361749	C	T	6	9	15	0	0	15	0	0
1	46806550	rs41293277	C	T	31	18	49	0	1	50	0	0
1	46806703	rs10489769	A	G	6	5	11	0	0	11	0	0
1	46807117	rs72885163	C	A	8	18	26	0	0	26	0	0
1	46807416	rs68083747	T	G	9	14	23	0	0	23	0	0
1	46807445	rs66972124	A	G	9	12	21	0	0	21	0	0
1	46807697	rs17357621	C	T	7	14	21	0	0	21	0	0
1	46808224	rs56909107	A	C	10	21	31	0	1	32	0	0
1	46808426	rs41293285	C	T	15	16	31	0	2	33	0	0
1	46808462	rs17357628	A	G	11	13	24	0	1	25	0	0
1	46808668	rs17357635	G	A	9	24	33	0	0	33	0	0
1	46808695	rs68191463	T	C	10	21	31	0	0	31	0	0
1	46808852	rs41293287	C	T	16	8	24	0	0	24	0	0
1	46808860	rs56126529	C	T	15	9	24	0	0	24	0	0
1	46809025	rs7525309	G	T	17	18	35	0	0	35	0	0
1	46809321	rs7548675	C	G	16	22	38	0	0	38	0	0
1	46809419	rs7515284	A	G	16	20	36	0	1	37	0	0
1	46809782	rs41294456	T	C	12	19	31	0	0	31	0	0
1	46810530	rs3737744	A	G	44	31	75	0	0	75	0	0
1	46810670	rs17361763	T	C	49	46	95	0	2	97	0	0
1	46827485	.	C	T	64	61	125	0	1	126	0	0
1	46827728	rs1053627	A	C	53	35	88	0	0	88	0	0
1	46827769	rs1053628	C	T	35	23	58	0	0	58	0	0
1	46827871	rs6429599	G	A	6	10	16	0	0	16	0	0
1	46828109	rs17361819	A	G	12	11	23	0	0	23	0	0
1	46828460	rs67142569	C	T	11	14	25	0	0	25	0	0
1	46828700	rs17361833	A	G	5	14	19	0	1	20	0	0
1	46828734	rs41534051	T	C	9	11	20	0	3	23	0	0
1	46829013	rs17357711	A	G	9	8	17	0	0	17	0	0
1	46830257	rs6683192	C	T	16	16	32	0	0	32	0	0
1	46830430	rs10252	G	A	15	11	26	0	0	26	0	0
1	46830447	rs12062	A	C	18	10	28	0	0	28	0	0
1	46875067	rs11576941	G	T	8	5	13	0	0	13	0	0
1	46877180	rs6662982	G	A	2	8	10	0	0	10	0	0
1	47023531	rs8602	C	A	33	31	64	0	3	67	0	0
1	47051881	rs114159561	G	A	7	2	9	0	0	9	0	0
1	47056227	rs764803	T	C	1	5	6	0	0	6	0	0
1	47058863	rs12093643	C	T	6	4	10	0	0	10	0	0
1	47059431	rs59446321	G	T	4	13	17	0	0	17	0	0
1	47078637	rs4660947	T	C	0	12	12	0	0	12	0	0
1	47100159	rs1139758	C	T	2	5	7	0	0	7	0	0
1	47118168	rs2289447	C	T	5	2	7	0	0	7	0	0
1	47118189	rs620431	G	T	9	2	11	0	1	12	0	0
1	47128715	rs7541868	T	C	3	8	11	0	0	11	0	0
1	47142538	rs1048380	G	A	12	9	21	0	0	21	0	0
1	47143480	rs1048351	C	T	8	14	22	0	1	23	0	0
1	47143547	rs13417	A	G	5	9	14	0	0	14	0	0
1	47182483	rs3737729	T	C	12	12	24	0	2	26	0	0
1	47184181	rs3766212	C	T	13	11	24	0	0	24	0	0
1	47184196	rs3766211	A	G	13	13	26	0	0	26	0	0
1	47184569	rs8851	G	C	9	4	13	0	0	13	0	0
1	47645846	rs2245116	G	T	4	5	9	0	0	9	0	0
1	47682017	rs7664	T	G	29	24	53	0	2	55	0	0
1	47683464	rs2070930	G	A	30	48	78	0	0	78	0	0
1	47683607	rs2070929	G	C	37	39	76	0	0	76	0	0
1	47684677	rs977747	T	G	51	52	103	0	3	106	0	0
1	47689842	rs34087210	C	G	3	3	6	0	0	6	0	0
1	47690438	rs2984618	G	T	5	1	6	0	0	6	0	0
1	47691802	.	T	G	8	4	12	0	0	12	0	0
1	47694167	rs11211481	A	G	23	64	87	0	0	87	0	0
1	47696581	rs12141363	C	A	8	15	23	0	0	23	0	0
1	47717189	rs2758735	A	G	26	31	57	0	0	57	0	0
1	47746678	rs10789505	G	C	15	18	33	0	0	33	0	0
1	47766647	rs12141060	C	T	26	21	47	0	0	47	0	0
1	47766943	rs6697248	T	C	9	9	18	0	0	18	0	0
1	47767141	rs6689687	C	A	12	19	31	0	0	31	0	0
1	47767914	rs3125630	G	A	25	21	46	0	1	47	0	0
1	47799639	rs7543016	G	C	32	34	66	0	2	68	0	0
1	47841472	rs11584518	G	C	2	4	6	0	0	6	0	0
1	47842777	rs1044457	C	T	250	248	498	0	3	501	0	0
1	47844464	rs6795	G	A	21	11	32	0	1	33	0	0
1	51716810	.	C	T	2	6	8	0	0	8	0	0
1	51868160	rs34957183	C	G	23	33	56	0	0	56	0	0
1	51927773	rs77180346	C	T	2	8	10	0	0	10	0	0
1	52188736	rs72898073	G	C	3	5	8	0	0	8	0	0
1	52189907	rs72898075	T	C	4	6	10	0	0	10	0	0
1	52190151	rs75125988	T	A	4	2	6	0	0	6	0	0
1	52190420	rs74080617	T	A	5	2	7	0	0	7	0	0
1	52217389	rs76910833	C	T	4	3	7	0	0	7	0	0
1	52221714	rs10489546	T	C	5	2	7	0	0	7	0	0
1	52231560	rs61739207	C	T	104	90	194	0	0	194	0	0
1	52241170	rs12067547	G	A	6	2	8	0	0	8	0	0
1	52248507	rs59703705	C	T	2	4	6	0	0	6	0	0
1	52251171	rs72900037	C	T	7	8	15	0	0	15	0	0
1	52251186	rs72900038	C	T	8	9	17	0	0	17	0	0
1	52253761	rs74080632	A	C	152	113	265	0	2	267	0	0
1	52253793	rs12097772	C	T	139	100	239	0	1	240	0	0
1	52253864	rs1045785	G	A	100	77	177	0	1	178	0	0
1	52263082	rs1417364	G	A	11	7	18	0	0	18	0	0
1	52264064	rs1770791	A	G	235	239	474	0	5	479	0	0
1	52264597	rs61783361	A	G	5	14	19	0	0	19	0	0
1	52264893	rs12047927	A	G	3	4	7	0	0	7	0	0
1	52266242	rs8375	G	A	232	223	455	0	3	458	0	0
1	52266350	rs2273198	C	T	232	170	402	0	2	404	0	0
1	52270616	rs12041578	G	A	2	5	7	0	0	7	0	0
1	52270752	rs12041630	G	A	5	3	8	0	0	8	0	0
1	52290984	rs11205896	T	G	122	141	263	0	3	266	0	0
1	52306027	rs114314660	G	A	110	116	226	0	1	227	0	0
1	52498370	rs2809917	C	T	86	80	166	0	1	167	0	0
1	52501504	rs76241915	A	C	1	5	6	0	0	6	0	0
1	52554919	rs74403700	T	C	22	13	35	0	3	38	0	0
1	52880214	rs143104267	G	A	2	4	6	0	0	6	0	0
1	53237872	rs6588442	G	A	11	0	11	0	2	13	0	0
1	53238187	.	A	T	18	0	18	0	2	20	0	0
1	53387356	rs138761671	G	A	5	3	8	0	0	8	0	0
1	53392989	rs115810571	A	T	4	2	6	0	0	6	0	0
1	53442376	rs41294530	A	G	15	28	43	0	0	43	0	0
1	53476182	rs113493366	G	A	0	7	7	0	0	7	0	0
1	53514728	rs3766763	A	G	4	2	6	0	0	6	0	0
1	53516742	rs13496	G	A	192	176	368	0	0	368	0	0
1	53516999	rs8871	A	C	29	40	69	0	2	71	0	0
1	53679878	rs1056438	T	C	26	16	42	0	0	42	0	0
1	53680090	rs1056425	G	A	53	33	86	0	0	86	0	0
1	53693627	rs12082305	T	G	5	6	11	0	1	12	0	0
1	53694388	rs2275087	T	C	4	7	11	0	0	11	0	0
1	53696051	rs10788949	C	T	5	4	9	0	0	9	0	0
1	53699129	rs17192655	G	C	1	6	7	0	0	7	0	0
1	53701581	rs2297656	A	G	4	2	6	0	0	6	0	0
1	53711735	rs5177	G	C	6	1	7	0	0	7	0	0
1	53712727	rs5174	C	T	20	15	35	0	1	36	0	0
1	53792651	rs3820198	A	C	11	8	19	0	0	19	0	0
1	54317697	rs1127922	T	C	46	37	83	0	0	83	0	0
1	54354658	rs2294508	T	G	25	16	41	0	0	41	0	0
1	54354935	rs3817871	G	C	20	19	39	0	0	39	0	0
1	54355041	rs10888814	A	G	14	17	31	0	0	31	0	0
1	54355105	rs10749693	A	G	11	12	23	0	0	23	0	0
1	54382648	rs7537364	T	C	6	0	6	0	0	6	0	0
1	54382686	rs7534991	A	G	8	0	8	0	0	8	0	0
1	54382732	rs79319225	G	A	10	0	10	0	0	10	0	0
1	54382742	rs76800100	G	A	10	0	10	0	0	10	0	0
1	54387577	rs12090789	T	C	4	3	7	0	0	7	0	0
1	54387857	rs10888822	T	C	3	3	6	0	0	6	0	0
1	54411319	rs186140661	C	T	15	34	49	0	0	49	0	0
1	54412181	rs1063162	T	C	20	22	42	0	0	42	0	0
1	54492493	rs56186476	C	T	15	16	31	0	1	32	0	0
1	54493060	rs11800869	C	T	17	18	35	0	0	35	0	0
1	54493420	rs6699257	A	G	10	17	27	0	0	27	0	0
1	54498149	rs11206275	C	T	7	1	8	0	0	8	0	0
1	54500487	rs7539402	G	A	6	0	6	0	0	6	0	0
1	54503729	rs12095340	T	A	11	10	21	0	0	21	0	0
1	54505437	rs3766466	C	A	10	3	13	0	0	13	0	0
1	54509594	rs74417302	T	C	4	2	6	0	0	6	0	0
1	54513123	.	A	G	9	7	16	0	0	16	0	0
1	54513323	rs12065783	A	G	2	6	8	0	0	8	0	0
1	54513324	rs187993583	A	G	2	6	8	0	0	8	0	0
1	54513827	rs914722	T	A	5	2	7	0	0	7	0	0
1	54513879	rs187731670	C	A	4	5	9	0	1	10	0	0
1	54519107	rs2236512	G	A	4	2	6	0	0	6	0	0
1	54534466	rs150639315	C	A	4	4	8	0	0	8	0	0
1	54670784	.	T	C	240	241	481	0	7	488	0	0
1	54681920	rs13571	G	C	328	341	669	0	5	674	0	0
1	54683856	rs15921	C	G	275	245	520	0	0	521	1	0
1	54690954	rs3088379	T	C	34	37	71	0	2	73	0	0
1	54691465	rs9012	C	T	53	46	99	0	0	99	0	0
1	54703630	rs113556489	C	T	2	5	7	0	0	7	0	0
1	54704510	rs2274662	A	C	7	2	9	0	2	11	0	0
1	55074840	rs1617287	T	A	9	7	16	0	1	18	1	0
1	55074922	rs2289016	G	A	4	8	12	0	2	14	0	0
1	55075452	rs1368883	G	A	6	4	10	0	1	11	0	0
1	55119144	rs11206407	A	G	2	7	9	0	0	9	0	0
1	55119289	rs9332417	G	C	10	6	16	0	0	16	0	0
1	55119515	rs1655519	T	G	9	10	19	0	0	19	0	0
1	55136529	rs480963	T	C	8	2	10	0	0	10	0	0
1	55139618	rs571199	G	A	5	2	7	0	0	7	0	0
1	55172642	rs12040738	G	T	5	1	6	0	0	6	0	0
1	55182300	rs1147990	T	A	9	7	16	0	0	16	0	0
1	55207754	rs13046	C	G	23	13	36	0	1	37	0	0
1	55315611	rs7373	C	G	18	24	42	0	0	42	0	0
1	55316322	rs7374	A	G	15	19	34	0	2	36	0	0
1	55317685	rs1138030	G	A	12	18	30	0	0	30	0	0
1	55319902	rs718265	A	G	12	12	24	0	0	24	0	0
1	55625328	rs150880897	T	C	16	10	26	0	0	26	0	0
1	56961486	rs8016	T	C	18	15	33	0	0	33	0	0
1	56961756	rs4628	A	G	18	13	31	0	0	31	0	0
1	57395020	rs2795	A	G	6	5	11	0	0	11	0	0
1	59041220	rs7333	C	T	5	1	6	0	0	6	0	0
1	62148927	rs11207809	G	A	2	4	6	0	0	6	0	0
1	62261168	rs7516332	A	G	4	7	11	0	0	11	0	0
1	62380270	rs1134766	C	T	10	5	15	0	1	16	0	0
1	62380298	rs1056513	G	A	13	5	18	0	0	18	0	0
1	64095111	rs855314	A	G	17	25	42	0	0	42	0	0
1	64114301	rs11208257	T	C	41	53	94	0	1	95	0	0
1	64125368	rs8294	C	T	55	52	107	0	0	107	0	0
1	64125439	rs4643	A	C	46	50	96	0	1	97	0	0
1	65292754	rs11587486	G	A	6	4	10	0	0	10	0	0
1	65297240	rs1048007	A	G	24	25	49	0	1	50	0	0
1	65297983	rs1556561	A	T	24	12	36	0	1	37	0	0
1	65298791	rs2780889	A	T	28	26	54	0	0	54	0	0
1	65302413	rs2780816	C	A	5	2	7	0	0	7	0	0
1	65302439	rs72675438	T	C	2	5	7	0	0	7	0	0
1	65302788	rs2780891	T	C	2	6	8	0	0	8	0	0
1	65303338	rs310241	A	G	4	5	9	0	0	9	0	0
1	65310489	rs2230588	T	C	99	103	202	0	0	202	0	0
1	65311214	rs3737139	G	C	81	67	148	0	0	148	0	0
1	65313945	rs2780898	A	G	6	6	12	0	0	12	0	0
1	65321250	rs2230586	G	A	55	64	119	0	0	119	0	0
1	65335095	rs11585932	T	C	52	58	110	0	1	111	0	0
1	65340837	rs76286105	T	C	11	13	24	0	0	24	0	0
1	65343066	rs11208534	A	G	1	9	10	0	0	10	0	0
1	65343562	rs72675457	C	T	7	4	11	0	0	11	0	0
1	65614034	rs57193680	T	C	6	1	7	0	0	7	0	0
1	65690461	rs4915685	G	A	71	3	74	0	0	74	0	0
1	65694080	rs13483	C	T	8	1	9	0	1	10	0	0
1	65694819	rs1062445	G	A	6	4	10	0	0	10	0	0
1	65695853	rs1855982	A	G	15	9	24	0	1	25	0	0
1	65695930	rs1336472	G	A	19	4	23	0	0	23	0	0
1	65696034	rs1855981	G	C	12	2	14	0	0	14	0	0
1	65886398	rs3790435	T	C	120	109	229	0	2	231	0	0
1	65891901	rs9436740	A	T	4	3	7	0	0	7	0	0
1	66840170	rs138911836	T	G	66	37	103	0	0	103	0	0
1	67225846	rs75585417	C	T	5	1	6	0	0	6	0	0
1	67226031	rs472181	A	G	2	7	9	0	0	9	0	0
1	67239576	rs7548496	C	G	24	21	45	0	0	45	0	0
1	67239891	rs1874802	C	T	5	6	11	0	0	11	0	0
1	67242571	rs471093	G	A	4	2	6	0	0	6	0	0
1	67244243	rs7524784	A	T	53	62	115	0	1	116	0	0
1	67452723	.	C	A	236	0	236	0	5	241	0	0
1	67467173	rs76609130	C	G	26	35	61	0	1	62	0	0
1	67875106	rs3171013	C	A	56	56	112	0	1	113	0	0
1	67875414	rs4655707	T	C	47	42	89	0	0	89	0	0
1	67875533	rs4655708	T	A	39	48	87	0	0	87	0	0
1	67878866	.	C	T	487	506	993	0	33	1027	1	0
1	67887563	rs12561767	G	A	7	5	12	0	0	12	0	0
1	67888931	rs112588573	G	A	7	8	15	0	0	15	0	0
1	67890526	rs6702742	A	G	13	12	25	0	0	25	0	0
1	68151685	rs3783466	C	T	16	20	36	0	0	36	0	0
1	68152363	rs3783468	G	A	39	17	56	0	0	56	0	0
1	68152388	rs681673	T	C	38	18	56	0	0	56	0	0
1	68152438	rs532446	C	T	54	15	69	0	1	70	0	0
1	68153206	rs3171012	T	C	42	42	84	0	0	84	0	0
1	70611208	rs676753	A	T	10	6	16	0	1	17	0	0
1	70623530	rs56200611	T	C	4	2	6	0	0	6	0	0
1	70627355	rs17131238	C	T	3	4	7	0	0	7	0	0
1	70690540	rs56299138	C	T	29	19	48	0	0	48	0	0
1	70714013	rs76757906	A	G	5	7	12	0	0	12	0	0
1	70820008	rs61782675	C	T	28	31	59	0	0	59	0	0
1	70904800	rs1021737	G	T	11	14	25	0	0	25	0	0
1	71416541	rs480867	C	T	21	18	39	0	1	40	0	0
1	71416722	rs1071020	G	A	23	11	34	0	0	34	0	0
1	71426743	rs926457	G	T	4	6	10	0	0	10	0	0
1	71430966	rs596829	G	C	3	3	6	0	0	6	0	0
1	71533463	.	A	G	3	3	6	0	1	7	0	0
1	71536228	rs79764325	A	G	8	5	13	0	0	13	0	0
1	71536574	rs11583800	G	C	96	107	203	0	2	205	0	0
1	72747844	rs3101341	C	T	5	1	6	0	0	6	0	0
1	72748084	rs142674139	G	C	19	6	25	0	1	26	0	0
1	76252011	rs1146634	G	A	13	9	22	0	0	22	0	0
1	76252335	rs1146635	A	G	18	11	29	0	0	29	0	0
1	76252687	rs1146636	T	C	2	8	10	0	0	10	0	0
1	76254726	rs1498311	G	T	38	50	88	0	1	89	0	0
1	76255613	rs11588643	A	G	55	69	124	0	1	125	0	0
1	76256618	rs1146637	A	G	8	5	13	0	1	14	0	0
1	76257892	rs12703	A	T	263	264	527	0	4	531	0	0
1	76258518	rs1146639	T	C	50	43	93	0	1	94	0	0
1	78029102	rs962388	G	A	10	6	16	0	0	16	0	0
1	78029365	rs728741	A	G	5	5	10	0	0	10	0	0
1	78029905	rs1962523	T	A	3	4	7	0	0	7	0	0
1	78094779	rs1389789	C	T	8	2	10	0	0	10	0	0
1	78094823	rs6674638	A	T	11	4	15	0	0	15	0	0
1	78178976	rs6603958	T	A	6	6	12	0	0	12	0	0
1	78179213	rs9662527	G	A	8	6	14	0	0	14	0	0
1	78184325	rs12142671	A	G	41	37	78	0	1	79	0	0
1	78184433	rs1963170	G	A	3	3	6	0	0	6	0	0
1	78201745	rs2296227	G	T	26	25	51	0	0	51	0	0
1	78225485	rs139942784	G	A	13	9	22	0	0	22	0	0
1	78280825	.	C	T	18	15	33	0	0	33	0	0
1	78341979	rs72685332	C	T	5	5	10	0	1	11	0	0
1	78417946	rs181845216	T	A	7	1	8	0	0	8	0	0
1	78418903	rs11806130	A	G	5	3	8	0	0	8	0	0
1	78419082	rs60234511	C	A	5	2	7	0	0	7	0	0
1	78419569	rs11162401	A	G	3	3	6	0	0	6	0	0
1	78483422	rs6424653	T	A	10	15	25	0	1	26	0	0
1	81969071	rs4650561	A	T	8	0	8	0	0	8	0	0
1	81969284	rs1108500	G	T	25	0	25	0	0	25	0	0
1	81969478	rs113344436	A	T	14	0	14	0	0	14	0	0
1	84672875	.	A	G	4	3	7	0	0	7	0	0
1	84701251	rs600674	T	C	14	13	27	0	0	27	0	0
1	84955233	rs11163983	C	T	3	4	7	0	0	7	0	0
1	84957826	rs312403	A	G	4	6	10	0	0	10	0	0
1	84958166	rs7541850	C	T	4	6	10	0	0	10	0	0
1	84958185	rs11163984	C	A	4	4	8	0	0	8	0	0
1	84959734	rs7524576	G	A	7	5	12	0	0	12	0	0
1	84960864	rs115310357	A	G	2	6	8	0	0	8	0	0
1	84965424	rs7555773	G	A	5	8	13	0	0	13	0	0
1	84965724	rs78289722	G	A	9	6	15	0	0	15	0	0
1	84966764	rs17365681	T	C	13	8	21	0	0	21	0	0
1	84967221	rs115781592	C	G	10	13	23	0	0	23	0	0
1	84969019	rs17365723	T	C	9	8	17	0	0	17	0	0
1	84969565	rs41302796	G	C	5	11	16	0	0	16	0	0
1	84971833	rs11163985	G	C	135	165	300	0	6	306	0	0
1	84971926	rs41284589	G	A	72	57	129	0	1	130	0	0
1	84971969	rs13093	G	T	56	68	124	0	1	125	0	0
1	84972059	rs6701280	C	G	17	12	29	0	0	29	0	0
1	84972089	rs12092954	C	G	23	13	36	0	0	36	0	0
1	84972465	rs41284591	C	A	5	8	13	0	1	14	0	0
1	85029077	rs15911	C	T	57	52	109	0	0	109	0	0
1	85029963	rs76372694	A	C	9	20	29	0	0	29	0	0
1	85031630	rs2994953	G	A	41	42	83	0	0	83	0	0
1	85039955	rs2303307	G	A	13	18	31	0	1	32	0	0
1	85040069	rs2911592	G	A	1	5	6	0	0	6	0	0
1	85040070	rs115347546	C	A	1	5	6	0	0	6	0	0
1	85113203	rs2994949	T	C	49	31	80	0	0	80	0	0
1	85716979	rs35798604	C	A	5	3	8	0	0	8	0	0
1	85719610	rs4074156	T	C	5	10	15	0	0	15	0	0
1	85720088	rs1077996	T	C	10	7	17	0	0	17	0	0
1	85720095	rs12746169	G	A	5	8	13	0	0	13	0	0
1	85721016	rs55808228	C	G	13	24	37	0	0	37	0	0
1	85721981	rs72722649	C	G	20	11	31	0	1	32	0	0
1	85723733	rs12143140	T	C	12	10	22	0	0	22	0	0
1	85723809	rs12561876	A	T	11	5	16	0	0	16	0	0
1	85729987	rs2647394	A	G	4	9	13	0	0	13	0	0
1	85741684	rs4949928	T	C	94	63	157	0	7	164	0	0
1	85741734	rs12068788	A	T	64	89	153	0	3	156	0	0
1	85741968	rs12562182	G	C	16	33	49	0	3	52	0	0
1	85742012	rs11576939	G	C	102	97	199	0	0	199	0	0
1	85742157	rs1060843	G	C	67	57	124	0	3	127	0	0
1	86119296	rs821399	C	A	43	31	74	0	0	74	0	0
1	86121895	rs3767163	T	G	0	6	6	0	0	6	0	0
1	86172032	rs41289759	G	A	19	11	30	0	0	30	0	0
1	86194997	rs1047895	C	T	13	12	25	0	0	25	0	0
1	86195047	rs1047893	T	C	12	16	28	0	0	28	0	0
1	86195066	rs1047892	A	C	15	12	27	0	0	27	0	0
1	86457867	rs28480217	G	A	15	1	16	0	0	16	0	0
1	86457896	rs7415711	G	C	14	2	16	0	0	16	0	0
1	86457904	rs7411585	C	T	13	2	15	0	0	15	0	0
1	86458623	rs2390007	G	A	7	1	8	0	0	8	0	0
1	86458632	rs2390008	T	C	6	0	6	0	0	6	0	0
1	86557967	rs11161732	G	A	5	2	7	0	0	7	0	0
1	87633929	rs17129860	A	G	32	36	68	0	0	68	0	0
1	87634149	rs1325236	C	T	29	37	66	0	0	66	0	0
1	89569973	rs7513609	G	C	9	9	18	0	1	19	0	0
1	89572014	rs4655899	C	T	4	4	8	0	0	8	0	0
1	89572015	rs4655900	A	G	4	4	8	0	0	8	0	0
1	89572057	rs4655901	A	T	4	7	11	0	0	11	0	0
1	89579941	rs2230338	T	C	40	14	54	0	2	56	0	0
1	89582690	rs1803632	G	C	32	14	46	0	0	46	0	0
1	89588380	rs10922573	A	G	2	4	6	0	0	6	0	0
1	89589556	rs10922575	T	C	4	5	9	0	0	9	0	0
1	89592459	rs7530803	C	T	3	5	8	0	0	8	0	0
1	89592522	rs10754262	C	T	3	4	7	0	0	7	0	0
1	89592863	rs2183160	T	C	0	8	8	0	0	8	0	0
1	89652087	rs1142890	C	T	6	0	6	0	0	6	0	0
1	89652088	rs1142889	C	G	6	0	6	0	0	6	0	0
1	89652094	rs1142887	G	A	5	1	6	0	0	6	0	0
1	89652097	rs1142886	C	T	5	1	6	0	0	6	0	0
1	89652102	rs655260	A	T	5	1	6	0	0	6	0	0
1	89732237	rs61729628	G	A	3	9	12	0	1	13	0	0
1	89738232	rs2147309	G	C	4	3	7	0	0	7	0	0
1	90059494	.	A	G	24	30	54	0	0	54	0	0
1	90499819	rs1831298	C	G	8	10	18	0	0	18	0	0
1	91479016	.	A	T	7	1	8	0	0	8	0	0
1	92148227	rs902	C	G	4	5	9	0	0	9	0	0
1	92177938	rs1805113	A	G	4	7	11	0	0	11	0	0
1	92940411	rs41313373	C	T	41	29	70	0	2	72	0	0
1	92940850	rs1325432	G	T	83	59	142	0	0	142	0	0
1	92978652	.	C	T	3	3	6	0	0	6	0	0
1	94983203	rs698951	C	T	9	4	13	0	1	14	0	0
1	94995411	rs841691	C	A	6	4	10	0	1	11	0	0
1	94995819	rs3354	C	T	7	4	11	0	0	11	0	0
1	97145014	rs3748786	T	C	159	0	159	0	13	172	0	0
1	97250520	rs273873	G	T	2	4	6	0	0	6	0	0
1	97265741	rs54790	T	C	4	6	10	0	0	10	0	0
1	97266007	rs35137759	A	G	6	2	8	0	0	8	0	0
1	97278804	rs273886	G	A	4	3	7	0	0	7	0	0
1	97279692	rs273885	C	T	147	144	291	0	0	291	0	0
1	97287825	rs35696197	G	T	5	6	11	0	0	11	0	0
1	100358103	rs3753494	C	T	6	3	9	0	0	9	0	0
1	100543354	.	C	T	56	36	92	0	0	92	0	0
1	100751558	rs76540281	C	T	4	2	6	0	0	6	0	0
1	100818286	rs527644	A	T	4	2	6	0	0	6	0	0
1	100887616	rs479269	A	G	7	6	13	0	0	13	0	0
1	100965942	rs12042531	G	A	4	2	6	0	0	6	0	0
1	101360684	rs3806163	G	C	14	10	24	0	0	24	0	0
1	101701923	rs59317557	C	G	3	3	6	0	0	6	0	0
1	101706246	rs114115083	T	C	41	77	118	0	0	118	0	0
1	104076462	rs6697444	C	T	12	12	24	0	1	25	0	0
1	104096692	rs11184430	T	C	7	5	12	0	0	12	0	0
1	104097685	rs10754	C	T	26	23	49	0	1	50	0	0
1	104117921	rs140978983	G	A	15	10	25	0	1	26	0	0
1	108117879	rs12094574	A	G	3	3	6	0	0	6	0	0
1	108121323	rs1410404	C	A	6	9	15	0	0	15	0	0
1	108185301	rs12403266	C	G	44	38	82	0	0	82	0	0
1	108677973	rs12065664	A	C	10	5	15	0	0	15	0	0
1	108678732	rs1062986	T	C	38	29	67	0	0	67	0	0
1	108728484	rs862493	T	C	41	28	69	0	4	73	0	0
1	108739104	rs533233	A	G	1	6	7	0	0	7	0	0
1	108740419	rs828994	C	T	2	4	6	0	0	6	0	0
1	108741065	rs594397	T	C	0	6	6	0	0	6	0	0
1	108743140	rs577690	C	G	2	4	6	0	0	6	0	0
1	109472773	rs1051868	G	A	15	19	34	0	0	34	0	0
1	109472813	rs12030	T	C	14	15	29	0	0	29	0	0
1	109759776	rs685653	A	G	4	3	7	0	0	7	0	0
1	109856306	rs464218	G	A	24	17	41	0	0	41	0	0
1	109968410	rs3820667	A	C	17	7	24	0	0	24	0	0
1	110128498	rs7546585	T	A	15	13	28	0	0	28	0	0
1	110136458	rs2301230	A	G	55	76	131	0	0	131	0	0
1	110163076	rs6669802	A	G	11	19	30	0	0	30	0	0
1	110167583	rs115321867	G	A	21	28	49	0	2	51	0	0
1	110277403	rs3814309	T	C	3	3	6	0	0	6	0	0
1	110278182	.	T	C	4	2	6	0	0	6	0	0
1	110279602	rs2234696	T	G	8	12	20	0	1	21	0	0
1	110279701	rs7483	C	T	47	52	99	0	0	99	0	0
1	110455305	rs333952	G	A	13	19	32	0	0	32	0	0
1	110455433	rs915357	A	G	6	12	18	0	0	18	0	0
1	110459773	rs333967	C	T	12	11	23	0	0	23	0	0
1	110461564	.	G	A	4	2	6	0	0	6	0	0
1	110465541	rs115658570	C	T	10	4	14	0	1	15	0	0
1	110469411	rs333974	A	G	13	7	20	0	0	20	0	0
1	110470184	rs3093041	C	T	20	17	37	0	3	40	0	0
1	110470424	rs3093040	G	A	30	18	48	0	1	49	0	0
1	110470592	rs333948	G	A	23	17	40	0	1	41	0	0
1	110581780	rs1834	T	G	3	3	6	0	0	6	0	0
1	110584257	rs41281344	C	T	14	25	39	0	0	39	0	0
1	110590816	rs12042401	C	T	5	7	12	0	0	12	0	0
1	110591705	.	G	A	6	2	8	0	0	8	0	0
1	110857953	rs615640	G	A	4	2	6	0	0	6	0	0
1	110861488	.	C	T	4	2	6	0	0	6	0	0
1	110880278	rs113123546	A	G	9	3	12	0	0	12	0	0
1	110882444	rs814771	A	G	22	16	38	0	1	39	0	0
1	110884493	rs61745292	T	C	82	97	179	0	1	180	0	0
1	110885736	rs1572263	G	A	21	10	31	0	1	32	0	0
1	110886773	rs4839343	G	C	34	27	61	0	1	62	0	0
1	110887075	rs3768460	G	A	17	15	32	0	1	33	0	0
1	110888948	rs61787373	G	A	186	143	329	0	1	330	0	0
1	110908706	rs113381099	G	A	6	3	9	0	0	9	0	0
1	110914285	rs6677797	G	C	5	3	8	0	0	8	0	0
1	110949720	rs6671673	C	T	253	191	444	0	2	446	0	0
1	110949857	rs6684395	A	T	99	105	204	0	0	204	0	0
1	111659997	rs325914	A	C	17	10	27	0	0	27	0	0
1	111682307	rs1043096	G	C	33	42	75	0	1	76	0	0
1	111993234	rs151060134	G	A	4	4	8	0	0	8	0	0
1	112019788	rs74109580	A	G	24	21	45	0	0	45	0	0
1	112247446	rs1811842	A	G	4	3	7	0	1	8	0	0
1	112251983	rs3738300	C	G	3	4	7	0	0	7	0	0
1	112253766	rs512251	T	A	6	5	11	0	0	11	0	0
1	112254512	rs3767593	C	T	4	3	7	0	0	7	0	0
1	112254610	rs1324890	T	C	4	5	9	0	0	9	0	0
1	112266366	rs197427	T	C	3	3	6	0	0	6	0	0
1	112267354	rs11800513	C	T	6	1	7	0	0	7	0	0
1	112268284	rs11102327	G	A	4	2	6	0	1	7	0	0
1	112268666	rs197433	T	C	4	2	6	0	0	6	0	0
1	112269872	rs197434	G	A	5	3	8	0	1	9	0	0
1	113162037	rs3790597	C	A	5	5	10	0	1	11	0	0
1	113455099	rs7169	G	A	15	32	47	0	0	47	0	0
1	113456546	rs1049434	A	T	33	38	71	0	2	73	0	0
1	114447403	.	C	A	28	32	60	0	1	62	1	0
1	114936079	rs41313288	T	A	11	3	14	0	0	14	0	0
1	114938175	rs1125002	C	T	6	2	8	0	0	8	0	0
1	114973429	rs12083584	T	C	12	14	26	0	0	26	0	0
1	115257791	rs9724622	G	A	5	2	7	0	0	7	0	0
1	115259599	rs8453	G	T	268	346	614	0	4	618	0	0
1	115259768	rs1065634	T	C	758	563	1321	0	15	1336	0	0
1	115260643	rs6851	C	T	639	571	1210	0	9	1219	0	0
1	115269211	rs2144428	G	A	4	5	9	0	0	9	0	0
1	115284717	rs142791733	A	G	3	5	8	0	0	8	0	0
1	115299486	rs78782041	A	G	8	3	11	0	0	11	0	0
1	115316158	rs3827739	T	C	10	5	15	0	0	15	0	0
1	115591058	rs1052480	T	C	22	16	38	0	0	38	0	0
1	115592398	rs67978763	A	C	16	37	53	0	1	54	0	0
1	115592820	rs3738706	T	C	53	39	92	0	1	93	0	0
1	115601528	rs3738702	C	G	114	113	227	0	0	227	0	0
1	115604798	rs10776795	C	T	73	88	161	0	0	161	0	0
1	115617406	rs1286364	A	G	8	15	23	0	0	23	0	0
1	115645113	rs57143685	T	C	2	5	7	0	0	7	0	0
1	115879892	.	T	G	15	0	15	0	6	21	0	0
1	115879896	.	T	G	17	0	17	0	4	21	0	0
1	116234313	rs3811012	A	G	20	22	42	0	4	46	0	0
1	116234505	rs6700610	A	G	15	26	41	0	0	41	0	0
1	116236351	rs12121158	T	G	2	5	7	0	0	7	0	0
1	116534852	rs4046190	C	T	5	1	6	0	1	7	0	0
1	116610227	rs1281744	G	A	5	1	6	0	0	6	0	0
1	116920952	rs850602	G	C	3	6	9	0	0	9	0	0
1	116932563	rs850609	T	A	5	6	11	0	0	11	0	0
1	116945847	.	G	A	5	2	7	0	0	7	0	0
1	117311147	rs699738	C	A	13	13	26	0	0	26	0	0
1	117617705	rs998532	A	G	100	84	184	0	1	185	0	0
1	117618067	rs1289673	C	T	94	70	164	0	6	170	0	0
1	117641668	rs2801935	G	A	1	6	7	0	0	7	0	0
1	117654354	rs1289662	G	A	2	5	7	0	0	7	0	0
1	117654422	rs1289661	T	C	2	5	7	0	0	7	0	0
1	117654443	rs1289660	A	G	3	5	8	0	0	8	0	0
1	117654858	rs1048635	G	A	8	7	15	0	1	16	0	0
1	117656088	rs1289658	A	G	7	6	13	0	0	13	0	0
1	117910682	rs1146297	G	A	15	17	32	0	0	32	0	0
1	117913019	rs1289951	A	G	3	4	7	0	0	7	0	0
1	118068558	rs2767318	G	A	10	7	17	0	0	17	0	0
1	118482149	rs34973445	C	T	10	9	19	0	0	19	0	0
1	119574074	rs8928	G	C	9	7	16	0	0	16	0	0
1	119574289	rs12030972	G	A	4	4	8	0	0	8	0	0
1	119574537	rs12026409	G	A	6	5	11	0	0	11	0	0
1	119574587	rs2645294	C	T	4	2	6	0	0	6	0	0
1	120162442	rs1045827	T	C	4	6	10	0	1	11	0	0
1	120162787	rs2281493	T	C	7	16	23	0	0	23	0	0
1	120163247	rs10737756	T	C	1	11	12	0	0	12	0	0
1	120163248	rs10754415	G	A	1	11	12	0	0	12	0	0
1	120163531	rs10754416	T	C	3	17	20	0	0	20	0	0
1	120163675	rs35922771	G	A	5	8	13	0	0	13	0	0
1	120163831	rs10923879	A	G	5	7	12	0	0	12	0	0
1	120164252	rs10802124	G	A	6	7	13	0	0	13	0	0
1	120164303	rs12081887	C	T	5	5	10	0	0	10	0	0
1	120165040	rs7522088	T	C	2	4	6	0	0	6	0	0
1	120165135	rs3795662	G	T	4	5	9	0	0	9	0	0
1	120166681	rs12067843	G	A	2	9	11	0	0	11	0	0
1	120254545	rs562038	G	C	1	6	7	0	0	7	0	0
1	120285546	rs543703	G	A	20	31	51	0	0	51	0	0
1	120454845	.	A	G	11	11	22	0	0	22	0	0
1	120533192	.	C	T	0	8	8	0	0	8	0	0
1	120533209	.	A	G	1	7	8	0	0	8	0	0
1	120539331	.	C	T	2	16	18	0	0	18	0	0
1	120572547	.	T	C	8	0	8	0	0	8	0	0
1	120572572	.	C	T	9	1	10	0	0	10	0	0
1	120611964	.	G	C	12	1	13	0	0	13	0	0
1	120612006	rs4021006	G	A	14	1	15	0	0	15	0	0
1	120612168	.	C	T	29	4	33	0	0	33	0	0
1	120693433	.	G	A	10	0	10	0	0	10	0	0
1	120693474	.	C	T	14	0	14	0	0	14	0	0
1	120695827	.	A	C	1	16	17	0	0	17	0	0
1	120695831	.	A	C	1	16	17	0	1	18	0	0
1	120695867	.	T	C	18	1	19	0	0	19	0	0
1	120695911	.	T	C	13	1	14	0	1	15	0	0
1	120836371	.	C	T	10	0	10	0	0	10	0	0
1	120838232	.	T	C	14	0	14	0	1	15	0	0
1	120927081	.	C	T	8	6	14	0	0	14	0	0
1	121116688	.	A	G	7	2	9	0	0	9	0	0
1	121123347	.	C	T	4	2	6	0	0	6	0	0
1	121123385	.	G	A	3	3	6	0	0	6	0	0
1	121132994	rs11249358	T	C	7	2	9	0	1	10	0	0
1	121133066	.	A	G	8	6	14	0	0	14	0	0
1	121133376	.	A	T	16	6	22	0	0	22	0	0
1	121133392	.	T	C	16	6	22	0	0	22	0	0
1	121133574	.	T	C	15	4	19	0	0	19	0	0
1	121133733	.	G	A	20	12	32	0	0	32	0	0
1	121133779	.	C	G	17	5	22	0	0	22	0	0
1	121134049	.	T	C	12	0	12	0	0	12	0	0
1	143743625	.	C	A	9	1	10	0	0	10	0	0
1	143744356	.	C	G	12	18	30	0	2	32	0	0
1	143744411	.	G	C	39	5	44	0	1	45	0	0
1	143744508	.	G	T	13	26	39	0	0	39	0	0
1	143744513	.	C	T	10	32	42	0	0	42	0	0
1	143744564	.	T	C	11	3	14	0	0	14	0	0
1	143745242	.	C	T	4	2	6	0	0	6	0	0
1	143984543	.	C	T	12	14	26	0	0	26	0	0
1	143985102	rs715466	T	C	8	12	20	0	0	20	0	0
1	144014051	.	G	A	42	18	60	0	0	60	0	0
1	144014068	.	T	C	15	44	59	0	0	59	0	0
1	144014234	.	A	G	8	2	10	0	0	10	0	0
1	144014253	.	A	T	3	6	9	0	0	9	0	0
1	144014345	.	C	T	6	6	12	0	0	12	0	0
1	144014524	.	T	A	6	0	6	0	0	6	0	0
1	144014526	.	T	A	8	0	8	0	0	8	0	0
1	144014528	.	T	A	7	0	7	0	1	8	0	0
1	144014530	rs76791488	T	A	7	1	8	0	0	8	0	0
1	144014532	rs77705691	T	A	7	1	8	0	0	8	0	0
1	144014737	.	G	A	6	4	10	0	0	10	0	0
1	144015041	.	G	T	10	10	20	0	0	20	0	0
1	144015141	rs56064064	C	G	5	2	7	0	0	7	0	0
1	144015222	.	G	A	2	6	8	0	0	8	0	0
1	144015565	.	G	T	1	9	10	0	0	10	0	0
1	144015573	.	G	C	4	6	10	0	0	10	0	0
1	144015730	.	T	A	5	11	16	0	0	16	0	0
1	144015863	rs1476380	A	G	6	16	22	0	1	23	0	0
1	144015980	.	A	G	5	19	24	0	0	24	0	0
1	144016042	.	T	C	4	23	27	0	1	28	0	0
1	144016222	.	T	A	15	7	22	0	0	22	0	0
1	144481208	.	T	C	16	10	26	0	0	26	0	0
1	144481235	.	A	G	8	14	22	0	1	23	0	0
1	144481334	.	G	A	2	4	6	0	1	7	0	0
1	144521102	rs141018108	T	A	18	10	28	0	0	28	0	0
1	144521193	rs3009831	T	C	6	8	14	0	0	14	0	0
1	144534125	.	C	T	10	24	34	0	1	35	0	0
1	144598641	.	C	T	3	3	6	0	0	6	0	0
1	144598659	.	C	T	3	6	9	0	0	9	0	0
1	144828748	rs144947204	C	T	7	58	65	0	0	65	0	0
1	144828764	.	G	T	7	72	79	0	1	80	0	0
1	144828765	rs1043478	A	T	7	73	80	0	0	80	0	0
1	144828784	.	A	G	8	93	101	0	0	101	0	0
1	144828910	.	A	T	4	62	66	0	0	66	0	0
1	144829025	.	A	G	0	22	22	0	0	22	0	0
1	144830160	rs61807992	C	G	26	0	26	0	1	27	0	0
1	144852080	.	T	C	4	2	6	0	0	6	0	0
1	144852321	.	C	A	5	1	6	0	0	6	0	0
1	144915624	rs1778112	G	A	8	0	8	0	0	8	0	0
1	144916748	.	C	G	7	2	9	0	0	9	0	0
1	144917546	.	A	G	5	2	7	0	0	7	0	0
1	144917841	.	T	C	6	0	6	0	0	6	0	0
1	144930940	.	T	C	5	2	7	0	0	7	0	0
1	144931330	.	C	T	5	3	8	0	0	8	0	0
1	144981303	.	A	G	4	3	7	0	0	7	0	0
1	145015877	.	G	T	55	3	58	0	1	59	0	0
1	145017182	.	C	G	4	2	6	0	0	6	0	0
1	145017187	.	C	A	4	2	6	0	0	6	0	0
1	145018480	.	A	G	4	2	6	0	0	6	0	0
1	145018581	.	G	C	5	1	6	0	0	6	0	0
1	145027338	.	G	A	3	3	6	0	0	6	0	0
1	145028149	.	G	A	6	1	7	0	0	7	0	0
1	145036274	.	A	T	5	1	6	0	0	6	0	0
1	145036346	.	G	T	5	2	7	0	0	7	0	0
1	145037893	.	A	G	8	1	9	0	0	9	0	0
1	145037903	.	G	A	7	1	8	0	0	8	0	0
1	145037984	rs2489136	T	G	5	1	6	0	0	6	0	0
1	145038132	.	G	T	6	0	6	0	0	6	0	0
1	145038736	.	C	G	6	2	8	0	0	8	0	0
1	145038952	rs1663881	C	T	10	1	11	0	0	11	0	0
1	145039026	.	T	C	10	1	11	0	0	11	0	0
1	145039562	.	C	T	6	0	6	0	0	6	0	0
1	145039866	.	A	G	31	3	34	0	0	34	0	0
1	145103928	rs2596251	G	A	0	61	61	0	1	62	0	0
1	145103947	.	T	C	0	54	54	0	0	54	0	0
1	145109583	.	C	A	1	63	64	0	0	64	0	0
1	145110213	.	G	A	0	8	8	0	0	8	0	0
1	145110238	.	A	G	0	7	7	0	0	7	0	0
1	145110367	.	C	A	0	14	14	0	0	14	0	0
1	145110574	.	G	T	0	9	9	0	1	10	0	0
1	145111366	.	T	A	10	0	10	0	0	10	0	0
1	145111384	.	G	A	10	0	10	0	0	10	0	0
1	145111485	.	A	G	0	12	12	0	0	12	0	0
1	145111637	.	G	A	0	8	8	0	0	8	0	0
1	145114475	rs4269725	A	G	7	0	7	0	0	7	0	0
1	145114487	rs4396070	C	T	6	0	6	0	2	8	0	0
1	145114628	.	C	G	0	9	9	0	0	9	0	0
1	145115810	.	A	G	1	71	72	0	0	72	0	0
1	145116798	.	G	A	0	64	64	0	0	64	0	0
1	145209330	.	G	C	19	25	44	0	0	44	0	0
1	145209344	.	C	A	38	7	45	0	1	46	0	0
1	145226875	.	G	A	12	3	15	0	0	15	0	0
1	145227234	.	C	T	20	8	28	0	0	28	0	0
1	145227257	.	A	G	24	13	37	0	0	37	0	0
1	145230356	.	A	C	14	0	14	0	10	24	0	0
1	145281543	.	C	T	132	79	211	0	3	214	0	0
1	145289096	.	T	C	3	4	7	0	0	7	0	0
1	145292442	.	G	T	7	6	13	0	0	13	0	0
1	145292721	.	G	A	10	4	14	0	0	14	0	0
1	145293012	.	G	A	10	4	14	0	0	14	0	0
1	145296372	.	A	G	3	3	6	0	0	6	0	0
1	145296478	.	G	T	6	4	10	0	0	10	0	0
1	145301793	.	A	G	8	1	9	0	0	9	0	0
1	145301802	.	C	G	8	1	9	0	0	9	0	0
1	145367863	.	A	T	29	16	45	0	0	45	0	0
1	145368837	.	C	A	80	74	154	0	0	154	0	0
1	145369322	.	A	T	25	18	43	0	1	44	0	0
1	145369339	rs199531492	A	G	26	18	44	0	1	45	0	0
1	145369340	rs199803686	A	T	26	18	44	0	1	45	0	0
1	145369354	.	C	T	29	20	49	0	0	49	0	0
1	145369559	.	G	A	25	11	36	0	1	37	0	0
1	145438581	rs9245	C	A	410	385	795	0	0	795	0	0
1	145588184	rs2004659	T	C	2	4	6	0	0	6	0	0
1	145597417	rs9728345	C	A	5	4	9	0	0	9	0	0
1	145689271	rs17354678	A	G	13	19	32	0	1	33	0	0
1	145690472	rs12123298	C	T	74	69	143	0	2	145	0	0
1	145691349	rs1284306	C	T	5	6	11	0	0	11	0	0
1	145693383	rs17352469	A	G	6	3	9	0	0	9	0	0
1	145694962	rs190520782	G	A	3	5	8	0	0	8	0	0
1	146467009	.	G	C	13	0	13	0	1	14	0	0
1	146626922	rs6937	T	C	48	24	72	0	0	72	0	0
1	146686228	rs3766520	C	T	6	2	8	0	0	8	0	0
1	148004440	rs61810197	C	A	34	14	48	0	1	49	0	0
1	148004783	.	C	A	19	18	37	0	1	38	0	0
1	148009349	.	A	G	21	17	38	0	0	38	0	0
1	148010911	.	G	A	23	11	34	0	0	34	0	0
1	148017578	rs61810777	C	T	4	2	6	0	0	6	0	0
1	148252048	rs200928669	T	A	59	4	63	0	0	63	0	0
1	148556752	.	A	C	1	7	8	0	0	8	0	0
1	149291675	.	C	A	0	8	8	0	0	8	0	0
1	149306063	.	A	G	0	6	6	0	0	6	0	0
1	149576545	.	G	C	8	2	10	0	0	10	0	0
1	149691525	.	G	A	0	11	11	0	0	11	0	0
1	149719247	.	T	G	6	0	6	0	0	6	0	0
1	149876370	rs28642307	A	T	40	33	73	0	0	73	0	0
1	150194485	rs7532164	C	T	4	2	6	0	0	6	0	0
1	150199123	rs7522034	G	T	211	212	423	0	1	424	0	0
1	150241230	rs2275780	G	T	238	247	485	0	12	497	0	0
1	150266338	rs3818978	T	A	47	36	83	0	2	85	0	0
1	150280801	rs8006	G	C	52	31	83	0	0	83	0	0
1	150281043	rs471464	C	A	26	18	44	0	0	44	0	0
1	150281202	rs580060	A	C	31	21	52	0	1	53	0	0
1	150308389	rs59325647	C	T	2	4	6	0	0	6	0	0
1	150312268	rs2794685	C	T	3	8	11	0	0	11	0	0
1	150315436	rs1272798	T	C	2	4	6	0	0	6	0	0
1	150321486	rs1625468	G	A	0	7	7	0	1	8	0	0
1	150433389	rs9436007	C	T	6	1	7	0	0	7	0	0
1	150445819	rs7002	A	G	98	128	226	0	4	230	0	0
1	150446067	.	C	T	33	29	62	0	9	74	3	0
1	150447269	rs7411534	G	A	15	15	30	0	1	31	0	0
1	150447398	rs12042229	A	G	16	21	37	0	0	37	0	0
1	150447462	rs12040949	C	T	12	12	24	0	1	25	0	0
1	150477061	rs3738487	C	T	6	2	8	0	0	8	0	0
1	150479901	rs1815544	C	T	24	8	32	0	1	33	0	0
1	150479977	rs1815545	A	G	12	1	13	0	0	13	0	0
1	150484987	rs13294	G	A	5	6	11	0	0	11	0	0
1	150526406	rs6681639	C	T	20	22	42	0	1	43	0	0
1	150530274	rs375427068	C	A	12	4	16	0	0	16	0	0
1	150582438	rs1355637	C	T	8	6	14	0	0	14	0	0
1	150782797	rs10847	C	T	25	18	43	0	1	44	0	0
1	150902941	rs11204744	A	G	5	6	11	0	0	11	0	0
1	150932696	rs12143614	T	A	13	12	25	0	0	25	0	0
1	150940625	rs267738	T	G	135	88	223	0	1	224	0	0
1	150947976	.	C	G	4	6	10	0	0	10	0	0
1	151028929	rs2864700	C	T	3	3	6	0	0	6	0	0
1	151257744	.	A	C	17	20	37	0	0	37	0	0
1	151260673	rs12745008	G	A	120	109	229	0	1	230	0	0
1	151372138	rs7172	G	A	575	520	1095	0	11	1106	0	0
1	151374025	rs4603	T	C	1005	911	1916	0	6	1922	0	0
1	151379250	rs2274535	G	A	9	4	13	0	0	13	0	0
1	151431632	rs12125310	T	C	30	18	48	0	1	49	0	0
1	151732552	rs141949185	T	C	287	253	540	0	5	545	0	0
1	151846719	rs4845385	A	G	7	5	12	0	1	13	0	0
1	151847180	rs10749666	A	G	12	6	18	0	0	18	0	0
1	151867560	rs3762427	G	A	11	3	14	0	0	14	0	0
1	152484129	rs2105117	G	A	5	4	9	0	0	9	0	0
1	153362788	rs41264638	T	C	68	85	153	0	1	154	0	0
1	153507959	rs659403	G	C	7	4	11	0	0	11	0	0
1	153508400	rs28427870	C	T	3	8	11	0	0	11	0	0
1	153604029	rs1046379	C	T	3	3	6	0	0	6	0	0
1	153604112	rs1046381	G	A	3	3	6	0	0	6	0	0
1	153604519	rs3818632	G	A	33	36	69	0	1	70	0	0
1	153606851	rs28580554	A	G	1	5	6	0	0	6	0	0
1	153609886	rs28510471	C	G	75	61	136	0	1	137	0	0
1	153610017	rs28613361	A	G	56	50	106	0	1	107	0	0
1	153611426	rs10158761	G	A	6	2	8	0	0	8	0	0
1	153612053	rs2274740	A	G	9	12	21	0	0	21	0	0
1	153612133	rs2274739	G	A	10	16	26	0	0	26	0	0
1	153612425	rs10908746	T	G	12	10	22	0	0	22	0	0
1	153613215	rs11580122	T	C	5	7	12	0	0	12	0	0
1	153614712	rs7549308	C	T	14	7	21	0	0	21	0	0
1	153616857	rs3790412	T	C	29	26	55	0	1	56	0	0
1	153617132	rs3828031	C	A	31	28	59	0	2	61	0	0
1	153618766	rs7934	C	T	10	12	22	0	0	22	0	0
1	153634058	rs7345	G	T	64	114	178	0	4	182	0	0
1	153635425	rs3795396	G	A	82	102	184	0	1	185	0	0
1	153636860	rs4351684	A	G	10	19	29	0	0	29	0	0
1	153745128	rs6663011	G	C	41	43	84	0	1	85	0	0
1	153748219	rs36064263	C	T	8	8	16	0	0	16	0	0
1	153751621	.	G	A	47	50	97	0	0	97	0	0
1	153777669	rs4451582	G	T	5	1	6	0	0	6	0	0
1	153777848	rs1139620	C	T	7	0	7	0	0	7	0	0
1	153779412	rs1127091	A	G	50	41	91	0	0	91	0	0
1	153780298	rs9426938	C	T	45	32	77	0	0	77	0	0
1	153781888	rs6700115	G	A	20	19	39	0	1	40	0	0
1	153786182	rs6668066	G	A	9	5	14	0	0	14	0	0
1	153786314	rs6677794	C	T	11	5	16	0	0	16	0	0
1	153889042	rs17364880	C	T	4	3	7	0	0	7	0	0
1	153903129	rs55874907	C	T	11	10	21	0	2	23	0	0
1	153903883	rs1572788	T	C	8	8	16	0	0	16	0	0
1	153904214	rs11586593	T	C	9	7	16	0	1	17	0	0
1	153904338	rs11264619	G	A	9	2	11	0	0	11	0	0
1	153904574	rs11264620	T	C	4	7	11	0	0	11	0	0
1	153906397	rs11264621	A	G	9	12	21	0	0	21	0	0
1	153907839	rs58095661	T	C	6	1	7	0	0	7	0	0
1	153908309	rs11586075	G	A	6	2	8	0	0	8	0	0
1	153909069	rs1043608	G	C	59	58	117	0	1	118	0	0
1	153920286	rs8450	G	A	185	180	365	0	1	366	0	0
1	153920564	rs10559	A	G	322	271	593	0	4	597	0	0
1	153923276	rs10127983	C	T	7	6	13	0	0	13	0	0
1	153926078	rs11264680	T	C	111	108	219	0	4	223	0	0
1	153927052	rs10908557	C	G	29	31	60	0	1	61	0	0
1	153927270	rs10908558	T	C	17	21	38	0	1	39	0	0
1	153929365	rs12117078	G	C	26	23	49	0	0	49	0	0
1	153932212	rs6724	G	C	134	165	299	0	1	300	0	0
1	153941514	rs11264743	C	T	11	17	28	0	0	28	0	0
1	153948705	rs11264763	C	T	7	8	15	0	0	15	0	0
1	153954646	rs2230324	C	T	225	245	470	0	1	471	0	0
1	154128672	rs4540651	G	A	15	11	26	0	0	26	0	0
1	154129265	rs1051370	A	G	2122	2142	4264	0	31	4296	1	0
1	154134557	rs3196889	A	C	4	3	7	0	0	7	0	0
1	154135869	.	C	T	4	5	9	0	0	9	0	0
1	154146095	rs7517127	G	A	3	6	9	0	0	9	0	0
1	154149129	.	G	A	18	8	26	0	1	27	0	0
1	154149240	rs10797047	G	A	22	16	38	0	0	38	0	0
1	154150722	rs143722947	G	T	16	20	36	0	0	36	0	0
1	154150911	rs12063830	A	G	12	15	27	0	0	27	0	0
1	154153106	rs4579747	A	G	6	3	9	0	0	9	0	0
1	154154587	rs61806853	T	C	13	9	22	0	0	22	0	0
1	154179679	rs6719	T	C	290	266	556	0	6	562	0	0
1	154185476	rs11265299	C	G	2	5	7	0	0	7	0	0
1	154227239	.	C	A	5	3	8	0	0	8	0	0
1	154233016	rs2220390	G	A	15	10	25	0	0	25	0	0
1	154243115	rs1044013	C	T	37	25	62	0	1	63	0	0
1	154243457	rs12354278	A	T	12	3	15	0	0	15	0	0
1	154245512	rs1194593	A	G	11	15	26	0	0	26	0	0
1	154245917	rs13796	T	C	82	113	195	0	2	197	0	0
1	154320942	rs2297607	A	G	38	27	65	0	0	65	0	0
1	154321663	rs12729561	C	T	25	44	69	0	0	69	0	0
1	154426970	rs2228145	A	C	13	3	16	0	0	16	0	0
1	154437896	rs2229238	T	C	13	11	24	0	1	25	0	0
1	154438084	rs7514452	C	T	13	12	25	0	1	26	0	0
1	154438880	rs4072391	T	C	13	15	28	0	0	28	0	0
1	154439865	rs4379670	T	A	28	30	58	0	0	58	0	0
1	154521584	rs41269915	T	A	18	16	34	0	0	34	0	0
1	154555492	rs1127326	T	C	152	163	315	0	1	316	0	0
1	154556040	rs1127317	T	G	141	143	284	0	7	291	0	0
1	154556266	rs1127314	G	A	155	108	263	0	0	263	0	0
1	154556425	rs1127313	G	A	118	128	246	0	1	247	0	0
1	154556663	rs1127311	G	A	114	85	199	0	5	204	0	0
1	154557685	rs9427094	C	T	3	4	7	0	0	7	0	0
1	154559598	rs2131902	T	C	2	4	6	0	0	6	0	0
1	154559876	rs144412359	T	C	3	4	7	0	0	7	0	0
1	154561925	rs1127309	C	T	63	54	117	0	1	118	0	0
1	154571371	.	A	C	11	16	27	0	0	27	0	0
1	154572228	rs903323	C	T	12	13	25	0	0	25	0	0
1	154573139	rs12139887	A	C	4	7	11	0	0	11	0	0
1	154573200	rs142654985	G	A	7	2	9	0	0	9	0	0
1	154573419	rs3738032	C	T	8	8	16	0	0	16	0	0
1	154573967	rs2229857	T	C	64	47	111	0	1	112	0	0
1	154574571	.	C	T	62	45	107	0	2	109	0	0
1	154909268	rs1109815	A	G	14	24	38	0	0	38	0	0
1	154917314	rs705094	G	A	77	88	165	0	2	167	0	0
1	154919080	rs2061690	C	T	48	38	86	0	0	86	0	0
1	154944735	.	T	A	13	5	18	0	0	18	0	0
1	154987526	rs11264295	C	T	36	35	71	0	0	71	0	0
1	154988533	rs77548871	G	C	3	3	6	0	0	6	0	0
1	154988957	rs2242195	A	G	86	64	150	0	4	154	0	0
1	154989595	rs6673081	T	C	45	40	85	0	0	85	0	0
1	154990297	rs2242194	C	G	47	42	89	0	2	91	0	0
1	155026942	rs6427128	A	C	260	216	476	0	5	481	0	0
1	155027763	rs10158328	A	G	7	2	9	0	0	9	0	0
1	155028522	rs11264302	G	A	16	11	27	0	1	28	0	0
1	155030557	rs11264303	A	C	271	263	534	0	9	543	0	0
1	155033308	rs11589479	G	A	296	197	493	0	7	500	0	0
1	155033317	rs11264304	T	C	26	8	34	0	0	34	0	0
1	155033572	rs11264305	A	G	11	7	18	0	0	18	0	0
1	155106768	rs6694256	T	C	7	7	14	0	0	14	0	0
1	155220114	rs142630415	A	G	20	23	43	0	0	43	0	0
1	155306195	rs114130331	T	C	4	8	12	0	0	12	0	0
1	155920629	.	G	A	140	103	243	0	6	249	0	0
1	155937390	rs114940022	C	T	5	5	10	0	1	11	0	0
1	155980684	rs184145946	G	A	2	4	6	0	2	8	0	0
1	156146689	rs41265019	G	A	91	92	183	0	0	183	0	0
1	156198366	rs3768276	G	A	5	1	6	0	0	6	0	0
1	156208230	rs10908491	A	G	6	10	16	0	0	16	0	0
1	156215899	rs2075165	G	A	12	6	18	0	0	18	0	0
1	156219450	rs1804999	A	G	136	132	268	0	1	269	0	0
1	156220056	rs1043165	T	C	128	109	237	0	3	240	0	0
1	156233189	rs2273833	C	T	114	70	184	0	3	187	0	0
1	156262653	rs6800	A	C	44	13	57	0	1	59	1	0
1	156263940	rs10908495	T	C	35	16	51	0	2	53	0	0
1	156264000	rs10908496	G	A	51	34	85	0	0	85	0	0
1	156434703	rs1050316	G	T	84	73	157	0	2	159	0	0
1	156438198	rs74116850	G	A	9	9	18	0	0	18	0	0
1	156439000	rs1109751	T	C	25	14	39	0	0	39	0	0
1	156442956	rs6700679	C	T	10	6	16	0	0	16	0	0
1	156443654	rs114507676	C	T	7	11	18	0	1	19	0	0
1	156446020	rs116367951	A	G	8	8	16	0	0	16	0	0
1	156446242	rs2274316	C	A	16	16	32	0	0	32	0	0
1	156446450	rs12131289	C	T	6	16	22	0	0	22	0	0
1	156446903	rs2274317	T	C	395	397	792	0	7	799	0	0
1	156450740	rs1925950	G	A	317	290	607	0	6	614	1	0
1	156451349	rs3790454	T	G	5	2	7	0	0	7	0	0
1	156454564	.	A	G	3	3	6	0	0	6	0	0
1	156499969	rs1171566	T	C	10	13	23	0	0	23	0	0
1	156518379	rs744224	G	A	13	11	24	0	0	24	0	0
1	156526430	rs35160849	G	A	8	11	19	0	0	19	0	0
1	156564640	rs3795732	G	A	18	19	37	0	0	37	0	0
1	156564922	rs3795733	C	T	17	21	38	0	0	38	0	0
1	156699302	rs13374043	A	G	7	8	15	0	0	15	0	0
1	156758337	rs56338469	T	C	6	4	10	0	0	10	0	0
1	156759585	rs4443882	G	A	3	8	11	0	0	11	0	0
1	156760887	rs11264554	C	A	22	20	42	0	1	43	0	0
1	156768711	rs11264556	A	G	3	4	7	0	1	8	0	0
1	156778122	rs877097	G	T	7	7	14	0	1	15	0	0
1	156784982	rs926103	T	C	40	30	70	0	0	70	0	0
1	156846233	rs6334	G	A	46	67	113	0	2	115	0	0
1	156848120	rs2768755	T	A	4	3	7	0	0	7	0	0
1	156848995	rs6337	C	T	71	66	137	0	3	140	0	0
1	156882996	rs822441	G	C	4	3	7	0	0	7	0	0
1	156885491	rs4661012	T	G	2	7	9	0	0	9	0	0
1	156904837	rs139355036	G	T	10	18	28	0	2	30	0	0
1	156907081	rs945508	T	C	20	17	37	0	0	37	0	0
1	156907115	rs868188	T	C	20	22	42	0	0	42	0	0
1	157101925	rs2182464	C	G	81	117	198	0	1	199	0	0
1	157102453	rs998842	G	T	6	8	14	0	2	16	0	0
1	158580887	rs3768535	T	C	3	3	6	0	1	7	0	0
1	158813081	rs148953771	T	C	69	78	147	0	1	148	0	0
1	158813819	rs857870	A	G	88	74	162	0	1	163	0	0
1	158814382	rs703151	G	A	4	4	8	0	0	8	0	0
1	158814834	rs860781	T	C	8	1	9	0	0	9	0	0
1	158814862	rs857871	T	C	8	1	9	0	0	9	0	0
1	158816343	rs857872	C	T	6	5	11	0	0	11	0	0
1	158816589	rs2188112	T	C	7	9	16	0	0	16	0	0
1	158817474	rs2261107	A	G	1	6	7	0	0	7	0	0
1	158817975	rs2820121	T	C	6	0	6	0	0	6	0	0
1	159175527	rs13962	G	A	2	4	6	0	0	6	0	0
1	159273041	rs2427828	G	A	4	7	11	0	0	11	0	0
1	159275274	rs2494265	A	T	7	6	13	0	0	13	0	0
1	159889686	rs2252815	G	A	20	12	32	0	1	33	0	0
1	159890459	rs11265297	T	C	9	14	23	0	0	23	0	0
1	159890969	rs55633025	G	A	11	14	25	0	0	26	1	0
1	159891917	rs6427499	C	T	10	9	19	0	0	19	0	0
1	159892088	rs2789422	G	A	7	6	13	0	0	13	0	0
1	159892780	rs7551141	G	A	6	11	17	0	0	17	0	0
1	160209273	rs16831677	C	T	8	11	19	0	0	19	0	0
1	160246924	rs193290301	G	A	39	32	71	0	1	72	0	0
1	160247185	rs10594	G	C	64	57	121	0	0	121	0	0
1	160260233	rs2298104	T	C	7	3	10	0	0	10	0	0
1	160266667	rs11265371	C	G	6	2	8	0	0	8	0	0
1	160268981	rs79304843	G	A	109	104	213	0	2	216	1	0
1	160270054	rs11265372	C	T	5	7	12	0	0	12	0	0
1	160287578	rs116234003	G	C	1	5	6	0	0	6	0	0
1	160302983	rs12130366	G	A	5	9	14	0	0	14	0	0
1	160307662	rs6700892	T	C	4	2	6	0	0	6	0	0
1	160308963	rs61801298	G	A	7	9	16	0	0	16	0	0
1	160309450	rs1886421	G	C	2	5	7	0	0	7	0	0
1	160312625	rs1324738	C	T	2	4	6	0	0	6	0	0
1	160313330	rs3737794	C	G	2	10	12	0	0	12	0	0
1	160320938	rs12240253	C	T	3	3	6	0	0	6	0	0
1	160321065	rs12239747	A	G	111	139	250	0	2	252	0	0
1	160321499	rs6664627	C	T	124	155	279	0	1	280	0	0
1	160323059	rs140142139	C	G	1	7	8	0	0	8	0	0
1	160323211	rs183389026	T	A	2	8	10	0	0	10	0	0
1	160323342	rs2369607	A	C	6	1	7	0	0	7	0	0
1	160324771	rs6677637	C	T	4	6	10	0	0	10	0	0
1	160325111	rs6427515	C	T	8	12	20	0	0	20	0	0
1	160325921	rs45503695	T	C	13	14	27	0	0	27	0	0
1	160327286	rs73031412	T	C	5	3	8	0	0	8	0	0
1	160327309	.	C	T	3	4	7	0	0	7	0	0
1	160327820	rs17370539	G	C	3	6	9	0	0	9	0	0
1	160509181	rs73016371	A	T	2	4	6	0	0	6	0	0
1	160509461	rs12080742	A	G	3	5	8	0	0	8	0	0
1	160510621	rs73016376	G	A	5	5	10	0	0	10	0	0
1	160511648	rs3816146	C	T	19	17	36	0	0	36	0	0
1	160512224	rs12134393	G	A	6	11	17	0	0	17	0	0
1	160512616	rs10737176	G	A	9	10	19	0	0	19	0	0
1	160514087	rs1138323	G	A	3	6	9	0	0	9	0	0
1	160515266	rs3737792	G	A	25	22	47	0	0	47	0	0
1	160515389	rs3737791	G	A	16	18	34	0	0	34	0	0
1	160516659	rs3733266	C	G	11	18	29	0	0	29	0	0
1	160517214	rs3766389	A	G	21	21	42	0	0	42	0	0
1	160517479	rs3766388	C	G	9	16	25	0	2	27	0	0
1	160517692	rs1055880	C	T	16	8	24	0	0	24	0	0
1	160522787	rs41266913	A	G	3	4	7	0	0	7	0	0
1	160578002	rs6427538	G	A	9	10	19	0	0	19	0	0
1	160578004	rs1726	T	A	8	9	17	0	1	19	1	0
1	160578141	rs5002947	C	T	10	8	18	0	1	19	0	0
1	160580015	rs1061217	A	G	6	10	16	0	0	16	0	0
1	160800480	rs485618	T	C	90	76	166	0	2	168	0	0
1	160800559	rs3766377	A	G	59	61	120	0	0	120	0	0
1	160808668	rs10158850	G	A	3	3	6	0	0	6	0	0
1	160808796	rs34984882	G	A	71	71	142	0	1	143	0	0
1	160854620	rs35779394	T	C	4	5	9	0	0	9	0	0
1	160990875	rs28365980	T	C	104	45	149	0	1	150	0	0
1	160990876	rs28365979	C	A	104	46	150	0	0	150	0	0
1	160990878	rs28365978	C	T	101	46	147	0	1	148	0	0
1	161010774	rs2516841	A	G	14	22	36	0	0	36	0	0
1	161010791	rs2073657	C	T	12	21	33	0	1	34	0	0
1	161011317	rs2516840	A	G	4	3	7	0	0	7	0	0
1	161011716	rs2774276	G	C	3	7	10	0	0	10	0	0
1	161013121	rs2516839	C	T	88	78	166	0	2	168	0	0
1	161013985	rs2774273	G	C	3	4	7	0	0	7	0	0
1	161014370	rs2516838	C	G	3	7	10	0	0	10	0	0
1	161014727	rs2516837	A	G	3	9	12	0	0	12	0	0
1	161017556	rs2774279	C	T	86	96	182	0	1	183	0	0
1	161019040	rs3813609	G	C	92	90	182	0	2	184	0	0
1	161019621	rs11588189	C	T	4	3	7	0	0	7	0	0
1	161088583	rs41270017	T	G	15	10	25	0	0	25	0	0
1	161092761	rs17389237	A	G	9	6	15	0	0	15	0	0
1	161094190	rs1135783	A	G	117	114	231	0	1	233	1	0
1	161094834	rs10908823	C	T	9	9	18	0	0	18	0	0
1	161145005	rs3813620	C	T	80	46	126	0	1	127	0	0
1	161172233	rs11538340	C	A	63	68	131	0	0	131	0	0
1	161179877	rs4656994	G	A	9	13	22	0	1	23	0	0
1	161181134	rs76265753	C	T	1	5	6	0	0	6	0	0
1	161181491	rs77230296	C	A	3	3	6	0	0	6	0	0
1	161185729	rs114495062	G	C	3	5	8	0	1	9	0	0
1	161186313	rs4379692	C	T	6	5	11	0	0	11	0	0
1	161188158	rs112079466	C	A	4	26	30	0	0	30	0	0
1	161188249	rs74865766	G	C	5	21	26	0	0	26	0	0
1	161189733	rs115159907	A	C	4	2	6	0	0	6	0	0
1	161488587	.	T	A	59	64	123	0	1	124	0	0
1	161495885	rs404508	T	C	7	3	10	0	0	10	0	0
1	161647533	rs844	A	G	12	5	17	0	1	18	0	0
1	161721707	rs1063178	C	T	86	97	183	0	1	184	0	0
1	161724527	rs12564653	T	C	4	2	6	0	0	6	0	0
1	161725772	rs4656332	G	A	3	3	6	0	1	7	0	0
1	162353726	rs164417	T	C	2	4	6	0	0	6	0	0
1	162470191	rs2342714	C	T	2	7	9	0	1	10	0	0
1	162470503	rs905718	G	A	15	9	24	0	1	25	0	0
1	162493009	rs1062174	C	T	19	28	47	0	0	47	0	0
1	162493123	rs2236581	A	G	24	36	60	0	0	60	0	0
1	162493665	rs9405	T	G	22	22	44	0	0	44	0	0
1	162494683	rs3820486	G	T	23	17	40	0	0	40	0	0
1	162495734	rs10917561	T	A	22	27	49	0	0	49	0	0
1	162497663	rs4657201	G	A	49	48	97	0	5	102	0	0
1	162498599	rs10737484	T	C	42	43	85	0	0	85	0	0
1	162498946	rs1045901	A	G	144	147	291	0	2	293	0	0
1	162563661	rs12122366	C	T	2	5	7	0	0	7	0	0
1	162564835	rs12040665	A	G	4	6	10	0	0	10	0	0
1	162565070	rs12040734	A	G	2	6	8	0	0	8	0	0
1	162565221	rs12040754	A	G	4	3	7	0	0	7	0	0
1	162565939	rs57648936	G	C	5	1	6	0	0	6	0	0
1	162566561	rs12045760	G	A	10	8	18	0	1	19	0	0
1	162567225	rs16863833	T	C	8	5	13	0	0	13	0	0
1	163297322	rs16852612	A	C	15	15	30	0	0	30	0	0
1	163309219	rs1509022	A	T	26	15	41	0	0	41	0	0
1	163313539	rs11802875	C	T	18	28	46	0	0	46	0	0
1	165667781	rs12408101	T	G	5	2	7	0	0	7	0	0
1	165877575	rs536109	A	C	2	8	10	0	0	10	0	0
1	167609842	rs138448072	A	G	24	28	52	0	0	52	0	0
1	167758901	rs3088322	A	G	13	8	21	0	0	21	0	0
1	167759281	rs7605	T	C	5	13	18	0	0	18	0	0
1	167886502	rs2420	A	T	56	49	105	0	1	106	0	0
1	167887416	rs1050037	C	T	619	513	1132	0	6	1138	0	0
1	167887436	rs1050036	A	C	624	580	1204	0	9	1213	0	0
1	167887924	rs72699714	C	T	9	1	10	0	0	10	0	0
1	167905987	rs11558510	A	G	5	3	8	0	0	8	0	0
1	167973976	rs1060041	C	T	52	37	89	0	1	90	0	0
1	168011995	rs7520232	T	C	4	8	12	0	0	12	0	0
1	168212234	rs2280989	G	A	20	13	33	0	0	33	0	0
1	168213619	rs143086034	G	A	8	2	10	0	1	11	0	0
1	168214098	rs10737541	T	G	11	5	16	0	0	16	0	0
1	168215499	rs2205699	C	A	8	8	16	0	0	16	0	0
1	168215505	rs2205698	A	G	8	9	17	0	0	17	0	0
1	168215575	rs2205697	G	A	8	13	21	0	1	22	0	0
1	168218504	rs11799946	T	C	18	14	32	0	0	32	0	0
1	168220052	rs11800493	A	G	40	32	72	0	1	73	0	0
1	168221225	rs12608	A	C	76	56	132	0	1	133	0	0
1	168221986	rs906	G	T	74	64	138	0	0	138	0	0
1	168510122	rs470733	T	A	8	5	13	0	0	13	0	0
1	168511321	rs4501820	C	T	19	1	20	0	0	20	0	0
1	168511325	rs4301615	G	C	17	2	19	0	1	20	0	0
1	168550535	rs1042882	A	G	5	7	12	0	0	12	0	0
1	169099061	rs1200157	G	A	2	5	7	0	0	7	0	0
1	169101273	rs1779796	T	G	48	78	126	0	3	129	0	0
1	169293721	rs1140523	G	A	7	14	21	0	1	22	0	0
1	169305269	rs4534447	C	T	14	6	20	0	0	20	0	0
1	169305429	rs139090718	G	A	9	1	10	0	0	10	0	0
1	169305468	rs4529780	A	G	6	1	7	0	1	8	0	0
1	169350726	rs6669901	T	C	10	5	15	0	0	15	0	0
1	169356833	rs6427185	G	T	10	14	24	0	0	24	0	0
1	169357144	rs10919158	C	T	17	20	37	0	0	37	0	0
1	169359654	rs6669741	C	T	2	4	6	0	0	6	0	0
1	169382994	rs10919162	A	G	3	3	6	0	0	6	0	0
1	169483561	rs6027	T	C	6	8	14	0	0	14	0	0
1	169660781	rs12938	A	G	35	24	59	0	0	60	1	0
1	169676486	rs1131498	A	G	11	9	20	0	0	20	0	0
1	170004480	rs114822988	T	C	2	4	6	0	0	6	0	0
1	171454777	rs71637410	C	T	27	33	60	0	4	64	0	0
1	171483717	rs1055417	A	C	35	34	69	0	0	69	0	0
1	171486912	rs10913157	G	A	43	27	70	0	0	70	0	0
1	171515786	rs6676140	T	C	5	11	16	0	0	16	0	0
1	171561203	rs3204333	T	G	55	52	107	0	0	107	0	0
1	171639719	rs112979407	T	C	78	0	78	0	0	78	0	0
1	171670823	rs10913514	T	A	6	8	14	0	1	15	0	0
1	171673272	rs15655	C	A	2	5	7	0	0	7	0	0
1	171694566	rs6678890	C	A	10	22	32	0	3	35	0	0
1	171696112	rs12139610	T	C	13	20	33	0	0	33	0	0
1	171711152	rs12119232	A	C	7	19	26	0	0	26	0	0
1	171751051	rs2294719	A	G	2	7	9	0	0	9	0	0
1	171751236	rs2294720	T	C	3	6	9	0	0	9	0	0
1	171753039	rs2232816	A	G	6	10	16	0	0	16	0	0
1	171755170	rs2232818	G	A	2	8	10	0	0	10	0	0
1	172363524	rs10752944	C	T	5	9	14	0	0	14	0	0
1	172502340	rs2285143	T	C	13	11	24	0	1	25	0	0
1	172502479	rs2285144	T	C	39	33	72	0	1	73	0	0
1	172522602	rs1159378	G	A	3	3	6	0	0	6	0	0
1	172524788	rs2239817	T	A	4	5	9	0	0	9	0	0
1	172542787	rs12120798	A	T	3	4	7	0	0	7	0	0
1	172547465	rs2285664	A	G	114	93	207	0	2	209	0	0
1	172570550	rs7553020	A	C	22	13	35	0	0	35	0	0
1	172571568	rs3830150	A	G	19	15	34	0	0	34	0	0
1	173154304	rs7514229	G	T	9	14	23	0	0	23	0	0
1	173452487	rs75905143	T	G	6	4	10	0	0	10	0	0
1	173735570	rs56048122	A	G	6	5	11	0	0	11	0	0
1	173736346	rs56019876	C	T	7	2	9	0	0	9	0	0
1	173754716	.	A	G	18	17	35	0	0	35	0	0
1	173792234	.	A	T	5	2	7	0	0	7	0	0
1	173835211	rs2067079	C	T	52	38	90	0	0	90	0	0
1	173836194	rs17359906	G	A	12	3	15	0	0	15	0	0
1	173836516	rs9660881	T	C	8	11	19	0	0	19	0	0
1	173836602	rs1951625	G	A	11	10	21	0	1	22	0	0
1	173855298	rs1322775	A	T	11	8	19	0	0	19	0	0
1	173857037	rs7349095	C	T	4	3	7	0	0	7	0	0
1	173857283	rs9425430	A	G	7	5	12	0	0	12	0	0
1	173858915	rs6698314	G	A	3	3	6	0	1	7	0	0
1	173859100	rs1322777	A	G	4	6	10	0	0	10	0	0
1	173859533	rs16846541	C	G	3	6	9	0	0	9	0	0
1	173859871	.	C	T	4	7	11	0	0	11	0	0
1	173871472	rs72711423	T	C	4	2	6	0	0	6	0	0
1	173900918	rs12137553	T	C	154	142	296	0	2	298	0	0
1	174982240	rs149801718	G	A	7	3	10	0	0	10	0	0
1	175371359	rs859407	T	C	25	0	25	0	0	25	0	0
1	177901655	rs3748792	G	A	3	3	6	0	0	6	0	0
1	177901658	rs7554597	C	T	4	3	7	0	0	7	0	0
1	177976316	rs1819587	G	A	7	2	9	0	0	9	0	0
1	177976534	rs41267168	C	T	5	1	6	0	0	6	0	0
1	177994472	rs946819	A	G	4	2	6	0	0	6	0	0
1	178006840	rs11581088	C	T	4	5	9	0	0	9	0	0
1	179061108	rs1570807	G	A	4	4	8	0	0	8	0	0
1	179311602	rs3753525	T	G	3	5	8	0	1	9	0	0
1	180857257	rs17302054	T	G	5	7	12	0	0	12	0	0
1	180858459	rs10494535	C	T	9	15	24	0	0	24	0	0
1	181026238	rs4652551	G	A	7	5	12	0	0	12	0	0
1	181026558	rs4652552	G	A	6	8	14	0	0	14	0	0
1	181026704	rs4652553	C	T	13	5	18	0	0	18	0	0
1	181027086	rs7541386	T	C	11	8	19	0	0	19	0	0
1	181027841	rs6686208	A	G	3	4	7	0	0	7	0	0
1	181028733	rs10797667	T	C	3	6	9	0	0	9	0	0
1	181029053	rs12029214	C	T	7	6	13	0	0	13	0	0
1	181029082	rs3170905	G	A	5	7	12	0	0	12	0	0
1	181030115	rs10158625	C	T	7	11	18	0	0	18	0	0
1	181030499	rs4048650	A	G	8	8	16	0	0	16	0	0
1	181057874	.	T	G	315	282	597	0	9	606	0	0
1	181058313	rs3747955	G	A	51	56	107	0	2	109	0	0
1	181058618	rs1416829	C	G	9	8	17	0	1	18	0	0
1	182352621	rs7734	T	C	3662	3632	7294	0	40	7335	1	0
1	182353198	rs9347	A	T	2235	2387	4622	0	14	4638	2	0
1	182354850	rs2296520	A	G	1094	1293	2387	0	11	2399	1	0
1	182355046	rs2296519	A	G	137	127	264	0	2	267	1	0
1	182356399	rs1058111	A	G	2684	2911	5595	0	33	5628	0	0
1	182358437	rs4652705	T	C	29	25	54	0	0	54	0	0
1	182358944	rs12136955	G	A	25	41	66	0	0	66	0	0
1	182359578	rs3895340	A	C	23	25	48	0	1	49	0	0
1	182360169	rs4075940	T	G	8	2	10	0	0	10	0	0
1	182360202	rs4075941	A	C	15	9	24	0	0	24	0	0
1	182360223	rs7539686	G	T	22	17	39	0	0	39	0	0
1	182568729	rs680431	C	G	3	11	14	0	0	14	0	0
1	182842989	rs61807503	C	T	8	7	15	0	0	15	0	0
1	183105705	rs20561	G	A	8	0	8	0	0	8	0	0
1	183566913	rs41439047	C	T	9	4	13	0	0	13	0	0
1	183567085	rs35682376	G	A	8	6	14	0	0	14	0	0
1	183592570	rs17488675	C	T	4	16	20	0	0	20	0	0
1	183596136	rs11755	A	G	73	128	201	0	0	201	0	0
1	184702008	rs41264582	G	A	10	15	25	0	0	25	0	0
1	184760433	rs7360	C	T	68	67	135	0	1	136	0	0
1	184761186	rs492126	G	A	61	45	106	0	1	107	0	0
1	184761365	rs682331	A	G	35	38	73	0	0	73	0	0
1	184762603	rs526024	T	A	35	33	68	0	0	68	0	0
1	184763525	rs14426	A	G	29	32	61	0	1	62	0	0
1	184763596	rs14023	C	T	35	32	67	0	1	68	0	0
1	184764067	rs581100	C	G	30	36	66	0	0	66	0	0
1	184768524	.	A	G	6	0	6	0	0	6	0	0
1	184768746	.	C	T	5	1	6	0	0	6	0	0
1	184801065	rs487675	T	C	23	26	49	0	1	50	0	0
1	184803508	rs630030	A	G	3	4	7	0	0	7	0	0
1	184803708	rs575624	C	T	4	5	9	0	0	9	0	0
1	184804331	rs4275418	G	T	5	5	10	0	0	10	0	0
1	184804718	rs495530	C	T	3	4	7	0	0	7	0	0
1	184851655	rs532092	G	A	4	4	8	0	0	8	0	0
1	184863330	rs78908040	G	A	49	81	130	0	2	132	0	0
1	184913661	rs72739641	C	T	4	6	10	0	0	10	0	0
1	185143721	rs10489579	A	G	3	3	6	0	0	6	0	0
1	185171869	rs6698109	A	G	3	7	10	0	1	11	0	0
1	185240474	rs12041704	A	G	6	4	10	0	0	10	0	0
1	185265711	rs7123	T	C	21	26	47	0	0	47	0	0
1	185267114	rs10174	A	G	215	119	334	0	3	337	0	0
1	185272594	rs10911702	T	G	31	23	54	0	0	54	0	0
1	185275011	rs72724134	G	A	22	26	48	0	0	48	0	0
1	186284767	rs12069419	A	T	3	5	8	0	0	8	0	0
1	186286782	rs34585917	A	G	7	6	13	0	0	13	0	0
1	186290333	rs3820182	G	A	12	5	17	0	0	17	0	0
1	186290495	rs10494583	C	G	5	5	10	0	0	10	0	0
1	186290521	rs10494584	C	T	9	4	13	0	0	13	0	0
1	186293729	rs75158977	G	A	6	1	7	0	0	7	0	0
1	186293757	rs2178214	T	C	2	6	8	0	0	8	0	0
1	186294577	rs10911847	T	C	5	1	6	0	0	6	0	0
1	186311842	rs3766704	G	T	3	5	8	0	0	8	0	0
1	186316488	rs3753565	C	T	45	46	91	0	0	91	0	0
1	186326210	rs6689129	C	T	3	4	7	0	0	7	0	0
1	186363119	rs12084264	C	G	47	64	111	0	0	111	0	0
1	186374412	rs12082399	A	G	3	6	9	0	1	10	0	0
1	186374985	rs75856021	T	G	5	3	8	0	0	8	0	0
1	186389391	.	C	T	46	40	86	0	2	88	0	0
1	186645488	rs4648276	A	G	9	10	19	0	1	20	0	0
1	186645927	rs2066826	C	T	4	4	8	0	0	8	0	0
1	186917987	rs4651343	C	A	4	5	9	0	0	9	0	0
1	186927994	rs59300656	A	C	2	6	8	0	0	8	0	0
1	186934092	rs12720662	C	T	2	4	6	0	0	6	0	0
1	186934187	rs12144159	T	C	3	3	6	0	0	6	0	0
1	186957996	rs12720707	G	A	4	5	9	0	0	9	0	0
1	192133004	rs201891663	T	A	6	0	6	0	0	6	0	0
1	192547710	rs1923949	A	G	19	8	27	0	0	27	0	0
1	192779227	rs2746073	T	A	77	74	151	0	1	152	0	0
1	192780498	rs17647363	A	G	82	99	181	0	2	183	0	0
1	192781172	rs4606	C	G	1728	2081	3809	0	28	3837	0	0
1	193027997	rs6692342	G	A	4	4	8	0	0	8	0	0
1	193028121	rs4657842	A	T	1	7	8	0	0	8	0	0
1	193054485	rs10801173	T	C	50	65	115	0	2	117	0	0
1	193055839	rs150193543	A	G	7	4	11	0	1	12	0	0
1	193057207	rs6663431	A	G	6	3	9	0	0	9	0	0
1	193057971	rs10737620	T	A	6	3	9	0	0	9	0	0
1	193075108	rs912071	C	T	2	4	6	0	0	6	0	0
1	193197407	rs1408830	A	G	12	7	19	0	0	19	0	0
1	193199496	rs12064521	C	T	5	2	7	0	0	7	0	0
1	193205272	rs3738244	T	A	2	4	6	0	1	7	0	0
1	197070442	rs3762271	G	T	9	7	16	0	1	17	0	0
1	197070697	rs41310927	T	C	5	7	12	0	0	12	0	0
1	197070707	rs41308365	G	A	4	7	11	0	0	11	0	0
1	197072420	rs41310925	T	C	3	3	6	0	0	6	0	0
1	197124306	.	G	C	8	8	16	0	0	16	0	0
1	197477448	rs12042609	C	T	12	4	16	0	0	16	0	0
1	197480927	rs12142127	C	T	31	25	56	0	0	56	0	0
1	197480986	rs10494755	C	T	31	32	63	0	0	63	0	0
1	198288709	rs6679100	A	G	9	12	21	0	0	21	0	0
1	198619686	rs1326270	A	G	3	4	7	0	0	7	0	0
1	198619759	rs1326271	G	A	4	3	7	0	0	7	0	0
1	198622043	rs16843591	A	G	5	1	6	0	0	6	0	0
1	198622082	rs59147127	G	T	6	0	6	0	0	6	0	0
1	198622086	rs34411674	G	A	6	0	6	0	0	6	0	0
1	198622659	rs3767735	C	T	2	4	6	0	0	6	0	0
1	198632356	rs1998843	C	T	3	3	6	0	0	6	0	0
1	198650513	rs1326279	T	A	3	5	8	0	0	8	0	0
1	198666232	rs2296618	A	G	8	9	17	0	0	17	0	0
1	198676063	rs2230606	A	C	89	80	169	0	2	171	0	0
1	198679388	rs72738047	A	T	5	9	14	0	0	14	0	0
1	198680233	rs12134126	A	G	14	17	31	0	0	31	0	0
1	198680967	rs10800584	C	T	5	25	30	0	0	30	0	0
1	198681088	rs72738050	T	G	13	26	39	0	0	39	0	0
1	198681367	rs187666458	G	C	20	20	40	0	0	40	0	0
1	198681426	rs192349825	G	C	23	25	48	0	2	50	0	0
1	198682831	rs72738053	T	G	9	11	20	0	0	20	0	0
1	198723752	.	T	A	9	25	34	0	0	34	0	0
1	198840934	rs143031547	G	T	5	1	6	0	0	6	0	0
1	198868084	rs10800597	G	A	5	1	6	0	0	6	0	0
1	200521412	rs12060793	G	A	4	2	6	0	0	6	0	0
1	200522269	rs6667775	G	A	13	4	17	0	0	17	0	0
1	200522566	rs12120084	G	C	8	4	12	0	0	12	0	0
1	200534255	rs77157287	T	A	9	7	16	0	0	16	0	0
1	200624496	rs12140579	T	C	15	17	32	0	2	34	0	0
1	200625043	rs35249716	C	G	4	4	8	0	0	8	0	0
1	200627312	rs10919993	C	A	5	6	11	0	0	11	0	0
1	201104556	rs11540083	C	A	114	111	225	0	3	228	0	0
1	201455815	rs3767542	A	G	6	5	11	0	0	11	0	0
1	201455910	rs3767541	C	T	6	5	11	0	0	11	0	0
1	201456799	rs12729389	G	T	4	2	6	0	0	6	0	0
1	201457214	rs12403361	T	A	3	3	6	0	1	7	0	0
1	201502592	rs6672166	A	G	8	2	10	0	0	10	0	0
1	201792306	rs10464	T	C	6	6	12	0	0	12	0	0
1	201846487	rs12023470	G	A	4	5	9	0	0	9	0	0
1	201846913	rs12030626	A	G	4	4	8	0	0	8	0	0
1	201849926	rs41304257	A	G	4	8	12	0	0	12	0	0
1	201926422	.	G	A	137	115	252	0	1	253	0	0
1	201927133	rs6697918	C	T	15	4	19	0	0	19	0	0
1	201927190	rs6698097	G	A	17	6	23	0	2	25	0	0
1	201927628	rs10800801	C	T	19	9	28	0	0	28	0	0
1	201928399	rs7554085	G	A	11	6	17	0	0	17	0	0
1	201928841	rs6702239	G	A	11	6	17	0	0	17	0	0
1	201932181	rs41313890	A	G	18	6	24	0	0	24	0	0
1	201932290	rs41299611	G	A	8	3	11	0	0	11	0	0
1	201932369	rs6690948	A	G	5	9	14	0	0	14	0	0
1	201934578	rs4648	G	A	227	237	464	0	4	468	0	0
1	201958049	.	C	T	25	40	65	0	2	67	0	0
1	201963011	rs4950812	G	T	4	4	8	0	0	8	0	0
1	201964182	rs6427925	G	A	1	5	6	0	0	6	0	0
1	201965710	rs143351408	C	T	1	5	6	0	0	6	0	0
1	201965756	rs10920299	G	T	6	2	8	0	0	8	0	0
1	201965985	rs11581656	C	T	5	3	8	0	0	8	0	0
1	201974442	rs10920303	T	C	5	2	7	0	0	7	0	0
1	202103802	rs4342901	G	A	12	19	31	0	0	31	0	0
1	202106488	rs66572093	C	G	6	2	8	0	0	8	0	0
1	202106797	rs16849710	A	G	2	5	7	0	1	8	0	0
1	202109041	rs12402757	G	T	8	6	14	0	0	14	0	0
1	202111945	rs60471116	C	T	9	5	14	0	0	14	0	0
1	202112899	rs3934809	C	A	7	6	13	0	0	13	0	0
1	202116238	rs9077	G	A	278	268	546	0	1	547	0	0
1	202116957	rs4623766	T	A	285	274	559	0	7	566	0	0
1	202116981	.	G	A	318	277	595	0	8	603	0	0
1	202119052	rs61250341	C	T	16	15	31	0	1	32	0	0
1	202119205	rs55813259	C	A	17	17	34	0	0	34	0	0
1	202122613	rs10920338	C	T	3	3	6	0	0	6	0	0
1	202122783	rs11590076	C	A	4	4	8	0	0	8	0	0
1	202129196	rs73085637	T	C	10	4	14	0	0	14	0	0
1	202129895	rs3935295	G	A	4	2	6	0	0	6	0	0
1	202130166	rs4420146	G	A	4	4	8	0	0	8	0	0
1	202287813	rs788793	T	C	1	11	12	0	0	12	0	0
1	202288462	rs788792	C	A	1	8	9	0	0	9	0	0
1	202304868	rs14451	T	C	36	75	111	0	4	115	0	0
1	202311013	.	C	T	0	17	17	0	0	17	0	0
1	202440936	rs2362282	T	A	27	0	27	0	0	27	0	0
1	202702353	rs4950791	T	C	3	4	7	0	1	8	0	0
1	202703053	rs4310498	G	A	5	2	7	0	0	7	0	0
1	202704060	rs10920467	C	T	5	3	8	0	0	8	0	0
1	202705455	rs1141109	G	C	103	110	213	0	4	217	0	0
1	202715284	rs1141108	G	A	80	90	170	0	1	171	0	0
1	202718202	rs1892164	G	A	90	87	177	0	0	177	0	0
1	202733238	rs3196669	C	T	53	54	107	0	1	108	0	0
1	202735751	rs12140729	T	C	6	6	12	0	0	12	0	0
1	202736619	rs10800864	C	G	2	8	10	0	0	10	0	0
1	202736626	rs12409769	T	C	2	10	12	0	0	12	0	0
1	202737249	rs10920478	C	T	6	5	11	0	0	11	0	0
1	202739792	rs4333896	A	G	2	5	7	0	0	7	0	0
1	202740428	rs12127137	C	T	8	3	11	0	0	11	0	0
1	202740437	rs12142024	G	T	8	3	11	0	0	11	0	0
1	202740447	rs12127139	C	T	7	3	10	0	0	10	0	0
1	202741266	rs4245711	C	T	12	8	20	0	1	21	0	0
1	202780530	rs2275895	T	C	6	7	13	0	0	13	0	0
1	202780663	rs2275896	T	C	5	6	11	0	0	11	0	0
1	202909974	rs7539542	G	C	22	15	37	0	0	37	0	0
1	202912108	rs4950870	C	T	20	16	36	0	0	36	0	0
1	202912422	rs80207299	T	C	17	23	40	0	0	40	0	0
1	202912720	rs34559546	G	A	27	35	62	0	0	62	0	0
1	202914356	rs1342387	T	C	8	9	17	0	0	17	0	0
1	202914553	rs1342386	C	T	9	9	18	0	0	18	0	0
1	202916481	rs2001831	C	A	25	13	38	0	0	38	0	0
1	202916652	rs58402552	T	A	5	5	10	0	0	10	0	0
1	202916737	rs7544565	C	T	5	9	14	0	0	14	0	0
1	202916806	rs12045862	C	T	10	11	21	0	0	21	0	0
1	202917197	rs33942950	G	A	24	15	39	0	1	40	0	0
1	202919851	rs16850799	G	A	6	13	19	0	0	19	0	0
1	202920300	rs2275737	A	C	3	3	6	0	0	6	0	0
1	202920304	rs2275738	T	C	3	3	6	0	0	6	0	0
1	202922040	rs12733285	C	T	1	19	20	0	0	20	0	0
1	202924810	rs35668790	G	A	4	3	7	0	0	7	0	0
1	202926513	rs7514221	C	T	7	4	11	0	0	11	0	0
1	202976622	rs11558253	G	T	73	79	152	0	5	157	0	0
1	202987770	rs782788	T	C	0	6	6	0	0	6	0	0
1	202987796	rs782787	G	A	1	8	9	0	0	9	0	0
1	202987981	rs782786	A	C	4	12	16	0	0	16	0	0
1	202988006	rs782785	C	T	5	8	13	0	0	13	0	0
1	202991244	rs150078601	G	A	4	2	6	0	0	6	0	0
1	202991745	rs12727457	C	T	2	4	6	0	0	6	0	0
1	202993198	rs1046532	C	A	73	40	113	0	0	113	0	0
1	202993614	.	G	T	58	37	95	0	0	95	0	0
1	202993848	rs14197	G	A	88	45	133	0	0	133	0	0
1	203034906	rs3737883	A	G	7	13	20	0	1	21	0	0
1	203035097	rs3737881	C	T	10	20	30	0	0	30	0	0
1	203035340	rs10800897	C	T	10	27	37	0	0	37	0	0
1	203035365	rs6694477	A	G	11	28	39	0	0	39	0	0
1	203035551	rs6670637	G	A	16	24	40	0	0	40	0	0
1	203035693	rs10920559	C	T	13	16	29	0	0	29	0	0
1	203035897	rs10920560	G	A	8	8	16	0	0	16	0	0
1	203035911	rs6670788	C	A	8	6	14	0	0	14	0	0
1	203036757	rs2275354	T	C	14	17	31	0	0	31	0	0
1	203045413	rs11578206	G	T	5	9	14	0	0	14	0	0
1	203151425	rs12141494	G	A	3	3	6	0	0	6	0	0
1	203152801	rs880633	T	C	211	174	385	0	0	385	0	0
1	203257719	rs4971211	C	T	3	3	6	0	0	6	0	0
1	203275407	rs17534048	C	G	14	4	18	0	1	19	0	0
1	203709034	rs955865	A	G	8	9	17	0	0	17	0	0
1	203709068	rs955866	T	C	10	8	18	0	0	18	0	0
1	203711699	rs79143201	C	T	12	6	18	0	0	18	0	0
1	203712996	rs970	T	C	18	22	40	0	0	40	0	0
1	203713133	rs568	G	A	9	14	23	0	0	23	0	0
1	203743122	rs3820194	G	A	12	7	19	0	0	19	0	0
1	203743653	rs3766748	C	T	7	5	12	0	0	12	0	0
1	203744258	rs4951198	T	C	2	5	7	0	0	7	0	0
1	203744457	rs34412467	G	A	10	5	15	0	0	15	0	0
1	203745184	rs10900475	A	G	8	11	19	0	0	19	0	0
1	203766827	rs872032	T	C	5	5	10	0	0	10	0	0
1	203805538	rs2365980	T	C	7	2	9	0	0	9	0	0
1	203805760	rs112407081	C	T	4	4	8	0	0	8	0	0
1	203818973	rs41299639	C	A	240	266	506	0	2	508	0	0
1	203819177	rs11808915	T	C	1	5	6	0	0	6	0	0
1	203821314	rs41264265	G	A	262	254	516	0	14	530	0	0
1	203823066	rs7311	G	C	214	182	396	0	5	401	0	0
1	203839273	rs2298870	C	T	17	9	26	0	1	27	0	0
1	204190873	rs10793758	A	G	3	7	10	0	0	10	0	0
1	204237416	rs10900571	C	T	2	4	6	0	0	6	0	0
1	204365667	rs115543441	A	C	8	3	11	0	1	12	0	0
1	204379452	rs2089891	T	C	212	218	430	0	4	434	0	0
1	204380979	rs143144279	C	T	13	14	27	0	0	27	0	0
1	204392442	rs4951374	G	A	1	6	7	0	0	7	0	0
1	204396830	rs17334387	G	A	7	2	9	0	0	9	0	0
1	204403659	rs3747636	A	G	4	2	6	0	0	6	0	0
1	204524714	.	T	C	17	15	32	0	0	32	0	0
1	205052939	rs4950979	G	A	10	4	14	0	0	14	0	0
1	205053219	rs4951168	C	T	3	4	7	0	0	7	0	0
1	205055949	rs7537322	G	A	44	39	83	0	0	83	0	0
1	205056301	rs11240353	A	G	28	11	39	0	2	41	0	0
1	205056476	rs12409915	T	C	35	28	63	0	0	63	0	0
1	205111761	rs2836	A	C	39	52	91	0	8	99	0	0
1	205113595	rs12037322	A	C	51	55	106	0	0	106	0	0
1	205113596	rs12040428	G	A	50	55	105	0	1	106	0	0
1	205114873	rs12048743	C	G	37	37	74	0	2	76	0	0
1	205115428	rs10900452	C	T	25	26	51	0	0	51	0	0
1	205116635	rs11367	A	T	30	40	70	0	6	76	0	0
1	205130413	rs3851294	A	G	32	30	62	0	1	63	0	0
1	205241659	rs17728	T	C	40	30	70	0	1	71	0	0
1	205272926	rs1106201	C	T	6	4	10	0	0	10	0	0
1	205272983	rs1106202	C	G	6	3	9	0	0	9	0	0
1	205320469	rs4951205	G	A	167	0	167	0	0	167	0	0
1	205588864	.	T	C	11	9	20	0	0	20	0	0
1	205683355	rs3805	T	G	34	36	70	0	1	71	0	0
1	205685195	rs80002556	A	G	19	19	38	0	0	38	0	0
1	205685554	rs78874940	T	C	34	30	64	0	0	64	0	0
1	205718634	rs370218853	T	G	3	4	7	0	1	8	0	0
1	205737739	rs11557080	G	A	12	21	33	0	0	33	0	0
1	205739266	rs708723	C	T	11	23	34	0	0	34	0	0
1	205759876	rs1341249	T	C	6	7	13	0	1	14	0	0
1	206145517	.	C	T	7	6	13	0	0	13	0	0
1	206238974	rs73088148	T	C	21	7	28	0	0	28	0	0
1	206239574	rs28391411	T	C	35	38	73	0	0	73	0	0
1	206277868	rs28546121	A	G	4	3	7	0	0	7	0	0
1	206283419	.	G	T	21	1	22	0	0	22	0	0
1	206283483	rs28837425	A	T	10	14	24	0	0	24	0	0
1	206283527	rs28754987	C	G	0	23	23	0	0	23	0	0
1	206283548	rs61602556	G	A	15	10	25	0	0	25	0	0
1	206283551	rs28852078	A	C	1	21	22	0	0	23	1	0
1	206283776	rs28773594	C	T	0	26	26	0	0	26	0	0
1	206284960	rs28805044	G	C	9	13	22	0	0	22	0	0
1	206285235	.	C	T	16	0	16	0	0	16	0	0
1	206285637	.	C	T	12	1	13	0	0	13	0	0
1	206286135	rs28865893	T	G	3	5	8	0	0	8	0	0
1	206286215	rs28801417	T	C	3	3	6	0	0	6	0	0
1	206288121	.	G	A	37	18	55	0	0	55	0	0
1	206305570	rs28406384	A	G	26	89	115	0	0	115	0	0
1	206306083	rs28482296	G	A	22	78	100	0	0	100	0	0
1	206566904	rs2919105	T	C	15	13	28	0	0	28	0	0
1	206580084	.	C	G	0	7	7	0	1	8	0	0
1	206626607	rs11120575	G	A	23	19	42	0	0	42	0	0
1	206636879	rs3813981	T	C	4	4	8	0	0	8	0	0
1	206637395	rs9242	C	T	7	3	10	0	0	10	0	0
1	206669465	rs3748022	C	T	14	10	24	0	0	24	0	0
1	206730641	rs71633591	C	A	5	19	24	0	0	24	0	0
1	206730691	rs67223538	G	C	14	19	33	0	0	33	0	0
1	206757070	rs12724616	C	T	5	4	9	0	0	9	0	0
1	206759637	rs4073393	C	G	14	17	31	0	0	31	0	0
1	206759783	rs7535580	A	G	15	23	38	0	0	38	0	0
1	206759975	rs10779488	G	A	10	11	21	0	0	21	0	0
1	206760474	rs7541244	T	C	215	215	430	0	3	433	0	0
1	206761938	rs11589	T	C	342	337	679	0	1	680	0	0
1	206765250	.	G	T	3	3	6	0	0	6	0	0
1	206776200	rs6668054	C	T	5	5	10	0	0	10	0	0
1	206778642	rs4077413	A	C	3	4	7	0	0	7	0	0
1	206892679	rs544624219	T	C	3	5	8	0	0	8	0	0
1	206896398	rs193214868	C	G	8	4	12	0	0	12	0	0
1	206941529	rs3024498	T	C	0	7	7	0	0	7	0	0
1	207219603	rs17258711	T	C	20	19	39	0	1	40	0	0
1	207220282	rs12123107	G	A	28	26	54	0	0	54	0	0
1	207220800	rs2629665	C	A	15	9	24	0	0	24	0	0
1	207221612	rs2054780	C	T	37	18	55	0	1	56	0	0
1	207221929	rs3790619	T	G	22	26	48	0	0	48	0	0
1	207517696	rs28739000	A	T	10	4	14	0	0	14	0	0
1	207532285	rs28371670	G	A	26	17	43	0	0	43	0	0
1	207753621	rs2274567	A	G	1	7	8	0	0	8	0	0
1	207767671	rs34386700	C	T	9	4	13	0	0	13	0	0
1	207782931	rs6691117	A	G	7	4	11	0	1	12	0	0
1	207790088	rs3811381	C	G	5	12	17	0	0	17	0	0
1	207813259	rs57994498	T	C	6	8	14	0	0	14	0	0
1	207813601	rs4844385	T	C	16	24	40	0	0	40	0	0
1	207813626	rs147511910	C	A	12	24	36	0	1	37	0	0
1	207813726	rs4844386	T	C	9	16	25	0	0	25	0	0
1	207955823	rs2796278	A	C	3	6	9	0	0	9	0	0
1	207958094	rs11806810	G	C	2	5	7	0	0	7	0	0
1	208058730	.	C	G	19	17	36	0	1	37	0	0
1	208058924	rs658347	T	C	12	10	22	0	0	22	0	0
1	208060464	rs3820521	G	A	1298	1193	2491	0	15	2506	0	0
1	208195981	rs556625	C	T	3	7	10	0	0	10	0	0
1	208197785	rs591752	C	T	4	4	8	0	0	8	0	0
1	208198161	rs11118973	C	T	4	7	11	0	0	11	0	0
1	208207839	rs3736963	G	A	8	8	16	0	1	17	0	0
1	208211850	rs148452011	G	A	3	3	6	0	0	6	0	0
1	208388830	rs529237527	G	A	15	16	31	0	0	31	0	0
1	209788656	.	T	C	8	9	17	0	0	17	0	0
1	209788703	rs1049607	T	C	11	11	22	0	0	22	0	0
1	209795909	rs3179860	T	C	5	8	13	0	0	13	0	0
1	209796329	rs12748250	T	A	4	2	6	0	0	6	0	0
1	209849002	rs3817870	T	C	51	55	106	0	2	108	0	0
1	209929579	rs2272867	C	A	12	6	18	0	0	18	0	0
1	209933331	rs6685077	A	G	14	3	17	0	1	18	0	0
1	209933540	rs2076150	A	G	17	4	21	0	0	21	0	0
1	209936914	rs17015169	C	T	15	10	25	0	0	25	0	0
1	209952865	rs623360	C	G	20	10	30	0	1	31	0	0
1	211447625	rs11580084	G	A	4	2	6	0	0	6	0	0
1	211451467	rs11577985	T	C	75	72	147	0	2	149	0	0
1	211482905	rs12116749	C	G	3	4	7	0	1	8	0	0
1	211484100	rs7514863	A	T	6	9	15	0	0	15	0	0
1	211488718	rs77254353	A	G	9	15	24	0	1	25	0	0
1	211605697	rs1055565	G	A	4	9	13	0	0	13	0	0
1	211745154	rs11277	C	G	44	42	86	0	1	87	0	0
1	211745290	rs11553543	T	A	24	21	45	0	0	45	0	0
1	211747902	rs7531277	A	T	7	4	11	0	0	11	0	0
1	211748118	rs7519865	C	T	16	14	30	0	0	30	0	0
1	211846876	rs701929	A	G	6	3	9	0	0	9	0	0
1	212114860	rs2808385	T	C	3	5	8	0	0	8	0	0
1	212190116	rs2993531	A	C	4	3	7	0	0	7	0	0
1	212224946	rs113106720	G	T	120	0	120	0	0	120	0	0
1	212225215	rs2970593	G	A	6	2	8	0	0	8	0	0
1	212234104	rs7522330	A	T	11	4	15	0	2	17	0	0
1	212277107	rs1387815	T	G	34	25	59	0	2	61	0	0
1	212277304	rs1387814	C	G	19	16	35	0	0	35	0	0
1	212277333	.	A	C	14	15	29	0	0	29	0	0
1	212515613	rs1774249	C	T	122	103	225	0	1	226	0	0
1	212516245	rs2252044	A	C	5	2	7	0	0	7	0	0
1	212516875	rs12736502	C	T	17	5	22	0	0	22	0	0
1	212517092	rs12756678	A	G	9	3	12	0	0	12	0	0
1	212517205	rs12726409	T	A	11	2	13	0	0	13	0	0
1	212527646	rs34080686	G	A	4	4	8	0	0	8	0	0
1	212533780	rs11587555	C	G	15	10	25	0	0	25	0	0
1	212534377	rs10019	T	A	154	118	272	0	1	273	0	0
1	212538456	rs12073615	T	G	78	81	159	0	1	160	0	0
1	212549357	rs1774247	C	T	6	3	9	0	0	9	0	0
1	212588206	rs518793	C	G	10	6	16	0	0	16	0	0
1	212619339	rs4804	T	C	372	330	702	0	4	706	0	0
1	212786250	rs6670133	G	C	6	1	7	0	0	7	0	0
1	212799870	rs3122713	A	G	7	1	8	0	0	8	0	0
1	212900463	rs41315583	G	A	4	3	7	0	0	7	0	0
1	212909472	rs113505281	A	T	4	2	6	0	0	6	0	0
1	212909744	rs11800642	A	G	3	3	6	0	0	6	0	0
1	212911615	rs1046083	C	T	12	11	23	0	0	23	0	0
1	212965095	rs17856201	G	A	16	12	28	0	1	29	0	0
1	212965284	rs61736926	C	G	8	10	18	0	0	18	0	0
1	212965469	rs3738798	C	T	0	6	6	0	0	6	0	0
1	212989107	rs2359322	C	T	13	17	30	0	0	30	0	0
1	212989840	rs1054733	C	T	2	9	11	0	0	11	0	0
1	213071445	rs1284854	G	A	3	5	8	0	0	8	0	0
1	213071540	rs1284853	G	A	5	4	9	0	0	9	0	0
1	213167537	rs41277162	C	T	7	11	18	0	0	18	0	0
1	213175115	rs7537285	A	C	6	5	11	0	0	11	0	0
1	213390949	rs149452809	C	T	6	1	7	0	0	7	0	0
1	213392888	rs61832467	A	G	5	8	13	0	0	13	0	0
1	213415291	.	A	C	16	20	36	0	0	36	0	0
1	213446604	rs41307658	G	A	53	31	84	0	0	84	0	0
1	214492286	rs1134647	G	A	49	88	137	0	0	137	0	0
1	214814571	rs3795521	C	T	4	2	6	0	0	6	0	0
1	214820099	rs3748697	A	G	17	5	22	0	0	22	0	0
1	214826196	rs335524	G	A	10	13	23	0	1	24	0	0
1	214829916	rs369801	T	G	2	4	6	0	0	6	0	0
1	214830617	rs438034	A	G	17	28	45	0	0	45	0	0
1	214837110	rs7289	C	G	22	40	62	0	1	63	0	0
1	220154768	rs1061160	C	T	95	92	187	0	2	190	1	0
1	220168633	rs2647468	A	G	10	2	12	0	1	13	0	0
1	220169163	rs2647469	A	G	11	4	15	0	0	15	0	0
1	220169341	rs2647431	C	T	4	3	7	0	0	7	0	0
1	220170013	rs2647470	G	A	5	6	11	0	1	12	0	0
1	220192495	rs2245457	C	G	5	1	6	0	0	6	0	0
1	220197625	rs2230301	G	T	67	36	103	0	1	104	0	0
1	220231447	rs2647465	G	A	17	9	26	0	2	28	0	0
1	220970028	rs2642438	A	G	10	12	22	0	0	22	0	0
1	221044966	rs12131897	T	C	7	9	16	0	2	18	0	0
1	221051566	rs41369048	A	G	4	3	7	0	0	7	0	0
1	221051713	rs2738751	C	G	10	6	16	0	0	16	0	0
1	221052765	rs2738752	A	G	28	20	48	0	2	50	0	0
1	221053545	rs12141189	T	C	138	126	264	0	0	264	0	0
1	221053574	rs62621984	A	C	139	140	279	0	10	289	0	0
1	221054761	rs17597773	C	G	7	13	20	0	1	21	0	0
1	221055463	rs2247213	G	A	9	6	15	0	0	15	0	0
1	221056216	rs1317189	T	C	27	15	42	0	0	42	0	0
1	221057646	rs2738755	C	T	519	509	1028	0	20	1049	1	0
1	221057739	rs11578466	C	G	456	402	858	0	3	861	0	0
1	221058059	rs2738756	C	T	351	322	673	0	8	681	0	0
1	221912361	rs1141714	T	C	235	210	445	0	5	451	1	0
1	221912808	rs1136448	T	C	260	278	538	0	7	545	0	0
1	221915205	rs12043337	A	T	5	5	10	0	0	10	0	0
1	222224277	rs2584320	C	T	2	4	6	0	0	6	0	0
1	222832010	rs35822937	A	G	12	4	16	0	0	16	0	0
1	223907298	rs17557525	G	A	4	3	7	0	0	7	0	0
1	223933061	rs17597	C	T	49	42	91	0	0	91	0	0
1	223933079	rs17598	C	T	47	49	96	0	0	96	0	0
1	223934720	rs17600	G	A	47	58	105	0	0	105	0	0
1	223956664	rs1222148	G	C	4	2	6	0	0	6	0	0
1	223962929	rs10961	G	A	60	76	136	0	0	136	0	0
1	223963468	rs7331	T	C	43	45	88	0	0	88	0	0
1	223967953	rs17739	C	T	95	77	172	0	0	172	0	0
1	223970325	rs1153944	T	C	3	5	8	0	0	8	0	0
1	223991119	rs34683843	G	T	76	69	145	0	0	145	0	0
1	223996174	rs145984122	T	A	5	1	6	0	0	6	0	0
1	224000517	rs1222126	T	G	6	3	9	0	0	9	0	0
1	224001273	rs6694960	T	C	3	4	7	0	0	7	0	0
1	224139955	rs61825424	G	A	9	5	14	0	0	14	0	0
1	224339000	rs7524705	G	A	8	2	10	0	0	10	0	0
1	224346959	rs8328	G	A	75	70	145	0	0	145	0	0
1	224348818	rs7526252	T	C	7	15	22	0	1	23	0	0
1	224380921	rs1060394	A	T	20	14	34	0	0	34	0	0
1	224492746	rs3754090	C	T	32	20	52	0	0	52	0	0
1	224495852	rs7534447	C	T	19	15	34	0	0	34	0	0
1	224551593	rs12128292	G	A	11	8	19	0	0	19	0	0
1	224574972	rs10495220	C	G	96	80	176	0	4	180	0	0
1	224580379	rs72758316	A	G	4	4	8	0	0	8	0	0
1	224599977	rs12121977	G	T	12	17	29	0	0	29	0	0
1	224603469	rs6693653	T	C	4	6	10	0	0	10	0	0
1	224605096	rs12124686	C	T	3	8	11	0	0	11	0	0
1	225589644	rs14205	A	G	100	144	244	0	5	249	0	0
1	225595790	rs78962574	T	C	25	34	59	0	0	59	0	0
1	225598309	rs1538930	A	C	31	24	55	0	2	57	0	0
1	225599923	rs10799307	T	C	86	80	166	0	0	166	0	0
1	225601647	rs3766928	C	T	5	5	10	0	0	10	0	0
1	225602823	rs6666171	A	T	12	19	31	0	0	31	0	0
1	225603944	rs79212207	C	T	1	6	7	0	0	7	0	0
1	225605257	rs76081334	T	C	3	4	7	0	0	7	0	0
1	225611661	rs1056607	C	T	216	222	438	0	1	439	0	0
1	225612525	rs113169763	T	C	2	4	6	0	0	6	0	0
1	225965832	rs1461957	G	T	8	8	16	0	0	16	0	0
1	225973679	rs12045030	C	G	2	5	7	0	0	7	0	0
1	225974531	rs4653433	A	G	5	1	6	0	0	6	0	0
1	225977968	rs1050033	C	T	179	146	325	0	1	326	0	0
1	226019633	rs1051740	T	C	16	11	27	0	0	27	0	0
1	226029557	rs2854452	A	G	6	3	9	0	0	9	0	0
1	226033476	rs6965	A	G	4	5	9	0	0	9	0	0
1	226044434	.	C	T	14	9	23	0	0	23	0	0
1	226053805	rs7515156	G	A	11	2	13	0	0	13	0	0
1	226054333	rs45492299	G	A	14	10	24	0	0	24	0	0
1	226054714	rs2292563	G	A	6	3	9	0	1	10	0	0
1	226055595	rs2292564	G	A	12	14	26	0	0	26	0	0
1	226110243	rs10915898	G	A	12	3	15	0	0	15	0	0
1	226171475	rs6664468	G	C	95	88	183	0	3	186	0	0
1	226336163	rs4653718	A	G	4	6	10	0	0	10	0	0
1	226336861	rs114954863	G	A	10	17	27	0	0	27	0	0
1	226339764	rs10915949	C	A	9	6	15	0	0	15	0	0
1	226352498	rs2306120	T	G	141	137	278	0	4	282	0	0
1	226453618	rs4418563	T	C	2	5	7	0	0	7	0	0
1	226474132	rs10799347	G	A	15	8	23	0	0	23	0	0
1	226548554	rs8679	A	G	48	42	90	0	1	91	0	0
1	226920757	.	G	A	4	2	6	0	0	6	0	0
1	227069677	rs11405	T	C	4	2	6	0	0	6	0	0
1	227069737	rs6759	C	T	4	2	6	0	0	6	0	0
1	227083550	rs8383	C	T	9	8	17	0	0	17	0	0
1	227170768	rs2256060	T	C	3	3	6	0	0	6	0	0
1	227174548	.	G	C	113	112	225	0	3	228	0	0
1	227920061	rs1060295	T	G	14	20	34	0	0	34	0	0
1	227920103	rs3087908	G	A	21	20	41	0	0	41	0	0
1	227922918	rs2295994	A	C	5	6	11	0	0	11	0	0
1	227935444	rs2236359	A	G	14	19	33	0	0	33	0	0
1	228277048	rs10916265	G	A	2	6	8	0	0	8	0	0
1	228282695	rs3768331	C	T	4	8	12	0	0	12	0	0
1	228288896	rs79502515	C	T	86	80	166	0	0	166	0	0
1	228289843	rs1128456	C	T	22	43	65	0	0	65	0	0
1	228296745	rs849749	C	T	36	26	62	0	0	62	0	0
1	228330033	rs181607511	T	C	15	18	33	0	1	34	0	0
1	228331040	rs2313602	C	A	13	19	32	0	1	33	0	0
1	228334277	rs10916268	C	T	76	62	138	0	4	142	0	0
1	228334436	rs55873533	G	A	50	38	88	0	5	93	0	0
1	228362682	rs2298014	G	A	15	11	26	0	0	26	0	0
1	228402508	rs2776853	C	T	4	3	7	0	0	7	0	0
1	228434395	rs7517088	T	C	2	4	6	0	0	6	0	0
1	228465346	rs493945	A	G	4	4	8	0	0	8	0	0
1	228471379	rs56168609	G	C	3	5	8	0	0	8	0	0
1	228547901	rs12035900	C	T	5	1	6	0	0	6	0	0
1	228586250	rs101235	A	G	6	4	10	0	0	10	0	0
1	229426360	rs6693714	G	A	3	9	12	0	0	12	0	0
1	229426985	rs237767	A	T	2	6	8	0	0	8	0	0
1	229439639	rs15452	T	A	266	233	499	0	3	502	0	0
1	229440190	rs2069372	C	T	53	38	91	0	1	92	0	0
1	229460246	rs2282081	A	T	13	14	27	0	0	27	0	0
1	229461024	rs2282083	C	T	23	13	36	0	0	36	0	0
1	229598917	rs7515418	C	T	6	5	11	0	0	11	0	0
1	229599225	rs7525324	T	C	7	2	9	0	0	9	0	0
1	229622162	rs1065675	A	G	32	31	63	0	0	63	0	0
1	229623131	rs6678721	G	C	4	3	7	0	0	7	0	0
1	229623137	rs4925493	T	C	3	3	6	0	1	7	0	0
1	229623338	rs1065674	T	C	30	31	61	0	0	61	0	0
1	229631734	rs11805194	T	C	24	17	41	0	0	41	0	0
1	229634396	rs10916492	G	T	3	3	6	0	1	7	0	0
1	229634397	rs10916493	G	T	3	3	6	0	1	7	0	0
1	229635521	rs10916495	A	G	19	23	42	0	1	43	0	0
1	229636388	rs6673421	A	G	6	3	9	0	0	9	0	0
1	229652587	rs1053513	T	C	12	13	25	0	0	25	0	0
1	229652698	rs1053512	G	T	56	37	93	0	0	93	0	0
1	229683264	rs3738187	G	A	29	33	62	0	1	63	0	0
1	230227208	rs12029443	C	G	4	4	8	0	0	8	0	0
1	230384937	rs3748006	T	C	24	22	46	0	1	47	0	0
1	230400121	rs16851275	C	G	3	4	7	0	1	8	0	0
1	230400531	rs7552730	G	A	2	6	8	0	0	8	0	0
1	230415244	rs2273968	T	C	31	29	60	0	0	60	0	0
1	230416038	rs3213495	G	A	25	25	50	0	0	50	0	0
1	230416218	rs13728	T	C	8	17	25	0	0	25	0	0
1	230416399	rs1043897	G	T	18	18	36	0	0	36	0	0
1	230416760	rs13490	A	G	25	21	46	0	0	46	0	0
1	230416953	rs10005	A	G	30	22	52	0	0	52	0	0
1	230417394	rs3088075	T	C	29	29	58	0	0	58	0	0
1	230417664	rs7022	C	G	23	19	42	0	0	42	0	0
1	231042732	rs3811502	T	A	10	18	28	0	0	28	0	0
1	231057247	rs2275333	A	T	5	4	9	0	0	9	0	0
1	231097042	rs11122162	G	A	5	2	7	0	0	7	0	0
1	231112110	rs7528061	A	C	6	4	10	0	0	10	0	0
1	231112197	rs12733740	A	G	4	4	8	0	0	8	0	0
1	231112202	rs12752412	C	G	4	4	8	0	0	8	0	0
1	231361505	rs566796	G	T	4	3	7	0	1	8	0	0
1	231377081	rs518686	C	T	49	38	87	0	2	89	0	0
1	231401902	rs574553	G	A	66	59	125	0	1	126	0	0
1	231468606	rs953	A	G	46	45	91	0	0	91	0	0
1	231468953	rs2064766	G	A	86	53	139	0	1	140	0	0
1	231470650	rs10489609	T	C	58	63	121	0	0	121	0	0
1	231470772	rs11122272	A	G	52	54	106	0	0	106	0	0
1	231830295	rs3738401	G	A	9	9	18	0	0	18	0	0
1	232144598	rs821616	A	T	16	8	24	0	0	24	0	0
1	232144887	rs821617	A	G	2	6	8	0	0	8	0	0
1	232174775	rs1411771	T	C	3	6	9	0	0	9	0	0
1	232176195	rs980989	G	T	19	18	37	0	0	37	0	0
1	232176306	rs9308481	G	A	17	8	25	0	0	25	0	0
1	232534776	rs586719	C	T	91	76	167	0	0	167	0	0
1	232537690	rs72757307	A	G	4	4	8	0	0	8	0	0
1	232538834	rs28402703	G	T	4	5	9	0	0	9	0	0
1	232596653	rs1766574	A	G	48	27	75	0	0	75	0	0
1	232596728	rs74807360	G	A	30	41	71	0	0	71	0	0
1	232941677	rs3766497	G	T	7	2	9	0	0	9	0	0
1	232942251	rs12048236	A	G	15	1	16	0	0	16	0	0
1	232945255	rs10489578	C	G	5	1	6	0	0	6	0	0
1	233086456	rs13381	T	C	60	94	154	0	9	163	0	0
1	233134086	rs56231757	C	T	2	10	12	0	0	12	0	0
1	233225848	rs12059884	T	C	7	3	10	0	0	10	0	0
1	233429825	rs6667845	G	A	6	1	7	0	0	7	0	0
1	233464915	.	G	A	2	5	7	0	0	7	0	0
1	233508564	rs10737197	G	A	2	4	6	0	0	6	0	0
1	233509448	rs12027279	C	T	6	1	7	0	0	7	0	0
1	233509450	rs12048106	G	A	5	1	6	0	1	7	0	0
1	233509909	rs10910138	T	G	4	3	7	0	1	8	0	0
1	233510113	rs10910142	A	G	4	2	6	0	0	6	0	0
1	233514934	rs3795375	G	A	11	13	24	0	0	24	0	0
1	233514975	rs3795374	G	T	10	9	19	0	1	20	0	0
1	233515071	rs963982	C	T	12	11	23	0	0	23	0	0
1	233515102	rs963981	T	G	7	14	21	0	1	22	0	0
1	233519057	rs182991306	T	A	7	8	15	0	0	15	0	0
1	233519393	rs1294231	C	T	5	5	10	0	0	10	0	0
1	234509136	rs141632934	C	T	11	13	24	0	0	24	0	0
1	234509259	rs10910420	G	C	12	8	20	0	0	20	0	0
1	234509865	rs45577939	T	G	4	4	8	0	0	8	0	0
1	234529570	rs2175593	G	A	100	91	191	0	1	192	0	0
1	234546245	rs1141264	C	T	18	15	33	0	0	33	0	0
1	234582651	rs4920246	T	C	32	18	50	0	1	51	0	0
1	234584231	rs2102596	C	T	37	25	62	0	1	63	0	0
1	234603290	rs17378453	C	T	13	13	26	0	0	26	0	0
1	234740141	rs8823	G	A	32	19	51	0	0	51	0	0
1	234740880	rs1329125	C	T	151	118	269	0	2	271	0	0
1	234740975	rs72749964	G	A	117	120	237	0	2	239	0	0
1	235096551	rs10910535	A	T	5	1	6	0	0	6	0	0
1	235097348	rs141343556	G	A	6	0	6	0	0	6	0	0
1	235273179	rs11301	G	A	472	394	866	0	7	873	0	0
1	235291652	rs34037390	T	C	6	1	7	0	1	8	0	0
1	235302256	rs4659549	T	C	7	15	22	0	0	22	0	0
1	235305217	rs67736021	G	A	3	4	7	0	0	7	0	0
1	235306563	rs4659941	C	T	2	5	7	0	0	7	0	0
1	235317741	rs4660042	C	T	11	16	27	0	0	27	0	0
1	235319373	rs4659601	C	G	5	5	10	0	0	10	0	0
1	235332555	rs6681842	G	T	3	3	6	0	0	6	0	0
1	235333174	rs12739051	G	A	3	5	8	0	0	8	0	0
1	235335177	rs12749859	G	A	3	4	7	0	0	7	0	0
1	235337418	rs9793257	A	G	4	6	10	0	0	10	0	0
1	235377979	rs6677573	T	G	1	6	7	0	0	7	0	0
1	235378344	rs10925125	G	A	12	3	15	0	0	15	0	0
1	235378659	rs10925127	C	T	8	6	14	0	0	14	0	0
1	235378896	rs7531921	A	G	7	7	14	0	0	14	0	0
1	235378898	rs7531922	A	G	7	7	14	0	0	14	0	0
1	235379186	rs4659647	G	A	4	3	7	0	0	7	0	0
1	235381342	rs12029822	T	G	5	3	8	0	0	8	0	0
1	235383188	rs4659654	A	G	107	91	198	0	1	199	0	0
1	235385934	rs12027832	A	G	29	11	40	0	1	41	0	0
1	235387854	rs9787250	T	A	6	2	8	0	0	8	0	0
1	235389998	rs12027647	G	A	5	5	10	0	0	10	0	0
1	235390396	rs10495362	T	C	2	13	15	0	0	15	0	0
1	235391264	rs10925162	C	T	6	4	10	0	0	10	0	0
1	235392083	rs4659673	A	C	2	5	7	0	0	7	0	0
1	235392546	rs12731746	T	C	95	77	172	0	10	182	0	0
1	235492546	rs3806393	T	G	8	10	18	0	0	18	0	0
1	235492972	rs12044028	T	G	5	2	7	0	0	7	0	0
1	235493804	rs10754614	G	A	8	7	15	0	0	15	0	0
1	235611285	rs6429095	G	C	10	1	11	0	0	11	0	0
1	235611293	rs6429096	G	A	9	1	10	0	0	10	0	0
1	236379149	rs2449	A	C	4	6	10	0	0	10	0	0
1	237054569	rs2229276	A	G	3	4	7	0	0	7	0	0
1	237058744	rs12070777	C	A	4	5	9	0	0	9	0	0
1	237058828	rs1131449	C	T	5	5	10	0	0	10	0	0
1	237061056	rs2853522	A	C	6	5	11	0	0	11	0	0
1	237061849	rs1131450	G	A	1	5	6	0	0	6	0	0
1	237062198	rs2853523	A	C	4	5	9	0	0	9	0	0
1	237062305	rs1050993	A	G	5	6	11	0	0	11	0	0
1	237063335	rs1050996	G	C	6	11	17	0	0	17	0	0
1	237063504	rs9779	A	G	5	6	11	0	0	11	0	0
1	239769945	rs12119540	T	C	4	2	6	0	0	6	0	0
1	241792562	rs3765819	A	G	9	17	26	0	0	26	0	0
1	241795123	rs76629357	G	A	3	7	10	0	0	10	0	0
1	241796284	rs676750	A	G	5	5	10	0	0	10	0	0
1	241796443	rs3765824	T	C	2	8	10	0	0	10	0	0
1	241797629	.	A	G	11	6	17	0	0	17	0	0
1	242042301	rs1047840	G	A	5	3	8	0	0	8	0	0
1	242042454	rs61736331	C	G	7	9	16	0	0	16	0	0
1	243392766	.	T	C	4	4	8	0	0	8	0	0
1	243396119	rs6669104	C	T	1	8	9	0	0	9	0	0
1	243416525	rs3904683	T	C	3	4	7	0	0	7	0	0
1	243419429	rs3904682	T	A	50	32	82	0	1	83	0	0
1	243451853	rs12748870	T	A	10	9	19	0	2	21	0	0
1	243468694	rs12759571	C	A	2	6	8	0	0	8	0	0
1	243469029	rs12758920	G	A	12	8	20	0	1	21	0	0
1	243481431	rs2783972	A	G	13	12	25	0	0	25	0	0
1	243481556	rs2636323	C	G	23	15	38	0	1	39	0	0
1	243493907	rs2275155	A	T	32	30	62	0	0	62	0	0
1	244572581	rs3087609	T	C	9	14	23	0	1	24	0	0
1	244583585	rs55648210	T	C	18	24	42	0	1	43	0	0
1	244613791	rs6667957	T	C	6	5	11	0	0	11	0	0
1	244614011	.	C	T	2	4	6	0	0	6	0	0
1	244816968	rs45437297	C	A	72	32	104	0	1	105	0	0
1	245004094	rs3191	T	G	17	32	49	0	0	50	1	0
1	245004623	rs41269399	G	A	33	31	64	0	0	64	0	0
1	245005085	rs12058012	G	C	17	28	45	0	0	45	0	0
1	245005373	rs10927335	A	G	9	10	19	0	0	19	0	0
1	245005713	rs12095737	A	C	13	15	28	0	0	28	0	0
1	245005828	rs12070200	C	T	18	12	30	0	0	30	0	0
1	245005841	rs12096894	T	A	17	11	28	0	2	30	0	0
1	245006827	rs1053700	A	G	109	142	251	0	4	255	0	0
1	245007679	.	C	G	195	216	411	0	4	415	0	0
1	245008275	rs143753993	A	G	100	86	186	0	1	187	0	0
1	245012509	rs12146095	T	G	3	9	12	0	0	12	0	0
1	245013807	rs1495946	G	A	5	4	9	0	1	10	0	0
1	245018555	.	G	A	19	11	30	0	0	30	0	0
1	245018624	rs10927336	C	A	20	18	38	0	0	38	0	0
1	245020285	rs1874393	T	C	3	7	10	0	0	10	0	0
1	245023311	rs12069105	G	A	23	18	41	0	1	42	0	0
1	245023365	rs12079538	C	T	21	17	38	0	0	38	0	0
1	245023418	.	G	A	16	14	30	0	0	30	0	0
1	245025692	rs12124462	A	T	29	25	54	0	2	56	0	0
1	245133489	rs7545078	T	G	7	6	13	0	0	13	0	0
1	245133662	rs61844237	G	C	17	12	29	0	0	29	0	0
1	245134114	rs2291426	A	C	0	6	6	0	0	6	0	0
1	245134683	rs6695687	T	A	3	4	7	0	0	7	0	0
1	245136033	rs6701858	T	C	2	5	7	0	0	7	0	0
1	245245402	rs10927387	C	T	21	39	60	0	1	61	0	0
1	245251020	rs1047707	G	T	3	24	27	0	0	27	0	0
1	245252343	rs11806396	G	A	2	10	12	0	0	12	0	0
1	246021941	rs2362587	T	C	425	356	781	0	4	785	0	0
1	246330026	rs191834451	C	T	2	5	7	0	0	7	0	0
1	246670481	rs7520453	C	G	36	33	69	0	0	69	0	0
1	246704563	rs764243	C	T	8	6	14	0	0	14	0	0
1	246704684	rs3124107	G	A	4	12	16	0	0	16	0	0
1	246704690	rs3129566	A	G	4	12	16	0	0	16	0	0
1	246705165	rs3120697	A	C	6	9	15	0	0	15	0	0
1	246705277	rs3129567	A	G	3	6	9	0	0	9	0	0
1	246705416	rs2340790	T	C	7	1	8	0	0	8	0	0
1	246705754	rs3124110	A	T	0	8	8	0	1	9	0	0
1	246705830	rs3124111	C	G	2	6	8	0	0	8	0	0
1	246705935	rs3124112	C	T	3	9	12	0	0	12	0	0
1	246706253	rs3124113	A	G	1	5	6	0	1	7	0	0
1	246706839	rs3124115	G	T	4	4	8	0	0	8	0	0
1	246707051	rs3124116	G	C	1	6	7	0	0	7	0	0
1	246707858	rs3129568	A	G	222	203	425	0	5	430	0	0
1	246708165	rs7527607	C	T	3	3	6	0	0	6	0	0
1	246708846	rs4545307	G	A	5	2	7	0	0	7	0	0
1	246712409	rs3129576	G	C	28	13	41	0	1	42	0	0
1	246713047	rs7517472	G	A	4	14	18	0	0	18	0	0
1	246713067	rs7517536	G	A	5	12	17	0	0	17	0	0
1	246713240	rs7526671	C	G	16	23	39	0	0	39	0	0
1	246713684	rs4654289	G	C	19	15	34	0	1	35	0	0
1	246713736	rs3120705	A	G	19	11	30	0	2	32	0	0
1	246713912	rs4654121	G	A	9	9	18	0	0	18	0	0
1	246714058	rs4654290	G	A	5	8	13	0	0	13	0	0
1	246714150	rs7537146	T	A	7	17	24	0	0	24	0	0
1	246714426	rs12140400	A	G	11	18	29	0	0	29	0	0
1	246714587	rs10754526	G	A	182	140	322	0	4	326	0	0
1	246714631	rs80342781	T	A	4	12	16	0	1	17	0	0
1	246714632	rs75477023	G	A	4	13	17	0	0	17	0	0
1	246714636	rs34850511	T	A	4	11	15	0	0	15	0	0
1	246714799	rs3124069	G	A	14	8	22	0	1	23	0	0
1	246714837	rs3124070	T	C	18	8	26	0	0	26	0	0
1	246714865	rs10737793	G	A	7	15	22	0	0	22	0	0
1	246714878	rs3129577	G	C	16	5	21	0	0	21	0	0
1	246714886	rs10737794	C	T	7	12	19	0	0	19	0	0
1	246715307	rs10465615	C	A	4	12	16	0	0	16	0	0
1	246715469	rs12119242	C	T	7	15	22	0	0	22	0	0
1	246715961	rs2340791	A	G	7	15	22	0	1	23	0	0
1	246716019	rs12138869	T	C	4	7	11	0	0	11	0	0
1	246716048	rs2340792	T	A	2	5	7	0	0	7	0	0
1	246716505	rs55873125	A	G	6	5	11	0	1	12	0	0
1	246716517	rs56177973	C	T	6	5	11	0	1	12	0	0
1	246716604	rs4654291	C	T	7	5	12	0	0	12	0	0
1	246716949	rs56263741	G	A	10	3	13	0	0	13	0	0
1	246717298	rs12082288	T	C	5	11	16	0	0	16	0	0
1	246717371	rs10465618	C	T	12	12	24	0	0	24	0	0
1	246717391	rs55741541	A	G	11	10	21	0	0	21	0	0
1	246717466	rs56367289	G	A	9	5	14	0	2	16	0	0
1	246717807	rs3129580	T	A	13	12	25	0	0	25	0	0
1	246717818	rs61852366	C	T	11	10	21	0	0	21	0	0
1	246718151	.	C	A	6	4	10	0	0	10	0	0
1	246722561	rs3124072	T	C	7	2	9	0	0	9	0	0
1	246723313	rs2341679	C	T	8	17	25	0	0	25	0	0
1	246725264	rs10924779	T	C	2	6	8	0	0	8	0	0
1	246727010	rs6701836	C	T	3	4	7	0	0	7	0	0
1	246760570	rs3007401	C	G	11	11	22	0	0	22	0	0
1	246765806	rs74345749	A	G	8	3	11	0	0	11	0	0
1	246785113	rs6699673	A	C	59	51	110	0	0	111	1	0
1	246785396	rs72762787	C	T	3	3	6	0	0	6	0	0
1	246790756	rs4129249	G	A	6	4	10	0	0	10	0	0
1	246793230	rs6704315	C	T	3	4	7	0	0	7	0	0
1	246793783	rs7514190	C	T	2	5	7	0	0	7	0	0
1	246793880	rs7518651	A	G	0	8	8	0	0	8	0	0
1	246794947	rs6701256	G	A	4	3	7	0	0	7	0	0
1	246796098	rs4316336	G	C	5	5	10	0	0	10	0	0
1	246824840	rs10802429	T	A	5	2	7	0	0	7	0	0
1	246826667	rs10924797	C	T	4	2	6	0	0	6	0	0
1	246829616	rs4130648	T	C	27	37	64	0	0	64	0	0
1	246829742	rs1135644	T	C	28	29	57	0	0	57	0	0
1	246829873	rs3795472	G	A	36	40	76	0	1	77	0	0
1	246830293	rs3795471	A	G	38	49	87	0	0	87	0	0
1	246830488	rs4335342	T	C	22	27	49	0	2	51	0	0
1	246930564	rs7779	G	C	302	257	559	0	3	562	0	0
1	247010598	rs80329222	A	C	6	2	8	0	0	8	0	0
1	247010801	rs56070865	T	C	7	1	8	0	0	8	0	0
1	247027521	.	C	T	3	5	8	0	0	8	0	0
1	247048834	rs2642990	T	C	35	33	68	0	3	71	0	0
1	247149918	rs4971306	G	A	3	7	10	0	0	10	0	0
1	247149996	rs4971310	A	G	4	8	12	0	0	12	0	0
1	247150740	rs3749427	T	C	2	9	11	0	0	11	0	0
1	247151557	rs2642992	A	G	6	5	11	0	1	12	0	0
1	247319489	rs3767857	G	A	6	4	10	0	0	10	0	0
1	247353783	rs12071728	T	C	31	49	80	0	0	80	0	0
1	247354072	rs6663099	C	A	31	26	57	0	0	57	0	0
1	247354581	rs6678604	A	C	2	8	10	0	0	10	0	0
1	247361877	rs12732373	G	T	1	12	13	0	0	13	0	0
1	247361918	.	A	C	14	1	15	0	0	15	0	0
1	247363397	rs11805511	T	C	38	29	67	0	1	68	0	0
1	247363589	rs11805544	T	G	18	12	30	0	0	30	0	0
1	247363863	rs11807412	A	T	21	13	34	0	0	34	0	0
1	247364329	rs56029850	A	C	5	6	11	0	0	11	0	0
1	247364344	rs55643126	A	G	8	7	15	0	0	15	0	0
1	247364560	rs76520525	T	C	20	10	30	0	3	33	0	0
1	247364604	rs111648317	A	G	18	10	28	0	1	29	0	0
1	247364646	rs112524571	T	C	13	7	20	0	0	20	0	0
1	247365061	rs77886725	T	C	29	17	46	0	0	46	0	0
1	247365152	rs78194184	T	C	34	18	52	0	2	54	0	0
1	247371918	rs7555638	T	C	22	62	84	0	1	85	0	0
1	247372130	.	A	G	18	43	61	0	1	62	0	0
1	247372163	rs17269923	G	T	20	30	50	0	0	50	0	0
1	247372672	rs6691539	C	T	12	45	57	0	0	57	0	0
1	247373631	rs7547697	C	T	5	9	14	0	0	14	0	0
1	247462701	rs1616299	C	T	60	55	115	0	0	115	0	0
1	247465278	rs112310657	G	A	4	3	7	0	0	7	0	0
1	247468146	rs9426180	G	T	5	5	10	0	0	10	0	0
1	247468572	rs9426181	G	A	2	8	10	0	0	10	0	0
1	247485162	rs150224217	G	A	5	2	7	0	0	7	0	0
1	247579749	rs72553860	A	G	1	5	6	0	0	6	0	0
1	247587408	rs7525979	C	T	86	49	135	0	2	138	1	0
1	247588858	rs35829419	C	A	80	70	150	0	0	150	0	0
1	247595850	rs10925019	C	T	2	4	6	0	0	6	0	0
1	247597281	.	A	G	3	3	6	0	0	6	0	0
1	247607973	rs139814109	C	T	125	84	209	0	3	212	0	0
1	247612036	rs10754558	G	C	51	81	132	0	2	134	0	0
1	247737928	rs12401701	A	T	82	52	134	0	13	147	0	0
1	247739213	rs12402077	A	G	63	38	101	0	0	101	0	0
1	247740764	rs12405268	C	A	66	38	104	0	1	105	0	0
1	248028219	rs946696	G	A	61	68	129	0	1	130	0	0
1	248039451	rs3811444	C	T	20	16	36	0	0	36	0	0
1	248059423	rs10888267	C	T	26	26	52	0	1	53	0	0
1	248059456	rs12135078	G	A	32	20	52	0	1	53	0	0
10	856918	rs4229	A	T	8	9	17	0	0	17	0	0
10	858022	rs9124	C	T	16	22	38	0	1	39	0	0
10	858394	rs7703	C	T	12	20	32	0	1	33	0	0
10	890252	rs10904575	G	A	5	2	7	0	0	7	0	0
10	954957	rs6560859	A	G	2	5	7	0	0	7	0	0
10	954972	rs11253503	T	C	3	3	6	0	0	6	0	0
10	955506	rs56318703	C	T	4	2	6	0	0	6	0	0
10	980785	rs35028518	C	T	5	4	9	0	0	9	0	0
10	981015	rs34405399	G	A	10	7	17	0	0	17	0	0
10	3141970	rs11251716	C	G	6	0	6	0	0	6	0	0
10	3145045	rs34543032	T	C	3	4	7	0	0	7	0	0
10	3145097	rs8181285	G	A	4	5	9	0	0	9	0	0
10	3146760	rs11251720	C	T	11	5	16	0	1	17	0	0
10	3147096	rs4424569	C	G	10	13	23	0	0	23	0	0
10	3147099	rs4469783	G	A	10	12	22	0	0	22	0	0
10	3147192	rs4256893	G	A	10	8	18	0	0	18	0	0
10	3147456	rs4271292	C	T	7	4	11	0	0	11	0	0
10	3147501	rs4881081	C	T	5	2	7	0	0	7	0	0
10	3147508	rs4881082	C	T	5	3	8	0	0	8	0	0
10	3155353	rs3816699	C	T	71	61	132	0	2	134	0	0
10	3155620	rs1052309	A	G	54	74	128	0	0	128	0	0
10	3155698	rs4881086	C	T	91	69	160	0	2	163	1	0
10	3156642	rs4281389	T	C	5	1	6	0	0	6	0	0
10	3156877	rs4881092	C	A	1	5	6	0	0	6	0	0
10	3156900	rs11251723	T	C	7	1	8	0	0	8	0	0
10	3156901	rs11251724	G	A	7	1	8	0	0	8	0	0
10	3157094	rs35375917	C	A	5	1	6	0	2	8	0	0
10	3157109	rs34260521	T	C	6	3	9	0	0	9	0	0
10	3157131	rs12250915	A	T	5	3	8	0	1	9	0	0
10	3157230	rs34795068	C	T	6	1	7	0	0	7	0	0
10	3157895	rs9423680	A	T	1	8	9	0	0	9	0	0
10	3158646	rs7916889	A	G	3	4	7	0	0	7	0	0
10	3158848	rs7086902	C	T	11	5	16	0	0	16	0	0
10	3163585	rs9423467	C	T	4	2	6	0	0	6	0	0
10	3165364	rs116187356	C	T	9	6	15	0	0	15	0	0
10	3166345	rs9423479	G	A	8	0	8	0	0	8	0	0
10	3167109	rs730141	C	T	7	1	8	0	0	8	0	0
10	3175917	rs4881105	C	G	6	3	9	0	0	9	0	0
10	3177111	rs9423698	C	G	9	5	14	0	0	14	0	0
10	3177488	rs71477811	A	G	13	6	19	0	1	20	0	0
10	3178815	rs9063	G	C	73	90	163	0	3	166	0	0
10	3178865	rs543	G	A	70	44	114	0	0	114	0	0
10	3178881	rs1053000	C	T	46	61	107	0	1	108	0	0
10	3180298	rs10175	C	T	132	148	280	0	4	284	0	0
10	3180759	rs9423495	G	A	26	38	64	0	0	64	0	0
10	3181126	rs17849904	C	T	123	112	235	0	3	238	0	0
10	3186458	rs3752803	C	G	3	6	9	0	0	9	0	0
10	3205745	rs7070745	T	C	5	2	7	0	0	7	0	0
10	3207632	rs3814596	A	G	39	41	80	0	1	81	0	0
10	3214942	rs11818724	T	C	20	9	29	0	0	29	0	0
10	3819714	rs1043009	C	T	1677	1646	3323	0	19	3342	0	0
10	3820787	rs1043003	T	C	973	1013	1986	0	16	2002	0	0
10	3821327	rs7634	A	T	866	695	1561	0	11	1573	1	0
10	3821506	rs1050046	G	A	1019	1039	2058	0	10	2069	1	0
10	3821561	rs17731	G	A	1092	1061	2153	0	20	2175	2	0
10	3823419	rs12221160	A	G	36	40	76	0	0	76	0	0
10	3826151	rs71477837	T	G	25	24	49	0	1	50	0	0
10	5136651	rs12529	C	G	6	3	9	0	0	9	0	0
10	5138747	rs11551177	A	G	1	7	8	0	0	8	0	0
10	5149703	rs3209896	G	A	8	0	8	0	1	9	0	0
10	5324796	.	T	C	7	0	7	0	0	7	0	0
10	5470248	rs11253172	T	A	0	6	6	0	0	6	0	0
10	5488580	rs7090012	C	G	4	2	6	0	0	6	0	0
10	5490932	rs12570751	A	T	6	8	14	0	0	14	0	0
10	5491495	rs56676146	A	G	5	5	10	0	0	10	0	0
10	5495157	rs11253185	A	G	5	3	8	0	0	8	0	0
10	5498248	rs4242790	G	T	9	2	11	0	0	11	0	0
10	5498390	rs10904507	C	T	4	10	14	0	0	14	0	0
10	5499173	rs11791	A	G	171	152	323	0	7	330	0	0
10	5681783	rs11256474	C	T	15	15	30	0	0	30	0	0
10	5682135	rs79839285	C	G	17	15	32	0	0	32	0	0
10	5682614	rs3750643	G	A	11	16	27	0	1	28	0	0
10	5773034	rs45584541	A	G	5	5	10	0	0	10	0	0
10	5781628	rs2254067	T	G	10	8	18	0	0	18	0	0
10	5781969	rs2797486	A	T	6	5	11	0	0	11	0	0
10	5788608	rs2797491	G	C	9	5	14	0	0	14	0	0
10	5807608	rs2497	A	G	404	353	757	0	3	760	0	0
10	5920121	rs1052420	T	C	5	9	14	0	0	14	0	0
10	5925971	rs631947	C	A	6	7	13	0	0	13	0	0
10	5967176	rs11255971	C	T	5	2	7	0	0	7	0	0
10	5979497	rs2387091	A	T	12	6	18	0	0	18	0	0
10	6138153	rs7100767	T	A	2	4	6	0	0	6	0	0
10	6141942	rs7902931	A	G	4	5	9	0	0	9	0	0
10	6148897	rs7904213	C	T	12	9	21	0	0	21	0	0
10	6149037	rs12778662	C	T	10	5	15	0	0	15	0	0
10	6151538	rs72777814	C	T	3	3	6	0	0	6	0	0
10	6155806	rs2274359	T	C	4	6	10	0	0	10	0	0
10	6155847	rs2274358	A	G	4	7	11	0	1	12	0	0
10	6155870	rs2274357	T	C	11	4	15	0	1	16	0	0
10	6188591	rs7074372	A	G	3	3	6	0	0	6	0	0
10	6259541	rs10906023	A	C	19	9	28	0	1	29	0	0
10	6266128	rs35050271	C	T	233	256	489	0	9	498	0	0
10	6268422	rs943117	A	G	20	20	40	0	0	40	0	0
10	6269855	rs7071157	T	C	19	12	31	0	1	32	0	0
10	6270511	rs12357847	A	G	14	8	22	0	0	22	0	0
10	6270618	rs56341765	A	T	22	17	39	0	1	40	0	0
10	6274211	rs11257453	G	A	4	3	7	0	1	8	0	0
10	6274511	rs11257456	T	G	37	31	68	0	2	70	0	0
10	6275135	rs41291285	C	T	291	288	579	0	2	581	0	0
10	6275145	rs1539232	T	C	265	279	544	0	5	549	0	0
10	6275498	rs11541590	G	A	309	358	667	0	5	672	0	0
10	6275784	rs3829148	C	G	334	298	632	0	3	635	0	0
10	6276574	rs1064891	T	C	385	303	688	0	5	693	0	0
10	6276743	rs1539234	G	A	454	535	989	0	6	995	0	0
10	6469155	rs582052	G	T	10	5	15	0	1	16	0	0
10	6469817	rs2236380	A	G	34	31	65	0	0	65	0	0
10	6472891	rs11258747	G	T	19	23	42	0	0	42	0	0
10	6495816	rs11595746	A	G	2	4	6	0	0	6	0	0
10	6498723	rs11258943	G	A	31	44	75	0	1	76	0	0
10	6875062	rs28817002	T	C	6	0	6	0	0	6	0	0
10	6875345	rs10752092	C	A	2	9	11	0	1	12	0	0
10	7202028	rs2692760	C	T	12	10	22	0	0	22	0	0
10	7203228	rs2692758	G	A	5	9	14	0	1	15	0	0
10	7203237	rs9665413	C	T	9	6	15	0	0	15	0	0
10	7204878	rs10795530	A	G	5	8	13	0	0	13	0	0
10	7808086	rs3736968	T	C	3	7	10	0	0	10	0	0
10	7841582	rs1244425	G	T	19	5	24	0	0	24	0	0
10	7844906	rs1244431	T	G	5	3	8	0	0	8	0	0
10	7845298	rs1244432	T	A	7	7	14	0	0	14	0	0
10	7845590	rs762452	A	G	3	5	8	0	0	8	0	0
10	7845769	rs762453	G	A	3	3	6	0	0	6	0	0
10	7846974	rs1244434	C	T	5	13	18	0	0	18	0	0
10	7847441	rs1244435	G	T	4	4	8	0	0	8	0	0
10	7847802	rs1137807	C	T	8	5	13	0	0	13	0	0
10	7847990	rs1137808	G	A	5	7	12	0	0	12	0	0
10	7848227	rs2853758	T	A	1	7	8	0	0	9	1	0
10	7848481	rs1244438	G	A	3	6	9	0	0	9	0	0
10	7848604	rs1244439	A	G	3	6	9	0	0	9	0	0
10	7849054	rs2853759	G	T	4	11	15	0	1	16	0	0
10	7849312	rs1057447	T	C	8	6	14	0	0	14	0	0
10	7849688	rs4655	T	C	491	510	1001	0	2	1003	0	0
10	11207045	rs61832289	G	A	7	7	14	0	0	14	0	0
10	11232306	rs7070821	A	G	5	2	7	0	0	7	0	0
10	11232579	rs622981	T	A	4	18	22	0	0	22	0	0
10	11233174	rs10905915	C	G	7	1	8	0	0	8	0	0
10	11235174	rs7084916	A	G	12	10	22	0	0	22	0	0
10	11237032	rs6602481	C	T	6	2	8	0	0	8	0	0
10	11239462	rs74756975	C	T	2	10	12	0	0	12	0	0
10	11246251	rs79560499	T	C	8	4	12	0	0	12	0	0
10	11250632	rs144660889	G	A	6	5	11	0	0	11	0	0
10	11260440	rs74341064	C	A	0	6	6	0	0	6	0	0
10	11268348	rs74582934	A	G	6	5	11	0	0	11	0	0
10	11268412	rs79044562	G	A	1	5	6	0	0	6	0	0
10	11269195	rs73579348	T	C	6	12	18	0	0	18	0	0
10	11269900	rs73579349	G	A	10	9	19	0	1	20	0	0
10	11272601	rs60149122	T	G	6	4	10	0	0	10	0	0
10	11272938	rs76527036	T	C	5	15	20	0	0	20	0	0
10	11272946	rs56116757	C	T	14	5	19	0	0	19	0	0
10	11302376	.	A	G	9	13	22	0	0	22	0	0
10	11359469	rs3781053	G	A	5	3	8	0	0	8	0	0
10	11360673	rs2279809	A	G	4	5	9	0	0	9	0	0
10	11363811	rs2134360	T	C	4	6	10	0	0	10	0	0
10	11364202	rs4750043	G	A	5	7	12	0	0	12	0	0
10	11364336	rs4747901	G	T	10	4	14	0	0	14	0	0
10	11364607	rs75669541	T	G	3	4	7	0	1	8	0	0
10	11367045	rs12261260	C	A	19	13	32	0	0	32	0	0
10	11367447	rs10905930	C	T	40	25	65	0	0	65	0	0
10	11368046	rs140364458	C	T	7	7	14	0	0	14	0	0
10	11368747	rs12268544	G	A	6	4	10	0	0	10	0	0
10	11369250	rs2378991	G	A	3	4	7	0	0	7	0	0
10	11369870	rs9329334	C	T	4	9	13	0	0	13	0	0
10	11377471	rs3814629	A	G	20	15	35	0	0	35	0	0
10	11498866	rs34665912	G	A	5	7	12	0	0	12	0	0
10	11499731	rs12359186	A	C	5	5	10	0	0	10	0	0
10	11505175	rs3740204	A	G	19	20	39	0	0	39	0	0
10	11606535	rs117158423	T	C	36	42	78	0	0	78	0	0
10	11797500	rs35986488	G	A	7	6	13	0	0	13	0	0
10	11805339	rs17850531	C	T	8	8	16	0	0	16	0	0
10	11892162	rs10906026	T	C	4	11	15	0	0	15	0	0
10	11913907	rs11257370	A	T	7	5	12	0	1	13	0	0
10	11915351	rs7902251	G	A	4	3	7	0	0	7	0	0
10	11915899	rs4359104	C	T	4	4	8	0	0	8	0	0
10	11916208	rs11257373	C	G	4	6	10	0	1	11	0	0
10	11935715	rs10752249	C	G	5	3	8	0	0	8	0	0
10	11935759	rs72775956	C	T	5	4	9	0	0	9	0	0
10	11996399	.	G	A	4	3	7	0	0	7	0	0
10	12062814	rs10906050	T	C	2	6	8	0	0	8	0	0
10	12068542	rs12415637	C	T	16	20	36	0	0	36	0	0
10	12069476	rs11257489	A	G	10	13	23	0	0	23	0	0
10	12069562	rs7079622	T	C	12	17	29	0	0	29	0	0
10	12071397	rs11257490	G	A	42	34	76	0	1	77	0	0
10	12081623	.	T	C	5	5	10	0	1	11	0	0
10	12081910	rs7090241	G	T	1	5	6	0	0	6	0	0
10	12131081	rs3740015	T	G	5	5	10	0	0	10	0	0
10	12131218	rs3740016	C	T	7	10	17	0	1	18	0	0
10	12149939	rs1722462	C	T	7	10	17	0	0	17	0	0
10	12236858	rs10906095	G	A	2	4	6	0	0	6	0	0
10	12288264	.	C	T	485	392	877	0	1	878	0	0
10	12416472	rs7093350	A	G	4	4	8	0	0	8	0	0
10	12596252	rs2492945	C	G	8	3	11	0	0	11	0	0
10	12596303	rs2478972	T	C	4	2	6	0	0	6	0	0
10	12596614	rs11257884	G	A	10	0	10	0	0	10	0	0
10	12596669	rs2249796	A	G	9	0	9	0	0	9	0	0
10	12596789	rs2249801	T	C	10	1	11	0	0	11	0	0
10	12711949	rs7905192	C	T	6	3	9	0	0	9	0	0
10	12803670	rs4237428	G	A	27	25	52	0	0	52	0	0
10	12867598	rs1757051	C	G	32	33	65	0	0	65	0	0
10	12868304	rs1644391	A	C	6	4	10	0	0	10	0	0
10	12872880	rs2431623	A	G	12	9	21	0	0	21	0	0
10	12873925	rs1757064	T	G	7	13	20	0	0	20	0	0
10	12873956	rs756002	G	T	9	14	23	0	0	23	0	0
10	12873964	rs1644397	G	A	11	14	25	0	0	25	0	0
10	12874283	rs1644398	T	C	20	21	41	0	0	41	0	0
10	12874332	rs1644399	T	C	18	24	42	0	0	42	0	0
10	12874421	rs1757065	A	G	13	15	28	0	1	29	0	0
10	12874715	rs2431621	T	G	19	15	34	0	1	35	0	0
10	12874969	rs1644400	G	C	10	21	31	0	1	32	0	0
10	12875285	rs2431636	G	A	5	5	10	0	0	10	0	0
10	12875451	rs2431635	G	T	14	15	29	0	1	30	0	0
10	12875491	rs2431634	A	G	20	17	37	0	0	37	0	0
10	12876247	rs1047721	T	C	20	19	39	0	0	39	0	0
10	13243688	rs11258249	C	T	6	0	6	0	0	6	0	0
10	13244255	rs118168867	G	T	3	4	7	0	0	7	0	0
10	13342902	rs36143400	C	T	2	4	6	0	0	6	0	0
10	13343488	rs7914269	C	A	9	3	12	0	0	12	0	0
10	13343521	rs6602647	A	C	8	3	11	0	0	11	0	0
10	13344169	rs3758423	G	A	21	10	31	0	0	31	0	0
10	13361421	rs10906347	C	T	7	2	9	0	0	9	0	0
10	13361976	rs1747683	A	G	1	5	6	0	0	6	0	0
10	13375906	rs10752297	T	C	68	72	140	0	0	140	0	0
10	13382754	rs10752298	T	C	7	6	13	0	0	13	0	0
10	13653653	rs1135102	A	G	57	67	124	0	1	125	0	0
10	14227649	rs11258928	C	T	2	4	6	0	0	6	0	0
10	14886908	rs41284451	G	A	17	10	27	0	0	27	0	0
10	14891406	rs17155992	G	A	10	15	25	0	0	25	0	0
10	14891524	rs45606139	A	G	61	124	185	0	7	192	0	0
10	14943176	rs61730323	C	G	11	7	18	0	0	18	0	0
10	14949127	.	G	A	37	40	77	0	0	77	0	0
10	14949192	.	G	A	46	32	78	0	0	78	0	0
10	14974905	rs12768894	T	C	22	14	36	0	0	37	1	0
10	14976414	rs7076862	G	A	23	16	39	0	0	39	0	0
10	14976727	rs35441642	G	C	24	22	46	0	0	46	0	0
10	15139633	rs3858175	C	T	2	6	8	0	0	8	0	0
10	15145855	rs15772	C	G	43	35	78	0	0	78	0	0
10	15146061	rs34040166	C	G	49	44	93	0	0	93	0	0
10	15148547	rs913038	G	A	2	4	6	0	0	6	0	0
10	16729607	rs7076105	C	G	3	7	10	0	0	10	0	0
10	16934034	rs2669150	C	G	0	14	14	0	0	14	0	0
10	17204187	rs11254413	G	A	3	3	6	0	0	6	0	0
10	17216556	rs2273734	C	T	11	6	17	0	2	19	0	0
10	17270912	rs3758412	A	G	18	21	39	0	0	39	0	0
10	17271110	rs3758411	G	C	6	13	19	0	0	19	0	0
10	17271400	rs3758410	G	C	836	868	1704	0	5	1709	0	0
10	17276066	rs57465155	C	T	28	26	54	0	0	54	0	0
10	17278171	.	C	G	305	208	513	0	5	518	0	0
10	17278800	rs11254468	C	T	54	63	117	0	0	117	0	0
10	17279517	rs3249	C	T	921	871	1792	0	27	1819	0	0
10	17421418	rs359324	G	C	7	6	13	0	0	13	0	0
10	17428774	rs371210	C	T	8	10	18	0	0	18	0	0
10	17428781	rs436491	C	T	9	9	18	0	0	18	0	0
10	17428782	rs436489	C	T	9	9	18	0	0	18	0	0
10	17428910	rs436299	C	G	17	20	37	0	0	37	0	0
10	17428971	rs366032	T	A	6	7	13	0	0	13	0	0
10	17488220	rs72778947	C	G	3	5	8	0	0	8	0	0
10	17639569	rs12774136	A	G	4	7	11	0	0	11	0	0
10	17654585	rs4237347	A	G	7	6	13	0	0	13	0	0
10	17654656	rs113884290	A	T	6	4	10	0	0	10	0	0
10	17655931	rs17141421	G	T	8	10	18	0	0	18	0	0
10	17655981	rs2461891	T	C	5	9	14	0	1	15	0	0
10	17657152	rs7918263	A	T	6	2	8	0	0	8	0	0
10	17657708	.	G	C	24	22	46	0	0	46	0	0
10	17686234	rs45579031	G	A	49	65	114	0	0	114	0	0
10	17686334	rs17141457	C	T	180	196	376	0	2	378	0	0
10	17741690	rs11595520	A	G	5	4	9	0	0	9	0	0
10	17745588	rs4748403	A	T	3	3	6	0	0	6	0	0
10	17745593	rs4748404	C	A	3	3	6	0	0	6	0	0
10	17746301	rs17141517	C	A	6	3	9	0	0	9	0	0
10	17750968	rs17464580	T	G	6	13	19	0	0	19	0	0
10	17751002	rs2272143	A	T	15	5	20	0	0	20	0	0
10	17751054	rs61842352	C	T	6	11	17	0	0	17	0	0
10	17753941	rs10508543	C	T	6	2	8	0	0	8	0	0
10	17754809	rs74118021	T	C	6	6	12	0	0	12	0	0
10	17754907	rs74118022	T	G	5	2	7	0	0	7	0	0
10	17755188	rs74118023	C	T	6	7	13	0	0	13	0	0
10	17755290	rs7075270	A	C	8	3	11	0	0	11	0	0
10	17755935	rs11596639	G	T	10	11	21	0	0	21	0	0
10	18801647	rs4748480	A	G	13	14	27	0	0	27	0	0
10	18801761	rs7073651	A	G	23	20	43	0	1	44	0	0
10	18802307	rs10741091	C	G	16	15	31	0	0	31	0	0
10	18829261	rs4748484	T	A	5	5	10	0	0	10	0	0
10	18829262	rs4748485	A	T	5	5	10	0	0	10	0	0
10	18940157	rs3740102	C	A	18	14	32	0	0	32	0	0
10	18964840	rs6482597	A	G	7	15	22	0	0	22	0	0
10	18966741	rs1055114	T	C	17	13	30	0	0	30	0	0
10	18966867	rs1055116	T	C	10	14	24	0	0	24	0	0
10	18966907	rs10741129	A	G	14	13	27	0	0	27	0	0
10	18967608	rs45499092	T	G	17	29	46	0	1	47	0	0
10	18970125	rs11540308	T	C	58	59	117	0	0	117	0	0
10	20506418	rs3817405	G	A	11	4	15	0	0	15	0	0
10	20534333	rs2778979	A	G	7	3	10	0	0	10	0	0
10	20569460	rs2778958	A	G	5	1	6	0	0	6	0	0
10	20575529	rs67447432	A	T	2	4	6	0	0	6	0	0
10	21783634	rs12770228	G	A	0	7	7	0	1	8	0	0
10	21803617	rs117517077	C	T	11	0	11	0	0	11	0	0
10	21806832	rs946711	A	C	0	10	10	0	0	10	0	0
10	21827796	rs1802669	G	A	27	75	102	0	0	102	0	0
10	22031556	rs78154192	C	A	80	24	104	0	5	109	0	0
10	22154881	rs148543003	T	C	18	0	18	0	0	18	0	0
10	22156520	rs114914389	C	T	14	0	14	0	0	14	0	0
10	22158613	rs112391882	T	G	7	0	7	0	0	7	0	0
10	22161740	rs77219229	A	C	6	0	6	0	0	6	0	0
10	22169146	rs76179804	C	T	18	0	18	0	0	18	0	0
10	22292482	rs114829490	C	A	20	0	20	0	0	20	0	0
10	22724646	rs55927891	G	A	21	1	22	0	0	22	0	0
10	22725413	rs7073797	G	T	0	16	16	0	0	16	0	0
10	22726093	rs73598518	A	G	12	0	12	0	0	12	0	0
10	23408278	rs7427	C	T	31	156	187	0	0	187	0	0
10	24872645	rs145297844	G	A	62	28	90	0	0	90	0	0
10	26727636	rs4749125	G	C	13	15	28	0	1	29	0	0
10	26727682	rs4749126	C	A	15	11	26	0	0	26	0	0
10	26727737	rs2992334	T	C	28	22	50	0	1	51	0	0
10	26733172	rs6482560	C	T	3	6	9	0	0	9	0	0
10	26733201	rs6482561	C	T	2	4	6	0	0	6	0	0
10	26733355	rs4747559	G	A	3	3	6	0	0	6	0	0
10	26791566	rs787038	A	G	17	9	26	0	2	28	0	0
10	26791667	rs74463104	C	T	19	18	37	0	0	37	0	0
10	27030431	rs7918403	C	A	4	4	8	0	0	8	0	0
10	27035478	rs12776877	C	T	17	16	33	0	1	34	0	0
10	27042917	rs11015265	A	T	9	8	17	0	0	17	0	0
10	27044049	rs2368185	C	T	8	10	18	0	0	18	0	0
10	27045387	rs1031858	C	T	6	2	8	0	0	8	0	0
10	27048470	rs16927324	A	G	13	10	23	0	1	24	0	0
10	27050961	rs12416171	G	T	22	10	32	0	0	32	0	0
10	27054375	rs7915128	C	T	5	1	6	0	0	6	0	0
10	27317840	rs10829163	C	T	4	2	6	0	0	6	0	0
10	27399859	rs10829185	C	T	106	97	203	0	2	205	0	0
10	27400314	rs4749226	C	T	224	202	426	0	5	431	0	0
10	27404315	.	A	C	3	4	7	0	0	7	0	0
10	27412669	rs2274743	A	T	11	14	25	0	0	25	0	0
10	27413174	rs3932559	C	T	17	9	26	0	2	28	0	0
10	27414274	rs7909444	G	C	9	6	15	0	0	15	0	0
10	27414656	rs11015548	G	A	14	5	19	0	1	20	0	0
10	27414778	rs11015549	G	A	5	8	13	0	2	15	0	0
10	27415143	rs11015553	G	C	21	12	33	0	0	33	0	0
10	27415229	rs11015554	G	A	15	9	24	0	0	24	0	0
10	27415906	rs10829192	C	A	38	38	76	0	1	77	0	0
10	27416747	rs6482596	T	G	14	20	34	0	0	34	0	0
10	27417059	rs11015555	T	A	10	9	19	0	0	19	0	0
10	27417254	rs11015556	A	C	14	13	27	0	0	27	0	0
10	27418065	rs11015558	A	G	6	7	13	0	0	13	0	0
10	27418194	rs11015559	G	A	27	16	43	0	1	44	0	0
10	27418351	rs41282204	C	A	15	12	27	0	0	27	0	0
10	27418667	rs7921222	A	G	4	4	8	0	0	8	0	0
10	27419203	rs12255977	C	A	21	15	36	0	0	36	0	0
10	27419444	rs12571792	C	G	18	8	26	0	0	26	0	0
10	27419607	rs11015560	C	T	14	8	22	0	0	22	0	0
10	27419630	rs10829193	A	C	13	8	21	0	1	22	0	0
10	27420185	rs7901653	T	G	10	11	21	0	0	21	0	0
10	27427750	rs57132590	T	C	7	7	14	0	0	14	0	0
10	27434483	rs2274634	G	A	216	209	425	0	3	428	0	0
10	27434674	rs2274635	C	T	0	7	7	0	0	7	0	0
10	27434968	rs11015570	G	T	24	5	29	0	1	30	0	0
10	27436295	rs3780926	A	C	9	3	12	0	1	13	0	0
10	27436566	rs62622019	T	C	14	18	32	0	0	32	0	0
10	27443623	rs3758403	C	G	7	18	25	0	0	25	0	0
10	27443875	rs28365962	C	T	21	9	30	0	0	30	0	0
10	27444303	rs3824593	G	A	3	11	14	0	1	15	0	0
10	27444328	rs7919803	C	A	9	14	23	0	0	23	0	0
10	27444329	rs7907981	T	C	9	14	23	0	0	23	0	0
10	27459670	rs1981296	C	T	32	55	87	0	0	87	0	0
10	27459746	rs3802526	C	G	71	34	105	0	1	106	0	0
10	27469660	rs112164028	C	T	2	4	6	0	0	6	0	0
10	27469678	rs11015590	G	T	5	2	7	0	0	7	0	0
10	27475444	rs10741130	T	C	48	82	130	0	2	132	0	0
10	27475494	rs10764686	T	C	41	63	104	0	1	105	0	0
10	27475693	rs1338	T	C	5	7	12	0	0	12	0	0
10	27484837	rs11015603	A	C	36	32	68	0	1	69	0	0
10	27546560	rs11015626	T	C	0	7	7	0	0	7	0	0
10	28812059	rs2993991	A	G	97	58	155	0	1	156	0	0
10	28812066	rs2998283	C	T	94	55	149	0	2	151	0	0
10	28812514	rs200814819	T	G	77	21	98	0	3	101	0	0
10	28813672	rs2491252	G	C	30	64	94	0	0	94	0	0
10	28814237	rs2993992	C	T	13	6	19	0	1	20	0	0
10	28814292	rs2491251	A	G	12	15	27	0	0	27	0	0
10	28827826	rs186961843	T	C	9	11	20	0	1	21	0	0
10	28873202	rs2790462	C	T	3	3	6	0	0	6	0	0
10	28873205	rs332149	G	A	3	3	6	0	0	6	0	0
10	28874260	rs332151	G	T	4	2	6	0	0	6	0	0
10	28902261	rs332173	C	T	8	2	10	0	0	10	0	0
10	28902618	rs2532744	T	G	3	6	9	0	0	9	0	0
10	28903771	rs332174	G	A	5	8	13	0	0	13	0	0
10	29188056	rs61737115	T	C	8	0	8	0	0	8	0	0
10	29704320	rs193058483	C	T	33	43	76	0	1	77	0	0
10	29779914	rs148355552	C	T	12	16	28	0	0	28	0	0
10	29973512	rs1148225	G	A	5	2	7	0	0	7	0	0
10	30014073	rs10826682	C	T	22	7	29	0	0	29	0	0
10	30020918	rs7908314	C	A	17	7	24	0	0	24	0	0
10	30022317	rs56014178	G	A	3	4	7	0	0	7	0	0
10	30024725	rs34220528	C	T	11	17	28	0	0	28	0	0
10	30025226	rs34982281	A	T	4	3	7	0	0	7	0	0
10	30626003	rs12221163	C	T	11	6	17	0	0	17	0	0
10	30626222	rs11007998	G	A	5	8	13	0	0	13	0	0
10	30626669	rs10826782	C	T	6	6	12	0	0	12	0	0
10	30628326	rs2254837	G	C	5	4	9	0	0	9	0	0
10	30628340	rs59372240	G	A	4	5	9	0	0	9	0	0
10	30723026	rs8176952	G	A	11	11	22	0	0	22	0	0
10	30723706	rs1360119	C	A	23	15	38	0	0	38	0	0
10	31134214	rs3740236	A	G	5	7	12	0	0	12	0	0
10	31606279	rs11008457	A	G	6	4	10	0	1	11	0	0
10	31607215	rs3737178	A	G	8	6	14	0	0	14	0	0
10	31607231	rs3737179	T	G	8	6	14	0	0	14	0	0
10	31607361	rs3737180	G	C	6	7	13	0	0	13	0	0
10	31996242	rs2277251	G	T	4	3	7	0	0	7	0	0
10	31996312	rs2277252	G	A	4	3	7	0	0	7	0	0
10	32301260	rs1639132	G	A	3	4	7	0	0	7	0	0
10	32301290	rs12570362	C	A	7	4	11	0	0	11	0	0
10	32328526	rs1251363	G	C	4	2	6	0	0	6	0	0
10	32391505	rs211403	T	C	0	9	9	0	0	9	0	0
10	32635912	rs139607084	G	T	261	283	544	0	6	550	0	0
10	33165422	rs12217414	G	A	4	4	8	0	0	8	0	0
10	33189657	rs7217	C	T	0	56	56	0	0	56	0	0
10	33192235	rs2488316	G	A	4	7	11	0	0	11	0	0
10	33192651	rs11009136	A	G	12	11	23	0	1	24	0	0
10	33196703	rs2488319	T	C	3	3	6	0	0	6	0	0
10	33201128	rs2504020	C	G	10	8	18	0	0	18	0	0
10	33201257	rs2488321	G	A	12	7	19	0	0	19	0	0
10	33201742	rs10827160	T	G	7	7	14	0	0	14	0	0
10	33202639	rs2995463	G	A	8	8	16	0	0	16	0	0
10	33204951	rs2488325	C	T	4	2	6	0	0	6	0	0
10	33208720	rs3780876	T	C	3	3	6	0	0	6	0	0
10	33214802	rs2298141	A	G	105	102	207	0	1	208	0	0
10	33542835	rs7074620	T	C	9	8	17	0	0	17	0	0
10	33552695	rs2070296	C	T	8	4	12	0	0	12	0	0
10	33623251	rs3750733	G	A	11	11	22	0	0	22	0	0
10	35772402	rs3802509	G	A	215	152	367	0	4	371	0	0
10	35857000	rs10764048	A	G	4	2	6	0	0	6	0	0
10	35858665	rs1043583	T	C	131	120	251	0	2	253	0	0
10	43281089	rs7074877	T	C	35	26	61	0	0	61	0	0
10	43326627	rs7133	A	C	110	89	199	0	1	200	0	0
10	43679795	rs1059483	T	C	169	150	319	0	2	321	0	0
10	43881075	rs7905676	A	G	5	4	9	0	0	9	0	0
10	43881094	rs1126709	T	G	7	4	11	0	0	11	0	0
10	43883342	rs1126487	T	A	375	306	681	0	5	686	0	0
10	43883645	rs10793430	G	T	4	7	11	0	0	11	0	0
10	43893544	rs10732897	T	C	4	2	6	0	0	6	0	0
10	43897470	rs7894374	T	C	5	1	6	0	0	6	0	0
10	43899578	rs2265952	C	T	4	2	6	0	0	6	0	0
10	43916493	rs2066044	T	C	16	11	27	0	0	27	0	0
10	43917481	.	G	A	10	18	28	0	0	28	0	0
10	43977929	.	C	T	5	5	10	0	0	10	0	0
10	43978087	rs3750890	A	G	6	7	13	0	0	13	0	0
10	44145131	rs12248526	G	C	3	3	6	0	0	6	0	0
10	45951333	rs139209589	G	A	42	40	82	0	0	82	0	0
10	46007397	rs565266100	G	A	6	1	7	0	0	7	0	0
10	46281813	.	T	G	4	3	7	0	0	7	0	0
10	47708660	.	C	T	16	0	16	0	0	16	0	0
10	48235892	.	C	T	7	1	8	0	0	8	0	0
10	48901420	.	C	T	2	4	6	0	0	6	0	0
10	49239513	rs138900870	C	A	7	0	7	0	1	8	0	0
10	49541419	rs6537560	G	A	4	3	7	0	0	7	0	0
10	49618329	rs146454329	C	T	8	6	14	0	1	15	0	0
10	49618352	rs56361423	T	G	4	4	8	0	0	8	0	0
10	49643226	rs1062225	A	G	8	1	9	0	1	10	0	0
10	49643570	rs9284	T	G	101	50	151	0	0	151	0	0
10	49644416	rs8428	T	C	11	8	19	0	0	19	0	0
10	49654195	rs1051509	A	G	51	62	113	0	0	113	0	0
10	49654342	rs1051508	C	T	57	79	136	0	1	137	0	0
10	49654403	rs1051507	C	T	53	79	132	0	0	132	0	0
10	49659637	rs3827681	T	C	10	10	20	0	0	20	0	0
10	49659644	rs72796303	A	G	10	10	20	0	0	20	0	0
10	49701873	rs10745277	G	A	9	11	20	0	0	20	0	0
10	49702153	rs11101342	C	T	26	19	45	0	1	46	0	0
10	49704732	rs10857585	T	C	3	8	11	0	0	11	0	0
10	49732141	rs7089439	C	T	4	4	8	0	0	8	0	0
10	50013402	rs2170132	T	C	25	20	45	0	0	45	0	0
10	50040722	rs12761517	C	A	14	13	27	0	0	27	0	0
10	50109895	rs35423873	A	C	13	22	35	0	0	35	0	0
10	50184949	rs2271565	C	T	33	42	75	0	0	75	0	0
10	50186415	rs2292584	C	T	36	45	81	0	1	82	0	0
10	50362930	rs12198	C	T	35	41	76	0	0	76	0	0
10	50374930	rs45563932	C	T	28	39	67	0	1	68	0	0
10	50678717	rs2228526	T	C	3	4	7	0	0	7	0	0
10	50681033	rs2229760	G	A	5	2	7	0	0	7	0	0
10	51026705	rs8474	C	G	5	6	11	0	0	11	0	0
10	51274153	.	C	A	0	6	6	0	0	6	0	0
10	51464656	rs61850063	G	C	1	8	9	0	0	9	0	0
10	51620361	.	G	C	9	0	9	0	0	9	0	0
10	51623129	.	G	T	11	5	16	0	2	18	0	0
10	51623147	.	C	T	12	9	21	0	0	21	0	0
10	51623174	.	C	A	8	8	16	0	1	17	0	0
10	51623190	.	T	C	6	8	14	0	0	14	0	0
10	51632855	.	A	G	6	0	6	0	1	7	0	0
10	51632906	.	G	A	9	0	9	0	1	10	0	0
10	51632971	.	A	G	10	0	10	0	0	10	0	0
10	51633027	.	T	C	17	0	17	0	0	17	0	0
10	51725909	rs12359836	C	G	4	4	8	0	0	8	0	0
10	51726017	rs2490916	C	T	5	9	14	0	0	14	0	0
10	51728763	rs58853915	T	G	6	6	12	0	0	12	0	0
10	51748684	rs61848260	G	A	7	1	8	0	0	8	0	0
10	52094626	rs1436213	C	T	9	4	13	0	0	13	0	0
10	52102649	rs1114039	C	G	6	1	7	0	0	7	0	0
10	52103707	rs10763354	A	G	15	21	36	0	0	36	0	0
10	52350006	rs11006229	C	T	2	7	9	0	0	9	0	0
10	52389659	rs60177889	G	A	5	2	7	0	0	7	0	0
10	60155791	rs3876	C	T	43	29	72	0	2	74	0	0
10	60156584	rs11006133	G	A	16	18	34	0	0	34	0	0
10	60156595	rs16912200	A	G	17	19	36	0	0	36	0	0
10	60156864	rs41283696	C	T	19	25	44	0	0	44	0	0
10	60157339	rs7089361	C	T	14	16	30	0	0	30	0	0
10	61549215	rs1127327	C	A	114	98	212	0	5	217	0	0
10	61549818	rs11540401	A	G	114	170	284	0	3	287	0	0
10	61551428	rs10821594	T	C	13	18	31	0	1	32	0	0
10	61552692	rs1053266	G	T	161	152	313	0	1	314	0	0
10	62554474	rs10711	T	G	22	16	38	0	3	41	0	0
10	64564892	rs2236295	G	T	5	3	8	0	0	8	0	0
10	64564934	rs10995311	C	G	9	7	16	0	0	16	0	0
10	64566258	rs224082	C	T	27	43	70	0	0	70	0	0
10	64914372	rs13095	G	C	42	44	86	0	1	87	0	0
10	64927823	rs1935	C	G	483	447	930	0	2	932	0	0
10	64932779	rs1904296	C	G	25	15	40	0	0	40	0	0
10	64933268	rs4466712	G	C	22	13	35	0	0	35	0	0
10	64934331	rs10995453	T	C	10	8	18	0	0	18	0	0
10	64934548	rs10822145	C	T	14	6	20	0	0	20	0	0
10	64936361	rs10995455	G	A	4	4	8	0	0	8	0	0
10	64936679	rs907	A	G	6	2	8	0	0	8	0	0
10	64938404	rs10761721	T	G	3	3	6	0	0	6	0	0
10	64945364	rs3211105	G	A	266	263	529	0	5	534	0	0
10	64960536	rs10465990	G	A	6	5	11	0	0	11	0	0
10	64960717	rs7099425	C	T	4	2	6	0	0	6	0	0
10	64961412	rs7895472	G	A	2	6	8	0	0	8	0	0
10	64961659	rs7895610	C	T	9	6	15	0	0	15	0	0
10	64964148	rs12413730	C	T	3	3	6	0	0	6	0	0
10	64970448	rs1579045	G	A	28	23	51	0	0	51	0	0
10	64971490	rs147013699	A	C	12	7	19	0	0	19	0	0
10	64972176	rs7920159	C	G	10	10	20	0	0	20	0	0
10	64974319	.	T	C	69	58	127	0	2	129	0	0
10	64974537	rs10761725	A	T	54	57	111	0	0	111	0	0
10	67345248	rs7096393	G	C	2	4	6	0	0	6	0	0
10	69647219	.	T	C	29	27	56	0	0	56	0	0
10	69828710	rs1981181	T	G	10	3	13	0	0	13	0	0
10	69830266	rs1981180	G	A	16	11	27	0	0	27	0	0
10	70093537	rs10998073	C	G	9	13	22	0	0	22	0	0
10	70093561	rs10998074	C	A	10	12	22	0	0	22	0	0
10	70093965	rs12217908	A	G	10	16	26	0	0	26	0	0
10	70098646	rs1162760	T	A	76	41	117	0	1	118	0	0
10	70099433	rs76636639	A	G	2	5	7	0	0	7	0	0
10	70099472	.	T	C	5	6	11	0	0	11	0	0
10	70100250	rs7071140	A	G	9	13	22	0	0	22	0	0
10	70100355	rs1162757	A	G	14	11	25	0	0	25	0	0
10	70102749	rs3199937	C	A	119	102	221	0	0	221	0	0
10	70103461	rs17297439	G	A	4	4	8	0	0	8	0	0
10	70103958	rs2281697	A	G	5	5	10	0	0	10	0	0
10	70104320	rs2281698	T	C	4	14	18	0	0	18	0	0
10	70105560	rs1162753	G	A	8	5	13	0	0	13	0	0
10	70167004	rs7098448	T	C	5	6	11	0	0	11	0	0
10	70191631	rs61855090	C	T	4	9	13	0	0	13	0	0
10	70225504	rs3758626	G	T	6	7	13	0	0	13	0	0
10	70392375	rs1747	G	A	0	67	67	0	0	67	0	0
10	70502288	rs1300253	G	A	36	24	60	0	0	60	0	0
10	70518615	rs1694335	A	G	8	4	12	0	0	12	0	0
10	70519603	rs1566222	A	T	5	6	11	0	0	11	0	0
10	70520422	rs1782339	G	A	10	3	13	0	0	13	0	0
10	70536694	rs1149689	G	A	3	6	9	0	0	9	0	0
10	70536933	rs12146315	C	G	4	2	6	0	0	6	0	0
10	70849172	.	C	T	37	27	64	0	1	65	0	0
10	70849959	rs2855022	G	A	42	29	71	0	1	72	0	0
10	70850195	rs2805906	C	G	36	28	64	0	0	64	0	0
10	70851617	rs10998566	T	C	10	14	24	0	0	24	0	0
10	70855972	rs2855025	A	T	20	23	43	0	0	43	0	0
10	70856455	rs2805907	G	A	23	27	50	0	0	50	0	0
10	70856852	rs2229498	G	A	4269	3899	8168	0	46	8215	1	0
10	70931474	rs1802295	C	T	38	59	97	0	0	97	0	0
10	70959543	rs1506768	A	G	6	4	10	0	0	10	0	0
10	71103597	rs1133189	C	G	59	30	89	0	4	93	0	0
10	71143951	rs2305197	T	C	7	4	11	0	0	11	0	0
10	71155839	rs4746851	T	G	4	4	8	0	0	8	0	0
10	71164655	rs2229170	C	T	1	5	6	0	1	7	0	0
10	71267010	rs1052179	G	A	63	62	125	0	2	127	0	0
10	71335802	rs12769661	G	A	2	30	32	0	0	32	0	0
10	71392557	rs12020	C	T	5	1	6	0	0	6	0	0
10	71907200	rs7087051	T	G	4	5	9	0	0	9	0	0
10	71910630	rs1046747	G	A	194	239	433	0	5	439	1	0
10	71910663	rs15801	C	T	191	217	408	0	3	411	0	0
10	71910888	rs7919647	C	T	135	136	271	0	1	272	0	0
10	71911014	rs2394643	C	T	18	35	53	0	8	61	0	0
10	71916461	rs9971029	G	A	3	3	6	0	0	6	0	0
10	71919271	rs10999165	G	A	3	7	10	0	0	10	0	0
10	71922900	rs7094581	C	T	35	23	58	0	0	58	0	0
10	71923472	rs4746024	T	C	31	27	58	0	1	59	0	0
10	71925446	rs6480443	T	C	18	17	35	0	0	35	0	0
10	71926288	rs7093644	T	C	9	11	20	0	0	20	0	0
10	71926620	rs10159731	G	A	5	4	9	0	0	9	0	0
10	71966819	rs9415004	C	T	4	4	8	0	0	8	0	0
10	71969062	rs9415006	G	A	7	0	7	0	0	7	0	0
10	71970791	rs10740330	T	G	3	5	8	0	0	8	0	0
10	71970792	rs10740331	T	A	3	5	8	0	0	8	0	0
10	71970818	.	C	A	4	4	8	0	0	8	0	0
10	71971032	rs7897538	A	C	4	2	6	0	0	6	0	0
10	71971469	rs6480446	A	T	10	5	15	0	0	15	0	0
10	71971554	rs2184334	G	A	11	6	17	0	0	17	0	0
10	71971979	rs2184333	T	C	3	6	9	0	0	9	0	0
10	71972828	rs2151834	T	C	3	6	9	0	0	9	0	0
10	71982305	rs10999196	T	C	0	6	6	0	0	6	0	0
10	71993094	rs7077538	T	G	179	175	354	0	1	355	0	0
10	72165478	.	G	C	2	10	12	0	0	12	0	0
10	72169625	rs7918386	G	A	3	7	10	0	0	10	0	0
10	72171244	rs35914122	G	A	5	1	6	0	0	6	0	0
10	72176133	rs34843983	G	A	5	6	11	0	0	11	0	0
10	72177053	rs7906800	T	C	11	6	17	0	0	17	0	0
10	72182110	rs45450199	G	A	110	76	186	0	1	187	0	0
10	72185224	rs10999326	G	C	6	1	7	0	0	7	0	0
10	72520254	rs61736607	C	T	10	5	15	0	0	15	0	0
10	72520567	rs10823616	A	G	10	8	18	0	0	18	0	0
10	72520930	rs2541232	G	A	11	8	19	0	0	19	0	0
10	72520944	rs45542543	T	C	13	9	22	0	0	22	0	0
10	72521155	rs2587469	G	A	6	7	13	0	0	13	0	0
10	72521175	rs2688769	T	C	4	11	15	0	0	15	0	0
10	72521309	rs3740440	C	G	9	12	21	0	0	21	0	0
10	72521422	rs2587468	T	C	10	14	24	0	0	24	0	0
10	72521651	rs3740438	C	T	10	10	20	0	0	20	0	0
10	72522088	rs11572	C	T	13	2	15	0	0	15	0	0
10	73051388	rs3740460	T	C	5	3	8	0	0	8	0	0
10	73057755	rs10823720	G	C	14	11	25	0	0	25	0	0
10	73059104	rs74761108	G	A	7	8	15	0	0	15	0	0
10	73059358	rs1060184	C	G	2	6	8	0	1	9	0	0
10	73059403	rs16928659	C	G	2	8	10	0	0	10	0	0
10	73061708	rs2275576	A	G	8	9	17	0	0	17	0	0
10	73062475	.	G	A	7	4	11	0	0	11	0	0
10	73062534	rs2275578	A	G	5	4	9	0	0	9	0	0
10	73111408	rs780668	C	T	2	4	6	0	0	6	0	0
10	73122468	rs780680	G	T	4	3	7	0	0	7	0	0
10	73520511	rs41305045	G	A	6	4	10	0	0	10	0	0
10	73521632	.	G	A	185	215	400	0	2	402	0	0
10	73529528	.	G	T	6	1	7	0	0	7	0	0
10	73818933	rs7307	G	A	64	78	142	0	0	142	0	0
10	73820001	rs1049269	A	G	65	63	128	0	0	128	0	0
10	73820396	rs896079	G	A	44	52	96	0	1	97	0	0
10	73820622	rs3180	A	G	48	97	145	0	1	146	0	0
10	73821633	rs1678623	C	T	59	68	127	0	5	132	0	0
10	73821663	rs1668174	C	T	59	68	127	0	2	129	0	0
10	73822025	rs1049246	A	G	27	51	78	0	1	79	0	0
10	73822243	rs1049245	G	T	75	131	206	0	2	208	0	0
10	73822507	rs1530803	C	T	45	99	144	0	1	145	0	0
10	73831952	.	G	A	67	101	168	0	1	169	0	0
10	73856984	rs3312	A	G	20	26	46	0	0	46	0	0
10	74093069	.	T	G	60	53	113	0	0	113	0	0
10	74096385	rs41282264	G	A	133	133	266	0	2	268	0	0
10	74098987	.	A	C	2	6	8	0	0	8	0	0
10	74113333	rs9415068	T	C	14	10	24	0	0	24	0	0
10	74127853	rs4262652	G	A	49	37	86	0	0	86	0	0
10	74152283	rs12778141	T	C	3	3	6	0	0	6	0	0
10	74292273	rs11815645	G	C	8	8	16	0	0	16	0	0
10	74292575	rs11000344	C	T	4	2	6	0	0	6	0	0
10	74645876	.	G	A	10	10	20	0	0	20	0	0
10	74767617	.	C	T	228	0	228	0	2	230	0	0
10	74767618	.	A	G	227	0	227	0	1	228	0	0
10	74767652	.	G	A	208	0	208	0	3	211	0	0
10	74767669	.	C	T	200	0	200	0	3	203	0	0
10	74767680	.	A	G	224	0	224	0	2	226	0	0
10	74767686	.	G	A	229	0	229	0	3	232	0	0
10	74893647	rs15302	A	T	22	31	53	0	1	54	0	0
10	75792805	rs10824059	A	G	4	12	16	0	0	16	0	0
10	75792883	.	A	G	7	9	16	0	0	16	0	0
10	75793175	rs12413620	T	C	6	9	15	0	0	15	0	0
10	75793372	rs4745730	C	T	10	11	21	0	2	23	0	0
10	75793623	rs7099171	C	T	13	9	22	0	0	22	0	0
10	75873789	rs141194476	G	A	14	22	36	0	0	36	0	0
10	76468202	rs148819558	G	A	124	118	242	0	2	244	0	0
10	76468851	rs1189553	C	T	15	16	31	0	0	31	0	0
10	76603482	rs11001179	C	T	3	5	8	0	0	8	0	0
10	76603535	rs11001180	G	A	4	6	10	0	0	10	0	0
10	76970613	rs11543	G	C	207	130	337	0	2	339	0	0
10	77807027	rs1898071	T	C	82	101	183	0	2	185	0	0
10	78295924	rs1907312	G	A	3	5	8	0	0	8	0	0
10	78295985	rs1907311	G	T	3	4	7	0	0	7	0	0
10	78296171	rs2172076	G	A	4	3	7	0	0	7	0	0
10	79551640	rs2165047	C	T	19	8	27	0	0	27	0	0
10	79552092	rs2165046	C	T	11	15	26	0	0	26	0	0
10	79552107	rs1058203	G	A	18	8	26	0	0	26	0	0
10	79566632	rs1058198	G	A	8	10	18	0	1	19	0	0
10	79579222	rs1248634	G	A	15	14	29	0	1	30	0	0
10	79579251	rs2289308	G	A	3	4	7	0	0	7	0	0
10	79735271	rs2241546	T	C	7	7	14	0	0	14	0	0
10	79735473	rs4979935	C	T	5	10	15	0	0	15	0	0
10	79735775	rs3088264	T	C	4	5	9	0	0	9	0	0
10	79736964	rs2241547	C	G	4	11	15	0	0	15	0	0
10	79793688	rs3740253	C	T	6	3	9	0	0	9	0	0
10	79794073	rs7071351	C	A	5	7	12	0	0	12	0	0
10	79796089	rs3824717	T	C	13	10	23	0	1	24	0	0
10	79796726	rs2395507	G	C	16	30	46	0	0	46	0	0
10	80855375	rs1538228	C	A	3	5	8	0	0	8	0	0
10	80855650	rs11002811	G	A	5	3	8	0	0	8	0	0
10	80856901	rs7079181	G	A	3	6	9	0	0	9	0	0
10	80858473	rs11002814	G	A	2	7	9	0	0	9	0	0
10	80858505	rs10762845	A	C	2	8	10	0	0	10	0	0
10	80858545	rs11002815	C	T	5	6	11	0	0	11	0	0
10	80858592	rs11002816	G	A	6	5	11	0	0	11	0	0
10	80858823	rs34277896	G	C	5	1	6	0	0	6	0	0
10	80859264	rs10762846	C	G	3	6	9	0	0	9	0	0
10	80859755	rs56038371	A	G	5	7	12	0	0	12	0	0
10	80862603	rs11002818	G	C	8	5	13	0	0	13	0	0
10	80862778	rs881407	C	T	2	6	8	0	0	8	0	0
10	80862955	rs881406	G	A	9	4	13	0	0	13	0	0
10	80862991	rs117089629	G	A	2	8	10	0	0	10	0	0
10	80863475	rs11002819	C	T	6	12	18	0	0	18	0	0
10	80864094	rs946009	C	T	12	9	21	0	1	22	0	0
10	80976442	rs1250584	G	T	4	3	7	0	0	7	0	0
10	80976472	rs11002875	G	A	2	5	7	0	0	7	0	0
10	81007151	rs10824730	A	G	5	1	6	0	0	6	0	0
10	81010250	rs1250597	A	G	2	4	6	0	0	6	0	0
10	81013645	rs1250603	A	G	4	2	6	0	0	6	0	0
10	81016112	rs1250535	C	G	9	1	10	0	0	10	0	0
10	81016209	rs1250534	G	A	4	2	6	0	0	6	0	0
10	81017157	rs1250532	T	C	4	2	6	0	0	6	0	0
10	81017241	rs1250531	A	C	3	3	6	0	2	8	0	0
10	81017467	rs1250530	T	C	4	4	8	0	0	8	0	0
10	81072828	rs2296422	C	T	80	80	160	0	0	160	0	0
10	81073515	rs3824718	C	G	122	101	223	0	1	224	0	0
10	81073763	rs2997468	G	C	71	89	160	0	5	165	0	0
10	81074125	rs1782652	T	A	94	114	208	0	3	211	0	0
10	81074248	rs11002921	C	T	85	105	190	0	3	193	0	0
10	81074816	rs3740259	G	A	108	88	196	0	3	199	0	0
10	81108482	rs6480931	T	C	4	2	6	0	0	6	0	0
10	81109708	rs2000404	T	C	28	21	49	0	0	49	0	0
10	81110307	rs1316313	C	T	36	31	67	0	0	67	0	0
10	81110417	rs1316312	G	C	25	25	50	0	0	50	0	0
10	81111036	rs876678	G	T	9	7	16	0	0	16	0	0
10	81114060	rs7332	G	A	340	277	617	0	4	621	0	0
10	81114813	rs8837	C	G	72	86	158	0	3	161	0	0
10	81114959	rs7898	C	T	65	67	132	0	1	133	0	0
10	81142365	rs6858	C	T	2	6	8	0	0	8	0	0
10	81145535	rs1063119	T	C	4	2	6	0	1	7	0	0
10	81477900	rs2913151	C	T	3	3	6	0	0	6	0	0
10	81525997	rs1044354	C	T	2	9	11	0	0	11	0	0
10	81568535	rs2065126	A	G	166	120	286	0	2	288	0	0
10	81574438	rs4039305	G	A	113	94	207	0	1	208	0	0
10	81586622	rs2758487	C	G	6	6	12	0	0	12	0	0
10	81841692	rs1932574	G	T	16	18	34	0	0	34	0	0
10	81851731	rs11201641	T	C	21	16	37	0	1	38	0	0
10	81912397	rs35014047	A	C	6	4	10	0	0	10	0	0
10	81912846	rs2095571	T	C	12	11	23	0	0	23	0	0
10	81913337	rs17100316	A	G	12	11	23	0	0	23	0	0
10	81913819	rs7078465	G	A	9	8	17	0	0	17	0	0
10	81914735	rs35176036	C	T	8	13	21	0	0	21	0	0
10	81914787	rs3748242	C	T	10	5	15	0	0	15	0	0
10	81916055	rs36073865	C	T	11	27	38	0	0	38	0	0
10	81916355	rs12779139	T	C	44	23	67	0	3	70	0	0
10	81916566	rs12768613	C	T	24	17	41	0	0	41	0	0
10	81917113	rs12769764	C	G	32	39	71	0	0	71	0	0
10	81917320	rs12775374	G	A	24	20	44	0	0	44	0	0
10	81917629	rs12767142	T	C	10	15	25	0	0	25	0	0
10	81917957	rs3862518	T	C	13	16	29	0	1	30	0	0
10	81918128	rs12781912	G	T	14	14	28	0	1	29	0	0
10	81918129	rs3890076	C	T	12	16	28	0	1	29	0	0
10	81918164	rs12781934	G	A	10	14	24	0	1	25	0	0
10	81918582	rs3851053	G	A	9	12	21	0	1	22	0	0
10	81921078	rs35497678	C	T	1	8	9	0	0	9	0	0
10	81923959	rs12762098	G	C	0	6	6	0	0	6	0	0
10	81924055	rs10466226	A	G	1	6	7	0	0	7	0	0
10	81924245	rs7067644	G	A	7	1	8	0	0	8	0	0
10	81926171	rs71481556	A	G	5	10	15	0	0	15	0	0
10	81926231	rs12411386	T	A	6	9	15	0	0	15	0	0
10	81926339	rs11201950	C	T	9	11	20	0	0	20	0	0
10	81926718	rs2228427	A	G	522	582	1104	0	9	1113	0	0
10	81927059	rs2229554	C	T	390	487	877	0	24	901	0	0
10	81928168	rs78683437	C	T	6	6	12	0	0	12	0	0
10	81928179	.	C	T	6	5	11	0	0	12	1	0
10	81931367	rs11201964	A	G	7	6	13	0	0	13	0	0
10	81931441	rs2573351	C	T	5	11	16	0	0	16	0	0
10	81932261	rs34523152	T	C	4	4	8	0	0	8	0	0
10	81932453	rs61860035	C	G	8	4	12	0	0	12	0	0
10	81932509	rs75804987	C	T	4	2	6	0	0	6	0	0
10	81932680	rs11201972	C	T	3	3	6	0	0	6	0	0
10	81937223	rs10887581	T	C	3	3	6	0	0	6	0	0
10	81938096	rs3851055	T	C	3	6	9	0	0	9	0	0
10	81938632	rs12256429	T	C	3	3	6	0	0	6	0	0
10	81940701	rs6585454	A	G	22	8	30	0	1	31	0	0
10	81940864	rs12779955	T	C	11	1	12	0	0	12	0	0
10	81941179	rs34613979	T	C	17	5	22	0	1	23	0	0
10	82272795	rs150552736	C	T	7	4	11	0	0	11	0	0
10	85900245	rs12570814	G	A	15	13	28	0	3	31	0	0
10	85900410	rs10887239	T	C	14	16	30	0	0	30	0	0
10	85900580	rs10887240	T	G	9	11	20	0	0	20	0	0
10	85900834	rs11200880	T	C	9	9	18	0	0	18	0	0
10	85902394	rs3816716	G	C	6	3	9	0	0	9	0	0
10	85905115	rs12768331	A	G	11	12	23	0	0	23	0	0
10	85905705	rs12413307	G	A	11	2	13	0	0	13	0	0
10	85906102	rs12412411	T	A	1	7	8	0	0	8	0	0
10	86101925	rs72841163	A	G	5	2	7	0	0	7	0	0
10	86274302	rs11915	C	G	4	12	16	0	0	16	0	0
10	88204877	rs11202038	C	T	1	5	6	0	0	6	0	0
10	88277457	rs10887621	C	T	15	30	45	0	1	46	0	0
10	88729379	rs12768022	G	A	1	5	6	0	0	6	0	0
10	88820789	rs9421572	T	C	137	108	245	0	1	246	0	0
10	88917974	rs4933430	A	G	0	6	6	0	0	6	0	0
10	88930249	rs11202365	A	T	19	21	40	0	0	40	0	0
10	88939962	rs7081609	T	C	32	31	63	0	2	65	0	0
10	88949045	rs6586063	A	G	3	5	8	0	0	8	0	0
10	88949406	rs7078848	C	T	3	6	9	0	0	9	0	0
10	88950646	rs3129402	A	C	30	14	44	0	0	44	0	0
10	88951001	rs9553	G	A	21	15	36	0	0	36	0	0
10	88951009	rs8574	C	G	21	14	35	0	0	35	0	0
10	88975783	rs28533204	C	T	8	8	16	0	1	17	0	0
10	88992641	rs3897219	G	A	0	15	15	0	0	15	0	0
10	88998470	rs12262768	T	C	6	10	16	0	0	16	0	0
10	89005496	rs11202400	T	G	13	6	19	0	0	19	0	0
10	89005906	rs603393	C	A	109	28	137	0	0	137	0	0
10	89005916	rs4111057	C	T	101	29	130	0	0	130	0	0
10	89005930	rs4040134	G	A	103	28	131	0	1	132	0	0
10	89078732	.	C	T	39	8	47	0	0	47	0	0
10	89078954	.	A	T	54	29	83	0	0	83	0	0
10	89086605	.	A	G	11	2	13	0	0	13	0	0
10	89087404	.	C	T	18	0	18	0	0	18	0	0
10	89087772	rs12251946	T	C	8	9	17	0	0	17	0	0
10	89092276	rs2478634	T	C	3	5	8	0	1	9	0	0
10	89092571	rs2260668	T	A	5	6	11	0	0	11	0	0
10	89093624	rs2478639	G	T	43	24	67	0	0	67	0	0
10	89103384	.	A	G	4	2	6	0	0	6	0	0
10	89114591	rs374392905	T	C	7	3	10	0	0	10	0	0
10	89115976	.	C	T	8	5	13	0	1	14	0	0
10	89124819	rs371046189	T	C	18	0	18	0	1	19	0	0
10	89124859	rs201741914	G	A	14	0	14	0	0	14	0	0
10	89507288	rs1058798	C	A	5	1	6	0	0	6	0	0
10	89513118	rs7481	G	A	8	6	14	0	0	14	0	0
10	89515522	rs12768487	C	T	4	2	6	0	1	7	0	0
10	89520188	rs34466534	T	C	2	4	6	0	0	6	0	0
10	89521206	rs35254974	C	G	3	4	7	0	0	7	0	0
10	89525860	rs9664653	C	T	4	4	8	0	0	8	0	0
10	89537605	rs9651491	C	T	4	4	8	0	0	8	0	0
10	89624757	rs117587034	C	T	26	29	55	0	0	55	0	0
10	89699209	rs2673803	C	T	4	2	6	0	0	6	0	0
10	89707070	rs34366180	A	G	4	3	7	0	0	7	0	0
10	89707265	rs2248293	T	C	5	4	9	0	1	10	0	0
10	89711273	.	A	G	1	5	6	0	0	6	0	0
10	89720907	rs555895	T	G	11	4	15	0	1	16	0	0
10	89727414	rs11202607	C	T	47	39	86	0	0	86	0	0
10	90673047	rs34270879	G	A	2	6	8	0	0	8	0	0
10	90754155	rs9325603	G	C	1	5	6	0	0	6	0	0
10	90770852	rs1571020	C	T	3	3	6	0	0	6	0	0
10	90771829	rs2234978	T	C	11	20	31	0	0	31	0	0
10	90774772	rs1051070	A	T	5	5	10	0	0	10	0	0
10	90775291	rs1468063	C	T	9	5	14	0	0	14	0	0
10	90984990	rs2297472	G	A	2	4	6	0	1	7	0	0
10	91007360	rs1051338	T	G	69	80	149	0	0	149	0	0
10	91066075	rs2070845	A	G	68	70	138	0	3	141	0	0
10	91066460	rs954439	T	A	78	90	168	0	0	168	0	0
10	91066769	rs1727	C	A	82	69	151	0	1	152	0	0
10	91067438	rs4934470	T	C	55	68	123	0	0	123	0	0
10	91067595	rs4933504	C	G	105	105	210	0	0	210	0	0
10	91099630	rs3780878	T	C	20	14	34	0	0	34	0	0
10	91099943	rs10749607	C	G	19	26	45	0	0	45	0	0
10	91100314	.	C	A	21	0	21	0	2	23	0	0
10	91178000	rs304448	C	T	27	23	50	0	1	51	0	0
10	91179694	rs35359667	G	A	4	2	6	0	0	6	0	0
10	91179829	rs303172	T	C	5	1	6	0	0	6	0	0
10	91404388	rs201927435	C	T	6	4	10	0	0	10	0	0
10	92668029	rs4933621	A	G	2	6	8	0	0	8	0	0
10	93603922	rs117475556	T	C	8	4	12	0	0	12	0	0
10	94297302	.	T	C	8	4	12	0	0	12	0	0
10	94453587	rs112926556	C	T	5	6	11	0	0	11	0	0
10	94819053	rs8211	C	T	28	25	53	0	0	53	0	0
10	95259979	rs3740370	C	G	3	4	7	0	0	7	0	0
10	95441272	rs11187583	G	A	35	40	75	0	0	75	0	0
10	95459817	rs726817	C	T	17	21	38	0	0	38	0	0
10	96093279	rs12269029	C	T	8	7	15	0	0	15	0	0
10	96093375	rs11558740	C	T	2	5	7	0	0	7	0	0
10	96093632	rs1678	C	G	2	5	7	0	0	7	0	0
10	96098373	rs17517578	C	T	5	2	7	0	0	7	0	0
10	96366268	.	T	A	8	6	14	0	0	14	0	0
10	96997589	rs1049961	A	G	892	575	1467	0	18	1485	0	0
10	96997670	rs1049921	A	G	840	521	1361	0	10	1371	0	0
10	96997820	rs1049814	A	G	903	533	1436	0	8	1444	0	0
10	96998519	rs2860998	T	C	6	5	11	0	0	11	0	0
10	96998591	rs2901833	G	A	5	4	9	0	0	9	0	0
10	96998625	rs12778613	T	C	9	3	12	0	0	12	0	0
10	96998648	rs2860999	G	A	7	1	8	0	0	8	0	0
10	96998688	rs12778797	T	C	8	3	11	0	0	11	0	0
10	96998743	rs12777195	A	G	9	4	13	0	0	13	0	0
10	96998744	rs12778837	T	C	8	4	12	0	1	13	0	0
10	96998853	rs11188243	A	G	12	6	18	0	0	18	0	0
10	96999006	rs11188244	C	T	7	3	10	0	0	10	0	0
10	96999046	rs11188245	G	A	6	3	9	0	0	9	0	0
10	96999787	rs7909905	C	T	4	3	7	0	0	7	0	0
10	96999873	rs7910217	G	A	5	1	6	0	0	6	0	0
10	97000206	rs2026680	G	C	5	2	7	0	0	7	0	0
10	97010631	rs11188250	C	G	3	4	7	0	0	7	0	0
10	97023630	rs2296961	T	C	424	685	1109	0	10	1119	0	0
10	97072727	rs1053417	A	C	11	8	19	0	1	20	0	0
10	97365908	rs41291562	C	T	101	82	183	0	1	184	0	0
10	97667582	rs41291578	G	T	7	3	10	0	0	10	0	0
10	97820339	rs1047370	G	T	14	32	46	0	0	46	0	0
10	97917843	rs61731060	C	T	7	7	14	0	1	15	0	0
10	97919550	rs61729856	T	G	12	10	22	0	2	24	0	0
10	97919839	rs41291606	A	T	12	10	22	0	0	22	0	0
10	97920798	rs12761705	C	T	11	10	21	0	0	21	0	0
10	97921013	rs74457030	C	T	24	8	32	0	0	32	0	0
10	98727984	rs112800955	A	C	2	4	6	0	0	6	0	0
10	99138004	.	G	A	10	12	22	0	0	22	0	0
10	99216818	rs555113369	A	C	47	33	80	0	1	81	0	0
10	99225645	rs12360068	G	A	27	32	59	0	0	59	0	0
10	99410790	rs7915721	T	C	2	6	8	0	0	8	0	0
10	99434274	rs1046198	G	A	6	5	11	0	0	11	0	0
10	99434760	rs10882983	C	T	17	7	24	0	0	24	0	0
10	99435006	rs11189321	G	T	14	11	25	0	0	25	0	0
10	99435487	rs1046221	A	C	17	14	31	0	0	31	0	0
10	99435629	rs1046237	A	G	16	13	29	0	0	29	0	0
10	99435730	rs1046249	A	G	5	9	14	0	0	14	0	0
10	99439541	rs2275047	G	C	31	28	59	0	0	59	0	0
10	99446425	rs4561136	T	C	5	8	13	0	0	13	0	0
10	99511511	.	T	G	10	10	20	0	0	20	0	0
10	99918976	rs4468282	A	G	4	2	6	0	0	6	0	0
10	99926271	rs7071239	T	A	1	5	6	0	0	6	0	0
10	99969568	rs11189513	A	G	42	35	77	0	1	78	0	0
10	99983310	rs12781480	T	C	5	9	14	0	0	14	0	0
10	100004441	rs1048757	G	C	47	28	75	0	0	75	0	0
10	100191970	rs11599152	G	A	3	4	7	0	0	7	0	0
10	100192240	rs78867785	A	G	2	4	6	0	0	6	0	0
10	100201707	rs7909297	A	G	7	0	7	0	0	7	0	0
10	100206618	.	A	G	38	45	83	0	2	85	0	0
10	101156981	rs1126878	T	G	4	3	7	0	0	7	0	0
10	101157160	rs11867	G	A	18	19	37	0	0	37	0	0
10	101166544	rs2234971	C	T	7	9	16	0	0	16	0	0
10	101287944	rs11190137	A	C	3	3	6	0	0	6	0	0
10	101289998	rs10883368	A	G	4	3	7	0	0	7	0	0
10	101295863	rs888208	A	G	70	54	124	0	0	124	0	0
10	101375896	rs1332103	A	G	3	3	6	0	0	6	0	0
10	101376976	rs12782208	T	C	4	5	9	0	0	9	0	0
10	101378923	rs7908026	T	C	21	19	40	0	0	40	0	0
10	101381519	rs2052318	C	T	4	2	6	0	1	7	0	0
10	101465708	rs7903514	T	C	10	14	24	0	0	24	0	0
10	101466305	rs4919387	T	C	5	10	15	0	0	15	0	0
10	101466606	rs1057490	G	T	3	4	7	0	1	8	0	0
10	101466620	rs1057491	C	T	4	3	7	0	1	8	0	0
10	101470927	rs10883407	A	G	7	4	11	0	0	11	0	0
10	101478721	rs12249652	G	A	12	8	20	0	0	20	0	0
10	101604207	rs3740066	C	T	4	6	10	0	1	11	0	0
10	101715899	rs2862923	G	A	14	7	21	0	0	21	0	0
10	101912064	rs2862954	T	C	106	108	214	0	4	218	0	0
10	101946014	rs10786583	C	G	6	6	12	0	0	12	0	0
10	101977883	rs2230804	C	T	40	28	68	0	0	68	0	0
10	101996286	rs7905395	C	T	3	3	6	0	0	6	0	0
10	101996295	rs7905302	A	G	3	3	6	0	0	6	0	0
10	102006429	rs4919438	T	C	3	3	6	0	0	6	0	0
10	102007714	rs6584354	A	C	10	5	15	0	1	16	0	0
10	102008169	rs7079072	C	G	11	8	19	0	0	19	0	0
10	102011211	rs12265333	A	G	3	5	8	0	0	8	0	0
10	102036684	rs34539738	C	G	6	27	33	0	0	33	0	0
10	102036824	rs35696979	C	G	52	103	155	0	2	157	0	0
10	102036984	rs2862956	T	C	27	38	65	0	1	66	0	0
10	102037104	.	G	A	9	15	24	0	1	25	0	0
10	102037105	.	C	G	9	16	25	0	0	25	0	0
10	102037575	.	G	A	9	0	9	0	1	10	0	0
10	102037659	.	T	C	6	0	6	0	0	6	0	0
10	102037750	rs11190451	T	C	6	0	6	0	1	7	0	0
10	102037852	.	C	T	5	2	7	0	0	7	0	0
10	102037933	rs370997960	T	C	3	3	6	0	0	6	0	0
10	102038641	rs61871342	G	A	12	22	34	0	1	35	0	0
10	102038685	rs12254005	T	A	9	19	28	0	0	28	0	0
10	102039187	rs34955138	T	G	15	20	35	0	0	35	0	0
10	102039458	rs4919446	G	A	10	16	26	0	0	26	0	0
10	102039463	rs4917896	T	C	8	20	28	0	1	29	0	0
10	102121579	rs3978768	A	G	44	50	94	0	0	94	0	0
10	102246512	rs2970	C	T	31	10	41	0	0	41	0	0
10	102247408	rs2298075	C	A	6	22	28	0	0	28	0	0
10	102247526	rs2298074	G	C	9	22	31	0	0	31	0	0
10	102248884	rs3750720	C	T	13	16	29	0	1	30	0	0
10	102248950	rs3750719	C	G	17	15	32	0	1	33	0	0
10	102265183	rs2295772	G	A	23	17	40	0	0	40	0	0
10	102265815	rs2295773	A	G	10	7	17	0	1	18	0	0
10	102265847	rs2295774	A	C	11	8	19	0	0	19	0	0
10	102269085	rs3793706	C	A	15	7	22	0	0	22	0	0
10	102269206	rs3763695	A	G	13	8	21	0	0	21	0	0
10	102284449	rs12358187	C	G	14	15	29	0	0	29	0	0
10	102287520	rs74210981	C	T	3	4	7	0	0	7	0	0
10	102288343	rs4919468	G	C	8	3	11	0	0	11	0	0
10	102308214	rs3750633	G	A	8	8	16	0	0	16	0	0
10	102308516	rs10883512	A	G	11	5	16	0	0	16	0	0
10	102308800	rs75780010	G	T	12	4	16	0	0	16	0	0
10	102308817	rs117727370	G	C	11	4	15	0	0	15	0	0
10	102309220	rs11816840	G	C	5	10	15	0	0	15	0	0
10	102312565	rs1054399	C	T	14	7	21	0	0	21	0	0
10	102313607	rs11292	A	G	9	5	14	0	1	15	0	0
10	102673063	rs3802725	G	T	4	7	11	0	0	11	0	0
10	102722576	.	C	A	8	8	16	0	1	17	0	0
10	102746231	rs7184	C	T	55	41	96	0	1	97	0	0
10	102762256	rs752974	C	T	23	17	40	0	0	40	0	0
10	102764511	rs807028	G	A	18	15	33	0	0	33	0	0
10	102795731	rs76529895	G	A	22	24	46	0	0	46	0	0
10	103313599	rs3127242	C	T	3	6	9	0	0	9	0	0
10	103313620	rs1045324	A	G	3	7	10	0	0	10	0	0
10	103338730	rs1055364	C	A	20	25	45	0	1	46	0	0
10	103338733	rs1055362	A	G	21	24	45	0	2	47	0	0
10	103340056	rs3730477	G	A	16	17	33	0	0	33	0	0
10	103340144	rs3730476	A	G	19	20	39	0	0	39	0	0
10	103344553	.	G	A	8	8	16	0	0	16	0	0
10	103361088	rs7874	C	T	28	35	63	0	0	63	0	0
10	103368654	rs7006	T	C	33	46	79	0	0	79	0	0
10	103547576	.	T	C	21	24	45	0	1	46	0	0
10	103555611	rs11191116	C	T	10	2	12	0	0	12	0	0
10	103557095	.	T	A	13	9	22	0	0	22	0	0
10	103558701	rs17697840	G	A	68	82	150	0	0	150	0	0
10	103559245	rs76134290	G	T	2	5	7	0	0	7	0	0
10	103577726	rs41291488	G	A	14	9	23	0	1	24	0	0
10	103605426	rs41291492	A	G	13	15	28	0	0	28	0	0
10	103605714	rs1044258	T	C	29	20	49	0	0	49	0	0
10	103718818	rs17699407	C	T	3	3	6	0	0	6	0	0
10	103726528	rs11191161	T	C	4	2	6	0	0	6	0	0
10	103732143	rs11191162	G	A	6	2	8	0	0	8	0	0
10	103873660	rs59485115	A	T	3	5	8	0	0	8	0	0
10	103900729	rs61731871	G	A	27	30	57	0	0	57	0	0
10	103907055	rs34169738	C	T	56	61	117	0	1	118	0	0
10	103907680	rs10509755	C	T	4	5	9	0	0	9	0	0
10	103920281	.	C	T	106	103	209	0	3	212	0	0
10	103920475	rs1049455	T	C	122	89	211	0	2	213	0	0
10	103922063	rs1049466	G	C	167	152	319	0	4	324	1	0
10	103922896	rs7897	G	T	111	112	223	0	3	226	0	0
10	104005410	rs2296887	T	C	23	20	43	0	0	43	0	0
10	104120846	.	G	A	9	15	24	0	0	24	0	0
10	104138996	rs61873660	C	T	5	10	15	0	0	15	0	0
10	104155823	rs61873662	A	T	4	3	7	0	0	7	0	0
10	104157711	rs7897947	T	G	13	5	18	0	0	18	0	0
10	104159696	rs11574849	G	A	101	84	185	0	0	185	0	0
10	104160575	.	C	T	201	168	369	0	1	370	0	0
10	104161724	rs41287457	A	G	4	4	8	0	0	8	0	0
10	104181366	rs76302201	G	C	13	6	19	0	0	19	0	0
10	104210735	rs2281878	C	A	7	4	11	0	0	11	0	0
10	104234282	rs61873703	A	G	3	3	6	0	0	6	0	0
10	104404335	rs4146426	A	T	31	29	60	0	0	60	0	0
10	104410736	rs17783771	C	T	3	5	8	0	0	8	0	0
10	104411958	rs11191361	C	T	8	4	12	0	0	12	0	0
10	104412049	rs10883759	G	A	8	3	11	0	0	11	0	0
10	104412742	rs3862031	G	T	6	3	9	0	0	9	0	0
10	104414183	rs3977743	G	A	2	6	8	0	1	9	0	0
10	104414184	rs3977744	A	T	3	6	9	0	0	9	0	0
10	104414709	rs2286748	C	A	3	4	7	0	0	7	0	0
10	105137068	.	T	C	2	5	7	0	0	7	0	0
10	105207205	.	T	G	8	8	16	0	0	16	0	0
10	105209413	rs2232659	C	T	7	5	12	0	0	12	0	0
10	105333127	rs12360357	C	T	2	4	6	0	0	6	0	0
10	105333242	rs1077016	T	G	5	1	6	0	0	6	0	0
10	105657363	rs11191853	C	G	41	82	123	0	0	125	2	0
10	105677897	rs4387287	A	C	13	8	21	0	0	21	0	0
10	105758670	rs10883960	A	G	48	68	116	0	0	116	0	0
10	105762671	.	G	A	31	29	60	0	2	62	0	0
10	105763026	rs3740469	C	T	47	66	113	0	3	116	0	0
10	105788746	rs6787	C	T	15	20	35	0	0	35	0	0
10	105882765	rs10786783	A	G	20	20	40	0	0	40	0	0
10	105885814	rs1052001	A	G	26	26	52	0	0	52	0	0
10	111629030	rs492943	T	A	2	4	6	0	0	6	0	0
10	111630917	rs3740137	G	A	6	3	9	0	0	9	0	0
10	111630931	rs3740138	C	T	7	4	11	0	0	11	0	0
10	111631265	rs7075964	C	A	12	9	21	0	0	21	0	0
10	111631665	rs2274978	C	G	12	5	17	0	0	17	0	0
10	111631781	rs2274979	G	A	8	5	13	0	0	13	0	0
10	111632445	rs7916801	G	A	6	6	12	0	0	12	0	0
10	111632937	rs3740140	T	G	9	9	18	0	0	18	0	0
10	111633966	rs58154613	C	T	17	17	34	0	0	34	0	0
10	111634568	rs58719275	G	A	10	5	15	0	0	15	0	0
10	111635212	rs3818285	T	C	8	16	24	0	0	24	0	0
10	111635785	rs41291880	A	G	20	16	36	0	0	36	0	0
10	111645313	rs3824623	G	A	2	4	6	0	0	6	0	0
10	111651541	rs111607977	G	A	110	92	202	0	2	204	0	0
10	111878510	rs12268910	T	G	1	6	7	0	0	7	0	0
10	112045171	rs14401	C	T	112	102	214	0	1	215	0	0
10	112046150	rs17658	T	C	119	129	248	0	0	248	0	0
10	112052689	rs10787227	C	G	3	3	6	0	0	6	0	0
10	112053599	rs1050755	C	T	201	120	321	0	4	325	0	0
10	112061085	rs4918491	A	G	16	13	29	0	0	29	0	0
10	112061248	rs4918492	G	C	10	5	15	0	0	15	0	0
10	112061725	rs10749027	C	A	5	3	8	0	0	8	0	0
10	112262843	rs11594185	C	T	11	7	18	0	0	18	0	0
10	112263030	rs1889568	C	T	6	15	21	0	0	21	0	0
10	112263999	rs17127463	A	G	4	6	10	0	0	10	0	0
10	112265135	rs3793892	G	T	6	6	12	0	0	12	0	0
10	112266046	rs1334944	C	T	7	8	15	0	0	15	0	0
10	112266771	rs1889567	C	T	349	336	685	0	8	693	0	0
10	112268801	rs17127481	C	T	8	11	19	0	0	19	0	0
10	112269400	rs7090060	A	G	4	5	9	0	0	9	0	0
10	112269486	rs3829192	G	C	4	9	13	0	0	13	0	0
10	112270675	rs1042606	A	C	465	471	936	0	1	938	1	0
10	112271288	rs3750811	A	G	32	23	55	0	1	56	0	0
10	113910721	rs1129555	A	G	4	2	6	0	0	6	0	0
10	114187787	rs8624	T	C	23	32	55	0	0	55	0	0
10	114187876	rs143421135	A	G	50	48	98	0	0	98	0	0
10	114192285	rs2306158	G	A	11	4	15	0	0	15	0	0
10	114200355	rs2306159	G	A	31	12	43	0	0	43	0	0
10	114205389	rs4918752	G	A	64	75	139	0	1	140	0	0
10	114206837	rs2277206	T	C	6	2	8	0	0	8	0	0
10	114208276	rs7075980	A	T	6	4	10	0	1	11	0	0
10	114747277	rs4073288	G	A	5	11	16	0	0	16	0	0
10	114926790	rs11196251	C	T	62	68	130	0	1	131	0	0
10	115472719	rs10749141	G	A	3	3	6	0	0	6	0	0
10	115473256	rs7099033	C	G	8	4	12	0	0	12	0	0
10	115489650	rs10787498	T	G	29	43	72	0	0	72	0	0
10	115490060	rs12247479	G	A	56	47	103	0	3	106	0	0
10	115609915	rs3750898	C	G	7	2	9	0	0	9	0	0
10	115614571	rs118152996	C	T	8	5	13	0	0	13	0	0
10	115675025	rs7895609	G	A	4	3	7	0	1	8	0	0
10	116191174	rs6646	A	G	118	96	214	0	1	215	0	0
10	116191959	rs7917021	G	T	62	66	128	0	0	128	0	0
10	116192831	rs7906164	T	G	59	67	126	0	1	127	0	0
10	116193716	rs17778547	T	C	57	41	98	0	0	98	0	0
10	116593175	rs11196939	C	T	6	5	11	0	2	13	0	0
10	116593532	rs10490909	C	T	5	6	11	0	0	11	0	0
10	116593791	rs11196940	T	G	4	14	18	0	0	18	0	0
10	116594934	rs11819372	A	G	5	5	10	0	0	10	0	0
10	116603198	rs7079877	G	A	8	6	14	0	0	14	0	0
10	116615045	rs3180654	T	C	103	117	220	0	0	220	0	0
10	116621154	rs34064819	C	A	16	6	22	0	0	22	0	0
10	116622339	rs41284358	A	G	39	32	71	0	0	71	0	0
10	116623059	rs36089581	G	C	12	13	25	0	0	25	0	0
10	116624067	rs1046492	C	T	33	31	64	0	0	64	0	0
10	116719543	rs7099565	G	A	26	18	44	0	1	45	0	0
10	119029515	rs363230	C	T	23	32	55	0	0	55	0	0
10	119037009	rs10377	A	C	21	18	39	0	0	39	0	0
10	119037071	rs14240	T	C	34	27	61	0	1	62	0	0
10	119038528	rs363237	T	C	137	159	296	0	4	300	0	0
10	119042408	rs12337	T	C	233	226	459	0	4	463	0	0
10	119045529	rs363241	T	C	3	3	6	0	0	6	0	0
10	119055123	rs2490628	T	C	3	4	7	0	0	7	0	0
10	119124017	rs10886063	G	A	2	4	6	0	0	6	0	0
10	119125217	rs7917325	C	T	5	2	7	0	0	7	0	0
10	119125301	rs76402367	G	A	10	3	13	0	1	14	0	0
10	119126650	rs12247698	T	C	1	5	6	0	0	6	0	0
10	119126662	rs61865312	C	T	0	6	6	0	0	6	0	0
10	120067450	rs17618810	G	A	14	5	19	0	0	19	0	0
10	120071546	rs853907	C	T	11	9	20	0	0	20	0	0
10	120441044	.	T	A	12	6	18	0	0	18	0	0
10	120446967	rs10787853	T	C	4	7	11	0	0	11	0	0
10	120447437	rs10886285	C	T	2	7	9	0	0	9	0	0
10	120448235	rs11594672	C	T	4	2	6	0	0	6	0	0
10	120449116	rs942945	T	C	2	5	7	0	0	7	0	0
10	120452654	rs1886897	G	C	32	19	51	0	0	51	0	0
10	120453490	rs7923434	A	G	8	10	18	0	0	18	0	0
10	120793700	rs61708394	C	G	18	17	35	0	0	35	0	0
10	120796969	rs74157620	G	A	13	23	36	0	0	36	0	0
10	120810646	rs17098380	G	A	12	3	15	0	0	15	0	0
10	120820528	rs3824822	A	G	3	5	8	0	0	8	0	0
10	120828969	rs7908387	A	G	79	102	181	0	0	181	0	0
10	120831077	rs10787904	G	T	2	4	6	0	0	6	0	0
10	120864412	rs2271361	T	G	231	99	330	0	0	330	0	0
10	120864781	rs1511034	C	A	17	19	36	0	3	39	0	0
10	120864868	rs1511033	T	C	31	27	58	0	0	58	0	0
10	120865796	rs76868723	C	T	4	5	9	0	0	9	0	0
10	120869807	rs10886386	C	T	4	3	7	0	0	7	0	0
10	120883045	rs74157632	A	G	41	51	92	0	2	94	0	0
10	120896027	rs11198799	G	A	44	50	94	0	0	94	0	0
10	120896927	rs4752252	G	A	37	31	68	0	0	68	0	0
10	120920588	rs10749291	T	C	60	42	102	0	4	106	0	0
10	120927544	rs3377	T	G	87	77	164	0	1	166	1	0
10	120927793	rs7768	G	C	84	99	183	0	2	185	0	0
10	120934649	rs75579129	T	C	6	3	9	0	2	11	0	0
10	120971464	rs10510055	C	G	3	3	6	0	0	6	0	0
10	121086097	rs2230345	A	T	5	7	12	0	1	13	0	0
10	121189170	rs867760	G	A	4	3	7	0	0	7	0	0
10	122114550	.	T	A	24	0	24	0	2	26	0	0
10	122624679	rs10886789	G	A	13	7	20	0	0	20	0	0
10	122645376	rs7899928	A	T	11	9	20	0	0	20	0	0
10	122649482	rs2289337	A	G	22	16	38	0	2	40	0	0
10	122667022	rs1530116	T	G	3	3	6	0	0	6	0	0
10	122667844	rs10788128	G	A	0	9	9	0	0	9	0	0
10	122668296	rs7077126	G	A	36	36	72	0	0	72	0	0
10	122668412	rs10886800	G	A	37	19	56	0	0	56	0	0
10	122668604	rs1045154	G	A	17	12	29	0	1	30	0	0
10	122668782	rs1045170	G	T	30	28	58	0	1	59	0	0
10	122668801	rs1045179	A	C	34	31	65	0	0	65	0	0
10	124190121	rs17103541	A	G	4	3	7	0	0	7	0	0
10	124610027	rs1891110	G	A	20	10	30	0	0	30	0	0
10	124639083	.	G	C	5	3	8	0	0	8	0	0
10	124742792	rs3736583	G	A	38	20	58	0	0	58	0	0
10	124742895	rs3736582	G	C	40	26	66	0	1	67	0	0
10	124742917	rs147031037	A	C	37	29	66	0	0	66	0	0
10	124750722	rs13353058	A	G	36	45	81	0	1	82	0	0
10	124753060	rs9423302	G	A	22	19	41	0	0	41	0	0
10	124754529	rs9423242	T	C	4	3	7	0	0	7	0	0
10	124755057	rs9423243	A	G	27	14	41	0	0	41	0	0
10	124755111	rs9423244	G	T	23	13	36	0	0	36	0	0
10	124755377	rs8192670	T	G	5	13	18	0	1	19	0	0
10	124757500	rs4980242	T	A	5	4	9	0	0	9	0	0
10	124758693	rs9423245	A	G	8	12	20	0	1	21	0	0
10	124765146	rs10902857	T	C	3	5	8	0	0	8	0	0
10	124765314	rs10902858	C	A	4	2	6	0	0	6	0	0
10	124765857	rs9328842	T	C	27	60	87	0	0	87	0	0
10	124768034	rs2277249	A	G	1	6	7	0	1	8	0	0
10	124768292	rs2277250	G	A	19	14	33	0	0	33	0	0
10	124813359	rs117078411	C	T	10	4	14	0	0	14	0	0
10	126089434	rs11461	G	A	143	104	247	0	4	251	0	0
10	126302009	rs544817587	C	T	11	7	18	0	1	19	0	0
10	126302597	rs11245317	C	T	18	8	26	0	0	26	0	0
10	126303408	rs56724871	C	T	0	8	8	0	0	8	0	0
10	126303580	rs11245318	C	T	2	5	7	0	1	8	0	0
10	126308683	rs3802703	A	G	34	35	69	0	1	70	0	0
10	126309448	rs10751601	C	G	56	40	96	0	1	97	0	0
10	126446592	rs1055256	A	G	4	4	8	0	0	8	0	0
10	126517989	rs2303611	G	A	51	61	112	0	1	113	0	0
10	127482764	rs41315014	T	C	9	12	21	0	0	21	0	0
10	127482950	rs2149019	G	A	9	6	15	0	1	16	0	0
10	127511756	rs4256900	C	T	9	9	18	0	1	19	0	0
10	127511790	rs4385801	G	T	1	7	8	0	0	8	0	0
10	127518538	rs11244667	G	A	6	5	11	0	0	11	0	0
10	127523964	rs10901452	C	T	2	6	8	0	1	9	0	0
10	127524156	rs113387133	A	C	8	5	13	0	0	13	0	0
10	127524612	rs4075326	C	T	8	9	17	0	0	17	0	0
10	127525072	rs7320	A	C	13	10	23	0	0	23	0	0
10	127530325	rs3208565	T	C	56	30	86	0	1	87	0	0
10	127539196	rs10901455	T	C	4	2	6	0	0	6	0	0
10	127584798	.	G	C	19	0	19	0	0	19	0	0
10	127584806	.	T	G	15	0	15	0	2	17	0	0
10	127585179	rs74162871	G	C	7	0	7	0	0	7	0	0
10	129216658	rs2229600	T	C	3	3	6	0	0	6	0	0
10	129242515	rs11371	G	A	7	3	10	0	1	11	0	0
10	129249662	rs2229603	G	A	7	7	14	0	0	14	0	0
10	129249676	rs2229604	C	T	6	7	13	0	0	13	0	0
10	129249693	rs2229605	G	A	6	7	13	0	0	13	0	0
10	129249701	rs2229606	C	G	6	7	13	0	0	13	0	0
10	129249914	rs3824814	T	C	13	12	25	0	0	25	0	0
10	129249925	rs10765104	T	C	13	11	24	0	0	24	0	0
10	129250075	rs3740543	A	G	10	5	15	0	0	15	0	0
10	129250497	rs4751414	C	T	4	2	6	0	0	6	0	0
10	129850665	rs72848749	G	A	12	12	24	0	0	24	0	0
10	129858101	rs77041435	C	A	21	14	35	0	1	36	0	0
10	129862725	rs59622882	G	A	6	4	10	0	0	10	0	0
10	129867168	rs10829324	C	T	12	8	20	0	0	20	0	0
10	129869233	rs10829325	A	G	100	100	200	0	0	200	0	0
10	129869398	rs10829326	C	G	187	150	337	0	4	341	0	0
10	129869809	rs41282872	G	A	158	149	307	0	1	308	0	0
10	129872552	rs7094840	T	C	25	35	60	0	0	60	0	0
10	129873093	rs10741142	G	C	54	45	99	0	1	100	0	0
10	129873113	rs10764744	C	G	51	43	94	0	1	95	0	0
10	129877184	rs11016056	C	T	50	20	70	0	0	70	0	0
10	129877567	rs3763791	C	A	33	18	51	0	1	52	0	0
10	129878602	rs7911438	C	T	4	9	13	0	0	13	0	0
10	129878899	rs4353188	T	C	8	7	15	0	1	16	0	0
10	129879700	rs2096285	A	G	15	15	30	0	0	30	0	0
10	129880911	rs72848780	G	A	9	10	19	0	0	19	0	0
10	129881701	rs7085589	A	G	26	53	79	0	1	80	0	0
10	129881778	rs3210509	T	A	40	61	101	0	0	101	0	0
10	129882098	rs7474666	C	G	65	91	156	0	4	160	0	0
10	129882119	rs1127299	A	G	61	88	149	0	2	151	0	0
10	129882401	rs4278435	C	T	45	68	113	0	3	116	0	0
10	129882553	rs4548544	G	A	42	42	84	0	2	86	0	0
10	129882640	rs4568912	A	G	52	61	113	0	0	113	0	0
10	129882699	rs4367863	A	G	60	66	126	0	0	126	0	0
10	129882819	rs148564459	G	A	80	80	160	0	3	164	1	0
10	129883110	rs4237449	T	C	80	92	172	0	0	172	0	0
10	129883121	rs3186827	C	A	82	75	157	0	3	160	0	0
10	129883370	rs1129205	A	G	159	106	265	0	4	269	0	0
10	129883780	rs12768414	G	A	111	106	217	0	3	220	0	0
10	129883933	rs6911	C	T	33	24	57	0	2	59	0	0
10	129896232	rs7347	A	G	35	45	80	0	0	80	0	0
10	129899578	rs8473	T	C	64	47	111	0	0	112	1	0
10	129899778	rs11106	G	C	43	45	88	0	0	88	0	0
10	129900858	rs3191122	C	T	31	35	66	0	1	67	0	0
10	129901501	rs2071496	G	C	43	31	74	0	0	74	0	0
10	129901747	rs10764749	C	T	27	25	52	0	0	52	0	0
10	129902281	rs1063535	G	A	31	25	56	0	0	56	0	0
10	129903016	rs7071768	T	C	15	29	44	0	2	46	0	0
10	129903465	rs2857028	A	G	27	27	54	0	1	55	0	0
10	129904560	rs2853346	C	T	13	10	23	0	0	23	0	0
10	129905297	.	C	T	11	6	17	0	0	17	0	0
10	129905896	rs3740423	T	A	8	10	18	0	0	18	0	0
10	129906980	rs2152143	C	T	6	11	17	0	0	17	0	0
10	131964784	rs34458027	G	A	114	101	215	0	7	222	0	0
10	131977270	rs76087798	A	G	6	2	8	0	0	8	0	0
10	131981015	rs872	C	G	4	6	10	0	0	10	0	0
10	131981726	rs12268200	A	G	6	1	7	0	0	7	0	0
10	132893576	rs56349900	C	T	0	6	6	0	0	6	0	0
10	133786586	rs1050704	T	C	50	33	83	0	0	83	0	0
10	133795400	rs45541140	C	G	2	6	8	0	0	8	0	0
10	134143942	rs1052281	C	T	36	9	45	0	0	45	0	0
10	134143985	rs1132165	G	T	44	6	50	0	1	51	0	0
10	134143986	rs1132164	C	T	43	6	49	0	2	51	0	0
10	134144005	rs7085852	T	C	7	1	8	0	0	8	0	0
10	134144466	rs7096166	G	T	5	2	7	0	0	7	0	0
10	134144468	rs7082370	A	G	5	2	7	0	0	7	0	0
10	134144484	rs7082379	A	G	5	1	6	0	0	6	0	0
10	134145136	rs7086691	A	G	28	11	39	0	0	39	0	0
10	134145138	rs7080014	C	G	26	11	37	0	0	37	0	0
10	134145153	rs7100410	G	A	28	7	35	0	0	35	0	0
10	134145166	rs13882	T	C	27	7	34	0	1	35	0	0
10	134145293	rs12784130	G	T	7	2	9	0	0	9	0	0
10	134145314	rs11146335	A	G	1	5	6	0	0	6	0	0
10	134147172	rs12414718	G	A	5	4	9	0	0	9	0	0
10	134180354	rs45513097	G	A	5	1	6	0	0	6	0	0
10	134218296	rs10747057	C	G	4	6	10	0	0	10	0	0
10	134219852	rs12242690	A	C	9	3	12	0	0	12	0	0
10	134220137	rs34941889	C	T	8	7	15	0	0	15	0	0
10	134220175	rs34487453	G	A	7	8	15	0	0	15	0	0
10	134228830	rs112703738	C	A	5	4	9	0	0	9	0	0
10	134230881	.	G	A	23	24	47	0	1	48	0	0
10	134248116	rs187850437	G	A	9	2	11	0	0	11	0	0
10	134459388	rs1133400	A	G	28	12	40	0	0	40	0	0
10	135051543	rs2240892	T	C	2	13	15	0	0	15	0	0
10	135051562	rs2998143	A	G	4	15	19	0	0	19	0	0
10	135076523	rs2995300	C	A	618	299	917	0	5	922	0	0
10	135076596	rs2230576	T	C	596	267	863	0	6	869	0	0
10	135076758	rs3008318	T	C	25	19	44	0	0	44	0	0
10	135076903	rs3121298	A	G	20	31	51	0	1	52	0	0
10	135077020	rs2275722	C	T	30	22	52	0	0	52	0	0
10	135077311	rs2995301	C	G	25	38	63	0	0	63	0	0
10	135077626	rs4838712	C	T	15	10	25	0	1	26	0	0
10	135079605	rs2995306	G	C	30	28	58	0	1	59	0	0
10	135079788	rs2995307	T	C	39	38	77	0	0	77	0	0
10	135079862	rs2995308	T	C	23	28	51	0	0	51	0	0
10	135081754	rs11101672	G	C	38	39	77	0	3	80	0	0
10	135082346	rs2275720	A	G	220	96	316	0	8	324	0	0
10	135082810	rs2995310	C	T	73	63	136	0	2	138	0	0
10	135082874	rs2995311	G	A	68	57	125	0	0	125	0	0
10	135083164	rs2275719	C	T	17	16	33	0	0	33	0	0
10	135083669	rs2995312	C	T	13	6	19	0	0	19	0	0
10	135083713	rs2995313	C	T	10	4	14	0	0	14	0	0
10	135083806	rs558767453	G	A	9	10	19	0	0	19	0	0
10	135083812	rs885023	C	A	10	9	19	0	1	20	0	0
10	135084322	rs3008321	A	G	23	82	105	0	1	106	0	0
10	135084601	rs2995314	T	C	10	3	13	0	0	13	0	0
10	135085321	rs1131720	C	T	224	86	310	0	2	312	0	0
10	135085754	rs1131718	G	A	305	100	405	0	6	411	0	0
10	135086203	rs3008323	C	T	44	42	86	0	0	86	0	0
10	135086766	rs45451297	G	A	141	66	207	0	2	209	0	0
10	135087521	rs3008326	G	A	264	113	377	0	3	380	0	0
10	135087780	.	G	A	5	11	16	0	0	16	0	0
10	135088741	rs2275724	C	T	11	5	16	0	0	16	0	0
10	135089035	rs2275725	A	G	155	49	204	0	1	205	0	0
10	135089397	rs2995316	C	T	6	4	10	0	0	10	0	0
10	135093580	.	C	T	25	22	47	0	0	47	0	0
10	135093982	rs2995321	T	C	12	17	29	0	1	30	0	0
10	135095408	rs2995324	C	T	15	23	38	0	0	38	0	0
10	135097434	rs2995326	A	G	177	187	364	0	2	366	0	0
10	135098345	rs3008333	G	A	48	56	104	0	2	106	0	0
10	135098672	rs3008334	G	A	153	143	296	0	2	298	0	0
10	135098830	rs3008335	T	C	63	65	128	0	1	129	0	0
10	135098845	rs2995327	C	T	64	72	136	0	0	136	0	0
10	135099533	rs3008336	T	C	7	4	11	0	0	11	0	0
10	135099553	rs3008337	G	A	6	4	10	0	0	10	0	0
10	135099999	rs3008338	G	A	3	6	9	0	0	9	0	0
10	135100346	rs3008339	T	G	2	4	6	0	0	6	0	0
10	135101378	rs2995329	A	G	4	5	9	0	0	9	0	0
10	135104493	rs7081338	C	G	14	6	20	0	0	20	0	0
10	135109825	rs3008347	C	T	20	15	35	0	1	36	0	0
10	135110469	rs6537596	C	T	27	14	41	0	1	42	0	0
10	135111844	rs11101683	G	A	3	5	8	0	0	8	0	0
10	135113056	rs2298121	C	T	83	86	169	0	0	169	0	0
10	135113819	rs2995332	A	C	7	4	11	0	1	12	0	0
10	135113937	rs11101686	G	A	9	6	15	0	0	15	0	0
10	135114559	rs3008349	G	C	6	3	9	0	1	10	0	0
10	135114757	rs2860658	T	C	6	4	10	0	0	10	0	0
10	135122507	rs3008357	G	A	12	13	25	0	1	26	0	0
10	135123880	.	A	T	5	8	13	0	0	13	0	0
10	135124153	rs3008358	T	C	3	5	8	0	0	8	0	0
10	135125186	rs111577243	T	C	8	8	16	0	0	16	0	0
10	135157758	rs10776671	A	C	4	2	6	0	0	6	0	0
10	135176091	rs4604	G	A	206	187	393	0	0	393	0	0
10	135176258	rs1050040	G	A	234	255	489	0	2	491	0	0
10	135178611	rs10857706	G	A	6	4	10	0	0	10	0	0
10	135178753	.	C	T	3	5	8	0	0	8	0	0
10	135179458	rs6537598	G	C	5	4	9	0	0	9	0	0
10	135179777	rs6537599	C	T	5	2	7	0	0	7	0	0
10	135181285	rs3975645	G	T	5	2	7	0	0	7	0	0
10	135184126	rs1049951	G	A	209	171	380	0	1	381	0	0
10	135186806	rs10466126	A	G	76	52	128	0	0	128	0	0
11	5270686	.	G	A	937	3	940	0	1	941	0	0
11	8999069	.	C	T	8	0	8	0	0	8	0	0
11	14516906	rs2597188	G	A	4	2	6	0	1	7	0	0
11	14521354	rs2575823	C	A	24	27	51	0	0	51	0	0
11	14523163	rs2575824	C	T	4	5	9	0	0	9	0	0
11	14524333	rs2597184	G	A	11	7	18	0	0	18	0	0
11	14524366	rs2597183	T	C	15	8	23	0	0	23	0	0
11	14528592	rs11023241	T	A	7	9	16	0	0	16	0	0
11	14528609	rs112296502	G	C	9	7	16	0	0	16	0	0
11	14529874	rs6486197	C	G	3	7	10	0	0	10	0	0
11	14530866	rs2597219	C	G	4	4	8	0	0	8	0	0
11	14532883	rs2597217	A	G	11	28	39	0	2	41	0	0
11	14533368	rs2575852	G	A	6	11	17	0	0	17	0	0
11	14533916	rs2597216	G	A	5	10	15	0	1	17	1	0
11	14533963	rs2575853	T	C	4	14	18	0	1	19	0	0
11	14534378	rs2597215	A	T	8	22	30	0	0	30	0	0
11	14534825	rs1548074	A	G	22	48	70	0	0	70	0	0
11	14542577	rs10766184	A	G	12	8	20	0	0	20	0	0
11	14632570	rs1403247	A	C	39	39	78	0	2	80	0	0
11	14665157	rs7106123	G	T	5	9	14	0	0	14	0	0
11	14669621	rs7939648	A	T	8	10	18	0	1	19	0	0
11	14672230	rs10832290	T	C	31	27	58	0	0	58	0	0
11	14672984	rs1403249	G	A	40	36	76	0	0	76	0	0
11	14683004	rs11023296	G	A	7	9	16	0	1	17	0	0
11	14683045	rs7127312	T	C	8	6	14	0	0	14	0	0
11	14683182	.	C	T	8	3	11	0	0	11	0	0
11	14685078	rs11529568	G	A	16	6	22	0	1	23	0	0
11	14685886	rs6486200	T	C	21	20	41	0	0	41	0	0
11	14687130	rs112514233	G	C	30	10	40	0	0	40	0	0
11	14687171	rs111890630	C	G	32	12	44	0	0	44	0	0
11	14687824	.	T	C	9	6	15	0	0	15	0	0
11	14688165	.	T	C	15	16	31	0	0	31	0	0
11	14688747	.	A	G	31	21	52	0	0	52	0	0
11	14696325	rs1533852	A	G	9	3	12	0	0	12	0	0
11	14725263	rs11023310	T	G	6	2	8	0	0	8	0	0
11	14743097	rs199889198	G	T	6	1	7	0	0	7	0	0
11	14804519	rs11023336	G	A	4	2	6	0	0	6	0	0
11	14810762	rs4757268	A	G	9	4	13	0	1	14	0	0
11	14903050	.	G	A	4	6	10	0	0	10	0	0
11	14912417	rs7129781	T	C	11	7	18	0	0	18	0	0
11	16760244	rs1846936	T	G	126	126	252	0	4	256	0	0
11	16761109	rs3802963	C	G	2	5	7	0	0	7	0	0
11	16761806	rs7928675	A	C	9	4	13	0	0	13	0	0
11	16772357	rs10766343	G	A	9	3	12	0	0	12	0	0
11	16773043	rs7939889	C	T	5	7	12	0	0	12	0	0
11	17096059	rs11024148	A	G	35	10	45	0	1	46	0	0
11	17096150	rs7125607	T	A	76	31	107	0	0	107	0	0
11	17096211	rs1541533	A	G	27	64	91	0	2	93	0	0
11	17111272	rs10832733	A	G	21	15	36	0	1	37	0	0
11	17191019	rs214936	A	G	6	10	16	0	0	16	0	0
11	17298365	rs214087	G	C	220	216	436	0	1	437	0	0
11	17298656	rs214085	C	T	27	13	40	0	1	41	0	0
11	17330109	rs10766384	A	G	4	2	6	0	0	6	0	0
11	17353910	rs10832765	A	C	15	9	24	0	0	24	0	0
11	17354775	rs11024256	T	G	23	17	40	0	1	41	0	0
11	17365827	rs11024260	G	C	6	3	9	0	0	9	0	0
11	17365888	rs10832768	T	G	6	4	10	0	0	10	0	0
11	17366158	rs10832769	G	C	5	10	15	0	0	15	0	0
11	17366659	rs10832770	G	A	2	4	6	0	0	6	0	0
11	17367249	rs10832771	G	A	8	3	11	0	0	11	0	0
11	17369885	.	T	G	7	0	7	0	2	9	0	0
11	17397273	rs10832782	G	C	5	3	8	0	0	8	0	0
11	17402336	rs4757511	C	G	4	4	8	0	0	8	0	0
11	17809639	rs10788	C	T	8	5	13	0	0	13	0	0
11	17809724	rs1528	T	C	26	19	45	0	0	45	0	0
11	18103222	rs72875761	C	T	4	5	9	0	0	9	0	0
11	18103702	rs56001925	A	C	5	2	7	0	0	7	0	0
11	18104454	rs11024469	A	G	3	3	6	0	0	6	0	0
11	18108512	rs35525096	T	C	47	49	96	0	0	96	0	0
11	18300625	rs1046628	G	A	8	8	16	0	2	18	0	0
11	18300954	rs1046615	G	A	21	16	37	0	0	37	0	0
11	18301129	rs12416821	A	G	17	19	36	0	0	36	0	0
11	18301130	rs12419588	G	A	17	18	35	0	1	36	0	0
11	18327684	rs1140047	G	T	7	14	21	0	0	21	0	0
11	18343878	rs3802968	A	G	2	4	6	0	0	6	0	0
11	18344064	rs3802967	T	C	3	7	10	0	0	10	0	0
11	18348581	rs12293544	T	C	4	4	8	0	0	8	0	0
11	18354877	rs4150561	T	C	3	3	6	0	0	6	0	0
11	18354995	rs4150562	A	G	6	6	12	0	0	12	0	0
11	18355308	rs4150564	G	A	7	5	12	0	0	12	0	0
11	18355599	rs4150566	C	G	12	7	19	0	0	19	0	0
11	18388128	rs4596	G	C	14	13	27	0	0	27	0	0
11	18419826	rs12284013	A	G	6	0	6	0	0	6	0	0
11	18421237	rs4757652	C	T	21	22	43	0	0	43	0	0
11	18421683	rs11601413	C	A	22	28	50	0	1	51	0	0
11	18422029	rs12274651	C	T	27	21	48	0	1	49	0	0
11	18429940	rs4757653	C	T	2	6	8	0	0	8	0	0
11	18505477	.	T	G	290	315	605	0	4	609	0	0
11	18524490	rs3925781	G	T	4	5	9	0	0	9	0	0
11	18528792	rs4298881	C	T	4	3	7	0	0	7	0	0
11	18531674	rs2658564	C	T	1	5	6	0	0	6	0	0
11	18535331	rs16935504	A	C	1	5	6	0	0	6	0	0
11	18547332	rs7931630	G	A	5	2	7	0	0	7	0	0
11	18555901	rs56151250	C	G	5	2	7	0	0	7	0	0
11	18555949	rs55999230	T	C	4	2	6	0	0	6	0	0
11	18629304	rs7934205	C	T	68	55	123	0	1	124	0	0
11	18633971	rs11605097	G	A	99	118	217	0	10	227	0	0
11	18636481	rs16935599	C	T	80	113	193	0	3	196	0	0
11	18636960	rs12795249	C	T	100	108	208	0	2	210	0	0
11	18656271	rs10832962	C	T	5	2	7	0	0	7	0	0
11	19167850	rs2271001	A	G	4	2	6	0	0	6	0	0
11	19251289	rs12273001	C	G	5	4	9	0	0	9	0	0
11	22646025	rs4447177	G	A	5	12	17	0	1	18	0	0
11	22842995	rs11543287	G	A	62	48	110	0	0	110	0	0
11	22843220	rs1019216	T	C	22	19	41	0	2	43	0	0
11	22843303	.	T	G	18	17	35	0	0	35	0	0
11	27517670	rs6484306	T	C	15	28	43	0	1	44	0	0
11	31531100	rs2295748	A	G	65	56	121	0	0	121	0	0
11	32606131	rs79865162	G	C	5	4	9	0	0	9	0	0
11	32623419	rs77379922	C	T	8	7	15	0	0	15	0	0
11	32624920	rs12789734	T	C	5	8	13	0	0	13	0	0
11	32955122	rs2297781	A	G	4	2	6	0	0	6	0	0
11	32956620	rs7481878	A	G	4	5	9	0	0	9	0	0
11	32996805	rs11032076	C	T	11	7	18	0	0	18	0	0
11	33076191	rs2273544	T	C	9	10	19	0	0	19	0	0
11	33095283	.	T	C	6	1	7	0	0	7	0	0
11	33097652	rs2273550	G	A	2	5	7	0	0	7	0	0
11	33097986	rs2273554	T	A	5	1	6	0	0	6	0	0
11	33099455	rs4756561	T	C	5	3	8	0	0	8	0	0
11	33102712	rs147835239	T	C	2	5	7	0	0	7	0	0
11	33183017	rs3736213	A	G	3	5	8	0	0	8	0	0
11	33378209	rs10600	A	G	26	23	49	0	0	49	0	0
11	33886547	rs3824848	C	T	11	10	21	0	1	22	0	0
11	33892298	.	T	C	9	10	19	0	1	20	0	0
11	33896780	rs7111491	T	C	5	2	7	0	0	7	0	0
11	33897278	rs10768032	A	G	2	5	7	0	0	7	0	0
11	33897791	rs10734420	T	G	0	6	6	0	0	6	0	0
11	33912790	rs11032440	C	T	7	35	42	0	1	43	0	0
11	33913568	rs2273799	T	C	3	5	8	0	0	8	0	0
11	34160326	rs12421526	T	A	8	8	16	0	1	17	0	0
11	34378381	rs1925368	G	C	3	4	7	0	0	7	0	0
11	34477876	rs2073059	G	C	5	4	9	0	0	9	0	0
11	34481916	rs144625345	G	A	4	3	7	0	0	7	0	0
11	34482908	rs769217	C	T	658	599	1257	0	10	1267	0	0
11	34491314	rs2284364	G	A	6	1	7	0	0	7	0	0
11	34491680	rs7947841	G	A	5	3	8	0	0	8	0	0
11	34491941	rs499406	T	C	5	1	6	0	0	6	0	0
11	34492443	rs17881488	C	A	5	5	10	0	0	10	0	0
11	35196599	rs75761035	C	T	1	5	6	0	0	6	0	0
11	35201842	rs1071695	C	T	1396	1131	2527	0	13	2540	0	0
11	35209584	rs72916137	A	G	4	3	7	0	1	8	0	0
11	35210492	rs140959562	A	T	4	4	8	0	0	8	0	0
11	35210798	rs996076	G	A	3	6	9	0	0	9	0	0
11	35210866	rs996075	T	G	2	6	8	0	0	8	0	0
11	35212084	rs149382108	T	G	9	11	20	0	0	20	0	0
11	35212288	rs7930724	A	G	8	4	12	0	0	12	0	0
11	35213126	rs7934770	G	T	4	4	8	0	0	8	0	0
11	35215726	rs10128562	T	G	3	4	7	0	0	7	0	0
11	35216935	rs11033021	C	T	5	1	6	0	0	6	0	0
11	35220471	rs11033023	C	T	6	3	9	0	1	10	0	0
11	35221862	rs7110737	T	A	14	7	21	0	0	21	0	0
11	35221910	rs11033024	T	C	9	19	28	0	0	28	0	0
11	35224531	rs75199214	G	A	20	10	30	0	0	30	0	0
11	35225044	rs79685344	T	A	11	17	28	0	0	28	0	0
11	35228499	rs145358857	G	C	8	10	18	0	0	18	0	0
11	35233347	rs61882763	G	A	6	1	7	0	0	7	0	0
11	35235430	rs17447755	G	A	10	10	20	0	0	20	0	0
11	35236734	rs7105890	G	A	7	2	9	0	1	10	0	0
11	35236923	rs61882766	C	A	5	2	7	0	0	7	0	0
11	35237412	rs11033028	C	T	6	2	8	0	0	8	0	0
11	35238122	rs61882767	T	C	6	6	12	0	0	12	0	0
11	35239145	rs4755391	G	T	3	3	6	0	0	6	0	0
11	35239907	rs12285721	C	T	3	4	7	0	0	7	0	0
11	35240329	rs61882769	A	G	5	9	14	0	0	14	0	0
11	35241229	rs2295756	T	C	4	4	8	0	0	8	0	0
11	35241637	rs10836342	C	G	6	0	6	0	0	6	0	0
11	35242500	rs10742333	G	A	5	2	7	0	0	7	0	0
11	35242542	rs2065005	G	A	2	8	10	0	0	10	0	0
11	35242907	rs10734436	G	A	6	0	6	0	0	6	0	0
11	35244058	rs7116432	A	G	97	74	171	0	3	174	0	0
11	35244574	rs11607862	C	T	108	63	171	0	0	171	0	0
11	35245287	rs10836344	G	T	8	21	29	0	0	29	0	0
11	35245783	rs10836345	G	A	4	3	7	0	0	7	0	0
11	35248780	rs4756199	T	G	3	5	8	0	0	8	0	0
11	35249670	rs12419062	A	G	10	13	23	0	0	23	0	0
11	35249818	rs10836346	G	A	12	6	18	0	0	18	0	0
11	35250518	rs927335	A	T	20	7	27	0	0	27	0	0
11	35251318	rs8193	C	T	1065	887	1952	0	20	1972	0	0
11	35252926	rs61882771	C	T	286	413	699	0	2	701	0	0
11	35253272	rs13347	C	T	490	519	1009	0	9	1018	0	0
11	35307148	rs3763888	T	C	6	5	11	0	0	11	0	0
11	35715905	rs1830816	A	G	2	4	6	0	0	6	0	0
11	35829003	rs597254	C	G	16	16	32	0	1	33	0	0
11	36103228	rs1138807	A	G	11	8	19	0	0	19	0	0
11	36399514	rs1425936	C	T	7	5	12	0	0	12	0	0
11	36400379	rs12421636	C	T	2	4	6	0	0	6	0	0
11	36401004	rs1425939	G	A	3	5	8	0	0	8	0	0
11	36473052	rs35407642	A	G	2	9	11	0	0	11	0	0
11	36484642	.	A	G	8	9	17	0	0	17	0	0
11	36508620	rs5030487	G	A	7	8	15	0	0	15	0	0
11	36509146	rs5030486	T	C	9	11	20	0	0	20	0	0
11	36509189	rs5030485	G	T	8	6	14	0	0	14	0	0
11	36510026	rs5030482	T	C	42	30	72	0	0	72	0	0
11	36510071	rs3740961	T	C	31	32	63	0	2	65	0	0
11	36510547	rs1046864	G	A	34	22	56	0	0	56	0	0
11	36513786	rs5030472	C	T	3	3	6	0	0	6	0	0
11	36514290	rs2303439	T	C	2	4	6	0	0	6	0	0
11	43346032	rs5743227	G	C	8	10	18	0	0	18	0	0
11	43358280	rs61883514	C	T	3	3	6	0	0	6	0	0
11	43362335	rs11828286	A	G	5	4	9	0	0	9	0	0
11	43364760	rs574726998	G	A	20	9	29	0	1	30	0	0
11	43411677	rs61883554	C	T	6	5	11	0	0	11	0	0
11	43472746	rs11551137	C	T	16	21	37	0	0	37	0	0
11	43776481	rs7115919	C	T	7	1	8	0	0	8	0	0
11	43876698	rs11555762	C	T	92	33	125	0	1	126	0	0
11	43877934	rs1061810	C	A	148	72	220	0	0	220	0	0
11	43919694	rs2460130	C	T	9	6	15	0	0	15	0	0
11	43919778	rs2434474	C	T	5	5	10	0	0	10	0	0
11	43919786	rs2460131	C	G	4	4	8	0	0	8	0	0
11	43920006	rs7107050	A	G	9	3	12	0	0	12	0	0
11	43921054	rs3824948	T	C	3	5	8	0	0	8	0	0
11	44087989	rs2074038	G	T	18	5	23	0	0	23	0	0
11	44089352	rs33952257	G	A	30	60	90	0	1	91	0	0
11	44098985	rs2074043	G	A	2	12	14	0	0	14	0	0
11	44099588	rs3134907	A	C	7	26	33	0	0	33	0	0
11	44099998	rs178526	T	A	28	13	41	0	0	41	0	0
11	44100021	rs3094391	T	C	10	25	35	0	2	37	0	0
11	44100542	rs2074044	G	T	4	8	12	0	0	12	0	0
11	44100846	rs178527	G	A	6	4	10	0	0	10	0	0
11	44104222	rs1080101	C	T	4	3	7	0	0	7	0	0
11	44104981	rs3107275	C	T	30	107	137	0	0	137	0	0
11	44607332	rs1981992	T	G	1	7	8	0	0	8	0	0
11	44638584	rs79332132	T	C	12	8	20	0	0	20	0	0
11	44640268	rs1139971	A	G	954	821	1775	0	23	1798	0	0
11	44640889	.	C	G	695	645	1340	0	4	1344	0	0
11	44650927	rs6485554	C	T	5	1	6	0	1	7	0	0
11	44954371	.	G	A	31	22	53	0	0	53	0	0
11	44954514	rs17722834	C	T	29	18	47	0	0	47	0	0
11	45203848	rs1078931	G	A	4	2	6	0	0	6	0	0
11	45832935	rs1139266	G	A	10	4	14	0	0	14	0	0
11	45833841	rs76564550	C	A	6	2	8	0	1	9	0	0
11	45833960	rs4756026	C	T	4	4	8	0	0	8	0	0
11	45834044	rs4756027	C	T	4	5	9	0	0	9	0	0
11	45834198	rs7943306	T	C	3	5	8	0	0	8	0	0
11	45834201	rs55758172	C	T	4	5	9	0	0	9	0	0
11	45888657	rs112302069	T	C	1	5	6	0	0	6	0	0
11	45889122	rs113196716	A	T	0	6	6	0	1	7	0	0
11	45892260	rs562197282	G	C	4	2	6	0	0	6	0	0
11	45903577	.	G	A	97	85	182	0	0	182	0	0
11	45903613	rs2292910	A	C	75	84	159	0	1	160	0	0
11	45904477	rs6798	T	C	152	127	279	0	1	280	0	0
11	45931248	.	C	G	5	2	7	0	0	7	0	0
11	46384580	rs145145944	T	C	6	4	10	0	0	10	0	0
11	46450142	rs2864834	C	T	0	8	8	0	0	8	0	0
11	47182353	rs7940473	A	G	4	3	7	0	0	7	0	0
11	47255132	.	C	T	4	6	10	0	0	10	0	0
11	47377283	rs71475909	A	G	58	30	88	0	2	90	0	0
11	47378245	rs3824869	T	C	117	108	225	0	1	226	0	0
11	47391948	rs10437655	G	A	2	4	6	0	0	6	0	0
11	47431703	rs61897432	A	G	21	23	44	0	0	44	0	0
11	47437033	rs11602837	C	T	55	63	118	0	0	118	0	0
11	47447955	rs7948705	C	G	19	15	34	0	0	34	0	0
11	47460306	rs7126210	A	G	3	3	6	0	0	6	0	0
11	47500267	rs2242081	T	C	3	4	7	0	0	7	0	0
11	47587452	rs11537751	C	T	30	8	38	0	1	39	0	0
11	47602879	rs75422278	G	A	9	10	19	0	0	19	0	0
11	47639063	rs9089	G	A	24	35	59	0	1	60	0	0
11	47640201	rs79845520	G	A	17	10	27	0	0	27	0	0
11	47746962	rs11039358	A	G	5	8	13	0	0	13	0	0
11	47748019	rs11605681	G	A	22	12	34	0	1	35	0	0
11	47748353	rs78904770	T	C	3	4	7	0	0	7	0	0
11	47753370	rs2290851	C	T	10	14	24	0	3	27	0	0
11	47763509	rs6485773	A	G	7	4	11	0	0	11	0	0
11	47764906	rs78261087	G	A	7	2	9	0	0	9	0	0
11	47773226	rs6485774	C	T	3	5	8	0	0	8	0	0
11	47773518	rs6485775	A	G	5	4	9	0	0	9	0	0
11	47800628	rs80090905	C	T	76	60	136	0	1	137	0	0
11	47805418	rs7925211	G	C	3	3	6	0	0	6	0	0
11	47828402	.	C	T	5	1	6	0	0	6	0	0
11	47828404	rs3837374	C	T	5	1	6	0	0	6	0	0
11	47828988	rs7115228	C	T	3	3	6	0	0	6	0	0
11	47857253	rs3816605	T	C	17	19	36	0	1	37	0	0
11	48145375	rs1566734	A	C	13	10	23	0	0	23	0	0
11	48146622	rs1503185	G	A	26	19	45	0	0	45	0	0
11	59623378	rs34324219	C	A	636	344	980	0	6	986	0	0
11	59623433	rs1042613	G	A	330	604	934	0	3	937	0	0
11	59830103	rs481950	A	G	1	5	6	0	0	6	0	0
11	59830198	rs533855	T	C	1	5	6	0	0	6	0	0
11	59831458	rs1286171	A	G	1	6	7	0	0	7	0	0
11	59833123	rs501697	T	A	0	6	6	0	0	6	0	0
11	59834318	rs579721	G	A	7	21	28	0	0	28	0	0
11	59837097	rs528823	C	T	986	668	1654	0	9	1663	0	0
11	59856028	rs1441586	T	C	4	5	9	0	0	9	0	0
11	59939307	rs610932	T	G	13	8	21	0	0	21	0	0
11	59940599	rs7232	T	A	102	90	192	0	3	195	0	0
11	59944580	rs72918674	C	T	16	12	28	0	0	28	0	0
11	59944810	rs7946992	T	C	11	14	25	0	0	25	0	0
11	59944898	rs631853	T	G	3	6	9	0	0	9	0	0
11	59945745	rs12453	T	C	122	95	217	0	1	218	0	0
11	59947252	rs583791	C	T	8	8	16	0	0	16	0	0
11	59968741	rs184909761	T	C	4	2	6	0	0	6	0	0
11	59976111	rs7932740	G	A	14	18	32	0	0	32	0	0
11	59978255	rs764859	C	G	3	3	6	0	0	6	0	0
11	59981769	rs670854	T	C	5	1	6	0	0	6	0	0
11	60609972	rs2074422	A	G	23	26	49	0	1	50	0	0
11	60617834	rs530963	C	A	44	40	84	0	1	85	0	0
11	60617942	rs493176	G	A	53	36	89	0	0	89	0	0
11	60619764	rs11571288	C	G	5	6	11	0	0	11	0	0
11	60660152	rs7105089	T	C	14	7	21	0	0	21	0	0
11	60660157	rs7116665	C	A	12	7	19	0	1	20	0	0
11	60663409	rs4939473	C	G	9	2	11	0	0	11	0	0
11	60663878	rs4938990	G	C	6	6	12	0	1	13	0	0
11	60664398	rs482584	T	C	5	2	7	0	0	7	0	0
11	60664562	rs3885382	C	T	4	2	6	0	0	6	0	0
11	60666341	rs3763840	G	A	552	480	1032	0	3	1035	0	0
11	60673868	rs17155470	T	C	183	146	329	0	8	337	0	0
11	60689445	rs555835	T	C	59	57	116	0	2	118	0	0
11	60739206	.	A	T	10	8	18	0	0	18	0	0
11	60739207	.	C	A	11	8	19	0	0	19	0	0
11	60739212	.	G	A	13	10	23	0	0	23	0	0
11	60783677	rs34993077	C	T	4	3	7	0	0	7	0	0
11	61101103	.	A	T	8	5	13	0	0	13	0	0
11	61113981	rs142611518	G	A	50	51	101	0	0	101	0	0
11	61549458	rs174534	A	G	3	3	6	0	0	6	0	0
11	61551356	rs174535	T	C	11	7	18	0	0	18	0	0
11	61557803	rs102275	T	C	4	6	10	0	0	10	0	0
11	61557826	rs102274	T	C	4	5	9	0	0	9	0	0
11	61631282	rs520298	C	T	3	5	8	0	0	8	0	0
11	61631331	rs639394	A	G	2	6	8	0	0	8	0	0
11	61631454	rs518511	T	G	4	4	8	0	0	8	0	0
11	61633182	rs482548	C	T	243	182	425	0	4	429	0	0
11	61642861	.	T	G	7	0	7	0	5	12	0	0
11	61730553	rs17185413	T	C	1	5	6	0	0	6	0	0
11	61733600	rs2019413	G	C	324	328	652	0	10	662	0	0
11	61736135	rs77709427	G	T	5	4	9	0	0	9	0	0
11	61736136	rs79502317	T	G	5	4	9	0	0	9	0	0
11	61895741	rs1675131	A	G	12	14	26	0	0	26	0	0
11	61897359	rs1675133	C	T	6	9	15	0	0	15	0	0
11	61908440	rs2277283	T	C	9	10	19	0	0	19	0	0
11	61913196	rs7129085	G	T	14	13	27	0	1	28	0	0
11	61919693	rs1047739	C	T	2	6	8	0	0	8	0	0
11	62293822	rs12366127	C	T	86	54	140	0	0	140	0	0
11	62294309	rs141117375	C	T	48	58	106	0	0	106	0	0
11	62361037	rs1058678	T	C	76	72	148	0	6	154	0	0
11	62361266	rs79825424	C	T	514	497	1011	0	10	1021	0	0
11	62388262	rs11231164	T	C	8	5	13	0	0	13	0	0
11	62430335	rs7386	G	A	58	59	117	0	0	117	0	0
11	62437362	.	G	A	26	24	50	0	1	51	0	0
11	62458663	rs72929419	A	C	3	3	6	0	0	6	0	0
11	62518611	rs141099182	G	A	8	1	9	0	0	9	0	0
11	62574587	rs10484	C	A	225	188	413	0	2	415	0	0
11	62652779	rs4726	C	T	318	271	589	0	8	597	0	0
11	63274120	rs12272556	G	C	5	7	12	0	0	12	0	0
11	63274526	rs12803628	T	A	2	4	6	0	0	6	0	0
11	63274768	rs1404504	T	G	5	4	9	0	0	9	0	0
11	63274914	rs1404503	G	A	7	8	15	0	0	15	0	0
11	63275563	rs10897430	C	T	10	5	15	0	0	15	0	0
11	63278621	rs2239679	C	G	5	3	8	0	0	8	0	0
11	63281273	rs933187	A	T	7	7	14	0	0	14	0	0
11	63281594	rs933186	C	T	3	9	12	0	0	12	0	0
11	63397946	rs189364963	A	T	7	5	12	0	0	12	0	0
11	63585804	rs643634	C	A	85	70	155	0	1	156	0	0
11	63587248	rs502529	C	T	2	4	6	0	0	6	0	0
11	63591965	rs480874	A	T	4	2	6	0	0	6	0	0
11	63592621	rs10897449	C	T	3	6	9	0	0	9	0	0
11	63593219	rs10897450	G	C	3	4	7	0	0	7	0	0
11	63593846	rs12286800	G	C	5	1	6	0	0	6	0	0
11	63594222	rs11231596	G	A	6	5	11	0	0	11	0	0
11	63595072	rs8995	C	A	107	78	185	0	3	188	0	0
11	63677932	rs10736731	C	T	74	78	152	0	1	153	0	0
11	63713317	rs3740637	G	A	22	26	48	0	0	48	0	0
11	63714319	rs4980500	T	C	15	7	22	0	0	22	0	0
11	63722448	rs10897465	C	T	37	39	76	0	2	78	0	0
11	63723238	rs10897466	A	G	23	24	47	0	2	49	0	0
11	63723281	rs1386346	G	A	23	16	39	0	0	39	0	0
11	63724175	rs1055933	G	A	15	23	38	0	0	38	0	0
11	63742553	rs11231664	T	G	3	9	12	0	0	12	0	0
11	63743420	rs11605797	A	G	8	11	19	0	0	19	0	0
11	63767186	rs709594	A	G	88	73	161	0	0	161	0	0
11	63964605	rs2236647	C	T	36	44	80	0	1	81	0	0
11	63965948	rs7123004	C	T	17	17	34	0	0	34	0	0
11	63969292	rs7934801	G	A	7	13	20	0	0	20	0	0
11	63969497	rs7950596	A	G	8	8	16	0	0	16	0	0
11	63969841	rs7102415	A	G	1	10	11	0	0	11	0	0
11	63971687	.	G	A	231	212	443	0	4	447	0	0
11	63974966	rs149000560	G	A	358	360	718	0	5	723	0	0
11	63989876	rs12283842	A	G	8	6	14	0	0	14	0	0
11	63992866	rs10897477	T	C	6	1	7	0	0	7	0	0
11	63994230	rs2286612	G	T	30	27	57	0	1	58	0	0
11	64012521	rs79599120	G	T	7	3	10	0	0	10	0	0
11	64023971	rs7943988	G	A	21	18	39	0	1	40	0	0
11	64026639	rs12146487	G	A	12	12	24	0	0	24	0	0
11	64026685	rs28395882	C	T	17	22	39	0	0	39	0	0
11	64033555	rs3815362	C	T	3	6	9	0	0	9	0	0
11	64037602	rs144873026	G	C	161	154	315	0	3	318	0	0
11	64039175	rs2286615	G	A	127	117	244	0	1	245	0	0
11	64052447	rs2510066	C	T	3	6	9	0	0	9	0	0
11	64055643	.	G	A	20	17	37	0	2	39	0	0
11	64083506	rs538292483	G	A	17	13	30	0	0	30	0	0
11	64087642	rs627425	C	T	4	2	6	0	0	6	0	0
11	64107735	rs663743	G	A	46	34	80	0	3	83	0	0
11	64111928	rs685870	T	C	155	111	266	0	11	277	0	0
11	64374241	rs3741399	G	A	99	64	163	0	2	165	0	0
11	64413968	rs56105921	C	A	2	6	8	0	0	8	0	0
11	64415111	rs7128467	C	T	3	4	7	0	0	7	0	0
11	64559740	rs17854520	G	A	117	104	221	0	1	222	0	0
11	64559898	rs10897526	T	C	6	6	12	0	0	12	0	0
11	64572602	rs2071313	G	A	13	22	35	0	1	36	0	0
11	64669678	.	G	A	28	50	78	0	1	79	0	0
11	64672292	rs61886114	C	T	7	1	8	0	0	8	0	0
11	65351074	rs10896018	G	A	54	70	124	0	0	124	0	0
11	65380124	rs1078457	C	T	4	4	8	0	0	8	0	0
11	65380916	rs2004649	G	A	153	160	313	0	3	316	0	0
11	65384727	rs12790427	C	T	23	11	34	0	0	34	0	0
11	65386301	.	C	T	17	17	34	0	0	34	0	0
11	65387378	rs61744384	T	A	21	11	32	0	2	34	0	0
11	65389890	rs11227241	G	C	5	7	12	0	0	12	0	0
11	65405596	rs56343805	G	T	8	2	10	0	0	10	0	0
11	65405600	rs2306363	G	T	5	8	13	0	0	13	0	0
11	65406869	rs3782086	C	T	4	5	9	0	0	9	0	0
11	65408937	rs3741378	C	T	110	111	221	0	1	222	0	0
11	65422591	rs7119750	C	T	3	5	8	0	0	8	0	0
11	65422853	rs11227247	A	C	6	3	9	0	0	9	0	0
11	65423930	rs1108922	C	T	25	21	46	0	1	47	0	0
11	65427346	rs2306365	G	A	7	3	10	0	0	10	0	0
11	65428302	rs4930158	G	T	15	14	29	0	1	30	0	0
11	65429936	rs11820062	T	C	2	4	6	0	0	6	0	0
11	65484569	rs563427	A	G	10	9	19	0	0	19	0	0
11	65484719	rs2236683	C	A	13	9	22	0	0	22	0	0
11	65484883	rs1151501	A	G	9	9	18	0	0	18	0	0
11	65485727	rs521678	T	G	38	57	95	0	2	97	0	0
11	65486237	.	C	T	96	38	134	0	2	136	0	0
11	65543421	rs522800	G	C	29	21	50	0	0	50	0	0
11	65546857	rs610037	A	C	59	43	102	0	1	103	0	0
11	65547333	rs12146493	G	A	46	42	88	0	0	88	0	0
11	65547455	rs12362011	C	A	16	12	28	0	0	28	0	0
11	65638719	rs633800	G	A	7	10	17	0	0	17	0	0
11	65640906	rs7940691	C	T	2	4	6	0	0	6	0	0
11	65663636	rs112865376	C	T	11	13	24	0	0	24	0	0
11	65664006	rs614520	G	A	12	14	26	0	0	26	0	0
11	65664346	rs637571	T	C	150	151	301	0	1	302	0	0
11	65665200	rs1151523	C	T	8	7	15	0	0	15	0	0
11	65665256	rs634534	A	G	6	12	18	0	0	18	0	0
11	65665988	rs689274	A	G	7	5	12	0	0	12	0	0
11	65667149	rs10160792	C	G	4	7	11	0	0	11	0	0
11	65667796	rs1058068	G	A	11	17	28	0	0	28	0	0
11	65727301	rs491973	A	G	1	5	6	0	0	6	0	0
11	65732651	rs550435	G	A	222	204	426	0	2	428	0	0
11	65733393	rs688862	C	T	207	172	379	0	6	385	0	0
11	65735174	rs660118	G	C	255	259	514	0	3	518	1	0
11	65744265	rs2276016	C	T	3	7	10	0	0	10	0	0
11	65746653	rs679581	A	G	5	1	6	0	0	6	0	0
11	65764383	rs3016868	C	T	65	65	130	0	1	131	0	0
11	65764538	rs9735063	T	C	52	49	101	0	2	103	0	0
11	65769295	rs613924	C	T	12	3	15	0	0	15	0	0
11	65769456	rs1047464	A	T	27	29	56	0	1	57	0	0
11	65769780	rs14157	T	G	5	18	23	0	0	23	0	0
11	65770413	rs12794370	G	A	15	13	28	0	0	28	0	0
11	65770545	rs2276132	G	A	3	4	7	0	0	7	0	0
11	66011280	rs2298466	T	C	144	102	246	0	2	248	0	0
11	66031660	rs1151539	C	T	6	5	11	0	0	11	0	0
11	66041807	rs1151540	A	C	39	30	69	0	0	69	0	0
11	66043898	rs2508657	G	A	266	256	522	0	9	531	0	0
11	66048452	rs72938506	C	T	6	8	14	0	0	14	0	0
11	66083129	rs3741367	T	C	22	33	55	0	2	57	0	0
11	66083782	rs3741368	G	A	7	10	17	0	0	17	0	0
11	66103481	rs140145986	C	T	5	2	7	0	0	7	0	0
11	66105194	rs1052566	G	A	233	223	456	0	7	463	0	0
11	66106261	rs143489952	G	A	5	7	12	0	0	12	0	0
11	66107320	rs2016960	G	A	6	6	12	0	1	13	0	0
11	66108660	rs947978	C	T	12	7	19	0	0	19	0	0
11	66108894	rs2236679	G	C	4	7	11	0	0	11	0	0
11	66109033	rs11537993	T	C	135	159	294	0	3	297	0	0
11	66116836	rs10896112	G	C	3	3	6	0	0	6	0	0
11	66130358	rs3177514	T	G	22	17	39	0	0	39	0	0
11	66130548	rs1047029	C	T	19	15	34	0	0	34	0	0
11	66136579	.	G	A	9	17	26	0	0	26	0	0
11	66203025	rs2279865	A	C	3	8	11	0	0	11	0	0
11	66240882	rs2277302	T	C	4	4	8	0	0	8	0	0
11	66242107	rs61582507	A	G	6	8	14	0	0	14	0	0
11	66242402	rs4930377	T	G	13	12	25	0	0	26	1	0
11	66247696	rs2279863	G	T	5	7	12	0	0	12	0	0
11	66254085	rs11550299	G	T	70	90	160	0	0	160	0	0
11	66272142	rs1671063	A	G	122	133	255	0	0	255	0	0
11	66272237	rs2305535	G	A	115	121	236	0	3	239	0	0
11	66277035	rs17065	G	A	142	109	251	0	0	251	0	0
11	66282095	rs2298806	G	A	12	14	26	0	2	28	0	0
11	66288733	rs10896125	G	C	20	23	43	0	0	43	0	0
11	66297363	rs3816492	C	T	7	6	13	0	0	13	0	0
11	66299515	rs8432	A	G	3	14	17	0	1	18	0	0
11	66300348	rs3741360	A	G	14	10	24	0	0	24	0	0
11	66300463	rs1791686	G	A	9	10	19	0	0	19	0	0
11	66303854	rs7116921	T	C	11	18	29	0	0	29	0	0
11	66303895	rs7116940	T	C	20	8	28	0	1	29	0	0
11	66305127	rs11227521	T	C	8	8	16	0	1	17	0	0
11	66305728	rs11227522	A	C	12	5	17	0	0	17	0	0
11	66305938	rs11227523	C	T	8	3	11	0	1	12	0	0
11	66306355	rs3737525	A	G	16	13	29	0	0	29	0	0
11	66309269	rs3867132	C	T	3	4	7	0	0	7	0	0
11	66313203	rs2305534	T	C	13	18	31	0	1	32	0	0
11	66331000	rs4576	A	G	12	11	23	0	0	23	0	0
11	66331458	rs572846	A	G	31	44	75	0	1	76	0	0
11	66333598	rs545009	C	T	34	29	63	0	0	63	0	0
11	66373305	rs1127145	G	A	139	76	215	0	1	216	0	0
11	66387094	rs477557	C	T	4	7	11	0	0	11	0	0
11	66392880	rs11550057	C	T	109	80	189	0	5	194	0	0
11	66394387	rs15969	C	T	149	128	277	0	2	279	0	0
11	66401373	rs566673	T	G	5	2	7	0	0	7	0	0
11	66402333	rs580910	C	T	3	5	8	0	0	8	0	0
11	66409409	rs519380	G	A	5	8	13	0	0	13	0	0
11	66443461	rs75863187	G	A	8	10	18	0	0	18	0	0
11	66613356	.	C	T	85	64	149	0	0	149	0	0
11	67018632	rs72930739	A	G	19	12	31	0	0	31	0	0
11	67039437	.	G	C	9	9	18	0	0	18	0	0
11	67196237	rs1476792	T	C	9	15	24	0	0	24	0	0
11	67197757	rs12573992	A	G	6	3	9	0	0	9	0	0
11	67199706	rs1638588	C	A	10	8	18	0	0	18	0	0
11	67200819	rs4930427	C	T	229	218	447	0	6	453	0	0
11	67202044	rs1790752	G	A	29	20	49	0	0	49	0	0
11	67202156	rs13859	C	T	184	172	356	0	3	359	0	0
11	67202826	rs10274	G	A	54	62	116	0	0	116	0	0
11	67204342	rs12787021	A	G	5	4	9	0	0	9	0	0
11	67207426	rs2302264	G	A	4	9	13	0	0	13	0	0
11	67264679	rs2276120	C	T	19	20	39	0	1	40	0	0
11	67351585	rs4147581	C	G	4	14	18	0	0	18	0	0
11	67351774	rs2370143	C	T	12	17	29	0	0	29	0	0
11	67352256	rs762803	C	A	8	14	22	0	0	22	0	0
11	67352689	rs1695	A	G	2474	3122	5596	0	75	5673	2	0
11	67353253	rs749174	G	A	12	9	21	0	1	22	0	0
11	67353844	rs1871042	C	T	65	15	80	0	0	80	0	0
11	67353970	rs4891	T	C	2253	2737	4990	0	28	5020	2	0
11	67374581	rs1871043	T	C	6	4	10	0	0	10	0	0
11	67375184	rs7948073	T	G	25	24	49	0	0	49	0	0
11	67393734	rs2514017	A	C	3	8	11	0	0	11	0	0
11	67395714	rs7124513	C	T	84	80	164	0	1	165	0	0
11	67758895	rs7932	G	C	59	64	123	0	0	123	0	0
11	67759254	rs7149	G	C	17	11	28	0	0	28	0	0
11	67765056	rs308328	T	C	3	9	12	0	0	12	0	0
11	67765507	rs308327	T	G	4	5	9	0	0	9	0	0
11	67789138	rs2286168	C	T	41	32	73	0	0	73	0	0
11	67793509	rs2286163	C	T	37	30	67	0	0	67	0	0
11	67796632	rs15518	T	C	41	28	69	0	0	69	0	0
11	67798567	rs1122731	G	A	2	4	6	0	0	6	0	0
11	67799926	rs2075626	T	C	17	33	50	0	0	50	0	0
11	67802907	rs1104739	A	C	7	2	9	0	0	9	0	0
11	67803215	rs2075627	G	A	12	7	19	0	0	19	0	0
11	67803453	rs140602229	T	G	14	2	16	0	0	16	0	0
11	67804074	rs1051806	C	T	73	79	152	0	2	154	0	0
11	67813573	rs12273861	G	T	5	4	9	0	0	9	0	0
11	67816092	rs72926470	G	C	4	3	7	0	0	7	0	0
11	67816936	rs2075609	A	G	2	10	12	0	0	12	0	0
11	67820335	rs11481	T	A	21	9	30	0	0	30	0	0
11	67821127	rs11538783	T	C	211	205	416	0	0	416	0	0
11	67827660	rs12270493	A	G	3	6	9	0	0	9	0	0
11	67832497	rs146760101	G	A	19	24	43	0	0	43	0	0
11	67833543	rs7928739	C	A	9	12	21	0	0	21	0	0
11	67851436	rs2512613	C	G	9	1	10	0	0	10	0	0
11	67853673	rs2512608	C	T	5	2	7	0	0	7	0	0
11	67854035	rs2511439	T	C	10	1	11	0	0	11	0	0
11	67857296	.	G	A	3	8	11	0	0	11	0	0
11	67884739	rs6591331	A	T	4	2	6	0	0	6	0	0
11	68094741	rs634008	C	T	5	3	8	0	0	8	0	0
11	68192690	rs556442	G	A	8	4	12	0	0	12	0	0
11	68241833	rs643609	A	G	3	3	6	0	0	6	0	0
11	68303980	rs11228275	G	A	4	2	6	0	0	6	0	0
11	68347870	rs7108376	A	G	5	3	8	0	0	8	0	0
11	68348354	rs73506204	C	T	1	5	6	0	0	6	0	0
11	68348695	rs871212	T	A	6	6	12	0	0	12	0	0
11	68349754	rs11228287	A	G	8	6	14	0	1	15	0	0
11	68377602	rs7104877	A	C	3	4	7	0	0	7	0	0
11	68378045	rs2236708	G	A	3	5	8	0	0	8	0	0
11	68379772	rs11228292	G	A	3	7	10	0	0	10	0	0
11	68381415	rs3740628	A	G	72	45	117	0	3	120	0	0
11	68381607	rs4988291	G	A	118	108	226	0	0	226	0	0
11	68382193	rs12941	C	T	119	134	253	0	0	253	0	0
11	68474980	rs193156810	T	G	3	9	12	0	0	12	0	0
11	68505174	rs187001630	T	C	6	2	8	0	0	8	0	0
11	68665480	rs117105758	T	C	212	163	375	0	1	376	0	0
11	68696973	rs79051613	A	G	17	12	29	0	0	29	0	0
11	68831364	rs72928978	G	A	11	13	24	0	0	24	0	0
11	68840160	rs3750965	A	G	17	13	30	0	0	30	0	0
11	68846399	rs35264875	A	T	21	14	35	0	0	35	0	0
11	68854012	rs35337391	A	G	9	13	22	0	0	22	0	0
11	69482068	rs61360017	A	G	10	5	15	0	0	15	0	0
11	70049523	rs1131677	A	G	16	8	24	0	0	24	0	0
11	70118251	rs670012	T	G	6	6	12	0	0	12	0	0
11	70118489	rs546502	G	A	12	16	28	0	0	28	0	0
11	70229171	rs552282	G	A	18	22	40	0	2	42	0	0
11	71146886	rs138659167	C	G	11	69	80	0	0	80	0	0
11	71822996	rs80125369	C	T	8	4	12	0	0	12	0	0
11	71850130	rs61734430	C	T	12	9	21	0	0	21	0	0
11	72003767	rs526344	C	A	5	6	11	0	0	11	0	0
11	72288599	rs1980091	G	A	21	22	43	0	0	43	0	0
11	72288725	rs1980089	C	T	5	2	7	0	0	7	0	0
11	72288843	rs371862	C	T	7	1	8	0	0	8	0	0
11	72289291	rs1135029	T	C	10	14	24	0	1	25	0	0
11	72290629	rs392565	G	A	25	24	49	0	0	49	0	0
11	72296039	rs907850	G	T	10	12	22	0	0	22	0	0
11	72396800	rs12802369	A	G	13	13	26	0	0	26	0	0
11	72396990	rs12805218	G	A	20	13	33	0	0	33	0	0
11	72399607	rs2306609	G	A	21	19	40	0	0	40	0	0
11	72400596	rs900615	A	G	9	12	21	0	0	21	0	0
11	72400857	rs900614	A	T	10	14	24	0	0	24	0	0
11	72400958	rs900613	G	T	17	14	31	0	0	31	0	0
11	72401101	rs4944668	T	C	14	27	41	0	1	42	0	0
11	72401813	rs55719917	T	G	18	17	35	0	0	35	0	0
11	72403595	rs2306607	T	C	8	8	16	0	1	17	0	0
11	72405545	rs11235569	A	C	8	9	17	0	0	17	0	0
11	72408266	rs2306614	C	T	10	7	17	0	0	17	0	0
11	72408657	rs2291289	C	T	136	120	256	0	6	262	0	0
11	72415329	rs2306615	G	A	67	77	144	0	3	147	0	0
11	72415528	rs2306616	G	T	2	4	6	0	0	6	0	0
11	72926201	rs1628464	C	T	4	3	7	0	0	7	0	0
11	72929447	rs7948393	T	C	3	7	10	0	0	10	0	0
11	72946020	rs1783596	C	T	65	14	79	0	1	80	0	0
11	72946204	rs1626154	C	T	77	32	109	0	2	111	0	0
11	73088478	rs112838398	C	G	46	37	83	0	1	84	0	0
11	73088494	rs60576099	G	A	43	32	75	0	3	78	0	0
11	73091484	rs7108185	A	T	49	50	99	0	1	100	0	0
11	73104724	rs79365754	G	T	62	41	103	0	0	103	0	0
11	73373552	rs6590	G	A	9	15	24	0	1	25	0	0
11	73611349	rs2067912	G	C	16	4	20	0	0	20	0	0
11	73678945	rs4944871	T	C	13	23	36	0	0	36	0	0
11	73679219	rs2306817	G	C	10	21	31	0	0	31	0	0
11	73679232	rs2306818	A	G	9	19	28	0	0	28	0	0
11	73679655	rs3816824	G	A	5	13	18	0	0	18	0	0
11	73679892	rs58125455	G	A	9	13	22	0	0	22	0	0
11	73680051	rs17132517	C	T	6	16	22	0	0	22	0	0
11	73680063	rs599277	G	A	8	14	22	0	0	22	0	0
11	73680128	rs72982970	T	G	7	6	13	0	0	13	0	0
11	73680776	rs72982971	C	T	10	12	22	0	0	22	0	0
11	73681090	rs2306819	C	T	7	6	13	0	0	13	0	0
11	73681135	rs72982975	G	A	9	10	19	0	0	19	0	0
11	73681347	rs2306820	T	C	5	13	18	0	1	19	0	0
11	73689104	rs660339	G	A	87	143	230	0	2	232	0	0
11	73690663	rs2200614	G	A	4	8	12	0	0	12	0	0
11	73690864	.	A	G	15	5	20	0	1	22	1	0
11	73712020	rs647126	A	G	4	2	6	0	0	6	0	0
11	73785326	rs4453265	T	C	12	13	25	0	0	25	0	0
11	73796917	rs826058	C	T	11	8	19	0	0	19	0	0
11	74043171	rs10793072	A	G	15	10	25	0	0	25	0	0
11	74043708	rs596976	G	A	9	4	13	0	0	13	0	0
11	74044139	rs11236061	G	A	4	2	6	0	0	6	0	0
11	74044557	rs1053021	C	T	5	8	13	0	0	13	0	0
11	74044976	rs3193507	C	T	7	3	10	0	0	10	0	0
11	74045742	rs1063807	A	G	6	8	14	0	0	14	0	0
11	74046861	rs7941916	C	T	5	3	8	0	0	8	0	0
11	74046975	rs598869	C	T	9	8	17	0	0	17	0	0
11	74047683	rs1044782	A	G	7	8	15	0	0	15	0	0
11	74049569	rs3867270	A	G	12	11	23	0	1	24	0	0
11	74053547	rs592644	C	T	7	5	12	0	1	13	0	0
11	74203004	rs3741128	G	A	4	2	6	0	0	6	0	0
11	74203308	rs586088	T	A	5	3	8	0	0	8	0	0
11	74352160	rs138458423	G	A	13	10	23	0	0	23	0	0
11	74546905	rs1125609	G	A	9	11	20	0	0	20	0	0
11	74548261	rs1866562	G	A	3	5	8	0	0	8	0	0
11	74549391	rs1821352	G	A	18	13	31	0	0	31	0	0
11	74550956	rs1583342	A	G	14	13	27	0	0	27	0	0
11	74551025	rs2033532	C	A	13	12	25	0	0	25	0	0
11	74553074	rs9444	C	T	22	36	58	0	7	65	0	0
11	74705696	rs544115	T	C	5	4	9	0	0	9	0	0
11	74721702	rs685116	C	G	12	9	21	0	0	21	0	0
11	74975662	rs2282600	G	A	62	80	142	0	1	143	0	0
11	74977067	rs2279129	C	T	80	85	165	0	1	166	0	0
11	74977185	rs2279130	C	T	76	82	158	0	0	158	0	0
11	75112137	rs2070763	A	G	3	3	6	0	0	6	0	0
11	75116959	rs4348932	G	A	23	33	56	0	0	56	0	0
11	75146384	rs1043638	A	G	100	70	170	0	7	177	0	0
11	75161579	rs12417328	G	A	4	8	12	0	0	12	0	0
11	75162036	rs56389002	G	C	5	10	15	0	0	15	0	0
11	75162041	rs61897376	G	A	5	10	15	0	0	15	0	0
11	75166510	rs56010007	T	C	2	4	6	0	0	6	0	0
11	75190413	rs56412430	G	A	8	14	22	0	0	22	0	0
11	75277992	rs651581	C	T	11	15	26	0	1	27	0	0
11	75283253	rs9175	A	G	8	9	17	0	1	18	0	0
11	76257535	rs3753052	A	C	3	4	7	0	0	7	0	0
11	76261533	rs2513513	A	G	20	7	27	0	0	27	0	0
11	76262652	rs8848	G	T	3	3	6	0	0	6	0	0
11	76369913	rs11236839	G	A	4	3	7	0	0	7	0	0
11	76579429	rs113895939	C	G	23	14	37	0	2	39	0	0
11	76733313	rs17135325	C	A	4	7	11	0	0	11	0	0
11	76737245	rs1945085	A	G	4	4	8	0	0	8	0	0
11	76919478	rs948962	C	A	6	0	6	0	0	6	0	0
11	77033699	rs2729762	A	G	38	30	68	0	0	68	0	0
11	77033708	rs2844337	A	C	39	31	70	0	0	70	0	0
11	77373471	rs2298819	C	A	3	7	10	0	0	10	0	0
11	77407652	rs7130719	A	T	22	19	41	0	1	42	0	0
11	77409246	rs4945201	G	A	5	6	11	0	0	11	0	0
11	77412851	rs7950873	A	G	23	28	51	0	0	51	0	0
11	77428933	rs72947668	C	T	3	3	6	0	0	6	0	0
11	77528161	rs4945220	C	G	5	2	7	0	0	7	0	0
11	77553638	rs585721	T	C	82	74	156	0	2	158	0	0
11	77583376	rs588217	G	A	19	14	33	0	0	33	0	0
11	77698651	rs6592756	T	C	2	10	12	0	0	12	0	0
11	77790653	rs534418	T	C	317	436	753	0	8	761	0	0
11	77790655	rs8875	G	C	323	436	759	0	5	764	0	0
11	77790863	rs499799	C	G	201	219	420	0	2	422	0	0
11	77813941	rs640016	T	C	4	12	16	0	0	16	0	0
11	77825320	rs665278	T	C	49	28	77	0	1	78	0	0
11	77926824	rs111642945	G	A	237	218	455	0	13	468	0	0
11	77929549	.	C	A	109	124	233	0	1	234	0	0
11	82400713	rs55868869	C	T	233	0	233	0	9	242	0	0
11	82564294	rs2229437	T	G	125	132	257	0	29	286	0	0
11	85344638	rs145926615	A	G	5	2	7	0	0	7	0	0
11	85345545	rs2304342	G	A	9	7	16	0	0	16	0	0
11	85347415	rs1046216	G	A	20	18	38	0	0	38	0	0
11	85367289	rs3753050	C	T	4	3	7	0	0	7	0	0
11	85373668	rs7116195	A	G	8	7	15	0	0	15	0	0
11	85375601	rs17810766	G	A	12	14	26	0	1	27	0	0
11	85670444	rs112133879	G	A	2	4	6	0	0	6	0	0
11	85673270	rs563773	C	T	6	2	8	0	0	8	0	0
11	85673836	rs57125313	C	T	3	3	6	0	0	6	0	0
11	85690012	rs7131120	C	G	6	17	23	0	0	23	0	0
11	85692181	rs694353	A	C	99	148	247	0	0	247	0	0
11	85696332	rs12224233	T	C	4	5	9	0	0	9	0	0
11	85696358	rs72951268	C	A	6	4	10	0	0	10	0	0
11	85697484	rs113479841	A	T	4	3	7	0	0	7	0	0
11	85753481	rs544848	A	T	21	8	29	0	0	29	0	0
11	85754392	rs10128700	G	A	13	12	25	0	0	25	0	0
11	85754721	rs17817919	G	C	17	14	31	0	0	31	0	0
11	85755538	rs17745273	A	G	5	10	15	0	0	15	0	0
11	85756362	rs618001	C	T	3	6	9	0	0	9	0	0
11	85756884	rs2508692	T	A	8	6	14	0	0	14	0	0
11	85757133	rs1941375	T	C	4	4	8	0	0	8	0	0
11	85757892	rs4944554	C	T	4	5	9	0	0	9	0	0
11	85968623	rs974144	C	T	25	15	40	0	0	40	0	0
11	85972478	rs10792843	C	T	4	2	6	0	0	6	0	0
11	85973869	.	C	T	2	4	6	0	0	6	0	0
11	86013361	rs291241	A	G	72	57	129	0	2	131	0	0
11	86055472	rs12289477	A	G	3	4	7	0	0	7	0	0
11	86153911	rs7548	G	A	32	23	55	0	0	55	0	0
11	86161388	rs1042780	C	G	20	28	48	0	0	48	0	0
11	87013438	rs2276102	G	A	9	3	12	0	0	12	0	0
11	87032664	rs17821399	G	A	4	5	9	0	0	9	0	0
11	87846757	rs9144	C	T	15	6	21	0	0	21	0	0
11	87847018	rs3740925	C	T	20	13	33	0	0	33	0	0
11	87847063	rs1027027	C	A	22	16	38	0	0	38	0	0
11	88030785	rs217111	G	A	0	6	6	0	0	6	0	0
11	88032419	rs10830610	A	G	3	5	8	0	0	8	0	0
11	88045125	rs10830638	C	T	6	1	7	0	0	7	0	0
11	88045583	rs217086	A	G	98	105	203	0	1	204	0	0
11	88054346	rs217054	G	C	2	4	6	0	0	6	0	0
11	88064686	rs567388	G	A	9	7	16	0	1	17	0	0
11	88064750	rs217067	A	G	8	20	28	0	0	28	0	0
11	88064982	rs217068	A	C	18	30	48	0	0	48	0	0
11	88066488	rs10765463	T	C	6	4	10	0	0	10	0	0
11	88066737	rs669660	G	A	7	4	11	0	0	11	0	0
11	88068004	rs217075	T	A	6	5	11	0	0	11	0	0
11	88068052	rs217076	G	T	6	7	13	0	0	13	0	0
11	89939569	rs723715	T	C	4	2	6	0	0	6	0	0
11	89941327	rs10741327	G	A	6	4	10	0	0	10	0	0
11	89942645	rs11018912	C	T	5	3	8	0	0	8	0	0
11	89942655	rs11018913	G	C	5	3	8	0	0	8	0	0
11	89942659	rs11018914	C	A	5	3	8	0	0	8	0	0
11	89944964	rs10765275	C	T	4	5	9	0	0	9	0	0
11	89945358	rs10765276	C	A	15	8	23	0	1	24	0	0
11	89945647	rs11018917	A	C	7	6	13	0	0	13	0	0
11	89945668	rs2226571	C	T	8	6	14	0	0	14	0	0
11	89946354	rs11601793	T	G	6	16	22	0	0	22	0	0
11	92878666	rs76935911	A	C	3	7	10	0	0	10	0	0
11	92881044	rs1062050	T	G	20	15	35	0	1	36	0	0
11	92914765	rs61920515	T	C	2	4	6	0	0	6	0	0
11	93408743	rs62622500	G	A	2	9	11	0	0	11	0	0
11	93476627	rs7943266	G	C	5	4	9	0	0	9	0	0
11	93476766	rs652961	G	A	7	4	11	0	1	12	0	0
11	93476860	rs7943525	G	C	9	8	17	0	0	17	0	0
11	93477621	rs10741476	A	G	0	6	6	0	0	6	0	0
11	93495975	rs7310	A	G	13	17	30	0	1	31	0	0
11	93498552	rs630811	G	A	4	6	10	0	0	10	0	0
11	93499361	rs644535	C	T	5	5	10	0	0	10	0	0
11	93517874	rs7116967	C	G	48	51	99	0	1	100	0	0
11	93517886	rs2848477	G	C	49	56	105	0	1	106	0	0
11	93537577	rs113023493	C	T	4	3	7	0	0	7	0	0
11	93540001	rs673869	G	A	3	3	6	0	0	6	0	0
11	93544175	rs11603339	C	T	14	20	34	0	0	34	0	0
11	93544242	rs11603364	C	T	23	20	43	0	0	43	0	0
11	93914451	rs1046805	G	A	6	4	10	0	0	10	0	0
11	93914478	rs13655	G	C	8	2	10	0	0	10	0	0
11	93914709	rs1046812	T	C	8	6	14	0	0	14	0	0
11	93914956	rs1070	A	G	10	8	18	0	0	18	0	0
11	93914990	rs1071	T	G	13	9	22	0	0	22	0	0
11	94193020	rs496190	A	G	2	4	6	0	0	6	0	0
11	94231257	rs2509943	C	G	34	40	74	0	1	75	0	0
11	94353933	rs77644062	G	A	5	8	13	0	0	13	0	0
11	94602385	.	C	T	16	14	30	0	0	30	0	0
11	94802318	rs1056986	G	A	4	4	8	0	0	8	0	0
11	94802620	rs12627	C	A	20	21	41	0	0	41	0	0
11	94802776	rs681695	G	C	23	14	37	0	0	37	0	0
11	94802952	rs681134	A	G	31	20	51	0	0	51	0	0
11	94803043	rs680673	A	T	23	26	49	0	0	49	0	0
11	94803525	rs1267145	T	C	6	7	13	0	0	13	0	0
11	94899847	rs3802776	G	C	8	8	16	0	0	16	0	0
11	94902171	rs12361586	A	G	5	8	13	0	0	13	0	0
11	95521975	.	G	A	8	6	14	0	0	14	0	0
11	95604414	rs1144673	C	A	4	6	10	0	0	10	0	0
11	102195124	rs17882391	A	G	3	3	6	0	0	6	0	0
11	102231922	rs1840447	T	C	0	7	7	0	0	7	0	0
11	102270726	rs191707669	A	T	6	0	6	0	0	6	0	0
11	102271300	rs56391674	T	G	11	4	15	0	0	15	0	0
11	102272884	rs2155587	C	T	426	412	838	0	6	844	0	0
11	102582832	rs12365082	T	A	13	8	21	0	0	21	0	0
11	102582970	rs12366109	G	A	13	21	34	0	1	35	0	0
11	102584104	rs35866072	T	G	7	9	16	0	0	16	0	0
11	102593273	rs12803000	T	G	3	6	9	0	0	9	0	0
11	102595492	rs3765620	G	A	5	3	8	0	0	8	0	0
11	102595579	rs17099450	G	C	6	3	9	0	0	9	0	0
11	102922410	rs1048250	T	G	3	3	6	0	0	6	0	0
11	102951612	rs2513994	A	G	8	3	11	0	0	11	0	0
11	102951654	rs139072082	C	T	9	4	13	0	0	13	0	0
11	104813887	rs547584	C	T	7	5	12	0	0	12	0	0
11	104900488	rs580253	G	A	15	13	28	0	0	28	0	0
11	104905047	rs539595	G	A	9	6	15	0	1	16	0	0
11	104912339	rs61754511	A	T	4	4	8	0	0	8	0	0
11	105961729	.	C	T	4	2	6	0	0	6	0	0
11	107197235	rs1046095	A	T	8	4	12	0	0	12	0	0
11	107197256	rs1046094	C	G	8	3	11	0	0	11	0	0
11	107197536	rs630782	C	T	10	7	17	0	0	17	0	0
11	107197640	rs3758911	T	C	4	4	8	0	0	8	0	0
11	107375422	rs117249984	C	A	4	5	9	0	0	9	0	0
11	107405933	rs536662076	C	T	8	5	13	0	0	13	0	0
11	107662790	rs518852	A	G	17	17	34	0	0	34	0	0
11	107663103	rs516091	C	G	27	16	43	0	0	43	0	0
11	107917087	rs7117111	A	G	105	97	202	0	4	206	0	0
11	107938731	rs111587264	C	T	5	2	7	0	0	7	0	0
11	107940042	rs4575229	A	G	5	2	7	0	1	8	0	0
11	107976450	rs3781870	C	T	7	5	12	0	0	12	0	0
11	107977059	rs78891752	T	C	15	6	21	0	0	21	0	0
11	107992312	rs3741054	C	G	12	12	24	0	0	24	0	0
11	108009660	rs35188041	C	A	36	60	96	0	1	97	0	0
11	108077536	rs148753515	C	T	9	6	15	0	0	15	0	0
11	109964568	rs11213260	C	T	8	8	16	0	0	16	0	0
11	109964829	rs10891053	A	T	7	5	12	0	0	12	0	0
11	110035262	rs1026608	A	G	16	12	28	0	0	28	0	0
11	110035301	rs1026607	A	G	14	10	24	0	0	24	0	0
11	110040812	rs55808598	A	G	3	5	8	0	0	8	0	0
11	110042157	rs4754425	G	A	14	12	26	0	0	26	0	0
11	110091645	rs11213316	A	T	5	1	6	0	0	6	0	0
11	110109702	rs12575162	G	A	6	14	20	0	1	21	0	0
11	110318522	rs10891112	T	C	2	4	6	0	0	6	0	0
11	110323774	rs12798224	G	A	2	5	7	0	0	7	0	0
11	110325714	rs11213408	G	A	0	6	6	0	1	7	0	0
11	110329895	rs935135	A	G	9	74	83	0	2	85	0	0
11	110335002	rs4753894	A	C	8	28	36	0	0	36	0	0
11	111953321	.	A	G	55	64	119	0	6	126	1	0
11	112097860	rs74660752	C	G	22	14	36	0	2	38	0	0
11	112098326	rs2676374	C	T	8	24	32	0	0	32	0	0
11	112098374	rs2518350	G	C	13	21	34	0	0	34	0	0
11	112100585	rs2564862	A	C	9	2	11	0	0	11	0	0
11	112100683	rs2518352	C	T	8	4	12	0	0	12	0	0
11	112101499	rs76465815	T	A	3	4	7	0	1	8	0	0
11	112104245	rs59731976	T	C	192	272	464	0	3	467	0	0
11	113669644	rs2285392	G	A	10	13	23	0	0	23	0	0
11	113949698	rs118121261	A	T	30	29	59	0	0	59	0	0
11	113950821	rs2606727	G	A	7	8	15	0	1	16	0	0
11	113953010	rs2852801	C	A	4	8	12	0	0	12	0	0
11	113982321	rs73000965	T	A	5	7	12	0	1	13	0	0
11	114079713	rs656269	T	C	5	2	7	0	0	7	0	0
11	114080769	rs641373	C	T	2	4	6	0	0	6	0	0
11	114121818	rs528334867	C	T	39	40	79	0	0	79	0	0
11	114122989	rs503768	C	T	29	40	69	0	1	70	0	0
11	114123539	rs509103	T	G	33	41	74	0	15	90	1	0
11	114270942	.	C	T	41	31	72	0	1	73	0	0
11	116631391	rs3741301	T	C	5	2	7	0	0	7	0	0
11	116648917	rs964184	G	C	71	52	123	0	1	124	0	0
11	116727850	rs1035237	G	C	7	5	12	0	0	12	0	0
11	116748905	rs61907566	C	G	3	4	7	0	0	7	0	0
11	116763783	rs73023063	A	G	27	33	60	0	0	60	0	0
11	116764021	rs672058	C	T	22	26	48	0	0	48	0	0
11	116793231	rs12225187	G	A	11	36	47	0	0	47	0	0
11	116796846	rs7121898	A	T	5	13	18	0	0	18	0	0
11	116805204	rs562179	T	C	4	2	6	0	0	6	0	0
11	116902616	rs12804122	C	G	2	6	8	0	0	8	0	0
11	116947361	rs4938335	A	C	2	4	6	0	0	6	0	0
11	117027481	rs4938352	G	A	3	3	6	0	0	6	0	0
11	117034619	rs7122944	G	T	10	9	19	0	0	19	0	0
11	117034621	.	T	C	9	10	19	0	0	19	0	0
11	117034729	rs10790175	T	C	9	8	17	0	0	17	0	0
11	117035502	rs10892080	A	G	3	8	11	0	0	11	0	0
11	117036805	rs7931335	C	T	1	5	6	0	0	6	0	0
11	117037065	rs6589602	T	C	2	10	12	0	0	12	0	0
11	117037361	rs7112513	A	G	19	15	34	0	0	34	0	0
11	117039325	rs10892082	T	G	228	200	428	0	4	432	0	0
11	117039797	rs1060211	G	A	265	242	507	0	3	510	0	0
11	117042238	rs10750103	C	T	10	12	22	0	1	23	0	0
11	117042377	rs4936367	G	A	6	18	24	0	1	25	0	0
11	117042580	rs10892083	G	C	13	16	29	0	0	29	0	0
11	117042816	rs7120309	T	A	7	18	25	0	0	25	0	0
11	117042899	rs7120449	T	C	10	19	29	0	0	29	0	0
11	117042949	rs7120565	T	C	8	15	23	0	0	23	0	0
11	117044203	rs4604928	C	A	7	8	15	0	2	17	0	0
11	117045335	rs7925256	T	C	9	8	17	0	1	18	0	0
11	117046197	rs4938353	G	A	11	11	22	0	0	22	0	0
11	117059347	rs90192	C	T	4	5	9	0	0	9	0	0
11	117059552	rs474339	G	A	2	6	8	0	0	8	0	0
11	117064693	rs521171	C	G	9	9	18	0	0	18	0	0
11	117066690	rs1263502	T	C	15	11	26	0	0	26	0	0
11	117067699	rs8521	C	T	32	21	53	0	0	53	0	0
11	117070857	rs664971	G	A	5	1	6	0	0	6	0	0
11	117071070	rs664082	C	G	5	8	13	0	0	13	0	0
11	117071970	rs494356	T	C	2	10	12	0	1	13	0	0
11	117072525	rs488962	C	T	5	1	6	0	0	6	0	0
11	117072963	rs634960	T	C	4	2	6	0	0	6	0	0
11	117076564	rs1242127	A	G	29	14	43	0	0	43	0	0
11	117076708	rs35186251	T	C	16	12	28	0	0	28	0	0
11	117077034	rs28590104	A	G	35	31	66	0	1	67	0	0
11	117080120	.	C	T	9	2	11	0	0	11	0	0
11	117080379	rs659955	T	A	3	6	9	0	0	9	0	0
11	117081763	rs171052	C	G	3	4	7	0	1	8	0	0
11	117081974	rs236910	A	G	6	3	9	0	0	9	0	0
11	117085270	rs236911	A	C	5	5	10	0	0	10	0	0
11	117089628	rs236916	G	A	3	5	8	0	1	9	0	0
11	117158858	rs1047857	A	G	28	20	48	0	0	48	0	0
11	117159878	rs535860	A	T	19	14	33	0	2	35	0	0
11	117267884	rs573455	A	G	6	6	12	0	0	12	0	0
11	117690918	rs11999	A	C	3	6	9	0	1	10	0	0
11	117857271	rs56175324	C	T	41	32	73	0	0	73	0	0
11	117857499	rs78574659	C	A	99	74	173	0	2	175	0	0
11	117858185	rs4252246	C	A	11	4	15	0	0	15	0	0
11	117858983	rs4252248	G	A	10	2	12	0	0	12	0	0
11	117859925	rs4252253	C	A	4	2	6	0	0	6	0	0
11	117860582	rs2512143	A	G	3	4	7	0	0	7	0	0
11	117861055	rs4252254	C	T	4	3	7	0	1	8	0	0
11	117861073	rs547602693	T	A	5	3	8	0	0	8	0	0
11	117861844	rs4252257	C	T	6	3	9	0	0	9	0	0
11	117862298	rs2512144	A	G	4	5	9	0	0	9	0	0
11	117862575	rs4252261	T	G	6	0	6	0	0	6	0	0
11	117863032	rs2512145	A	G	5	1	6	0	0	6	0	0
11	117864047	rs2256111	A	G	281	162	443	0	1	444	0	0
11	117864063	rs3135932	A	G	153	256	409	0	2	411	0	0
11	117864961	rs4252274	G	C	7	3	10	0	0	10	0	0
11	117867351	.	G	A	10	6	16	0	0	16	0	0
11	117867593	rs4252284	C	T	11	7	18	0	0	18	0	0
11	117869591	rs2229115	C	T	243	143	386	0	3	390	1	0
11	117869670	rs2229113	A	G	236	158	394	0	3	397	0	0
11	117872086	rs9610	G	A	217	137	354	0	0	354	0	0
11	118068752	rs2298831	T	C	4	6	10	0	1	11	0	0
11	118098890	rs1793156	T	C	13	6	19	0	1	20	0	0
11	118098962	rs1793155	G	A	9	5	14	0	1	15	0	0
11	118099186	rs3802863	C	T	5	4	9	0	0	9	0	0
11	118099617	rs11216825	G	A	8	9	17	0	0	17	0	0
11	118099713	rs11216826	A	T	10	9	19	0	0	19	0	0
11	118100411	rs869638	G	C	5	10	15	0	0	15	0	0
11	118120802	rs61900655	G	C	14	6	20	0	0	20	0	0
11	118178007	rs1126924	C	T	17	15	32	0	0	32	0	0
11	118221349	rs3753059	T	C	4	5	9	0	1	10	0	0
11	118221350	rs3753058	G	T	5	5	10	0	0	10	0	0
11	118230359	rs2276419	C	T	34	33	67	0	0	67	0	0
11	118232026	rs77806521	C	T	2	4	6	0	0	6	0	0
11	118235490	rs12576486	T	C	5	3	8	0	0	8	0	0
11	118240715	rs12792929	G	C	6	15	21	0	0	21	0	0
11	118250586	rs7949539	A	G	7	12	19	0	0	19	0	0
11	118268613	rs7108613	A	G	47	50	97	0	0	97	0	0
11	118269105	rs527449105	A	G	30	32	62	0	0	62	0	0
11	118273019	rs17122154	G	A	8	5	13	0	1	14	0	0
11	118276116	rs9666463	C	G	4	3	7	0	0	7	0	0
11	118276246	rs7483081	T	C	5	3	8	0	1	9	0	0
11	118276492	rs17122157	G	A	11	7	18	0	0	18	0	0
11	118320553	rs629470	G	A	63	67	130	0	1	131	0	0
11	118393396	rs573971	A	G	24	12	36	0	1	37	0	0
11	118405068	rs12289253	A	G	29	24	53	0	0	53	0	0
11	118405305	rs45505501	G	A	3	4	7	0	0	7	0	0
11	118405641	rs3741323	A	G	1	5	6	0	0	6	0	0
11	118430519	rs11552421	C	T	8	12	20	0	1	21	0	0
11	118435756	rs2277291	C	T	6	7	13	0	0	13	0	0
11	118443944	rs11216906	G	A	6	5	11	0	0	11	0	0
11	118471423	rs11216925	T	C	55	42	97	0	1	98	0	0
11	118471996	rs11216926	C	T	38	49	87	0	0	87	0	0
11	118472354	rs10892245	C	A	77	65	142	0	2	144	0	0
11	118473231	rs1047079	T	C	127	88	215	0	0	215	0	0
11	118473385	rs17742	T	C	130	90	220	0	2	222	0	0
11	118618776	rs1048024	A	T	78	82	160	0	2	162	0	0
11	118619047	rs2077579	T	G	188	142	330	0	2	332	0	0
11	118619253	rs2004781	C	T	82	84	166	0	2	168	0	0
11	118619960	rs3889239	C	T	42	36	78	0	0	78	0	0
11	118621495	rs487728	G	C	48	43	91	0	5	96	0	0
11	118627149	rs11217016	A	C	3	4	7	0	0	7	0	0
11	118628373	rs74676029	C	T	2	5	7	0	0	7	0	0
11	118629364	rs73001486	G	A	5	5	10	0	0	10	0	0
11	118661376	rs73003294	C	T	1	5	6	0	0	6	0	0
11	118765267	rs598207	G	C	6	1	7	0	0	7	0	0
11	118765283	rs665648	G	A	7	2	9	0	0	9	0	0
11	118765688	rs676925	C	G	10	5	15	0	0	15	0	0
11	118889114	rs10892321	A	G	82	54	136	0	2	138	0	0
11	118914998	rs35588561	A	G	22	23	45	0	1	46	0	0
11	118915944	rs1043314	A	G	98	102	200	0	0	200	0	0
11	118917587	rs45510602	C	T	2	4	6	0	0	6	0	0
11	118919132	rs2276060	G	A	5	2	7	0	0	7	0	0
11	118919206	rs568922	T	C	79	81	160	0	0	160	0	0
11	118922200	rs1804690	G	A	73	61	134	0	0	134	0	0
11	118925341	rs538478	G	A	49	35	84	0	0	84	0	0
11	118926720	rs470679	A	C	2	4	6	0	0	6	0	0
11	118938880	rs584115	A	G	21	15	36	0	0	36	0	0
11	118938882	rs670526	C	T	21	15	36	0	0	36	0	0
11	118940967	.	T	C	46	61	107	0	0	107	0	0
11	118942134	rs45609135	G	A	1	5	6	0	0	6	0	0
11	118947634	rs540261	C	T	65	46	111	0	0	111	0	0
11	118951642	rs2508948	T	A	7	1	8	0	0	8	0	0
11	118955679	rs589925	C	T	46	42	88	0	0	88	0	0
11	118978319	rs7936924	C	T	4	6	10	0	0	10	0	0
11	118986630	rs608444	G	A	6	3	9	0	0	9	0	0
11	118986659	rs608793	C	T	9	5	14	0	0	14	0	0
11	118987971	rs571445	G	A	8	11	19	0	1	20	0	0
11	118989098	rs1129013	C	G	5	1	6	0	0	6	0	0
11	118994516	rs7103544	G	A	6	1	7	0	0	7	0	0
11	118995325	rs7123630	T	C	6	6	12	0	0	12	0	0
11	118995353	rs624588	C	G	5	4	9	0	0	9	0	0
11	118995481	rs1786142	C	T	13	5	18	0	0	18	0	0
11	119004686	rs658922	T	A	6	4	10	0	0	10	0	0
11	119005088	rs512703	C	T	12	9	21	0	0	21	0	0
11	119005132	rs100803	C	T	6	13	19	0	1	20	0	0
11	119005485	rs7234	C	T	17	5	22	0	1	23	0	0
11	119041659	rs626984	C	T	5	1	6	0	0	6	0	0
11	119043656	rs643423	C	T	13	4	17	0	0	17	0	0
11	119052826	rs4245191	C	A	22	25	47	0	1	48	0	0
11	119054488	rs10790286	C	T	28	16	44	0	1	45	0	0
11	119104146	rs7940651	C	G	7	2	9	0	0	9	0	0
11	119145274	rs2276083	A	G	10	13	23	0	0	23	0	0
11	119173763	.	T	A	7	5	12	0	0	12	0	0
11	119175422	.	T	C	9	2	11	0	0	11	0	0
11	119180316	rs7914	G	A	47	23	70	0	0	70	0	0
11	119181170	rs2249466	T	C	13	19	32	0	0	32	0	0
11	119181674	rs2510146	G	C	7	5	12	0	0	12	0	0
11	119205735	rs12797083	T	C	78	64	142	0	2	144	0	0
11	119205830	rs12795576	A	G	83	64	147	0	2	149	0	0
11	119206375	rs2511841	G	A	87	76	163	0	0	163	0	0
11	121178302	rs1061332	A	C	22	18	40	0	1	41	0	0
11	121328954	rs661057	T	C	4	10	14	0	0	14	0	0
11	121456962	rs1699102	C	T	7	5	12	0	0	12	0	0
11	121475922	rs3824968	T	A	9	4	13	0	0	13	0	0
11	121501238	rs10892762	G	A	5	5	10	0	0	10	0	0
11	121501406	rs10790449	T	C	12	11	23	0	1	24	0	0
11	121501755	rs1133174	G	A	16	9	25	0	1	26	0	0
11	121502745	rs1131497	C	G	24	11	35	0	0	35	0	0
11	121502768	rs3087925	A	G	23	12	35	0	1	36	0	0
11	121502894	rs1131499	T	C	30	15	45	0	0	45	0	0
11	121504091	.	T	C	33	27	60	0	2	62	0	0
11	122646967	rs12790613	G	A	12	3	15	0	0	15	0	0
11	122659918	rs955051	T	G	7	9	16	0	0	16	0	0
11	122665437	rs872414	A	G	5	2	7	0	0	7	0	0
11	122682156	rs3134428	A	G	2	10	12	0	0	12	0	0
11	122683382	rs3134430	A	T	14	8	22	0	0	22	0	0
11	122928622	rs4802	A	G	1226	1118	2344	0	25	2369	0	0
11	122928875	rs4936770	C	T	4	5	9	0	0	9	0	0
11	122929201	rs77374206	G	T	4	9	13	0	0	13	0	0
11	122929407	rs1064585	T	G	961	891	1852	0	10	1862	0	0
11	122929624	rs1461496	A	G	16	11	27	0	0	27	0	0
11	122932182	rs41302367	G	A	2	4	6	0	0	6	0	0
11	122932776	rs2276074	G	C	402	323	725	0	5	730	0	0
11	122933677	rs7944075	C	T	5	1	6	0	0	6	0	0
11	123302186	rs948003	T	C	12	4	16	0	0	16	0	0
11	123302229	rs58979012	T	G	7	15	22	0	0	22	0	0
11	123302696	rs78206655	G	T	3	3	6	0	0	6	0	0
11	123302788	rs76854774	C	G	2	8	10	0	0	10	0	0
11	123303109	rs111655335	A	G	8	1	9	0	0	9	0	0
11	123305966	rs2846054	T	G	10	9	19	0	0	19	0	0
11	123306172	rs17671708	T	C	83	87	170	0	0	170	0	0
11	123477352	rs2279519	G	A	14	9	23	0	0	23	0	0
11	123480981	rs10893053	T	C	4	9	13	0	0	13	0	0
11	123495617	rs7924813	G	T	3	3	6	0	0	6	0	0
11	123495847	rs3741112	C	G	5	4	9	0	0	9	0	0
11	123496314	rs1274204	C	T	6	2	8	0	0	8	0	0
11	123497971	rs3741116	A	G	15	22	37	0	1	38	0	0
11	123609364	rs3741114	G	A	7	3	10	0	0	10	0	0
11	123609391	rs3741113	G	T	8	8	16	0	0	16	0	0
11	123609763	rs1557427	G	A	14	4	18	0	0	18	0	0
11	123609932	rs1557425	A	T	10	6	16	0	0	16	0	0
11	124007890	rs34188444	G	A	5	5	10	0	0	10	0	0
11	124015994	rs1056615	C	T	11	3	14	0	0	14	0	0
11	124016058	rs117689747	C	T	6	3	9	0	0	9	0	0
11	124016740	rs9326269	A	T	4	5	9	0	0	9	0	0
11	124016865	rs17128436	G	C	11	9	20	0	0	20	0	0
11	124017091	rs1939861	C	T	7	7	14	0	0	14	0	0
11	124017158	rs1939860	C	G	3	4	7	0	0	7	0	0
11	124494303	rs2156155	G	A	6	1	7	0	1	8	0	0
11	124500024	rs61910593	G	C	1	6	7	0	0	7	0	0
11	124500953	rs11601766	T	G	2	4	6	0	0	6	0	0
11	124502020	rs75601279	A	T	113	114	227	0	0	227	0	0
11	124502260	rs1047661	A	G	26	16	42	0	2	44	0	0
11	124619407	rs11604175	C	T	4	2	6	0	0	6	0	0
11	124623492	rs12541	T	C	30	21	51	0	0	51	0	0
11	124624854	rs6590090	T	C	2	4	6	0	0	6	0	0
11	124746770	rs11219823	T	C	4	3	7	0	0	7	0	0
11	125452313	rs4627097	A	G	158	126	284	0	2	287	1	0
11	125454154	.	A	T	56	32	88	0	7	95	0	0
11	125479363	rs2241502	G	A	76	56	132	0	1	133	0	0
11	125493879	rs491741	T	C	11	3	14	0	0	14	0	0
11	125493955	rs11220165	G	A	6	4	10	0	0	10	0	0
11	125494215	rs516262	C	T	6	6	12	0	0	12	0	0
11	125495022	rs2298483	C	T	5	12	17	0	0	17	0	0
11	125495211	rs1057733	T	C	22	14	36	0	0	36	0	0
11	125495264	rs558351	C	T	17	23	40	0	0	40	0	0
11	125526161	rs567889	G	A	73	34	107	0	0	107	0	0
11	126133182	rs17656	C	A	359	367	726	0	4	730	0	0
11	126134698	rs638766	T	C	34	20	54	0	0	54	0	0
11	126139100	rs1786702	T	C	6	13	19	0	0	19	0	0
11	126147697	rs667627	G	A	17	47	64	0	0	64	0	0
11	126164349	rs625413	T	C	10	26	36	0	1	37	0	0
11	126225964	rs2848583	T	C	4	2	6	0	0	6	0	0
11	126274959	rs11220476	C	T	5	2	7	0	0	7	0	0
11	126277216	rs2230278	C	T	235	215	450	0	0	451	1	0
11	126278075	rs2230279	C	T	249	170	419	0	3	422	0	0
11	126279365	rs1316361	A	T	3	4	7	0	0	7	0	0
11	128563037	rs4526784	G	C	13	1	14	0	0	14	0	0
11	128651893	rs35195224	A	G	103	82	185	0	1	186	0	0
11	128675292	rs7113191	T	A	108	99	207	0	4	211	0	0
11	128677459	rs2071619	C	T	1	5	6	0	0	6	0	0
11	128835758	rs546239	C	T	11	6	17	0	0	17	0	0
11	128868239	rs670440	T	C	4	4	8	0	0	8	0	0
11	129104413	rs12418338	T	G	1	8	9	0	0	9	0	0
11	129104428	rs12416909	C	T	1	9	10	0	0	10	0	0
11	129105255	rs6590369	G	T	5	7	12	0	0	12	0	0
11	129105587	rs7122135	A	C	3	3	6	0	0	6	0	0
11	129106492	rs10790995	T	C	5	10	15	0	0	15	0	0
11	129106638	rs10894006	C	A	3	8	11	0	1	12	0	0
11	129729775	rs74238128	C	T	4	11	15	0	0	15	0	0
11	129752991	rs2293664	G	C	7	2	9	0	0	9	0	0
11	129754644	rs1131972	A	G	28	21	49	0	0	49	0	0
11	129758327	rs1650823	G	A	14	13	27	0	0	27	0	0
11	129763769	rs7116648	C	G	3	4	7	0	0	7	0	0
11	129764526	rs1783919	C	T	3	5	8	0	0	8	0	0
11	129764568	rs3829264	C	T	4	4	8	0	0	8	0	0
11	129769926	rs1043654	T	C	13	12	25	0	0	25	0	0
11	129772013	rs3734078	C	T	10	3	13	0	0	13	0	0
11	129785594	rs3734073	G	A	5	1	6	0	0	6	0	0
11	129794950	rs2241571	T	C	4	5	9	0	0	9	0	0
11	130066335	rs476106	C	T	4	5	9	0	0	9	0	0
11	130080017	rs704624	C	T	7	11	18	0	2	20	0	0
11	130080037	rs704625	C	G	3	11	14	0	0	14	0	0
11	130080065	rs5852	G	A	7	16	23	0	0	23	0	0
11	130783779	rs78178813	A	G	5	11	16	0	0	16	0	0
11	130784011	rs118027083	T	A	7	9	16	0	1	17	0	0
11	134106675	rs573929	A	G	2	5	7	0	0	7	0	0
11	134116125	rs12180	G	A	75	76	151	0	1	152	0	0
11	134122250	rs570113	C	T	5	4	9	0	0	9	0	0
11	134132334	rs73603086	G	C	6	3	9	0	0	9	0	0
11	134132559	rs561945	G	A	11	9	20	0	0	20	0	0
12	80030	.	A	C	2	4	6	0	0	6	0	0
12	80118	.	A	G	5	5	10	0	0	10	0	0
12	80171	.	C	T	6	2	8	0	0	8	0	0
12	80309	.	G	T	5	2	7	0	0	7	0	0
12	80562	.	T	C	6	2	8	0	0	8	0	0
12	80572	.	C	G	6	2	8	0	0	8	0	0
12	81148	.	T	G	4	3	7	0	0	7	0	0
12	82343	.	A	G	1	6	7	0	0	7	0	0
12	82454	.	C	T	3	5	8	0	0	8	0	0
12	82547	.	G	A	1	11	12	0	0	12	0	0
12	82560	.	T	G	1	11	12	0	0	12	0	0
12	82650	.	C	T	5	8	13	0	0	13	0	0
12	82755	.	C	T	0	6	6	0	0	6	0	0
12	82857	.	T	C	3	3	6	0	0	6	0	0
12	83011	rs370570891	T	C	2	6	8	0	0	8	0	0
12	83012	rs374646339	C	G	2	6	8	0	0	8	0	0
12	83508	.	T	G	2	4	6	0	0	6	0	0
12	83757	.	G	C	4	10	14	0	0	14	0	0
12	83765	.	C	T	11	5	16	0	0	16	0	0
12	83801	rs367621886	T	A	4	11	15	0	0	15	0	0
12	83802	rs371798112	G	A	4	11	15	0	0	15	0	0
12	83865	.	T	C	2	7	9	0	0	9	0	0
12	84096	.	C	G	7	13	20	0	0	20	0	0
12	84205	.	C	T	5	22	27	0	0	27	0	0
12	84243	.	C	T	7	20	27	0	0	27	0	0
12	84284	rs368024842	G	T	17	9	26	0	1	27	0	0
12	84286	rs376266576	G	T	9	18	27	0	0	27	0	0
12	84296	.	G	C	9	17	26	0	0	26	0	0
12	84343	.	T	C	4	20	24	0	0	24	0	0
12	84433	.	C	A	6	15	21	0	0	21	0	0
12	84552	.	G	T	4	6	10	0	0	10	0	0
12	84568	.	G	A	4	6	10	0	0	10	0	0
12	84588	.	C	T	6	8	14	0	0	14	0	0
12	84590	.	A	G	6	8	14	0	0	14	0	0
12	84598	.	T	G	6	5	11	0	0	11	0	0
12	84650	.	G	A	3	11	14	0	0	14	0	0
12	84668	.	T	C	4	8	12	0	0	12	0	0
12	84674	.	T	C	4	8	12	0	0	12	0	0
12	84676	.	T	C	10	4	14	0	0	14	0	0
12	84716	.	G	A	9	7	16	0	0	16	0	0
12	84755	.	T	A	10	11	21	0	0	21	0	0
12	84772	.	T	A	10	15	25	0	1	26	0	0
12	84856	.	G	T	5	14	19	0	0	19	0	0
12	84871	.	G	C	5	18	23	0	2	25	0	0
12	84963	.	T	C	4	12	16	0	1	17	0	0
12	85105	.	G	A	4	5	9	0	0	9	0	0
12	86584	.	T	C	19	10	29	0	0	29	0	0
12	87650	.	T	C	118	48	166	0	2	168	0	0
12	87928	.	T	C	23	16	39	0	0	39	0	0
12	89419	.	A	T	5	7	12	0	0	12	0	0
12	89484	rs369297261	G	A	18	3	21	0	0	21	0	0
12	89564	rs372772361	G	A	7	21	28	0	0	28	0	0
12	89850	.	A	G	17	6	23	0	0	23	0	0
12	90102	.	A	T	14	0	14	0	0	14	0	0
12	90736	rs71227148	T	C	5	2	7	0	0	7	0	0
12	90902	.	C	T	94	144	238	0	5	245	2	0
12	90914	rs17353727	C	T	111	128	239	0	4	243	0	0
12	90953	.	C	G	87	88	175	0	0	175	0	0
12	91155	.	C	T	17	13	30	0	2	32	0	0
12	8073698	.	C	T	748	0	748	0	4	752	0	0
12	8073897	.	G	A	618	0	618	0	6	624	0	0
12	8073901	.	T	C	626	0	626	0	2	628	0	0
12	8074055	.	T	C	596	0	596	0	2	598	0	0
12	9451397	.	G	A	16	2	18	0	0	18	0	0
12	9451905	.	G	A	11	1	12	0	0	12	0	0
12	9452017	.	C	A	8	1	9	0	0	9	0	0
12	9580293	.	A	G	34	0	34	0	0	34	0	0
12	9580431	.	C	T	29	0	29	0	0	29	0	0
12	9585328	.	C	G	6	1	7	0	1	8	0	0
12	9600624	.	T	C	18	3	21	0	0	21	0	0
12	53343005	.	G	A	29	0	29	0	0	29	0	0
12	53343007	.	G	A	30	0	30	0	0	30	0	0
12	53343033	.	G	A	39	0	39	0	0	39	0	0
12	53343036	.	C	T	40	0	40	0	0	40	0	0
12	53343040	.	C	A	40	0	40	0	0	40	0	0
12	53343051	.	G	T	43	0	43	0	0	43	0	0
12	53343069	.	G	T	40	0	40	0	0	40	0	0
12	53343071	.	C	T	39	0	39	0	0	39	0	0
12	53343074	.	T	C	39	0	39	0	0	39	0	0
12	53343098	.	C	T	51	0	51	0	0	51	0	0
12	53343099	.	G	A	51	0	51	0	0	51	0	0
12	53343105	.	C	T	50	0	50	0	0	50	0	0
12	53343120	.	A	C	39	0	39	0	4	43	0	0
12	53343124	.	G	A	45	0	45	0	0	45	0	0
12	53343132	.	G	T	48	0	48	0	0	48	0	0
12	53343134	.	G	T	49	0	49	0	0	49	0	0
12	53343148	.	C	G	50	0	50	0	0	50	0	0
12	53343152	.	C	G	49	0	49	0	2	51	0	0
12	53343158	.	A	G	49	0	49	0	0	49	0	0
12	53343209	.	G	A	60	0	60	0	5	65	0	0
12	53873890	.	A	T	33	0	33	0	51	84	0	0
12	64216995	.	C	T	8	0	8	0	0	8	0	0
12	64217013	.	A	T	11	0	11	0	0	11	0	0
12	64217017	.	C	A	9	0	9	0	2	11	0	0
12	64217030	.	C	T	9	0	9	0	1	10	0	0
12	64217036	.	A	T	11	0	11	0	0	11	0	0
12	64217057	.	T	C	12	0	12	0	0	12	0	0
12	64217058	.	A	C	11	0	11	0	1	12	0	0
12	64217080	.	A	G	10	0	10	0	0	10	0	0
12	93794479	.	G	A	275	0	275	0	3	278	0	0
12	93794530	.	C	A	312	2	314	0	0	314	0	0
12	93795742	.	C	T	116	0	116	0	11	127	0	0
12	104359677	.	A	G	9	0	9	0	0	9	0	0
12	104381355	.	G	C	28	0	28	0	1	29	0	0
12	104382453	.	C	G	44	0	44	0	1	46	1	0
12	113735344	.	T	A	21	0	21	0	11	32	0	0
12	123186880	.	C	T	164	0	164	0	0	164	0	0
12	133159733	rs11550079	C	T	12	0	12	0	0	12	0	0
13	19801420	rs9551255	C	T	3	7	10	0	0	10	0	0
13	19895624	rs1330731	A	G	4	3	7	0	0	7	0	0
13	19943770	rs4112696	A	G	1	5	6	0	0	6	0	0
13	20221516	rs35424555	A	G	55	34	89	0	0	89	0	0
13	20249421	rs2290812	C	T	4	9	13	0	0	13	0	0
13	20277413	.	T	C	420	7	427	0	10	437	0	0
13	20277686	rs3864980	A	T	2	5	7	0	0	7	0	0
13	20278520	rs17241375	T	G	3	5	8	0	0	8	0	0
13	20278688	.	G	A	6	4	10	0	0	10	0	0
13	20282149	.	T	G	4	7	11	0	0	11	0	0
13	20356941	rs9508887	T	A	79	82	161	0	0	161	0	0
13	20397908	rs9552009	A	C	6	9	15	0	0	15	0	0
13	20398669	rs9508907	T	C	11	8	19	0	0	19	0	0
13	20398742	rs9508908	C	T	7	6	13	0	0	13	0	0
13	20409931	rs9552012	A	G	6	3	9	0	0	9	0	0
13	20416333	rs73168967	C	T	2	7	9	0	0	9	0	0
13	20418854	rs9508913	A	G	6	2	8	0	0	8	0	0
13	20421418	rs73168969	C	A	3	3	6	0	0	6	0	0
13	20425150	rs35634189	A	T	12	22	34	0	0	34	0	0
13	20436598	rs3783037	T	G	80	105	185	0	4	189	0	0
13	20600341	rs73428072	C	A	3	4	7	0	0	7	0	0
13	20638491	rs2273993	A	G	6	3	9	0	0	9	0	0
13	20656439	rs4769946	G	T	2	8	10	0	0	10	0	0
13	21086599	rs7139733	G	A	26	25	51	0	1	52	0	0
13	21354586	rs9315865	A	G	33	40	73	0	1	74	0	0
13	21355927	rs9509372	A	G	15	25	40	0	0	40	0	0
13	21357452	rs9509373	A	G	12	11	23	0	0	23	0	0
13	21366007	rs7318451	C	T	4	7	11	0	0	11	0	0
13	21367077	rs143218848	C	G	5	4	9	0	0	9	0	0
13	21405847	rs2585907	T	C	4	2	6	0	1	7	0	0
13	21547317	rs535233	T	C	132	149	281	0	3	284	0	0
13	21561453	rs73169516	A	C	4	2	6	0	0	6	0	0
13	21904752	rs261729	T	C	11	23	34	0	0	34	0	0
13	21918844	rs7336525	G	A	6	15	21	0	0	21	0	0
13	23905711	rs2737699	A	G	7	10	17	0	0	17	0	0
13	23907909	rs17078605	A	G	3	6	9	0	0	9	0	0
13	23909162	rs9552929	A	G	8	7	15	0	0	15	0	0
13	23911820	rs4143768	A	G	2	4	6	0	0	6	0	0
13	23929095	rs1536365	T	C	24	29	53	0	0	53	0	0
13	23930055	rs2031640	A	T	20	39	59	0	0	59	0	0
13	23944608	rs34003697	A	C	14	10	24	0	0	24	0	0
13	24859190	rs9507299	G	A	3	3	6	0	0	6	0	0
13	24878466	rs3803218	A	G	12	13	25	0	1	26	0	0
13	24879413	rs73455777	T	A	31	35	66	0	1	67	0	0
13	24879877	rs1891103	T	A	25	15	40	0	0	40	0	0
13	24880538	.	A	G	43	53	96	0	1	97	0	0
13	25466955	rs3742165	T	C	7	6	13	0	0	13	0	0
13	25821905	.	A	G	65	62	127	0	2	130	1	0
13	25879489	.	C	T	3	3	6	0	0	6	0	0
13	27999643	rs11619784	A	G	6	3	9	0	0	9	0	0
13	27999711	rs4771120	G	C	6	1	7	0	0	7	0	0
13	28000282	rs7988412	C	T	26	15	41	0	1	42	0	0
13	28003362	rs1237710	C	G	35	11	46	0	0	46	0	0
13	28007765	rs74183666	A	T	29	26	55	0	0	55	0	0
13	28007823	rs79793528	G	A	45	30	75	0	0	75	0	0
13	28007830	rs2780337	T	C	42	30	72	0	0	72	0	0
13	28007862	rs79553479	G	A	40	19	59	0	0	59	0	0
13	28007891	rs2760898	A	G	38	23	61	0	1	62	0	0
13	28009031	rs7323	G	C	987	1281	2268	0	19	2287	0	0
13	28009851	rs7669	G	A	32	24	56	0	0	56	0	0
13	28024544	rs12584061	C	T	5	5	10	0	0	10	0	0
13	28024694	rs12585587	G	A	12	7	19	0	0	19	0	0
13	28122408	rs55768029	C	A	6	2	8	0	0	8	0	0
13	28152895	rs77338524	A	C	7	4	11	0	0	11	0	0
13	28195257	rs2232665	G	A	31	31	62	0	2	64	0	0
13	28195495	rs2232669	C	T	52	62	114	0	1	115	0	0
13	28196033	rs2232679	G	C	182	107	289	0	5	294	0	0
13	28224258	rs1218951	G	A	15	16	31	0	0	31	0	0
13	28226678	rs655885	G	A	5	8	13	0	1	14	0	0
13	28227130	rs7330014	T	G	4	2	6	0	0	6	0	0
13	28239940	rs11029	G	C	151	139	290	0	1	291	0	0
13	28239970	rs14105	G	A	157	158	315	0	1	316	0	0
13	28240828	rs14144	A	G	26	22	48	0	3	51	0	0
13	28241061	rs11149483	T	C	81	89	170	0	12	182	0	0
13	28577688	rs3829382	G	T	15	17	32	0	0	32	0	0
13	28712689	rs138028125	C	G	3	6	9	0	0	9	0	0
13	28849762	rs76806311	G	A	4	4	8	0	0	8	0	0
13	29243748	.	C	T	10	5	15	0	0	15	0	0
13	30088607	rs41318021	G	A	8	9	17	0	0	17	0	0
13	30339472	rs10492458	C	T	24	9	33	0	0	33	0	0
13	30399520	rs9551747	A	G	3	3	6	0	0	6	0	0
13	30399594	rs9508562	T	C	5	2	7	0	0	7	0	0
13	30399740	rs143378305	C	A	1	8	9	0	0	9	0	0
13	30424627	rs278037	C	T	7	7	14	0	0	14	0	0
13	30777202	rs10478	T	C	5	8	13	0	0	13	0	0
13	30779819	rs11620056	C	T	5	5	10	0	0	10	0	0
13	30946446	rs1275190	T	G	4	6	10	0	0	10	0	0
13	31202076	rs2031279	A	G	2	5	7	0	0	7	0	0
13	31203763	rs7318713	A	C	1	5	6	0	0	6	0	0
13	31229326	rs140813066	G	A	4	2	6	0	0	6	0	0
13	31229758	rs9508813	T	G	4	5	9	0	0	9	0	0
13	31231513	rs7983138	C	T	4	7	11	0	0	11	0	0
13	31231806	rs7984952	T	C	94	104	198	0	0	198	0	0
13	31233063	rs3742302	G	A	190	199	389	0	1	390	0	0
13	31315139	rs12018461	A	G	2	5	7	0	0	7	0	0
13	31318308	rs3803277	C	A	6	2	8	0	0	8	0	0
13	31318401	rs3803278	T	C	5	3	8	0	0	8	0	0
13	31319133	rs17245120	C	A	18	31	49	0	0	49	0	0
13	31319546	rs4356336	T	C	13	10	23	0	1	24	0	0
13	31319553	rs4584668	A	T	12	11	23	0	0	23	0	0
13	31319751	rs17238773	A	T	4	9	13	0	0	13	0	0
13	31319954	rs4147063	T	C	7	7	14	0	0	14	0	0
13	31320118	rs4147064	T	C	13	6	19	0	0	19	0	0
13	31320249	rs4147062	C	T	14	5	19	0	0	19	0	0
13	31320543	rs9315046	G	A	15	11	26	0	0	26	0	0
13	31322009	rs17238815	C	T	5	3	8	0	0	8	0	0
13	31322949	rs4254166	T	C	5	5	10	0	0	10	0	0
13	31323988	rs17245204	C	T	5	5	10	0	0	10	0	0
13	31325370	rs17238857	T	G	3	7	10	0	1	11	0	0
13	31325635	rs17238864	G	A	11	8	19	0	0	19	0	0
13	31325643	rs11147439	C	A	8	10	18	0	1	19	0	0
13	31712572	.	C	T	64	62	126	0	1	127	0	0
13	31718552	rs7981699	C	T	5	2	7	0	0	7	0	0
13	31726557	rs12429503	T	C	4	6	10	0	0	10	0	0
13	31728162	rs2137077	A	T	3	3	6	0	0	6	0	0
13	31728639	rs2274017	C	T	4	2	6	0	0	6	0	0
13	31728666	rs2274018	G	A	5	2	7	0	0	7	0	0
13	31728703	rs2274019	T	C	4	3	7	0	0	7	0	0
13	31891746	rs1041073	G	A	5	4	9	0	0	9	0	0
13	31903834	rs1060709	G	T	13	15	28	0	0	28	0	0
13	31904694	rs2025729	A	G	8	4	12	0	1	13	0	0
13	31905606	rs912604	A	G	6	1	7	0	0	7	0	0
13	31905872	rs2056445	A	G	6	0	6	0	0	6	0	0
13	31905887	rs2056444	G	T	7	1	8	0	0	8	0	0
13	31905942	rs2056443	T	C	10	3	13	0	0	13	0	0
13	31906141	rs13080	A	C	13	0	13	0	0	13	0	0
13	32332013	rs9548976	A	G	2	5	7	0	0	7	0	0
13	32369347	rs113664467	C	T	35	20	55	0	0	55	0	0
13	32370040	rs61946590	C	A	20	22	42	0	3	45	0	0
13	32371361	rs17076657	A	G	78	58	136	0	1	137	0	0
13	32601801	rs416443	T	C	0	8	8	0	0	8	0	0
13	32676114	rs364995	A	G	12	7	19	0	0	19	0	0
13	32785340	rs2073994	C	T	5	5	10	0	0	10	0	0
13	32889792	rs206118	A	G	13	19	32	0	1	33	0	0
13	32973012	rs15869	A	C	11	9	20	0	0	20	0	0
13	32973276	rs7334543	A	G	14	18	32	0	0	32	0	0
13	32986219	rs206319	A	G	5	5	10	0	0	10	0	0
13	32986232	rs206320	A	G	4	5	9	0	0	9	0	0
13	32999951	rs206335	G	C	73	71	144	0	4	148	0	0
13	33000581	rs206336	G	C	36	17	53	0	0	53	0	0
13	33078604	rs11844016	T	C	5	5	10	0	0	10	0	0
13	33078742	rs207629	T	C	11	3	14	0	0	14	0	0
13	33078836	rs207630	T	C	6	10	16	0	0	16	0	0
13	33080493	rs207631	C	T	4	5	9	0	1	10	0	0
13	33080900	rs10492398	T	C	4	2	6	0	0	6	0	0
13	33091241	rs9337	G	C	30	36	66	0	2	68	0	0
13	33099347	rs45604	G	T	5	2	7	0	0	7	0	0
13	33106182	rs378429	A	G	2	5	7	0	0	7	0	0
13	33160705	rs7994229	C	A	11	7	18	0	0	18	0	0
13	33232435	rs2301393	A	G	15	13	28	0	0	28	0	0
13	33272542	rs9596081	G	A	6	2	8	0	0	8	0	0
13	33347688	rs3213532	G	A	4	5	9	0	0	9	0	0
13	33348027	rs9315179	T	C	3	4	7	0	0	7	0	0
13	33348568	rs7327412	G	A	9	11	20	0	0	20	0	0
13	33349341	rs3492	A	G	21	21	42	0	0	42	0	0
13	33351016	rs9596233	C	T	6	11	17	0	0	17	0	0
13	33592070	rs562020	A	G	8	13	21	0	0	21	0	0
13	34406043	rs3135610	A	G	1	7	8	0	0	8	0	0
13	34406194	rs3135611	T	C	4	5	9	0	0	9	0	0
13	34406376	rs3135612	G	C	6	9	15	0	0	15	0	0
13	34406414	rs3135613	G	C	7	9	16	0	0	16	0	0
13	34406644	rs3135615	G	A	3	3	6	0	0	6	0	0
13	34408502	rs7988717	A	G	5	1	6	0	0	6	0	0
13	34408649	rs3135625	G	A	7	6	13	0	0	13	0	0
13	34409603	rs3135629	T	G	4	10	14	0	0	14	0	0
13	34409805	rs3135631	G	A	2	5	7	0	0	7	0	0
13	34410186	rs3135632	G	T	1	5	6	0	0	6	0	0
13	34410531	rs3135635	C	T	8	3	11	0	0	11	0	0
13	34410630	rs3135637	A	G	2	9	11	0	0	11	0	0
13	34411395	rs3135640	C	A	29	26	55	0	0	55	0	0
13	34423295	rs9528238	G	C	9	4	13	0	0	13	0	0
13	34423449	rs9528242	G	A	8	4	12	0	0	12	0	0
13	37015242	rs17188012	C	G	14	19	33	0	0	33	0	0
13	37016510	rs187139171	A	G	10	15	25	0	0	25	0	0
13	37527667	rs9576145	T	C	7	1	8	0	0	8	0	0
13	37574681	rs7334233	C	T	7	12	19	0	0	19	0	0
13	37574714	rs9547715	C	T	10	12	22	0	0	22	0	0
13	37575766	rs7329314	C	T	28	21	49	0	2	51	0	0
13	37577725	rs7983986	A	C	20	26	46	0	0	46	0	0
13	37578090	rs7982674	G	C	5	4	9	0	0	9	0	0
13	37578126	rs7984730	A	G	6	5	11	0	0	11	0	0
13	37579282	rs7991057	A	T	8	10	18	0	0	18	0	0
13	37579480	rs9547717	C	T	17	14	31	0	0	31	0	0
13	37580139	rs1127446	G	A	186	193	379	0	3	382	0	0
13	37580768	rs9576153	C	A	3	7	10	0	0	10	0	0
13	37581051	rs9576154	T	G	3	9	12	0	0	12	0	0
13	37583831	rs9469	G	A	92	70	162	0	1	163	0	0
13	38924083	rs2231330	A	T	3	3	6	0	0	6	0	0
13	38924117	rs2231331	C	G	4	7	11	0	0	11	0	0
13	38924263	rs2231332	T	C	33	67	100	0	0	100	0	0
13	38930034	rs2481879	C	G	5	3	8	0	0	8	0	0
13	38930893	rs2481880	C	T	7	3	10	0	0	10	0	0
13	38931144	rs9548318	T	C	8	5	13	0	0	13	0	0
13	38932648	rs2485786	C	T	1	5	6	0	0	6	0	0
13	38932681	rs2485785	G	T	1	6	7	0	0	7	0	0
13	38932949	rs9532209	A	G	8	9	17	0	0	17	0	0
13	38936310	rs2485783	A	G	208	258	466	0	3	470	1	0
13	39584916	rs17226809	A	T	32	32	64	0	1	65	0	0
13	39585178	rs2274385	C	T	24	21	45	0	2	47	0	0
13	39586343	rs9576697	G	C	104	100	204	0	2	206	0	0
13	39587166	rs11147745	A	G	126	93	219	0	2	221	0	0
13	39587677	rs3751379	A	G	63	55	118	0	0	118	0	0
13	39587763	rs35453341	C	T	83	85	168	0	1	169	0	0
13	39587865	rs3751378	A	C	87	67	154	0	1	155	0	0
13	39587889	rs3751377	T	C	83	73	156	0	5	161	0	0
13	39598616	rs61945763	G	A	39	47	86	0	0	86	0	0
13	39599884	rs1409441	G	A	4	3	7	0	0	7	0	0
13	39608900	rs9888511	T	C	4	4	8	0	0	8	0	0
13	39622075	rs9532318	T	C	5	3	8	0	0	8	0	0
13	40169423	rs9566462	T	C	4	2	6	0	0	6	0	0
13	41323397	rs13508	C	T	39	30	69	0	0	69	0	0
13	41340684	rs7986077	T	G	4	3	7	0	0	7	0	0
13	41382711	rs17849654	A	T	14	10	24	0	0	24	0	0
13	41384156	rs9549293	A	G	10	11	21	0	0	21	0	0
13	41454804	rs9532642	C	T	5	2	7	0	0	7	0	0
13	41508718	rs187807249	G	A	6	9	15	0	0	15	0	0
13	41514312	rs10467470	A	G	16	13	29	0	0	29	0	0
13	41515182	rs9562247	T	C	1167	1316	2483	0	23	2509	3	0
13	41518919	rs9285144	T	C	17	9	26	0	2	28	0	0
13	41522338	rs9532679	A	C	7	13	20	0	0	20	0	0
13	41523876	rs9525435	T	C	5	5	10	0	0	10	0	0
13	41524673	rs9532680	C	A	5	8	13	0	0	13	0	0
13	41552222	rs190603883	G	A	4	3	7	0	1	8	0	0
13	41565006	.	T	A	5	2	7	0	0	7	0	0
13	41591723	rs11147833	C	G	10	12	22	0	1	23	0	0
13	41644722	rs9532718	A	C	5	2	7	0	0	7	0	0
13	41834744	rs2297555	C	T	16	12	28	0	0	28	0	0
13	41893105	rs2065498	T	G	4	6	10	0	0	10	0	0
13	41893813	rs2483106	T	C	4	8	12	0	0	12	0	0
13	41902939	rs3812896	T	C	189	135	324	0	3	327	0	0
13	41905902	rs6560978	A	G	9	9	18	0	0	18	0	0
13	41907638	rs9532791	G	C	27	19	46	0	1	47	0	0
13	41916203	rs9315832	C	T	6	8	14	0	0	14	0	0
13	41941164	rs7988913	A	T	4	3	7	0	0	7	0	0
13	41941416	rs6560981	T	A	3	7	10	0	0	10	0	0
13	41948051	rs9525478	G	C	7	12	19	0	0	19	0	0
13	41948151	rs9525479	T	G	7	8	15	0	0	15	0	0
13	41948177	rs9525480	C	T	3	9	12	0	0	12	0	0
13	41948593	rs9285147	C	T	7	2	9	0	0	9	0	0
13	41949804	rs6560982	G	T	18	20	38	0	0	39	1	0
13	41950538	rs9532797	G	C	25	30	55	0	0	55	0	0
13	41950562	rs9315836	A	G	26	28	54	0	1	55	0	0
13	42032572	rs7136	T	C	223	187	410	0	10	420	0	0
13	42033698	rs10467472	G	C	16	18	34	0	0	34	0	0
13	42895166	rs1014659	C	T	2	4	6	0	0	6	0	0
13	43181799	rs12721444	T	C	4	2	6	0	0	6	0	0
13	43182002	rs1054016	G	T	5	2	7	0	0	7	0	0
13	43461643	rs2281810	A	G	6	8	14	0	0	14	0	0
13	43462422	rs1044856	A	T	13	8	21	0	0	21	0	0
13	43469157	rs1128105	G	A	6	16	22	0	0	22	0	0
13	43469211	rs1359184	G	A	6	9	15	0	1	16	0	0
13	43597706	rs17553284	C	T	12	0	12	0	0	12	0	0
13	43597865	rs12015	A	G	234	2	236	0	1	237	0	0
13	43659200	rs912441	C	G	6	0	6	0	0	6	0	0
13	43681427	rs1047775	G	A	120	3	123	0	35	159	1	0
13	43682841	rs9533394	A	G	28	0	28	0	0	28	0	0
13	43683008	rs11728	G	A	15	0	15	0	0	15	0	0
13	43683020	rs11346	A	G	11	0	11	0	0	11	0	0
13	44411421	rs79782223	C	T	5	1	6	0	0	6	0	0
13	45009532	rs7326974	C	A	11	9	20	0	0	20	0	0
13	45010616	rs7997320	G	A	5	2	7	0	1	8	0	0
13	45589192	.	A	G	6	7	13	0	2	15	0	0
13	45912478	rs35952083	C	T	50	35	85	0	0	85	0	0
13	45934312	rs12871798	A	G	1	6	7	0	0	7	0	0
13	45952669	rs11618141	C	T	33	20	53	0	1	54	0	0
13	45957288	rs9526063	C	G	28	19	47	0	2	49	0	0
13	45985583	rs12872200	T	G	11	13	24	0	0	24	0	0
13	45985608	rs7997155	T	A	9	11	20	0	0	20	0	0
13	46067593	rs2985959	G	A	10	9	19	0	0	19	0	0
13	46092122	rs942891	T	C	4	3	7	0	0	7	0	0
13	46103935	rs2274285	A	G	24	13	37	0	0	38	1	0
13	46108643	rs3014901	T	C	4	3	7	0	0	7	0	0
13	46108691	rs9595339	A	C	3	3	6	0	0	6	0	0
13	46109026	rs1061694	T	A	19	19	38	0	0	38	0	0
13	46541673	rs9534264	T	A	10	20	30	0	0	30	0	0
13	46562935	rs1134071	A	G	5	8	13	0	0	13	0	0
13	46566823	rs9534272	G	C	2	5	7	0	0	7	0	0
13	46566988	rs9534273	A	G	4	4	8	0	0	8	0	0
13	46575557	rs4294711	C	T	27	27	54	0	0	54	0	0
13	46708291	rs4941543	T	C	1483	1526	3009	0	27	3036	0	0
13	46709389	.	T	C	6	12	18	0	0	18	0	0
13	46712587	rs1980830	A	G	12	9	21	0	0	21	0	0
13	46723715	rs1886039	A	G	8	17	25	0	1	26	0	0
13	46724166	rs17601737	C	T	17	15	32	0	0	32	0	0
13	46727405	rs7987733	T	C	9	6	15	0	0	15	0	0
13	46728583	rs1886045	T	C	3	4	7	0	0	7	0	0
13	46728771	rs4258501	T	C	12	5	17	0	0	17	0	0
13	46728924	rs2296122	C	T	10	4	14	0	0	14	0	0
13	46755880	rs10492449	T	G	12	14	26	0	0	26	0	0
13	46961300	rs45593739	T	C	5	3	8	0	0	8	0	0
13	48517289	rs4941618	A	G	27	16	43	0	0	43	0	0
13	48545973	rs12873870	C	T	2	6	8	0	0	8	0	0
13	48547467	rs7320366	A	T	10	25	35	0	0	35	0	0
13	48561837	rs9534898	A	T	2	5	7	0	0	7	0	0
13	48562239	rs7337744	G	C	10	4	14	0	0	14	0	0
13	48576238	rs7999505	A	G	8	8	16	0	0	16	0	0
13	48578906	rs7333659	T	G	60	46	106	0	1	107	0	0
13	48601455	rs61973260	C	T	8	4	12	0	0	12	0	0
13	48601456	rs61973261	A	G	8	4	12	0	0	12	0	0
13	48601759	rs56193118	A	T	3	3	6	0	1	7	0	0
13	48612372	rs17071168	A	G	0	6	6	0	0	6	0	0
13	48615435	rs943066	T	C	25	20	45	0	1	46	0	0
13	48628449	rs9595835	T	C	7	0	7	0	0	7	0	0
13	48628765	rs9595836	G	T	9	0	9	0	0	9	0	0
13	48655130	rs7323821	C	A	3	4	7	0	0	7	0	0
13	48655134	rs7325175	T	C	3	5	8	0	0	8	0	0
13	48661240	rs9591135	G	A	1	6	7	0	0	7	0	0
13	48665136	rs144265943	T	C	8	1	9	0	0	9	0	0
13	48665714	rs9567993	T	A	1	7	8	0	0	8	0	0
13	48666005	rs7990060	G	A	3	12	15	0	0	15	0	0
13	48666138	rs7990099	C	T	1	8	9	0	0	9	0	0
13	48666690	rs9316348	G	A	3	5	8	0	0	8	0	0
13	48666761	rs7332363	C	G	4	5	9	0	0	9	0	0
13	48666828	rs9316349	G	A	5	4	9	0	0	9	0	0
13	48667878	rs9567994	C	G	2	6	8	0	0	8	0	0
13	48668410	rs7981114	A	G	4	5	9	0	0	9	0	0
13	48668792	rs7986400	G	T	3	8	11	0	0	11	0	0
13	48669181	rs34140370	C	G	48	63	111	0	0	111	0	0
13	48808132	rs3803188	C	T	8	5	13	0	1	14	0	0
13	48810789	rs9316367	C	T	5	10	15	0	0	15	0	0
13	48817288	rs9534998	C	G	3	3	6	0	0	6	0	0
13	48818485	rs2243626	G	A	7	7	14	0	2	16	0	0
13	48826819	rs7984795	C	G	3	3	6	0	0	6	0	0
13	48882342	rs1981435	C	T	13	11	24	0	0	24	0	0
13	48882363	rs2854355	A	G	13	12	25	0	0	25	0	0
13	49556113	rs9596047	G	A	8	6	14	0	0	14	0	0
13	49841534	.	C	A	9	6	15	0	1	16	0	0
13	50093807	.	G	A	6	2	8	0	1	9	0	0
13	50242696	rs7999786	C	T	1	7	8	0	0	8	0	0
13	50253644	rs9562910	T	C	6	8	14	0	0	14	0	0
13	50273831	rs1043729	T	C	161	180	341	0	5	346	0	0
13	50273970	rs1819191	C	T	186	186	372	0	5	377	0	0
13	50275515	rs7446	C	T	95	113	208	0	3	211	0	0
13	50283819	rs17073322	T	C	170	172	342	0	0	342	0	0
13	50285551	rs2236326	G	A	1	6	7	0	0	7	0	0
13	50287894	rs7984711	T	C	3	4	7	0	0	7	0	0
13	50488855	rs1609571	C	A	7	1	8	0	0	8	0	0
13	50583025	rs35590518	T	C	6	1	7	0	0	7	0	0
13	50614098	rs9568371	C	T	4	4	8	0	0	8	0	0
13	50617508	.	T	G	6	2	8	0	0	8	0	0
13	50617515	rs35456235	T	G	4	3	7	0	0	7	0	0
13	50637787	rs790943	G	T	4	3	7	0	0	7	0	0
13	50656582	rs2066575	T	A	60	37	97	0	0	97	0	0
13	50697838	rs2066589	C	A	14	10	24	0	0	24	0	0
13	50698447	rs61962356	G	C	2	4	6	0	0	6	0	0
13	50700431	rs76067960	C	T	2	5	7	0	0	7	0	0
13	51484445	rs9535526	C	T	1	5	6	0	0	6	0	0
13	51516305	rs7316955	A	G	9	14	23	0	0	23	0	0
13	51544431	.	C	A	18	20	38	0	1	39	0	0
13	52028770	.	A	G	15	11	26	0	0	26	0	0
13	52507110	rs928169	G	C	2	4	6	0	0	6	0	0
13	52507720	rs1051332	C	T	3	3	6	0	0	6	0	0
13	52544805	rs1801244	C	G	4	2	6	0	0	6	0	0
13	52602919	rs3825528	A	C	8	2	10	0	0	10	0	0
13	52603775	rs3742291	C	T	3	7	10	0	0	10	0	0
13	52605675	rs2897964	A	G	7	5	12	0	0	12	0	0
13	52607169	rs1055062	T	C	4	3	7	0	0	7	0	0
13	52707240	rs3368	C	G	33	32	65	0	1	66	0	0
13	52709938	rs2296351	A	C	24	32	56	0	1	57	0	0
13	52722798	rs2274202	C	A	4	2	6	0	0	6	0	0
13	52765847	rs9535895	G	A	3	6	9	0	0	9	0	0
13	52989863	rs1056335	C	T	23	21	44	0	0	44	0	0
13	53006058	rs7323666	T	C	4	4	8	0	0	8	0	0
13	53024374	rs12430462	G	C	3	12	15	0	0	15	0	0
13	53050076	.	T	C	24	24	48	0	1	49	0	0
13	53217035	rs9536211	C	A	57	39	96	0	1	97	0	0
13	53217270	rs9536212	A	G	93	55	148	0	2	150	0	0
13	55015081	rs811605	G	A	35	0	35	0	3	38	0	0
13	60240961	rs9538494	C	T	4	8	12	0	0	12	0	0
13	61109375	rs41293436	A	C	1	6	7	0	0	7	0	0
13	64577497	rs9598695	A	T	10	0	10	0	0	10	0	0
13	64577532	rs9592311	A	G	10	0	10	0	0	10	0	0
13	64608552	rs269583	G	T	0	6	6	0	0	6	0	0
13	73284411	rs7931	A	T	44	36	80	0	1	81	0	0
13	73329358	rs10887	G	A	12	8	20	0	0	20	0	0
13	73338175	rs4885043	G	A	6	3	9	0	0	9	0	0
13	73338848	rs7988394	T	C	5	5	10	0	0	10	0	0
13	73339232	rs2325495	A	G	4	2	6	0	0	6	0	0
13	73343039	rs2196979	C	T	55	75	130	0	0	130	0	0
13	73349359	rs7332388	G	C	76	49	125	0	1	126	0	0
13	73369642	rs1372000	A	G	13	12	25	0	0	25	0	0
13	73373213	rs2031295	G	A	1	6	7	0	0	7	0	0
13	75876389	rs2297208	G	A	5	1	6	0	0	6	0	0
13	77559950	rs389644	A	G	5	2	7	0	0	7	0	0
13	77560008	rs392121	T	C	6	1	7	0	0	7	0	0
13	77565655	rs642394	C	T	3	4	7	0	0	7	0	0
13	77565972	rs654196	A	G	2	4	6	0	0	6	0	0
13	77589725	rs599115	A	C	9	0	9	0	0	9	0	0
13	77590936	rs591576	A	G	12	2	14	0	0	14	0	0
13	77596408	rs606861	C	G	3	10	13	0	0	13	0	0
13	77738664	rs2274547	A	G	8	10	18	0	0	18	0	0
13	77751892	rs4885445	C	T	17	13	30	0	0	30	0	0
13	79954274	rs568220298	A	C	1	8	9	0	0	9	0	0
13	79975867	rs140719497	A	G	4	4	8	0	0	8	0	0
13	80126768	rs1212082	G	A	6	4	10	0	0	10	0	0
13	80912225	rs148930676	A	T	5	7	12	0	0	12	0	0
13	82264468	rs9574945	G	A	24	0	24	0	2	26	0	0
13	88329746	rs34892880	C	T	8	13	21	0	0	21	0	0
13	92005118	rs113242099	T	G	5	7	12	0	0	13	1	0
13	92005134	rs111371822	A	G	3	3	6	0	0	6	0	0
13	92005137	rs7336610	C	T	4	3	7	0	0	7	0	0
13	95264604	rs9524559	C	T	5	3	8	0	0	8	0	0
13	95279505	rs9524568	T	A	3	4	7	0	0	7	0	0
13	95672237	rs3770	G	A	14	23	37	0	0	37	0	0
13	95672528	rs9584273	C	T	28	31	59	0	0	59	0	0
13	95672886	rs74341718	G	A	30	31	61	0	0	61	0	0
13	95672950	rs1059751	A	G	24	25	49	0	0	49	0	0
13	95673135	rs4148553	C	T	28	28	56	0	1	57	0	0
13	95673518	rs4148551	T	C	23	20	43	0	0	43	0	0
13	95673791	rs3742106	A	C	12	19	31	0	0	31	0	0
13	95841549	rs2448299	A	G	64	0	64	0	1	65	0	0
13	95861804	rs899494	A	G	5	7	12	0	0	12	0	0
13	96408119	rs9561948	C	T	7	4	11	0	1	12	0	0
13	97938649	rs9516890	T	C	5	1	6	0	0	6	0	0
13	97938708	rs9513225	C	T	5	3	8	0	0	8	0	0
13	97938717	rs9513226	C	T	4	4	8	0	0	8	0	0
13	98119524	rs12873919	T	C	5	4	9	0	1	10	0	0
13	98640318	rs592246	C	T	15	5	20	0	0	20	0	0
13	98654065	rs76282191	G	A	5	7	12	0	0	12	0	0
13	98676168	.	G	A	28	23	51	0	0	51	0	0
13	99104170	rs3742134	C	T	4	3	7	0	0	7	0	0
13	99104689	rs6956	T	C	228	182	410	0	4	414	0	0
13	99105302	rs12463	G	A	154	150	304	0	2	306	0	0
13	99105395	rs8481	G	A	118	108	226	0	6	232	0	0
13	99118590	rs9584854	C	T	6	1	7	0	0	7	0	0
13	99157232	rs74426694	G	C	15	13	28	0	0	28	0	0
13	99171326	rs12583333	C	T	6	6	12	0	0	12	0	0
13	99852753	rs2296860	A	G	4	6	10	0	0	10	0	0
13	99854223	.	A	G	4	3	7	0	0	7	0	0
13	99895284	rs7993615	G	T	3	3	6	0	0	6	0	0
13	99944235	rs9517673	A	T	4	4	8	0	0	8	0	0
13	99958565	rs1927730	T	C	1	5	6	0	0	6	0	0
13	100518580	rs3783185	A	G	22	24	46	0	2	48	0	0
13	101256563	rs3742244	T	A	23	17	40	0	0	40	0	0
13	101287340	rs946837	C	T	21	13	34	0	0	34	0	0
13	101287404	rs2297943	G	A	21	15	36	0	0	36	0	0
13	101322622	rs1283201	G	C	15	15	30	0	0	30	0	0
13	103263233	rs7995787	G	A	4	2	6	0	0	6	0	0
13	103263531	rs35832914	C	G	3	4	7	0	0	7	0	0
13	103275495	rs17507043	C	T	12	14	26	0	0	26	0	0
13	103493013	rs1140184	G	A	5	8	13	0	2	15	0	0
13	103493180	rs2018836	A	G	8	6	14	0	1	15	0	0
13	103493825	rs4743	C	G	4	2	6	0	0	6	0	0
13	103498664	.	G	A	15	19	34	0	0	34	0	0
13	103499417	rs7325496	C	A	6	1	7	0	0	7	0	0
13	103504517	rs1047768	T	C	24	29	53	0	0	53	0	0
13	103515992	rs4150324	C	T	4	4	8	0	0	8	0	0
13	103521114	rs3783236	C	T	3	3	6	0	0	6	0	0
13	103524762	rs4150360	C	T	7	0	7	0	0	7	0	0
13	103527079	rs4150370	A	T	4	2	6	0	1	7	0	0
13	103527230	rs4150383	G	A	4	2	6	0	0	6	0	0
13	107144320	rs9520087	G	A	13	17	30	0	0	30	0	0
13	107197068	.	T	C	3	3	6	0	0	6	0	0
13	107197119	rs3783057	A	C	4	6	10	0	0	10	0	0
13	107210841	rs9587158	T	C	165	179	344	0	3	347	0	0
13	108960188	rs4145212	T	A	3	3	6	0	0	6	0	0
13	111147214	rs59977960	G	A	0	6	6	0	0	6	0	0
13	111175419	rs3742189	G	T	4	2	6	0	0	6	0	0
13	111176519	rs375814	G	T	159	145	304	0	1	305	0	0
13	111176616	rs1062004	G	T	4	2	6	0	0	6	0	0
13	111184954	rs394559	C	T	5	1	6	0	0	6	0	0
13	111203685	rs912942	A	G	1	5	6	0	0	6	0	0
13	111210178	rs2025656	T	G	8	8	16	0	1	17	0	0
13	111210520	rs9521841	C	T	10	12	22	0	0	22	0	0
13	111210903	rs9521842	G	A	8	5	13	0	0	13	0	0
13	111280712	rs1041143	G	T	2	5	7	0	0	7	0	0
13	111280738	rs2011692	C	T	3	6	9	0	0	9	0	0
13	111281600	rs2148081	C	T	1	6	7	0	0	7	0	0
13	111281614	rs1041173	G	T	0	6	6	0	0	6	0	0
13	111283809	rs3783097	A	C	5	4	9	0	0	9	0	0
13	111284759	rs113942509	C	T	6	4	10	0	0	10	0	0
13	111284812	rs144684178	G	A	6	5	11	0	0	11	0	0
13	111285098	rs111281134	C	G	7	3	10	0	0	10	0	0
13	111285989	rs72661650	G	A	5	8	13	0	0	13	0	0
13	111286199	rs12430333	G	A	4	3	7	0	0	7	0	0
13	111286318	rs2986321	T	C	3	3	6	0	0	6	0	0
13	111287304	rs3742196	T	C	8	5	13	0	0	13	0	0
13	111287344	rs72661656	C	T	8	6	14	0	0	14	0	0
13	111287552	rs72661657	C	T	2	8	10	0	0	10	0	0
13	111288716	rs79481071	G	A	7	6	13	0	0	13	0	0
13	111289698	rs3825467	A	G	9	4	13	0	0	13	0	0
13	111290220	rs9588214	A	G	24	7	31	0	0	31	0	0
13	111290258	rs77982490	C	T	21	10	31	0	0	31	0	0
13	111290880	rs330563	G	A	26	35	61	0	0	61	0	0
13	111291044	rs330564	T	C	24	27	51	0	0	51	0	0
13	111291247	rs330566	G	A	36	22	58	0	0	58	0	0
13	111291256	rs424943	G	A	38	21	59	0	0	59	0	0
13	111291266	rs74127059	T	C	34	15	49	0	1	50	0	0
13	111291818	rs2274411	C	T	31	39	70	0	1	71	0	0
13	111292044	rs7394	A	G	36	33	69	0	0	69	0	0
13	111296024	rs4771702	G	A	6	5	11	0	0	11	0	0
13	111296170	rs4771704	C	T	11	12	23	0	0	23	0	0
13	111298392	rs436462	A	G	197	205	402	0	4	406	0	0
13	111299061	rs450565	C	T	9	1	10	0	0	10	0	0
13	111300897	rs451270	C	T	4	2	6	0	0	6	0	0
13	111301882	rs9583520	C	T	2	4	6	0	0	6	0	0
13	111316043	.	G	C	11	19	30	0	2	32	0	0
13	111316061	rs2296655	C	T	11	17	28	0	2	30	0	0
13	111316590	rs8000115	A	G	3	3	6	0	0	6	0	0
13	111316883	rs8000867	C	A	4	4	8	0	0	8	0	0
13	111317138	rs9583523	T	A	6	4	10	0	0	10	0	0
13	111317772	rs7985128	G	A	3	3	6	0	0	6	0	0
13	111318794	rs7328764	T	C	9	5	14	0	0	14	0	0
13	111318831	rs7328928	T	C	5	2	7	0	0	7	0	0
13	111318836	rs12584848	G	A	2	5	7	0	0	7	0	0
13	111319754	rs4628819	T	C	124	148	272	0	2	274	0	0
13	111373205	.	C	A	6	3	9	0	1	10	0	0
13	111531264	rs6829	C	T	72	54	126	0	0	126	0	0
13	111531483	rs3180286	G	A	98	101	199	0	1	200	0	0
13	111531742	rs3809343	A	G	75	84	159	0	1	160	0	0
13	111531885	rs1547178	C	A	64	62	126	0	0	126	0	0
13	111534577	rs75292703	G	A	8	10	18	0	0	18	0	0
13	111536743	rs6492325	T	C	3	7	10	0	0	10	0	0
13	111538047	rs7332528	A	G	1	5	6	0	0	6	0	0
13	111540560	rs9521977	T	C	2	5	7	0	0	7	0	0
13	111543043	rs9515307	G	A	4	3	7	0	0	7	0	0
13	111543106	rs7994149	C	T	4	6	10	0	0	10	0	0
13	111547103	rs116355942	T	A	18	5	23	0	0	23	0	0
13	111547130	rs9521982	T	C	15	9	24	0	0	24	0	0
13	111547210	rs9521983	T	C	9	7	16	0	0	16	0	0
13	111547760	rs11618215	G	T	12	12	24	0	0	24	0	0
13	111548261	rs2148568	C	T	33	26	59	0	0	59	0	0
13	111548896	rs77579810	A	G	25	37	62	0	0	62	0	0
13	111549315	rs9559902	C	T	10	5	15	0	0	15	0	0
13	111549722	rs1134348	C	T	10	10	20	0	0	20	0	0
13	111549982	rs9521984	G	C	17	19	36	0	1	37	0	0
13	111550388	rs9559903	C	T	10	12	22	0	0	22	0	0
13	111551920	rs3205743	T	C	11	5	16	0	0	16	0	0
13	111552119	rs4773270	G	A	8	10	18	0	1	19	0	0
13	111553839	rs9521986	A	T	7	1	8	0	0	8	0	0
13	111553865	rs74899630	C	G	9	3	12	0	0	12	0	0
13	111555363	rs9515308	C	A	8	2	10	0	0	10	0	0
13	111555372	rs9515309	A	G	8	3	11	0	0	11	0	0
13	111555592	rs9521987	G	A	13	6	19	0	0	19	0	0
13	111556559	rs544775957	T	G	5	8	13	0	0	13	0	0
13	111557399	rs7987467	G	A	2	4	6	0	0	6	0	0
13	111557849	rs34123604	A	C	2	4	6	0	0	6	0	0
13	111567385	rs4773274	T	C	4	6	10	0	0	10	0	0
13	111806040	rs9555774	T	G	11	15	26	0	0	26	0	0
13	111806245	rs61966721	A	G	8	15	23	0	1	24	0	0
13	111886057	rs9583590	T	C	41	36	77	0	0	77	0	0
13	111906065	rs55761866	T	A	0	6	6	0	0	6	0	0
13	111933098	rs2296353	C	G	7	10	17	0	0	17	0	0
13	111934172	rs72653558	C	T	31	13	44	0	0	44	0	0
13	111944866	rs4145274	A	G	24	13	37	0	0	37	0	0
13	111946651	rs41275852	C	T	19	22	41	0	0	41	0	0
13	111950969	rs72653569	C	T	5	1	6	0	0	6	0	0
13	111951311	rs942648	C	T	3	3	6	0	0	6	0	0
13	111955907	rs6492352	T	C	37	45	82	0	0	82	0	0
13	111956103	rs3783083	A	G	51	43	94	0	2	96	0	0
13	113153114	rs9549532	T	C	3	8	11	0	0	11	0	0
13	113174003	rs112509508	A	C	5	3	8	0	0	8	0	0
13	113186474	rs7983260	C	T	3	3	6	0	0	6	0	0
13	113201733	rs113923467	T	C	8	5	13	0	0	13	0	0
13	113205688	rs76523728	T	C	4	3	7	0	0	7	0	0
13	113363042	rs379185	C	T	4	5	9	0	0	9	0	0
13	113363755	rs12427584	G	A	5	9	14	0	0	14	0	0
13	113371656	rs381583	C	T	25	3	28	0	0	28	0	0
13	113473626	.	C	T	8	12	20	0	0	20	0	0
13	113527967	rs1320525	G	A	6	4	10	0	1	12	1	0
13	113530199	rs11616795	G	A	10	15	25	0	0	25	0	0
13	113531357	rs9549595	A	G	6	16	22	0	0	22	0	0
13	113531469	rs9549596	C	T	6	5	11	0	0	11	0	0
13	113532076	rs9549315	G	A	7	1	8	0	0	8	0	0
13	113532990	rs1278761	T	C	6	2	8	0	0	8	0	0
13	113533113	rs9549597	G	A	4	7	11	0	0	11	0	0
13	113534907	rs9577174	T	C	1	6	7	0	1	8	0	0
13	113536132	rs1290177	T	C	11	7	18	0	0	18	0	0
13	113536467	rs36048052	G	A	14	18	32	0	0	32	0	0
13	113537311	rs3742232	C	T	20	18	38	0	0	38	0	0
13	113537448	rs3742233	G	A	25	18	43	0	4	47	0	0
13	113538187	rs11617625	G	A	9	8	17	0	0	17	0	0
13	113539523	rs1063098	G	A	24	11	35	0	0	35	0	0
13	113539688	rs1140048	A	C	16	21	37	0	0	37	0	0
13	113539894	rs1046793	C	T	19	18	37	0	0	37	0	0
13	113540004	rs1046790	T	C	15	21	36	0	0	36	0	0
13	113540395	rs9549599	C	T	11	9	20	0	0	20	0	0
13	113875080	rs56129102	C	T	23	35	58	0	0	58	0	0
13	113918770	rs11552924	A	C	30	41	71	0	0	71	0	0
13	114110660	rs14067	A	G	16	7	23	0	1	24	0	0
13	114112008	rs3814255	G	A	2	4	6	0	0	6	0	0
13	114112287	rs3814254	C	A	9	13	22	0	0	22	0	0
13	114147997	rs2261163	T	C	11	17	28	0	1	29	0	0
13	114148720	rs11617768	T	C	23	34	57	0	0	57	0	0
13	114150107	rs11164135	C	T	290	338	628	0	5	633	0	0
13	114155706	rs2490956	T	C	2	4	6	0	0	6	0	0
13	114157650	rs2248742	C	T	3	5	8	0	0	8	0	0
13	114158900	rs2265152	C	T	6	8	14	0	0	14	0	0
13	114175038	rs7319493	G	A	33	75	108	0	1	109	0	0
13	114189122	rs8000521	T	C	4	4	8	0	1	9	0	0
13	114204255	rs11699	A	G	14	26	40	0	1	41	0	0
13	114204369	rs1046518	G	A	10	12	22	0	1	23	0	0
13	114292538	rs4150818	C	G	5	6	11	0	0	11	0	0
13	114519614	rs11619248	G	C	1	10	11	0	0	11	0	0
13	114519674	rs11618382	C	T	2	8	10	0	2	12	0	0
13	114522295	rs10219951	C	T	0	6	6	0	0	6	0	0
13	114522534	rs7990393	G	A	6	11	17	0	0	17	0	0
13	114523387	rs34766013	C	G	22	13	35	0	0	35	0	0
13	114530627	rs34551980	T	G	4	2	6	0	0	6	0	0
13	114530817	rs12585097	G	C	4	2	6	0	0	6	0	0
13	114531911	rs9604463	A	G	9	0	9	0	0	9	0	0
13	114536340	rs41284479	C	T	6	2	8	0	0	8	0	0
13	114537517	rs8191974	C	T	7	3	10	0	0	10	0	0
13	114545317	rs9577924	A	G	6	14	20	0	0	20	0	0
13	114545925	rs7320583	A	G	9	5	14	0	0	14	0	0
13	114545955	rs56298096	G	T	9	7	16	0	0	16	0	0
13	114546549	rs6602912	T	G	1	5	6	0	0	6	0	0
13	114547372	rs6602911	C	T	7	6	13	0	0	13	0	0
13	114547695	rs59144674	C	T	11	3	14	0	3	17	0	0
13	114548040	rs33999512	G	A	12	6	18	0	0	18	0	0
13	114548163	rs9577923	C	G	7	6	13	0	0	13	0	0
13	114549015	rs6602910	T	C	7	4	11	0	0	11	0	0
13	114551980	rs7400614	C	A	2	5	7	0	0	7	0	0
13	114551993	rs6602909	T	C	2	4	6	0	0	6	0	0
13	114552039	rs6602908	T	C	4	3	7	0	0	7	0	0
13	114747391	rs11672	C	T	83	73	156	0	1	157	0	0
13	114748139	rs11552972	A	G	67	39	106	0	0	106	0	0
13	114748384	rs11552971	C	T	33	38	71	0	0	71	0	0
13	114748709	rs11147333	G	A	50	46	96	0	0	96	0	0
13	114764212	rs9525178	T	C	3	3	6	0	0	6	0	0
13	114774952	rs41291211	C	T	5	4	9	0	0	9	0	0
13	114774991	rs41291213	C	T	7	5	12	0	0	12	0	0
13	114775538	rs2297099	T	A	9	7	16	0	0	16	0	0
13	114775783	rs2297102	A	G	9	3	12	0	0	12	0	0
13	114780764	rs2274717	A	G	35	29	64	0	0	64	0	0
13	114848707	rs7329987	C	A	1	5	6	0	0	6	0	0
13	114881650	rs116587697	T	C	3	3	6	0	0	6	0	0
13	114890897	rs117056755	G	A	13	5	18	0	0	18	0	0
13	114891196	rs9525277	T	C	11	6	17	0	0	17	0	0
13	115002305	rs8002514	G	A	34	79	113	0	1	114	0	0
13	115003468	rs6560947	C	G	2	9	11	0	0	11	0	0
13	115004914	rs2296971	C	T	33	52	85	0	3	88	0	0
13	115004935	rs2296970	T	C	41	64	105	0	0	105	0	0
13	115010254	rs3211416	C	T	7	7	14	0	0	14	0	0
13	115030714	rs8809	T	C	73	103	176	0	1	177	0	0
13	115047305	rs3752105	G	A	22	25	47	0	0	47	0	0
13	115047464	rs112035922	C	T	16	17	33	0	0	33	0	0
13	115049220	rs80113989	T	C	4	7	11	0	2	13	0	0
13	115064423	rs3752107	G	A	51	19	70	0	2	72	0	0
13	115087808	rs12584212	A	G	7	6	13	0	0	13	0	0
13	115090019	rs3813131	G	A	43	15	58	0	2	60	0	0
13	115090193	rs3813133	G	A	20	30	50	0	0	50	0	0
13	115091399	rs9525332	T	C	31	31	62	0	0	62	0	0
14	20755287	rs1057605	C	A	4	2	6	0	0	6	0	0
14	20756405	rs10130942	C	T	5	5	10	0	0	10	0	0
14	20757804	rs3737220	C	A	6	24	30	0	0	30	0	0
14	20764585	rs1953552	A	C	10	12	22	0	0	22	0	0
14	20770036	rs3742945	T	C	6	13	19	0	0	19	0	0
14	20784718	rs1132644	G	T	322	274	596	0	4	600	0	0
14	20786432	rs76311431	C	G	3	8	11	0	0	11	0	0
14	20822830	.	G	T	11	5	16	0	0	16	0	0
14	20834548	rs1713419	A	G	9	6	15	0	0	15	0	0
14	20834809	rs1713418	A	G	3	6	9	0	0	9	0	0
14	20836173	rs56343177	C	G	5	3	8	0	0	8	0	0
14	20837701	rs938886	G	C	14	7	21	0	0	21	0	0
14	20841707	rs1713449	C	T	8	8	16	0	0	16	0	0
14	20859205	rs872074	C	T	5	1	6	0	0	6	0	0
14	20863677	rs2228036	C	A	3	3	6	0	0	6	0	0
14	20916896	.	A	G	201	235	436	0	7	443	0	0
14	20916958	rs938883	T	C	191	221	412	0	4	416	0	0
14	20916987	rs938882	G	A	6	6	12	0	0	12	0	0
14	20917442	rs938881	A	T	33	61	94	0	0	94	0	0
14	20917665	rs999692	T	C	35	44	79	0	1	80	0	0
14	20917744	rs883037	C	T	39	32	71	0	0	71	0	0
14	20918113	rs8015086	A	G	18	20	38	0	0	38	0	0
14	20918245	rs3120072	T	C	7	11	18	0	1	19	0	0
14	20918598	rs3120071	A	C	11	19	30	0	0	30	0	0
14	20919097	rs3120070	T	C	4	4	8	0	0	8	0	0
14	20919188	rs3094277	G	A	4	7	11	0	0	11	0	0
14	20919192	rs3120069	C	T	7	3	10	0	1	11	0	0
14	20919551	rs3120068	C	T	12	12	24	0	1	25	0	0
14	20919623	rs3120067	T	C	8	8	16	0	0	16	0	0
14	20919667	rs3120066	C	T	9	4	13	0	0	13	0	0
14	20919712	rs3120065	C	T	11	7	18	0	0	18	0	0
14	20920043	rs1320150	C	T	14	22	36	0	1	37	0	0
14	20920250	rs2275007	T	C	137	117	254	0	0	254	0	0
14	20920340	rs2275006	A	G	9	4	13	0	0	13	0	0
14	20920749	rs1878703	C	G	12	11	23	0	1	24	0	0
14	20923431	.	T	C	297	327	624	0	2	626	0	0
14	20926148	.	G	A	128	120	248	0	1	249	0	0
14	21460578	rs2297718	T	C	3	6	9	0	0	9	0	0
14	21461721	rs56026871	A	T	12	8	20	0	1	21	0	0
14	21461836	rs2783802	A	G	8	10	18	0	0	18	0	0
14	21461840	rs56390589	G	A	10	7	17	0	0	17	0	0
14	21461846	rs4982388	C	T	9	8	17	0	0	17	0	0
14	21461904	rs56023476	T	A	8	6	14	0	0	14	0	0
14	21461909	rs149304930	A	G	8	7	15	0	0	15	0	0
14	21461912	rs56307900	A	G	8	7	15	0	0	15	0	0
14	21463080	rs143843703	T	C	18	24	42	0	0	42	0	0
14	21553877	.	C	T	28	24	52	0	0	52	0	0
14	21558558	rs6571653	G	C	87	58	145	0	0	145	0	0
14	21672042	rs78667784	C	T	8	6	14	0	0	14	0	0
14	21672972	rs17102536	T	C	6	5	11	0	1	12	0	0
14	21673133	rs199902517	A	G	8	9	17	0	0	19	2	0
14	21673332	rs12892305	A	C	9	9	18	0	0	18	0	0
14	21674214	rs1243370	T	C	6	7	13	0	0	13	0	0
14	21674392	rs1243371	C	T	8	4	12	0	0	12	0	0
14	21677694	rs7495	T	C	221	180	401	0	2	403	0	0
14	21699069	rs8016099	A	C	6	15	21	0	0	21	0	0
14	21724070	rs7142957	G	A	9	9	18	0	0	18	0	0
14	21724639	.	C	T	5	4	9	0	0	9	0	0
14	21733457	rs12589290	A	G	6	3	9	0	0	9	0	0
14	21735715	rs74693625	A	T	6	7	13	0	0	13	0	0
14	21818827	rs56097784	T	G	17	17	34	0	0	34	0	0
14	21829129	rs3762158	C	G	116	91	207	0	2	209	0	0
14	21831052	rs10138699	T	C	133	110	243	0	3	246	0	0
14	21836400	rs8008670	T	C	6	4	10	0	0	10	0	0
14	21838160	rs2181125	A	G	3	3	6	0	0	6	0	0
14	21838363	rs73579641	C	T	4	3	7	0	0	7	0	0
14	21851910	.	G	A	10	6	16	0	0	16	0	0
14	21859536	rs3762159	T	C	3	3	6	0	0	6	0	0
14	21860360	rs1998332	G	A	6	1	7	0	0	7	0	0
14	21873230	rs192710775	C	T	16	9	25	0	1	26	0	0
14	21875487	rs7147024	T	C	6	5	11	0	0	11	0	0
14	21927638	rs4981372	T	C	53	49	102	0	0	102	0	0
14	21928338	rs1045812	C	T	47	50	97	0	2	99	0	0
14	21928383	rs1045811	T	C	43	36	79	0	1	80	0	0
14	21928397	rs28927672	A	G	47	32	79	0	2	81	0	0
14	21928398	rs56310285	T	C	47	33	80	0	1	81	0	0
14	21928485	rs61973205	A	G	38	23	61	0	1	62	0	0
14	21931955	rs11848193	T	A	1	7	8	0	0	8	0	0
14	21934603	rs56267245	G	A	6	2	8	0	0	8	0	0
14	21939302	rs7157640	A	G	4	3	7	0	1	8	0	0
14	21939621	rs7157563	C	G	7	4	11	0	0	11	0	0
14	21940730	rs6571844	T	A	2	4	6	0	0	6	0	0
14	21940854	rs6571845	G	A	6	3	9	0	0	9	0	0
14	21940886	rs6571846	C	T	9	3	12	0	0	12	0	0
14	21941214	rs181863754	A	G	4	2	6	0	0	6	0	0
14	21942279	rs7141654	G	A	3	5	8	0	0	8	0	0
14	21945415	rs2282046	A	G	49	31	80	0	1	81	0	0
14	21955356	rs2297093	C	T	3	3	6	0	0	6	0	0
14	21955930	rs1061031	G	A	46	49	95	0	1	96	0	0
14	21960816	rs1060722	T	C	164	212	376	0	3	379	0	0
14	21960969	rs7617	G	A	168	228	396	0	2	398	0	0
14	21963809	rs933192	C	A	5	11	16	0	0	16	0	0
14	21965677	rs3929984	G	T	57	28	85	0	4	89	0	0
14	21967438	rs3168880	G	A	10	11	21	0	0	21	0	0
14	21967916	rs1139130	A	G	33	30	63	0	0	63	0	0
14	21969672	rs1263791	A	T	6	1	7	0	0	7	0	0
14	21970379	rs1263793	A	G	3	5	8	0	0	8	0	0
14	21970410	rs966602	A	G	7	6	13	0	0	13	0	0
14	21970810	rs74034930	T	C	8	4	12	0	0	12	0	0
14	21971729	rs2242526	C	G	19	9	28	0	0	28	0	0
14	21972840	rs536023136	A	G	9	1	10	0	0	10	0	0
14	21972988	rs12884313	G	C	6	3	9	0	0	9	0	0
14	21973313	rs35856604	A	T	7	2	9	0	0	9	0	0
14	21977076	rs10450907	C	G	6	8	14	0	0	14	0	0
14	21977092	rs1263799	C	A	5	8	13	0	0	13	0	0
14	21977672	rs1754626	G	T	15	7	22	0	0	22	0	0
14	21978262	rs17106871	T	C	11	8	19	0	0	19	0	0
14	21978752	rs17106876	A	G	12	8	20	0	0	20	0	0
14	21978884	rs1263801	G	C	33	21	54	0	1	55	0	0
14	23020638	rs15795	T	C	45	31	76	0	2	78	0	0
14	23020921	rs3701	G	C	10	22	32	0	0	32	0	0
14	23021039	rs9125	G	A	3	8	11	0	1	12	0	0
14	23033990	rs1803479	T	C	997	850	1847	0	8	1855	0	0
14	23034026	rs14752	C	G	977	934	1911	0	8	1919	0	0
14	23035339	rs5742864	G	A	2	4	6	0	0	6	0	0
14	23039115	rs5742833	C	A	3	3	6	0	0	6	0	0
14	23040793	rs5742818	A	G	2	22	24	0	1	25	0	0
14	23040810	rs5742817	A	G	3	24	27	0	0	27	0	0
14	23044004	rs1051154	C	T	877	785	1662	0	14	1676	0	0
14	23068419	rs1483980	C	T	5	3	8	0	0	8	0	0
14	23069853	rs970348	A	G	7	1	8	0	0	8	0	0
14	23074881	rs17120310	T	C	7	4	11	0	0	11	0	0
14	23282449	rs1805059	C	T	6	2	8	0	0	8	0	0
14	23284572	rs2281677	A	G	1	5	6	0	0	6	0	0
14	23299135	rs1135641	G	T	149	143	292	0	3	295	0	0
14	23300515	rs56300357	C	A	2	4	6	0	0	6	0	0
14	23300771	rs55648471	A	G	9	4	13	0	0	13	0	0
14	23300796	rs17122934	A	T	9	3	12	0	0	12	0	0
14	23301945	rs58429310	G	A	6	3	9	0	0	9	0	0
14	23315331	rs743257	T	C	11	6	17	0	0	17	0	0
14	23349953	rs35956093	A	G	22	17	39	0	1	40	0	0
14	23369994	rs1043207	G	A	15	9	24	0	0	24	0	0
14	23371268	rs56708790	A	G	89	81	170	0	0	170	0	0
14	23372913	rs12437151	G	A	4	3	7	0	0	7	0	0
14	23374435	rs2295680	G	A	61	93	154	0	1	155	0	0
14	23374862	rs2295682	C	T	59	37	96	0	1	97	0	0
14	23375251	rs8015121	A	G	3	7	10	0	0	10	0	0
14	23386280	rs11157927	T	C	5	1	6	0	0	6	0	0
14	23386682	rs3794452	T	G	10	6	16	0	0	16	0	0
14	23386875	rs3794453	A	T	22	6	28	0	0	28	0	0
14	23387585	rs34344888	A	G	6	5	11	0	0	11	0	0
14	23387609	rs55898715	T	A	4	4	8	0	0	8	0	0
14	23387628	rs34917191	T	C	8	6	14	0	1	15	0	0
14	23388326	rs1951119	A	C	44	51	95	0	1	96	0	0
14	23400059	rs7155857	C	A	6	0	6	0	0	6	0	0
14	23426182	rs2273626	C	A	89	78	167	0	1	168	0	0
14	23456315	rs1043675	T	C	7	1	8	0	0	8	0	0
14	23528236	.	G	A	474	375	849	0	7	856	0	0
14	23529410	rs2012588	T	A	8	2	10	0	0	10	0	0
14	23530622	rs60168438	T	C	243	219	462	0	5	467	0	0
14	23531758	rs45466096	G	A	8	9	17	0	0	17	0	0
14	23532477	rs55993812	G	T	9	5	14	0	0	14	0	0
14	23532535	rs78674032	G	A	12	4	16	0	0	16	0	0
14	23532577	rs75499906	C	T	10	3	13	0	0	13	0	0
14	23533758	rs113181706	G	A	8	7	15	0	0	15	0	0
14	23533874	rs56186012	A	G	14	6	20	0	0	20	0	0
14	23537082	rs45608732	G	A	142	148	290	0	4	294	0	0
14	23539133	rs8006767	C	T	4	2	6	0	0	6	0	0
14	23541441	rs55833875	C	A	5	3	8	0	0	8	0	0
14	23542399	rs75568395	T	C	2	5	7	0	0	7	0	0
14	23546870	rs76260171	G	A	2	7	9	0	0	9	0	0
14	23549319	rs1885097	A	G	97	102	199	0	2	201	0	0
14	23549380	rs1885098	G	A	96	88	184	0	2	186	0	0
14	23549785	rs3811182	T	C	106	82	188	0	1	189	0	0
14	23565012	rs8003631	C	T	25	10	35	0	0	35	0	0
14	23565603	rs2331832	C	T	2	4	6	0	0	6	0	0
14	23567761	rs1059379	A	G	7	6	13	0	0	13	0	0
14	23567774	rs6736	T	A	6	5	11	0	0	11	0	0
14	23587555	rs1474920	G	T	8	4	12	0	0	12	0	0
14	23767084	rs113316623	C	T	4	3	7	0	0	7	0	0
14	23779877	rs3210043	C	A	9	17	26	0	1	27	0	0
14	23789955	rs34074573	A	G	2	6	8	0	0	8	0	0
14	23792416	rs45508899	A	C	6	11	17	0	0	17	0	0
14	23793305	rs45528934	C	T	31	23	54	0	1	55	0	0
14	23944010	.	G	T	3	3	6	0	0	6	0	0
14	23945849	rs185131159	A	G	8	4	12	0	0	12	0	0
14	24025340	rs28403575	C	T	1	6	7	0	0	7	0	0
14	24032091	rs2281679	G	C	8	3	11	0	1	12	0	0
14	24033027	rs12897422	G	A	64	86	150	0	0	150	0	0
14	24408954	rs1885811	A	G	4	7	11	0	0	11	0	0
14	24422995	rs4457918	T	G	35	19	54	0	2	56	0	0
14	24423007	rs17099455	G	A	48	21	69	0	1	70	0	0
14	24423090	rs2273944	A	G	58	28	86	0	0	86	0	0
14	24424367	rs12147221	G	A	39	18	57	0	0	57	0	0
14	24429194	rs79275197	T	C	52	6	58	0	0	58	0	0
14	24438189	rs4706	C	A	75	61	136	0	2	138	0	0
14	24458162	rs2273946	G	C	28	32	60	0	0	60	0	0
14	24475318	rs75949238	C	A	83	52	135	0	0	136	1	0
14	24529260	rs58283036	C	T	4	5	9	0	0	9	0	0
14	24532673	rs73603047	A	G	4	7	11	0	0	11	0	0
14	24533539	rs10146906	C	A	3	3	6	0	0	6	0	0
14	24550224	rs3561	C	T	5	7	12	0	0	12	0	0
14	24587639	rs3825584	G	A	85	75	160	0	4	164	0	0
14	24587667	rs17101367	C	T	74	55	129	0	6	136	1	0
14	24591892	rs2277483	A	G	7	5	12	0	0	12	0	0
14	24591918	rs762093	G	C	7	7	14	0	0	14	0	0
14	24593980	rs8009511	G	A	37	39	76	0	0	76	0	0
14	24594114	rs1134334	A	G	37	49	86	0	0	86	0	0
14	24594213	rs1134340	C	T	53	41	94	0	0	94	0	0
14	24609534	rs10873178	T	G	2	7	9	0	0	9	0	0
14	24610733	rs2236352	T	C	8	3	11	0	0	11	0	0
14	24615435	rs4575	T	C	331	238	569	0	2	571	0	0
14	24617238	rs2273913	C	T	31	42	73	0	0	73	0	0
14	24619143	.	C	T	3	3	6	0	0	6	0	0
14	24628111	.	G	A	3	5	8	0	0	8	0	0
14	24647814	rs1885711	T	C	146	52	198	0	0	198	0	0
14	24647957	rs1885710	C	T	9	6	15	0	0	15	0	0
14	24651784	.	C	T	2	4	6	0	0	6	0	0
14	24654489	rs2025258	T	C	61	48	109	0	1	110	0	0
14	24657936	rs114902352	G	A	13	28	41	0	0	41	0	0
14	24660323	rs3742504	A	G	7	5	12	0	0	12	0	0
14	24664609	rs2234100	T	C	6	6	12	0	0	12	0	0
14	24671444	rs2748541	A	G	6	4	10	0	0	10	0	0
14	24673121	rs1242019	A	G	5	4	9	0	1	10	0	0
14	24679877	rs2295322	C	T	139	94	233	0	0	233	0	0
14	24704471	rs12891162	C	A	4	4	8	0	0	8	0	0
14	24704507	.	G	C	4	4	8	0	0	8	0	0
14	24704889	.	A	G	7	6	13	0	0	13	0	0
14	24707845	.	A	G	159	146	305	0	1	307	1	0
14	24735130	rs6573651	A	G	2	4	6	0	0	6	0	0
14	24735264	.	C	T	2	5	7	0	0	7	0	0
14	24735688	rs34973999	C	T	55	75	130	0	3	133	0	0
14	24736027	rs14193	G	A	65	79	144	0	0	144	0	0
14	24736961	rs729421	T	C	55	63	118	0	1	120	1	0
14	24737203	rs941502	A	T	10	4	14	0	0	14	0	0
14	24782958	rs2224123	T	A	3	9	12	0	0	12	0	0
14	24783414	rs2224122	G	C	5	8	13	0	0	13	0	0
14	24786060	rs1046587	G	A	3	3	6	0	0	6	0	0
14	24786293	rs4981503	T	G	6	1	7	0	0	7	0	0
14	24786976	rs3181384	T	C	12	10	22	0	0	22	0	0
14	24805824	rs3181251	C	T	4	4	8	0	0	8	0	0
14	24806800	rs1950501	G	C	11	7	18	0	0	18	0	0
14	24808168	rs3181248	G	A	3	3	6	0	0	6	0	0
14	24843620	rs2295298	T	C	4	5	9	0	0	9	0	0
14	24845841	rs7149586	T	C	5	4	9	0	0	9	0	0
14	24846961	rs10362	G	T	10	9	19	0	0	19	0	0
14	24877161	rs146351794	A	G	3	7	10	0	0	10	0	0
14	24883887	rs8017377	G	A	12	16	28	0	1	29	0	0
14	24885606	rs17103672	A	G	16	7	23	0	0	23	0	0
14	24888335	rs14076	T	C	29	25	54	0	0	54	0	0
14	24904154	rs10134603	A	G	5	11	16	0	0	16	0	0
14	24904602	rs10145542	G	A	4	5	9	0	0	9	0	0
14	25288513	rs872978	C	T	3	5	8	0	0	8	0	0
14	31085525	rs45475495	G	A	25	19	44	0	0	44	0	0
14	31188832	rs2273519	G	A	3	3	6	0	0	6	0	0
14	31188833	rs2273518	G	A	3	3	6	0	0	6	0	0
14	31863299	.	A	G	2	5	7	0	0	7	0	0
14	32625144	.	T	C	6	14	20	0	0	20	0	0
14	32626805	rs7152756	T	A	4	6	10	0	0	10	0	0
14	34985506	rs7766	G	C	377	353	730	0	5	735	0	0
14	34987129	rs8005596	C	T	1	8	9	0	0	9	0	0
14	34988067	rs12589576	C	A	4	2	6	0	0	6	0	0
14	35032112	rs13826	C	T	166	144	310	0	0	310	0	0
14	35033292	rs28515732	G	A	6	4	10	0	0	10	0	0
14	35036598	rs149986885	C	T	2	5	7	0	0	7	0	0
14	35038628	rs12050294	T	G	4	5	9	0	0	9	0	0
14	35062312	rs12432539	C	T	170	189	359	0	4	363	0	0
14	35180033	rs9491	C	A	4	17	21	0	0	21	0	0
14	35180389	rs712301	T	A	33	30	63	0	0	63	0	0
14	35181146	rs11539496	A	G	24	21	45	0	1	46	0	0
14	35181786	rs9789	T	C	45	73	118	0	0	118	0	0
14	35222623	rs3742371	T	C	35	40	75	0	0	75	0	0
14	35260347	.	G	T	4	2	6	0	0	6	0	0
14	35263983	rs17102745	T	C	126	127	253	0	3	256	0	0
14	35343629	rs2145031	A	C	21	19	40	0	0	40	0	0
14	35345352	rs1950770	G	A	11	8	19	0	0	19	0	0
14	35433187	rs2273154	C	T	8	3	11	0	1	12	0	0
14	35452257	rs12891473	T	C	4	7	11	0	0	11	0	0
14	35497285	rs78609489	T	C	5	6	11	0	0	11	0	0
14	35498443	rs28577270	G	A	26	26	52	0	0	52	0	0
14	35498485	rs11540758	C	T	25	25	50	0	0	50	0	0
14	35515096	rs3809448	C	T	5	4	9	0	1	10	0	0
14	35515327	rs45447399	C	G	3	4	7	0	0	7	0	0
14	35515920	rs2295103	C	G	34	25	59	0	0	59	0	0
14	35528227	rs112726660	C	T	11	7	18	0	0	18	0	0
14	35552396	rs76897719	T	A	1	7	8	0	0	8	0	0
14	35569721	rs2415258	G	C	3	3	6	0	0	6	0	0
14	35570606	rs78124218	G	A	3	3	6	0	0	6	0	0
14	35581432	rs8020370	G	A	7	3	10	0	0	10	0	0
14	35581480	rs8021414	T	A	5	1	6	0	0	6	0	0
14	35582138	rs12879871	A	G	2	6	8	0	0	8	0	0
14	35591174	rs1056879	T	C	37	51	88	0	1	89	0	0
14	35591726	rs2236167	T	C	5	5	10	0	0	10	0	0
14	35761675	rs1048990	C	G	477	435	912	0	7	920	1	0
14	35762991	rs78426265	A	T	10	6	16	0	0	16	0	0
14	35783073	rs116910767	G	A	7	4	11	0	0	11	0	0
14	35871093	rs696	C	T	1994	1935	3929	0	30	3960	1	0
14	35871217	rs8904	G	A	2173	2254	4427	0	29	4456	0	0
14	35871407	rs1022714	A	G	50	30	80	0	1	81	0	0
14	35873770	rs1957106	G	A	912	930	1842	0	12	1854	0	0
14	39594216	.	T	C	17	19	36	0	0	36	0	0
14	39685539	rs7140164	A	G	6	0	6	0	1	7	0	0
14	39735104	rs12587713	G	C	11	14	25	0	0	25	0	0
14	39777676	rs1950952	G	C	47	51	98	0	0	98	0	0
14	39793554	rs6571920	G	A	3	4	7	0	0	7	0	0
14	39793656	rs10137052	A	G	3	3	6	0	0	6	0	0
14	39793661	rs10137352	G	C	3	3	6	0	0	6	0	0
14	39793824	rs11157059	T	A	2	4	6	0	0	6	0	0
14	39794432	rs72645017	A	C	3	3	6	0	0	6	0	0
14	39794496	rs12897272	A	G	5	3	8	0	0	8	0	0
14	39794622	rs56126634	T	A	3	4	7	0	1	8	0	0
14	39794778	rs11625027	A	G	1	7	8	0	0	8	0	0
14	39794811	rs10140553	C	T	3	5	8	0	0	8	0	0
14	39795169	rs7144848	C	T	9	9	18	0	1	19	0	0
14	39819734	rs8177	T	G	26	21	47	0	0	47	0	0
14	39868646	rs3814860	C	A	96	70	166	0	4	170	0	0
14	45650900	rs78211950	A	G	4	8	12	0	0	12	0	0
14	45665468	rs3736772	C	G	5	8	13	0	0	13	0	0
14	45675772	rs111894327	T	G	18	15	33	0	0	33	0	0
14	45676778	rs10143794	T	C	15	25	40	0	1	41	0	0
14	45680004	rs78482006	C	A	4	2	6	0	0	6	0	0
14	45692145	rs17115912	G	A	5	1	6	0	0	6	0	0
14	45692315	rs73350255	C	T	3	3	6	0	0	6	0	0
14	45692754	rs76251356	G	A	3	3	6	0	0	6	0	0
14	45692763	rs8010456	G	A	3	3	6	0	0	6	0	0
14	45696037	rs34101857	T	G	77	97	174	0	3	177	0	0
14	45711594	rs1266209	T	C	46	37	83	0	2	85	0	0
14	50044392	rs2883438	T	C	68	71	139	0	0	139	0	0
14	50051496	rs10139832	T	A	6	7	13	0	0	13	0	0
14	50051565	rs10150624	A	G	2	5	7	0	0	7	0	0
14	50051751	rs10150823	C	T	8	8	16	0	0	16	0	0
14	50051819	rs11629047	G	C	8	17	25	0	0	25	0	0
14	50052097	rs11621094	A	C	7	9	16	0	1	17	0	0
14	50065359	rs2281837	C	G	4	6	10	0	1	11	0	0
14	50065717	rs2281836	G	C	46	31	77	0	1	78	0	0
14	50066796	rs28405032	T	A	7	6	13	0	1	14	0	0
14	50067605	rs4127814	C	T	12	11	23	0	0	23	0	0
14	50086563	rs3007030	C	T	4	6	10	0	0	10	0	0
14	50087753	rs7519	T	C	41	27	68	0	1	69	0	0
14	50092471	rs9989177	T	C	16	16	32	0	1	33	0	0
14	50098896	rs1952012	T	A	5	9	14	0	0	14	0	0
14	50100386	rs2985687	T	C	77	77	154	0	2	156	0	0
14	50100683	rs2985686	C	G	6	4	10	0	0	10	0	0
14	50101370	rs2985685	G	A	7	4	11	0	0	11	0	0
14	50101682	rs2985684	C	G	7	6	13	0	0	13	0	0
14	50234633	rs8012683	C	G	2	6	8	0	1	9	0	0
14	50252408	rs559576779	C	T	12	10	22	0	0	22	0	0
14	50575411	rs1044754	A	G	50	39	89	0	0	89	0	0
14	50575808	rs10844	T	C	54	38	92	0	1	93	0	0
14	50575839	rs10150798	T	C	46	30	76	0	0	76	0	0
14	50577617	rs2355667	T	G	4	2	6	0	0	6	0	0
14	50579651	rs12896684	A	C	24	5	29	0	0	29	0	0
14	50580135	rs2883739	C	T	19	19	38	0	0	38	0	0
14	50580213	rs4243566	T	A	20	14	34	0	1	35	0	0
14	50581716	rs2144577	C	T	8	5	13	0	0	13	0	0
14	50582118	rs4536369	C	T	8	2	10	0	0	10	0	0
14	50582321	rs12895760	G	A	9	3	12	0	0	12	0	0
14	50582395	rs147471403	T	C	3	19	22	0	0	22	0	0
14	50610731	rs7147367	G	A	3	3	6	0	0	6	0	0
14	50616878	rs2229869	G	A	51	60	111	0	3	114	0	0
14	50769717	rs2297995	G	A	6	8	14	0	0	14	0	0
14	50778816	rs2275591	A	C	6	5	11	0	0	11	0	0
14	50786662	rs3825574	C	T	4	2	6	0	0	6	0	0
14	50788213	rs2275592	C	T	49	41	90	0	0	90	0	0
14	50793814	rs7147718	G	A	9	13	22	0	0	22	0	0
14	50901768	rs17780143	G	A	47	53	100	0	0	100	0	0
14	50927900	.	C	T	6	2	8	0	0	8	0	0
14	51188124	rs4534750	G	A	54	41	95	0	1	96	0	0
14	51188341	rs10140023	A	G	51	65	116	0	0	116	0	0
14	51188754	rs45558232	C	T	62	64	126	0	0	126	0	0
14	51191676	rs2984270	C	T	37	31	68	0	5	73	0	0
14	51193213	rs2984272	A	T	14	17	31	0	0	31	0	0
14	51204996	rs11376	C	T	208	220	428	0	1	429	0	0
14	51359935	rs9671422	C	A	0	32	32	0	0	32	0	0
14	51360053	rs9671339	T	A	0	32	32	0	0	32	0	0
14	51367328	rs73284788	C	T	2	4	6	0	0	6	0	0
14	51370849	rs7154732	T	C	4	18	22	0	0	22	0	0
14	51387782	rs946616	C	T	270	197	467	0	3	470	0	0
14	51388969	rs10140858	A	G	9	9	18	0	0	18	0	0
14	51389086	rs1953875	G	A	6	8	14	0	0	14	0	0
14	51389307	rs12878997	C	T	8	3	11	0	0	11	0	0
14	51389918	rs8005400	G	A	10	11	21	0	0	21	0	0
14	51390132	rs8020787	T	A	146	88	234	0	1	235	0	0
14	51390173	rs55943056	T	C	235	114	349	0	4	353	0	0
14	51390840	rs41317304	C	T	12	17	29	0	0	29	0	0
14	51392833	rs1953873	T	C	7	8	15	0	0	15	0	0
14	51392849	rs1953872	A	G	6	7	13	0	0	13	0	0
14	51393929	rs10149867	T	C	2	4	6	0	0	6	0	0
14	51394480	rs8022952	C	T	5	3	8	0	0	8	0	0
14	51394918	rs3783275	T	C	10	3	13	0	0	13	0	0
14	51394991	rs3783274	T	C	4	3	7	0	1	8	0	0
14	51395205	rs3825541	T	C	7	6	13	0	0	13	0	0
14	51395384	rs11845307	T	G	5	6	11	0	0	11	0	0
14	51396381	rs11850411	G	A	2	6	8	0	0	8	0	0
14	51396384	rs11846533	T	C	1	6	7	0	0	7	0	0
14	51396508	rs11846565	T	C	6	7	13	0	0	13	0	0
14	51397065	rs11851482	G	A	4	4	8	0	0	8	0	0
14	51397071	rs11851406	A	G	4	4	8	0	0	8	0	0
14	51397394	rs74051859	A	C	2	4	6	0	0	6	0	0
14	51397399	rs74051860	T	C	2	4	6	0	0	6	0	0
14	51408152	rs17123232	C	G	12	7	19	0	1	20	0	0
14	51408834	rs17123235	A	T	6	6	12	0	0	12	0	0
14	51410178	rs8014291	T	G	3	11	14	0	0	14	0	0
14	51410596	rs74051873	T	C	13	9	22	0	0	22	0	0
14	51410969	rs77316189	G	A	220	188	408	0	6	414	0	0
14	51720626	.	C	A	3	4	7	0	0	7	0	0
14	52457777	rs1253678	G	A	7	10	17	0	0	17	0	0
14	52470228	rs1056352	G	C	6	8	14	0	0	14	0	0
14	52470519	rs560019909	T	A	9	3	12	0	0	12	0	0
14	52470532	rs545434094	T	A	9	3	12	0	0	12	0	0
14	52470889	rs1151574	A	G	11	4	15	0	0	15	0	0
14	52472868	rs74049324	C	T	2	5	7	0	0	7	0	0
14	52473729	rs2029984	A	G	3	4	7	0	0	7	0	0
14	52474721	rs1476284	C	T	6	6	12	0	0	12	0	0
14	52476539	rs61971548	G	T	7	8	15	0	0	15	0	0
14	52477059	rs4901177	A	G	3	9	12	0	1	13	0	0
14	52478541	rs61971549	A	G	5	5	10	0	0	10	0	0
14	52478669	rs61971550	T	G	3	3	6	0	0	6	0	0
14	52479077	rs55979603	G	A	4	4	8	0	0	8	0	0
14	52794900	rs45461592	A	T	62	58	120	0	2	122	0	0
14	52897619	rs11039	T	G	14	18	32	0	0	32	0	0
14	54941733	rs1134761	T	A	59	62	121	0	0	121	0	0
14	55323450	rs1952437	C	T	30	40	70	0	2	72	0	0
14	55527546	rs77387716	C	G	20	19	39	0	0	39	0	0
14	55604935	rs4644	C	A	186	145	331	0	6	337	0	0
14	55605036	rs4652	A	C	258	206	464	0	16	480	0	0
14	55619311	rs15870	A	G	8	10	18	0	1	19	0	0
14	55737832	rs2880103	A	C	5	2	7	0	1	8	0	0
14	55738018	rs56166765	T	C	4	3	7	0	0	7	0	0
14	55738907	rs7146752	A	G	2	5	7	0	1	8	0	0
14	55765402	rs61210954	T	C	5	1	6	0	0	6	0	0
14	55817708	rs10144418	T	C	55	41	96	0	1	97	0	0
14	55818517	rs1045002	T	A	71	55	126	0	2	128	0	0
14	55818706	rs3742569	T	C	60	68	128	0	1	129	0	0
14	55833874	rs1572611	T	A	96	82	178	0	1	179	0	0
14	55834351	rs3783648	A	G	42	34	76	0	0	76	0	0
14	55834410	rs3783649	G	A	63	43	106	0	1	107	0	0
14	55835227	rs11626751	T	C	32	21	53	0	0	53	0	0
14	55836773	rs10136596	A	G	2	7	9	0	0	9	0	0
14	55845185	rs10137307	T	C	4	4	8	0	0	8	0	0
14	55846850	rs7161439	C	T	6	1	7	0	0	7	0	0
14	55864130	rs8003279	A	G	32	21	53	0	0	53	0	0
14	56078739	rs1138345	T	G	15	16	31	0	0	31	0	0
14	56103882	rs10483647	A	G	7	3	10	0	0	10	0	0
14	56584561	rs1046596	T	C	6	4	10	0	0	10	0	0
14	56584625	rs1046597	G	A	3	3	6	0	0	6	0	0
14	56654212	rs77682274	A	C	0	7	7	0	0	7	0	0
14	56654705	rs4901642	A	T	17	4	21	0	0	21	0	0
14	56655013	rs3844020	T	G	6	3	9	0	0	9	0	0
14	56700438	rs77744109	G	A	3	4	7	0	0	7	0	0
14	56758690	rs3783683	G	A	1	6	7	0	0	7	0	0
14	56765746	rs1152467	A	G	38	28	66	0	0	66	0	0
14	56766094	rs8018553	T	G	23	38	61	0	2	63	0	0
14	57048044	rs12884831	G	A	4	2	6	0	0	6	0	0
14	57052511	rs3737171	G	T	3	3	6	0	0	6	0	0
14	57075920	rs17776256	G	T	3	3	6	0	0	6	0	0
14	57099859	rs1041316	G	A	6	3	9	0	0	9	0	0
14	57115583	.	G	A	5	5	10	0	0	10	0	0
14	57670959	rs4612984	T	C	5	2	7	0	0	7	0	0
14	57672715	rs3742578	C	T	4	7	11	0	0	11	0	0
14	57672871	rs7141911	A	G	5	7	12	0	1	13	0	0
14	57674867	rs10137379	T	C	8	10	18	0	0	18	0	0
14	57675185	rs10150771	C	T	29	32	61	0	0	61	0	0
14	57860386	rs4901778	A	T	5	2	7	0	0	7	0	0
14	57860547	rs4901779	C	A	16	19	35	0	0	35	0	0
14	57860688	rs1057737	A	G	15	17	32	0	0	32	0	0
14	57876265	rs11620639	G	A	77	70	147	0	2	149	0	0
14	57876575	rs11625443	T	C	69	67	136	0	0	136	0	0
14	57876842	rs3825621	T	C	38	35	73	0	1	74	0	0
14	58699629	rs28697080	G	A	5	2	7	0	0	7	0	0
14	58701880	rs10134112	C	T	7	5	12	0	0	12	0	0
14	58729762	rs2004312	G	A	5	1	6	0	0	6	0	0
14	58732748	rs12892257	G	A	59	79	138	0	4	142	0	0
14	58733845	rs61975956	G	A	21	16	37	0	0	37	0	0
14	58733854	rs7161678	G	A	12	18	30	0	0	30	0	0
14	58736517	rs116912810	G	A	19	7	26	0	0	26	0	0
14	58740480	rs10145652	C	A	5	3	8	0	0	8	0	0
14	58762413	rs28637941	C	A	56	59	115	0	1	116	0	0
14	58813514	rs112901448	C	T	3	3	6	0	0	6	0	0
14	58819463	rs17094474	G	C	9	5	14	0	0	14	0	0
14	58830582	rs8004706	T	C	12	8	20	0	1	21	0	0
14	58838668	rs1051860	A	G	168	151	319	0	3	322	0	0
14	58838701	rs1051861	C	T	164	157	321	0	1	322	0	0
14	58839339	rs8014077	A	C	53	40	93	0	1	94	0	0
14	58876645	rs147817538	A	G	5	3	8	0	0	8	0	0
14	58914419	rs1743728	G	A	4	3	7	0	0	7	0	0
14	59010649	rs28535751	T	C	2	8	10	0	0	10	0	0
14	59114399	rs116646724	T	A	4	5	9	0	0	9	0	0
14	59114447	rs17833004	C	T	3	3	6	0	0	6	0	0
14	59261651	rs10483703	G	A	15	0	15	0	1	16	0	0
14	59835972	rs3742647	A	C	2	5	7	0	0	7	0	0
14	59939727	rs8660	T	C	16	6	22	0	0	22	0	0
14	59941578	rs1271741	A	G	3	3	6	0	0	6	0	0
14	59942365	rs1272909	C	T	4	2	6	0	0	6	0	0
14	59950417	rs1268584	T	G	6	2	8	0	0	8	0	0
14	59951278	rs10140007	T	C	20	17	37	0	0	37	0	0
14	59953379	rs1253109	A	T	5	2	7	0	0	7	0	0
14	59969219	rs4901928	A	G	3	4	7	0	0	7	0	0
14	59970176	rs7145491	C	T	3	3	6	0	0	6	0	0
14	59971611	rs11545225	A	G	6	7	13	0	0	13	0	0
14	60864583	rs1254293	G	T	8	0	8	0	0	8	0	0
14	61997226	rs1088680	C	T	6	7	13	0	0	13	0	0
14	63839870	rs12587233	T	C	8	7	15	0	1	16	0	0
14	63840466	rs1986032	A	G	12	7	19	0	0	19	0	0
14	63841891	rs3742624	A	G	76	69	145	0	0	145	0	0
14	63842235	rs28366791	T	C	57	40	97	0	0	97	0	0
14	63861806	rs3783744	A	G	6	1	7	0	0	7	0	0
14	64009866	rs189374035	C	T	13	13	26	0	0	26	0	0
14	64637147	rs7161192	C	A	1	8	9	0	0	9	0	0
14	64656855	rs2256191	T	C	4	3	7	0	0	7	0	0
14	64692630	rs1152582	G	C	9	6	15	0	0	15	0	0
14	65205465	rs72724477	G	C	39	53	92	0	0	92	0	0
14	65210269	.	C	T	98	102	200	0	3	203	0	0
14	65210927	rs72724480	T	C	39	19	58	0	1	59	0	0
14	65467581	rs61596817	G	A	1	6	7	0	0	7	0	0
14	65467874	rs59414553	C	T	12	9	21	0	1	22	0	0
14	65469201	rs113356602	C	T	11	7	18	0	0	18	0	0
14	65469620	.	C	G	11	13	24	0	0	24	0	0
14	65470831	rs12587546	A	G	24	33	57	0	0	57	0	0
14	65471920	rs72728236	G	A	9	17	26	0	0	26	0	0
14	65505645	rs55918235	T	C	2	4	6	0	0	6	0	0
14	65513835	rs55771504	T	C	5	2	7	0	0	7	0	0
14	66028065	rs45549535	G	A	15	10	25	0	1	26	0	0
14	67804758	.	T	G	6	3	9	0	0	9	0	0
14	68059834	rs12897715	A	G	12	12	24	0	2	26	0	0
14	68060033	rs34767169	T	C	9	15	24	0	0	24	0	0
14	68060375	rs2038490	C	T	20	20	40	0	0	40	0	0
14	68113293	rs742869	G	A	4	6	10	0	0	10	0	0
14	68116324	rs8015333	A	G	8	12	20	0	0	20	0	0
14	68142443	rs7150436	C	T	4	3	7	0	0	7	0	0
14	68156842	rs55790812	A	G	2	4	6	0	0	6	0	0
14	68213792	rs1044126	A	G	15	9	24	0	0	24	0	0
14	68214788	rs12879105	T	C	12	12	24	0	0	24	0	0
14	68249499	rs2235967	C	T	7	8	15	0	1	16	0	0
14	68264867	rs12891164	A	G	7	2	9	0	0	9	0	0
14	69255644	.	A	C	6	11	17	0	1	18	0	0
14	69255652	.	G	T	5	11	16	0	1	17	0	0
14	69255660	.	G	C	4	9	13	0	0	13	0	0
14	69344290	rs72733506	T	G	15	12	27	0	0	27	0	0
14	69346014	rs77149924	G	A	5	1	6	0	0	6	0	0
14	69347632	rs36039812	C	T	107	121	228	0	4	232	0	0
14	69353909	rs181472	C	T	33	16	49	0	0	49	0	0
14	69354062	rs113318356	A	G	15	27	42	0	0	42	0	0
14	69354541	rs7145390	G	A	14	12	26	0	1	27	0	0
14	69354651	rs181475	G	A	10	19	29	0	0	29	0	0
14	69354660	rs181476	T	G	9	19	28	0	0	28	0	0
14	69354701	rs140998374	G	A	29	7	36	0	0	36	0	0
14	69354871	rs181478	T	G	3	15	18	0	1	19	0	0
14	69355193	rs147533250	G	A	14	6	20	0	0	20	0	0
14	69355492	rs112096640	G	C	7	11	18	0	0	18	0	0
14	69355747	rs117836393	G	A	8	3	11	0	0	11	0	0
14	69356080	rs117952285	T	A	4	6	10	0	0	10	0	0
14	69356095	rs77419898	A	G	4	6	10	0	0	10	0	0
14	69519324	rs114857623	T	C	73	63	136	0	0	136	0	0
14	69581898	rs7158145	C	G	2	14	16	0	1	17	0	0
14	69704553	rs8007859	G	T	5	4	9	0	0	9	0	0
14	69708241	rs1043254	G	A	7	2	9	0	0	9	0	0
14	69709373	rs3173	G	A	4	5	9	0	0	9	0	0
14	69709416	rs3174	C	T	6	3	9	0	0	9	0	0
14	69709929	rs10148349	C	T	7	2	9	0	0	9	0	0
14	69846975	rs193051508	T	C	361	324	685	0	11	696	0	0
14	69849448	rs112664252	C	T	4	3	7	0	0	7	0	0
14	69849471	rs11847666	G	T	4	3	7	0	0	7	0	0
14	69850128	rs959242	C	T	5	3	8	0	0	8	0	0
14	69851683	rs7140358	T	G	6	3	9	0	1	10	0	0
14	69928943	rs7276	A	G	38	41	79	0	0	79	0	0
14	70178337	rs945310	T	C	162	169	331	0	4	335	0	0
14	70178981	rs945309	G	A	149	161	310	0	4	314	0	0
14	70180778	.	C	G	313	296	609	0	7	616	0	0
14	70233665	rs56154784	C	T	3	4	7	0	0	7	0	0
14	70233845	rs28488181	G	A	42	37	79	0	1	80	0	0
14	70235741	rs3104	G	A	85	104	189	0	4	193	0	0
14	70236600	rs45527638	A	G	370	345	715	0	10	725	0	0
14	70352817	rs56101942	G	A	116	0	116	0	4	120	0	0
14	70641383	.	T	G	7	0	7	0	5	12	0	0
14	70745199	rs2332281	C	T	8	2	10	0	0	10	0	0
14	70793004	rs4749	A	G	91	87	178	0	17	196	1	0
14	70813286	rs12590679	C	T	6	0	6	0	0	6	0	0
14	70816896	rs11623974	C	T	7	10	17	0	0	17	0	0
14	70816936	rs74065319	C	G	8	8	16	0	0	16	0	0
14	71049388	rs10134004	T	C	8	5	13	0	0	13	0	0
14	71050983	rs17108244	A	G	23	38	61	0	0	61	0	0
14	71051233	rs7150330	T	C	61	87	148	0	3	151	0	0
14	71051816	.	C	A	12	7	19	0	0	19	0	0
14	71052108	rs2153113	C	T	10	6	16	0	0	16	0	0
14	71052127	rs2153114	C	A	11	5	16	0	0	16	0	0
14	71052798	rs17108245	C	T	5	8	13	0	0	13	0	0
14	71053607	rs79901469	T	C	12	10	22	0	0	22	0	0
14	71054384	rs8010044	T	C	4	8	12	0	0	12	0	0
14	71054736	rs149226720	G	A	7	8	15	0	0	15	0	0
14	71055086	rs150935936	T	C	8	4	12	0	0	12	0	0
14	71056632	rs61980460	T	A	6	7	13	0	0	13	0	0
14	71057782	rs115145347	C	A	4	2	6	0	0	6	0	0
14	71058454	rs189950034	T	G	5	6	11	0	0	11	0	0
14	71059255	rs1137491	A	G	8	6	14	0	1	15	0	0
14	71059312	rs1137490	T	C	11	5	16	0	0	16	0	0
14	71374702	rs2526882	G	A	252	185	437	0	4	441	0	0
14	71377295	rs2526878	A	G	4	3	7	0	0	7	0	0
14	71382687	rs35168506	C	T	9	1	10	0	0	10	0	0
14	71383848	rs2810073	T	C	173	163	336	0	1	337	0	0
14	71384885	rs2526872	C	T	5	6	11	0	0	11	0	0
14	71385582	rs12895177	G	T	3	4	7	0	0	7	0	0
14	71387648	rs2810071	A	G	12	13	25	0	1	26	0	0
14	71392732	rs17108711	G	A	6	1	7	0	0	7	0	0
14	71409614	rs2526862	T	C	3	3	6	0	0	6	0	0
14	71410805	rs10220379	G	T	2	5	7	0	0	7	0	0
14	71411878	rs2526860	T	C	2	6	8	0	0	8	0	0
14	71444788	rs3814871	G	A	16	12	28	0	0	28	0	0
14	71505328	.	T	C	6	11	17	0	0	17	0	0
14	71578741	rs221927	G	A	4	3	7	0	0	7	0	0
14	72169130	rs79937396	T	C	6	2	8	0	0	8	0	0
14	73404752	rs2302588	G	C	14	18	32	0	0	32	0	0
14	73404795	rs2302587	G	A	6	1	7	0	0	7	0	0
14	73409613	rs2333012	G	A	4	4	8	0	0	8	0	0
14	73409683	rs2240980	C	G	4	8	12	0	0	12	0	0
14	73422259	rs3815460	C	G	12	18	30	0	0	30	0	0
14	73422350	rs2806034	T	G	22	9	31	0	0	31	0	0
14	73426290	rs2572	C	T	17	7	24	0	1	25	0	0
14	73428660	rs2243596	G	A	5	4	9	0	0	9	0	0
14	73436805	rs2806028	G	C	36	33	69	0	0	69	0	0
14	73440864	rs12931	C	T	39	43	82	0	0	82	0	0
14	73448583	rs2286838	G	A	24	25	49	0	0	49	0	0
14	73459917	rs2333016	C	T	31	30	61	0	2	63	0	0
14	73463479	rs1007934	G	A	4	3	7	0	0	7	0	0
14	73464143	rs9888558	G	A	4	6	10	0	0	10	0	0
14	73465003	rs997667	A	G	14	27	41	0	0	41	0	0
14	73491307	rs3742828	C	A	25	10	35	0	0	35	0	0
14	73525265	rs2535923	A	T	13	20	33	0	2	35	0	0
14	73530678	rs8005215	T	C	12	11	23	0	0	23	0	0
14	73531688	rs74562619	T	G	9	17	26	0	0	26	0	0
14	73569475	rs1990059	A	G	58	44	102	0	0	102	0	0
14	73570656	.	T	A	4	7	11	0	2	13	0	0
14	73581011	rs362414	A	G	265	264	529	0	1	530	0	0
14	73640638	rs214269	A	G	10	6	16	0	0	16	0	0
14	73688105	.	G	A	9	12	21	0	0	21	0	0
14	73957772	.	A	G	6	6	12	0	0	12	0	0
14	73958375	rs758109	T	C	7	6	13	0	0	13	0	0
14	73958812	rs3813563	T	C	28	25	53	0	1	54	0	0
14	74178729	rs8949	G	T	74	52	126	0	0	126	0	0
14	74184917	rs60510049	A	G	56	52	108	0	0	108	0	0
14	74184939	rs4899476	A	G	44	59	103	0	4	107	0	0
14	74185596	rs9652296	C	T	9	15	24	0	0	24	0	0
14	74196581	rs11847050	G	A	60	49	109	0	1	110	0	0
14	74196686	rs2075025	T	C	53	53	106	0	1	107	0	0
14	74196792	rs8019058	T	C	12	2	14	0	0	14	0	0
14	74253818	rs35499409	C	T	13	13	26	0	0	26	0	0
14	74329567	rs112754986	C	T	3	6	9	0	0	9	0	0
14	74340797	rs11159042	A	T	7	5	12	0	0	12	0	0
14	74351488	rs8007148	G	C	2	6	8	0	0	8	0	0
14	74351791	rs113327319	A	G	2	4	6	0	0	6	0	0
14	74352101	rs17182670	A	C	3	4	7	0	0	7	0	0
14	74353204	rs2286426	G	T	4	7	11	0	0	11	0	0
14	74353326	rs2159177	C	T	2	7	9	0	0	9	0	0
14	74361980	rs62003714	T	C	2	5	7	0	0	7	0	0
14	74362767	rs62003715	A	G	2	4	6	0	0	6	0	0
14	74387375	rs2302121	A	T	5	9	14	0	0	14	0	0
14	74388908	rs1127392	T	C	102	137	239	0	0	239	0	0
14	74389218	rs11620776	G	A	2	4	6	0	0	6	0	0
14	74395128	rs12432077	G	C	4	2	6	0	0	6	0	0
14	74396488	rs6574153	G	C	4	2	6	0	0	6	0	0
14	74397333	rs11624247	G	C	2	5	7	0	0	7	0	0
14	74413129	rs7146634	C	G	8	9	17	0	0	17	0	0
14	74423659	rs11623965	T	C	1	5	6	0	0	6	0	0
14	74424265	rs62006131	T	C	8	3	11	0	0	11	0	0
14	74424491	rs17782310	T	C	6	2	8	0	0	8	0	0
14	74424938	rs3180946	T	C	18	16	34	0	0	34	0	0
14	74425056	rs3764859	C	A	8	9	17	0	0	17	0	0
14	74428445	rs8500	G	A	43	34	77	0	0	77	0	0
14	74430447	rs1029704	C	T	16	7	23	0	0	23	0	0
14	74431191	rs3742815	A	G	7	7	14	0	0	14	0	0
14	74432162	rs7156320	T	C	6	5	11	0	0	11	0	0
14	74432265	rs7155210	C	A	2	9	11	0	0	11	0	0
14	74432430	rs4140924	A	G	8	2	10	0	0	10	0	0
14	74433552	rs13743	A	T	4	3	7	0	0	7	0	0
14	74441684	rs2074932	G	A	16	5	21	0	0	21	0	0
14	74454813	rs2302117	C	A	2	6	8	0	0	8	0	0
14	74454819	rs12434581	T	A	6	2	8	0	0	8	0	0
14	74514674	rs3784038	A	T	7	3	10	0	0	10	0	0
14	74666977	rs1972562	A	G	6	4	10	0	0	10	0	0
14	74752902	rs2466	A	C	37	42	79	0	0	79	0	0
14	76640510	rs35949653	A	T	26	37	63	0	1	64	0	0
14	76640818	rs72727863	C	T	38	10	48	0	1	49	0	0
14	76668649	.	G	A	36	26	62	0	0	62	0	0
14	76669309	rs4903385	C	A	17	30	47	0	0	47	0	0
14	76670036	rs3742758	G	A	30	27	57	0	0	57	0	0
14	76670781	rs10873287	C	T	38	37	75	0	0	75	0	0
14	76670897	rs60179226	G	A	18	13	31	0	0	31	0	0
14	76671951	rs749074	A	G	22	26	48	0	0	48	0	0
14	76671961	rs72727893	G	T	21	18	39	0	0	39	0	0
14	76672054	rs72727894	A	C	16	19	35	0	1	36	0	0
14	76672150	.	C	T	17	21	38	0	4	42	0	0
14	76673283	rs72727896	A	G	9	7	16	0	0	16	0	0
14	76673359	rs72727897	T	C	14	7	21	0	0	21	0	0
14	76674617	rs12587317	C	T	4	2	6	0	0	6	0	0
14	76674681	rs58250330	T	C	6	4	10	0	0	10	0	0
14	76674773	rs12589946	T	C	6	6	12	0	0	12	0	0
14	76675374	rs59387534	G	C	7	8	15	0	0	15	0	0
14	76675452	rs2121074	A	G	4	7	11	0	0	11	0	0
14	76676827	rs8005754	T	C	7	14	21	0	0	21	0	0
14	76677057	rs1947085	T	C	13	14	27	0	0	27	0	0
14	77236380	rs3815550	C	T	7	3	10	0	1	11	0	0
14	77245537	.	C	T	4	2	6	0	0	6	0	0
14	77246758	rs2280796	C	T	5	2	7	0	0	7	0	0
14	77254836	rs2242624	A	C	8	9	17	0	0	17	0	0
14	77492891	rs879027	G	A	37	45	82	0	0	82	0	0
14	77493788	.	C	T	1	7	8	0	0	8	0	0
14	77494682	rs12897921	G	A	25	34	59	0	3	62	0	0
14	77723185	rs383459	C	T	5	2	7	0	0	7	0	0
14	77723259	rs429443	G	C	5	1	6	0	0	6	0	0
14	77736153	.	C	G	19	0	19	0	5	24	0	0
14	77736154	.	C	G	22	0	22	0	2	24	0	0
14	77736155	.	C	A	19	0	19	0	5	24	0	0
14	77743644	rs1055592	G	A	12	11	23	0	0	23	0	0
14	77793207	rs7975	G	A	10	13	23	0	0	23	0	0
14	77801431	rs6637	T	C	20	27	47	0	0	47	0	0
14	77801654	rs6636	G	C	51	54	105	0	2	107	0	0
14	77843353	rs10141317	G	T	1	5	6	0	0	6	0	0
14	77902238	rs148698913	G	A	19	13	32	0	0	32	0	0
14	77923905	.	A	G	6	5	11	0	0	11	0	0
14	77931223	rs17824322	C	T	3	4	7	0	0	7	0	0
14	77932823	rs3783985	T	C	3	3	6	0	0	6	0	0
14	77933141	rs17751370	G	A	4	4	8	0	0	8	0	0
14	77933162	rs79229447	G	A	4	4	8	0	0	8	0	0
14	77934297	.	G	A	4	5	9	0	0	9	0	0
14	77935659	rs11539461	G	A	94	105	199	0	1	200	0	0
14	77974990	rs1063271	C	T	21	22	43	0	0	43	0	0
14	77975103	rs1063270	T	G	15	15	30	0	1	31	0	0
14	77976325	rs11159269	T	C	5	9	14	0	0	14	0	0
14	77976450	rs17824567	T	G	8	8	16	0	0	16	0	0
14	77976468	rs45493395	T	C	7	7	14	0	0	14	0	0
14	77976972	rs45480297	C	G	6	7	13	0	1	14	0	0
14	77977493	rs17751562	A	G	4	9	13	0	0	13	0	0
14	77979110	rs117457686	G	A	1	5	6	0	0	6	0	0
14	77985352	rs28419564	A	C	6	6	12	0	0	12	0	0
14	77987958	rs2072672	C	A	72	66	138	0	1	139	0	0
14	77988648	rs2299910	G	A	29	21	50	0	0	50	0	0
14	77989637	rs2178875	A	T	80	45	125	0	0	125	0	0
14	77989783	rs77644804	G	A	85	110	195	0	1	196	0	0
14	77989826	rs2142183	G	C	109	79	188	0	0	188	0	0
14	77991049	rs58883103	G	C	64	33	97	0	1	98	0	0
14	77991106	rs10147810	C	T	39	61	100	0	0	100	0	0
14	77991359	rs12436428	G	A	15	18	33	0	1	34	0	0
14	77991369	rs56276583	T	A	20	15	35	0	0	35	0	0
14	77991672	rs28771140	C	T	28	32	60	0	1	61	0	0
14	77993033	rs7144024	C	T	4	2	6	0	0	6	0	0
14	77993060	rs7145386	T	C	3	3	6	0	0	6	0	0
14	77993590	rs10131773	C	T	9	13	22	0	0	22	0	0
14	77994375	rs55732483	C	A	17	7	24	0	0	24	0	0
14	77994873	rs28393685	C	G	3	5	8	0	1	9	0	0
14	77995020	rs28584839	A	G	9	5	14	0	0	14	0	0
14	77995174	rs8019658	T	C	20	18	38	0	2	40	0	0
14	77995298	rs151190833	C	A	8	17	25	0	0	25	0	0
14	77995592	.	T	A	7	8	15	0	3	18	0	0
14	77995599	.	T	C	10	8	18	0	1	19	0	0
14	77995601	.	T	C	13	6	19	0	2	21	0	0
14	77996115	rs28417590	G	A	18	11	29	0	0	29	0	0
14	77997058	rs28677959	T	C	20	8	28	0	0	28	0	0
14	77997204	rs28719093	T	C	7	12	19	0	0	19	0	0
14	77999781	rs9323645	C	T	9	6	15	0	1	16	0	0
14	78000278	rs56192928	G	A	7	9	16	0	0	16	0	0
14	78000889	rs8018049	C	T	5	1	6	0	0	6	0	0
14	78001300	.	C	T	51	33	84	0	2	86	0	0
14	78001692	rs75989864	C	T	67	66	133	0	0	133	0	0
14	78002223	rs28628767	G	A	64	70	134	0	1	135	0	0
14	78017152	rs10151907	C	G	4	2	6	0	0	6	0	0
14	78039286	rs146055839	C	T	3	5	8	0	0	8	0	0
14	78039971	rs117271004	C	A	6	10	16	0	0	16	0	0
14	78040434	rs61990793	A	G	9	9	18	0	1	19	0	0
14	78041174	rs11621931	G	T	9	5	14	0	0	14	0	0
14	78060031	rs2364603	C	T	4	10	14	0	0	14	0	0
14	78062414	rs2037931	T	C	27	18	45	0	0	45	0	0
14	78062994	rs34278364	C	T	33	18	51	0	1	52	0	0
14	78080668	rs2267750	A	C	7	9	16	0	0	16	0	0
14	78080746	rs2267751	A	G	2	4	6	0	0	6	0	0
14	78080749	rs8021200	C	T	2	4	6	0	0	6	0	0
14	78080804	rs176904	A	G	4	2	6	0	0	6	0	0
14	78080832	rs8021376	C	A	7	3	10	0	0	10	0	0
14	78080845	rs2267754	A	C	6	3	9	0	1	10	0	0
14	78081302	rs176905	A	G	4	4	8	0	0	8	0	0
14	78140329	rs6493	G	A	11	13	24	0	2	26	0	0
14	78140355	rs6494	T	A	12	12	24	0	2	26	0	0
14	78140527	.	C	T	10	14	24	0	1	25	0	0
14	78174473	rs11159286	A	C	139	122	261	0	5	266	0	0
14	78177115	rs76566741	T	C	2	4	6	0	0	6	0	0
14	78178129	rs56339806	T	C	3	3	6	0	0	6	0	0
14	78179084	rs117506698	C	T	4	3	7	0	0	7	0	0
14	78179104	rs176948	C	T	3	5	8	0	0	8	0	0
14	78179192	rs176949	C	A	3	4	7	0	0	7	0	0
14	78181205	rs72685293	A	G	4	2	6	0	0	6	0	0
14	78181704	rs176956	T	C	4	3	7	0	0	7	0	0
14	78182940	rs149524083	G	A	6	2	8	0	0	8	0	0
14	78182960	rs176958	G	C	3	5	8	0	0	8	0	0
14	78183706	rs176959	C	T	6	4	10	0	0	10	0	0
14	78184661	rs17825620	T	G	27	21	48	0	1	49	0	0
14	78185461	rs79381682	G	A	5	1	6	0	0	6	0	0
14	78186969	rs45465691	C	G	2	4	6	0	0	6	0	0
14	78187740	rs72685302	C	T	2	4	6	0	0	6	0	0
14	78197365	rs114763	C	T	259	239	498	0	8	506	0	0
14	78203636	rs11622293	T	C	6	10	16	0	0	16	0	0
14	78227126	.	C	T	1	7	8	0	0	8	0	0
14	78390880	rs2302944	T	C	3	4	7	0	0	7	0	0
14	81251255	rs327463	T	C	4	3	7	0	0	7	0	0
14	81360750	rs10141970	C	T	6	1	7	0	0	7	0	0
14	81360958	rs2288347	C	T	4	2	6	0	0	6	0	0
14	81405846	rs3742722	C	A	12	8	20	0	1	21	0	0
14	81643692	rs12878339	A	C	12	3	15	0	0	15	0	0
14	81675420	rs2099108	C	G	2	4	6	0	0	6	0	0
14	81686319	rs10149681	G	A	8	4	12	0	0	12	0	0
14	81729897	.	A	C	8	2	10	0	0	10	0	0
14	81732976	rs12889291	G	C	6	11	17	0	0	17	0	0
14	81733964	rs12894596	A	G	8	6	14	0	1	15	0	0
14	81735001	rs11625861	T	C	3	6	9	0	0	9	0	0
14	81737076	rs2241621	A	C	28	40	68	0	0	68	0	0
14	81830400	rs58532062	T	C	2	4	6	0	0	6	0	0
14	81859994	rs4089876	A	T	3	4	7	0	0	7	0	0
14	81860917	rs61986599	G	A	9	4	13	0	0	13	0	0
14	81864618	rs17551467	G	C	33	31	64	0	0	64	0	0
14	81941413	rs3208229	A	G	13	12	25	0	0	25	0	0
14	81942261	rs12435937	T	C	14	7	21	0	0	21	0	0
14	88399488	rs17198	A	C	35	54	89	0	1	90	0	0
14	88399623	rs405567	T	C	86	62	148	0	5	153	0	0
14	88399801	rs1042042	C	T	32	23	55	0	0	55	0	0
14	88400353	rs412915	C	T	27	23	50	0	1	51	0	0
14	88400450	rs432946	G	A	16	5	21	0	0	21	0	0
14	88400486	rs1042029	A	G	4	14	18	0	0	18	0	0
14	88407888	rs398607	A	G	36	34	70	0	1	71	0	0
14	88414211	rs398076	G	A	31	28	59	0	0	59	0	0
14	88431898	rs12888666	C	T	33	45	78	0	1	79	0	0
14	88471562	rs10139328	T	C	34	38	72	0	2	74	0	0
14	88472672	rs6574977	A	G	8	1	9	0	0	9	0	0
14	88475921	rs35355673	G	A	6	1	7	0	0	7	0	0
14	88477413	rs6574978	C	T	42	44	86	0	1	87	0	0
14	89871495	rs3825665	T	A	3	3	6	0	0	6	0	0
14	89873853	rs12431798	T	C	4	2	6	0	0	6	0	0
14	89883137	rs71415423	A	T	5	3	8	0	0	8	0	0
14	89884022	rs7422	A	C	6	11	17	0	1	18	0	0
14	90431172	rs117708351	A	G	5	2	7	0	0	7	0	0
14	90730943	rs2282031	T	C	7	5	12	0	0	12	0	0
14	90733890	rs115667214	A	G	15	16	31	0	1	32	0	0
14	90734378	rs2236402	G	C	31	16	47	0	0	47	0	0
14	90736477	rs114316342	C	T	16	21	37	0	1	38	0	0
14	90744546	rs45471798	C	T	4	7	11	0	0	11	0	0
14	90744981	rs79334826	G	A	5	2	7	0	0	7	0	0
14	90745974	rs72699170	G	T	5	2	7	0	0	7	0	0
14	90745975	rs72699171	C	T	5	2	7	0	0	7	0	0
14	90746112	rs74485471	G	A	5	2	7	0	0	7	0	0
14	90747488	rs4559843	T	C	4	2	6	0	0	6	0	0
14	90749638	rs59905513	T	C	5	1	6	0	0	6	0	0
14	90752754	rs116980182	G	A	6	8	14	0	1	15	0	0
14	90756760	rs3742671	A	T	18	9	27	0	0	27	0	0
14	90767607	rs3825661	C	T	22	6	28	0	0	28	0	0
14	90768183	rs8020828	C	T	5	2	7	0	0	7	0	0
14	90863870	rs12886752	C	T	3	3	6	0	0	6	0	0
14	90864848	rs2300496	C	A	13	19	32	0	0	32	0	0
14	90865627	rs41304357	T	C	11	8	19	0	0	19	0	0
14	90865717	rs2300500	G	C	16	13	29	0	0	29	0	0
14	90866346	rs2268433	C	T	22	20	42	0	0	42	0	0
14	90869110	rs9646173	C	T	8	10	18	0	0	18	0	0
14	90869913	rs3213718	C	T	19	8	27	0	1	28	0	0
14	90873412	rs3179089	C	G	90	87	177	0	1	178	0	0
14	91123844	rs3742658	C	T	7	1	8	0	0	8	0	0
14	91153818	rs12893238	A	G	6	4	10	0	0	10	0	0
14	91153864	rs76324158	G	C	8	5	13	0	0	13	0	0
14	91161862	rs10146731	C	T	42	51	93	0	0	93	0	0
14	91239235	rs720925	A	G	21	28	49	0	1	50	0	0
14	91385651	rs2145958	A	T	4	2	6	0	0	6	0	0
14	91404688	rs1286119	T	C	18	23	41	0	2	43	0	0
14	91435705	rs3783832	C	T	3	5	8	0	0	8	0	0
14	91436255	rs7153641	C	T	4	4	8	0	0	8	0	0
14	91691471	rs6562	G	A	45	55	100	0	2	102	0	0
14	91738577	rs11624871	A	G	58	53	111	0	1	112	0	0
14	91738696	rs12878426	T	G	45	52	97	0	3	100	0	0
14	91739081	rs941920	A	G	31	31	62	0	2	64	0	0
14	91751986	rs76612086	A	G	21	23	44	0	1	45	0	0
14	91845133	rs1046311	A	G	5	2	7	0	0	7	0	0
14	91883129	rs45437097	G	A	20	21	41	0	1	42	0	0
14	91926079	rs71428759	T	G	3	4	7	0	0	7	0	0
14	91928908	rs17224453	C	G	11	2	13	0	0	13	0	0
14	91935534	rs12896490	C	T	8	2	10	0	0	10	0	0
14	91948043	rs17127374	T	C	154	150	304	0	2	306	0	0
14	92268647	.	C	G	15	10	25	0	1	26	0	0
14	92530459	.	C	A	16	16	32	0	1	33	0	0
14	92980256	rs368389701	C	A	13	9	22	0	2	24	0	0
14	93111106	rs553741340	C	T	4	5	9	0	0	9	0	0
14	93111120	rs11624512	C	T	5	5	10	0	0	10	0	0
14	93111167	rs67910622	C	T	2	4	6	0	0	6	0	0
14	93118229	rs117068593	C	T	27	47	74	0	8	82	0	0
14	93118668	rs3742717	C	T	299	200	499	0	10	509	0	0
14	93119407	rs3818321	C	T	415	285	700	0	1	701	0	0
14	93121381	rs80010211	G	A	10	8	18	0	0	18	0	0
14	93123549	rs2402174	G	A	14	19	33	0	0	33	0	0
14	93127174	rs58006834	A	T	5	4	9	0	0	9	0	0
14	93127411	rs12896830	G	A	11	5	16	0	0	16	0	0
14	93127422	rs57407935	C	G	12	5	17	0	0	17	0	0
14	93128103	.	C	A	13	8	21	0	1	22	0	0
14	93129070	rs10134607	G	A	7	11	18	0	0	18	0	0
14	93131795	rs10047925	C	T	5	5	10	0	0	10	0	0
14	93131973	rs9672040	A	G	7	2	9	0	0	9	0	0
14	93132299	rs12895078	G	C	4	4	8	0	0	8	0	0
14	93132938	rs4904971	T	G	4	4	8	0	0	8	0	0
14	93133120	rs59124998	C	T	15	7	22	0	0	22	0	0
14	93133731	rs61992632	G	A	1	5	6	0	0	6	0	0
14	93152137	rs12887391	A	C	59	44	103	0	1	104	0	0
14	93153412	rs61994063	G	A	50	34	84	0	3	87	0	0
14	93153538	rs2402184	A	G	20	42	62	0	3	65	0	0
14	93406702	rs3814828	A	G	112	105	217	0	1	218	0	0
14	93406789	rs1043547	G	T	138	109	247	0	6	253	0	0
14	93407062	rs1043542	A	G	85	90	175	0	2	177	0	0
14	93407248	rs11446	A	G	102	95	197	0	1	198	0	0
14	93407301	rs13316	C	A	82	81	163	0	1	164	0	0
14	93407481	rs11160096	T	C	109	111	220	0	0	220	0	0
14	93407486	rs12588550	C	T	114	107	221	0	2	223	0	0
14	93407535	rs3742711	G	A	96	102	198	0	1	200	1	0
14	93407771	rs7140970	G	A	43	40	83	0	0	83	0	0
14	93649383	rs15837	C	T	158	115	273	0	0	273	0	0
14	93649501	rs1046099	A	G	159	169	328	0	2	330	0	0
14	93684444	rs10143050	A	C	4	2	6	0	0	6	0	0
14	93693422	rs2905	C	T	40	47	87	0	0	87	0	0
14	93693831	rs11621915	C	T	72	71	143	0	3	146	0	0
14	93705124	rs1044780	T	C	5	4	9	0	0	9	0	0
14	93706243	rs11622582	G	A	9	3	12	0	0	12	0	0
14	93706555	rs8013451	T	C	2	4	6	0	0	6	0	0
14	93754437	rs12587394	A	G	12	6	18	0	1	19	0	0
14	93788250	rs2402277	G	A	6	5	11	0	1	12	0	0
14	93788740	rs12435488	T	C	4	2	6	0	0	6	0	0
14	93789660	rs12889579	G	A	2	6	8	0	0	8	0	0
14	93790276	rs3783890	T	C	10	14	24	0	1	25	0	0
14	93799221	rs2273640	G	A	5	10	15	0	0	15	0	0
14	94563265	rs79237142	C	T	125	97	222	0	2	224	0	0
14	94856914	rs8004738	G	A	49	59	108	0	2	110	0	0
14	95554142	rs1057035	T	C	7	10	17	0	0	17	0	0
14	95874508	rs1047403	C	G	6	2	8	0	0	8	0	0
14	95884323	rs12434757	G	A	7	10	17	0	0	17	0	0
14	95912388	rs61749972	G	A	0	9	9	0	0	9	0	0
14	95921741	rs4905324	C	T	5	12	17	0	0	17	0	0
14	95923670	rs2024863	A	C	6	4	10	0	0	10	0	0
14	96009748	rs10484052	A	G	5	12	17	0	0	17	0	0
14	96010424	rs11628901	G	A	402	331	733	0	4	737	0	0
14	96708716	rs2069589	G	A	0	6	6	0	0	6	0	0
14	96747960	rs146028187	G	A	8	7	15	0	0	15	0	0
14	96747986	rs10134160	T	C	7	7	14	0	0	14	0	0
14	96748288	rs7150025	T	G	10	11	21	0	0	21	0	0
14	96748610	rs7150634	T	C	5	7	12	0	0	12	0	0
14	96748876	rs3809420	T	C	4	8	12	0	0	12	0	0
14	96748991	rs3809421	A	G	8	9	17	0	0	17	0	0
14	96749381	rs4900321	A	T	3	4	7	0	0	7	0	0
14	96749759	rs3742476	G	A	11	5	16	0	0	16	0	0
14	96749846	rs3742475	T	C	5	3	8	0	0	8	0	0
14	96751010	rs8019013	T	C	5	1	6	0	0	6	0	0
14	96820342	rs72704901	T	C	2	5	7	0	0	7	0	0
14	96820446	rs12147175	G	A	16	11	27	0	0	27	0	0
14	96820777	rs12147185	G	A	57	44	101	0	0	101	0	0
14	96821049	rs77574609	T	C	32	31	63	0	0	63	0	0
14	96821396	rs11160333	C	T	29	37	66	0	1	67	0	0
14	96823739	rs72704902	C	T	8	7	15	0	0	15	0	0
14	96829850	rs35941406	G	T	6	1	7	0	0	7	0	0
14	96830391	.	G	A	20	9	29	0	0	29	0	0
14	96852071	rs1545280	T	C	13	28	41	0	1	42	0	0
14	96993995	rs7146883	A	G	7	4	11	0	0	11	0	0
14	96994682	rs2274795	T	C	3	4	7	0	0	7	0	0
14	96996268	rs78401219	T	G	2	4	6	0	0	6	0	0
14	96998484	rs58057794	C	T	6	8	14	0	0	14	0	0
14	96998641	rs185780744	G	T	6	7	13	0	0	13	0	0
14	96998643	rs45581934	G	T	6	7	13	0	0	13	0	0
14	96999153	rs79971494	A	T	17	7	24	0	0	24	0	0
14	96999675	rs80332203	C	T	9	7	16	0	1	17	0	0
14	97000340	rs17094149	G	T	15	11	26	0	0	26	0	0
14	97000479	rs75845012	G	A	15	12	27	0	0	27	0	0
14	97003767	rs1484251	A	G	5	9	14	0	0	14	0	0
14	97030550	rs10136277	T	A	4	3	7	0	0	7	0	0
14	97347056	rs8013300	G	C	2	4	6	0	0	6	0	0
14	99439543	rs1257620	A	G	1	33	34	0	2	37	1	0
14	99876216	rs2943	G	A	18	17	35	0	1	36	0	0
14	99876505	rs1047351	A	G	54	33	87	0	0	87	0	0
14	99924036	rs941554	G	A	13	3	16	0	0	16	0	0
14	99932341	rs2144798	A	C	9	12	21	0	1	22	0	0
14	99933825	rs3809412	C	T	9	7	16	0	0	16	0	0
14	99934161	rs1884526	T	C	3	14	17	0	0	17	0	0
14	99935261	rs11621155	A	G	4	6	10	0	0	10	0	0
14	99936258	rs8011670	G	A	3	4	7	0	0	7	0	0
14	99938225	rs941552	T	C	3	3	6	0	0	6	0	0
14	99938340	rs8023115	G	A	3	3	6	0	0	6	0	0
14	99948357	rs3918038	C	G	3	6	9	0	0	9	0	0
14	99948585	rs1950598	A	G	5	4	9	0	0	9	0	0
14	99954084	rs3918051	A	G	7	6	13	0	0	13	0	0
14	99954792	rs61984133	T	A	7	4	11	0	0	11	0	0
14	99956916	rs3918056	A	G	4	5	9	0	0	9	0	0
14	99957703	rs2400677	T	C	18	12	30	0	0	30	0	0
14	99957927	rs2400678	T	A	19	12	31	0	0	31	0	0
14	99971294	rs3918094	C	T	19	8	27	0	1	28	0	0
14	99978981	.	C	T	16	19	35	0	0	35	0	0
14	99980087	rs1998050	C	G	10	9	19	0	0	19	0	0
14	99981105	rs3742374	G	C	9	9	18	0	0	18	0	0
14	100563943	rs3206354	G	A	67	58	125	0	0	125	0	0
14	100607360	rs1951486	T	C	4	4	8	0	0	8	0	0
14	100739180	rs61992953	A	C	2	5	7	0	0	7	0	0
14	100739397	rs61992954	G	C	2	4	6	0	0	6	0	0
14	100740904	rs4905942	G	C	3	4	7	0	0	7	0	0
14	100741182	rs115934889	G	T	11	7	18	0	0	18	0	0
14	100742658	rs28470843	T	C	11	9	20	0	0	20	0	0
14	100748543	rs61992959	C	T	127	93	220	0	1	221	0	0
14	100748623	rs1042897	C	A	97	75	172	0	10	182	0	0
14	100748790	rs61993676	T	A	119	141	260	0	3	263	0	0
14	100748994	rs11427	A	G	99	103	202	0	2	204	0	0
14	100759046	rs3825555	C	A	12	10	22	0	0	22	0	0
14	100759277	rs3742379	C	T	12	11	23	0	0	23	0	0
14	100760422	rs117267874	C	A	5	4	9	0	0	9	0	0
14	100762503	rs12431901	G	T	4	3	7	0	0	7	0	0
14	100763369	rs72711990	A	G	3	4	7	0	0	7	0	0
14	100764318	rs55663005	T	G	3	3	6	0	0	6	0	0
14	100771483	rs12432201	T	C	3	4	7	0	0	7	0	0
14	100808845	rs9453	G	A	172	70	242	0	2	245	1	0
14	100820536	rs3783345	A	G	9	7	16	0	0	16	0	0
14	100841700	rs7143006	A	T	8	20	28	0	0	28	0	0
14	100842637	rs2273804	C	G	13	14	27	0	1	28	0	0
14	100996312	rs13065	T	C	8	10	18	0	0	18	0	0
14	101195522	rs117667438	C	T	0	9	9	0	0	9	0	0
14	101200645	rs1802710	T	C	0	687	687	0	6	693	0	0
14	101204203	rs876374	C	A	12	0	12	0	0	12	0	0
14	101204319	rs876375	A	G	15	0	15	0	1	16	0	0
14	101296084	rs183426957	C	G	0	65	65	0	2	67	0	0
14	101296662	rs35458454	T	C	0	22	22	0	0	22	0	0
14	101297454	rs35431412	T	C	0	44	44	0	1	45	0	0
14	101297515	rs10147988	A	G	0	49	49	0	0	49	0	0
14	101297963	rs3087918	T	G	0	30	30	0	0	30	0	0
14	101298031	rs3087917	A	G	0	29	29	0	0	29	0	0
14	101299959	rs12897172	C	A	0	37	37	0	0	37	0	0
14	101299960	rs12878222	T	C	0	37	37	0	0	37	0	0
14	101300273	rs1884540	C	T	0	45	45	0	1	46	0	0
14	101300567	rs2400941	C	G	44	0	44	0	1	45	0	0
14	101301012	rs10132552	T	C	0	43	43	0	0	43	0	0
14	101301038	rs3194464	C	G	50	0	50	0	0	50	0	0
14	101301261	rs11160606	C	T	0	56	56	0	1	57	0	0
14	101301438	rs1950628	C	T	0	35	35	0	0	35	0	0
14	101301837	rs4906021	C	T	0	62	62	0	0	62	0	0
14	101302086	rs4906022	C	T	0	143	143	0	1	144	0	0
14	101302295	rs4378559	C	T	0	65	65	0	0	65	0	0
14	101302305	rs12890215	T	C	0	59	59	0	0	59	0	0
14	101587557	rs12879192	G	A	126	73	199	0	4	203	0	0
14	101587629	rs72702946	C	T	3	10	13	0	0	13	0	0
14	102392140	.	C	G	33	31	64	0	2	66	0	0
14	102452670	.	C	T	21	24	45	0	0	45	0	0
14	102463407	rs12893215	A	G	30	38	68	0	2	70	0	0
14	102484565	rs7148324	T	C	16	7	23	0	1	24	0	0
14	102493761	rs8010870	A	G	101	81	182	0	0	182	0	0
14	102495144	rs4906174	A	G	5	1	6	0	0	6	0	0
14	102504333	rs17541491	C	G	20	13	33	0	0	33	0	0
14	102504838	rs17541505	C	T	132	141	273	0	0	273	0	0
14	102507065	rs17541540	G	C	4	2	6	0	0	6	0	0
14	102509953	rs1190605	G	C	5	9	14	0	1	15	0	0
14	102510863	rs17512884	G	A	4	18	22	0	0	22	0	0
14	102510874	rs2273440	G	A	4	17	21	0	0	21	0	0
14	102511597	rs1190607	A	G	3	16	19	0	1	20	0	0
14	102512157	rs4534770	T	C	13	9	22	0	0	22	0	0
14	102513044	rs34509705	C	G	8	14	22	0	1	23	0	0
14	102513086	rs11160668	G	A	18	8	26	0	1	27	0	0
14	102513396	rs71415871	T	A	10	17	27	0	1	29	1	0
14	102513596	rs11844113	A	G	7	18	25	0	0	25	0	0
14	102514227	rs13749	T	C	238	207	445	0	6	451	0	0
14	102514713	rs941792	G	A	6	10	16	0	0	16	0	0
14	102515015	rs1004903	G	A	6	8	14	0	1	15	0	0
14	102515171	rs1004904	A	G	9	1	10	0	0	10	0	0
14	102515504	rs10136116	G	C	11	9	20	0	1	21	0	0
14	102521309	rs8019874	T	C	3	4	7	0	0	7	0	0
14	102547105	rs1059629	A	G	16	10	26	0	0	26	0	0
14	102547218	rs1059623	G	A	129	45	174	0	1	175	0	0
14	102547602	rs11547531	A	G	1830	1755	3585	0	31	3617	1	0
14	102548224	rs2298877	T	C	35	22	57	0	1	58	0	0
14	102548384	rs6575895	C	T	40	19	59	0	0	59	0	0
14	102549231	rs10873530	C	T	34	25	59	0	0	59	0	0
14	102549262	rs10782495	A	G	34	28	62	0	0	62	0	0
14	102549839	rs7155973	A	G	14	13	27	0	1	28	0	0
14	102550569	rs3742429	G	A	9	6	15	0	0	15	0	0
14	102550803	rs4947	G	A	1162	1087	2249	0	21	2270	0	0
14	102552773	rs8004640	A	G	7	6	13	0	0	13	0	0
14	102552775	rs3736807	T	G	6	6	12	0	1	13	0	0
14	102675350	rs6575900	G	C	32	27	59	0	0	59	0	0
14	102675837	rs12888595	G	T	43	31	74	0	0	74	0	0
14	102679193	rs45511198	A	C	3	5	8	0	0	8	0	0
14	102680110	rs34907794	C	T	2	6	8	0	0	8	0	0
14	102680164	rs45443993	G	A	3	4	7	0	0	7	0	0
14	102691854	rs6575901	T	C	3	4	7	0	0	7	0	0
14	102695563	rs3087686	A	G	20	42	62	0	0	62	0	0
14	102695693	rs2236493	T	C	28	54	82	0	0	82	0	0
14	102696204	rs55889703	A	T	6	1	7	0	0	7	0	0
14	102792386	rs7158731	T	C	14	15	29	0	0	29	0	0
14	102792631	rs7158139	G	A	23	16	39	0	0	39	0	0
14	102808330	rs12590618	C	T	35	33	68	0	0	68	0	0
14	102808655	rs11704	G	C	9	10	19	0	0	19	0	0
14	102809133	rs141050487	G	A	4	4	8	0	0	8	0	0
14	102810628	rs2031233	T	C	6	8	14	0	0	14	0	0
14	102813867	rs60530409	T	G	5	2	7	0	0	7	0	0
14	102814945	rs7012	G	A	131	122	253	0	0	253	0	0
14	102965897	rs1044502	G	A	0	6	6	0	0	6	0	0
14	102974999	rs2273905	T	C	15	30	45	0	1	46	0	0
14	102975265	rs8006911	A	G	17	35	52	0	0	52	0	0
14	102975266	rs8007356	G	A	17	35	52	0	0	52	0	0
14	102975552	rs3742445	T	A	8	13	21	0	1	22	0	0
14	102975572	rs3742446	C	T	5	10	15	0	1	16	0	0
14	102975655	rs1061924	C	T	3	7	10	0	0	10	0	0
14	103060418	rs79271450	C	T	29	29	58	0	0	58	0	0
14	103060606	rs20485	C	T	28	25	53	0	0	53	0	0
14	103190362	rs11628569	A	G	4	6	10	0	1	11	0	0
14	103190843	rs59457020	A	G	5	1	6	0	0	6	0	0
14	103193028	rs2295695	G	A	81	65	146	0	2	148	0	0
14	103193336	rs75017083	C	T	66	59	125	0	1	126	0	0
14	103194560	rs45485304	A	G	89	79	168	0	0	168	0	0
14	103194998	rs8006699	A	G	96	72	168	0	1	169	0	0
14	103342015	.	C	T	54	39	93	0	1	94	0	0
14	103368976	.	G	A	5	2	7	0	0	7	0	0
14	103376828	rs4900558	G	A	4	3	7	0	0	7	0	0
14	103398034	rs6575935	A	G	4	4	8	0	0	8	0	0
14	103399448	rs4708	T	C	31	22	53	0	1	54	0	0
14	103800071	rs2281824	C	T	4	4	8	0	0	8	0	0
14	103801574	rs8021359	G	T	21	15	36	0	0	36	0	0
14	103810913	rs10289	A	G	57	55	112	0	0	112	0	0
14	103811181	rs3548	A	G	44	55	99	0	0	99	0	0
14	103852164	rs11541718	C	G	4	2	6	0	0	6	0	0
14	103900609	rs17841064	C	T	4	2	6	0	0	6	0	0
14	103900639	rs34411783	G	A	3	4	7	0	0	7	0	0
14	103900654	.	C	T	6	2	8	0	0	8	0	0
14	103910983	rs35339837	G	A	2	4	6	0	0	6	0	0
14	103929889	rs12436729	G	C	5	3	8	0	0	8	0	0
14	103930032	rs12432803	C	T	3	3	6	0	0	6	0	0
14	103969909	rs13987	A	G	38	33	71	0	0	71	0	0
14	103987078	rs2071408	G	A	17	17	34	0	2	36	0	0
14	103987140	rs2071407	T	C	22	14	36	0	2	38	0	0
14	104001517	rs2756119	G	A	24	24	48	0	0	48	0	0
14	104002234	rs7161305	G	A	35	34	69	0	1	70	0	0
14	104025893	rs35498576	T	C	51	55	106	0	0	106	0	0
14	104029449	rs2274267	G	A	52	69	121	0	2	123	0	0
14	104040473	rs71417867	A	G	86	106	192	0	3	195	0	0
14	104095701	rs1054080	A	C	5	7	12	0	0	12	0	0
14	104095769	rs3742463	G	T	7	10	17	0	0	17	0	0
14	104095922	rs3742465	T	C	20	9	29	0	0	29	0	0
14	104096031	rs61637848	C	T	15	7	22	0	0	22	0	0
14	104096558	rs11850979	T	C	16	6	22	0	0	22	0	0
14	104146361	rs4900589	A	G	4	4	8	0	0	8	0	0
14	104146421	rs4900590	C	T	6	2	8	0	0	8	0	0
14	104147377	rs11540512	C	T	5	5	10	0	0	10	0	0
14	104147886	rs4906359	T	C	2	4	6	0	0	6	0	0
14	104150352	rs35140615	G	A	4	6	10	0	0	10	0	0
14	104150360	rs7494546	C	T	6	4	10	0	0	10	0	0
14	104151400	rs35011804	C	T	7	7	14	0	0	14	0	0
14	104152352	rs8702	C	G	14	7	21	0	0	21	0	0
14	104154878	rs4900591	G	A	1	5	6	0	0	6	0	0
14	104154882	rs12586322	C	G	5	1	6	0	0	6	0	0
14	104155945	rs861545	A	G	1	6	7	0	0	7	0	0
14	104156108	rs11846404	C	G	2	7	9	0	0	9	0	0
14	104160113	rs8007701	G	A	21	25	46	0	0	46	0	0
14	104160141	rs2273175	T	C	17	20	37	0	0	37	0	0
14	104161281	rs1606	G	A	12	19	31	0	0	31	0	0
14	104162263	rs861544	G	A	23	27	50	0	0	50	0	0
14	104162376	rs3212140	C	T	6	11	17	0	0	17	0	0
14	104162994	rs3212136	G	A	35	21	56	0	0	56	0	0
14	104165927	rs1799796	T	C	11	13	24	0	1	25	0	0
14	104166783	rs3212103	A	G	12	15	27	0	0	27	0	0
14	104179267	rs1799794	T	C	14	12	26	0	0	26	0	0
14	104180444	rs2295152	C	T	9	5	14	0	0	14	0	0
14	104180735	rs3212024	G	A	6	5	11	0	0	11	0	0
14	104195610	rs2295148	T	C	3	3	6	0	0	6	0	0
14	104195664	rs2295147	C	T	5	4	9	0	0	9	0	0
14	104199356	rs2295146	C	T	10	6	16	0	0	16	0	0
14	104199580	rs8548	A	C	11	5	16	0	2	18	0	0
14	104646717	rs947000	C	T	11	12	23	0	0	23	0	0
14	104646771	rs946999	T	C	11	11	22	0	0	22	0	0
14	104646839	rs11160791	A	G	15	6	21	0	1	22	0	0
14	105156076	rs115602636	G	A	13	8	21	0	0	21	0	0
14	105162462	rs4275790	T	C	14	4	18	0	0	18	0	0
14	105162493	rs12588024	T	A	14	7	21	0	0	21	0	0
14	105162807	rs117572009	C	A	7	1	8	0	0	8	0	0
14	105167807	rs4983530	C	T	37	30	67	0	0	68	1	0
14	105168414	rs11160817	C	T	13	9	22	0	0	22	0	0
14	105168428	rs11851852	C	T	14	10	24	0	0	24	0	0
14	105168839	rs12588561	T	C	7	6	13	0	0	13	0	0
14	105171022	rs11538811	C	A	11	18	29	0	0	29	0	0
14	105180565	rs4983535	T	C	55	61	116	0	1	117	0	0
14	105180785	rs34251364	C	T	105	99	204	0	0	204	0	0
14	105185666	rs1128880	G	T	118	87	205	0	2	207	0	0
14	105213343	rs6644	A	G	21	19	40	0	1	41	0	0
14	105219529	.	C	T	25	38	63	0	2	65	0	0
14	105219976	rs12889167	T	C	4	5	9	0	0	9	0	0
14	105222037	rs1132975	C	T	361	331	692	0	6	698	0	0
14	105223457	rs12587551	C	T	12	16	28	0	1	29	0	0
14	105223525	rs12590163	T	C	16	18	34	0	0	34	0	0
14	105225979	rs1133044	C	G	19	13	32	0	0	32	0	0
14	105237680	rs2494731	G	C	8	3	11	0	0	11	0	0
14	105238604	rs2498800	C	T	4	3	7	0	0	7	0	0
14	105239894	rs1130233	C	T	133	141	274	0	29	304	1	0
14	105240784	rs2494733	C	G	5	3	8	0	0	8	0	0
14	105240885	rs2494734	C	G	3	4	7	0	0	7	0	0
14	105243735	rs367946565	G	A	2	4	6	0	0	6	0	0
14	105516226	rs12890396	C	T	3	7	10	0	0	10	0	0
14	105522201	rs7157567	C	T	4	3	7	0	0	7	0	0
14	105528212	rs7152235	T	C	4	6	10	0	0	10	0	0
14	105528273	rs7152401	T	C	4	7	11	0	0	11	0	0
14	105529530	rs35966880	A	T	4	5	9	0	0	9	0	0
14	105715515	rs2816605	C	T	7	3	10	0	0	10	0	0
14	105716034	rs2816606	C	T	34	27	61	0	1	62	0	0
14	105717279	rs4677	T	C	25	16	41	0	1	42	0	0
14	105722726	rs1008628	T	C	8	9	17	0	0	17	0	0
14	105858022	rs147461490	C	T	27	32	59	0	1	60	0	0
14	105860985	.	C	T	116	69	185	0	1	186	0	0
14	105932544	rs9671696	G	A	6	1	7	0	0	7	0	0
14	105954705	rs55633823	C	T	1094	605	1699	0	8	1708	1	0
14	105963944	rs4983426	C	T	5	1	6	0	0	6	0	0
14	105963945	rs4983427	T	C	5	1	6	0	0	6	0	0
14	105996341	rs28662250	C	G	11	1	12	0	0	12	0	0
14	106092152	rs10137020	G	A	3	3	6	0	0	6	0	0
14	106109528	rs12882905	C	T	1	7	8	0	0	8	0	0
14	106109573	rs28371022	T	C	16	4	20	0	0	20	0	0
14	106110057	rs11160859	G	A	48	12	60	0	0	60	0	0
14	106110137	rs8009156	C	T	10	64	74	0	2	76	0	0
14	106110914	rs11627594	G	T	14	42	56	0	0	56	0	0
14	106110966	rs11557955	C	T	42	7	49	0	0	49	0	0
14	106134628	rs10144455	C	G	0	19	19	0	1	20	0	0
14	106134635	.	C	G	0	14	14	0	0	14	0	0
14	106207725	rs17841089	T	C	4	3	7	0	0	7	0	0
14	106207763	rs12431749	G	A	5	3	8	0	0	8	0	0
14	106207798	.	C	T	8	4	12	0	0	12	0	0
14	106207822	.	A	G	5	22	27	0	1	28	0	0
14	106303222	rs1055855	G	C	28	9	37	0	1	38	0	0
14	106303232	rs1055854	C	T	27	8	35	0	3	38	0	0
14	106303325	rs3764172	A	G	23	12	35	0	0	35	0	0
14	106304899	rs762807	G	T	3	3	6	0	0	6	0	0
14	106305038	rs762806	T	C	5	2	7	0	0	7	0	0
14	106305039	rs762805	G	A	5	2	7	0	0	7	0	0
14	106305461	rs11622796	T	G	3	4	7	0	0	7	0	0
14	106306841	rs709589	C	T	44	13	57	0	3	60	0	0
14	106321913	rs1136534	G	A	255	378	633	0	4	637	0	0
14	106355953	rs3814949	C	A	54	20	74	0	0	74	0	0
14	106356054	rs3814947	A	G	191	67	258	0	5	263	0	0
14	106356087	rs3814946	T	G	4	14	18	0	0	18	0	0
14	106356110	rs3814945	T	G	5	14	19	0	0	19	0	0
14	106357644	rs149695294	T	C	2	4	6	0	0	6	0	0
14	106361807	rs3829431	G	A	6	3	9	0	0	9	0	0
14	106361814	rs3829432	C	T	6	3	9	0	0	9	0	0
14	106362195	rs143255385	G	A	0	8	8	0	0	8	0	0
14	106362204	rs186333947	G	C	0	9	9	0	0	9	0	0
14	106362241	rs2753534	G	A	7	0	7	0	0	7	0	0
14	106384372	rs2516947	G	A	15	5	20	0	0	20	0	0
14	106386996	rs59137576	T	C	333	166	499	0	2	501	0	0
14	106391044	rs112002895	G	A	2	6	8	0	0	8	0	0
14	106444709	rs35373150	C	G	0	22	22	0	0	22	0	0
14	106873972	rs2106003	A	G	0	7	7	0	0	7	0	0
14	106878056	rs4774113	T	G	3	5	8	0	0	8	0	0
14	106926388	.	T	C	0	6	6	0	0	6	0	0
14	107170062	rs55891010	A	G	5	1	6	0	0	6	0	0
15	20644221	.	G	A	1	7	8	0	0	8	0	0
15	22466126	rs1985064	A	C	2	6	8	0	1	9	0	0
15	22925851	rs4134802	C	T	13	5	18	0	1	19	0	0
15	22939192	rs11633474	G	A	18	14	32	0	0	32	0	0
15	22999458	.	C	T	22	23	45	0	0	45	0	0
15	23003463	rs7733	C	G	20	39	59	0	0	59	0	0
15	23016558	rs6606817	T	C	7	4	11	0	0	11	0	0
15	23022061	rs72698084	G	A	14	10	24	0	0	24	0	0
15	23026831	rs72698085	C	A	3	5	8	0	0	8	0	0
15	23034002	rs1347314	C	T	8	5	13	0	0	13	0	0
15	23282589	rs11557517	A	G	27	11	38	0	0	38	0	0
15	23282925	.	G	T	37	3	40	0	0	40	0	0
15	23283157	.	T	C	24	9	33	0	0	33	0	0
15	23283671	.	G	T	9	2	11	0	0	11	0	0
15	23283711	rs295729	A	G	10	1	11	0	0	11	0	0
15	23283942	.	C	T	6	2	8	0	1	9	0	0
15	23300033	rs1058831	T	C	15	11	26	0	0	26	0	0
15	25211613	rs2855523	T	C	0	10	10	0	0	10	0	0
15	25211810	rs2732025	G	T	0	12	12	0	0	12	0	0
15	25219512	rs705	T	C	1	352	353	0	1	354	0	0
15	25235326	rs6576398	C	G	0	15	15	0	0	15	0	0
15	25235716	rs2732029	G	A	0	16	16	0	0	16	0	0
15	25236128	rs765438	A	G	0	19	19	0	0	19	0	0
15	25324141	rs4344720	C	T	0	7	7	0	0	7	0	0
15	25364551	rs1043164	T	C	0	20	20	0	0	20	0	0
15	25579846	rs6576418	C	T	5	3	8	0	0	8	0	0
15	28356859	rs1129038	C	T	45	55	100	0	1	101	0	0
15	29061956	rs71467359	G	A	16	0	16	0	0	16	0	0
15	29347019	rs8040932	T	C	9	4	13	0	0	13	0	0
15	29394009	rs73370275	C	T	7	2	9	0	0	9	0	0
15	29395379	rs1038731	T	C	6	6	12	0	0	12	0	0
15	29395418	rs1038730	G	A	6	5	11	0	0	11	0	0
15	29396321	rs1565401	C	G	5	5	10	0	1	11	0	0
15	29397345	rs2279491	C	T	5	7	12	0	1	13	0	0
15	30778351	rs11635528	T	C	6	1	7	0	0	7	0	0
15	30781885	rs62017513	C	T	43	42	85	0	0	85	0	0
15	30899336	.	G	C	9	3	12	0	0	12	0	0
15	30900873	.	T	C	6	1	7	0	0	7	0	0
15	30900895	rs80198225	G	A	7	1	8	0	0	8	0	0
15	30909446	.	T	G	8	0	8	0	0	8	0	0
15	31060115	rs4779494	T	C	12	17	29	0	0	29	0	0
15	31063058	rs4779777	A	G	2	4	6	0	0	6	0	0
15	31117403	rs798127	T	C	5	6	11	0	0	11	0	0
15	31117842	rs7171983	C	T	5	4	9	0	0	9	0	0
15	31129037	rs11070624	G	A	9	1	10	0	0	10	0	0
15	31175269	rs8036176	C	T	3	3	6	0	0	6	0	0
15	31191687	rs28708881	C	T	6	6	12	0	0	12	0	0
15	31197564	rs4779794	G	A	13	7	20	0	0	20	0	0
15	31211323	rs2955798	C	T	6	17	23	0	0	23	0	0
15	31211886	rs2959038	T	C	7	4	11	0	1	12	0	0
15	31217553	rs185356346	C	T	8	3	11	0	0	11	0	0
15	31219742	rs2959036	T	G	27	21	48	0	0	48	0	0
15	31219788	rs2955777	A	C	22	18	40	0	1	41	0	0
15	31229420	rs2955795	T	C	21	18	39	0	1	40	0	0
15	31230078	rs2949567	T	C	9	12	21	0	0	21	0	0
15	31230611	rs34017474	T	C	6	13	19	0	1	20	0	0
15	31231255	rs2873	A	G	87	80	167	0	4	171	0	0
15	31232581	rs1043742	A	C	39	44	83	0	0	83	0	0
15	31234653	.	C	T	26	22	48	0	1	49	0	0
15	31234981	rs11293	G	A	32	54	86	0	1	87	0	0
15	31235005	rs3512	G	C	38	48	86	0	2	88	0	0
15	31235452	rs7168641	G	A	7	1	8	0	0	8	0	0
15	31236788	.	T	A	5	7	12	0	0	12	0	0
15	31237776	rs35256769	G	A	20	13	33	0	0	33	0	0
15	31238271	rs61997079	G	C	17	19	36	0	0	36	0	0
15	31238423	rs11629793	G	A	16	14	30	0	0	30	0	0
15	31238572	rs2949569	A	G	35	45	80	0	0	80	0	0
15	31238783	rs11637469	T	C	61	40	101	0	2	103	0	0
15	31239535	rs72710420	T	C	7	1	8	0	0	8	0	0
15	31240957	rs8034856	T	C	6	3	9	0	0	9	0	0
15	31242540	rs2949570	T	C	3	5	8	0	0	8	0	0
15	31243259	rs2949571	G	C	3	6	9	0	0	9	0	0
15	31244083	rs2955790	T	G	5	2	7	0	0	7	0	0
15	31262599	rs72710435	C	T	2	8	10	0	0	10	0	0
15	31262808	rs2949577	C	T	7	0	7	0	0	7	0	0
15	31263272	rs1524876	C	T	2	7	9	0	0	9	0	0
15	31263728	rs1404469	G	A	8	1	9	0	0	9	0	0
15	31267147	rs1133642	C	T	89	100	189	0	4	193	0	0
15	31665443	rs4779520	C	T	77	90	167	0	3	170	0	0
15	31667796	rs6493629	C	T	95	118	213	0	0	213	0	0
15	31668694	rs11537748	A	G	156	154	310	0	1	311	0	0
15	32445955	.	T	C	6	0	6	0	0	6	0	0
15	32450704	.	G	A	1	10	11	0	0	11	0	0
15	32685277	.	A	G	5	1	6	0	0	6	0	0
15	32713884	.	T	C	4	3	7	0	0	7	0	0
15	32898631	rs1062254	C	G	6	10	16	0	0	16	0	0
15	32930505	rs4779582	G	C	34	31	65	0	0	65	0	0
15	32931921	rs28457217	G	A	12	10	22	0	0	22	0	0
15	34158529	rs2241648	G	C	19	19	38	0	0	38	0	0
15	34168130	rs146625663	T	A	38	19	57	0	2	59	0	0
15	34388399	rs115117959	T	A	11	10	21	0	0	21	0	0
15	34390351	rs6495519	T	G	5	4	9	0	1	10	0	0
15	34393214	rs16958770	T	C	0	6	6	0	0	6	0	0
15	34501587	rs8027499	A	T	3	4	7	0	0	7	0	0
15	34501871	rs6495619	A	G	3	3	6	0	0	6	0	0
15	34634033	rs3063	A	G	690	606	1296	0	2	1298	0	0
15	34634124	rs1045238	C	G	1054	980	2034	0	9	2043	0	0
15	34634138	rs1045204	G	A	1050	924	1974	0	3	1977	0	0
15	34634139	rs1045194	T	C	1042	924	1966	0	5	1971	0	0
15	34634324	rs422388	C	G	5	3	8	0	0	8	0	0
15	34635029	rs2615357	G	T	3	4	7	0	0	7	0	0
15	34672835	rs77038074	C	T	3	54	57	0	0	57	0	0
15	34673059	rs149231939	C	T	2	50	52	0	0	52	0	0
15	34673255	.	G	A	0	12	12	0	0	12	0	0
15	34673376	rs78955581	T	G	4	36	40	0	0	40	0	0
15	34678911	.	C	G	1	13	14	0	0	14	0	0
15	34679022	.	C	T	67	8	75	0	0	75	0	0
15	34817507	rs3538	A	G	6	9	15	0	1	16	0	0
15	34817765	rs3200769	C	T	9	34	43	0	1	44	0	0
15	34818124	rs1059895	A	C	45	59	104	0	1	105	0	0
15	34818128	rs36006600	A	G	45	56	101	0	2	103	0	0
15	34818132	rs34404542	C	G	46	51	97	0	2	99	0	0
15	34818262	rs1059893	C	T	33	58	91	0	1	92	0	0
15	34818337	rs1059887	A	G	36	96	132	0	1	133	0	0
15	34818413	rs36106641	T	C	18	71	89	0	1	90	0	0
15	34819198	rs4041350	C	T	26	18	44	0	0	44	0	0
15	34856224	rs349647	A	T	4	2	6	0	0	6	0	0
15	34856729	.	T	C	6	0	6	0	0	6	0	0
15	34856806	.	G	A	5	2	7	0	0	7	0	0
15	34857214	.	C	G	4	2	6	0	0	6	0	0
15	35198879	rs80093103	G	A	20	19	39	0	0	39	0	0
15	35221638	rs113968771	G	T	35	31	66	0	0	66	0	0
15	35256624	rs9920529	C	G	3	3	6	0	0	6	0	0
15	35270996	rs7165312	C	T	16	20	36	0	0	36	0	0
15	35271144	rs78946025	T	C	14	10	24	0	0	24	0	0
15	35272702	rs10438394	G	A	19	26	45	0	0	45	0	0
15	35272883	rs11852594	C	A	24	26	50	0	0	50	0	0
15	39873284	rs1478605	G	A	0	8	8	0	0	8	0	0
15	39873321	rs1478604	T	C	19	62	81	0	2	83	0	0
15	39884667	rs45461294	G	A	5	7	12	0	0	12	0	0
15	39885301	rs2228263	T	C	217	450	667	0	4	671	0	0
15	39885533	rs17632916	A	G	4	9	13	0	0	13	0	0
15	39887649	rs1051442	C	T	210	431	641	0	3	644	0	0
15	39888246	rs41315060	C	T	221	563	784	0	8	792	0	0
15	39888281	rs17633107	A	C	200	531	731	0	7	738	0	0
15	40269052	rs34298786	G	A	7	1	8	0	0	8	0	0
15	40269333	rs7169411	T	C	3	8	11	0	0	11	0	0
15	40269501	rs4923847	C	T	2	10	12	0	0	12	0	0
15	40282701	rs2307104	T	C	3	4	7	0	0	7	0	0
15	40313141	rs3207297	C	T	71	69	140	0	1	141	0	0
15	40328292	rs4770	A	G	511	423	934	0	5	939	0	0
15	40328973	rs2291620	A	G	3	6	9	0	0	9	0	0
15	40380207	rs8116	T	A	13	16	29	0	1	30	0	0
15	40380818	rs1540686	A	G	33	34	67	0	0	67	0	0
15	40380933	rs648289	T	C	38	34	72	0	0	72	0	0
15	40383779	rs3743129	A	C	29	19	48	0	0	48	0	0
15	40545438	rs11636097	A	G	7	5	12	0	0	12	0	0
15	40564576	rs3743137	C	T	11	8	19	0	0	19	0	0
15	40565055	rs2253603	G	A	4	3	7	0	0	7	0	0
15	40568823	rs2242119	C	A	10	13	23	0	1	24	0	0
15	40569441	rs75108621	G	A	17	9	26	0	0	26	0	0
15	40593199	rs11636491	C	T	14	9	23	0	0	23	0	0
15	40618613	rs12081	G	C	182	193	375	0	3	378	0	0
15	40676997	rs7176592	C	T	2	5	7	0	0	7	0	0
15	40677038	rs7177949	T	A	2	4	6	0	0	6	0	0
15	40685850	rs11541643	A	G	15	17	32	0	2	34	0	0
15	40686087	rs11541641	T	C	27	17	44	0	0	44	0	0
15	40705225	rs2229312	C	T	36	35	71	0	0	71	0	0
15	40707456	rs875767	C	T	1	5	6	0	0	6	0	0
15	40711933	rs4923865	G	A	11	14	25	0	0	25	0	0
15	40712352	rs12185076	G	C	17	16	33	0	0	33	0	0
15	40712737	rs11790	T	C	9	9	18	0	0	18	0	0
15	40727879	rs72733450	C	A	30	13	43	0	0	43	0	0
15	40760116	rs8826	G	C	75	64	139	0	0	139	0	0
15	40764549	rs582736	G	A	16	12	28	0	1	29	0	0
15	40842275	rs921624	T	C	2	4	6	0	0	6	0	0
15	40842299	rs8025458	G	A	2	5	7	0	0	7	0	0
15	40857240	rs3803353	G	A	1	5	6	0	0	6	0	0
15	40862930	rs1453183	C	T	5	2	7	0	0	7	0	0
15	40863534	rs7167922	G	A	2	4	6	0	0	6	0	0
15	40916801	rs16970911	A	G	7	2	9	0	1	10	0	0
15	40987528	rs1801320	G	C	0	13	13	0	0	13	0	0
15	41032138	rs2304583	A	G	2	4	6	0	0	6	0	0
15	41038082	rs12372947	C	G	2	5	7	0	0	7	0	0
15	41099349	rs11070297	C	T	4	7	11	0	0	11	0	0
15	41101124	rs3743033	C	G	9	8	17	0	0	17	0	0
15	41101145	rs3743034	C	T	9	5	14	0	0	14	0	0
15	41106485	rs7915	A	C	54	49	103	0	1	104	0	0
15	41192768	rs147751220	C	T	54	48	102	0	0	102	0	0
15	41271447	rs9796	A	T	88	89	177	0	2	179	0	0
15	41282534	rs28501589	G	A	2	4	6	0	0	6	0	0
15	41564393	rs28417774	A	G	67	67	134	0	4	138	0	0
15	41572703	.	A	T	70	0	70	0	8	78	0	0
15	41573612	rs9568	C	A	279	253	532	0	2	534	0	0
15	41576241	rs11267024	C	T	41	76	117	0	0	117	0	0
15	41688732	rs35227875	C	T	7	15	22	0	0	22	0	0
15	41799711	rs4924549	C	T	14	2	16	0	0	16	0	0
15	41805237	rs2305030	C	T	1	46	47	0	0	47	0	0
15	41813951	.	C	T	9	5	14	0	0	14	0	0
15	41991315	rs2178004	A	T	11	6	17	0	0	17	0	0
15	42007520	rs6493010	C	G	7	6	13	0	0	13	0	0
15	42026764	rs1918314	C	T	3	4	7	0	0	7	0	0
15	42032383	rs17677991	C	G	5	2	7	0	0	7	0	0
15	42041712	rs2695163	G	A	4	4	8	0	0	8	0	0
15	42059521	rs2605570	A	T	3	4	7	0	1	8	0	0
15	42115019	rs34055060	C	T	5	2	7	0	0	7	0	0
15	42115747	rs3959569	G	C	35	32	67	0	1	68	0	0
15	42118123	rs3179542	G	C	23	39	62	0	1	63	0	0
15	42118971	rs3743024	A	G	26	22	48	0	0	48	0	0
15	42119593	rs4924576	C	A	22	36	58	0	0	58	0	0
15	42119603	rs4923914	C	T	23	37	60	0	0	60	0	0
15	42119606	rs4923915	C	T	20	34	54	0	4	58	0	0
15	42119711	rs2277535	G	A	23	33	56	0	1	57	0	0
15	42123747	rs149185661	G	A	4	3	7	0	0	7	0	0
15	42131770	rs16972136	C	T	2	6	8	0	1	9	0	0
15	42131965	rs57498313	A	G	5	4	9	0	0	9	0	0
15	42134930	rs1648832	G	T	1	5	6	0	0	6	0	0
15	42135541	rs1648831	G	T	4	4	8	0	0	8	0	0
15	42135579	rs191819967	G	T	1	6	7	0	0	7	0	0
15	42135988	rs1672466	C	T	15	25	40	0	0	40	0	0
15	42137576	rs1648828	C	T	4	3	7	0	0	7	0	0
15	42137581	rs1648827	A	C	4	3	7	0	0	7	0	0
15	42140166	rs1061354	G	T	30	32	62	0	0	62	0	0
15	42188549	rs1704381	A	G	3	13	16	0	0	16	0	0
15	42188591	rs1704382	G	A	5	14	19	0	0	19	0	0
15	42190069	rs1209334	T	C	5	4	9	0	1	10	0	0
15	42190196	rs1672461	C	T	5	8	13	0	0	13	0	0
15	42190989	rs1648810	T	C	7	9	16	0	0	16	0	0
15	42191067	rs7166358	C	A	4	5	9	0	0	9	0	0
15	42191348	rs11636178	C	T	9	10	19	0	0	19	0	0
15	42191519	rs11070353	G	A	6	10	16	0	0	16	0	0
15	42191909	rs1048175	C	G	62	73	135	0	2	137	0	0
15	42192040	rs1048166	T	C	51	83	134	0	1	135	0	0
15	42199780	rs28550631	C	A	4	3	7	0	0	7	0	0
15	42200895	rs34180124	T	A	13	5	18	0	0	18	0	0
15	42201339	rs1704389	A	G	4	2	6	0	0	6	0	0
15	42201421	rs9920696	G	A	6	5	11	0	0	11	0	0
15	42211486	rs1704396	A	G	32	32	64	0	0	64	0	0
15	42451108	rs7086	G	C	52	54	106	0	0	106	0	0
15	42457582	rs633483	G	A	6	6	12	0	0	12	0	0
15	42458347	rs663454	T	C	17	8	25	0	0	25	0	0
15	42459034	rs1619030	T	C	22	20	42	0	0	42	0	0
15	42483455	rs635919	C	T	5	7	12	0	0	12	0	0
15	42505176	rs1703755	C	T	3	3	6	0	0	6	0	0
15	42517500	rs2677752	G	A	3	6	9	0	1	10	0	0
15	42517502	.	G	T	6	3	9	0	1	10	0	0
15	42517791	rs1678991	C	A	8	9	17	0	0	17	0	0
15	42521188	rs1678986	G	C	4	7	11	0	1	12	0	0
15	42522010	rs1678985	T	C	7	5	12	0	0	12	0	0
15	42522792	rs10518756	G	C	4	4	8	0	0	8	0	0
15	42523171	rs1712418	A	C	2	5	7	0	0	7	0	0
15	42524399	rs1712421	G	A	10	10	20	0	0	20	0	0
15	42539302	rs9672382	T	C	5	3	8	0	1	9	0	0
15	42564369	rs4244587	C	T	7	5	12	0	0	12	0	0
15	42565588	rs2277533	C	A	41	44	85	0	3	88	0	0
15	42570718	rs8024732	A	G	9	11	20	0	0	20	0	0
15	42573067	rs8037020	C	T	4	4	8	0	0	8	0	0
15	42631928	rs36023127	T	C	7	7	14	0	0	14	0	0
15	42631976	rs35039186	G	A	9	2	11	0	0	11	0	0
15	42643529	rs7181742	T	C	4	9	13	0	0	13	0	0
15	42644746	.	A	C	5	6	11	0	0	11	0	0
15	42644790	rs76540793	G	A	4	5	9	0	1	10	0	0
15	42645344	rs75090520	G	C	10	10	20	0	0	20	0	0
15	42645768	rs3743006	G	A	5	8	13	0	0	13	0	0
15	42647200	rs76075885	G	T	3	3	6	0	0	6	0	0
15	42647962	rs112317950	T	C	5	2	7	0	0	7	0	0
15	42652099	rs1801496	T	C	4	7	11	0	0	12	1	0
15	42705464	rs12594633	A	C	102	111	213	0	1	214	0	0
15	42707843	rs1062038	G	C	36	29	65	0	0	65	0	0
15	42708005	rs1139100	A	G	24	12	36	0	0	36	0	0
15	42734320	rs61753567	C	T	33	32	65	0	0	65	0	0
15	42742435	rs34792942	T	C	33	32	65	0	0	65	0	0
15	42817896	rs58641431	G	A	3	3	6	0	0	6	0	0
15	42820589	rs1060291	G	A	100	109	209	0	2	211	0	0
15	42824476	rs73404763	A	G	87	91	178	0	1	179	0	0
15	42824578	rs11022	T	C	119	136	255	0	4	259	0	0
15	42824582	rs1060265	T	C	112	132	244	0	3	247	0	0
15	42833475	rs12906697	G	C	2	4	6	0	0	6	0	0
15	42834962	rs75705010	C	T	101	108	209	0	0	209	0	0
15	42836056	rs34359922	A	G	118	78	196	0	2	198	0	0
15	42837498	rs1060293	T	A	2	9	11	0	0	11	0	0
15	42859235	rs10851411	T	G	23	27	50	0	0	50	0	0
15	42859933	rs113194201	T	C	26	25	51	0	2	53	0	0
15	42860591	rs4924687	G	T	79	57	136	0	4	140	0	0
15	42861567	rs34643746	A	G	45	45	90	0	2	92	0	0
15	43170793	rs6493068	A	G	7	2	9	0	0	9	0	0
15	43170823	rs16957250	C	T	5	2	7	0	0	7	0	0
15	43212818	rs12437637	C	G	13	10	23	0	0	23	0	0
15	43236612	rs7178567	C	T	8	8	16	0	0	16	0	0
15	43236616	.	G	A	8	8	16	0	0	16	0	0
15	43237203	rs3803341	T	C	7	7	14	0	0	14	0	0
15	43244699	rs2277532	A	G	3	3	6	0	0	6	0	0
15	43264217	rs1381856	C	T	4	5	9	0	0	9	0	0
15	43468803	.	C	T	2	4	6	0	0	6	0	0
15	43478113	rs540587	G	C	46	38	84	0	1	85	0	0
15	43478511	rs530118	C	T	4	3	7	0	1	8	0	0
15	43479328	rs538218	C	T	3	4	7	0	0	7	0	0
15	43479363	rs2947019	T	C	4	5	9	0	0	9	0	0
15	43621947	rs3742969	A	G	3	3	6	0	0	6	0	0
15	43622265	rs3742970	C	A	4	5	9	0	0	9	0	0
15	43624189	rs1549523	C	T	10	1	11	0	0	11	0	0
15	43632549	rs2278857	T	C	17	9	26	0	0	26	0	0
15	43651256	rs935901	G	C	6	4	10	0	0	10	0	0
15	43656434	.	T	G	10	7	17	0	0	17	0	0
15	43659320	rs17780818	C	T	4	2	6	0	0	6	0	0
15	43661802	rs3809482	T	C	18	8	26	0	0	26	0	0
15	43662829	rs3809481	G	A	11	9	20	0	0	20	0	0
15	43698212	rs2444037	C	T	3	3	6	0	0	6	0	0
15	43698602	rs1837960	T	C	28	17	45	0	0	45	0	0
15	43698679	rs1837959	A	G	28	17	45	0	0	45	0	0
15	43700427	rs45585139	G	A	8	13	21	0	0	21	0	0
15	43700930	rs1058298	G	T	8	13	21	0	0	21	0	0
15	43704465	rs690263	C	G	3	6	9	0	0	9	0	0
15	43713634	rs2242069	A	C	6	8	14	0	0	15	1	0
15	43724407	.	C	T	51	40	91	0	1	92	0	0
15	43724618	.	T	C	37	32	69	0	1	70	0	0
15	43724646	rs2602141	T	G	39	42	81	0	0	81	0	0
15	43731454	rs2245908	C	G	4	3	7	0	0	7	0	0
15	43748304	rs690367	A	G	25	45	70	0	2	72	0	0
15	43748890	.	C	T	32	28	60	0	1	61	0	0
15	43762196	rs689647	C	T	21	36	57	0	1	58	0	0
15	43765533	rs2264239	C	G	14	18	32	0	0	32	0	0
15	43765978	rs2584706	T	C	7	13	20	0	0	20	0	0
15	43766025	rs2264050	G	C	7	12	19	0	0	19	0	0
15	43766069	rs2264049	T	C	16	12	28	0	0	28	0	0
15	43766303	rs526083	T	C	3	4	7	0	1	8	0	0
15	43766341	rs2264248	G	A	5	1	6	0	0	6	0	0
15	43767209	rs2251538	G	C	4	3	7	0	0	7	0	0
15	43767774	rs560191	G	C	19	38	57	0	1	58	0	0
15	43816917	rs1060939	G	A	4	2	6	0	0	6	0	0
15	43826557	rs689797	C	T	10	7	17	0	0	17	0	0
15	44038899	rs2411284	C	T	585	520	1105	0	4	1109	0	0
15	44043793	rs28718261	C	G	7	2	9	0	0	9	0	0
15	44047430	rs12908467	C	T	4	2	6	0	0	6	0	0
15	44050376	rs7168158	G	A	7	4	11	0	0	11	0	0
15	44053617	rs8040336	C	T	6	2	8	0	0	8	0	0
15	44057045	rs11070410	A	G	4	3	7	0	0	7	0	0
15	44059322	rs7170167	T	C	4	2	6	0	0	6	0	0
15	44060236	rs7175032	C	T	4	3	7	0	0	7	0	0
15	44060435	rs7169988	T	C	8	5	13	0	0	13	0	0
15	44061802	rs1053492	C	T	1027	854	1881	0	11	1892	0	0
15	44063859	rs3087657	G	A	68	67	135	0	1	136	0	0
15	44064806	rs3862142	A	C	38	36	74	0	0	74	0	0
15	44064886	rs2788	A	G	38	36	74	0	2	76	0	0
15	44093927	rs12702	T	C	316	407	723	0	1	724	0	0
15	44102010	rs2228368	A	C	41	51	92	0	1	93	0	0
15	44116053	rs28636829	C	T	5	1	6	0	0	6	0	0
15	44812420	rs150533639	C	T	11	18	29	0	0	29	0	0
15	44819581	rs2288341	C	T	11	13	24	0	0	24	0	0
15	44820363	rs74405840	G	C	7	11	18	0	0	18	0	0
15	44827257	rs60399672	A	C	13	13	26	0	2	28	0	0
15	44827523	rs61234123	C	G	18	8	26	0	0	26	0	0
15	44827663	rs116922787	T	C	15	12	27	0	0	27	0	0
15	44828723	rs17551416	G	C	4	4	8	0	0	8	0	0
15	44830371	rs75825481	G	T	12	11	23	0	0	23	0	0
15	44849698	rs2303578	G	A	171	140	311	0	4	315	0	0
15	44853572	rs148692596	T	C	204	203	407	0	2	409	0	0
15	44854785	rs2288342	A	G	75	68	143	0	0	143	0	0
15	44862930	rs2277610	G	A	4	7	11	0	0	11	0	0
15	44864894	rs35932349	C	T	8	13	21	0	0	21	0	0
15	44873558	rs8037416	A	C	3	3	6	0	0	6	0	0
15	44943797	rs3759873	T	C	21	14	35	0	0	35	0	0
15	44943798	rs3759874	G	A	21	14	35	0	0	35	0	0
15	45006618	rs2254835	A	C	13	11	24	0	0	24	0	0
15	45006673	rs2254831	T	C	13	5	18	0	0	18	0	0
15	45008694	rs17229438	G	A	129	142	271	0	0	271	0	0
15	45024889	rs14711	A	G	5	4	9	0	0	9	0	0
15	45357501	.	C	A	107	85	192	0	1	193	0	0
15	45491082	rs80131405	G	A	3	3	6	0	0	6	0	0
15	45891039	.	T	G	45	0	45	0	0	45	0	0
15	45891251	.	T	A	129	0	129	0	0	129	0	0
15	45968435	rs1044032	T	C	62	68	130	0	0	130	0	0
15	45971751	.	T	C	3	5	8	0	0	8	0	0
15	48702873	rs1042078	G	A	5	17	22	0	0	22	0	0
15	49281624	rs1054307	A	C	14	30	44	0	0	44	0	0
15	49282165	rs11542124	T	G	49	37	86	0	2	88	0	0
15	49284065	rs8033060	T	C	30	27	57	0	0	57	0	0
15	49293194	rs11854184	C	A	15	29	44	0	1	45	0	0
15	49325289	rs11638215	A	C	27	17	44	0	0	44	0	0
15	49417546	rs1048975	T	G	14	12	26	0	0	26	0	0
15	49423723	rs600863	G	T	5	2	7	0	0	7	0	0
15	49424044	rs12905094	A	G	4	2	6	0	0	6	0	0
15	49448012	rs17435932	C	A	4	3	7	0	0	7	0	0
15	49922606	rs72731116	G	A	3	3	6	0	0	6	0	0
15	49922775	rs7172906	C	G	2	4	6	0	0	6	0	0
15	49923026	rs1976551	C	G	5	10	15	0	0	15	0	0
15	50163700	rs62020396	T	C	5	2	7	0	0	7	0	0
15	50163808	rs17487348	G	A	5	1	6	0	0	6	0	0
15	50178422	rs4775845	C	T	3	4	7	0	0	7	0	0
15	50179371	rs12914231	A	G	14	7	21	0	0	21	0	0
15	50180635	rs35996890	A	T	14	3	17	0	0	17	0	0
15	50184767	rs17487811	A	G	25	13	38	0	0	38	0	0
15	50272085	rs8034382	A	G	1	7	8	0	0	8	0	0
15	50275195	rs57498160	C	T	1	5	6	0	0	6	0	0
15	50276885	rs79062567	C	T	63	45	108	0	1	109	0	0
15	50276945	rs6493393	A	G	57	41	98	0	2	100	0	0
15	50277418	rs8027127	C	T	30	18	48	0	1	49	0	0
15	50277619	rs8027524	C	T	21	11	32	0	0	32	0	0
15	50277689	rs8027678	C	T	30	17	47	0	1	48	0	0
15	50277743	rs16963149	C	T	25	18	43	0	0	43	0	0
15	50278691	rs12101586	G	A	23	20	43	0	0	43	0	0
15	50279662	rs16963151	T	C	61	52	113	0	0	113	0	0
15	50282623	rs7164710	C	T	3	3	6	0	0	6	0	0
15	50311148	rs11070741	A	G	5	21	26	0	0	26	0	0
15	50409400	rs35030867	C	A	28	10	38	0	0	38	0	0
15	50410530	rs2414020	A	G	5	13	18	0	0	18	0	0
15	50411840	rs11853852	C	T	6	14	20	0	1	21	0	0
15	50412454	rs74012893	C	A	2	6	8	0	0	8	0	0
15	50551083	rs854153	T	C	12	5	17	0	0	17	0	0
15	50551103	rs854154	A	T	12	2	14	0	1	15	0	0
15	50551185	rs854155	A	G	10	3	13	0	0	13	0	0
15	50551632	rs2238292	G	T	15	9	24	0	0	24	0	0
15	50552855	rs854157	C	T	11	11	22	0	0	22	0	0
15	50553077	rs854158	A	G	5	4	9	0	0	9	0	0
15	50555011	rs860526	C	T	10	8	18	0	0	18	0	0
15	50555236	rs854159	A	G	8	7	15	0	0	15	0	0
15	50570036	rs12923	A	G	122	114	236	0	1	237	0	0
15	50571444	rs4775872	T	C	7	6	13	0	0	13	0	0
15	50572398	rs12906304	C	T	10	3	13	0	0	13	0	0
15	50572477	rs35033384	G	A	6	4	10	0	0	10	0	0
15	50572601	rs12910368	A	G	11	6	17	0	1	18	0	0
15	50573557	rs7179756	C	T	6	5	11	0	0	11	0	0
15	50573599	.	G	A	3	5	8	0	0	8	0	0
15	50573615	rs59514998	A	G	5	1	6	0	0	6	0	0
15	50573676	rs7179819	A	G	5	3	8	0	0	8	0	0
15	50573688	rs7180278	G	A	4	3	7	0	0	7	0	0
15	50574621	rs11635546	G	A	6	5	11	0	1	12	0	0
15	50577794	rs12440811	T	C	10	16	26	0	0	26	0	0
15	50640880	rs11629603	G	A	3	4	7	0	0	7	0	0
15	50642916	rs6493430	T	C	6	8	14	0	0	14	0	0
15	50645530	rs526045	G	T	3	4	7	0	0	7	0	0
15	50645617	rs526952	G	A	5	8	13	0	0	13	0	0
15	50654138	rs7164431	G	A	4	3	7	0	0	7	0	0
15	50716633	rs2241769	G	C	12	19	31	0	0	31	0	0
15	50723981	rs62016944	G	A	4	2	6	0	0	6	0	0
15	50724492	rs934636	C	G	8	2	10	0	0	10	0	0
15	50731213	rs11632697	G	C	65	55	120	0	2	122	0	0
15	50749197	rs7165464	T	C	3	3	6	0	0	6	0	0
15	50756859	rs11070780	G	A	5	4	9	0	0	9	0	0
15	50759159	rs11637104	A	G	5	1	6	0	0	6	0	0
15	50782703	rs11638390	A	G	34	34	68	0	0	68	0	0
15	50788428	rs62019113	C	T	7	1	8	0	0	8	0	0
15	50788603	.	T	G	4	2	6	0	0	6	0	0
15	50789125	rs11637031	A	G	10	14	24	0	0	24	0	0
15	50789163	rs10519278	A	T	10	14	24	0	0	24	0	0
15	50790233	rs8037553	A	G	4	2	6	0	0	6	0	0
15	50790556	rs62019115	A	G	13	8	21	0	0	21	0	0
15	50853639	rs62021060	T	C	33	54	87	0	0	87	0	0
15	50914159	rs151067682	G	A	6	3	9	0	0	9	0	0
15	51201357	rs2614789	G	T	3	5	8	0	0	8	0	0
15	51217361	rs2306331	T	C	8	11	19	0	1	21	1	0
15	51254502	rs8182062	A	G	4	9	13	0	0	13	0	0
15	51294832	rs3825798	G	A	12	12	24	0	0	24	0	0
15	51294995	rs3743045	G	A	4	4	8	0	0	8	0	0
15	51296015	rs2619685	G	A	7	12	19	0	0	19	0	0
15	51296407	rs714784	T	C	8	11	19	0	0	19	0	0
15	51741056	rs3751585	G	A	36	26	62	0	1	63	0	0
15	51753994	rs7162412	C	T	4	5	9	0	0	9	0	0
15	51783820	rs10851500	T	C	8	6	14	0	0	14	0	0
15	51791559	rs12102203	A	G	5	8	13	0	0	13	0	0
15	51829812	rs17524906	G	A	9	4	13	0	0	13	0	0
15	51853817	rs11070856	C	T	8	0	8	0	0	8	0	0
15	51868373	rs2414105	A	G	8	6	14	0	0	14	0	0
15	51904812	rs4775963	C	T	1	5	6	0	0	6	0	0
15	51914662	rs2278990	G	A	7	15	22	0	0	22	0	0
15	51914716	rs2278989	T	C	8	11	19	0	0	19	0	0
15	51914778	rs6493514	T	G	11	11	22	0	0	22	0	0
15	52022355	rs8028258	G	T	2	6	8	0	0	8	0	0
15	52023074	rs2606130	C	T	12	3	15	0	0	15	0	0
15	52025739	rs11070865	T	C	9	5	14	0	0	14	0	0
15	52027537	rs8040986	G	T	2	5	7	0	0	7	0	0
15	52030020	rs28699115	G	T	5	8	13	0	0	13	0	0
15	52043877	rs76930538	G	A	3	16	19	0	0	19	0	0
15	52045368	rs11638820	G	A	1	5	6	0	0	6	0	0
15	52046713	rs4365237	A	G	3	15	18	0	0	18	0	0
15	52127230	rs6493526	T	C	3	3	6	0	0	6	0	0
15	52176912	rs2570228	T	C	4	6	10	0	0	10	0	0
15	52202980	rs1135871	T	G	35	32	67	0	4	71	0	0
15	52203664	rs2433221	A	C	6	6	12	0	0	12	0	0
15	52203813	rs11049	A	G	7	9	16	0	0	16	0	0
15	52206681	rs2593177	T	C	8	5	13	0	0	13	0	0
15	52207029	rs2448949	G	A	4	2	6	0	0	6	0	0
15	52208330	rs2929425	C	T	15	8	23	0	0	23	0	0
15	52213737	rs2623281	T	C	4	6	10	0	0	10	0	0
15	52226474	rs2570268	A	G	4	3	7	0	0	7	0	0
15	52226532	rs2916177	C	T	5	5	10	0	0	10	0	0
15	52239380	rs2414122	C	A	2	7	9	0	0	9	0	0
15	52264094	rs17612102	T	C	5	9	14	0	0	14	0	0
15	52353498	rs35697691	C	G	190	158	348	0	0	348	0	0
15	52401933	rs2231297	A	G	2	4	6	0	0	6	0	0
15	52401951	rs2227308	G	A	2	4	6	0	0	6	0	0
15	52413316	rs12396	G	C	41	27	68	0	0	68	0	0
15	52441524	rs3794543	C	T	3	3	6	0	0	6	0	0
15	52441686	rs12438937	C	T	4	6	10	0	0	10	0	0
15	52484841	rs1077383	G	C	11	6	17	0	0	17	0	0
15	52484950	rs1063902	A	C	4	5	9	0	0	9	0	0
15	52517714	rs3825801	C	T	6	1	7	0	0	7	0	0
15	52601033	rs36078972	T	C	22	20	42	0	0	42	0	0
15	52611495	.	C	G	56	51	107	0	0	107	0	0
15	52841622	rs11539780	C	T	92	83	175	0	4	179	0	0
15	55473192	rs3759861	C	T	5	4	9	0	0	9	0	0
15	55476392	rs28710976	T	C	4	5	9	0	0	9	0	0
15	55483890	rs17238164	A	G	3	4	7	0	0	7	0	0
15	55484294	rs6493768	T	A	4	4	8	0	0	8	0	0
15	55486566	rs74971065	T	C	0	8	8	0	0	8	0	0
15	55489065	rs9300	G	A	469	442	911	0	13	927	3	0
15	55489104	rs13733	A	G	248	217	465	0	1	466	0	0
15	55495698	rs6493769	C	T	44	18	62	0	1	63	0	0
15	55495774	rs6493770	A	G	33	5	38	0	1	39	0	0
15	55495779	.	A	T	35	4	39	0	0	39	0	0
15	55495801	.	T	A	30	6	36	0	5	41	0	0
15	55495963	rs1061824	T	C	42	35	77	0	0	77	0	0
15	55496043	rs1061823	T	A	34	32	66	0	0	66	0	0
15	55496058	rs1061822	A	C	32	28	60	0	0	60	0	0
15	55496111	rs1061821	T	C	21	22	43	0	5	48	0	0
15	55496278	rs1061875	C	T	46	21	67	0	1	68	0	0
15	55496287	rs1061874	A	T	46	22	68	0	0	68	0	0
15	55496756	rs1061873	T	C	30	13	43	0	0	43	0	0
15	55496769	rs1061870	G	T	28	12	40	0	0	40	0	0
15	55496853	rs3179664	G	A	42	20	62	0	0	62	0	0
15	55497691	rs1050931	G	A	166	92	258	0	1	259	0	0
15	55609692	rs28685005	C	T	101	57	158	0	2	160	0	0
15	55611126	rs12902710	T	C	32	36	68	0	4	72	0	0
15	55632859	rs678892	G	T	11	10	21	0	0	21	0	0
15	55647492	rs8043415	C	T	33	28	61	0	0	61	0	0
15	55647786	rs11732	A	G	13	8	21	0	0	21	0	0
15	55652719	rs34958422	A	G	19	48	67	0	0	67	0	0
15	55652845	rs11545679	A	G	24	48	72	0	0	72	0	0
15	55664110	rs117236526	G	C	28	15	43	0	0	43	0	0
15	55664220	rs3203152	G	A	38	11	49	0	0	49	0	0
15	55665089	rs8041885	T	C	7	3	10	0	0	10	0	0
15	55665313	rs8041044	C	A	5	3	8	0	0	8	0	0
15	55665506	rs10518810	C	T	7	1	8	0	0	8	0	0
15	55667569	rs7177888	T	G	7	0	7	0	0	7	0	0
15	55700427	rs8023354	G	A	13	6	19	0	0	19	0	0
15	56119577	rs3088077	C	T	3	6	9	0	0	9	0	0
15	56120962	rs16976592	T	C	12	5	17	0	0	17	0	0
15	56121334	rs7162435	T	C	11	8	19	0	0	19	0	0
15	56121886	rs1042477	C	A	17	5	22	0	0	22	0	0
15	56152729	rs2303579	T	C	7	9	16	0	0	16	0	0
15	56152872	rs2303580	C	T	10	8	18	0	1	19	0	0
15	56243766	rs61732704	C	T	14	18	32	0	0	32	0	0
15	56274779	rs8034692	G	A	4	4	8	0	0	8	0	0
15	57024237	rs117989361	G	A	3	3	6	0	0	6	0	0
15	57210275	.	C	G	7	11	18	0	0	18	0	0
15	57210297	rs3803455	G	A	7	9	16	0	1	17	0	0
15	57254778	rs2116066	A	G	5	7	12	0	1	13	0	0
15	57254842	rs1642929	T	A	11	7	18	0	0	18	0	0
15	57356494	rs2920268	G	A	8	5	13	0	0	13	0	0
15	57422552	rs2169465	T	G	3	6	9	0	0	9	0	0
15	57426901	rs72731943	A	G	4	2	6	0	0	6	0	0
15	57564473	rs8042322	A	G	8	2	10	0	0	10	0	0
15	57580940	rs8035097	T	C	21	29	50	0	0	50	0	0
15	57581311	rs12911297	G	A	13	12	25	0	1	26	0	0
15	57581413	rs2921430	T	C	14	13	27	0	0	27	0	0
15	57594066	rs2440979	T	C	6	0	6	0	0	6	0	0
15	57597961	rs2248534	T	G	6	3	9	0	0	9	0	0
15	58892410	rs7166076	T	C	6	2	8	0	0	8	0	0
15	58892464	rs7164620	A	T	6	2	8	0	0	8	0	0
15	58893521	rs6494026	A	C	4	4	8	0	0	8	0	0
15	58893584	rs7171098	A	C	4	3	7	0	0	7	0	0
15	58982849	rs2052804	A	C	3	3	6	0	0	6	0	0
15	59156140	rs694918	T	C	13	0	13	0	1	14	0	0
15	59157540	rs592407	C	T	12	0	12	0	0	12	0	0
15	59173310	rs2013117	C	T	8	8	16	0	1	17	0	0
15	59173382	rs28529423	G	A	5	12	17	0	0	17	0	0
15	59173481	rs28709922	G	A	5	10	15	0	0	15	0	0
15	59173643	rs7173317	G	C	8	2	10	0	0	10	0	0
15	59174539	rs7179456	G	T	12	9	21	0	0	21	0	0
15	59175228	rs11858989	T	C	6	2	8	0	0	8	0	0
15	59180748	rs112400142	A	G	162	162	324	0	2	326	0	0
15	59222464	rs11856185	G	A	10	11	21	0	0	21	0	0
15	59222700	rs11853076	T	A	9	9	18	0	0	18	0	0
15	59225818	rs2279719	G	A	6	9	15	0	0	15	0	0
15	59323048	rs2899642	C	G	57	58	115	0	3	118	0	0
15	59930350	rs1129616	G	C	11	5	16	0	0	16	0	0
15	59930772	rs8027679	G	C	11	4	15	0	0	15	0	0
15	59931131	rs4232	A	G	214	132	346	0	4	350	0	0
15	59949178	rs8041394	T	C	5	3	8	0	0	8	0	0
15	59949433	rs7162964	C	T	6	6	12	0	0	12	0	0
15	59949625	rs7164756	T	G	249	173	422	0	3	425	0	0
15	59951573	rs7882	A	G	29	34	63	0	1	64	0	0
15	59951997	rs1046053	C	A	9	5	14	0	0	14	0	0
15	59952124	rs6494133	G	T	20	14	34	0	0	34	0	0
15	59952253	rs4775195	C	G	27	22	49	0	0	49	0	0
15	59952905	rs11854063	A	G	14	21	35	0	0	35	0	0
15	59953314	rs8033161	C	T	11	17	28	0	0	28	0	0
15	59953908	rs6151592	A	G	15	10	25	0	0	25	0	0
15	59953965	rs6151590	A	G	9	7	16	0	0	16	0	0
15	59954569	rs6151586	T	A	7	6	13	0	0	13	0	0
15	59954723	rs1871499	T	A	5	5	10	0	0	10	0	0
15	59955651	rs2306355	A	G	492	386	878	0	8	886	0	0
15	59955668	rs1057059	A	C	392	438	830	0	2	832	0	0
15	59956730	rs6151581	G	A	6	2	8	0	0	8	0	0
15	59957585	rs8040114	C	T	1	5	6	0	0	6	0	0
15	59958771	rs6151576	C	T	3	5	8	0	0	8	0	0
15	59958811	rs6151574	A	G	6	3	9	0	0	9	0	0
15	59960155	rs6151570	G	C	7	6	13	0	0	13	0	0
15	59960261	rs6151568	T	C	4	4	8	0	0	8	0	0
15	59961752	rs6151561	C	T	8	5	13	0	0	13	0	0
15	59963488	rs1135148	A	G	224	409	633	0	1	634	0	0
15	59965441	rs12907554	A	T	4	4	8	0	1	9	0	0
15	59966020	rs12912652	C	T	5	4	9	0	0	9	0	0
15	59966221	rs67820349	G	A	6	4	10	0	0	10	0	0
15	59966306	rs71480542	C	A	5	2	7	0	0	7	0	0
15	59966553	rs12593480	G	A	6	1	7	0	0	7	0	0
15	59966649	rs7497974	T	A	9	11	20	0	0	20	0	0
15	59966920	rs11071468	A	T	7	10	17	0	0	17	0	0
15	59967047	rs11071469	C	T	4	5	9	0	0	9	0	0
15	59967774	rs12903647	C	G	4	12	16	0	0	16	0	0
15	59968148	rs6151533	C	G	4	8	12	0	0	12	0	0
15	59968213	rs6151532	T	C	2	8	10	0	0	10	0	0
15	59968414	rs6151529	A	C	4	3	7	0	0	7	0	0
15	59968486	rs6151528	C	A	5	5	10	0	0	10	0	0
15	59968888	rs6151525	A	G	15	19	34	0	1	35	0	0
15	59970298	rs2307272	C	A	7	9	16	0	0	16	0	0
15	59970420	rs6151514	A	G	8	16	24	0	1	25	0	0
15	59971532	rs1552031	A	G	5	9	14	0	0	14	0	0
15	59971615	rs1002181	G	C	5	9	14	0	3	17	0	0
15	59973464	rs6151496	C	T	3	4	7	0	0	7	0	0
15	59973487	rs6151494	T	A	4	5	9	0	0	9	0	0
15	59973563	rs17236804	C	T	4	4	8	0	0	8	0	0
15	59974458	rs6151487	G	A	15	2	17	0	0	17	0	0
15	59974481	rs6151486	G	T	3	14	17	0	0	17	0	0
15	59974566	rs2307275	C	G	8	1	9	0	0	9	0	0
15	59974777	rs6151483	A	G	7	2	9	0	0	9	0	0
15	59975650	rs6151477	T	C	4	3	7	0	1	8	0	0
15	59976245	rs6151470	A	T	6	1	7	0	0	7	0	0
15	59976351	rs6151467	A	G	3	3	6	0	0	6	0	0
15	59976781	rs6151462	G	T	6	6	12	0	0	12	0	0
15	59976805	rs6151461	G	C	5	4	9	0	1	10	0	0
15	59980049	rs6151449	G	A	5	1	6	0	0	6	0	0
15	59980635	rs6151440	A	T	6	2	8	0	0	8	0	0
15	59981242	rs2306358	C	T	11	1	12	0	0	12	0	0
15	59981515	rs3087328	A	G	10	7	17	0	0	17	0	0
15	59981719	rs754642	C	T	4	6	10	0	0	10	0	0
15	60640228	rs7163836	C	T	6	1	7	0	0	7	0	0
15	60677638	rs10454693	A	G	15	5	20	0	0	20	0	0
15	60683949	rs8023979	G	A	2	4	6	0	0	6	0	0
15	60686631	rs62004990	C	T	1	9	10	0	0	10	0	0
15	60687230	rs12440452	A	C	8	0	8	0	0	8	0	0
15	60687676	rs3940746	G	T	9	1	10	0	0	10	0	0
15	60687844	rs2100432	A	G	6	3	9	0	0	9	0	0
15	60715643	rs3068	C	T	29	17	46	0	0	46	0	0
15	60715800	rs1046657	T	G	19	26	45	0	2	47	0	0
15	60734697	rs1063100	A	G	17	14	31	0	0	31	0	0
15	60770850	rs2100431	C	A	6	0	6	0	0	6	0	0
15	60803741	rs61740274	C	T	5	6	11	0	1	12	0	0
15	62144991	rs191825877	G	C	3	4	7	0	0	7	0	0
15	62159818	rs181961510	C	T	3	4	7	0	0	7	0	0
15	62538610	rs143731875	A	G	7	5	12	0	1	14	1	0
15	63430502	rs72747067	C	T	3	3	6	0	0	6	0	0
15	63432495	rs2088929	A	T	5	3	8	0	0	8	0	0
15	63433766	rs2729835	G	A	56	60	116	0	1	117	0	0
15	63434110	rs8468	C	T	21	23	44	0	3	47	0	0
15	63434763	rs4774478	A	G	2	4	6	0	0	6	0	0
15	63435129	rs12898885	G	A	6	2	8	0	0	8	0	0
15	63435196	rs12899931	T	C	6	2	8	0	0	8	0	0
15	63440938	rs6494394	A	G	3	6	9	0	1	10	0	0
15	63443968	rs28394803	A	C	7	3	10	0	0	10	0	0
15	63445144	rs953978	C	T	6	1	7	0	0	7	0	0
15	63445764	rs28434769	T	C	158	59	217	0	2	219	0	0
15	63445872	rs28542166	C	T	165	53	218	0	4	222	0	0
15	63446012	rs28637229	G	A	41	14	55	0	1	56	0	0
15	63446332	rs35018260	C	T	12	9	21	0	0	21	0	0
15	63446598	rs28562564	C	T	22	23	45	0	1	46	0	0
15	63446934	rs8182067	A	G	14	8	22	0	0	22	0	0
15	63447198	rs3784677	G	A	26	14	40	0	0	40	0	0
15	63448471	rs11853249	T	C	4	5	9	0	0	9	0	0
15	63448780	rs2270948	C	G	12	23	35	0	0	35	0	0
15	63449005	rs28377261	G	A	285	200	485	0	6	491	0	0
15	63449777	rs12902921	G	A	3	4	7	0	0	7	0	0
15	63449865	rs8036501	G	T	5	3	8	0	0	8	0	0
15	63494159	rs12595312	T	C	1	9	10	0	0	10	0	0
15	63494217	rs12912452	C	T	1	7	8	0	0	8	0	0
15	63503313	rs12913551	C	T	2	4	6	0	0	6	0	0
15	63548787	rs10851726	G	A	166	184	350	0	0	350	0	0
15	63553994	rs1017545	T	C	10	9	19	0	0	19	0	0
15	63554824	rs7172246	G	A	3	5	8	0	0	8	0	0
15	63558299	rs34896765	G	A	104	85	189	0	3	192	0	0
15	63559609	rs13681	T	A	110	100	210	0	0	210	0	0
15	63600603	rs17762798	G	A	3	3	6	0	0	6	0	0
15	63601026	rs71394506	A	T	6	4	10	0	0	10	0	0
15	63829538	rs11853890	A	G	5	2	7	0	0	7	0	0
15	63831869	rs2058913	A	T	6	4	10	0	0	10	0	0
15	63832562	rs16947268	T	C	6	3	9	0	0	9	0	0
15	63874864	rs77290236	G	C	4	4	8	0	0	8	0	0
15	63875161	rs77475530	G	T	3	5	8	0	0	8	0	0
15	63878198	rs28517814	A	G	5	4	9	0	0	9	0	0
15	63878336	rs28627799	A	C	4	4	8	0	0	8	0	0
15	63878889	rs7162745	T	A	16	12	28	0	0	28	0	0
15	63879235	rs28531781	T	C	12	13	25	0	0	25	0	0
15	63879488	rs117519876	C	T	6	12	18	0	2	20	0	0
15	63881931	rs4984303	T	C	13	11	24	0	0	24	0	0
15	63884275	rs8043465	T	C	6	4	10	0	0	10	0	0
15	63884462	rs8023506	T	C	6	4	10	0	0	10	0	0
15	63885699	rs7171858	C	T	12	14	26	0	0	26	0	0
15	63885810	rs3210904	T	C	10	15	25	0	0	25	0	0
15	63886250	rs11071758	G	A	22	21	43	0	0	43	0	0
15	63886379	rs11457	G	C	23	25	48	0	1	49	0	0
15	63886593	rs2649	C	T	23	29	52	0	1	53	0	0
15	63904110	rs73441919	G	A	3	13	16	0	0	16	0	0
15	63904135	rs12102137	G	A	15	3	18	0	0	18	0	0
15	63906609	rs11636284	T	C	9	5	14	0	0	14	0	0
15	63907940	rs7178853	T	C	3	4	7	0	0	7	0	0
15	63909184	rs11855988	C	T	12	7	19	0	0	19	0	0
15	63909577	rs8023851	A	T	26	22	48	0	0	48	0	0
15	63909930	rs55640532	G	C	24	23	47	0	0	47	0	0
15	63910315	rs71394521	T	C	13	10	23	0	0	23	0	0
15	63911171	rs146159842	C	T	12	12	24	0	0	24	0	0
15	63911652	rs76453046	T	C	8	8	16	0	1	17	0	0
15	63912030	.	G	C	8	2	10	0	0	10	0	0
15	63913819	rs144335858	G	A	5	6	11	0	0	11	0	0
15	63929232	rs8030077	T	A	22	29	51	0	0	51	0	0
15	63930798	rs80088271	G	A	8	3	11	0	0	11	0	0
15	63932513	rs2228517	G	C	75	47	122	0	0	122	0	0
15	63970456	rs2228510	T	C	19	17	36	0	0	36	0	0
15	64001876	rs2318	C	G	12	9	21	0	0	21	0	0
15	64005722	rs61749474	A	G	5	10	15	0	1	16	0	0
15	64006923	rs12148696	T	A	3	3	6	0	0	6	0	0
15	64033901	rs1065250	T	C	2	4	6	0	0	6	0	0
15	64036214	rs12913540	G	T	2	8	10	0	0	10	0	0
15	64036953	rs2089619	G	C	1	5	6	0	0	6	0	0
15	64037439	rs56019571	A	G	1	5	6	0	0	6	0	0
15	64419374	rs34257057	G	T	30	60	90	0	0	90	0	0
15	64423080	rs72755093	C	A	2	4	6	0	0	6	0	0
15	64429643	rs72755099	G	A	4	6	10	0	0	10	0	0
15	64430098	rs11551152	T	C	15	52	67	0	0	67	0	0
15	64430526	rs58621982	T	C	6	3	9	0	1	10	0	0
15	64432001	rs150714696	A	G	7	8	15	0	0	15	0	0
15	64434537	rs17201990	G	A	3	3	6	0	0	6	0	0
15	64449839	rs3784381	G	T	7	7	14	0	0	14	0	0
15	64451746	rs28720186	C	T	3	4	7	0	0	7	0	0
15	64451961	rs28720185	G	A	8	2	10	0	0	10	0	0
15	64459327	rs72756913	A	T	12	10	22	0	1	23	0	0
15	64459604	rs72756914	G	C	22	21	43	0	0	43	0	0
15	64460028	rs72756915	T	A	11	20	31	0	0	31	0	0
15	64461098	rs62024254	T	C	5	14	19	0	0	19	0	0
15	64504569	rs72756936	G	A	6	4	10	0	0	10	0	0
15	64508763	rs6494466	G	A	12	15	27	0	0	27	0	0
15	64656762	rs1033206	T	C	44	36	80	0	1	81	0	0
15	64656764	rs1033205	G	C	42	37	79	0	0	79	0	0
15	64657496	rs6494476	C	T	29	49	78	0	2	80	0	0
15	64657684	rs72758928	C	A	52	50	102	0	1	103	0	0
15	64673615	rs11554310	A	G	154	135	289	0	10	299	0	0
15	64706332	rs34758599	A	G	30	34	64	0	0	64	0	0
15	64967654	rs16948170	C	T	10	12	22	0	1	23	0	0
15	64975763	rs11071804	C	G	30	48	78	0	0	78	0	0
15	64977055	rs72742982	C	T	41	31	72	0	4	76	0	0
15	64983249	rs66586340	A	G	6	10	16	0	0	16	0	0
15	64985604	rs7165925	C	T	4	4	8	0	0	8	0	0
15	64986268	.	C	T	2	4	6	0	0	6	0	0
15	64986269	.	C	T	4	2	6	0	0	6	0	0
15	64986272	.	C	A	5	4	9	0	0	9	0	0
15	64987229	rs72742986	T	C	6	4	10	0	2	12	0	0
15	64987570	rs1133357	G	A	6	4	10	0	0	10	0	0
15	64988982	rs16948187	C	T	2	5	7	0	0	7	0	0
15	65032726	rs138676714	G	A	10	7	17	0	0	17	0	0
15	65147398	rs865576	A	G	1	5	6	0	0	6	0	0
15	65147711	rs832879	A	C	6	5	11	0	0	11	0	0
15	65148643	rs832880	C	G	6	4	10	0	0	10	0	0
15	65150837	rs832882	G	A	1	7	8	0	1	9	0	0
15	65150973	rs832883	A	C	2	4	6	0	0	6	0	0
15	65156035	rs12904909	A	C	5	2	7	0	0	7	0	0
15	65156523	rs1719277	A	G	6	9	15	0	0	15	0	0
15	65157874	rs141176661	G	A	169	145	314	0	2	316	0	0
15	65158047	rs77456635	G	A	90	148	238	0	0	238	0	0
15	65159458	rs1043697	T	C	177	169	346	0	1	348	1	0
15	65247614	rs67054282	A	G	6	2	8	0	0	8	0	0
15	65442479	rs2946667	A	C	7	13	20	0	0	20	0	0
15	65442523	rs12909981	G	A	10	9	19	0	1	20	0	0
15	65527098	rs8025296	A	C	5	2	7	0	0	7	0	0
15	65553246	rs2304896	C	T	24	16	40	0	0	40	0	0
15	65588628	rs7175829	C	T	10	6	16	0	0	16	0	0
15	65592640	rs117362573	G	A	11	1	12	0	0	12	0	0
15	65592751	rs4315292	A	G	3	8	11	0	0	11	0	0
15	65592767	rs55711164	G	A	8	3	11	0	0	11	0	0
15	65592902	rs12441850	T	C	3	3	6	0	0	6	0	0
15	65735707	rs590958	T	G	0	6	6	0	0	6	0	0
15	65805389	rs352476	T	C	1	5	6	0	0	6	0	0
15	65856653	rs11539008	G	A	23	25	48	0	0	48	0	0
15	65869272	rs12333	C	T	35	30	65	0	0	65	0	0
15	65870130	rs11539010	G	A	58	51	109	0	1	110	0	0
15	65903398	rs4366668	G	A	4	5	9	0	0	9	0	0
15	65944548	rs8035639	C	T	4	2	6	0	0	6	0	0
15	65952034	rs8031179	T	C	8	4	12	0	0	12	0	0
15	65952345	rs72741220	G	A	5	4	9	0	1	10	0	0
15	65958942	rs8030562	T	C	23	24	47	0	1	48	0	0
15	65959645	rs113627784	C	T	13	6	19	0	0	19	0	0
15	65960195	rs6494531	A	G	2	4	6	0	0	6	0	0
15	65974936	rs7181632	T	C	4	4	8	0	0	8	0	0
15	65982141	rs28444423	T	G	1	5	6	0	0	6	0	0
15	65994733	rs17810074	C	T	40	23	63	0	0	63	0	0
15	66025275	rs1435126	C	T	3	3	6	0	0	6	0	0
15	66028590	rs72741257	G	T	4	2	6	0	0	6	0	0
15	66626195	rs147436267	G	A	8	7	15	0	0	15	0	0
15	66783378	rs56366941	G	T	139	150	289	0	4	293	0	0
15	66995075	rs34643453	G	A	11	0	11	0	0	11	0	0
15	67358478	rs1061427	G	A	13	23	36	0	0	36	0	0
15	67359738	rs4776337	G	A	7	15	22	0	0	22	0	0
15	67359883	rs4776338	T	C	4	10	14	0	0	14	0	0
15	67361308	rs7162912	T	G	17	16	33	0	1	34	0	0
15	67361774	rs12904944	G	A	16	20	36	0	1	37	0	0
15	67362994	rs17291497	T	C	11	12	23	0	0	23	0	0
15	67363283	rs10518705	T	G	4	14	18	0	1	19	0	0
15	67363407	rs78679132	G	A	18	9	27	0	0	27	0	0
15	67363573	rs11632964	C	T	15	17	32	0	1	33	0	0
15	67364320	rs4776879	T	A	9	9	18	0	0	18	0	0
15	67391805	rs9972423	T	A	6	11	17	0	0	17	0	0
15	67468525	rs35251008	A	G	1	5	6	0	0	6	0	0
15	67472683	rs7178824	G	C	4	3	7	0	0	7	0	0
15	67483276	rs8025774	C	T	56	45	101	0	2	103	0	0
15	67483979	rs8031440	G	A	16	17	33	0	0	33	0	0
15	67484119	rs8031627	G	A	7	9	16	0	0	16	0	0
15	67484297	rs2278670	C	T	15	12	27	0	0	27	0	0
15	67485101	rs11638476	G	A	21	14	35	0	0	35	0	0
15	67485156	rs12595334	C	T	17	14	31	0	0	31	0	0
15	67485667	rs3743342	C	T	24	10	34	0	0	34	0	0
15	67486383	rs11556090	A	G	25	28	53	0	0	53	0	0
15	67493726	rs12476	T	C	71	51	122	0	2	124	0	0
15	67494494	rs1050285	T	C	121	115	236	0	0	236	0	0
15	67494823	rs10518716	G	C	113	73	186	0	1	187	0	0
15	67494922	rs12148121	T	C	69	61	130	0	1	131	0	0
15	67499411	rs7165503	C	T	6	4	10	0	0	10	0	0
15	67499477	rs11071940	A	C	5	6	11	0	0	11	0	0
15	67500049	rs7171475	G	C	3	7	10	0	0	10	0	0
15	67500330	rs4776905	T	C	8	5	13	0	0	13	0	0
15	67503637	rs10163156	G	A	5	2	7	0	0	7	0	0
15	67503808	rs72625777	G	C	4	2	6	0	0	6	0	0
15	67528374	rs7173826	T	G	87	68	155	0	2	157	0	0
15	67529118	.	G	A	38	41	79	0	0	79	0	0
15	67890453	rs35733169	G	C	6	6	12	0	0	12	0	0
15	67892766	rs3865018	C	T	10	5	15	0	1	16	0	0
15	67892792	rs17241808	A	G	4	7	11	0	1	12	0	0
15	68124665	rs72751453	C	A	6	4	10	0	0	10	0	0
15	68126398	.	C	A	4	6	10	0	0	10	0	0
15	68479259	rs2176333	C	T	13	11	24	0	0	24	0	0
15	68480887	rs1049493	C	T	25	22	47	0	0	47	0	0
15	68481582	rs12912276	A	T	46	27	73	0	0	73	0	0
15	68490495	rs3743089	C	A	5	5	10	0	0	10	0	0
15	68498052	rs11071991	T	C	10	9	19	0	0	19	0	0
15	68499661	rs8142	G	A	184	160	344	0	2	346	0	0
15	68570158	rs116529867	T	G	9	7	16	0	1	17	0	0
15	68570166	rs55941639	G	A	12	9	21	0	0	21	0	0
15	68584556	rs6494730	G	T	44	29	73	0	0	73	0	0
15	68585218	rs66989829	G	T	76	68	144	0	1	145	0	0
15	69740273	rs117120578	T	C	27	26	53	0	0	53	0	0
15	69745168	rs188707409	A	C	181	77	258	0	2	260	0	0
15	70341166	rs3195776	C	G	329	333	662	0	3	665	0	0
15	70344616	rs3743310	A	G	5	4	9	0	0	9	0	0
15	70345281	rs7167790	T	C	5	9	14	0	0	14	0	0
15	70345356	rs4777225	G	T	4	6	10	0	0	10	0	0
15	70345360	rs4777226	G	A	3	6	9	0	0	9	0	0
15	70345626	rs1057865	C	T	346	303	649	0	11	662	2	0
15	70346169	rs8032946	A	G	3	4	7	0	0	7	0	0
15	70346923	rs2228178	C	T	177	205	382	0	4	386	0	0
15	70350287	rs7175702	C	T	5	9	14	0	1	15	0	0
15	70350293	rs7175541	A	C	6	9	15	0	0	15	0	0
15	70350457	rs2291982	C	A	10	3	13	0	0	13	0	0
15	70351788	rs2133977	T	C	306	282	588	0	5	593	0	0
15	70357918	rs16954106	G	A	4	3	7	0	0	7	0	0
15	70360947	rs34687476	G	T	3	3	6	0	0	6	0	0
15	70389271	.	T	C	32	15	47	0	1	48	0	0
15	72114747	rs8178	G	A	5	2	7	0	0	7	0	0
15	72115230	rs2246225	T	C	7	6	13	0	0	13	0	0
15	72115541	rs8747	C	A	9	3	12	0	0	12	0	0
15	72115733	rs8557	T	C	8	4	12	0	0	12	0	0
15	72115763	rs9120	G	A	10	4	14	0	0	14	0	0
15	72116778	rs2742323	T	A	3	8	11	0	0	11	0	0
15	72117102	rs16956273	G	A	3	7	10	0	0	10	0	0
15	72118777	rs2625529	G	C	13	3	16	0	0	16	0	0
15	72191073	rs2415128	T	C	2	7	9	0	0	9	0	0
15	72208780	.	A	T	2	4	6	0	0	6	0	0
15	72496011	rs2607090	C	A	15	14	29	0	0	29	0	0
15	72496762	rs2856929	T	C	13	9	22	0	0	22	0	0
15	72519858	rs8192362	G	A	5	3	8	0	0	8	0	0
15	72523043	rs35603965	C	T	3	5	8	0	0	8	0	0
15	72536695	rs16956623	T	C	5	12	17	0	0	17	0	0
15	72539494	rs35206011	T	C	4	2	6	0	0	6	0	0
15	72540180	rs55763892	C	T	2	10	12	0	0	12	0	0
15	72540296	rs7169264	G	C	3	7	10	0	0	10	0	0
15	72559326	rs62022788	T	G	5	1	6	0	0	6	0	0
15	72564492	rs62022789	C	T	8	9	17	0	0	17	0	0
15	72783168	.	A	G	5	5	10	0	0	10	0	0
15	72798178	rs2415140	G	A	11	6	17	0	0	17	0	0
15	72871371	rs141565107	C	T	6	7	13	0	0	13	0	0
15	73027478	rs2277598	T	C	2	10	12	0	1	13	0	0
15	73030619	rs192812230	G	A	6	5	11	0	0	11	0	0
15	73044575	rs9460	G	A	157	158	315	0	2	317	0	0
15	73044863	rs34149613	G	A	154	128	282	0	0	282	0	0
15	73047053	rs77474591	A	C	7	8	15	0	0	15	0	0
15	73051093	rs8033073	G	A	15	13	28	0	0	28	0	0
15	73051219	rs9806742	G	A	5	7	12	0	0	12	0	0
15	73052014	rs141303576	T	C	11	7	18	0	0	18	0	0
15	73052431	rs2304597	A	G	5	9	14	0	0	14	0	0
15	73069064	rs76136312	C	T	2	4	6	0	0	6	0	0
15	73069937	rs11631214	T	A	5	1	6	0	0	6	0	0
15	73072344	rs75552570	C	A	1	5	6	0	0	6	0	0
15	73079253	rs17827419	G	A	5	2	7	0	0	7	0	0
15	73859016	rs62004587	A	C	4	2	6	0	1	7	0	0
15	74219546	rs1048661	G	T	0	7	7	0	0	7	0	0
15	74315358	.	C	T	8	11	19	0	0	19	0	0
15	74702661	rs2075594	T	C	133	140	273	0	2	275	0	0
15	74702778	rs2075593	G	A	110	112	222	0	7	229	0	0
15	74703022	rs2075592	G	A	102	125	227	0	0	227	0	0
15	74704072	rs190337982	G	A	5	3	8	0	0	8	0	0
15	74704588	rs5015024	G	A	9	6	15	0	1	16	0	0
15	74704658	rs28362924	G	A	3	9	12	0	0	12	0	0
15	74706565	rs28362921	C	T	5	5	10	0	0	10	0	0
15	74706943	rs1046146	G	A	93	126	219	0	0	219	0	0
15	74716080	rs59797898	T	C	2	4	6	0	0	6	0	0
15	74891884	rs3803461	G	C	3	3	6	0	0	6	0	0
15	74914649	rs56298217	G	A	24	29	53	0	0	53	0	0
15	75093389	rs2229730	C	T	202	154	356	0	2	358	0	0
15	75095483	rs7085	T	C	45	43	88	0	2	90	0	0
15	75128501	rs9210	T	C	11	9	20	0	0	20	0	0
15	75130093	rs12898397	T	C	58	0	58	0	1	59	0	0
15	75131661	rs4886615	A	G	37	36	73	0	0	73	0	0
15	75131959	rs936227	A	G	33	32	65	0	0	65	0	0
15	75136257	rs6939	A	C	134	111	245	0	0	245	0	0
15	75136261	rs6938	C	G	144	123	267	0	1	268	0	0
15	75136444	rs872263	C	T	113	87	200	0	0	200	0	0
15	75144543	rs2305667	G	A	2	4	6	0	0	6	0	0
15	75145098	rs936230	T	C	3	3	6	0	0	6	0	0
15	75190690	rs7497201	A	G	2	4	6	0	0	6	0	0
15	75191564	rs149741671	A	G	4	4	8	0	0	8	0	0
15	75193432	rs74450883	A	G	25	42	67	0	2	69	0	0
15	75193623	rs7163332	C	T	25	37	62	0	0	62	0	0
15	75194490	rs6495127	C	T	34	22	56	0	3	59	0	0
15	75195514	rs6495128	G	T	3	7	10	0	0	10	0	0
15	75305040	rs7174129	A	G	1	5	6	0	0	6	0	0
15	75311959	rs8033925	A	G	3	6	9	0	0	9	0	0
15	75312187	rs13056	A	G	4	5	9	0	0	9	0	0
15	75338890	rs1108059	A	C	9	10	19	0	0	19	0	0
15	75339575	rs78664321	G	A	10	12	22	0	0	22	0	0
15	75340722	rs2304901	G	A	8	17	25	0	0	25	0	0
15	75352201	rs12185102	G	A	4	2	6	0	0	6	0	0
15	75643759	rs7182283	G	T	5	2	7	0	0	7	0	0
15	75645350	rs5745920	T	C	8	3	11	0	0	11	0	0
15	75647964	rs4462560	G	C	11	11	22	0	0	22	0	0
15	75649326	rs77463819	G	A	16	13	29	0	0	29	0	0
15	75650836	rs1128933	G	A	90	66	156	0	1	157	0	0
15	75650972	rs3809549	G	A	44	8	52	0	1	53	0	0
15	75669044	rs7184009	A	T	9	8	17	0	0	17	0	0
15	75669823	rs148530107	G	A	6	8	14	0	0	14	0	0
15	75670079	rs9972533	C	T	13	12	25	0	0	25	0	0
15	75711883	rs11856344	A	G	35	38	73	0	0	74	1	0
15	75712481	rs6495174	C	T	36	32	68	0	0	68	0	0
15	75712933	rs7173220	T	G	29	16	45	0	0	45	0	0
15	75736039	rs7163783	G	T	5	15	20	0	1	21	0	0
15	75760723	.	T	A	13	17	30	0	0	30	0	0
15	75892188	rs571046155	T	G	7	7	14	0	0	14	0	0
15	75893088	rs11072552	A	C	8	10	18	0	0	18	0	0
15	75932129	rs13737	G	T	61	56	117	0	0	117	0	0
15	75950163	rs11638663	G	A	10	10	20	0	0	20	0	0
15	75950733	rs8609	T	C	17	6	23	0	0	23	0	0
15	75976743	rs75499392	C	T	2	4	6	0	0	6	0	0
15	76507952	rs4886781	C	T	8	5	13	0	0	13	0	0
15	76726465	rs1607017	G	T	10	8	18	0	0	18	0	0
15	77239651	rs2280194	C	T	3	3	6	0	0	6	0	0
15	77240688	rs79796508	A	G	12	8	20	0	0	20	0	0
15	77324880	rs4078354	A	G	1	5	6	0	0	6	0	0
15	77338784	rs8032	G	C	77	98	175	0	1	176	0	0
15	77344793	rs11737	T	A	48	85	133	0	1	134	0	0
15	77359514	rs34443712	T	G	2	5	7	0	0	7	0	0
15	77402744	rs1823100	C	T	3	4	7	0	0	7	0	0
15	77403477	rs17381821	T	A	3	3	6	0	0	6	0	0
15	77406396	rs3743479	C	T	6	0	6	0	0	6	0	0
15	77776498	rs952471	C	G	11	11	22	0	1	23	0	0
15	77776562	rs952472	A	C	13	15	28	0	0	28	0	0
15	78287889	rs2921118	T	G	9	1	10	0	0	10	0	0
15	78288727	rs76398134	G	A	11	10	21	0	0	21	0	0
15	78288799	rs75180810	A	G	11	12	23	0	0	23	0	0
15	78288848	rs62011473	C	T	5	12	17	0	0	17	0	0
15	78288854	rs62011474	C	T	4	12	16	0	0	16	0	0
15	78288975	rs10519181	G	C	21	13	34	0	0	34	0	0
15	78294163	rs62011475	C	T	5	9	14	0	0	14	0	0
15	78294389	rs79991040	A	T	2	7	9	0	0	9	0	0
15	78313041	rs56357772	C	G	1	5	6	0	0	6	0	0
15	78315497	rs12594823	C	T	13	7	20	0	0	20	0	0
15	78316386	rs1992470	T	A	7	9	16	0	0	16	0	0
15	78369815	rs9047	G	A	9	19	28	0	0	28	0	0
15	78398146	rs10456	G	A	5	8	13	0	0	13	0	0
15	78441769	rs11555541	T	C	17	10	27	0	1	28	0	0
15	78573619	rs3743083	C	T	13	14	27	0	1	28	0	0
15	78632830	rs1127472	C	G	70	27	97	0	0	97	0	0
15	78730591	rs954144	C	T	5	3	8	0	0	8	0	0
15	78763289	rs114642875	G	A	3	6	9	0	0	9	0	0
15	78763617	rs7174190	C	T	6	13	19	0	0	19	0	0
15	78764285	rs3817092	A	G	10	12	22	0	0	22	0	0
15	78764324	rs8036042	G	A	14	8	22	0	0	22	0	0
15	78765189	rs16969883	C	T	13	11	24	0	1	25	0	0
15	78768167	rs28602670	C	G	9	9	18	0	0	18	0	0
15	78791061	rs3743079	C	T	54	60	114	0	0	115	1	0
15	78791911	rs192822075	A	G	15	9	24	0	0	24	0	0
15	78792439	rs7174348	G	A	14	12	26	0	0	26	0	0
15	78793109	rs16969906	T	C	21	23	44	0	0	44	0	0
15	78832832	rs3813570	T	C	146	72	218	0	2	220	0	0
15	78833223	rs12901682	A	C	12	12	24	0	0	24	0	0
15	78833362	rs77424455	A	G	12	12	24	0	0	24	0	0
15	78833450	rs59133824	C	A	9	8	17	0	1	18	0	0
15	78833453	rs59683676	T	C	10	9	19	0	0	19	0	0
15	78835678	rs78262427	A	G	2	4	6	0	0	6	0	0
15	79083120	.	G	A	5	1	6	0	0	6	0	0
15	79151860	rs12903249	C	T	9	0	9	0	1	10	0	0
15	79151999	rs12903542	C	T	10	0	10	0	0	10	0	0
15	79166822	rs10851913	C	T	5	3	8	0	0	8	0	0
15	79168040	rs72749233	A	G	8	8	16	0	0	16	0	0
15	79174326	rs76675237	C	T	2	4	6	0	0	6	0	0
15	79181930	rs7179763	A	G	31	24	55	0	0	55	0	0
15	79183747	rs10519215	T	A	5	7	12	0	0	12	0	0
15	79184352	rs12443105	C	T	1	7	8	0	1	9	0	0
15	79184387	rs9806693	G	A	2	4	6	0	0	6	0	0
15	79185119	rs12050510	A	G	16	11	27	0	0	27	0	0
15	79185134	rs12050511	A	G	15	8	23	0	0	23	0	0
15	79185294	rs62013184	G	A	7	8	15	0	0	15	0	0
15	79185537	rs62013185	G	A	14	7	21	0	0	21	0	0
15	79185877	rs1836556	A	G	4	7	11	0	0	11	0	0
15	79185898	rs1435163	C	A	1156	1060	2216	0	6	2222	0	0
15	79186741	rs12050636	G	A	5	3	8	0	0	8	0	0
15	79187342	rs10519216	T	A	6	8	14	0	0	14	0	0
15	79188278	rs10519217	C	T	2	4	6	0	0	6	0	0
15	79188554	rs10444811	C	G	5	10	15	0	0	15	0	0
15	79189282	rs12438433	T	C	5	7	12	0	0	12	0	0
15	79190132	rs10519219	T	C	76	37	113	0	2	115	0	0
15	79224747	rs13345	C	T	32	8	40	0	0	40	0	0
15	79237247	rs1036938	C	G	4	12	16	0	0	16	0	0
15	79237324	rs1036939	C	A	1	6	7	0	0	7	0	0
15	80253987	rs2562753	T	A	3	3	6	0	0	6	0	0
15	80255209	rs2562754	C	T	6	2	8	0	0	8	0	0
15	80259074	rs7180804	G	A	1	6	7	0	0	7	0	0
15	80259964	rs16971619	C	T	4	5	9	0	0	9	0	0
15	80260014	rs8026803	T	C	3	11	14	0	0	14	0	0
15	80260073	rs78937288	G	A	7	3	10	0	0	10	0	0
15	80260554	rs8026767	G	A	4	4	8	0	0	8	0	0
15	80260872	rs67760360	G	A	6	2	8	0	0	8	0	0
15	80263217	rs3826007	C	T	859	982	1841	0	4	1845	0	0
15	80263345	rs1138358	A	C	709	886	1595	0	6	1601	0	0
15	80263406	rs1138357	C	T	717	847	1564	0	7	1571	0	0
15	80412870	rs79140833	T	C	4	6	10	0	0	10	0	0
15	80413384	rs2903265	A	G	2	5	7	0	0	7	0	0
15	80413994	rs12915043	A	T	6	8	14	0	0	14	0	0
15	80414173	rs1522636	C	G	7	5	12	0	0	12	0	0
15	80418513	rs71397595	C	T	8	6	14	0	0	14	0	0
15	80418756	rs7169038	G	A	9	5	14	0	0	14	0	0
15	80419797	rs2866369	T	G	5	2	7	0	0	7	0	0
15	80419916	rs2903266	G	A	4	2	6	0	0	6	0	0
15	80421421	rs34008123	A	G	8	21	29	0	0	29	0	0
15	80445219	rs56043846	G	A	3	5	8	0	0	8	0	0
15	81072088	rs3848177	C	T	11	5	16	0	0	16	0	0
15	81072495	rs1811729	C	G	5	9	14	0	0	14	0	0
15	81271406	rs8039384	C	A	31	16	47	0	0	47	0	0
15	81271557	rs8039607	C	A	30	24	54	0	0	54	0	0
15	81279706	rs57967327	C	T	3	4	7	0	0	7	0	0
15	81281676	rs16972625	T	C	2	4	6	0	0	6	0	0
15	81281720	rs61021444	C	A	2	5	7	0	0	7	0	0
15	81293344	rs111785807	C	G	4	4	8	0	0	8	0	0
15	81592802	rs11073001	A	G	25	34	59	0	1	60	0	0
15	81598269	rs11556218	T	G	31	34	65	0	0	65	0	0
15	81598416	rs1803275	G	A	30	33	63	0	2	65	0	0
15	81599355	rs3926278	C	G	4	2	6	0	0	6	0	0
15	81599791	rs17875542	G	C	4	2	6	0	0	6	0	0
15	81601322	rs859	A	G	32	36	68	0	0	68	0	0
15	81601340	rs11325	G	T	26	29	55	0	0	56	1	0
15	81604104	rs8041557	T	C	5	2	7	0	0	7	0	0
15	81604131	rs4778640	A	G	3	3	6	0	0	6	0	0
15	81604388	rs4778641	T	C	6	14	20	0	0	20	0	0
15	81604389	rs4778892	T	C	6	14	20	0	0	20	0	0
15	81604871	rs3726	T	C	2	7	9	0	0	9	0	0
15	81616329	rs74028612	G	A	4	3	7	0	0	7	0	0
15	82443939	rs4725	G	A	11	14	25	0	0	25	0	0
15	82444437	rs905450	A	G	10	13	23	0	0	23	0	0
15	82444663	rs2292071	T	C	5	7	12	0	0	12	0	0
15	82456227	rs1128431	T	C	16	13	29	0	0	29	0	0
15	83481880	rs35270670	A	G	65	67	132	0	0	132	0	0
15	83493379	.	G	A	8	3	11	0	0	11	0	0
15	83497589	rs17158267	G	A	7	4	11	0	0	11	0	0
15	83502065	rs11259953	A	C	168	162	330	0	3	333	0	0
15	83502066	rs11259954	C	G	170	162	332	0	0	333	1	0
15	83502777	rs12915294	C	T	128	134	262	0	1	263	0	0
15	83503163	rs28698473	G	T	186	172	358	0	3	362	1	0
15	83655104	rs74030863	T	A	168	73	241	0	1	242	0	0
15	83657468	rs115868366	T	C	12	3	15	0	0	15	0	0
15	83657800	rs61738562	G	T	211	42	253	0	0	253	0	0
15	83674076	rs150955027	G	A	16	18	34	0	0	34	0	0
15	83685440	rs7757	A	G	139	158	297	0	5	302	0	0
15	83686759	rs17158127	T	C	39	48	87	0	0	87	0	0
15	83719242	rs28429062	T	C	9	10	19	0	4	23	0	0
15	83722362	rs147846225	G	A	4	4	8	0	0	8	0	0
15	83723559	rs67482297	G	A	3	7	10	0	0	10	0	0
15	83781631	rs1989	C	T	8	6	14	0	0	14	0	0
15	83783233	rs146246208	G	C	6	2	8	0	0	8	0	0
15	85147910	rs7169769	G	C	1	5	6	0	1	7	0	0
15	85157969	rs112350359	G	T	9	9	18	0	0	18	0	0
15	85188839	rs11073619	C	T	23	24	47	0	2	49	0	0
15	85190269	.	G	A	5	4	9	0	0	9	0	0
15	85191274	rs7169629	C	G	5	3	8	0	0	8	0	0
15	85198606	rs17598561	C	T	64	52	116	0	0	116	0	0
15	85198631	.	G	A	55	49	104	0	0	104	0	0
15	85333953	rs2241645	A	G	48	44	92	0	0	92	0	0
15	85336949	rs56194751	C	T	4	2	6	0	1	7	0	0
15	85337800	rs35726233	C	T	2	4	6	0	0	6	0	0
15	85343878	rs8037997	A	C	4	3	7	0	0	7	0	0
15	85343980	rs35960805	T	G	9	2	11	0	0	11	0	0
15	85344290	rs68097191	G	A	2	4	6	0	0	6	0	0
15	85347709	rs17601029	A	G	3	3	6	0	0	6	0	0
15	85348172	rs1719	G	T	12	10	22	0	0	22	0	0
15	85348919	.	G	C	9	15	24	0	2	26	0	0
15	85657120	rs62019510	A	G	6	7	13	0	0	13	0	0
15	85958438	rs11638454	C	G	10	5	15	0	0	15	0	0
15	85958673	rs35451550	G	T	15	8	23	0	0	23	0	0
15	86122970	rs17557307	T	C	7	10	17	0	0	17	0	0
15	86123170	rs745191	G	T	13	10	23	0	0	23	0	0
15	86126350	rs72758699	T	G	26	56	82	0	0	82	0	0
15	86182670	rs16942564	G	A	67	114	181	0	1	182	0	0
15	86228369	rs2306224	C	G	5	1	6	0	0	6	0	0
15	86230290	rs17636666	C	T	5	1	6	0	0	6	0	0
15	86230958	rs11073492	A	G	4	2	6	0	1	7	0	0
15	86236067	rs72748162	T	A	6	0	6	0	0	6	0	0
15	86261128	rs79813743	C	G	5	3	8	0	0	8	0	0
15	86278309	rs2241268	G	A	279	167	446	0	3	449	0	0
15	86279928	rs11635956	G	A	3	4	7	0	0	7	0	0
15	86283720	rs112031434	T	C	13	6	19	0	0	19	0	0
15	86284072	rs11632034	C	T	8	13	21	0	0	21	0	0
15	86284896	rs56412576	G	A	3	5	8	0	0	8	0	0
15	86284944	.	A	C	4	3	7	0	0	7	0	0
15	86285824	rs56141817	A	C	10	12	22	0	0	22	0	0
15	86286787	rs61734378	C	T	173	257	430	0	0	430	0	0
15	86287547	rs11636138	T	A	8	2	10	0	0	10	0	0
15	86287724	rs11629690	G	A	7	3	10	0	0	10	0	0
15	86287910	rs11073517	C	T	172	249	421	0	6	427	0	0
15	86288387	rs11630274	C	T	254	178	432	0	4	436	0	0
15	86288655	rs17576816	A	C	173	210	383	0	1	384	0	0
15	86289363	rs12905492	G	A	155	119	274	0	0	274	0	0
15	86289879	rs3743326	G	C	168	216	384	0	2	386	0	0
15	86290060	rs3743327	T	C	188	229	417	0	5	423	1	0
15	86290212	rs34121119	G	T	193	187	380	0	1	381	0	0
15	86290940	rs3803506	A	C	301	249	550	0	2	553	1	0
15	86291455	rs3169120	T	C	176	99	275	0	4	280	1	0
15	86291548	rs3169121	T	G	147	209	356	0	2	358	0	0
15	86292114	rs13225	C	G	398	381	779	0	6	785	0	0
15	86292324	rs8110	G	C	127	183	310	0	1	311	0	0
15	86302765	rs8040517	C	T	5	6	11	0	0	11	0	0
15	86303180	rs11556865	C	G	10	13	23	0	2	25	0	0
15	86304002	rs12901134	C	T	6	4	10	0	0	10	0	0
15	89012003	rs76254831	G	A	5	8	13	0	0	13	0	0
15	89421327	rs2280463	A	G	3	3	6	0	0	6	0	0
15	89421405	rs7182726	G	A	3	4	7	0	0	7	0	0
15	89422286	rs3809574	C	T	4	3	7	0	0	7	0	0
15	89430506	rs3743395	C	T	5	9	14	0	0	14	0	0
15	89430544	rs62620238	G	A	7	7	14	0	0	14	0	0
15	89442432	rs2280215	C	G	5	3	8	0	0	8	0	0
15	89450546	rs1878327	C	T	5	5	10	0	0	10	0	0
15	89450587	rs1878326	G	T	7	6	13	0	0	13	0	0
15	89637418	rs293375	C	A	34	22	56	0	0	56	0	0
15	89638091	rs293374	C	T	3	3	6	0	0	6	0	0
15	89638440	rs293373	G	A	7	7	14	0	0	14	0	0
15	89652138	rs293386	G	A	6	1	7	0	0	7	0	0
15	89652552	rs293385	G	A	3	3	6	0	0	6	0	0
15	89653764	rs1033155	A	G	6	1	7	0	0	7	0	0
15	89654197	rs293382	T	A	3	5	8	0	0	8	0	0
15	89654764	rs293401	A	G	8	5	13	0	0	13	0	0
15	89654976	rs293400	T	C	7	4	11	0	0	11	0	0
15	89655405	rs293399	C	G	4	4	8	0	0	8	0	0
15	89656467	rs12442260	T	C	6	14	20	0	1	21	0	0
15	89720921	rs2283439	T	C	5	1	6	0	0	6	0	0
15	89721461	rs2283438	T	C	29	43	72	0	0	72	0	0
15	89863004	.	G	A	7	5	12	0	0	12	0	0
15	90161104	rs12148152	A	G	6	1	7	0	0	7	0	0
15	90168693	rs1866928	T	A	3	3	6	0	0	6	0	0
15	90170237	rs3743372	C	T	3	3	6	0	0	6	0	0
15	90170933	rs3743371	G	A	5	5	10	0	0	10	0	0
15	90171306	rs1054435	A	G	2	6	8	0	0	8	0	0
15	90172834	rs72750748	T	G	3	6	9	0	0	9	0	0
15	90174789	rs9672286	C	T	12	11	23	0	0	23	0	0
15	90174824	rs12900805	C	T	12	7	19	0	0	19	0	0
15	90176073	rs3803530	C	A	6	7	13	0	0	13	0	0
15	90193686	rs12595712	G	A	6	4	10	0	0	10	0	0
15	90328305	rs1042499	T	C	274	284	558	0	3	561	0	0
15	90328551	rs10584	G	C	248	237	485	0	3	488	0	0
15	90334477	rs6496604	A	G	2	7	9	0	1	10	0	0
15	90340725	rs3934	A	C	3	3	6	0	0	6	0	0
15	90344036	rs112938613	G	A	9	6	15	0	0	15	0	0
15	90344352	rs8192297	T	C	151	128	279	0	4	283	0	0
15	90351574	rs10152918	G	A	4	4	8	0	0	8	0	0
15	90352221	rs142760622	A	G	6	3	9	0	0	9	0	0
15	90378463	rs11558579	G	A	83	59	142	0	0	142	0	0
15	90624675	.	G	A	16	35	51	0	0	51	0	0
15	90771704	rs3751656	G	A	18	25	43	0	0	43	0	0
15	90771750	rs3751655	T	G	20	24	44	0	0	44	0	0
15	90772005	rs11547962	G	A	20	22	42	0	0	42	0	0
15	90772156	rs11547961	A	G	14	27	41	0	1	42	0	0
15	90772831	rs7024	C	T	14	6	20	0	0	20	0	0
15	90773782	rs2073706	C	T	3	6	9	0	0	9	0	0
15	90774987	rs2073704	G	A	70	72	142	0	4	146	0	0
15	90775397	rs2073703	G	A	41	48	89	0	0	89	0	0
15	90775700	rs4628940	G	A	67	99	166	0	0	166	0	0
15	90775913	rs8041338	C	T	35	81	116	0	1	117	0	0
15	90775919	rs8025875	T	A	34	85	119	0	1	120	0	0
15	90776154	rs9745131	G	T	23	47	70	0	0	70	0	0
15	90776375	rs9744242	T	C	43	177	220	0	2	222	0	0
15	90816339	rs1059495	C	T	3	3	6	0	0	6	0	0
15	90819641	rs12904877	A	C	9	8	17	0	0	17	0	0
15	90819876	rs7174932	T	C	6	5	11	0	0	11	0	0
15	90820063	rs12909724	T	C	6	8	14	0	0	14	0	0
15	91430617	rs2071384	G	A	4	4	8	0	1	9	0	0
15	91430647	rs28438927	A	C	5	5	10	0	0	10	0	0
15	91430907	rs4932179	G	A	7	5	12	0	0	12	0	0
15	91431255	rs4932374	G	A	4	2	6	0	0	6	0	0
15	91431470	rs4548831	G	A	1	8	9	0	0	9	0	0
15	91431524	rs4533264	T	C	3	7	10	0	0	10	0	0
15	91431856	rs76792278	A	C	6	8	14	0	0	14	0	0
15	91435422	rs12909124	G	A	8	13	21	0	1	22	0	0
15	91435516	rs11638635	C	G	9	11	20	0	0	20	0	0
15	91446472	rs734252	T	C	24	23	47	0	1	48	0	0
15	91449654	rs2072077	T	C	95	98	193	0	1	194	0	0
15	91449702	rs12594307	A	T	100	96	196	0	1	197	0	0
15	91450248	rs2239294	A	T	5	2	7	0	0	7	0	0
15	91450441	rs2677744	G	A	11	5	16	0	0	16	0	0
15	91450524	rs11073958	G	A	15	8	23	0	0	23	0	0
15	91452595	rs2106673	A	G	107	70	177	0	2	179	0	0
15	91454571	rs1266495	T	C	39	30	69	0	0	69	0	0
15	91457810	rs2009105	T	G	5	3	8	0	0	8	0	0
15	91458406	rs72630484	C	G	3	4	7	0	1	8	0	0
15	91458552	rs1266488	T	C	5	5	10	0	0	10	0	0
15	91459925	rs4932377	G	A	3	8	11	0	0	11	0	0
15	91459981	rs4932180	G	A	6	2	8	0	0	8	0	0
15	91463842	rs4773	G	A	221	187	408	0	0	408	0	0
15	91493059	rs17636026	T	C	4	3	7	0	0	7	0	0
15	91509592	rs7601	T	C	140	124	264	0	5	269	0	0
15	91511260	rs12910825	A	G	12	12	24	0	1	25	0	0
15	91542337	rs3743449	C	T	17	15	32	0	0	32	0	0
15	91543761	rs11073964	C	T	62	62	124	0	1	125	0	0
15	91544076	rs12899811	A	G	6	5	11	0	0	11	0	0
15	91549822	rs3826032	G	C	9	12	21	0	0	21	0	0
15	91565804	rs11073967	A	G	4	2	6	0	1	7	0	0
15	92647684	rs72655652	A	C	42	43	85	0	0	85	0	0
15	92689472	rs12901919	G	C	3	4	7	0	0	7	0	0
15	92706594	rs8174	T	C	22	20	42	0	0	42	0	0
15	92707295	rs3743370	C	T	6	2	8	0	0	8	0	0
15	92707909	rs9302356	T	C	8	5	13	0	1	14	0	0
15	92707970	rs3169130	G	A	7	0	7	0	0	7	0	0
15	92708063	rs7497640	T	C	13	4	17	0	0	17	0	0
15	92708268	rs2108601	G	T	9	5	14	0	0	14	0	0
15	92708303	rs7496880	C	T	7	6	13	0	0	13	0	0
15	92708550	rs1060206	T	C	3	11	14	0	0	14	0	0
15	92715571	rs1053909	G	A	25	16	41	0	0	41	0	0
15	93428462	rs77276732	T	C	40	45	85	0	2	87	0	0
15	93429646	rs1439620	A	G	31	25	56	0	0	56	0	0
15	93429654	.	C	A	32	26	58	0	0	58	0	0
15	93431163	rs11074115	C	T	20	19	39	0	1	40	0	0
15	93432448	rs35812522	T	C	9	19	28	0	0	28	0	0
15	93433497	rs368930068	C	T	15	10	25	0	0	25	0	0
15	93433522	rs12438062	C	T	11	11	22	0	0	22	0	0
15	93433530	rs8026336	G	T	11	9	20	0	0	20	0	0
15	93433936	rs4778055	T	G	38	43	81	0	2	83	0	0
15	93434249	rs2119011	G	A	59	44	103	0	2	105	0	0
15	93435225	rs2304655	C	T	60	78	138	0	1	139	0	0
15	93435820	rs34918115	G	T	13	8	21	0	0	21	0	0
15	93435953	rs369480703	G	A	21	18	39	0	0	39	0	0
15	93436311	rs11074116	A	G	38	32	70	0	0	70	0	0
15	93436489	rs12900342	G	A	16	17	33	0	0	33	0	0
15	93438609	rs1992283	G	C	19	16	35	0	0	35	0	0
15	93439224	rs8024067	T	G	11	8	19	0	0	19	0	0
15	93439343	rs8040241	A	C	3	3	6	0	0	6	0	0
15	93441267	rs7743	G	A	693	569	1262	0	4	1266	0	0
15	93441907	rs1439621	A	G	10	13	23	0	0	23	0	0
15	93442379	rs2388023	A	C	5	1	6	0	0	6	0	0
15	93445783	rs12901651	G	A	4	3	7	0	0	7	0	0
15	93446472	rs4146836	C	G	19	13	32	0	0	32	0	0
15	93463477	rs76487856	G	A	7	2	9	0	0	9	0	0
15	93463574	rs34266454	T	C	2	8	10	0	0	10	0	0
15	93464160	rs79551512	A	T	9	7	16	0	0	16	0	0
15	93464376	rs12916015	A	G	6	4	10	0	0	10	0	0
15	93520839	rs1534779	T	C	1	5	6	0	0	6	0	0
15	93526003	rs11634207	A	G	4	2	6	0	0	6	0	0
15	93526893	rs3784786	T	G	5	1	6	0	0	6	0	0
15	93536197	rs2272457	C	T	89	75	164	0	0	164	0	0
15	93536666	rs11074124	G	A	8	6	14	0	0	14	0	0
15	93536910	rs11630052	C	G	6	5	11	0	0	11	0	0
15	93538651	rs10520719	T	C	2	6	8	0	0	8	0	0
15	93539989	rs146471618	C	A	4	6	10	0	0	10	0	0
15	93540089	rs11630582	T	C	4	4	8	0	0	8	0	0
15	93540756	rs1623	G	A	8	5	13	0	0	13	0	0
15	93540997	rs2053359	C	T	4	6	10	0	0	10	0	0
15	93542079	rs7179483	T	C	4	2	6	0	0	6	0	0
15	93542935	rs36048863	G	T	8	4	12	0	0	12	0	0
15	93542942	rs7180629	A	G	4	7	11	0	0	11	0	0
15	93543531	rs4778065	A	T	9	4	13	0	0	13	0	0
15	93547575	rs8042437	T	C	1	5	6	0	0	6	0	0
15	93556976	rs4778067	C	G	6	2	8	0	0	8	0	0
15	93570786	rs1044778	G	C	295	298	593	0	1	594	0	0
15	94408827	rs28417566	C	T	7	5	12	0	0	12	0	0
15	94408850	rs35966742	A	C	8	6	14	0	0	14	0	0
15	94776265	rs12595780	G	T	12	8	20	0	0	20	0	0
15	94776950	rs28732672	T	G	8	5	13	0	0	13	0	0
15	94780241	rs11635007	G	T	21	20	41	0	0	41	0	0
15	94780486	rs12904339	G	A	13	19	32	0	0	32	0	0
15	94780720	rs28750203	C	G	16	18	34	0	1	35	0	0
15	94884108	rs8025851	G	C	4	9	13	0	0	13	0	0
15	94921037	.	A	T	3	3	6	0	0	6	0	0
15	95019387	rs3784637	G	A	4	5	9	0	2	11	0	0
15	95024591	rs3743299	C	T	9	3	12	0	0	12	0	0
15	95024760	rs1048048	T	C	7	6	13	0	1	14	0	0
15	100982978	.	C	T	6	0	6	0	0	6	0	0
15	100982979	.	G	C	0	6	6	0	0	6	0	0
15	100983259	.	C	T	7	0	7	0	0	7	0	0
15	101616113	.	C	T	0	6	6	0	0	6	0	0
15	101716583	rs11433	A	G	89	123	212	0	0	212	0	0
15	101717065	rs3784523	A	G	108	123	231	0	0	231	0	0
15	101717680	rs8024370	G	T	85	91	176	0	0	176	0	0
15	101718097	rs28364839	C	G	70	93	163	0	2	165	0	0
15	101718700	rs2005180	G	A	73	53	126	0	2	128	0	0
15	101728369	.	G	A	34	22	56	0	0	56	0	0
15	101728381	rs7166488	C	T	31	20	51	0	0	51	0	0
15	101778710	rs8033360	C	A	6	6	12	0	0	12	0	0
15	101779863	rs11858464	G	A	5	8	13	0	0	13	0	0
15	101780691	rs58136452	C	T	4	10	14	0	0	14	0	0
15	101781934	rs752092	A	G	4	4	8	0	0	8	0	0
15	101782089	rs8029617	G	A	3	4	7	0	0	7	0	0
15	101782175	rs8031074	C	T	6	1	7	0	0	7	0	0
15	101782187	rs8036047	T	C	5	1	6	0	0	6	0	0
15	101782759	rs11639408	T	C	8	6	14	0	0	14	0	0
15	101784223	rs7182945	C	T	3	4	7	0	1	8	0	0
15	101784281	rs28465510	A	T	2	6	8	0	0	8	0	0
15	101784546	rs12324545	G	A	4	2	6	0	0	6	0	0
15	101784664	rs11247277	A	G	6	2	8	0	0	8	0	0
15	101785970	rs8038272	T	C	4	3	7	0	0	7	0	0
15	101788054	rs11630071	G	A	3	3	6	0	0	6	0	0
15	101789044	rs28498458	C	T	4	3	7	0	0	7	0	0
15	101789505	rs8023810	G	A	4	2	6	0	0	6	0	0
15	101789567	rs8025126	C	T	4	3	7	0	0	7	0	0
15	101791359	rs7176149	C	G	32	29	61	0	0	61	0	0
15	101811293	rs12438654	C	G	24	6	30	0	1	31	0	0
15	101823337	rs12902917	G	T	12	13	25	0	0	25	0	0
15	101823476	rs8028140	A	G	6	6	12	0	0	12	0	0
15	101823639	rs12438426	C	T	7	7	14	0	0	14	0	0
15	101823790	rs4965816	A	C	12	13	25	0	0	25	0	0
15	101824070	rs28622909	G	A	4	3	7	0	0	7	0	0
15	101824271	rs12909636	C	T	8	12	20	0	0	20	0	0
15	101824624	rs12908996	G	A	15	9	24	0	0	24	0	0
15	101825064	rs28415096	G	T	7	4	11	0	0	11	0	0
15	101826919	rs28698071	G	A	24	25	49	0	0	49	0	0
15	101827759	rs35525027	T	C	12	7	19	0	0	19	0	0
15	101827855	rs61752834	C	T	12	11	23	0	0	23	0	0
15	101828423	rs10152335	C	T	8	9	17	0	0	17	0	0
15	101828572	rs10152348	C	T	5	6	11	0	1	12	0	0
15	101828597	rs34314457	G	A	3	6	9	0	0	9	0	0
15	101828923	rs8027101	A	C	3	5	8	0	0	8	0	0
15	101829089	rs6598445	T	G	14	13	27	0	1	28	0	0
15	101829734	rs36106922	C	A	3	10	13	0	0	13	0	0
15	101830534	rs34883767	C	A	7	9	16	0	0	16	0	0
15	101830812	rs12899728	T	C	10	4	14	0	0	14	0	0
15	101831867	rs117729784	C	T	7	8	15	0	0	15	0	0
15	101832055	rs12440683	G	T	7	9	16	0	0	16	0	0
15	101832387	rs8028930	A	G	4	5	9	0	0	9	0	0
15	101832688	rs4965818	T	C	3	4	7	0	1	8	0	0
15	101834320	rs4965819	T	A	6	4	10	0	0	10	0	0
15	101834929	rs4965820	A	G	7	2	9	0	0	9	0	0
15	101844219	rs112505264	A	C	3	3	6	0	0	6	0	0
15	101910550	rs20543	G	A	1	6	7	0	0	7	0	0
15	102183167	.	G	A	5	2	7	0	0	7	0	0
15	102183323	rs11857841	A	G	2	6	8	0	1	9	0	0
15	102183336	rs479913	T	A	2	5	7	0	0	7	0	0
15	102191203	rs527864012	T	C	5	1	6	0	0	6	0	0
15	102192258	rs13329495	G	A	5	2	7	0	0	7	0	0
15	102194288	rs9964	C	T	6	3	9	0	0	9	0	0
15	102224341	rs12901450	G	A	18	12	30	0	0	30	0	0
15	102283990	.	T	C	13	0	13	0	0	13	0	0
15	102284675	.	A	G	43	0	43	0	1	44	0	0
15	102285012	rs568843687	C	T	2	8	10	0	0	10	0	0
15	102507050	.	T	A	7	7	14	0	0	14	0	0
15	102507130	.	G	A	6	0	6	0	0	6	0	0
15	102513166	.	G	C	75	47	122	0	0	122	0	0
15	102513167	.	G	A	99	23	122	0	0	122	0	0
15	102514709	.	C	T	12	2	14	0	0	14	0	0
15	102515149	.	G	A	1	8	9	0	0	9	0	0
15	102515347	.	C	A	195	35	230	0	1	231	0	0
15	102516235	rs75878093	T	C	5	8	13	0	0	13	0	0
15	102516258	rs80332447	T	C	2	8	10	0	0	10	0	0
16	64208	.	G	A	2	40	42	0	0	42	0	0
16	64228	.	A	G	1	38	39	0	0	39	0	0
16	64260	.	A	G	1	79	80	0	1	81	0	0
16	64276	.	G	A	1	79	80	0	1	81	0	0
16	64285	.	T	A	0	82	82	0	2	84	0	0
16	67415	.	C	A	6	7	13	0	1	14	0	0
16	97354	rs8466	A	G	32	59	91	0	0	91	0	0
16	103923	rs2562145	C	G	87	47	134	0	0	134	0	0
16	240280	rs1211375	A	C	5	11	16	0	0	16	0	0
16	240338	rs10153124	T	C	11	6	17	0	0	17	0	0
16	242898	rs111775488	G	C	3	3	6	0	0	6	0	0
16	259345	rs1211378	T	G	4	3	7	0	0	7	0	0
16	264642	rs1203980	C	T	3	3	6	0	0	6	0	0
16	277458	rs1203974	G	A	40	19	59	0	0	59	0	0
16	304514	rs3213508	C	T	56	22	78	0	0	78	0	0
16	312253	rs10903013	A	G	5	4	9	0	0	9	0	0
16	312635	rs11248925	T	C	6	2	8	0	0	8	0	0
16	313202	rs2239738	C	A	6	0	6	0	0	6	0	0
16	315436	rs11248926	G	A	124	87	211	0	6	217	0	0
16	315557	rs7193384	C	G	150	66	216	0	1	217	0	0
16	418597	rs11557302	G	C	265	237	502	0	3	505	0	0
16	447925	rs74784460	C	T	21	38	59	0	0	59	0	0
16	448172	rs431324	A	G	34	43	77	0	1	79	1	0
16	448479	rs387290	C	T	13	21	34	0	1	35	0	0
16	448561	rs11248932	A	T	24	12	36	0	0	36	0	0
16	449345	rs763151	G	C	6	2	8	0	0	8	0	0
16	449659	rs14293	G	A	823	499	1322	0	17	1340	1	0
16	450309	rs5841	C	T	1080	789	1869	0	10	1880	1	0
16	450759	rs407983	C	G	4	4	8	0	0	8	0	0
16	451487	rs2007351	G	A	4	3	7	0	0	7	0	0
16	493844	rs3785299	A	G	1	5	6	0	0	6	0	0
16	570557	rs11537754	T	C	18	7	25	0	0	25	0	0
16	601632	rs3213574	T	C	41	22	63	0	1	64	0	0
16	602313	rs9930550	C	A	20	19	39	0	0	39	0	0
16	603471	rs11248937	A	G	66	47	113	0	0	113	0	0
16	618266	rs183189301	C	T	4	2	6	0	0	6	0	0
16	624114	rs2071979	A	G	10	3	13	0	0	13	0	0
16	624713	rs4984669	C	T	20	26	46	0	0	46	0	0
16	626346	rs2071980	A	C	6	6	12	0	0	12	0	0
16	630902	rs1045274	C	G	31	34	65	0	0	65	0	0
16	632283	rs7187227	G	A	25	30	55	0	1	56	0	0
16	633125	rs1045277	T	C	28	31	59	0	0	59	0	0
16	633353	rs710924	T	C	40	44	84	0	0	84	0	0
16	633354	rs710925	G	A	40	44	84	0	0	84	0	0
16	633706	rs1045283	C	T	65	53	118	0	0	118	0	0
16	633843	rs8675	A	G	42	45	87	0	1	88	0	0
16	633851	rs8909	T	C	37	45	82	0	1	83	0	0
16	671245	rs11648607	G	A	2	6	8	0	0	8	0	0
16	674601	rs72767889	C	T	3	3	6	0	0	6	0	0
16	675680	rs763014	T	C	0	6	6	0	0	6	0	0
16	677854	rs15564	G	T	20	20	40	0	0	40	0	0
16	678020	rs11548188	G	A	13	18	31	0	1	32	0	0
16	707099	.	G	A	11	18	29	0	0	29	0	0
16	723838	rs1045729	C	A	132	135	267	0	3	270	0	0
16	726907	rs111852492	C	T	3	5	8	0	0	8	0	0
16	730955	rs72773412	A	T	3	4	7	0	0	7	0	0
16	731725	rs6597	T	G	74	76	150	0	0	150	0	0
16	737269	rs17850290	C	T	9	7	16	0	0	16	0	0
16	772061	rs55956436	C	T	6	5	11	0	0	11	0	0
16	778024	rs1406814	T	C	3	3	6	0	0	6	0	0
16	778820	rs12448432	G	A	6	15	21	0	0	21	0	0
16	780339	rs7205337	A	G	30	26	56	0	0	56	0	0
16	781633	rs3829492	G	A	12	24	36	0	1	37	0	0
16	784765	rs9928077	C	T	19	11	30	0	0	30	0	0
16	787738	rs12597563	G	C	5	1	6	0	0	6	0	0
16	789618	rs10794640	G	A	7	6	13	0	0	13	0	0
16	835508	rs74587236	G	A	69	56	125	0	2	127	0	0
16	839269	rs77682584	G	A	17	14	31	0	1	32	0	0
16	840378	rs3765263	A	G	43	35	78	0	2	80	0	0
16	840599	rs59706474	C	T	39	40	79	0	1	80	0	0
16	841157	.	G	T	18	19	37	0	1	38	0	0
16	841175	rs2063911	C	T	43	38	81	0	1	82	0	0
16	841617	rs74001028	C	T	12	7	19	0	0	19	0	0
16	841710	rs742318	C	G	12	14	26	0	0	26	0	0
16	845819	rs2294446	A	G	58	51	109	0	0	109	0	0
16	847936	rs117923274	C	T	77	49	126	0	0	126	0	0
16	848013	rs28396288	G	A	52	24	76	0	1	77	0	0
16	1004605	rs12448005	A	G	7	7	14	0	0	14	0	0
16	1278424	rs1060341	G	A	5	1780	1785	0	3	1789	1	0
16	1279438	rs202041848	C	T	2	540	542	0	4	546	0	0
16	1279574	rs199887053	C	G	1	747	748	0	1	749	0	0
16	1279584	rs111992451	T	C	2	803	805	0	0	805	0	0
16	1279704	.	A	G	9	553	562	0	5	567	0	0
16	1279710	.	G	A	9	463	472	0	7	479	0	0
16	1279714	.	A	G	10	421	431	0	4	435	0	0
16	1279717	.	C	T	10	321	331	0	8	339	0	0
16	1279732	.	C	A	10	296	306	0	1	307	0	0
16	1280087	rs143547788	G	C	8	3	11	0	0	11	0	0
16	1291188	.	C	T	458	14	472	0	3	475	0	0
16	1291622	rs149113013	A	G	583	2	585	0	2	587	0	0
16	1291941	.	G	A	9	493	502	0	4	506	0	0
16	1291972	.	C	G	8	556	564	0	1	565	0	0
16	1291975	.	G	A	7	497	504	0	8	512	0	0
16	1291989	.	C	A	10	337	347	0	3	350	0	0
16	1292085	.	C	T	17	595	612	0	6	618	0	0
16	1292147	.	G	A	26	901	927	0	19	946	0	0
16	1306268	rs1969652	C	T	46	0	46	0	0	46	0	0
16	1306355	rs1800984	T	C	26	63	89	0	0	89	0	0
16	1306642	rs61739908	C	T	39	23	62	0	0	62	0	0
16	1306918	.	C	T	41	1166	1207	0	4	1212	1	0
16	1306921	.	G	A	41	1078	1119	0	3	1122	0	0
16	1306927	.	C	T	44	1173	1217	0	5	1222	0	0
16	1306971	.	A	G	50	885	935	0	1	936	0	0
16	1306973	.	A	G	47	881	928	0	4	933	1	0
16	1306981	rs2272971	G	A	1136	6	1142	0	5	1147	0	0
16	1360657	rs72775490	C	T	16	7	23	0	1	24	0	0
16	1365267	.	G	C	8	7	15	0	0	15	0	0
16	1373017	rs11648216	G	A	5	2	7	0	1	8	0	0
16	1373024	rs11648562	C	G	3	3	6	0	2	8	0	0
16	1374524	rs761059	A	G	20	9	29	0	0	29	0	0
16	1375937	rs12925270	C	A	13	12	25	0	0	25	0	0
16	1397815	rs1132358	C	T	4	3	7	0	0	7	0	0
16	1411107	.	C	G	2	4	6	0	0	6	0	0
16	1509886	.	T	G	5	2	7	0	4	12	1	0
16	1546208	rs28655879	C	T	4	4	8	0	0	8	0	0
16	1559838	rs3180228	T	C	82	78	160	0	1	161	0	0
16	1560111	rs9454	C	T	80	92	172	0	0	172	0	0
16	1560886	rs1053730	A	G	12	11	23	0	2	25	0	0
16	1561446	rs2667688	A	G	0	7	7	0	0	7	0	0
16	1562026	rs8048290	T	C	4	21	25	0	0	25	0	0
16	1562460	rs8048980	T	C	3	8	11	0	0	11	0	0
16	1569252	rs3784820	G	A	5	1	6	0	0	6	0	0
16	1574863	rs2235640	G	A	7	5	12	0	0	12	0	0
16	1608082	rs2076436	A	G	4	6	10	0	0	10	0	0
16	1614097	rs8048410	A	G	6	4	10	0	0	10	0	0
16	1664931	rs7201813	T	C	15	6	21	0	0	21	0	0
16	1706435	rs61739874	C	T	37	28	65	0	0	65	0	0
16	1716010	rs8058190	A	C	4	2	6	0	0	6	0	0
16	1814019	rs2974846	G	C	10	4	14	0	0	14	0	0
16	1814440	rs2294619	A	G	42	46	88	0	2	90	0	0
16	1817431	rs2575369	C	T	11	19	30	0	0	30	0	0
16	1819020	rs2076432	A	T	26	38	64	0	1	65	0	0
16	1819433	rs2575329	G	A	92	94	186	0	27	213	0	0
16	1826302	rs2437732	G	T	8	2	10	0	0	10	0	0
16	1827836	rs1178432	T	C	168	162	330	0	3	333	0	0
16	1830437	rs1178433	G	A	29	26	55	0	0	55	0	0
16	1830551	rs1178434	C	G	27	22	49	0	0	49	0	0
16	1830621	rs1178435	T	C	24	11	35	0	0	35	0	0
16	1831653	rs1178436	T	C	5	4	9	0	0	9	0	0
16	1835231	rs2745170	G	T	4	3	7	0	0	7	0	0
16	1835393	rs2575352	A	G	7	3	10	0	0	10	0	0
16	1836255	rs344357	C	G	6	2	8	0	0	8	0	0
16	1836796	rs2235648	C	A	62	35	97	0	0	97	0	0
16	1838640	rs344359	T	C	154	143	297	0	1	298	0	0
16	1838836	rs1065656	C	G	154	108	262	0	4	266	0	0
16	1839023	rs1065663	G	A	133	89	222	0	1	223	0	0
16	1839134	rs1065666	T	C	42	36	78	0	1	79	0	0
16	1859150	rs1057071	G	A	21	15	36	0	0	36	0	0
16	1859153	rs1057070	T	C	21	14	35	0	1	36	0	0
16	1869987	rs114352351	C	T	57	32	89	0	1	90	0	0
16	1877494	rs3743854	T	C	7	8	15	0	0	15	0	0
16	1877558	rs3743853	G	A	10	15	25	0	0	25	0	0
16	1878031	rs1143032	G	A	8	18	26	0	0	26	0	0
16	1878032	rs1143033	C	T	8	18	26	0	0	26	0	0
16	1878067	rs1143034	C	G	6	13	19	0	0	19	0	0
16	1878492	rs1065583	G	A	15	39	54	0	1	55	0	0
16	1878521	rs1065584	C	G	17	41	58	0	1	59	0	0
16	1878597	rs1065585	T	C	11	37	48	0	2	50	0	0
16	1878641	rs1065586	A	C	8	40	48	0	0	48	0	0
16	1878740	rs1065587	A	G	9	23	32	0	0	32	0	0
16	1878801	rs1065589	G	T	11	15	26	0	0	26	0	0
16	1878852	rs1065590	T	C	7	10	17	0	0	17	0	0
16	2014031	rs6366	C	G	8	16	24	0	0	24	0	0
16	2014283	rs2286466	A	G	5333	123	5456	0	52	5508	0	0
16	2014424	rs403609	C	G	6	24	30	0	1	31	0	0
16	2014979	rs2302177	G	T	6	100	106	0	1	107	0	0
16	2034661	rs2075812	T	C	13	17	30	0	0	30	0	0
16	2035762	rs72766613	T	C	5	2	7	0	0	7	0	0
16	2036048	rs1046495	T	C	40	41	81	0	0	81	0	0
16	2036216	rs61729106	T	A	23	20	43	0	0	43	0	0
16	2036408	rs186856814	G	A	26	27	53	0	0	53	0	0
16	2036631	rs17135743	A	G	21	28	49	0	0	49	0	0
16	2036663	rs11859464	C	T	35	18	53	0	0	53	0	0
16	2036780	rs17135745	C	T	20	21	41	0	0	41	0	0
16	2036935	rs11542302	T	C	20	28	48	0	0	48	0	0
16	2036937	rs11859311	G	C	28	20	48	0	1	49	0	0
16	2037595	rs11860328	G	C	9	13	22	0	0	22	0	0
16	2047891	rs9081	C	A	263	242	505	0	1	507	1	0
16	2048796	rs1058474	C	T	250	224	474	0	1	475	0	0
16	2048943	rs377386417	C	A	7	2	9	0	0	9	0	0
16	2049728	rs11248905	C	T	127	104	231	0	1	232	0	0
16	2049849	rs12149722	T	C	99	63	162	0	2	164	0	0
16	2050192	rs11556528	G	T	124	141	265	0	4	269	0	0
16	2050346	rs3743846	A	G	8	7	15	0	0	15	0	0
16	2050635	rs8045302	C	G	5	1	6	0	0	6	0	0
16	2051060	rs61743532	T	A	73	98	171	0	3	174	0	0
16	2051428	rs72766631	G	A	12	10	22	0	0	22	0	0
16	2051452	rs117679198	C	G	12	12	24	0	0	24	0	0
16	2051943	rs556053184	C	G	76	81	157	0	2	159	0	0
16	2054155	rs8045887	G	A	6	3	9	0	0	9	0	0
16	2054969	rs72766633	T	C	16	5	21	0	1	22	0	0
16	2054981	rs72766634	A	G	16	7	23	0	1	24	0	0
16	2055110	rs72766635	C	T	5	10	15	0	0	15	0	0
16	2055200	rs72766636	G	A	9	9	18	0	0	18	0	0
16	2055342	rs17653678	C	T	12	8	20	0	1	21	0	0
16	2055572	rs376956175	T	C	4	3	7	0	0	7	0	0
16	2055644	rs72766637	G	A	7	2	9	0	0	9	0	0
16	2055820	rs72766639	G	A	8	5	13	0	0	13	0	0
16	2055853	rs17653749	G	A	5	3	8	0	0	8	0	0
16	2056080	rs35397583	A	G	8	5	13	0	0	13	0	0
16	2056351	rs72766641	A	G	12	8	20	0	0	20	0	0
16	2057318	rs549691262	G	A	2	9	11	0	1	12	0	0
16	2058040	rs740582	T	A	7	6	13	0	0	13	0	0
16	2058527	rs191256718	A	G	7	5	12	0	0	12	0	0
16	2070568	rs2286472	A	C	298	321	619	0	0	619	0	0
16	2083358	rs11544570	A	G	5	5	10	0	0	10	0	0
16	2085680	rs2516781	C	T	6	7	13	0	0	13	0	0
16	2087562	rs1132368	G	A	30	35	65	0	1	66	0	0
16	2132417	rs201878712	C	T	5	3	8	0	0	8	0	0
16	2132731	rs9928737	G	A	10	7	17	0	0	17	0	0
16	2138269	rs1748	T	C	93	87	180	0	2	182	0	0
16	2138584	rs1051771	G	C	56	76	132	0	2	134	0	0
16	2139127	rs3087631	A	T	32	52	84	0	3	87	0	0
16	2140010	rs7203729	A	G	34	36	70	0	0	70	0	0
16	2140454	rs3087632	T	C	23	31	54	0	1	55	0	0
16	2140680	rs10960	T	C	29	37	66	0	1	67	0	0
16	2144176	rs34197769	G	A	33	38	71	0	0	71	0	0
16	2147357	rs7194935	G	A	35	26	61	0	0	61	0	0
16	2152129	rs12926160	A	G	13	1	14	0	0	14	0	0
16	2152387	rs9925969	A	G	17	18	35	0	0	35	0	0
16	2152388	rs9935834	C	G	16	18	34	0	1	35	0	0
16	2153619	rs117856830	G	A	17	16	33	0	1	34	0	0
16	2155426	rs9936785	T	C	11	6	17	0	0	17	0	0
16	2155881	rs143124196	G	A	10	13	23	0	0	23	0	0
16	2156021	rs28575767	A	G	16	5	21	0	0	21	0	0
16	2156447	rs2003782	G	A	5	3	8	0	1	9	0	0
16	2156613	rs115772084	G	A	14	9	23	0	0	23	0	0
16	2156850	rs2457533	A	G	16	5	21	0	0	21	0	0
16	2159714	rs143916489	C	T	4	5	9	0	0	9	0	0
16	2159996	rs9935526	G	A	10	9	19	0	0	19	0	0
16	2160503	rs71385734	T	G	5	2	7	0	0	7	0	0
16	2161679	rs139744826	G	A	3	7	10	0	0	10	0	0
16	2161744	rs142202785	G	A	2	7	9	0	0	9	0	0
16	2162361	rs2549677	A	G	13	4	17	0	0	17	0	0
16	2162887	rs2369068	A	G	9	9	18	0	0	18	0	0
16	2164330	rs142357713	T	G	10	6	16	0	0	16	0	0
16	2204835	rs13242	T	C	193	151	344	0	2	346	0	0
16	2225436	.	G	A	7	11	18	0	0	18	0	0
16	2227087	.	C	T	79	88	167	0	7	174	0	0
16	2258753	rs201818053	C	T	4	3	7	0	0	7	0	0
16	2259191	rs3160	T	C	101	114	215	0	0	215	0	0
16	2262071	rs114996223	C	T	11	1	12	0	0	12	0	0
16	2262334	.	C	G	15	12	27	0	0	27	0	0
16	2262857	rs112511919	C	T	5	3	8	0	0	8	0	0
16	2262987	rs62038850	G	A	2	4	6	0	1	7	0	0
16	2280277	rs27382	G	A	5	5	10	0	0	10	0	0
16	2280318	rs26837	G	A	4	7	11	0	0	11	0	0
16	2281151	rs26838	G	C	4	6	10	0	0	10	0	0
16	2281829	rs27709	G	A	8	8	16	0	1	17	0	0
16	2285357	rs26840	C	T	60	60	120	0	0	120	0	0
16	2303353	rs7299	T	C	676	542	1218	0	7	1225	0	0
16	2303371	rs7298	C	A	725	674	1399	0	2	1401	0	0
16	2305539	rs155243	A	G	4	3	7	0	0	7	0	0
16	2306008	rs150930	A	C	19	16	35	0	0	35	0	0
16	2308204	rs4787270	G	A	6	3	9	0	0	9	0	0
16	2313774	rs12444273	C	T	17	7	24	0	2	26	0	0
16	2316383	.	G	A	22	21	43	0	0	43	0	0
16	2317777	rs11646649	C	G	17	13	30	0	0	30	0	0
16	2317778	rs11642797	T	G	17	13	30	0	0	30	0	0
16	2323394	rs12599229	G	A	1	7	8	0	0	8	0	0
16	2512523	rs3810794	G	A	6	6	12	0	0	12	0	0
16	2647876	rs10866	C	T	10	11	21	0	0	21	0	0
16	2661042	.	C	T	2	6	8	0	0	8	0	0
16	2806211	rs117726522	C	T	6	3	9	0	0	9	0	0
16	2810623	rs2285879	T	G	4	4	8	0	0	8	0	0
16	2812939	rs2240140	C	A	288	251	539	0	10	549	0	0
16	2812949	.	A	C	262	272	534	0	7	541	0	0
16	2819178	rs79439891	C	T	752	692	1444	0	15	1459	0	0
16	2821763	rs1058855	C	G	51	42	93	0	0	93	0	0
16	2882197	rs12373	G	T	25	22	47	0	0	47	0	0
16	2882267	rs886953	G	C	2	6	8	0	0	8	0	0
16	2945248	rs1063677	G	C	44	39	83	0	0	83	0	0
16	2949248	rs7281	T	C	39	43	82	0	3	87	2	0
16	2962102	rs3743947	C	T	3	4	7	0	0	7	0	0
16	2962104	rs3743948	G	A	4	4	8	0	0	8	0	0
16	2964283	rs2074365	G	A	13	12	25	0	0	25	0	0
16	2984382	.	A	G	6	1	7	0	0	7	0	0
16	2987279	rs61747750	G	T	13	5	18	0	0	18	0	0
16	3001035	rs757277	G	A	5	7	12	0	0	12	0	0
16	3022261	rs7189958	C	T	12	17	29	0	0	29	0	0
16	3056462	rs2717706	T	A	3	5	8	0	1	9	0	0
16	3063264	rs2227269	C	T	7	1	8	0	0	8	0	0
16	3070788	rs8052002	G	C	19	17	36	0	0	36	0	0
16	3071964	rs13209	T	C	38	44	82	0	0	82	0	0
16	3073240	rs10508	G	T	110	93	203	0	18	221	0	0
16	3075999	rs2245000	C	G	3	5	8	0	1	9	0	0
16	3119167	rs34184287	T	C	12	0	12	0	0	12	0	0
16	3119304	.	A	G	25	0	25	0	1	26	0	0
16	3136919	rs4786384	T	C	9	5	14	0	0	14	0	0
16	3136946	rs7196127	T	C	11	4	15	0	0	15	0	0
16	3181963	rs1053871	T	C	15	17	32	0	0	32	0	0
16	3181996	rs11649450	G	A	15	20	35	0	0	35	0	0
16	3191356	rs2735537	G	A	6	4	10	0	0	10	0	0
16	3192651	rs1053996	T	C	12	17	29	0	0	29	0	0
16	3192673	rs1053997	T	C	7	16	23	0	0	23	0	0
16	3192741	rs1053998	C	G	6	12	18	0	0	18	0	0
16	3432594	rs1044390	T	A	20	24	44	0	0	44	0	0
16	3447282	rs27241	C	G	16	10	26	0	0	26	0	0
16	3450907	rs1878931	G	C	4	3	7	0	0	7	0	0
16	3451881	rs37810	C	T	16	34	50	0	0	50	0	0
16	3455247	rs37814	C	T	4	4	8	0	0	8	0	0
16	3462595	rs2680221	A	G	4	4	8	0	1	9	0	0
16	3530752	rs72778116	A	G	2	4	6	0	0	6	0	0
16	3531343	rs145121748	C	T	1	6	7	0	0	7	0	0
16	3531827	rs72778117	T	C	3	4	7	0	0	7	0	0
16	3533577	rs1137454	C	G	122	110	232	0	2	234	0	0
16	3533881	rs4453493	T	C	32	28	60	0	0	60	0	0
16	3534451	rs757270	C	T	29	29	58	0	0	58	0	0
16	3534831	rs17793994	C	G	152	90	242	0	0	242	0	0
16	3534892	rs13740	G	A	177	117	294	0	1	295	0	0
16	3535116	rs4785936	T	C	44	36	80	0	0	80	0	0
16	3535540	rs2240075	G	A	142	115	257	0	1	258	0	0
16	3536444	rs2285815	C	T	198	133	331	0	4	335	0	0
16	3536872	rs2736	G	A	158	96	254	0	1	255	0	0
16	3586230	rs9790	C	T	10	7	17	0	0	17	0	0
16	3589110	rs1134597	G	A	8	2	10	0	0	10	0	0
16	3590600	rs1609847	A	C	7	4	11	0	0	11	0	0
16	3594316	rs74760019	C	T	2	7	9	0	0	9	0	0
16	3639139	rs3810812	A	G	5	4	9	0	0	9	0	0
16	3707747	rs1053874	G	A	1	5	6	0	0	6	0	0
16	3721773	rs1136948	G	C	163	134	297	0	0	297	0	0
16	3724465	rs13926	G	C	137	141	278	0	2	280	0	0
16	3724857	rs2074805	A	T	5	8	13	0	0	13	0	0
16	3777836	rs55916120	T	C	163	129	292	0	3	295	0	0
16	4015313	rs1045476	A	G	4	2	6	0	0	6	0	0
16	4015316	rs1045475	A	G	4	3	7	0	0	7	0	0
16	4015729	rs879620	C	T	2	4	6	0	0	6	0	0
16	4016676	rs2230742	A	G	1	6	7	0	0	7	0	0
16	4027605	rs2240735	C	T	3	8	11	0	0	11	0	0
16	4164337	rs887248	C	T	7	13	20	0	0	20	0	0
16	4386524	rs62037613	G	A	1	5	6	0	0	6	0	0
16	4441725	.	C	T	9	3	12	0	0	12	0	0
16	4506232	rs4786494	G	A	16	18	34	0	1	35	0	0
16	4519548	rs62039231	A	G	16	4	20	0	0	20	0	0
16	4524443	rs2058812	C	G	55	45	100	0	2	102	0	0
16	4558615	rs2270366	G	A	7	8	15	0	0	15	0	0
16	4560929	rs7702	G	C	2	6	8	0	0	8	0	0
16	4562351	rs8129	T	C	74	96	170	0	1	171	0	0
16	4562512	rs7665	A	G	87	80	167	0	1	168	0	0
16	4588394	rs863501	G	C	6	2	8	0	0	8	0	0
16	4708551	.	C	A	4	3	7	0	2	9	0	0
16	4722055	rs141768641	C	T	5	6	11	0	0	11	0	0
16	4726451	rs1684604	C	G	5	8	13	0	1	14	0	0
16	4735528	rs865775	C	T	3	4	7	0	0	7	0	0
16	4735631	rs1684588	T	G	4	4	8	0	0	8	0	0
16	4736316	rs841225	C	T	4	7	11	0	0	11	0	0
16	4736834	rs841224	G	A	8	8	16	0	1	17	0	0
16	4737981	rs841223	G	A	11	13	24	0	0	24	0	0
16	4738251	rs841222	T	C	4	6	10	0	0	10	0	0
16	4739514	rs1684590	T	C	31	35	66	0	0	66	0	0
16	4740208	rs3747592	T	G	64	62	126	0	4	130	0	0
16	4740441	rs1045518	G	C	87	95	182	0	3	185	0	0
16	4740444	rs1045519	C	T	91	100	191	0	1	192	0	0
16	4740477	rs1045520	T	C	111	126	237	0	0	237	0	0
16	4740602	rs841220	T	C	94	151	245	0	2	247	0	0
16	4746829	rs841216	A	G	12	12	24	0	0	24	0	0
16	4748825	rs841214	C	T	6	2	8	0	0	8	0	0
16	4751045	rs863980	C	T	14	9	23	0	0	23	0	0
16	4752134	rs841210	A	G	7	4	11	0	0	11	0	0
16	4801366	rs11076845	C	G	7	8	15	0	0	15	0	0
16	4801419	rs11076846	A	G	8	8	16	0	0	16	0	0
16	4801723	rs921863	G	A	4	4	8	0	0	8	0	0
16	4801842	rs921864	G	A	1	6	7	0	0	7	0	0
16	4802370	rs3747601	C	A	3	7	10	0	0	10	0	0
16	4802386	rs3747602	G	T	4	8	12	0	0	12	0	0
16	4814037	rs7191598	C	G	4	2	6	0	0	6	0	0
16	4847169	rs8118	G	A	199	171	370	0	4	374	0	0
16	4847317	rs7546	C	T	252	171	423	0	9	432	0	0
16	4850414	rs144111721	C	A	7	4	11	0	0	11	0	0
16	4854648	rs17624872	G	A	76	48	124	0	1	125	0	0
16	4855279	rs8064024	A	G	44	35	79	0	0	79	0	0
16	4864101	rs930854	A	G	7	6	13	0	1	14	0	0
16	4864104	rs139093431	C	T	8	5	13	0	0	13	0	0
16	4864179	rs930855	A	G	7	9	16	0	0	16	0	0
16	4866189	rs77500958	G	A	6	10	16	0	0	16	0	0
16	4866547	rs78417771	C	G	3	3	6	0	0	6	0	0
16	4867124	rs1966897	C	G	5	2	7	0	1	8	0	0
16	4867565	rs6500635	A	G	2	7	9	0	0	9	0	0
16	4868912	rs73515173	G	A	5	5	10	0	0	10	0	0
16	4896647	rs8050525	G	C	19	30	49	0	1	50	0	0
16	4896730	rs2072594	G	C	16	24	40	0	0	40	0	0
16	4896780	rs4141486	A	C	15	19	34	0	3	37	0	0
16	4897153	rs2072595	A	G	6	11	17	0	0	17	0	0
16	4908956	rs8060576	C	T	9	12	21	0	0	21	0	0
16	4911195	rs960006	T	C	8	11	19	0	0	19	0	0
16	4911239	rs1395602	A	C	8	13	21	0	0	21	0	0
16	4922201	rs12446456	C	T	11	7	18	0	0	18	0	0
16	4926142	rs2660222	G	A	1	5	6	0	0	6	0	0
16	4927799	.	T	A	6	3	9	0	0	9	0	0
16	4929269	rs11076854	A	G	14	7	21	0	0	21	0	0
16	5075542	rs887854	G	A	14	19	33	0	0	33	0	0
16	5075633	rs7188856	G	A	14	13	27	0	0	27	0	0
16	5132636	rs1047732	C	T	28	41	69	0	0	69	0	0
16	5134774	rs9745522	T	A	24	27	51	0	0	51	0	0
16	5135380	rs6775	A	G	7	4	11	0	0	11	0	0
16	5139186	rs12928528	G	C	7	3	10	0	0	10	0	0
16	5139217	rs9745857	C	G	3	5	8	0	0	8	0	0
16	8716036	rs8062874	C	T	2	7	9	0	0	9	0	0
16	8716041	rs6498208	G	T	1	6	7	0	1	8	0	0
16	8716107	rs6498214	A	C	2	5	7	0	0	7	0	0
16	8716624	rs8063843	C	T	9	3	12	0	0	12	0	0
16	8716906	rs117695817	C	T	3	5	8	0	0	8	0	0
16	8722629	rs2270286	G	C	45	47	92	0	0	92	0	0
16	8728999	rs151312932	G	A	4	3	7	0	0	7	0	0
16	8889628	rs12049	T	C	3	3	6	0	0	6	0	0
16	8941934	rs2075828	C	A	9	2	11	0	1	12	0	0
16	8942941	rs78698557	C	G	27	20	47	0	1	48	0	0
16	8945705	rs2053207	C	G	5	4	9	0	0	9	0	0
16	8946904	rs1058982	C	A	49	57	106	0	0	106	0	0
16	8947077	rs1657067	G	A	123	79	202	0	2	204	0	0
16	8948473	rs2447924	A	C	10	4	14	0	0	14	0	0
16	8948898	rs6899	T	G	39	60	99	0	1	100	0	0
16	8949187	rs2231709	C	T	3	7	10	0	0	10	0	0
16	8949220	rs2231708	C	T	2	10	12	0	0	12	0	0
16	8949455	rs11647985	T	A	2	4	6	0	0	6	0	0
16	8949647	rs4985056	G	A	5	2	7	0	0	7	0	0
16	8950250	rs17566813	A	C	2	9	11	0	0	11	0	0
16	8950273	rs2437704	T	C	9	2	11	0	0	11	0	0
16	8950326	rs116632308	C	A	2	10	12	0	0	12	0	0
16	8950418	rs1657069	G	T	4	2	6	0	0	6	0	0
16	8951323	.	A	G	4	2	6	0	2	8	0	0
16	8951392	rs7500728	G	C	5	4	9	0	0	9	0	0
16	8951579	rs140347645	C	T	7	4	11	0	0	11	0	0
16	8951714	rs2017185	G	A	9	2	11	0	0	11	0	0
16	8952113	rs62033507	C	A	7	2	9	0	0	9	0	0
16	8952524	rs3743802	A	G	11	13	24	0	0	24	0	0
16	8952790	rs79516099	C	G	14	11	25	0	0	25	0	0
16	8953081	rs8097	C	G	217	155	372	0	1	373	0	0
16	8953484	rs3743803	C	T	2	6	8	0	0	8	0	0
16	8953700	rs1677484	T	C	6	0	6	0	0	6	0	0
16	8954058	rs34242778	C	A	0	6	6	0	0	6	0	0
16	8956633	rs117038397	G	A	2	4	6	0	0	6	0	0
16	8988188	rs899254	A	G	14	22	36	0	0	36	0	0
16	8988692	rs11551183	C	G	344	336	680	0	4	684	0	0
16	8990239	rs11801	T	C	3	4	7	0	1	8	0	0
16	8992342	rs2304465	G	A	3	3	6	0	0	6	0	0
16	9187256	rs8047402	C	T	7	0	7	0	0	7	0	0
16	9189524	rs12931763	C	T	9	1	10	0	0	10	0	0
16	9189823	rs34839208	G	C	5	1	6	0	0	6	0	0
16	9197429	rs76845905	A	G	181	103	284	0	6	290	0	0
16	9198987	rs12447184	G	C	286	189	475	0	6	481	0	0
16	9199036	rs1133686	T	A	233	156	389	0	4	393	0	0
16	9199213	rs12919043	C	G	117	89	206	0	2	208	0	0
16	9200015	rs77781667	C	T	78	115	193	0	0	194	1	0
16	9200238	rs13333477	A	G	90	77	167	0	9	176	0	0
16	9200322	rs9928759	A	C	125	134	259	0	3	262	0	0
16	9200547	rs12918271	T	C	66	69	135	0	1	136	0	0
16	9200910	rs36058934	T	C	80	81	161	0	4	165	0	0
16	9201970	rs7186634	G	T	68	58	126	0	0	126	0	0
16	9203594	rs9940147	T	A	178	186	364	0	4	368	0	0
16	9203648	rs9937728	A	C	198	189	387	0	13	401	1	0
16	9203871	rs9937906	A	G	280	232	512	0	3	515	0	0
16	9203899	rs11075212	G	A	302	263	565	0	5	570	0	0
16	9204805	rs112431913	G	T	347	313	660	0	4	664	0	0
16	9205363	rs9039	T	C	346	382	728	0	12	740	0	0
16	9205982	rs1127997	C	G	26	47	73	0	0	73	0	0
16	9207003	rs1128001	T	C	16	17	33	0	0	33	0	0
16	9213419	rs6777	A	C	6	11	17	0	1	18	0	0
16	10480388	rs78684162	C	T	34	36	70	0	1	71	0	0
16	10995850	rs6498124	G	T	9	5	14	0	0	14	0	0
16	11000848	rs4774	G	C	18	26	44	0	0	44	0	0
16	11001770	rs34654419	G	T	20	17	37	0	0	37	0	0
16	11002626	rs4780334	G	A	5	3	8	0	0	8	0	0
16	11002904	rs2228238	G	A	36	37	73	0	0	73	0	0
16	11020235	rs1139565	C	T	6	7	13	0	1	14	0	0
16	11020255	rs8052709	A	G	8	9	17	0	0	17	0	0
16	11020455	rs11648656	T	C	4	6	10	0	0	10	0	0
16	11020831	rs12932240	A	G	6	9	15	0	1	16	0	0
16	11021247	rs3205043	C	T	6	8	14	0	0	14	0	0
16	11023208	rs3087519	T	C	32	27	59	0	0	59	0	0
16	11025054	rs3922481	A	G	8	5	13	0	0	13	0	0
16	11031156	rs4780338	C	T	3	7	10	0	0	10	0	0
16	11036465	.	A	G	13	6	19	0	0	19	0	0
16	11056378	rs16957839	C	T	16	22	38	0	0	38	0	0
16	11056618	rs1700820	A	G	9	14	23	0	0	23	0	0
16	11056764	rs3871209	A	G	11	15	26	0	0	26	0	0
16	11056920	rs3871208	C	A	15	11	26	0	0	26	0	0
16	11056923	rs1700819	C	A	15	12	27	0	0	27	0	0
16	11057269	rs1700818	C	G	17	15	32	0	1	33	0	0
16	11057873	rs8046423	C	T	12	15	27	0	0	27	0	0
16	11058564	rs77599345	C	G	10	12	22	0	0	22	0	0
16	11150071	rs61280649	G	C	8	11	19	0	0	19	0	0
16	11150098	rs12924259	G	C	11	11	22	0	1	23	0	0
16	11150140	rs58102322	G	A	12	11	23	0	0	23	0	0
16	11150248	rs876476	G	A	17	11	28	0	0	28	0	0
16	11154770	rs2286973	G	A	10	9	19	0	0	19	0	0
16	11273459	rs62023563	C	T	6	3	9	0	0	9	0	0
16	11441748	rs12149020	A	G	1	5	6	0	0	6	0	0
16	11442279	rs7191093	A	G	4	3	7	0	0	7	0	0
16	11444572	rs7204628	A	C	2	13	15	0	0	15	0	0
16	11444716	rs2032932	A	G	22	4	26	0	0	26	0	0
16	11444726	rs6498185	C	T	5	22	27	0	0	27	0	0
16	11445404	rs1061128	A	G	41	15	56	0	0	56	0	0
16	11445552	rs1541702	T	C	14	4	18	0	0	18	0	0
16	11592004	rs7194483	A	G	3	7	10	0	0	10	0	0
16	11592105	rs7194686	A	G	5	7	12	0	0	12	0	0
16	11642242	rs7102	T	C	199	553	752	0	6	758	0	0
16	11650325	rs3743582	G	A	8	2	10	0	0	10	0	0
16	11763734	rs78891184	C	T	4	4	8	0	0	8	0	0
16	11764329	rs8191279	G	C	7	1	8	0	0	8	0	0
16	11764920	rs7193637	C	T	3	4	7	0	0	7	0	0
16	11766905	rs8191295	A	G	6	1	7	0	0	7	0	0
16	11766986	rs8191297	T	C	7	1	8	0	0	8	0	0
16	11767055	rs8191298	C	A	8	3	11	0	0	11	0	0
16	11769176	rs12921129	C	T	2	5	7	0	0	7	0	0
16	11769266	rs8045300	C	G	5	5	10	0	0	10	0	0
16	11769948	rs1050068	C	T	37	31	68	0	0	68	0	0
16	11769963	rs1050069	C	T	37	30	67	0	2	69	0	0
16	11770777	rs7194034	A	G	21	31	52	0	1	53	0	0
16	11771094	rs7198518	C	G	25	30	55	0	1	56	0	0
16	11771353	rs8191335	C	A	35	45	80	0	1	81	0	0
16	11773662	rs3190321	C	G	593	486	1079	0	4	1083	0	0
16	11773743	rs7188511	G	T	14	11	25	0	0	25	0	0
16	11774625	rs12929396	C	T	6	4	10	0	1	11	0	0
16	11774950	rs4781137	T	C	14	5	19	0	0	19	0	0
16	11784129	rs8059262	G	T	13	16	29	0	0	29	0	0
16	11784880	rs732799	G	A	14	8	22	0	0	22	0	0
16	11787714	rs11648550	G	C	4	4	8	0	0	8	0	0
16	11788431	rs11645244	G	A	7	2	9	0	0	9	0	0
16	11792700	rs933574	A	C	14	9	23	0	0	23	0	0
16	11793395	rs933573	C	T	12	4	16	0	0	16	0	0
16	11793788	.	A	G	13	8	21	0	1	22	0	0
16	11794895	rs17606153	C	T	3	3	6	0	0	6	0	0
16	11799673	rs191664741	G	A	9	3	12	0	0	12	0	0
16	11800848	rs35902600	C	T	3	5	8	0	0	8	0	0
16	11813899	rs35649585	G	A	3	5	8	0	0	8	0	0
16	11820003	rs55934118	G	C	19	64	83	0	1	84	0	0
16	11820256	rs12929940	G	A	3	7	10	0	0	10	0	0
16	11821708	rs10492852	G	A	8	6	14	0	0	14	0	0
16	11822066	rs12599288	T	C	7	4	11	0	0	11	0	0
16	11824056	rs11639945	T	G	5	4	9	0	0	9	0	0
16	11825293	rs7501380	G	A	3	3	6	0	1	7	0	0
16	11836398	rs3743587	C	G	24	16	40	0	0	40	0	0
16	11836508	rs3743588	G	A	1	6	7	0	0	7	0	0
16	11844655	rs7090	C	A	31	18	49	0	0	49	0	0
16	11853690	rs1062210	C	T	5	2	7	0	0	7	0	0
16	11853767	rs12927907	G	A	4	2	6	0	0	6	0	0
16	11863993	rs62040624	G	A	2	4	6	0	0	6	0	0
16	11929818	rs2098722	A	G	28	22	50	0	0	50	0	0
16	11929914	rs3971913	C	T	19	23	42	0	0	42	0	0
16	11930337	rs3743590	C	A	19	18	37	0	3	40	0	0
16	11933678	rs2075160	G	C	571	573	1144	0	6	1150	0	0
16	11940390	rs8052900	T	C	395	395	790	0	0	790	0	0
16	11965741	rs2051546	G	A	7	12	19	0	0	19	0	0
16	11966350	rs56041551	T	A	32	16	48	0	0	48	0	0
16	11978807	.	C	T	11	27	38	0	0	38	0	0
16	11991944	rs33635	C	T	3	6	9	0	0	9	0	0
16	11992257	rs4781161	T	C	2	4	6	0	0	6	0	0
16	11997490	rs33629	G	A	5	5	10	0	0	10	0	0
16	12001447	rs7184515	G	C	12	13	25	0	0	25	0	0
16	12001772	rs13335494	G	A	12	9	21	0	0	21	0	0
16	12003035	rs4781162	C	T	9	5	14	0	0	14	0	0
16	12003785	rs144189760	A	T	0	6	6	0	0	6	0	0
16	12003948	rs7204312	C	G	7	2	9	0	0	9	0	0
16	12008513	rs33621	G	A	3	5	8	0	0	8	0	0
16	12009277	rs185937624	C	A	18	28	46	0	1	47	0	0
16	12162969	rs1641843	A	G	10	4	14	0	0	14	0	0
16	12663207	rs10451100	C	T	17	5	22	0	0	22	0	0
16	12663208	rs10451101	G	A	17	5	22	0	0	22	0	0
16	12664946	rs28605243	C	T	18	10	28	0	1	29	0	0
16	12665964	rs17822411	T	A	13	15	28	0	0	28	0	0
16	12666202	rs9673974	T	C	13	16	29	0	1	30	0	0
16	12667267	rs11542103	G	A	16	15	31	0	0	31	0	0
16	12667589	rs10500383	G	A	19	18	37	0	3	40	0	0
16	12667908	rs1061008	A	T	16	11	27	0	0	27	0	0
16	14958523	.	A	G	42	0	42	0	0	42	0	0
16	14988868	.	A	G	135	0	135	0	1	136	0	0
16	14989420	.	C	T	223	0	223	0	1	224	0	0
16	15010140	.	G	T	3	4	7	0	0	8	1	0
16	15023409	.	C	T	13	7	20	0	0	20	0	0
16	15100295	.	G	A	62	35	97	0	0	97	0	0
16	15110077	rs4262938	C	T	6	5	11	0	0	11	0	0
16	15122195	.	A	G	0	7	7	0	0	7	0	0
16	15123280	.	A	G	1	5	6	0	0	6	0	0
16	15124242	.	G	A	5	15	20	0	0	20	0	0
16	15127310	rs67624034	A	G	5	3	8	0	0	8	0	0
16	15129092	rs7404466	C	T	8	5	13	0	0	13	0	0
16	15129158	rs7404524	A	G	6	2	8	0	0	8	0	0
16	15129162	rs7404526	A	G	6	2	8	0	0	8	0	0
16	15129459	rs4985155	A	G	10	5	15	0	0	15	0	0
16	15129940	rs3198697	C	T	57	46	103	0	1	104	0	0
16	15165103	rs73491931	G	A	111	110	221	0	1	222	0	0
16	15165991	rs58923875	T	A	27	25	52	0	0	52	0	0
16	15166232	rs11075255	A	G	12	12	24	0	0	24	0	0
16	15174571	rs4122352	G	A	5	5	10	0	0	10	0	0
16	15174603	rs150888796	C	T	4	6	10	0	0	10	0	0
16	15177695	rs8060236	T	A	8	5	13	0	0	13	0	0
16	15179788	rs35429473	A	G	16	17	33	0	1	34	0	0
16	15179855	rs146007965	T	C	17	18	35	0	0	35	0	0
16	15198598	rs62039525	C	T	91	90	181	0	1	182	0	0
16	15204289	rs62039528	C	T	90	73	163	0	1	164	0	0
16	15220125	rs200841956	C	A	24	36	60	0	0	60	0	0
16	15220735	rs9925500	G	A	60	32	92	0	0	92	0	0
16	15220753	rs2941262	G	C	28	57	85	0	0	85	0	0
16	15221262	rs13339619	T	C	58	14	72	0	2	74	0	0
16	15223941	rs202172522	G	C	6	9	15	0	0	15	0	0
16	15225444	rs9940242	C	G	29	6	35	0	0	35	0	0
16	15225447	rs1800568	A	G	27	4	31	0	1	32	0	0
16	15226979	rs377290171	C	G	12	2	14	0	1	15	0	0
16	15229662	rs2905113	A	G	34	16	50	0	0	50	0	0
16	15503550	rs222913	T	C	16	20	36	0	0	36	0	0
16	15503968	rs222914	A	G	5	4	9	0	0	9	0	0
16	15504225	rs11642570	G	A	12	2	14	0	0	14	0	0
16	15822075	rs2018109	G	C	3	6	9	0	0	9	0	0
16	15961222	.	G	C	53	54	107	0	3	111	1	0
16	16025750	rs12924488	T	C	6	0	6	0	0	6	0	0
16	16116022	rs246213	G	C	5	4	9	0	0	9	0	0
16	16116556	rs17264736	G	T	3	6	9	0	0	9	0	0
16	16117271	rs152033	T	C	5	5	10	0	0	10	0	0
16	16127235	rs2062541	G	A	6	1	7	0	0	7	0	0
16	16214255	rs2238475	T	G	4	2	6	0	0	6	0	0
16	16227589	rs150530	C	T	3	3	6	0	0	6	0	0
16	16232607	rs212089	T	C	5	3	8	0	2	10	0	0
16	16235939	rs129081	G	C	40	26	66	0	2	68	0	0
16	16236004	rs212090	T	A	89	109	198	0	1	199	0	0
16	16236650	rs212091	T	C	253	265	518	0	7	525	0	0
16	16423065	.	A	G	169	167	336	0	1	337	0	0
16	16470175	.	C	T	29	0	29	0	0	29	0	0
16	16470177	.	C	T	29	0	29	0	0	29	0	0
16	16470203	.	C	T	43	0	43	0	0	43	0	0
16	17196433	rs1045885	G	C	40	26	66	0	0	66	0	0
16	17198524	rs9934313	C	A	25	18	43	0	0	43	0	0
16	17200116	rs56209014	C	T	19	29	48	0	1	49	0	0
16	17201482	rs147337673	G	A	31	43	74	0	0	74	0	0
16	17202097	rs73526133	G	A	31	35	66	0	0	66	0	0
16	17202801	rs34511974	G	A	41	35	76	0	0	76	0	0
16	17542995	rs56227399	C	T	6	15	21	0	0	21	0	0
16	17548880	rs7499691	G	A	6	0	6	0	0	6	0	0
16	17549058	rs72783562	G	A	3	7	10	0	0	10	0	0
16	17550576	rs7191780	T	C	4	2	6	0	0	6	0	0
16	17552274	rs72783564	A	G	4	5	9	0	0	9	0	0
16	17560233	rs2113310	G	C	2	6	8	0	0	8	0	0
16	17560235	rs8182153	G	A	6	2	8	0	0	8	0	0
16	19079037	rs17357834	G	A	2	4	6	0	0	6	0	0
16	19085298	rs11074359	C	T	9	7	16	0	0	16	0	0
16	19623956	rs8049073	A	T	4	9	13	0	0	13	0	0
16	19624011	rs8049383	C	A	3	6	9	0	0	9	0	0
16	19680546	rs957676	T	C	48	49	97	0	4	101	0	0
16	19717985	rs34069083	C	T	3	7	10	0	1	11	0	0
16	19717986	.	G	A	8	3	11	0	0	11	0	0
16	19726275	rs11640454	C	T	3	8	11	0	0	11	0	0
16	20690877	rs71374827	A	G	5	4	9	0	0	9	0	0
16	20692039	rs34880359	A	G	13	17	30	0	0	30	0	0
16	20729699	rs11643620	G	A	19	13	32	0	0	32	0	0
16	20734520	rs11649682	A	C	8	4	12	0	0	12	0	0
16	20734566	.	C	T	7	2	9	0	0	9	0	0
16	20740722	rs8050965	G	A	3	3	6	0	0	6	0	0
16	20745277	rs1058904	C	T	76	62	138	0	1	139	0	0
16	20746239	rs67088894	G	C	117	82	199	0	2	201	0	0
16	20747104	rs1136268	C	T	55	53	108	0	0	108	0	0
16	20747646	rs146168323	T	C	50	44	94	0	2	96	0	0
16	20748331	rs11074471	C	A	74	63	137	0	1	138	0	0
16	20749461	rs9788809	T	C	2	13	15	0	0	15	0	0
16	20766922	rs234285	C	T	16	9	25	0	0	25	0	0
16	20781939	rs12918637	G	A	2	4	6	0	0	6	0	0
16	20783039	rs8052747	A	G	5	1	6	0	0	6	0	0
16	20796387	rs5716	G	C	42	34	76	0	0	76	0	0
16	20809283	rs11648835	C	A	5	5	10	0	0	10	0	0
16	20811681	rs2301771	C	T	10	13	23	0	0	23	0	0
16	20855309	rs9929443	A	G	58	68	126	0	2	128	0	0
16	20867672	rs12926084	A	G	10	5	15	0	0	15	0	0
16	20873767	rs7187522	T	G	15	17	32	0	0	32	0	0
16	21132298	rs13330317	T	C	7	13	20	0	0	20	0	0
16	21420079	.	G	A	2	9	11	0	0	11	0	0
16	21513228	.	G	A	6	2	8	0	1	9	0	0
16	21513372	.	T	C	14	5	19	0	1	20	0	0
16	21531494	.	T	C	5	5	10	0	0	10	0	0
16	21651525	rs9921724	T	C	3	4	7	0	0	7	0	0
16	21665864	rs7204005	T	A	3	3	6	0	0	6	0	0
16	21665897	rs7204169	T	C	2	4	6	0	0	6	0	0
16	21854719	.	G	C	15	10	25	0	0	25	0	0
16	22262514	rs2303186	C	A	11	8	19	0	0	19	0	0
16	22276433	rs13332017	A	G	3	3	6	0	0	6	0	0
16	22277965	rs1559316	T	C	11	6	17	0	0	17	0	0
16	22278053	rs36095301	C	T	11	16	27	0	0	27	0	0
16	22345191	rs7764	G	A	69	51	120	0	0	120	0	0
16	22432474	rs116971061	A	C	4	2	6	0	0	6	0	0
16	22545897	.	G	T	25	44	69	0	4	73	0	0
16	23080435	rs115182011	G	A	11	11	22	0	0	22	0	0
16	23090732	rs76437304	A	G	1	6	7	0	1	8	0	0
16	23477213	rs1135088	G	C	25	25	50	0	1	51	0	0
16	24166130	rs432998	T	C	114	102	216	0	1	217	0	0
16	24202458	rs3729904	C	T	188	160	348	0	4	352	0	0
16	24227025	rs3785378	A	G	90	88	178	0	5	183	0	0
16	24229809	rs2239338	G	A	12	16	28	0	0	28	0	0
16	24230203	rs411103	T	A	8	5	13	0	0	13	0	0
16	24230680	rs2239340	G	A	16	4	20	0	0	20	0	0
16	24550930	rs9922288	A	G	75	73	148	0	0	148	0	0
16	24560993	rs12051373	A	G	7	9	16	0	0	16	0	0
16	24567056	.	A	T	3	3	6	0	0	6	0	0
16	24831666	.	G	A	20	36	56	0	0	56	0	0
16	25239872	rs2287797	G	C	4	2	6	0	0	6	0	0
16	25247764	rs2277961	G	A	13	13	26	0	1	27	0	0
16	25248276	rs2112812	G	A	5	15	20	0	0	20	0	0
16	25248417	rs17717344	C	T	2	8	10	0	0	10	0	0
16	25250064	rs11645343	C	T	12	10	22	0	0	22	0	0
16	25254878	rs143628292	G	A	3	4	7	0	0	7	0	0
16	25255242	rs8059494	T	A	6	4	10	0	0	10	0	0
16	25255506	rs11642611	C	T	7	5	12	0	0	12	0	0
16	25258035	rs11649280	A	G	13	6	19	0	0	19	0	0
16	25263278	rs2112811	G	A	8	6	14	0	0	14	0	0
16	27325021	rs12927172	A	G	5	1	6	0	0	6	0	0
16	27715233	.	C	T	4	8	12	0	0	12	0	0
16	27788905	rs76049273	A	G	2	8	10	0	0	10	0	0
16	28167117	rs72789666	G	C	7	3	10	0	0	10	0	0
16	28374161	rs201918842	G	C	3	6	9	0	0	9	0	0
16	28488943	rs77595156	T	C	124	125	249	0	10	259	0	0
16	28495752	rs151182	C	T	7	2	9	0	0	9	0	0
16	28496014	rs76662516	T	C	6	2	8	0	0	8	0	0
16	28506872	rs149271	A	G	49	40	89	0	0	89	0	0
16	28507644	rs180743	C	G	49	53	102	0	1	103	0	0
16	28508048	rs180744	A	G	77	48	125	0	1	126	0	0
16	28508069	rs151174	C	T	70	48	118	0	1	119	0	0
16	28508447	rs40831	A	G	54	64	118	0	3	121	0	0
16	28565489	rs62034351	G	A	6	4	10	0	0	10	0	0
16	28603655	rs1059491	T	G	5	6	11	0	0	11	0	0
16	28617057	rs1042157	G	A	66	34	100	0	0	100	0	0
16	28617128	rs6839	T	C	79	50	129	0	0	129	0	0
16	28617514	.	C	T	62	12	74	0	1	75	0	0
16	28617552	.	C	G	74	6	80	0	1	81	0	0
16	28617574	rs4149394	C	T	8	4	12	0	0	12	0	0
16	28617595	rs4149393	A	G	6	7	13	0	0	13	0	0
16	28618446	rs2925623	T	C	8	4	12	0	0	12	0	0
16	28618545	rs2925624	G	T	11	5	16	0	0	16	0	0
16	28618636	rs3020804	A	G	12	7	19	0	0	19	0	0
16	28618708	rs11648192	C	T	11	12	23	0	2	25	0	0
16	28619076	rs2925629	T	C	2	6	8	0	1	9	0	0
16	28619132	rs2925630	T	C	7	7	14	0	0	14	0	0
16	28619178	rs56169261	G	A	7	5	12	0	0	12	0	0
16	28619179	rs56091264	A	G	7	5	12	0	0	12	0	0
16	28619180	rs56305122	C	T	7	5	12	0	0	12	0	0
16	28619911	rs1126447	T	C	49	22	71	0	1	72	0	0
16	28619920	rs1126446	A	G	50	17	67	0	1	68	0	0
16	28620311	rs1690405	C	G	7	0	7	0	0	7	0	0
16	28620572	rs750155	C	T	7	11	18	0	1	19	0	0
16	28620800	rs3760091	C	G	7	5	12	0	0	12	0	0
16	28621311	rs2077412	T	C	35	8	43	0	1	44	0	0
16	28766159	rs397464	A	G	4	2	6	0	0	6	0	0
16	28827498	rs62036617	T	C	2	6	8	0	0	8	0	0
16	28837203	rs62036622	T	G	13	11	24	0	0	24	0	0
16	28837515	rs8049439	T	C	14	8	22	0	0	22	0	0
16	28837906	rs8062405	A	G	12	4	16	0	1	17	0	0
16	28838073	rs12448482	A	G	17	16	33	0	0	33	0	0
16	28839392	rs72793811	G	A	10	11	21	0	0	21	0	0
16	28839425	rs78613234	T	C	11	11	22	0	0	22	0	0
16	28839735	rs62036623	C	G	5	3	8	0	0	8	0	0
16	28839930	rs62036624	G	T	7	9	16	0	3	19	0	0
16	28840381	rs72793812	A	G	15	12	27	0	1	28	0	0
16	28843025	rs55991577	C	T	21	14	35	0	0	35	0	0
16	28843118	rs56358680	A	G	15	15	30	0	0	30	0	0
16	28844068	rs7498491	T	A	7	14	21	0	0	21	0	0
16	28844284	rs62036626	A	G	7	7	14	0	0	14	0	0
16	28844365	rs62036657	G	A	7	10	17	0	0	17	0	0
16	28845251	rs12444171	G	A	10	3	13	0	0	13	0	0
16	28846840	rs56404918	T	G	22	24	46	0	1	47	0	0
16	28846866	rs55719896	G	A	27	23	50	0	1	51	0	0
16	28847149	rs55830740	G	C	49	49	98	0	1	99	0	0
16	28847246	rs12928404	T	C	47	36	83	0	0	83	0	0
16	28853996	rs3088215	A	C	4	8	12	0	1	13	0	0
16	28854769	rs28403629	A	G	3	7	10	0	0	10	0	0
16	28855522	rs61737565	G	C	44	47	91	0	0	91	0	0
16	28857645	rs7187776	A	G	21	19	40	0	1	41	0	0
16	28875482	rs7193733	A	G	8	5	13	0	0	13	0	0
16	28881001	rs11150623	G	T	3	7	10	0	0	10	0	0
16	28881202	rs8055982	A	C	1	6	7	0	0	7	0	0
16	28883241	rs7498665	A	G	56	68	124	0	5	129	0	0
16	28883327	rs28433345	T	C	2	4	6	0	0	6	0	0
16	28915527	rs10499	G	A	6	15	21	0	1	22	0	0
16	28917746	rs62037412	G	A	3	3	6	0	0	6	0	0
16	28922149	rs11646653	C	T	3	3	6	0	0	6	0	0
16	28937259	rs4072402	T	C	4	4	8	0	1	9	0	0
16	28969480	rs9937676	A	G	3	4	7	0	0	7	0	0
16	28969607	rs11641854	G	A	9	8	17	0	0	17	0	0
16	28974958	rs118139364	C	T	3	3	6	0	0	6	0	0
16	28977020	rs7500321	G	A	38	38	76	0	2	78	0	0
16	28977713	rs1137843	T	C	35	25	60	0	1	61	0	0
16	28977988	rs140531733	G	A	34	19	53	0	0	53	0	0
16	28990101	rs7187575	C	T	6	5	11	0	0	11	0	0
16	28992000	rs4788113	G	A	8	5	13	0	0	13	0	0
16	28992646	rs3922668	G	A	19	11	30	0	2	32	0	0
16	28993049	rs6565300	A	C	15	16	31	0	0	31	0	0
16	28995145	rs4788114	C	T	135	121	256	0	3	259	0	0
16	28995757	rs7140	C	A	71	54	125	0	6	131	0	0
16	29106284	.	C	T	5	2	7	0	0	7	0	0
16	29118679	rs11865711	C	T	4	3	7	0	0	7	0	0
16	29121426	rs147667954	G	A	20	10	30	0	0	30	0	0
16	29124421	rs1641997	T	C	72	54	126	0	0	126	0	0
16	29263021	rs2250104	A	G	4	4	8	0	1	9	0	0
16	29394552	.	G	T	14	0	14	0	0	14	0	0
16	29469934	.	C	T	6	4	10	0	0	10	0	0
16	29470113	.	T	G	3	6	9	0	0	9	0	0
16	29559020	rs77623870	A	G	29	11	40	0	0	40	0	0
16	29572021	.	T	G	8	8	16	0	2	18	0	0
16	29576811	rs201149124	A	G	22	31	53	0	0	53	0	0
16	29580611	rs2161671	G	A	99	89	188	0	0	188	0	0
16	29606045	rs28548524	T	C	3	3	6	0	0	6	0	0
16	29827681	rs11546678	G	A	8	10	18	0	0	18	0	0
16	29828120	.	A	G	20	27	47	0	0	47	0	0
16	29869748	rs8335	G	C	84	121	205	0	2	207	0	0
16	29872361	rs3815822	G	A	3	5	8	0	0	8	0	0
16	29918034	rs1129700	T	C	35	33	68	0	1	69	0	0
16	29922011	rs12933766	C	T	4	3	7	0	0	7	0	0
16	29922723	rs142098164	C	T	5	3	8	0	0	8	0	0
16	29974167	rs6565173	G	A	9	16	25	0	0	25	0	0
16	29983148	rs9925102	T	C	2	4	6	0	0	6	0	0
16	29984070	rs11901	C	G	5	3	8	0	0	8	0	0
16	29994922	rs3814883	C	T	70	69	139	0	2	141	0	0
16	29995880	rs4787489	G	A	2	5	7	0	0	7	0	0
16	29998200	rs4077410	A	G	7	13	20	0	0	20	0	0
16	30000330	rs11150579	T	G	3	3	6	0	0	6	0	0
16	30000901	rs3814881	G	A	4	4	8	0	0	8	0	0
16	30003076	rs9924686	G	A	23	23	46	0	0	46	0	0
16	30018500	rs3935873	C	T	10	10	20	0	0	20	0	0
16	30021402	rs1140239	C	T	8	10	18	0	0	18	0	0
16	30078492	rs9783783	G	C	2	4	6	0	0	6	0	0
16	30089641	.	C	T	6	16	22	0	0	22	0	0
16	30089908	rs12447915	C	T	28	14	42	0	0	42	0	0
16	30089911	rs12445768	T	C	27	14	41	0	1	42	0	0
16	30092048	rs9932605	A	G	5	9	14	0	0	14	0	0
16	30093779	rs2278557	C	G	17	17	34	0	1	35	0	0
16	30095236	rs11644459	C	T	12	13	25	0	1	26	0	0
16	30198151	rs1132812	A	G	1459	1479	2938	0	34	2974	2	0
16	30362813	rs80000693	G	A	33	19	52	0	2	54	0	0
16	30364071	rs11862806	A	G	24	28	52	0	0	52	0	0
16	30365335	rs139111996	T	A	67	53	120	0	0	120	0	0
16	30371655	rs11642676	C	G	8	6	14	0	0	14	0	0
16	30376486	rs8049108	T	C	66	65	131	0	1	133	1	0
16	30376959	rs11646130	T	C	15	13	28	0	0	28	0	0
16	30380486	rs4238961	T	C	32	25	57	0	0	57	0	0
16	30393660	rs4787643	G	A	8	7	15	0	0	15	0	0
16	30408765	rs12921440	C	T	14	5	19	0	0	19	0	0
16	30410445	rs4788413	C	T	15	15	30	0	0	30	0	0
16	30435601	rs146094440	C	G	318	243	561	0	3	564	0	0
16	30505821	rs3087439	C	T	3	4	7	0	0	7	0	0
16	30518041	rs2230433	G	C	38	35	73	0	1	74	0	0
16	30536918	rs10871453	C	G	95	83	178	0	2	180	0	0
16	30538419	rs56391383	G	A	7	7	14	0	0	14	0	0
16	30546488	rs6565191	G	A	5	8	13	0	0	13	0	0
16	30548352	rs72793342	G	A	6	0	6	0	0	6	0	0
16	30566747	rs17850402	G	A	5	8	13	0	0	13	0	0
16	30666367	rs3747481	C	T	352	306	658	0	10	668	0	0
16	30672097	rs67128646	A	C	30	39	69	0	0	69	0	0
16	30672719	rs885107	T	C	13	11	24	0	0	24	0	0
16	30737905	rs72793375	G	A	15	16	31	0	1	32	0	0
16	30770950	rs62622830	T	C	6	13	19	0	1	20	0	0
16	30785467	rs72793383	G	A	252	152	404	0	6	410	0	0
16	30792389	rs35695082	T	C	12	10	22	0	0	22	0	0
16	30977799	rs11150601	G	A	21	16	37	0	0	37	0	0
16	30981884	rs72799363	C	T	4	2	6	0	0	6	0	0
16	30995528	rs11076	A	G	225	227	452	0	5	457	0	0
16	30995669	rs6950	T	C	132	158	290	0	6	296	0	0
16	30996871	rs12443808	C	G	7	12	19	0	0	19	0	0
16	30996872	rs12443627	G	C	7	12	19	0	0	19	0	0
16	30999142	rs9938550	A	G	23	22	45	0	1	46	0	0
16	30999462	rs2305880	T	C	30	31	61	0	0	62	1	0
16	31044897	rs12445650	G	A	12	6	18	0	0	18	0	0
16	31072909	rs8046978	G	A	34	31	65	0	0	65	0	0
16	31090407	rs35713203	G	C	14	11	25	0	0	25	0	0
16	31091209	rs3751855	T	C	14	10	24	0	0	24	0	0
16	31092075	rs7196726	G	A	12	9	21	0	0	21	0	0
16	31093954	rs750952	C	T	12	10	22	0	0	22	0	0
16	31094679	rs72785535	C	T	10	21	31	0	0	31	0	0
16	31094861	rs45599534	G	A	9	9	18	0	0	18	0	0
16	31096164	rs7199949	G	C	4	4	8	0	0	8	0	0
16	31102321	rs7294	C	T	306	240	546	0	3	549	0	0
16	31122571	rs889555	C	T	9	6	15	0	0	15	0	0
16	31132250	rs11865499	A	G	39	51	90	0	1	91	0	0
16	31132510	rs56388508	C	T	27	30	57	0	2	59	0	0
16	31132662	rs28725459	G	A	24	9	33	0	0	33	0	0
16	31133100	rs59735493	G	A	15	24	39	0	0	39	0	0
16	31133110	rs11649030	A	G	23	17	40	0	1	41	0	0
16	31133449	rs1060506	C	T	43	24	67	0	1	68	0	0
16	31134059	rs61320757	G	A	32	15	47	0	2	49	0	0
16	31134213	rs60996860	T	A	19	20	39	0	0	39	0	0
16	31142271	rs17855606	A	G	8	5	13	0	0	13	0	0
16	31195279	rs1052352	C	T	464	430	894	0	4	898	0	0
16	31276811	rs1143679	G	A	18	18	36	0	0	36	0	0
16	31282970	rs34082782	G	A	4	4	8	0	0	8	0	0
16	31289396	rs1143680	T	C	27	29	56	0	0	56	0	0
16	31335906	rs41476751	T	C	4	2	6	0	0	6	0	0
16	31336888	rs1143683	C	T	49	37	86	0	0	86	0	0
16	31340216	rs4889543	C	T	1	6	7	0	0	7	0	0
16	31343005	rs1143678	C	T	55	55	110	0	1	111	0	0
16	31343235	rs58200984	T	C	52	53	105	0	5	110	0	0
16	31343386	rs9933520	A	G	45	30	75	0	0	75	0	0
16	31367318	rs2230424	T	C	30	46	76	0	0	76	0	0
16	31368816	rs11574635	G	C	24	29	53	0	1	54	0	0
16	31368835	rs11574636	C	T	30	23	53	0	0	53	0	0
16	31368874	rs11574637	T	C	39	28	67	0	0	67	0	0
16	31370452	rs1106398	C	T	7	8	15	0	0	15	0	0
16	31370765	rs13336235	G	A	8	6	14	0	0	14	0	0
16	31371674	rs2230428	G	A	18	15	33	0	0	33	0	0
16	31389954	rs58724472	C	T	2	4	6	0	0	6	0	0
16	31393544	rs9929832	C	T	21	18	39	0	4	43	0	0
16	31394179	rs1140195	A	G	32	34	66	0	0	66	0	0
16	31476458	rs11150624	C	T	14	22	36	0	0	36	0	0
16	31476695	rs111510548	T	C	22	9	31	0	1	32	0	0
16	31488916	rs10596	C	G	5	4	9	0	0	9	0	0
16	31489033	rs13143	C	T	5	5	10	0	0	10	0	0
16	31717354	rs1406178	T	C	12	2	14	0	0	14	0	0
16	31719727	rs3751742	G	T	15	7	22	0	0	22	0	0
16	31720486	rs2359455	A	C	15	2	17	0	0	17	0	0
16	31720636	rs3751738	T	C	22	4	26	0	0	26	0	0
16	31721064	rs709402	T	G	10	7	17	0	0	17	0	0
16	31721493	rs2008774	G	A	11	2	13	0	0	13	0	0
16	31722952	rs1045483	A	T	8	1	9	0	0	9	0	0
16	31770723	rs12921028	T	A	8	5	13	0	0	13	0	0
16	31925986	rs117668484	T	C	38	35	73	0	0	73	0	0
16	31927308	rs118056264	G	A	127	119	246	0	4	250	0	0
16	31928090	rs181982743	T	C	100	116	216	0	0	216	0	0
16	46614595	rs12928618	C	T	22	12	34	0	1	35	0	0
16	46989764	rs34141059	G	C	10	10	20	0	2	22	0	0
16	46997729	rs34802381	A	G	5	7	12	0	0	12	0	0
16	50265430	.	G	C	55	45	100	0	4	104	0	0
16	50335996	rs7193875	C	T	2	7	9	0	0	9	0	0
16	50340154	rs4785210	C	T	6	2	8	0	0	8	0	0
16	50340217	rs4785403	A	C	4	3	7	0	1	8	0	0
16	50348409	rs9926131	A	T	7	9	16	0	0	16	0	0
16	50348577	rs3813755	T	C	7	3	10	0	0	10	0	0
16	50350210	rs1872691	G	A	33	21	54	0	0	54	0	0
16	50351444	rs4785407	T	C	25	33	58	0	0	58	0	0
16	50353708	rs72786265	C	T	9	3	12	0	0	12	0	0
16	50353710	rs7196135	A	G	3	7	10	0	0	10	0	0
16	50370703	rs8059133	G	C	1	8	9	0	0	9	0	0
16	50371209	rs111428776	T	G	6	1	7	0	1	8	0	0
16	50371362	rs11639573	A	G	4	14	18	0	0	18	0	0
16	50371463	rs11644259	T	G	2	8	10	0	0	10	0	0
16	50371738	rs11644386	T	C	2	19	21	0	0	21	0	0
16	50706188	rs76667099	T	C	37	32	69	0	1	70	0	0
16	50715185	rs2066848	G	A	5	7	12	0	0	12	0	0
16	50766127	rs3135499	A	C	6	5	11	0	0	11	0	0
16	50787147	rs3785142	G	A	1	8	9	0	0	9	0	0
16	50816660	rs17314341	C	T	3	6	9	0	0	9	0	0
16	50819112	rs8047910	A	G	1	5	6	0	0	6	0	0
16	50819566	rs4027241	G	A	8	14	22	0	0	22	0	0
16	50819910	rs2111435	C	T	8	19	27	0	0	27	0	0
16	50820078	rs17314544	C	T	4	7	11	0	0	11	0	0
16	50820263	rs17223195	A	G	3	4	7	0	0	7	0	0
16	50820406	rs13337656	C	T	11	7	18	0	0	18	0	0
16	50822964	rs4785226	A	C	10	4	14	0	0	14	0	0
16	50827601	rs2302759	A	G	1	9	10	0	0	10	0	0
16	50829853	rs2160683	A	T	4	9	13	0	0	13	0	0
16	53503934	rs1131220	G	A	17	4	21	0	0	21	0	0
16	53504721	rs10748	T	C	16	14	30	0	1	31	0	0
16	53524308	rs3929	G	C	19	20	39	0	0	39	0	0
16	53999638	rs17823223	C	T	7	1	8	0	0	8	0	0
16	54147935	rs708277	G	A	7	12	19	0	0	19	0	0
16	54318172	rs1126960	C	A	17	11	28	0	0	28	0	0
16	55364262	rs17230294	C	A	7	0	7	0	1	8	0	0
16	55571303	rs1819831	C	A	1	5	6	0	0	6	0	0
16	55578599	rs62028768	T	C	9	9	18	0	0	18	0	0
16	55619474	rs187121939	A	C	11	19	30	0	0	30	0	0
16	55620291	rs1044775	C	T	28	22	50	0	1	51	0	0
16	56395610	rs2550303	G	A	46	66	112	0	1	113	0	0
16	56396486	rs4924	C	T	173	167	340	0	3	343	0	0
16	56465425	rs8059717	C	T	83	82	165	0	2	167	0	0
16	56510299	rs14306	A	C	11	17	28	0	0	28	0	0
16	56510601	rs7198524	C	T	61	76	137	0	3	140	0	0
16	56511026	rs112162270	A	G	47	49	96	0	2	98	0	0
16	56511245	rs3228	T	G	69	66	135	0	1	136	0	0
16	56545175	rs11373	T	C	1	9	10	0	0	10	0	0
16	56642491	rs28366003	A	G	15	11	26	0	0	26	0	0
16	56643343	rs10636	G	C	430	251	681	0	3	685	1	0
16	56873495	rs1138295	C	T	174	138	312	0	2	314	0	0
16	56873814	rs72786737	A	G	7	8	15	0	0	15	0	0
16	56873840	rs2304477	G	A	4	6	10	0	0	10	0	0
16	56966071	rs37024	T	G	56	44	100	0	0	100	0	0
16	56966416	rs8056195	C	G	5	7	12	0	0	12	0	0
16	56966786	rs12445769	A	G	17	12	29	0	2	31	0	0
16	56967177	rs72786778	T	G	6	4	10	0	0	10	0	0
16	56967758	rs7500979	G	A	3	5	8	0	0	8	0	0
16	56969683	rs39718	C	T	10	12	22	0	0	22	0	0
16	56969854	rs1428847	A	G	5	3	8	0	1	9	0	0
16	56970203	rs8044804	A	G	8	6	14	0	0	14	0	0
16	56972345	rs247610	T	G	6	5	11	0	0	11	0	0
16	57024884	rs7197864	G	A	4	5	9	0	0	9	0	0
16	57056463	rs1651665	A	C	3	5	8	0	0	8	0	0
16	57056507	rs16970107	C	G	5	3	8	0	0	8	0	0
16	57056609	rs1651667	A	G	6	4	10	0	0	10	0	0
16	57059427	rs74439742	C	T	26	21	47	0	1	48	0	0
16	57063494	rs75974417	C	T	3	3	6	0	0	6	0	0
16	57071113	rs1684579	T	C	39	20	59	0	0	59	0	0
16	57080528	rs289723	C	A	42	33	75	0	1	76	0	0
16	57089130	rs1167512	C	A	3	3	6	0	1	7	0	0
16	57089959	rs1183247	G	C	11	20	31	0	0	31	0	0
16	57090666	rs77142395	G	A	5	6	11	0	0	11	0	0
16	57090858	rs73546879	A	G	11	12	23	0	0	23	0	0
16	57091334	rs2062544	T	G	12	7	19	0	0	19	0	0
16	57107426	rs117551921	C	A	8	2	10	0	0	10	0	0
16	57155396	rs4784770	G	A	2	4	6	0	0	6	0	0
16	57155457	rs4783976	T	C	2	4	6	0	0	6	0	0
16	57157206	rs2305696	C	T	4	2	6	0	0	6	0	0
16	57217725	.	G	A	4	6	10	0	0	10	0	0
16	57586235	rs7185200	C	T	6	4	10	0	0	10	0	0
16	57586637	rs12232444	T	C	5	1	6	0	0	6	0	0
16	57595999	rs1004363	A	G	19	22	41	0	0	41	0	0
16	57600079	rs9922499	A	G	6	1	7	0	0	7	0	0
16	57601792	rs9937918	C	T	32	19	51	0	0	51	0	0
16	57689385	rs1801257	C	G	20	20	40	0	0	40	0	0
16	57689883	rs1376041	T	C	17	21	38	0	0	38	0	0
16	57695604	rs2290177	C	T	5	3	8	0	0	8	0	0
16	57697532	rs10852554	T	G	32	27	59	0	0	59	0	0
16	57704472	rs7195755	T	C	4	3	7	0	0	7	0	0
16	57707789	rs59976419	T	C	4	2	6	0	0	6	0	0
16	57708034	rs62039893	T	A	3	3	6	0	0	6	0	0
16	57708056	rs935748	C	G	4	3	7	0	0	7	0	0
16	57710077	rs72793600	G	A	2	4	6	0	0	6	0	0
16	57710539	rs66853547	G	T	2	9	11	0	1	12	0	0
16	57713679	rs9935751	C	A	4	3	7	0	0	7	0	0
16	57713685	rs9925879	A	C	3	3	6	0	0	6	0	0
16	57714917	rs9928982	A	T	14	15	29	0	1	30	0	0
16	57716020	rs72795504	C	T	24	24	48	0	0	48	0	0
16	57716824	rs2006660	C	A	25	15	40	0	0	40	0	0
16	57716832	rs1814520	A	T	24	15	39	0	0	39	0	0
16	57716865	rs1814521	A	G	22	18	40	0	0	40	0	0
16	57716872	rs2006654	G	A	23	19	42	0	1	43	0	0
16	57718783	rs727216	C	G	4	7	11	0	1	12	0	0
16	57720241	rs731960	C	T	5	4	9	0	0	9	0	0
16	57720405	rs935738	C	G	10	7	17	0	0	17	0	0
16	57720488	rs1463235	G	A	8	11	19	0	1	20	0	0
16	57720610	rs1965228	G	A	9	15	24	0	0	24	0	0
16	57720779	rs4556777	C	T	7	14	21	0	0	21	0	0
16	57720797	rs2290179	A	G	4	10	14	0	1	15	0	0
16	57720965	rs7203347	C	T	12	6	18	0	0	18	0	0
16	57721272	rs2122485	T	C	8	9	17	0	0	17	0	0
16	57721952	rs8051301	T	C	15	13	28	0	0	28	0	0
16	57722038	rs8045126	G	T	13	14	27	0	0	27	0	0
16	57722328	rs12444859	C	T	300	342	642	0	5	647	0	0
16	57722576	rs11648336	T	A	316	392	708	0	8	716	0	0
16	57722833	rs7193154	C	T	357	362	719	0	42	762	1	0
16	57722866	rs12927110	C	T	464	428	892	0	40	932	0	0
16	57723077	rs1064326	G	A	370	291	661	0	11	672	0	0
16	57723179	rs1064327	G	A	214	157	371	0	3	374	0	0
16	57723197	rs1064328	A	G	198	128	326	0	2	328	0	0
16	57723239	rs1141417	A	G	133	98	231	0	0	231	0	0
16	57723249	rs1141418	T	C	106	85	191	0	1	192	0	0
16	57786711	rs2965798	C	T	0	79	79	0	2	81	0	0
16	57787027	rs12922275	C	T	108	0	108	0	0	108	0	0
16	57788352	rs2967123	G	C	0	7	7	0	0	7	0	0
16	57790161	rs34131744	G	T	13	0	13	0	0	13	0	0
16	57790907	.	G	A	145	1	146	0	0	146	0	0
16	57792688	rs71387192	G	A	59	44	103	0	3	106	0	0
16	57795394	rs2967172	G	A	26	23	49	0	0	49	0	0
16	57824801	rs2967118	G	A	15	12	27	0	0	27	0	0
16	57831336	rs35820612	C	G	2	5	7	0	0	7	0	0
16	58028860	rs9083	G	A	70	53	123	0	0	123	0	0
16	58030053	rs3743553	T	C	46	52	98	0	1	99	0	0
16	58030192	rs3743554	A	C	43	49	92	0	1	93	0	0
16	58030247	.	A	G	32	38	70	0	0	70	0	0
16	58030401	rs3743555	T	C	5	5	10	0	0	10	0	0
16	58030634	rs3743556	C	T	25	26	51	0	0	51	0	0
16	58045469	rs1986162	G	A	16	22	38	0	0	38	0	0
16	58049046	.	T	G	5	2	7	0	0	7	0	0
16	58054671	rs12930821	G	C	80	85	165	0	3	168	0	0
16	58054888	rs11551263	C	T	100	95	195	0	0	195	0	0
16	58080009	rs11076213	C	T	20	21	41	0	0	41	0	0
16	58080215	rs1050779	G	C	17	19	36	0	0	36	0	0
16	58149704	rs141933093	C	T	10	6	16	0	0	16	0	0
16	58551360	rs37034	C	G	5	4	9	0	0	9	0	0
16	58552959	rs3169293	A	G	21	18	39	0	1	40	0	0
16	58553348	rs37036	T	C	8	11	19	0	0	19	0	0
16	58553777	rs3200575	G	A	9	10	19	0	0	19	0	0
16	58554780	rs17821549	C	T	103	116	219	0	1	220	0	0
16	58573901	rs246194	G	A	6	3	9	0	0	9	0	0
16	58574253	rs246196	T	C	5	5	10	0	0	10	0	0
16	58575489	rs11540994	G	A	36	32	68	0	1	69	0	0
16	58577138	rs28307	A	C	4	4	8	0	0	8	0	0
16	58579274	rs246258	C	T	39	38	77	0	1	78	0	0
16	58587737	rs11866002	C	T	11	23	34	0	1	35	0	0
16	58652888	rs8053005	G	A	2	7	9	0	0	9	0	0
16	58656146	rs7198329	T	A	3	3	6	0	0	6	0	0
16	58699690	rs30822	C	G	5	2	7	0	0	7	0	0
16	58741949	rs72792419	T	C	97	94	191	0	2	193	0	0
16	66646591	rs3743719	C	T	317	192	509	0	8	517	0	0
16	66758203	rs12600097	T	C	5	6	11	0	0	11	0	0
16	66759454	rs6499096	C	A	4	3	7	0	0	7	0	0
16	66764678	rs2068942	A	G	24	22	46	0	0	46	0	0
16	66764809	rs2067040	G	T	22	21	43	0	0	43	0	0
16	66765067	rs2122491	G	A	22	16	38	0	0	38	0	0
16	66765837	rs935760	G	C	16	13	29	0	1	30	0	0
16	66766913	rs8043912	C	T	11	9	20	0	2	22	0	0
16	66767459	rs9921999	C	T	7	8	15	0	0	15	0	0
16	66767632	rs9922030	A	T	9	5	14	0	0	14	0	0
16	66767659	rs12919973	G	C	12	8	20	0	0	20	0	0
16	66767796	rs9922207	A	G	8	3	11	0	0	11	0	0
16	66861966	rs152164	G	A	7	5	12	0	0	12	0	0
16	66966799	rs3890213	C	T	11	14	25	0	2	27	0	0
16	66967084	rs3759994	A	G	7	13	20	0	0	20	0	0
16	66969820	.	C	T	8	12	20	0	1	21	0	0
16	66977094	rs2241409	G	A	7	3	10	0	0	10	0	0
16	66977997	rs8192925	A	G	25	23	48	0	0	48	0	0
16	67006838	rs3848289	G	A	4	3	7	0	0	7	0	0
16	67178434	.	C	G	6	4	10	0	0	10	0	0
16	67188455	rs79616223	A	G	13	20	33	0	0	33	0	0
16	67265633	.	G	A	97	76	173	0	2	175	0	0
16	67268770	.	T	C	4	3	7	0	0	7	0	0
16	67316234	rs11860295	C	T	40	32	72	0	0	72	0	0
16	67318242	rs8044843	A	G	31	26	57	0	0	57	0	0
16	67320223	rs3868142	G	A	42	38	80	0	0	80	0	0
16	67423939	rs1053612	A	G	6	8	14	0	1	15	0	0
16	67424122	rs11552319	G	A	13	6	19	0	0	19	0	0
16	67424412	rs11552322	T	A	14	11	25	0	0	25	0	0
16	67471926	rs4360931	C	G	7	0	7	0	0	7	0	0
16	67471956	rs1053293	G	A	49	45	94	0	0	94	0	0
16	67472255	rs56294631	G	C	274	164	438	0	6	444	0	0
16	67473389	rs55877766	G	A	6	3	9	0	0	9	0	0
16	67574408	rs75204333	T	C	6	1	7	0	0	7	0	0
16	67578143	rs79437914	C	A	3	3	6	0	0	6	0	0
16	67625872	rs6499135	T	G	5	5	10	0	0	10	0	0
16	67669455	rs117447021	G	A	4	2	6	0	0	6	0	0
16	67682497	rs139104491	A	G	5	6	11	0	0	11	0	0
16	67682580	rs9972635	T	C	9	9	18	0	1	19	0	0
16	67691668	rs6979	A	G	65	73	138	0	1	139	0	0
16	67696365	rs35356834	G	A	40	50	90	0	0	90	0	0
16	67708897	rs12449157	A	G	9	11	20	0	1	21	0	0
16	67715437	rs8061500	A	G	4	5	9	0	0	9	0	0
16	67716147	rs144026838	G	C	6	4	10	0	0	10	0	0
16	67717264	rs79407301	G	A	5	4	9	0	0	9	0	0
16	67718563	rs28587148	A	C	5	2	7	0	0	7	0	0
16	67761917	rs112526325	T	C	4	2	6	0	0	6	0	0
16	67764626	rs114376569	G	T	2	10	12	0	0	12	0	0
16	67865073	rs8052287	G	A	9	4	13	0	0	13	0	0
16	67867739	rs11558534	G	T	13	11	24	0	1	25	0	0
16	67880834	rs28670302	C	T	9	23	32	0	2	34	0	0
16	67902326	rs2271294	A	T	21	8	29	0	0	29	0	0
16	67905407	rs11553287	A	G	8	7	15	0	0	15	0	0
16	67905994	rs76649027	G	A	18	21	39	0	1	40	0	0
16	67911517	rs8060686	T	C	66	60	126	0	0	126	0	0
16	67911874	rs8061384	T	G	36	35	71	0	1	72	0	0
16	67916271	rs145920378	T	C	7	6	13	0	0	13	0	0
16	67936975	rs28542199	T	C	16	14	30	0	0	30	0	0
16	67964203	rs1134760	T	C	39	31	70	0	0	70	0	0
16	67967878	rs7187289	A	C	10	8	18	0	0	18	0	0
16	67969531	rs14178	A	G	351	301	652	0	5	657	0	0
16	67969930	rs20549	A	G	287	250	537	0	6	543	0	0
16	67973953	rs5923	G	A	10	8	18	0	0	18	0	0
16	67977382	rs1109166	T	C	3	5	8	0	0	8	0	0
16	67980969	rs11860125	G	C	16	14	30	0	0	30	0	0
16	67984589	rs11542821	A	G	17	14	31	0	1	32	0	0
16	68021468	rs1133090	G	C	133	140	273	0	0	273	0	0
16	68023169	rs117782866	G	A	4	6	10	0	0	10	0	0
16	68023790	rs76177657	C	T	1	5	6	0	0	6	0	0
16	68026126	rs73596365	T	C	3	7	10	0	0	10	0	0
16	68072004	rs11555012	A	G	33	28	61	0	0	61	0	0
16	68172490	rs75788262	A	G	18	2	20	0	0	20	0	0
16	68172568	rs74851284	C	G	13	2	15	0	0	15	0	0
16	68192097	rs56111587	T	G	3	8	11	0	0	11	0	0
16	68293320	rs3743739	T	C	34	33	67	0	2	69	0	0
16	68294000	rs116844179	C	T	55	48	103	0	0	103	0	0
16	68320544	rs78805615	T	G	3	4	7	0	0	7	0	0
16	68330989	rs74024440	G	A	7	3	10	0	0	10	0	0
16	68332197	.	A	G	35	28	63	0	0	63	0	0
16	68332747	rs1127773	G	A	34	47	81	0	0	81	0	0
16	68386754	rs2035869	A	G	4	4	8	0	0	8	0	0
16	68387373	rs1562479	C	T	12	11	23	0	0	23	0	0
16	68388661	rs3785126	C	T	5	5	10	0	1	11	0	0
16	68388781	rs3826166	C	G	6	4	10	0	0	10	0	0
16	68389255	rs149702301	G	A	7	4	11	0	0	11	0	0
16	68389559	rs184288195	G	A	5	2	7	0	0	7	0	0
16	68389772	rs1131933	C	T	64	51	115	0	1	116	0	0
16	68390697	rs61733486	C	T	41	44	85	0	0	85	0	0
16	68574096	rs17621931	A	T	3	3	6	0	0	6	0	0
16	68598007	rs1177648	A	G	7	8	15	0	0	15	0	0
16	68599728	rs55886823	C	T	7	5	12	0	0	12	0	0
16	68600351	rs17689437	C	T	13	11	24	0	0	24	0	0
16	68600595	rs116861174	A	G	17	13	30	0	0	30	0	0
16	69359293	rs35628469	G	A	6	7	13	0	0	13	0	0
16	69497248	rs11075720	T	G	34	42	76	0	2	78	0	0
16	69605211	rs11642030	A	C	5	2	7	0	0	7	0	0
16	69695589	rs16959025	T	G	4	4	8	0	0	8	0	0
16	69698450	rs149547382	G	T	2	5	7	0	0	7	0	0
16	69730555	rs3826154	A	G	18	11	29	0	1	30	0	0
16	69733009	rs16959059	G	A	9	13	22	0	0	22	0	0
16	69733665	rs7359387	T	G	28	26	54	0	1	55	0	0
16	69734503	rs1865965	C	A	24	11	35	0	1	36	0	0
16	69734563	rs11641233	C	T	36	16	52	0	1	53	0	0
16	69735359	rs56059812	C	T	11	9	20	0	0	20	0	0
16	69736851	rs12232410	G	A	10	26	36	0	0	36	0	0
16	69743760	rs10517	A	G	7	5	12	0	0	12	0	0
16	69745145	rs1800566	G	A	19	9	28	0	2	30	0	0
16	69779151	rs60174731	G	A	2	4	6	0	0	6	0	0
16	69786258	rs144970081	C	G	132	129	261	0	1	262	0	0
16	69963297	.	A	G	3	3	6	0	0	6	0	0
16	70010610	.	C	T	1	25	26	0	0	26	0	0
16	70013457	.	T	C	5	2	7	0	0	7	0	0
16	70025188	rs149241265	A	G	2	6	8	0	0	8	0	0
16	70284588	.	A	G	145	36	181	0	19	200	0	0
16	70690989	rs8046424	G	C	3	6	9	0	0	9	0	0
16	70696009	rs72792847	C	T	56	64	120	0	1	121	0	0
16	70696367	rs3752785	C	T	62	46	108	0	4	112	0	0
16	70700214	rs11639579	A	C	5	6	11	0	0	11	0	0
16	70700363	rs2054183	C	G	3	6	9	0	0	9	0	0
16	70701400	rs7195565	G	A	4	2	6	0	0	6	0	0
16	70701411	rs7195572	G	A	4	2	6	0	0	6	0	0
16	70713047	rs35566469	A	G	7	4	11	0	0	11	0	0
16	70714287	rs11075777	G	A	6	6	12	0	1	13	0	0
16	70714434	rs11075778	T	C	8	6	14	0	1	15	0	0
16	70714584	rs11643085	C	G	5	5	10	0	0	10	0	0
16	70722940	rs4985416	A	C	4	4	8	0	0	8	0	0
16	70723294	rs12599280	A	T	5	3	8	0	0	8	0	0
16	70723314	rs11075779	C	T	5	3	8	0	0	8	0	0
16	70723404	rs12599324	A	G	4	3	7	0	0	7	0	0
16	70723925	rs11075780	A	G	8	2	10	0	0	10	0	0
16	70725141	rs3826272	A	C	3	4	7	0	0	7	0	0
16	70733138	rs4985563	G	A	2	5	7	0	0	7	0	0
16	70749970	rs11642770	A	G	5	3	8	0	0	8	0	0
16	70749997	rs11642775	A	G	4	2	6	0	0	6	0	0
16	71317664	.	C	T	18	19	37	0	1	38	0	0
16	71318001	rs3096381	G	T	13	13	26	0	0	26	0	0
16	71319539	rs3826247	C	T	6	3	9	0	0	9	0	0
16	71678932	rs8203	T	C	4	3	7	0	0	7	0	0
16	71679057	rs1058750	C	T	14	2	16	0	0	16	0	0
16	71679204	rs1058747	C	T	18	7	25	0	1	26	0	0
16	71680002	rs7188675	C	T	6	3	9	0	0	9	0	0
16	71681515	rs4788822	A	G	4	5	9	0	0	9	0	0
16	71681582	.	C	G	2	4	6	0	0	6	0	0
16	71764834	rs3751817	C	T	43	52	95	0	2	97	0	0
16	71765416	rs11539980	G	T	60	65	125	0	1	126	0	0
16	71767661	rs4788551	C	T	5	5	10	0	0	10	0	0
16	71768500	rs2278031	T	C	4	5	9	0	0	9	0	0
16	71774390	rs11645467	G	A	13	18	31	0	0	31	0	0
16	71774697	rs11646635	G	T	3	4	7	0	0	7	0	0
16	71774896	rs11641873	T	G	13	11	24	0	0	24	0	0
16	71775080	rs11646748	C	T	4	3	7	0	0	7	0	0
16	71776144	rs951453	C	T	7	8	15	0	0	15	0	0
16	71776769	rs2036337	G	A	6	5	11	0	0	11	0	0
16	71777448	rs4788442	G	C	4	8	12	0	0	12	0	0
16	71780599	rs2270831	T	C	17	16	33	0	0	33	0	0
16	71784793	.	C	T	4	3	7	0	0	7	0	0
16	71786537	rs34366687	T	C	4	3	7	0	0	7	0	0
16	71790221	rs8052910	A	G	5	3	8	0	0	8	0	0
16	71886530	rs7184486	T	A	56	50	106	0	0	106	0	0
16	71890489	rs2291947	C	G	82	78	160	0	1	161	0	0
16	71902142	rs2288031	C	A	3	5	8	0	0	8	0	0
16	71951094	rs7350856	G	T	4	2	6	0	0	6	0	0
16	71951845	rs4788579	A	C	3	11	14	0	0	14	0	0
16	71954448	rs148051953	C	A	4	10	14	0	0	14	0	0
16	71955400	rs4788450	T	G	34	15	49	0	0	49	0	0
16	71956596	rs2335708	A	G	20	13	33	0	0	33	0	0
16	71956597	rs2335707	A	T	19	13	32	0	1	33	0	0
16	71957753	rs9925684	T	C	64	78	142	0	1	143	0	0
16	71959061	.	G	A	3	3	6	0	0	6	0	0
16	71959727	rs12444829	A	G	14	11	25	0	0	25	0	0
16	72049799	rs8048262	A	T	3	3	6	0	0	6	0	0
16	72058881	rs2288000	A	G	3	4	7	0	0	7	0	0
16	72119812	rs9930890	A	G	3	10	13	0	0	13	0	0
16	72144493	rs2241411	T	C	6	5	11	0	0	11	0	0
16	72146441	rs7940	C	G	106	84	190	0	1	191	0	0
16	74332052	rs113156784	T	C	5	3	8	0	2	10	0	0
16	74333380	rs889641	T	C	7	8	15	0	0	15	0	0
16	74333737	rs12325102	T	C	9	4	13	0	0	13	0	0
16	74337036	rs1195629	G	A	6	7	13	0	0	13	0	0
16	74337104	rs17336867	G	C	6	13	19	0	0	19	0	0
16	74340431	rs1195630	C	A	8	3	11	0	0	11	0	0
16	74360410	rs4888212	G	C	1	5	6	0	0	6	0	0
16	74365283	rs9929478	A	G	4	19	23	0	0	23	0	0
16	74365290	rs11648396	G	A	4	19	23	0	0	23	0	0
16	74425358	rs6564065	G	A	0	17	17	0	0	17	0	0
16	74425447	.	C	T	52	0	52	0	0	52	0	0
16	74486189	rs7978	T	C	58	51	109	0	0	109	0	0
16	74490556	rs9945	G	A	54	71	125	0	0	125	0	0
16	74498398	rs3826239	C	T	4	4	8	0	0	8	0	0
16	74499046	rs9937943	G	C	5	1	6	0	0	6	0	0
16	74499589	rs2303275	G	A	45	47	92	0	0	92	0	0
16	74504843	rs12447531	C	T	4	2	6	0	0	6	0	0
16	74506447	rs8059315	G	C	4	4	8	0	0	8	0	0
16	74506765	rs8059869	G	C	4	11	15	0	0	15	0	0
16	74537591	rs4887772	C	T	21	26	47	0	0	47	0	0
16	74655601	rs1138861	G	T	169	92	261	0	4	265	0	0
16	74655634	rs1138860	G	C	177	89	266	0	2	268	0	0
16	74655848	rs7185722	G	A	144	187	331	0	1	332	0	0
16	74657421	rs7204804	T	C	123	131	254	0	1	255	0	0
16	74657485	rs8058133	A	T	87	109	196	0	1	197	0	0
16	74664743	rs7193541	T	C	74	72	146	0	1	147	0	0
16	74664810	rs7188880	A	T	92	85	177	0	2	179	0	0
16	74670458	rs4888262	C	T	68	49	117	0	0	117	0	0
16	74692426	rs4462623	C	T	4	2	6	0	0	6	0	0
16	74692453	rs4243108	C	T	4	2	6	0	0	6	0	0
16	74695079	rs8058922	G	T	53	63	116	0	1	117	0	0
16	74697421	rs8055784	C	T	4	2	6	0	0	6	0	0
16	74698252	rs74820302	A	T	4	4	8	0	0	8	0	0
16	74698263	rs7199068	C	G	5	3	8	0	0	8	0	0
16	74698576	rs4888270	A	G	11	4	15	0	0	15	0	0
16	74706298	rs4888274	A	T	44	35	79	0	1	80	0	0
16	74710254	rs6564157	T	C	10	5	15	0	0	15	0	0
16	74710728	rs7196369	T	C	3	5	8	0	0	8	0	0
16	74920191	rs14308	G	A	36	50	86	0	0	86	0	0
16	74943928	rs12324959	C	A	3	3	6	0	0	6	0	0
16	74944117	rs12919653	C	G	4	3	7	0	0	7	0	0
16	74944135	rs12324946	G	A	5	5	10	0	0	10	0	0
16	74944162	rs12918550	G	A	6	4	10	0	0	10	0	0
16	74945394	rs713257	G	C	5	7	12	0	0	12	0	0
16	75018874	rs12448858	G	A	11	3	14	0	0	14	0	0
16	75478089	rs149281505	G	A	32	41	73	0	0	73	0	0
16	75572495	rs2550888	G	A	8	11	19	0	0	19	0	0
16	75572713	rs2641800	G	A	7	10	17	0	0	17	0	0
16	75572791	rs2738790	G	A	7	9	16	0	0	16	0	0
16	75572793	rs2738789	T	C	7	9	16	0	0	16	0	0
16	75572820	rs2650396	G	A	6	7	13	0	0	13	0	0
16	75572906	rs364229	G	T	4	2	6	0	0	6	0	0
16	75573754	rs2242408	G	A	7	6	13	0	0	13	0	0
16	75573884	rs2242407	T	C	8	11	19	0	1	20	0	0
16	75630989	rs75354439	A	T	4	9	13	0	0	13	0	0
16	75633712	rs11149842	A	G	5	4	9	0	0	9	0	0
16	75633765	rs11546854	A	G	3	4	7	0	0	7	0	0
16	75636186	rs76060128	G	A	3	6	9	0	0	9	0	0
16	75646423	rs62619985	A	G	8	9	17	0	0	17	0	0
16	75646685	rs3743598	G	T	6	11	17	0	1	18	0	0
16	75656400	rs16941008	T	C	5	6	11	0	0	11	0	0
16	75661760	rs111679674	C	T	481	465	946	0	5	951	0	0
16	75661767	rs78654839	G	C	522	458	980	0	8	988	0	0
16	75661803	rs6834	G	C	514	450	964	0	9	974	1	0
16	75662883	rs41505349	C	T	3	3	6	0	0	6	0	0
16	75662925	rs61588474	T	G	4	2	6	0	0	6	0	0
16	75667013	rs4888441	G	C	5	2	7	0	0	7	0	0
16	75667954	rs6564270	C	T	34	27	61	0	2	63	0	0
16	75668164	.	G	C	460	420	880	0	6	887	1	0
16	75677576	rs60376290	C	A	4	5	9	0	0	9	0	0
16	75681603	rs1865492	G	A	8	5	13	0	1	14	0	0
16	75681743	rs1865493	C	G	54	30	84	0	1	85	0	0
16	75681756	rs2233810	C	A	64	38	102	0	1	103	0	0
16	75683614	rs73615089	G	A	3	10	13	0	0	13	0	0
16	75684526	rs114872429	C	T	7	12	19	0	0	19	0	0
16	75685511	rs4888443	A	G	11	18	29	0	0	29	0	0
16	75686146	rs7186790	G	T	6	4	10	0	0	10	0	0
16	75689858	rs60545422	C	T	16	12	28	0	0	28	0	0
16	75689900	rs56892159	C	T	22	15	37	0	0	37	0	0
16	77224863	rs2278045	A	C	3	3	6	0	0	6	0	0
16	77224889	rs2232498	G	T	9	6	15	0	0	15	0	0
16	77225718	rs11149970	C	G	10	2	12	0	0	12	0	0
16	77226904	rs7204238	G	C	4	2	6	0	1	7	0	0
16	77227180	rs2241416	G	A	3	7	10	0	0	10	0	0
16	77227884	rs3743761	C	G	6	6	12	0	0	12	0	0
16	77227942	rs3743762	T	C	7	9	16	0	0	16	0	0
16	77228866	rs2232504	T	C	23	19	42	0	1	43	0	0
16	77228971	rs2232506	C	T	30	23	53	0	0	53	0	0
16	77246218	rs13331769	G	A	9	10	19	0	0	19	0	0
16	77246517	rs62049594	C	A	23	13	36	0	0	36	0	0
16	77775917	rs1133108	A	G	9	7	16	0	0	16	0	0
16	78133671	rs11545028	C	T	36	38	74	0	0	74	0	0
16	79245820	rs383362	G	T	27	13	40	0	0	40	0	0
16	79245956	rs2288034	C	G	17	21	38	0	0	38	0	0
16	79245961	rs2288033	T	C	17	16	33	0	0	33	0	0
16	79246078	rs2288032	G	A	12	28	40	0	2	42	0	0
16	79246323	rs12828	G	A	31	26	57	0	0	57	0	0
16	79246535	rs391870	T	C	7	6	13	0	0	13	0	0
16	80632143	rs77437475	G	A	10	3	13	0	0	13	0	0
16	80632290	rs10395	T	C	8	5	13	0	0	13	0	0
16	80632586	rs1985288	A	G	9	5	14	0	0	14	0	0
16	80635000	rs4281727	C	T	8	1	9	0	1	10	0	0
16	80635032	rs4258628	G	A	8	1	9	0	0	9	0	0
16	80636812	.	A	C	5	2	7	0	0	7	0	0
16	80637015	rs8063688	A	G	4	2	6	0	0	6	0	0
16	80718879	rs8049284	A	G	1	8	9	0	0	9	0	0
16	81063537	rs7199631	C	T	7	10	17	0	0	17	0	0
16	81074691	.	C	A	4	3	7	0	0	7	0	0
16	81076821	rs2278022	T	C	39	53	92	0	1	93	0	0
16	81077204	rs16954513	T	A	40	46	86	0	0	86	0	0
16	81349486	rs570488627	A	G	12	8	20	0	0	20	0	0
16	81349491	rs4888136	C	T	11	8	19	0	1	20	0	0
16	81412168	rs12920236	G	A	7	5	12	0	0	12	0	0
16	81418565	rs544316973	C	T	6	0	6	0	0	6	0	0
16	81422951	rs8062805	T	C	5	6	11	0	0	11	0	0
16	81495350	rs80263475	C	T	6	8	14	0	0	14	0	0
16	81504339	rs58289676	G	A	4	5	9	0	0	9	0	0
16	81504448	rs1563654	G	C	3	4	7	0	0	7	0	0
16	81505109	rs57912627	A	C	4	3	7	0	0	7	0	0
16	81505160	rs565690980	G	A	5	4	9	0	0	9	0	0
16	81505281	rs74794715	C	A	4	2	6	0	0	6	0	0
16	81505396	rs9928937	G	T	4	4	8	0	0	8	0	0
16	81505584	rs34506659	A	G	4	2	6	0	0	6	0	0
16	81508244	rs80154255	T	G	14	16	30	0	0	30	0	0
16	81509279	rs2927333	A	G	3	5	8	0	0	8	0	0
16	81509722	rs2927328	T	C	2	5	7	0	0	7	0	0
16	81509727	rs78828066	T	C	2	5	7	0	0	7	0	0
16	81510046	rs2925999	T	C	6	20	26	0	0	26	0	0
16	81514976	rs75187514	G	C	5	5	10	0	0	10	0	0
16	81516858	rs2966086	T	C	3	5	8	0	0	8	0	0
16	81516996	rs76669629	C	A	4	5	9	0	0	9	0	0
16	81664100	rs7192273	T	C	10	10	20	0	1	21	0	0
16	81665052	rs4265801	T	G	19	21	40	0	0	40	0	0
16	81666536	rs4888160	T	C	4	2	6	0	0	6	0	0
16	81668671	rs72829098	A	G	15	10	25	0	0	25	0	0
16	81704033	rs8044418	C	G	5	4	9	0	0	9	0	0
16	81731869	rs4889367	A	G	3	3	6	0	0	6	0	0
16	81732358	rs765414	A	G	7	2	9	0	0	9	0	0
16	81734522	rs80289151	C	T	3	3	6	0	1	7	0	0
16	81740829	rs67721827	T	C	2	5	7	0	1	8	0	0
16	81741078	rs2052588	C	T	8	2	10	0	0	10	0	0
16	81742767	rs57916148	G	C	4	6	10	0	0	10	0	0
16	81743041	rs75410123	C	T	4	4	8	0	0	8	0	0
16	81819768	rs1143685	T	C	16	11	27	0	0	27	0	0
16	81922813	rs1143687	C	T	23	12	35	0	0	35	0	0
16	81941319	rs1143689	C	T	22	14	36	0	2	38	0	0
16	81970359	rs3934954	A	G	1	5	6	0	0	6	0	0
16	81970407	rs3934956	C	T	3	4	7	0	0	7	0	0
16	81970471	rs3934957	C	G	4	2	6	0	0	6	0	0
16	81970970	rs4077853	G	A	5	1	6	0	0	6	0	0
16	81971403	rs1071644	T	C	29	43	72	0	0	72	0	0
16	81993974	rs4243226	A	G	12	12	24	0	0	24	0	0
16	82181934	rs1056675	T	C	10	10	20	0	0	20	0	0
16	82181977	rs1064208	T	C	11	9	20	0	0	20	0	0
16	82203705	rs2303265	A	C	0	10	10	0	0	10	0	0
16	82203711	rs2303264	G	T	0	10	10	0	0	10	0	0
16	82203742	rs1134847	T	C	56	38	94	0	1	95	0	0
16	82203758	rs2303262	C	T	46	30	76	0	1	77	0	0
16	82203768	rs2303261	G	T	40	22	62	0	1	63	0	0
16	82203786	rs2303260	C	G	23	7	30	0	4	34	0	0
16	83842792	rs8053753	G	T	3	3	6	0	0	6	0	0
16	83843836	rs4782845	C	T	4	2	6	0	0	6	0	0
16	83846198	rs4522	G	A	109	112	221	0	4	225	0	0
16	84087787	rs146603309	C	T	89	85	174	0	1	175	0	0
16	84087888	rs150264549	G	A	63	57	120	0	0	120	0	0
16	84088047	rs11607	C	T	58	45	103	0	2	105	0	0
16	84088968	rs8053890	T	C	4	4	8	0	0	8	0	0
16	84089767	rs17849043	C	T	8	10	18	0	0	18	0	0
16	84090364	rs7205717	A	C	7	6	13	0	0	13	0	0
16	84090519	rs7206438	G	T	10	6	16	0	1	17	0	0
16	84091056	rs3785012	G	C	11	4	15	0	0	15	0	0
16	84091104	rs3785013	A	G	13	7	20	0	0	20	0	0
16	84091113	rs143549415	C	T	11	6	17	0	0	17	0	0
16	84091155	rs3785014	C	A	8	5	13	0	0	13	0	0
16	84091169	rs3785015	G	A	9	5	14	0	0	14	0	0
16	84091823	rs12598408	G	A	17	7	24	0	0	24	0	0
16	84092382	rs4782583	A	C	11	3	14	0	0	14	0	0
16	84092466	rs2280025	C	T	9	3	12	0	0	12	0	0
16	84092896	rs150333081	C	T	7	6	13	0	0	13	0	0
16	84093062	rs2280024	G	A	10	3	13	0	0	13	0	0
16	84093152	rs2280023	T	G	8	7	15	0	0	15	0	0
16	84094015	rs140048642	C	T	2	6	8	0	0	8	0	0
16	84094865	rs999783	C	T	10	8	18	0	0	18	0	0
16	84095147	rs999782	A	G	11	6	17	0	0	17	0	0
16	84095691	rs3759972	C	G	3	6	9	0	0	9	0	0
16	84096014	rs3759974	G	A	4	3	7	0	0	7	0	0
16	84096130	rs7193888	C	T	5	3	8	0	0	8	0	0
16	84103572	.	C	T	47	35	82	0	2	84	0	0
16	84115279	rs3826139	T	C	5	28	33	0	0	33	0	0
16	84115483	rs3743631	G	A	42	37	79	0	2	81	0	0
16	84115893	rs146962228	A	G	2	5	7	0	0	7	0	0
16	84119815	rs7200337	G	C	5	9	14	0	0	14	0	0
16	84120005	rs7200709	G	A	11	8	19	0	1	20	0	0
16	84120325	rs12448774	T	C	9	9	18	0	0	18	0	0
16	84120534	rs16962761	G	T	7	9	16	0	0	16	0	0
16	84120656	rs2875857	A	C	12	10	22	0	0	22	0	0
16	84120784	rs869426	C	T	5	11	16	0	0	16	0	0
16	84125629	rs2292321	G	C	5	3	8	0	0	8	0	0
16	84126358	rs11149625	C	A	3	3	6	0	1	7	0	0
16	84135453	rs1049884	A	T	24	13	37	0	0	37	0	0
16	84135515	rs11550471	C	T	25	16	41	0	1	42	0	0
16	84150378	rs7205363	A	G	13	20	33	0	0	33	0	0
16	84150454	rs7205403	A	G	2	9	11	0	0	11	0	0
16	84156755	rs3817155	G	A	8	5	13	0	0	13	0	0
16	84211483	rs8692	C	T	6	5	11	0	0	11	0	0
16	84211718	rs1056616	C	T	29	35	64	0	0	64	0	0
16	84211735	rs2288025	A	C	34	38	72	0	1	73	0	0
16	84211788	rs1056612	G	C	56	45	101	0	0	101	0	0
16	84211969	rs3208968	A	C	58	37	95	0	1	96	0	0
16	84212031	rs1056611	A	C	47	44	91	0	1	92	0	0
16	84212779	rs2230131	G	A	37	54	91	0	1	92	0	0
16	84212928	rs3743642	G	A	40	37	77	0	2	79	0	0
16	84213965	rs2278043	G	A	23	12	35	0	0	35	0	0
16	84214214	rs4150162	A	T	19	11	30	0	1	31	0	0
16	84214236	rs4150161	T	C	15	10	25	0	1	26	0	0
16	84214338	rs4150159	C	A	6	6	12	0	0	12	0	0
16	84218565	rs2230126	T	C	34	13	47	0	0	47	0	0
16	84691044	rs3751762	C	T	21	29	50	0	0	50	0	0
16	84691823	rs12444911	C	T	17	14	31	0	0	31	0	0
16	84692572	rs12445708	C	T	11	10	21	0	1	22	0	0
16	84693084	rs11149671	A	G	20	21	41	0	0	41	0	0
16	84693099	rs11149672	G	C	21	19	40	0	0	40	0	0
16	84693675	rs2303230	C	T	3	3	6	0	0	6	0	0
16	84693879	rs9319452	G	A	2	4	6	0	0	6	0	0
16	84695990	rs4783041	C	T	5	4	9	0	0	9	0	0
16	84697706	rs873857	G	C	5	4	9	0	0	9	0	0
16	84699839	rs3803626	G	A	2	4	6	0	0	6	0	0
16	84734412	rs6564067	G	A	5	1	6	0	0	6	0	0
16	84766138	rs11863037	G	C	3	6	9	0	0	9	0	0
16	84786175	rs8044808	T	C	4	6	10	0	0	10	0	0
16	84786185	rs17764145	G	A	4	7	11	0	0	11	0	0
16	84786347	rs6564075	A	G	3	3	6	0	0	6	0	0
16	84788948	rs1477392	C	T	4	2	6	0	0	6	0	0
16	84792291	rs41327444	A	G	3	6	9	0	0	9	0	0
16	84792428	rs7202832	C	T	2	6	8	0	0	8	0	0
16	84797967	rs75396687	G	T	3	3	6	0	0	6	0	0
16	84808824	rs774298	C	G	97	88	185	0	0	185	0	0
16	84808900	rs774299	G	A	4	6	10	0	0	10	0	0
16	84808969	rs2303232	G	C	3	6	9	0	1	10	0	0
16	84808984	rs774300	T	C	3	6	9	0	0	9	0	0
16	84810224	rs774302	C	T	3	3	6	0	0	6	0	0
16	84810776	rs12932847	T	G	8	9	17	0	0	17	0	0
16	84811789	rs17597942	A	G	12	4	16	0	0	16	0	0
16	84811961	rs774306	G	A	3	3	6	0	0	6	0	0
16	84872051	rs1546124	G	C	7	3	10	0	0	10	0	0
16	84879464	rs12051468	A	G	6	9	15	0	0	15	0	0
16	84883102	rs8061351	C	T	6	6	12	0	0	12	0	0
16	84940525	rs3803632	G	C	3	6	9	0	0	9	0	0
16	84940980	rs2641670	G	A	12	9	21	0	0	21	0	0
16	84941329	rs4783099	C	T	6	18	24	0	0	24	0	0
16	84941818	rs3751758	C	T	14	1	15	0	0	15	0	0
16	84942638	rs16974880	T	G	4	27	31	0	0	31	0	0
16	84943049	rs2485	A	T	4	2	6	0	0	6	0	0
16	85009463	rs3210967	T	C	178	160	338	0	7	345	0	0
16	85009970	rs7195377	A	G	213	198	411	0	2	415	2	0
16	85011622	rs8044638	G	A	7	3	10	0	0	10	0	0
16	85012430	rs6564088	T	C	10	2	12	0	1	13	0	0
16	85015541	rs16975086	G	A	120	133	253	0	4	258	1	0
16	85016975	rs1566460	C	T	11	7	18	0	0	18	0	0
16	85018323	rs3930432	T	C	9	9	18	0	0	18	0	0
16	85018854	rs1566459	A	C	4	5	9	0	0	9	0	0
16	85018931	rs1566458	T	C	5	4	9	0	0	9	0	0
16	85019615	rs16975090	A	G	4	5	9	0	0	9	0	0
16	85020061	rs16975093	G	A	5	4	9	0	0	9	0	0
16	85020704	rs1982969	T	C	5	2	7	0	0	7	0	0
16	85020864	rs1982968	T	C	5	4	9	0	1	10	0	0
16	85020974	rs1982967	T	C	6	4	10	0	0	10	0	0
16	85023855	rs931713	C	T	8	9	17	0	0	17	0	0
16	85028221	.	C	T	4	7	11	0	0	11	0	0
16	85035412	rs35215168	A	G	7	9	16	0	0	16	0	0
16	85205255	rs8056587	C	T	6	1	7	0	0	7	0	0
16	85698079	rs3812967	T	G	3	4	7	0	0	7	0	0
16	85701573	.	A	T	17	3	20	0	1	21	0	0
16	85701586	.	C	T	17	8	25	0	0	25	0	0
16	85708846	rs2029	C	A	36	28	64	0	1	65	0	0
16	85709316	rs11865	A	G	46	38	84	0	1	85	0	0
16	85709610	rs8571	G	A	51	46	97	0	0	97	0	0
16	85710983	rs1974868	C	T	2	10	12	0	0	12	0	0
16	85711077	rs1974869	G	A	3	5	8	0	0	8	0	0
16	85711502	rs9534	T	C	56	64	120	0	1	121	0	0
16	85722560	rs58171120	C	G	11	4	15	0	0	15	0	0
16	85741257	rs7773	C	G	13	6	19	0	0	19	0	0
16	85812955	.	T	A	13	17	30	0	0	30	0	0
16	85813231	rs8587	A	C	58	45	103	0	0	103	0	0
16	85813526	rs301163	G	A	8	5	13	0	0	13	0	0
16	85815097	rs96603	C	T	6	3	9	0	0	9	0	0
16	85816204	rs100812	C	G	1	7	8	0	0	8	0	0
16	85816971	rs301170	G	A	3	4	7	0	0	7	0	0
16	85817250	rs301171	T	C	5	7	12	0	0	12	0	0
16	85819521	rs4843788	G	A	4	4	8	0	0	8	0	0
16	85821934	rs921435	A	T	7	2	9	0	0	9	0	0
16	85821974	rs921436	C	G	4	3	7	0	0	7	0	0
16	85825529	rs9931892	G	T	5	1	6	0	0	6	0	0
16	85825951	rs12923264	G	A	4	3	7	0	0	7	0	0
16	85827269	rs9931644	T	C	3	5	8	0	0	8	0	0
16	85828183	rs56306388	T	C	4	3	7	0	0	7	0	0
16	85828228	rs6540211	A	G	4	2	6	0	0	6	0	0
16	85828564	rs3794664	C	G	4	6	10	0	0	10	0	0
16	85829560	rs7206847	C	T	6	8	14	0	0	14	0	0
16	85833737	rs2072627	G	A	4	2	6	0	0	6	0	0
16	85836489	rs116972724	C	T	15	18	33	0	0	33	0	0
16	85838026	rs137975688	G	A	17	18	35	0	0	35	0	0
16	85955304	rs1568391	G	T	8	0	8	0	0	8	0	0
16	85956044	rs6638	A	T	25	13	38	0	0	39	1	0
16	86563894	rs8776	C	T	2	5	7	0	0	7	0	0
16	86564364	rs1046990	A	G	5	4	9	0	0	9	0	0
16	86565537	rs56017283	C	G	4	6	10	0	0	10	0	0
16	86565882	rs3751802	G	C	11	7	18	0	0	18	0	0
16	86566039	rs3751801	C	T	5	8	13	0	0	13	0	0
16	86566042	rs3751800	G	A	5	7	12	0	0	12	0	0
16	86575992	rs55782369	G	T	5	1	6	0	0	6	0	0
16	86576331	rs7204197	A	G	4	4	8	0	0	8	0	0
16	86580891	rs2303229	A	G	2	4	6	0	0	6	0	0
16	87397288	rs745280	G	A	4	2	6	0	0	6	0	0
16	87417621	rs2318450	G	A	6	1	7	0	0	7	0	0
16	87423600	rs62053114	C	G	4	2	6	0	0	6	0	0
16	87440895	rs1050863	G	A	4	4	8	0	1	9	0	0
16	87445363	rs1050846	G	A	3	5	8	0	0	8	0	0
16	87736160	rs113031351	G	A	3	4	7	0	0	7	0	0
16	87736778	rs1469453	T	C	3	5	8	0	0	8	0	0
16	87788864	rs2303771	G	A	28	24	52	0	0	52	0	0
16	87864269	rs16943300	G	A	484	499	983	0	22	1005	0	0
16	87865201	rs55936694	T	A	303	262	565	0	16	581	0	0
16	87867591	rs1806865	C	T	6	9	15	0	0	15	0	0
16	87868462	rs56207802	C	T	8	7	15	0	0	15	0	0
16	87868974	rs7186542	C	G	8	6	14	0	0	14	0	0
16	87869090	rs34475048	A	T	5	8	13	0	0	13	0	0
16	87869220	rs12711480	T	C	3	5	8	0	0	8	0	0
16	87869516	rs55776570	C	G	4	4	8	0	0	8	0	0
16	87869540	rs35225909	C	T	3	5	8	0	0	8	0	0
16	87869640	rs16943315	G	A	7	7	14	0	1	15	0	0
16	87869711	rs12444533	C	T	5	8	13	0	0	13	0	0
16	87870312	rs12444670	C	T	4	3	7	0	0	7	0	0
16	87870866	rs4265809	T	C	4	3	7	0	0	7	0	0
16	87872488	rs2287122	G	A	10	13	23	0	0	23	0	0
16	87872718	rs4843712	G	C	14	6	20	0	0	20	0	0
16	87872844	rs4843713	A	G	8	4	12	0	0	12	0	0
16	87873577	rs12927136	A	G	2	5	7	0	0	7	0	0
16	87874182	rs12931876	T	C	3	5	8	0	0	8	0	0
16	87874336	rs4843714	G	A	3	5	8	0	0	8	0	0
16	87876375	rs34508683	T	C	7	0	7	0	0	7	0	0
16	87876500	rs34380332	A	G	8	3	11	0	0	11	0	0
16	87876567	rs28684940	C	T	10	3	13	0	0	13	0	0
16	87876631	rs28609922	C	A	11	5	16	0	0	16	0	0
16	87876812	rs28611500	T	C	5	3	8	0	0	8	0	0
16	87876859	rs28415618	T	C	4	4	8	0	0	8	0	0
16	87877246	rs58852522	T	C	6	5	11	0	0	11	0	0
16	87877312	rs57455079	G	A	6	4	10	0	0	10	0	0
16	87877313	rs56722741	C	G	6	4	10	0	0	10	0	0
16	87878072	rs4843270	C	A	2	5	7	0	0	7	0	0
16	87878076	rs4843715	G	A	2	5	7	0	0	7	0	0
16	87878162	rs4843716	T	G	5	3	8	0	0	8	0	0
16	87878165	rs4843717	T	C	5	3	8	0	0	8	0	0
16	87878476	rs4843718	G	A	2	7	9	0	0	9	0	0
16	87878651	rs8052118	C	A	4	4	8	0	1	9	0	0
16	87878708	rs8052746	A	G	6	5	11	0	0	11	0	0
16	87878822	rs8051149	G	A	6	4	10	0	0	10	0	0
16	87878883	rs35459492	C	G	7	3	10	0	0	10	0	0
16	87878964	rs4325563	A	G	6	2	8	0	0	8	0	0
16	87882539	rs74039983	A	G	3	4	7	0	0	7	0	0
16	87889714	rs4843272	C	T	3	4	7	0	0	7	0	0
16	87986136	rs7186168	T	C	52	54	106	0	0	106	0	0
16	87987424	rs6540120	C	T	2	6	8	0	0	8	0	0
16	87995179	rs7205205	A	G	5	4	9	0	0	9	0	0
16	87995200	rs12934497	A	G	5	3	8	0	0	8	0	0
16	87995510	rs7205819	A	G	8	15	23	0	0	23	0	0
16	88017809	rs3815820	C	T	5	5	10	0	0	10	0	0
16	88110422	rs7499959	C	G	6	9	15	0	1	16	0	0
16	88505786	rs78600508	C	A	3	4	7	0	0	7	0	0
16	88552370	rs3751673	A	G	5	3	8	0	1	9	0	0
16	88555464	rs148828760	G	A	12	8	20	0	1	21	0	0
16	88594567	rs35121729	C	T	7	12	19	0	0	19	0	0
16	88599023	rs56041036	A	G	6	13	19	0	0	19	0	0
16	88655501	rs11865270	G	T	3	4	7	0	0	7	0	0
16	88656044	rs12597572	A	G	10	8	18	0	1	20	1	0
16	88689997	rs2277903	C	T	3	3	6	0	0	6	0	0
16	88693051	rs62047995	G	A	8	8	16	0	0	16	0	0
16	88695338	rs4782388	C	G	3	4	7	0	0	7	0	0
16	88695376	rs4782307	A	G	4	3	7	0	0	7	0	0
16	88695484	rs58553631	C	T	6	1	7	0	0	7	0	0
16	88695604	rs7198909	C	T	3	4	7	0	1	8	0	0
16	88696485	rs8062710	C	G	17	15	32	0	0	32	0	0
16	88696525	rs77426029	A	G	12	14	26	0	0	26	0	0
16	88709712	rs7195830	A	G	112	113	225	0	1	226	0	0
16	88709737	rs1049255	C	T	220	207	427	0	3	430	0	0
16	88709828	rs1049254	A	G	451	342	793	0	68	862	1	0
16	88710833	rs3180279	C	G	155	146	301	0	1	302	0	0
16	88710882	rs3794622	T	C	134	144	278	0	5	283	0	0
16	88710888	rs3794623	G	T	119	139	258	0	3	261	0	0
16	88712319	rs12709102	T	C	32	45	77	0	0	77	0	0
16	88712733	.	C	T	28	7	35	0	2	37	0	0
16	88712767	rs12933505	A	G	23	13	36	0	1	37	0	0
16	88712780	rs12933512	A	C	25	13	38	0	0	38	0	0
16	88712782	rs12709103	A	G	25	13	38	0	0	38	0	0
16	88713236	rs4673	A	G	2238	2124	4362	0	17	4379	0	0
16	88713473	rs4782308	G	A	6	20	26	0	0	26	0	0
16	88713501	rs4782393	A	G	7	18	25	0	1	26	0	0
16	88717285	rs149933335	T	C	2	5	7	0	0	7	0	0
16	88718353	rs9932581	C	T	3	6	9	0	0	9	0	0
16	88770033	rs76206848	G	A	17	15	32	0	0	32	0	0
16	88804462	.	G	A	47	43	90	0	1	91	0	0
16	88871908	rs1834065	A	G	184	145	329	0	4	333	0	0
16	88872229	rs480727	A	G	256	245	501	0	3	504	0	0
16	88874632	rs572275	C	G	329	356	685	0	3	688	0	0
16	88875248	rs188631314	C	A	114	117	231	0	2	233	0	0
16	88875478	rs8191509	C	T	182	197	379	0	1	381	1	0
16	88875928	rs4695	T	C	330	194	524	0	1	525	0	0
16	88876059	rs8191497	A	G	631	631	1262	0	5	1267	0	0
16	88876666	rs8191489	C	G	21	14	35	0	0	35	0	0
16	88877004	rs8191487	A	G	26	32	58	0	1	59	0	0
16	88882257	rs555812	T	G	6	4	10	0	0	10	0	0
16	88882857	rs79530020	C	T	4	4	8	0	0	8	0	0
16	88883047	rs12935469	T	G	5	4	9	0	0	9	0	0
16	88884466	rs2303271	C	T	58	50	108	0	2	110	0	0
16	88891240	rs2303269	C	A	39	41	80	0	0	80	0	0
16	88901673	rs35232749	G	A	42	38	80	0	1	81	0	0
16	88904086	rs3743544	A	G	20	28	48	0	2	50	0	0
16	88929272	rs74822080	G	T	6	12	18	0	0	18	0	0
16	88929890	.	C	T	5	7	12	0	0	12	0	0
16	89336188	.	G	C	5	5	10	0	0	10	0	0
16	89342733	rs7192878	G	A	4	2	6	0	0	6	0	0
16	89344477	rs1466540	C	T	3	4	7	0	0	7	0	0
16	89344767	.	T	C	6	5	11	0	0	11	0	0
16	89346871	.	G	C	8	12	20	0	0	20	0	0
16	89359010	rs1979504	C	T	3	3	6	0	1	7	0	0
16	89368030	rs3114914	C	T	4	9	13	0	0	13	0	0
16	89369430	rs3803692	G	A	5	6	11	0	0	11	0	0
16	89370677	rs3096311	C	G	1	5	6	0	0	6	0	0
16	89406914	rs3102379	T	C	12	6	18	0	0	18	0	0
16	89406943	rs7403817	A	C	15	5	20	0	0	20	0	0
16	89409720	rs3102381	G	C	1	7	8	0	0	8	0	0
16	89458527	rs2930214	T	C	0	11	11	0	1	12	0	0
16	89458984	rs7205785	A	G	5	9	14	0	0	14	0	0
16	89493043	rs2965939	G	A	1	6	7	0	0	7	0	0
16	89553624	rs4785676	T	C	4	5	9	0	0	9	0	0
16	89553707	rs4785568	A	G	6	8	14	0	0	14	0	0
16	89570635	rs4347628	T	C	2	5	7	0	0	7	0	0
16	89584185	rs7192801	G	T	3	5	8	0	0	8	0	0
16	89587438	rs57654699	C	G	3	4	7	0	1	8	0	0
16	89587579	rs57505611	C	T	3	4	7	0	0	7	0	0
16	89590060	rs28643511	G	A	1	5	6	0	0	6	0	0
16	89590243	rs3803680	G	A	2	5	7	0	1	8	0	0
16	89597221	rs4785691	A	G	9	0	9	0	0	9	0	0
16	89603586	rs382745	A	G	3	10	13	0	0	13	0	0
16	89607414	rs2056309	G	A	13	5	18	0	1	19	0	0
16	89607679	rs3751687	G	A	7	7	14	0	0	14	0	0
16	89608235	rs457372	A	G	5	2	7	0	0	7	0	0
16	89608342	rs12928752	T	C	2	5	7	0	0	7	0	0
16	89613123	rs2292954	A	G	30	23	53	0	1	54	0	0
16	89615333	rs67643661	C	T	17	11	28	0	0	28	0	0
16	89615453	rs4325552	A	C	11	6	17	0	1	18	0	0
16	89616039	rs997212	G	A	9	2	11	0	0	11	0	0
16	89616155	rs2377056	G	T	7	6	13	0	0	13	0	0
16	89616167	rs2889543	T	C	5	6	11	0	0	11	0	0
16	89616178	rs2377057	G	A	5	5	10	0	0	10	0	0
16	89616232	rs1864155	G	A	4	4	8	0	0	8	0	0
16	89616725	rs71396923	C	T	6	1	7	0	1	8	0	0
16	89616772	rs71396924	G	T	5	1	6	0	0	6	0	0
16	89617064	rs3794632	G	C	4	5	9	0	0	9	0	0
16	89617518	rs17775174	C	T	8	7	15	0	0	15	0	0
16	89618530	rs4785577	G	A	6	9	15	0	0	15	0	0
16	89620328	rs12960	G	A	48	31	79	0	2	81	0	0
16	89623405	rs61747711	C	T	63	59	122	0	1	123	0	0
16	89627460	rs2280370	T	G	2145	530	2675	0	9	2684	0	0
16	89627671	rs174035	C	T	1493	796	2289	0	5	2294	0	0
16	89628381	rs3751691	C	T	10	10	20	0	0	20	0	0
16	89628621	rs3751690	A	G	12	14	26	0	0	26	0	0
16	89628870	rs885268	C	G	19	8	27	0	0	27	0	0
16	89629070	rs34414057	C	G	16	11	27	0	1	28	0	0
16	89629736	rs3211567	C	T	240	360	600	0	1	601	0	0
16	89629780	rs3211568	G	A	144	255	399	0	2	401	0	0
16	89629819	rs3211569	G	A	112	163	275	0	2	277	0	0
16	89629928	rs57775530	C	G	16	4	20	0	2	22	0	0
16	89630092	rs13380730	C	G	39	32	71	0	0	71	0	0
16	89630212	rs12709088	T	A	39	20	59	0	0	59	0	0
16	89630311	rs12709089	G	A	32	22	54	0	0	54	0	0
16	89630630	rs12932337	C	T	49	36	85	0	1	86	0	0
16	89648580	rs352935	C	T	10	2	12	0	0	12	0	0
16	89662422	rs461227	A	G	9	9	18	0	0	18	0	0
16	89662990	rs694285	T	C	45	38	83	0	0	83	0	0
16	89663072	rs659974	G	A	29	42	71	0	1	72	0	0
16	89724590	rs151272435	G	A	12	15	27	0	0	27	0	0
16	89795381	rs13339414	G	A	3	4	7	0	0	7	0	0
16	89801952	rs11649196	G	A	4	3	7	0	0	7	0	0
16	90230250	.	C	T	6	0	6	0	0	6	0	0
16	90232872	.	C	T	23	17	40	0	0	40	0	0
16	90236509	rs139560308	T	C	7	0	7	0	1	8	0	0
17	62484	rs1138504	T	A	5	1	6	0	0	6	0	0
17	62646	rs9907477	C	T	1	5	6	0	0	6	0	0
17	258914	rs9895447	G	A	2	4	6	0	1	7	0	0
17	259248	rs71355256	C	T	4	4	8	0	0	8	0	0
17	262555	rs35067709	A	G	4	2	6	0	0	6	0	0
17	290362	rs12776	C	G	559	501	1060	0	5	1065	0	0
17	290370	rs13072	A	C	509	459	968	0	9	978	1	0
17	290460	rs3201393	T	G	507	442	949	0	6	955	0	0
17	290552	rs7223337	A	G	402	408	810	0	8	818	0	0
17	291564	rs80162254	G	A	302	327	629	0	3	632	0	0
17	294087	rs9914883	C	T	6	4	10	0	0	10	0	0
17	295283	rs7225942	T	G	7	10	17	0	1	18	0	0
17	419335	rs35712141	C	T	4	4	8	0	0	8	0	0
17	419903	rs34570514	G	A	12	4	16	0	0	16	0	0
17	421269	.	C	T	9	8	17	0	0	17	0	0
17	617993	rs35915949	C	T	6	7	13	0	0	13	0	0
17	645261	rs74363945	C	T	10	9	19	0	0	19	0	0
17	649067	rs1062923	A	G	33	33	66	0	1	67	0	0
17	650518	rs35696687	G	A	54	33	87	0	0	87	0	0
17	908502	rs11247571	A	G	44	57	101	0	0	101	0	0
17	1129279	rs28687296	C	T	9	7	16	0	0	16	0	0
17	1130029	rs9747955	C	T	3	4	7	0	0	7	0	0
17	1130470	rs9747012	C	T	7	4	11	0	0	11	0	0
17	1130749	rs9908795	G	A	5	6	11	0	1	12	0	0
17	1131179	rs34317816	G	T	3	3	6	0	0	6	0	0
17	1131254	rs28571829	T	C	5	4	9	0	0	9	0	0
17	1131258	rs34009414	G	T	5	4	9	0	0	9	0	0
17	1249777	rs7213824	A	G	2	10	12	0	0	12	0	0
17	1261112	rs6502174	C	T	6	2	8	0	0	8	0	0
17	1397973	rs149739834	C	T	47	47	94	0	5	99	0	0
17	1398259	rs111962255	C	T	65	67	132	0	2	134	0	0
17	1398270	rs1059139	G	A	65	67	132	0	0	132	0	0
17	1398300	rs14391	C	A	63	50	113	0	1	114	0	0
17	1421390	rs17474	A	G	30	27	57	0	0	57	0	0
17	1440460	.	C	G	3	3	6	0	0	6	0	0
17	1473578	rs9890887	G	C	5	2	7	0	0	7	0	0
17	1475033	rs7210066	C	A	7	1	8	0	0	8	0	0
17	1477007	rs35312453	C	T	5	2	7	0	0	7	0	0
17	1477062	rs76568554	C	T	2	6	8	0	0	8	0	0
17	1477522	rs78703872	G	T	9	8	17	0	0	17	0	0
17	1477619	rs6502793	A	G	12	8	20	0	0	20	0	0
17	1494567	rs12953268	G	A	10	6	16	0	0	16	0	0
17	1539845	.	T	G	3	3	6	0	0	6	0	0
17	1540106	rs34849297	G	A	46	37	83	0	0	83	0	0
17	1636945	rs146469235	C	T	14	15	29	0	0	29	0	0
17	1683012	rs11062	G	A	5	4	9	0	0	9	0	0
17	1683284	rs1133109	G	T	5	5	10	0	0	10	0	0
17	1690752	rs11549830	G	A	6	3	9	0	0	9	0	0
17	1733399	rs5030749	A	G	31	30	61	0	3	64	0	0
17	1782957	rs2230930	C	T	57	66	123	0	2	125	0	0
17	1941768	rs11078787	A	C	3	6	9	0	0	9	0	0
17	1942861	rs7207466	C	T	5	10	15	0	0	15	0	0
17	1943888	rs2236375	T	C	65	68	133	0	1	134	0	0
17	1945225	rs869020	T	G	4	10	14	0	1	15	0	0
17	1945621	rs2015866	G	T	3	4	7	0	1	8	0	0
17	1945694	rs55815331	C	T	2	5	7	0	0	7	0	0
17	1945744	rs55801908	C	T	5	6	11	0	0	11	0	0
17	1946503	rs1051322	C	G	273	309	582	0	3	585	0	0
17	1963961	rs12946564	G	A	38	35	73	0	0	73	0	0
17	1964018	rs903158	G	A	41	23	64	0	7	71	0	0
17	1964397	rs903157	A	T	31	39	70	0	0	70	0	0
17	1965085	rs7214308	C	T	10	9	19	0	0	19	0	0
17	1965096	rs12939002	C	T	10	8	18	0	1	19	0	0
17	1965542	rs12451211	G	A	5	8	13	0	0	13	0	0
17	1966457	rs1048483	C	T	2	5	7	0	0	7	0	0
17	2096384	rs1466389	C	T	8	6	14	0	1	15	0	0
17	2177484	rs9898390	C	G	9	8	17	0	0	17	0	0
17	2178092	rs2038677	C	G	4	7	11	0	0	11	0	0
17	2202323	rs34047637	T	C	18	14	32	0	0	32	0	0
17	2202943	rs216196	T	C	17	17	34	0	0	34	0	0
17	2202949	rs138722546	C	T	18	15	33	0	2	35	0	0
17	2203025	rs1885987	T	G	21	17	38	0	0	38	0	0
17	2203167	rs216195	T	G	19	16	35	0	0	35	0	0
17	2203175	rs1885986	C	G	17	15	32	0	0	32	0	0
17	2222325	rs8081273	C	T	1	5	6	0	0	6	0	0
17	2223486	rs191085938	C	G	3	4	7	0	0	7	0	0
17	2230386	rs4477758	T	C	5	2	7	0	0	7	0	0
17	2236404	rs2281726	T	C	25	24	49	0	1	50	0	0
17	2238675	rs61743762	A	G	46	42	88	0	1	89	0	0
17	2241899	rs7218436	T	C	5	3	8	0	0	8	0	0
17	2275701	rs185126674	C	T	37	41	78	0	1	79	0	0
17	2278644	rs2252910	C	T	8	10	18	0	0	18	0	0
17	2293725	rs2429918	C	A	5	6	11	0	0	11	0	0
17	2299766	rs1970835	A	G	3	5	8	0	0	8	0	0
17	2321253	rs5015342	A	G	37	24	61	0	1	62	0	0
17	2322598	rs3744276	C	T	19	25	44	0	0	44	0	0
17	2322776	rs1056321	T	C	15	16	31	0	0	31	0	0
17	2929011	rs12601808	G	C	5	4	9	0	0	9	0	0
17	2934876	rs12946537	G	A	7	2	9	0	1	10	0	0
17	2934984	rs12938309	C	T	6	1	7	0	0	7	0	0
17	2935133	.	T	A	8	4	12	0	1	13	0	0
17	2936770	rs12150200	T	C	28	22	50	0	0	50	0	0
17	2939070	rs4480844	G	A	33	26	59	0	0	59	0	0
17	2939582	rs4264423	G	A	42	42	84	0	1	85	0	0
17	2939694	rs62089808	T	C	51	47	98	0	0	98	0	0
17	2939782	rs12936437	T	C	45	51	96	0	1	97	0	0
17	2939981	rs12603123	A	G	47	43	90	0	0	90	0	0
17	2940720	rs10805	C	A	31	20	51	0	0	51	0	0
17	3480447	rs8065080	T	C	4	3	7	0	1	8	0	0
17	3486702	rs224534	G	A	5	3	8	0	1	9	0	0
17	3493200	rs222747	C	G	1	6	7	0	0	7	0	0
17	3511808	rs460716	A	G	2	5	7	0	0	7	0	0
17	3513719	rs465563	G	A	9	10	19	0	0	19	0	0
17	3557499	rs437287	C	T	4	2	6	0	0	6	0	0
17	3563963	rs2873624	C	G	11	8	19	0	0	19	0	0
17	3564400	rs222754	T	A	17	14	31	0	0	31	0	0
17	3566232	rs7093	C	T	40	40	80	0	0	80	0	0
17	3578122	rs149592	A	C	3	4	7	0	0	7	0	0
17	3579398	rs160583	A	T	4	3	7	0	0	7	0	0
17	3579417	rs150849	C	G	4	3	7	0	0	7	0	0
17	3579858	rs222765	C	T	4	2	6	0	0	6	0	0
17	3581110	rs150850	C	T	5	4	9	0	0	9	0	0
17	3581903	rs150853	C	A	5	2	7	0	0	7	0	0
17	3582595	rs160580	A	G	5	1	6	0	0	6	0	0
17	3591359	rs146166049	G	A	114	74	188	0	0	188	0	0
17	3705526	rs2891	C	T	6	7	13	0	0	13	0	0
17	3717716	.	G	A	52	44	96	0	0	96	0	0
17	3726827	rs4790543	G	A	6	2	8	0	0	8	0	0
17	3742922	rs12602844	A	G	40	34	74	0	0	74	0	0
17	3764630	rs2288684	G	A	39	27	66	0	0	66	0	0
17	3765268	rs2915546	T	G	18	13	31	0	0	31	0	0
17	3775848	rs7214723	T	C	28	16	44	0	0	44	0	0
17	3788099	rs55771332	G	A	4	2	6	0	0	6	0	0
17	3796257	rs113583025	C	T	2	4	6	0	0	6	0	0
17	3797269	rs4790547	C	A	1	7	8	0	0	8	0	0
17	3799918	rs6502752	G	C	112	74	186	0	0	186	0	0
17	3800218	rs28930668	C	T	304	277	581	0	12	593	0	0
17	3804073	rs4790548	A	G	3	9	12	0	0	12	0	0
17	3805848	rs7214561	T	C	9	1	10	0	0	10	0	0
17	3807044	rs740794	T	C	26	15	41	0	5	46	0	0
17	3810251	rs11078473	C	T	5	11	16	0	1	17	0	0
17	3810390	rs116855460	G	T	3	8	11	0	1	12	0	0
17	3811039	rs147972206	G	C	6	6	12	0	0	12	0	0
17	3811533	rs3826484	C	T	3	8	11	0	0	11	0	0
17	3812388	rs56107789	G	A	6	2	8	0	0	8	0	0
17	3814429	rs35154409	C	T	14	14	28	0	1	29	0	0
17	3814718	rs12946584	C	T	29	16	45	0	0	45	0	0
17	3814826	rs9898098	C	A	4	7	11	0	0	11	0	0
17	3815464	rs12603104	G	A	20	21	41	0	0	41	0	0
17	3815920	rs1985205	C	T	17	13	30	0	1	31	0	0
17	3816140	rs56176070	G	A	27	24	51	0	1	52	0	0
17	3816488	rs12948248	C	A	9	13	22	0	0	22	0	0
17	3816952	rs12947413	G	A	25	19	44	0	2	46	0	0
17	3817609	rs1007637	G	A	20	16	36	0	1	37	0	0
17	3827502	rs917605	T	G	414	417	831	0	12	843	0	0
17	4060233	rs118123280	G	A	15	13	28	0	0	28	0	0
17	4173248	rs144121055	G	A	88	56	144	0	2	146	0	0
17	4351560	rs12450838	G	A	166	150	316	0	0	316	0	0
17	4352539	rs7224464	C	T	152	118	270	0	1	271	0	0
17	4356375	rs11655342	G	T	177	190	367	0	2	369	0	0
17	4391430	rs333121	T	C	89	109	198	0	0	198	0	0
17	4439512	rs11658114	A	G	17	15	32	0	1	33	0	0
17	4439515	rs9908450	G	T	16	18	34	0	0	34	0	0
17	4457116	rs78557985	T	C	32	25	57	0	5	62	0	0
17	4536241	rs743646	T	C	1	5	6	0	0	6	0	0
17	4577884	rs76038822	C	G	31	44	75	0	0	75	0	0
17	4619091	rs28365157	C	T	34	56	90	0	0	90	0	0
17	4699552	rs3169950	G	A	370	342	712	0	4	716	0	0
17	4700446	rs12942695	T	C	3	5	8	0	0	8	0	0
17	4796274	rs11556634	T	C	20	16	36	0	0	36	0	0
17	4796286	rs11556635	C	T	20	20	40	0	2	42	0	0
17	4796660	rs147436680	C	T	8	7	15	0	0	15	0	0
17	4801125	rs9914357	C	G	43	48	91	0	4	95	0	0
17	4836973	rs6067	A	G	8	7	15	0	0	15	0	0
17	4845768	rs238247	G	A	6	2	8	0	0	8	0	0
17	4846045	rs11871232	A	G	6	12	18	0	0	18	0	0
17	4849087	rs113941832	A	G	3531	3548	7079	0	143	7223	1	0
17	4849284	rs13204	G	A	4829	4511	9340	0	76	9416	0	0
17	4849384	rs2233656	C	T	12	13	25	0	0	25	0	0
17	4850487	rs11650919	G	A	60	44	104	0	1	105	0	0
17	4854480	rs366577	C	T	5	4	9	0	0	9	0	0
17	4856580	rs238239	T	C	13	11	24	0	0	24	0	0
17	4862962	rs12451097	G	A	26	34	60	0	0	60	0	0
17	4863006	rs73343381	G	A	36	37	73	0	0	73	0	0
17	4864518	rs11655967	G	A	3	3	6	0	0	6	0	0
17	4883045	rs79255821	C	T	29	27	56	0	3	59	0	0
17	4889779	rs2286010	G	A	6	6	12	0	1	13	0	0
17	4889816	rs391548	G	T	8	10	18	0	0	18	0	0
17	4892603	rs113318176	A	G	0	6	6	0	0	6	0	0
17	4926882	rs346828	A	G	11	9	20	0	0	20	0	0
17	4929640	rs502211	C	A	10	4	14	0	0	14	0	0
17	4930721	rs7216211	A	G	6	5	11	0	0	11	0	0
17	4930987	rs6502831	G	A	7	8	15	0	0	15	0	0
17	4997039	rs3744706	G	C	2	6	8	0	0	8	0	0
17	4997433	rs12600437	G	A	5	2	7	0	0	7	0	0
17	4998852	rs3744708	G	C	5	5	10	0	0	10	0	0
17	5010148	rs17224791	A	T	5	1	6	0	0	6	0	0
17	5011736	rs7224929	G	A	5	2	7	0	0	7	0	0
17	5014416	rs57461327	G	A	8	6	14	0	0	14	0	0
17	15448814	.	G	A	7	1	8	0	0	8	0	0
17	15448886	.	T	A	8	0	8	0	0	8	0	0
17	15448887	.	C	T	8	0	8	0	0	8	0	0
17	18574009	rs3813032	A	G	6	0	6	0	0	6	0	0
17	18574794	rs9635679	C	T	3	3	6	0	0	6	0	0
17	18575127	rs9635680	G	A	3	3	6	0	0	6	0	0
17	18575140	rs9635681	A	G	3	3	6	0	0	6	0	0
17	18967152	rs62068862	C	T	4	7	11	0	0	11	0	0
17	19015381	rs16942268	T	A	7	0	7	0	0	7	0	0
17	19015683	rs76091851	G	C	14	0	14	0	0	14	0	0
17	20332138	.	G	A	0	7	7	0	0	7	0	0
17	21100934	rs66974258	G	A	7	4	11	0	1	12	0	0
17	21101435	rs143161750	C	G	272	213	485	0	2	487	0	0
17	21142572	rs6902	A	C	9	7	16	0	0	16	0	0
17	21142577	rs7948	G	A	10	7	17	0	0	17	0	0
17	21192149	rs1379592	T	G	4	2	6	0	0	6	0	0
17	21193432	rs9903708	C	T	6	2	8	0	0	8	0	0
17	21194013	.	A	G	6	0	6	0	0	6	0	0
17	21194024	rs79337823	G	T	7	0	7	0	1	8	0	0
17	21194078	.	A	G	10	0	10	0	0	10	0	0
17	21194121	.	G	A	7	0	7	0	0	7	0	0
17	21194769	rs72840055	C	T	6	0	6	0	0	6	0	0
17	21194785	.	T	C	6	0	6	0	0	6	0	0
17	21194820	.	G	A	6	0	6	0	0	6	0	0
17	21194843	.	T	C	7	0	7	0	0	7	0	0
17	21194852	.	G	A	6	0	6	0	0	6	0	0
17	21194859	.	G	A	7	0	7	0	0	7	0	0
17	21195139	.	C	T	7	0	7	0	0	7	0	0
17	21195180	.	C	T	9	0	9	0	0	9	0	0
17	21195225	rs77307626	G	A	12	0	12	0	0	12	0	0
17	21195229	rs78947202	A	G	12	0	12	0	0	12	0	0
17	21195233	rs79162051	G	A	11	0	11	0	0	11	0	0
17	21195236	rs80052421	G	A	11	0	11	0	0	11	0	0
17	21195241	.	A	G	11	0	11	0	0	11	0	0
17	21195301	.	C	T	6	0	6	0	0	6	0	0
17	21195332	rs7224594	G	A	6	0	6	0	0	6	0	0
17	21195670	.	C	G	7	0	7	0	0	7	0	0
17	21196032	.	C	T	9	0	9	0	0	9	0	0
17	21196037	.	A	G	10	0	10	0	0	10	0	0
17	21200503	rs3785542	G	T	4	6	10	0	0	10	0	0
17	21204982	rs12602754	G	A	3	3	6	0	0	6	0	0
17	21205095	rs35122311	T	C	3	4	7	0	0	7	0	0
17	21206440	rs3744222	C	T	1	5	6	0	0	6	0	0
17	21207276	rs6587136	T	C	9	2	11	0	0	11	0	0
17	21207277	rs6587137	A	G	9	2	11	0	0	11	0	0
17	21207916	rs7209761	A	G	11	9	20	0	0	20	0	0
17	21210954	.	T	C	4	4	8	0	0	8	0	0
17	21211100	rs11657248	C	T	20	13	33	0	1	34	0	0
17	21212820	rs11650053	G	A	19	17	36	0	0	36	0	0
17	21213782	rs9901404	A	G	66	54	120	0	0	120	0	0
17	21214432	rs7218577	T	C	63	45	108	0	1	109	0	0
17	21214616	rs4021717	A	G	65	29	94	0	1	95	0	0
17	21214932	.	G	C	158	0	158	0	2	160	0	0
17	21215204	rs9909362	C	T	74	62	136	0	0	136	0	0
17	21216159	rs12602050	G	A	7	4	11	0	2	13	0	0
17	21216294	rs4985838	A	C	8	4	12	0	0	12	0	0
17	21216602	rs12602109	G	A	10	9	19	0	0	19	0	0
17	21216964	rs1657686	T	C	22	14	36	0	0	36	0	0
17	21218144	.	C	T	1000	1028	2028	0	13	2041	0	0
17	21319121	.	C	T	6	0	6	0	0	6	0	0
17	21731041	rs145087783	G	A	21	0	21	0	2	23	0	0
17	29859016	rs1992	G	A	12	17	29	0	0	29	0	0
17	29859506	rs2290436	G	T	23	17	40	0	0	40	0	0
17	29863879	rs1551359	C	T	3	3	6	0	0	6	0	0
17	30188948	rs188393992	T	C	7	4	11	0	0	11	0	0
17	30222002	rs3760454	T	C	30	22	52	0	0	52	0	0
17	30280977	rs8068046	T	C	2	5	7	0	0	7	0	0
17	30505303	rs144937882	C	T	7	3	10	0	0	10	0	0
17	30507351	rs301347	G	A	2	5	7	0	0	7	0	0
17	30509618	rs79057723	C	T	6	3	9	0	0	9	0	0
17	32583911	rs13900	C	T	13	7	20	0	0	20	0	0
17	33269648	rs2230553	C	G	6	6	12	0	0	12	0	0
17	33289937	rs8249	A	T	29	27	56	0	2	58	0	0
17	33322322	rs3135998	A	G	3	3	6	0	0	6	0	0
17	33330150	rs4796030	A	C	4	2	6	0	0	6	0	0
17	33331575	rs1052536	C	T	16	10	26	0	0	26	0	0
17	33332177	rs1003918	G	A	4	5	9	0	0	9	0	0
17	33332629	rs12948362	G	A	5	4	9	0	0	9	0	0
17	33341834	rs2074519	T	C	1	5	6	0	0	6	0	0
17	33456008	rs1138723	G	A	1	7	8	0	0	8	0	0
17	33464864	rs7215209	C	T	22	29	51	0	2	53	0	0
17	33766427	rs8064840	T	G	5	1	6	0	0	6	0	0
17	33881631	rs321612	T	C	4	3	7	0	0	7	0	0
17	33901965	rs10068	C	G	3	3	6	0	0	6	0	0
17	33902635	rs1037590	G	T	9	4	13	0	0	13	0	0
17	33929582	rs35237539	A	G	4	3	7	0	0	7	0	0
17	33930021	rs12945980	A	G	8	2	10	0	0	10	0	0
17	33987034	rs3506	T	C	21	22	43	0	0	43	0	0
17	33998904	rs17670584	T	C	105	84	189	0	1	190	0	0
17	34052874	rs740913	T	G	262	262	524	0	0	524	0	0
17	34158726	rs4796112	C	T	5	1	6	0	0	6	0	0
17	34160764	rs3785764	C	T	4	6	10	0	0	10	0	0
17	34199162	rs3817656	A	G	191	121	312	0	0	312	0	0
17	34415763	rs1063340	G	C	183	219	402	0	1	403	0	0
17	34416246	rs1719130	T	C	20	27	47	0	0	47	0	0
17	34416537	rs1130371	G	A	256	274	530	0	5	535	0	0
17	34416946	rs1719134	G	A	20	23	43	0	0	43	0	0
17	34432237	rs72833526	G	A	9	4	13	0	0	13	0	0
17	34432403	rs1634517	C	A	7	6	13	0	0	13	0	0
17	34432944	rs148133700	C	T	24	34	58	0	0	58	0	0
17	34903950	.	C	T	7	10	17	0	0	17	0	0
17	34939937	.	G	A	5	2	7	0	0	7	0	0
17	34942750	rs1076184	T	A	10	7	17	0	0	17	0	0
17	35306312	rs2306658	G	C	42	43	85	0	0	85	0	0
17	35346641	rs1045056	T	C	125	116	241	0	1	242	0	0
17	35837607	rs112117387	T	G	7	9	16	0	0	16	0	0
17	35837695	rs376368023	G	A	16	3	19	0	0	19	0	0
17	35838091	rs2269838	C	T	6	5	11	0	0	11	0	0
17	35875629	rs58781505	T	C	3	4	7	0	0	7	0	0
17	35896123	rs1045000	T	C	4	5	9	0	0	9	0	0
17	35956391	rs12944821	G	C	4	3	7	0	0	7	0	0
17	35972019	.	C	A	5	3	8	0	0	8	0	0
17	35972024	.	C	A	5	3	8	0	0	8	0	0
17	36352244	.	G	A	2	4	6	0	0	6	0	0
17	36352489	.	A	C	59	0	59	0	0	59	0	0
17	36354215	.	T	C	8	4	12	0	0	12	0	0
17	36356980	.	T	C	9	0	9	0	0	9	0	0
17	36357835	.	G	A	12	0	12	0	0	12	0	0
17	36622482	rs8075324	G	C	5	5	10	0	0	10	0	0
17	36860927	rs3760148	G	T	6	3	9	0	0	9	0	0
17	36864953	rs11657029	G	A	3	5	8	0	0	8	0	0
17	36882595	rs11543289	T	A	146	134	280	0	5	285	0	0
17	36886720	rs11652810	C	A	1	5	6	0	0	6	0	0
17	36886828	rs11658500	G	A	4	5	9	0	0	9	0	0
17	36889559	rs2879097	C	T	181	144	325	0	1	326	0	0
17	36889979	rs34857493	C	T	3	13	16	0	0	16	0	0
17	36890949	rs708692	T	C	20	11	31	0	0	31	0	0
17	36891208	rs1060338	A	C	11	6	17	0	0	17	0	0
17	36894839	rs1138349	G	A	17	4	21	0	0	21	0	0
17	36915540	rs35246838	T	C	2	7	9	0	0	9	0	0
17	37004785	rs1239175	C	T	24	24	48	0	0	48	0	0
17	37006131	rs1239176	T	C	41	52	93	0	1	94	0	0
17	37009072	rs1239179	C	T	28	20	48	0	0	48	0	0
17	37067839	rs653342	G	A	4	4	8	0	0	8	0	0
17	37070658	rs525989	A	G	161	159	320	0	0	320	0	0
17	37071995	rs569502	T	C	5	4	9	0	0	9	0	0
17	37073182	rs600158	G	A	9	3	12	0	0	12	0	0
17	37073532	rs598751	G	A	6	3	9	0	0	9	0	0
17	37075758	rs11539845	G	A	251	218	469	0	4	473	0	0
17	37083464	rs649997	G	A	8	10	18	0	1	19	0	0
17	37084227	rs512003	A	G	6	3	9	0	0	10	1	0
17	37409625	rs1046632	A	G	27	26	53	0	0	53	0	0
17	37409801	rs755499	G	A	16	19	35	0	0	35	0	0
17	37409865	rs755500	G	A	26	23	49	0	0	49	0	0
17	37415544	rs11078896	C	T	5	3	8	0	0	8	0	0
17	37415870	rs11078897	C	T	2	7	9	0	0	9	0	0
17	37417575	rs3744348	C	G	7	8	15	0	0	15	0	0
17	37651651	.	T	G	9	0	9	0	1	10	0	0
17	37682657	rs4404103	A	G	18	19	37	0	0	37	0	0
17	37683153	rs4541107	T	C	8	6	14	0	0	14	0	0
17	37683231	rs3889368	C	T	8	9	17	0	0	17	0	0
17	37683548	rs1077715	A	T	9	8	17	0	0	17	0	0
17	37684407	rs7405770	T	A	8	4	12	0	0	12	0	0
17	37684990	rs55660616	C	A	8	4	12	0	0	12	0	0
17	37814080	rs1877031	G	A	81	79	160	0	0	160	0	0
17	37815899	rs11658786	G	A	4	7	11	0	0	11	0	0
17	37817482	rs2271308	T	C	4	6	10	0	0	10	0	0
17	37821435	rs931992	G	T	4	2	6	0	0	6	0	0
17	37822311	rs1053651	A	C	19	16	35	0	0	35	0	0
17	37828072	rs14050	C	T	45	31	76	0	1	77	0	0
17	37828496	rs2952151	T	C	28	24	52	0	0	52	0	0
17	37828745	rs2941503	A	G	29	28	57	0	1	58	0	0
17	37828787	rs907087	G	A	23	24	47	0	1	48	0	0
17	37830900	rs2941504	A	G	16	23	39	0	0	39	0	0
17	38137364	rs3087852	G	A	104	89	193	0	3	196	0	0
17	38137623	rs8075668	C	T	22	22	44	0	0	44	0	0
17	38146154	rs9916279	T	C	288	326	614	0	15	629	0	0
17	38147293	rs11654706	A	G	4	3	7	0	1	8	0	0
17	38147294	rs11078931	C	T	3	5	8	0	0	8	0	0
17	38153473	rs12453334	C	T	7	2	9	0	0	9	0	0
17	38154084	rs2012	G	C	184	208	392	0	3	395	0	0
17	38173143	rs25645	G	A	146	44	190	0	0	190	0	0
17	38173737	rs2827	C	T	50	170	220	0	3	223	0	0
17	38175462	rs12309	C	T	133	64	197	0	8	205	0	0
17	38175866	rs11555254	G	A	109	123	232	0	0	232	0	0
17	38176256	rs2270401	A	T	3	5	8	0	0	8	0	0
17	38177839	rs12453732	A	C	4	2	6	0	0	6	0	0
17	38178149	rs2302776	A	G	7	2	9	0	0	9	0	0
17	38179492	rs2302777	A	G	75	56	131	0	1	132	0	0
17	38179667	rs2302778	A	G	4	2	6	0	0	6	0	0
17	38182081	rs7503939	A	G	4	5	9	0	0	9	0	0
17	38182844	rs2302775	T	C	6	10	16	0	0	16	0	0
17	38183090	rs2302774	G	T	9	4	13	0	0	13	0	0
17	38186106	rs11555255	C	T	74	74	148	0	1	149	0	0
17	38246286	rs73983006	A	G	13	11	24	0	1	25	0	0
17	38246960	rs12948025	G	A	17	22	39	0	0	39	0	0
17	38248354	rs3744805	C	T	22	21	43	0	4	47	0	0
17	38504241	rs482284	A	G	5	5	10	0	0	10	0	0
17	38506457	rs9894845	T	C	54	49	103	0	2	105	0	0
17	38512197	rs8069541	T	C	5	4	9	0	0	9	0	0
17	38545193	rs13695	C	T	37	38	75	0	1	76	0	0
17	39780767	rs11553457	C	G	9	3	12	0	1	13	0	0
17	39910531	rs9902034	C	A	7	3	10	0	0	10	0	0
17	39911771	rs4627408	A	G	76	72	148	0	2	150	0	0
17	39912145	rs1126821	T	A	363	292	655	0	10	665	0	0
17	39914070	rs8067890	G	T	8	1	9	0	0	9	0	0
17	39920257	rs7406225	A	G	5	1	6	0	0	6	0	0
17	39920321	rs74731707	G	A	5	3	8	0	0	8	0	0
17	39925925	rs7405731	A	G	216	196	412	0	3	415	0	0
17	39942919	rs4796702	T	C	83	22	105	0	3	108	0	0
17	39967442	rs13412	T	C	5	4	9	0	0	9	0	0
17	39974642	rs34764749	A	G	16	13	29	0	0	29	0	0
17	39979062	rs1043002	T	A	35	27	62	0	2	64	0	0
17	39979081	rs1043005	C	G	39	28	67	0	0	67	0	0
17	39979082	rs1043007	C	G	39	28	67	0	0	67	0	0
17	39983808	rs1046404	G	C	96	24	120	0	0	120	0	0
17	39983820	rs1046403	G	A	103	21	124	0	1	125	0	0
17	39983849	rs1128966	G	C	117	32	149	0	3	152	0	0
17	40005158	rs75914986	G	C	33	32	65	0	0	65	0	0
17	40009950	rs79313880	C	T	21	15	36	0	0	36	0	0
17	40010979	rs3744782	G	A	16	13	29	0	1	30	0	0
17	40099978	rs35459707	C	T	8	6	14	0	0	14	0	0
17	40101775	rs79175247	A	T	2	4	6	0	1	7	0	0
17	40120771	rs8078650	T	G	11	6	17	0	0	17	0	0
17	40122485	rs12952456	C	T	2	4	6	0	0	6	0	0
17	40123521	rs11079027	A	G	2	4	6	0	0	6	0	0
17	40123829	rs12602950	G	A	6	3	9	0	0	9	0	0
17	40126133	rs11079028	G	A	29	44	73	0	1	74	0	0
17	40127060	rs11296	T	C	46	41	87	0	0	87	0	0
17	40127537	rs4796751	T	C	8	7	15	0	1	16	0	0
17	40127865	rs56316666	C	T	13	9	22	0	0	22	0	0
17	40139080	rs78071022	C	T	3	5	8	0	0	8	0	0
17	40142302	rs1127182	T	C	113	158	271	0	3	274	0	0
17	40169960	rs11079029	G	A	4	6	10	0	0	10	0	0
17	40255743	rs112616358	T	C	8	0	8	0	0	8	0	0
17	40280850	.	A	G	8	0	8	0	0	8	0	0
17	40375881	rs9900213	G	T	4	3	7	0	0	7	0	0
17	40418571	rs9909628	A	T	2	6	8	0	0	8	0	0
17	40418956	rs34129849	A	C	3	4	7	0	0	7	0	0
17	40421513	rs6503692	G	A	2	4	6	0	0	6	0	0
17	40424255	rs8064638	G	A	2	7	9	0	0	9	0	0
17	40425494	rs7223228	T	C	4	2	6	0	0	6	0	0
17	40427147	rs8080122	G	A	4	4	8	0	0	8	0	0
17	40449246	rs9889323	T	C	4	2	6	0	0	6	0	0
17	40449484	rs28380298	T	C	3	5	8	0	0	8	0	0
17	40451363	rs6503694	T	C	3	7	10	0	0	10	0	0
17	40455690	rs9908237	C	T	39	32	71	0	1	72	0	0
17	40455846	rs9906989	G	T	42	53	95	0	1	96	0	0
17	40456010	rs9907453	G	T	22	36	58	0	0	58	0	0
17	40457246	rs60288073	G	C	3	5	8	0	0	8	0	0
17	40458957	rs2002052	C	T	20	8	28	0	0	28	0	0
17	40459562	rs2272087	A	G	34	11	45	0	1	46	0	0
17	40459737	rs1135669	C	T	420	438	858	0	17	875	0	0
17	40460989	rs2293155	A	G	9	7	16	0	0	16	0	0
17	40461003	rs2293154	C	T	8	7	15	0	0	15	0	0
17	40461674	rs12601982	A	G	34	21	55	0	0	55	0	0
17	40462994	rs3198502	G	T	390	345	735	0	10	745	0	0
17	40465616	rs1053023	T	C	222	270	492	0	1	493	0	0
17	40465910	rs1053005	T	C	172	187	359	0	4	363	0	0
17	40466092	rs1053004	G	A	214	159	373	0	3	376	0	0
17	40466438	rs3744483	T	C	73	91	164	0	3	167	0	0
17	40468489	rs9891867	G	A	7	7	14	0	0	14	0	0
17	40469598	rs8074524	C	T	5	7	12	0	0	12	0	0
17	40470342	rs9909736	A	C	4	4	8	0	0	8	0	0
17	40471101	rs8066464	T	A	4	3	7	0	0	7	0	0
17	40471980	rs3809758	C	T	4	5	9	0	0	9	0	0
17	40474864	rs8064496	A	G	2	5	7	0	0	7	0	0
17	40474880	rs8081431	G	C	2	6	8	0	0	8	0	0
17	40477739	rs9896889	T	C	1	6	7	0	0	7	0	0
17	40479535	rs12103893	T	C	2	6	8	0	0	8	0	0
17	40480381	rs8078731	A	T	3	4	7	0	0	7	0	0
17	40480498	rs8064327	T	G	7	0	7	0	0	7	0	0
17	40480521	rs8077296	G	A	5	2	7	0	0	7	0	0
17	40538979	rs12947808	A	T	5	8	13	0	0	13	0	0
17	40539825	rs3736164	T	G	14	32	46	0	0	46	0	0
17	40554849	rs9252	G	A	239	211	450	0	5	455	0	0
17	40555259	rs4796583	C	G	132	131	263	0	2	265	0	0
17	40555707	rs35725766	C	T	127	131	258	0	0	258	0	0
17	40555799	rs1129422	C	T	103	97	200	0	2	202	0	0
17	40555939	rs709631	A	T	98	73	171	0	1	172	0	0
17	40562610	rs4365333	G	C	25	12	37	0	3	40	0	0
17	40563017	rs72823047	G	A	16	10	26	0	0	26	0	0
17	40563106	rs111550283	G	A	9	6	15	0	0	15	0	0
17	40632729	rs41283429	C	T	43	35	78	0	0	78	0	0
17	40639422	rs8069972	G	A	2	5	7	0	0	7	0	0
17	40663916	rs138224795	G	A	2	7	9	0	0	9	0	0
17	40664072	rs141815387	G	A	6	8	14	0	0	14	0	0
17	40670242	rs141112514	C	T	20	8	28	0	0	28	0	0
17	40671818	rs111466029	G	A	22	10	32	0	0	32	0	0
17	40690118	rs4792923	G	C	8	4	12	0	0	12	0	0
17	40696233	rs86312	C	G	35	51	86	0	0	86	0	0
17	40697793	rs600233	C	T	3	10	13	0	0	13	0	0
17	40698246	rs592502	A	G	6	1	7	0	0	7	0	0
17	40699291	rs607740	G	A	2	5	7	0	0	7	0	0
17	40703535	rs62075854	C	T	4	2	6	0	0	6	0	0
17	40721850	rs17671179	C	G	13	25	38	0	0	38	0	0
17	40722162	rs1474040	G	A	60	49	109	0	0	109	0	0
17	40724276	rs679	C	T	45	39	84	0	0	84	0	0
17	40732698	rs8079855	A	G	10	8	18	0	1	19	0	0
17	40813865	rs7218686	T	C	2	4	6	0	0	6	0	0
17	40824339	rs200210041	G	A	13	14	27	0	0	27	0	0
17	40855261	rs148215732	T	C	3	4	7	0	0	7	0	0
17	41144884	.	T	C	42	27	69	0	1	70	0	0
17	41150949	rs2271539	G	A	15	19	34	0	1	35	0	0
17	41323290	rs551517526	C	G	4	15	19	0	0	19	0	0
17	41477710	rs3179287	A	G	11	6	17	0	1	18	0	0
17	41843979	rs15359	C	G	42	49	91	0	1	92	0	0
17	41844689	rs1230397	C	T	33	36	69	0	0	69	0	0
17	41845235	rs1230398	C	A	23	23	46	0	0	46	0	0
17	41845403	rs1230399	C	T	21	24	45	0	0	45	0	0
17	41845451	rs1230400	G	A	26	22	48	0	1	49	0	0
17	41845527	rs1230401	C	A	26	18	44	0	0	44	0	0
17	41846508	rs1230402	A	G	55	54	109	0	1	110	0	0
17	41991975	rs1731889	T	G	6	9	15	0	0	15	0	0
17	42153562	rs1046770	G	C	137	167	304	0	1	305	0	0
17	42154331	rs3088347	C	T	9	2	11	0	0	11	0	0
17	42154470	rs375171	A	G	4	3	7	0	0	7	0	0
17	42155442	rs74679777	G	A	5	2	7	0	0	7	0	0
17	42155838	rs9913925	G	A	3	3	6	0	0	6	0	0
17	42173252	rs189050	G	C	4	3	7	0	0	7	0	0
17	42264962	rs4793082	A	G	25	33	58	0	2	60	0	0
17	42266224	rs8073555	G	C	17	15	32	0	0	32	0	0
17	42268274	rs757430	C	T	92	81	173	0	4	177	0	0
17	42271191	rs77324959	G	A	174	156	330	0	0	330	0	0
17	42299300	rs79539199	A	G	4	5	9	0	0	9	0	0
17	42476409	rs3744427	G	A	57	29	86	0	0	86	0	0
17	42827673	rs3744477	G	A	7	3	10	0	0	10	0	0
17	42854610	rs8075210	T	C	2	4	6	0	0	6	0	0
17	42855554	rs2070605	T	C	6	0	6	0	0	6	0	0
17	42929970	rs2289673	T	C	4	3	7	0	0	7	0	0
17	42929985	rs73984100	G	T	4	2	6	0	0	6	0	0
17	42937749	rs9903106	C	G	3	7	10	0	0	10	0	0
17	42945296	rs2120276	A	G	4	6	10	0	1	11	0	0
17	42945867	rs3785890	A	G	8	6	14	0	0	14	0	0
17	42947087	rs7208122	A	C	6	4	10	0	0	10	0	0
17	42947114	rs7212451	T	C	7	5	12	0	0	12	0	0
17	42947314	rs7216587	T	C	9	5	14	0	0	14	0	0
17	42949168	rs9910936	A	T	5	3	8	0	1	9	0	0
17	42949202	rs9915732	C	T	7	3	10	0	0	10	0	0
17	42949808	rs11654183	G	A	2	4	6	0	0	6	0	0
17	42956055	rs11868767	G	A	4	2	6	0	0	6	0	0
17	42959642	rs12452911	T	C	4	3	7	0	0	7	0	0
17	42961009	rs2289677	C	T	6	2	8	0	0	8	0	0
17	42973313	rs9908594	G	A	4	9	13	0	0	13	0	0
17	43002704	rs111305569	A	G	2	5	7	0	0	7	0	0
17	43003484	rs3169733	T	C	2	6	8	0	0	8	0	0
17	43138333	rs62065833	T	G	5	5	10	0	0	10	0	0
17	43185023	rs2269746	C	A	7	5	12	0	0	12	0	0
17	43185242	rs1989802	G	C	4	8	12	0	0	12	0	0
17	43185820	rs2239925	T	C	14	17	31	0	0	31	0	0
17	43189049	rs1052169	A	C	4	3	7	0	0	7	0	0
17	43189359	rs5026009	T	C	9	9	18	0	0	18	0	0
17	43192821	rs713101	A	G	5	5	10	0	0	10	0	0
17	43294324	rs8068730	G	A	20	16	36	0	0	36	0	0
17	43294588	rs139098453	T	C	6	10	16	0	0	16	0	0
17	43295879	rs141249601	T	C	4	2	6	0	1	7	0	0
17	43302680	rs62066719	A	G	4	2	6	0	0	6	0	0
17	43304649	rs79091156	G	A	3	3	6	0	0	6	0	0
17	43305401	rs9889614	G	A	6	5	11	0	0	11	0	0
17	43305456	rs62066720	C	G	5	3	8	0	0	8	0	0
17	43306148	rs11869822	T	A	5	6	11	0	0	11	0	0
17	43306305	rs11079492	C	G	9	7	16	0	0	16	0	0
17	43306345	rs11079493	G	C	10	5	15	0	0	15	0	0
17	43307719	rs4792892	G	T	4	4	8	0	0	8	0	0
17	43308183	rs58744688	A	C	5	4	9	0	0	9	0	0
17	43312831	rs1989230	G	A	63	60	123	0	2	125	0	0
17	43312893	rs1989229	A	G	63	58	121	0	1	122	0	0
17	43315547	rs1133458	G	A	7	3	10	0	0	10	0	0
17	43316613	rs8182370	G	C	3	5	8	0	0	8	0	0
17	43317574	rs7212404	G	A	8	4	12	0	0	12	0	0
17	43319770	rs1801353	C	T	606	530	1136	0	13	1149	0	0
17	43471489	rs4763	G	A	45	43	88	0	2	90	0	0
17	43472321	rs1059504	A	G	53	39	92	0	1	93	0	0
17	43472507	rs8327	A	G	53	78	131	0	2	133	0	0
17	43472825	rs117139057	G	C	16	30	46	0	0	46	0	0
17	43474013	rs145751046	C	T	2	5	7	0	1	8	0	0
17	43474463	rs148339832	C	T	4	6	10	0	0	10	0	0
17	43474668	rs62064598	C	G	2	8	10	0	0	10	0	0
17	43514176	rs146944003	C	T	192	164	356	0	5	361	0	0
17	43530550	rs56278545	G	A	21	19	40	0	0	40	0	0
17	43533532	rs139503809	A	G	3	5	8	0	0	8	0	0
17	43534322	rs8075717	T	C	5	3	8	0	0	8	0	0
17	43551086	rs142100599	G	A	5	3	8	0	0	8	0	0
17	43551672	rs2037442	C	T	4	5	9	0	0	9	0	0
17	43552106	rs4792859	C	T	4	2	6	0	0	6	0	0
17	43598764	.	G	A	5	2	7	0	0	7	0	0
17	44109474	rs7220988	G	A	118	5	123	0	0	123	0	0
17	49408462	rs11650278	G	T	0	6	6	0	0	6	0	0
17	53029328	rs3087650	G	A	5	6	11	0	0	11	0	0
17	53038654	rs1802212	A	C	11	22	33	0	1	34	0	0
17	53038745	rs17817901	A	G	10	21	31	0	1	32	0	0
17	53039315	rs4829	C	T	7	2	9	0	0	9	0	0
17	53039483	rs7643	G	A	129	83	212	0	4	216	0	0
17	53470462	rs11547827	C	T	56	28	84	0	1	85	0	0
17	53471105	rs4476230	T	G	44	39	83	0	0	83	0	0
17	53471191	rs4570925	T	A	14	10	24	0	1	25	0	0
17	53497246	rs28414540	C	T	6	14	20	0	0	20	0	0
17	53497765	rs4630612	A	G	15	31	46	0	0	46	0	0
17	53498846	rs75646226	C	T	8	3	11	0	0	11	0	0
17	53498990	rs78612327	T	C	6	6	12	0	0	12	0	0
17	54941967	rs33932456	T	A	15	10	25	0	0	25	0	0
17	54942166	.	A	G	5	1	6	0	0	6	0	0
17	54945011	rs113604757	C	G	6	9	15	0	1	16	0	0
17	54967404	rs205500	T	C	84	74	158	0	0	158	0	0
17	54967528	rs2525998	A	G	76	54	130	0	1	131	0	0
17	54972401	rs205499	G	A	5	4	9	0	0	9	0	0
17	54981783	.	C	T	54	62	116	0	1	117	0	0
17	55027850	rs8071691	T	C	55	58	113	0	1	114	0	0
17	55075582	rs1811258	A	G	3	5	8	0	0	8	0	0
17	55079471	rs12940187	T	C	169	181	350	0	1	351	0	0
17	55197802	rs4583	C	A	11	9	20	0	1	21	0	0
17	55198420	rs6967	C	T	7	13	20	0	0	20	0	0
17	55351370	.	A	G	2	4	6	0	0	6	0	0
17	55710036	rs3826301	T	C	61	88	149	0	0	149	0	0
17	55710350	rs12449785	A	G	17	20	37	0	0	37	0	0
17	55754573	rs2286359	G	A	3	6	9	0	0	9	0	0
17	55755701	.	C	T	3	3	6	0	0	6	0	0
17	55756866	rs4793561	T	C	7	7	14	0	0	14	0	0
17	55757381	rs7214420	A	C	28	36	64	0	1	65	0	0
17	55759488	rs563823513	T	G	18	18	36	0	0	36	0	0
17	56076127	rs76257397	G	C	0	11	11	0	0	11	0	0
17	56162496	rs11079337	C	A	12	10	22	0	0	22	0	0
17	56168371	rs10132	G	A	341	311	652	0	4	656	0	0
17	56270121	rs12602891	T	C	6	10	16	0	0	16	0	0
17	62810603	.	G	C	6	0	6	0	0	6	0	0
17	64685078	rs2227857	G	A	5	13	18	0	0	18	0	0
17	64800898	rs74199615	G	A	8	2	10	0	0	10	0	0
17	65066879	rs11193	A	G	38	30	68	0	1	69	0	0
17	65068131	rs2363845	A	C	12	11	23	0	1	24	0	0
17	65069655	rs7217216	C	T	20	16	36	0	0	36	0	0
17	65104666	rs11657929	T	G	28	38	66	0	0	66	0	0
17	65146338	rs8080855	C	T	4	2	6	0	0	6	0	0
17	65182445	rs8066336	G	A	8	6	14	0	0	14	0	0
17	65184412	rs72838437	G	A	17	21	38	0	0	38	0	0
17	65186749	rs72838439	C	T	7	2	9	0	0	9	0	0
17	65192484	rs12942297	G	A	5	7	12	0	0	12	0	0
17	65212042	rs8080100	C	T	77	94	171	0	0	171	0	0
17	65241954	rs8072883	G	C	6	6	12	0	0	12	0	0
17	65346116	rs11867328	C	T	2	4	6	0	0	6	0	0
17	65346975	rs113294227	T	A	15	13	28	0	0	28	0	0
17	65347058	rs113314548	G	A	18	11	29	0	0	29	0	0
17	65348542	rs56284332	T	C	3	5	8	0	0	8	0	0
17	65352181	rs7221926	T	A	11	5	16	0	0	16	0	0
17	65357692	rs62085808	G	A	7	9	16	0	0	16	0	0
17	65358688	rs57672368	G	C	5	4	9	0	0	9	0	0
17	65362294	rs7207883	C	T	4	2	6	0	0	6	0	0
17	65362552	rs11079691	T	A	121	111	232	0	1	233	0	0
17	65735543	rs367732036	G	C	6	3	9	0	0	9	0	0
17	65735546	rs371211767	C	T	6	3	9	0	0	9	0	0
17	65735547	rs374993733	A	C	7	3	10	0	0	10	0	0
17	65893641	rs117307545	A	G	5	2	7	0	1	8	0	0
17	65940727	rs6504555	A	G	4	7	11	0	2	13	0	0
17	65947970	rs11867401	G	A	3	5	8	0	0	8	0	0
17	65977682	rs7502707	T	G	5	1	6	0	0	6	0	0
17	65988049	rs9891146	T	C	30	20	50	0	1	51	0	0
17	66031900	rs12752	T	C	221	240	461	0	6	467	0	0
17	66032298	rs7214119	G	A	4	2	6	0	0	6	0	0
17	66038556	rs62084697	G	A	5	3	8	0	0	8	0	0
17	66039350	rs4638	A	G	431	400	831	0	7	838	0	0
17	66122496	rs7209499	C	T	8	0	8	0	1	9	0	0
17	66123432	rs8064704	T	G	8	0	8	0	0	8	0	0
17	66124489	rs2240606	G	A	10	2	12	0	0	12	0	0
17	66131095	rs1873	T	C	7	1	8	0	0	8	0	0
17	66131658	rs7210736	C	A	5	1	6	0	0	6	0	0
17	66250552	rs77962247	G	T	101	75	176	0	0	176	0	0
17	66421260	rs12948224	G	C	5	2	7	0	0	7	0	0
17	66445469	rs2952296	G	C	2	4	6	0	0	6	0	0
17	66445652	rs2909208	G	A	7	5	12	0	0	12	0	0
17	66446136	rs2909209	G	A	8	8	16	0	0	16	0	0
17	66449122	rs883541	G	A	6	10	16	0	1	17	0	0
17	66508243	rs8080306	C	A	3	5	8	0	0	8	0	0
17	71192663	rs1052706	G	A	11	6	17	0	0	17	0	0
17	71192873	rs11544800	A	G	11	22	33	0	0	33	0	0
17	71196809	rs1026128	A	G	30	20	50	0	0	50	0	0
17	71197748	rs1037256	G	A	37	31	68	0	0	68	0	0
17	71200948	rs8072987	G	A	6	7	13	0	0	13	0	0
17	71205854	rs8387	A	G	71	81	152	0	0	152	0	0
17	71279839	rs3841	T	C	43	37	80	0	0	80	0	0
17	71279856	rs536	C	T	65	56	121	0	0	121	0	0
17	71280052	rs6905	T	A	86	82	168	0	1	169	0	0
17	71280075	rs1042988	T	C	80	71	151	0	0	151	0	0
17	71280213	rs1071577	G	A	68	49	117	0	1	118	0	0
17	71280722	rs12795	T	C	47	73	120	0	1	121	0	0
17	71280954	rs2345288	T	C	24	43	67	0	0	67	0	0
17	71755038	.	A	C	7	0	7	0	4	11	0	0
17	72541980	rs783230	A	G	6	4	10	0	0	10	0	0
17	72606372	rs554592	A	T	2	5	7	0	0	7	0	0
17	72606867	rs578460	A	G	2	4	6	0	0	6	0	0
17	72667020	rs9904078	G	A	4	3	7	0	0	7	0	0
17	72744798	rs745666	G	C	62	69	131	0	0	131	0	0
17	72761242	rs16978176	T	C	8	4	12	0	0	12	0	0
17	72762646	rs8064299	C	A	3	4	7	0	0	7	0	0
17	72762901	rs4788849	A	T	4	4	8	0	0	8	0	0
17	72763798	rs745318	C	T	8	6	14	0	0	14	0	0
17	72765215	rs7420	C	T	282	344	626	0	2	628	0	0
17	72766993	rs12797	G	A	72	78	150	0	1	151	0	0
17	72767435	rs880827	T	C	91	86	177	0	1	178	0	0
17	72767565	rs3744208	A	G	67	90	157	0	1	158	0	0
17	72768970	rs2305214	G	A	8	3	11	0	1	12	0	0
17	72769334	rs878906	T	C	7	11	18	0	0	18	0	0
17	72769411	rs878905	G	A	7	7	14	0	1	15	0	0
17	72769694	rs878907	A	G	6	7	13	0	0	13	0	0
17	72772698	rs4789096	G	C	3	4	7	0	0	7	0	0
17	72781812	rs2166703	G	A	4	7	11	0	0	11	0	0
17	72782476	rs12449384	T	A	4	3	7	0	0	7	0	0
17	72782501	rs57802405	C	T	4	2	6	0	0	6	0	0
17	72784630	rs2384957	A	G	7	2	9	0	0	9	0	0
17	72784649	rs895690	C	T	7	2	9	0	0	9	0	0
17	72784932	rs2016126	G	A	11	10	21	0	0	21	0	0
17	72832928	rs11558036	G	A	14	15	29	0	1	30	0	0
17	72834585	rs3803783	A	G	16	20	36	0	1	37	0	0
17	72834954	rs3826320	C	A	13	13	26	0	0	26	0	0
17	72847205	rs7219247	C	T	4	7	11	0	0	11	0	0
17	72847548	rs3744194	G	T	2	6	8	0	0	8	0	0
17	72848998	rs11869277	A	G	6	2	8	0	0	8	0	0
17	72849179	rs782463	C	T	6	3	9	0	0	9	0	0
17	72849356	rs534353	C	G	7	2	9	0	0	9	0	0
17	72853450	rs690578	G	A	1	7	8	0	0	8	0	0
17	72859709	rs690307	C	A	12	14	26	0	1	27	0	0
17	72860253	rs552432	A	G	16	3	19	0	0	19	0	0
17	72861427	rs521002	C	T	17	7	24	0	1	25	0	0
17	72862593	rs690514	C	T	37	33	70	0	0	70	0	0
17	72862809	rs509911	T	C	9	5	14	0	0	14	0	0
17	72863030	rs1688149	T	C	10	9	19	0	0	19	0	0
17	72863984	rs689649	C	T	8	5	13	0	0	13	0	0
17	72864084	rs2467576	A	G	5	5	10	0	0	10	0	0
17	72864407	rs563297	C	T	6	4	10	0	0	10	0	0
17	72864768	rs560323	A	G	3	4	7	0	0	7	0	0
17	72865470	rs690174	G	A	4	5	9	0	0	9	0	0
17	72869078	rs492095	A	G	9	5	14	0	0	14	0	0
17	72956124	rs3744198	G	A	5	1	6	0	0	6	0	0
17	73016621	rs1044228	C	T	101	86	187	0	3	190	0	0
17	73089706	rs4789134	G	A	9	6	15	0	0	15	0	0
17	73095224	rs4538044	G	A	2	4	6	0	0	6	0	0
17	73205976	rs34126097	T	C	26	22	48	0	0	48	0	0
17	73222865	rs1478785	G	A	3	3	6	0	0	6	0	0
17	73228144	rs2291030	T	C	7	26	33	0	2	35	0	0
17	73228173	rs2291031	C	T	7	28	35	0	1	36	0	0
17	73230856	rs9988	C	T	62	89	151	0	1	152	0	0
17	73235478	rs34008167	C	G	37	33	70	0	1	71	0	0
17	73236605	rs11077781	C	A	14	4	18	0	1	19	0	0
17	73257830	rs2279161	C	T	9	6	15	0	0	15	0	0
17	73257986	rs8075276	C	T	32	47	79	0	0	79	0	0
17	73258479	rs6501772	C	T	16	21	37	0	0	37	0	0
17	73260298	rs4788878	A	G	28	22	50	0	1	51	0	0
17	73269258	rs7198	G	C	17	13	30	0	0	30	0	0
17	73269676	rs4789164	C	T	15	9	24	0	0	24	0	0
17	73586413	rs79794615	C	T	25	15	40	0	2	42	0	0
17	73587268	rs2290455	C	T	53	36	89	0	1	90	0	0
17	73587477	rs72854926	C	A	6	5	11	0	0	11	0	0
17	73587519	rs55903825	C	T	6	5	11	0	0	11	0	0
17	73587910	rs12449676	C	T	32	3	35	0	0	35	0	0
17	73588027	rs746840	C	T	3	28	31	0	0	31	0	0
17	73588058	rs736522	G	T	37	24	61	0	0	61	0	0
17	73588067	rs736523	A	G	41	21	62	0	1	63	0	0
17	73590275	rs2898577	A	G	3	3	6	0	0	6	0	0
17	73590331	rs62089228	A	T	5	5	10	0	0	10	0	0
17	73590817	rs2305524	C	T	38	38	76	0	1	77	0	0
17	73597544	rs11871553	A	G	62	50	112	0	2	114	0	0
17	73597919	rs3760124	C	T	10	1	11	0	0	11	0	0
17	73597935	rs1661694	G	A	8	1	9	0	0	9	0	0
17	73599574	rs1661697	A	G	2	8	10	0	0	10	0	0
17	73602081	rs8068464	G	A	31	27	58	0	2	60	0	0
17	73609112	rs820142	G	A	90	61	151	0	2	153	0	0
17	73609139	rs3803728	C	T	76	89	165	0	3	168	0	0
17	73625286	rs820190	G	A	3	5	8	0	0	8	0	0
17	73625430	rs4788902	G	A	5	2	7	0	0	7	0	0
17	73627539	rs820196	T	C	6	4	10	0	0	10	0	0
17	73650495	rs820210	T	C	5	2	7	0	0	7	0	0
17	73687495	rs820218	G	A	50	48	98	0	0	98	0	0
17	73688294	rs820217	G	A	9	13	22	0	0	22	0	0
17	73697391	rs820233	C	T	14	14	28	0	0	28	0	0
17	73702253	rs2305529	G	A	7	1	8	0	0	8	0	0
17	73703644	rs115467173	G	A	46	35	81	0	0	81	0	0
17	73747796	rs820390	A	T	6	5	11	0	0	11	0	0
17	73773000	rs1060120	C	T	590	599	1189	0	8	1197	0	0
17	73775585	rs60700976	G	A	24	22	46	0	0	46	0	0
17	73775825	rs12882	G	A	2010	1616	3626	0	19	3645	0	0
17	73782191	rs2125345	T	C	3	5	8	0	0	8	0	0
17	73790093	rs1047743	C	G	80	58	138	0	0	138	0	0
17	73816446	rs11868566	A	G	7	1	8	0	0	8	0	0
17	73816844	rs878371	G	A	1	6	7	0	0	7	0	0
17	73819525	rs8078208	C	T	12	9	21	0	0	21	0	0
17	73824121	rs7210574	T	C	204	155	359	0	3	362	0	0
17	73825463	rs111365807	G	C	29	14	43	0	0	43	0	0
17	73825664	rs7216664	A	G	13	4	17	0	0	17	0	0
17	73827205	rs1135688	T	C	323	282	605	0	1	606	0	0
17	73828903	rs112267124	G	A	8	6	14	0	0	14	0	0
17	73830996	rs17581728	C	T	10	14	24	0	1	25	0	0
17	73836162	rs7223416	C	G	229	155	384	0	2	386	0	0
17	73837142	rs8067076	A	C	6	0	6	0	0	6	0	0
17	73837311	rs8074963	T	C	4	7	11	0	0	11	0	0
17	73838091	rs9897048	A	G	7	4	11	0	1	12	0	0
17	73838108	rs11870078	G	A	8	3	11	0	0	11	0	0
17	73838816	rs3744006	G	A	3	3	6	0	0	6	0	0
17	73839214	rs3744008	G	C	8	7	15	0	0	15	0	0
17	73839366	rs3744009	C	T	8	3	11	0	0	11	0	0
17	73839498	rs9903200	G	A	5	1	6	0	0	6	0	0
17	73840243	rs3744010	G	A	5	4	9	0	1	10	0	0
17	73885161	rs8068749	A	G	24	25	49	0	1	50	0	0
17	73885805	rs1551619	C	T	37	28	65	0	0	65	0	0
17	73886888	rs3760128	A	G	28	28	56	0	0	56	0	0
17	73888354	rs34974290	G	A	32	24	56	0	0	56	0	0
17	73888423	rs7222755	A	G	24	21	45	0	1	46	0	0
17	73888427	rs7222757	A	C	24	20	44	0	0	44	0	0
17	73894804	rs7370	G	A	105	119	224	0	1	225	0	0
17	73896299	rs1046446	C	T	12	5	17	0	0	17	0	0
17	73897046	rs9902371	A	G	7	3	10	0	0	10	0	0
17	73900688	rs3744015	T	C	102	90	192	0	1	193	0	0
17	73906222	rs3785437	G	T	10	6	16	0	0	16	0	0
17	73922941	rs2305913	T	C	4	3	7	0	0	7	0	0
17	73934130	rs2608882	G	A	2	4	6	0	0	6	0	0
17	73942150	rs3682	A	G	16	24	40	0	0	40	0	0
17	73949540	rs1135640	G	C	18	20	38	0	0	38	0	0
17	74035543	rs7409	T	C	144	147	291	0	2	293	0	0
17	74036912	rs2598444	A	G	4	5	9	0	0	9	0	0
17	74037208	rs2598445	G	A	5	7	12	0	0	12	0	0
17	74037715	rs2598446	A	G	4	2	6	0	0	6	0	0
17	74037772	rs2598447	T	C	6	2	8	0	0	8	0	0
17	74037997	rs2665977	G	A	4	4	8	0	0	8	0	0
17	74038751	rs8068389	T	C	2	4	6	0	0	6	0	0
17	74039867	rs1530834	T	C	11	6	17	0	1	18	0	0
17	74046672	rs2665972	A	G	5	1	6	0	0	6	0	0
17	74052488	rs8071975	C	T	1	5	6	0	0	6	0	0
17	74056413	rs2665998	C	T	162	158	320	0	2	322	0	0
17	74467017	rs8150	G	C	13	6	19	0	0	19	0	0
17	74469449	rs148916542	G	A	4	5	9	0	0	9	0	0
17	74477620	rs12943385	C	T	18	7	25	0	0	25	0	0
17	74560728	rs1132652	A	G	222	141	363	0	2	365	0	0
17	74561213	rs7352	A	G	328	298	626	0	16	642	0	0
17	74561319	rs7353	G	A	252	244	496	0	5	501	0	0
17	74710128	rs2240775	T	C	9	7	16	0	0	16	0	0
17	74710572	rs2240774	T	C	8	6	14	0	0	14	0	0
17	74711723	rs2240772	T	C	8	4	12	0	0	12	0	0
17	74712310	rs2286585	A	G	4	3	7	0	0	7	0	0
17	74715662	rs62086781	C	T	17	4	21	0	0	21	0	0
17	74717604	rs2240770	C	T	10	8	18	0	1	19	0	0
17	74718155	rs2240769	C	T	22	19	41	0	1	42	0	0
17	74723422	rs140223834	T	C	1	8	9	0	0	9	0	0
17	74729691	rs138247613	G	A	55	73	128	0	0	128	0	0
17	74733403	rs3744061	G	A	23	14	37	0	0	37	0	0
17	75085015	rs8082404	G	A	21	19	40	0	0	40	0	0
17	75085260	rs2247814	C	G	17	22	39	0	0	39	0	0
17	75085434	rs2678770	G	A	4	6	10	0	0	10	0	0
17	75087863	rs55633074	A	G	5	2	7	0	0	7	0	0
17	75088462	rs577490	A	G	5	3	8	0	0	8	0	0
17	75090826	rs3760141	A	G	15	20	35	0	0	35	0	0
17	75144393	rs58069837	A	G	3	3	6	0	0	6	0	0
17	75144835	rs62078297	C	T	3	12	15	0	2	17	0	0
17	75146909	rs55994155	C	G	8	9	17	0	0	17	0	0
17	75148741	rs10163481	G	A	6	10	16	0	0	16	0	0
17	75198223	rs117140021	T	C	6	5	11	0	0	11	0	0
17	75199024	rs145663279	A	T	4	2	6	0	0	6	0	0
17	75199580	rs12602668	A	G	10	5	15	0	0	15	0	0
17	75200605	.	T	C	10	0	10	0	0	10	0	0
17	75207545	rs77291632	G	A	4	8	12	0	0	12	0	0
17	75207586	rs77932036	T	G	5	6	11	0	0	11	0	0
17	75207853	rs78493457	A	C	5	4	9	0	0	9	0	0
17	75208580	rs35528126	C	T	6	6	12	0	0	12	0	0
17	75208601	rs35300000	G	A	4	4	8	0	0	8	0	0
17	75208638	rs9912398	G	A	6	6	12	0	0	12	0	0
17	75208766	rs1983158	C	T	13	18	31	0	0	31	0	0
17	75210574	rs3744063	A	C	56	42	98	0	2	100	0	0
17	75211608	rs12942219	G	A	67	56	123	0	19	142	0	0
17	75369578	rs7217986	T	C	6	4	10	0	0	10	0	0
17	75370468	rs93075	T	G	2	4	6	0	0	6	0	0
17	75447586	rs11650934	C	G	2	9	11	0	0	11	0	0
17	75494746	rs1059485	A	G	83	57	140	0	13	153	0	0
17	75495065	rs448203	T	C	127	148	275	0	3	278	0	0
17	75495397	rs9038	T	C	154	151	305	0	2	307	0	0
17	75496460	rs445507	T	C	22	23	45	0	1	47	1	0
17	76112223	rs2008609	G	A	8	7	15	0	0	15	0	0
17	76112253	rs77304758	T	C	5	4	9	0	0	9	0	0
17	76114101	rs62079068	G	A	16	8	24	0	0	24	0	0
17	76114941	rs2613519	C	T	10	6	16	0	2	18	0	0
17	76115181	rs2252496	A	T	23	8	31	0	0	31	0	0
17	76116017	rs743047	C	A	4	5	9	0	0	9	0	0
17	76116153	rs2926778	T	C	2	4	6	0	0	6	0	0
17	76117517	rs4789014	G	A	5	12	17	0	0	17	0	0
17	76117570	rs2613520	G	C	6	10	16	0	0	16	0	0
17	76119817	rs2613521	C	A	3	4	7	0	1	8	0	0
17	76123954	rs62079071	C	A	2	9	11	0	0	11	0	0
17	76127431	rs383603	G	C	42	27	69	0	2	71	0	0
17	76129636	rs417780	T	C	7	4	11	0	0	11	0	0
17	76129910	rs58590476	A	C	2	4	6	0	0	6	0	0
17	76130575	rs7208422	A	T	64	54	118	0	2	120	0	0
17	76131070	rs12452890	G	A	82	60	142	0	8	150	0	0
17	76131519	rs12603246	A	G	6	7	13	0	0	13	0	0
17	76132065	rs11658268	A	G	6	5	11	0	0	12	1	0
17	76132141	rs11658379	G	C	6	2	8	0	0	10	2	0
17	76132692	rs8068430	T	C	4	5	9	0	0	9	0	0
17	76132826	rs8067323	A	G	5	5	10	0	0	10	0	0
17	76133693	rs55694641	C	T	14	3	17	0	0	17	0	0
17	76133746	rs12449680	A	G	13	4	17	0	0	17	0	0
17	76134828	rs7221365	C	A	8	8	16	0	0	16	0	0
17	76135412	rs17773854	G	T	33	16	49	0	0	49	0	0
17	76137337	rs454138	C	G	54	46	100	0	0	100	0	0
17	76137477	rs2871647	T	G	73	43	116	0	1	117	0	0
17	76138577	rs4789015	A	G	199	110	309	0	13	323	1	0
17	76165548	rs3794742	G	A	4	7	11	0	0	11	0	0
17	76165863	rs3829575	C	T	7	8	15	0	0	15	0	0
17	76166196	rs870355	A	G	5	6	11	0	0	11	0	0
17	76166491	rs1810063	G	A	4	12	16	0	0	16	0	0
17	76166689	rs4583318	C	A	9	14	23	0	0	23	0	0
17	76168219	rs10358	C	T	265	248	513	0	4	517	0	0
17	76168971	rs9897765	G	A	4	4	8	0	0	8	0	0
17	76170735	rs1065769	C	T	105	92	197	0	0	197	0	0
17	76172167	rs9893988	G	A	6	6	12	0	0	12	0	0
17	76178748	rs1143697	T	C	106	82	188	0	2	191	1	0
17	76183043	rs1071664	A	G	97	67	164	0	1	165	0	0
17	76198587	rs72897838	A	G	12	21	33	0	1	34	0	0
17	76200965	rs72897843	C	T	10	3	13	0	0	13	0	0
17	76203600	rs9903738	T	C	58	44	102	0	0	102	0	0
17	76203652	rs60968356	T	C	46	57	103	0	0	103	0	0
17	76353910	rs4969169	T	C	720	727	1447	0	13	1460	0	0
17	76357874	rs11868378	G	A	4	2	6	0	0	6	0	0
17	76400230	rs3744220	G	A	18	59	77	0	0	77	0	0
17	76402116	rs2376584	G	A	17	4	21	0	0	21	0	0
17	76410871	rs3744216	G	A	4	3	7	0	0	7	0	0
17	76415153	rs72921261	G	C	2	4	6	0	0	6	0	0
17	76415215	rs72921265	A	G	4	3	7	0	0	7	0	0
17	76416045	rs7208969	A	G	10	9	19	0	0	19	0	0
17	76416825	rs8071516	G	A	17	9	26	0	1	27	0	0
17	76417883	rs2376585	T	C	4	20	24	0	0	24	0	0
17	76418740	rs72903315	G	A	13	14	27	0	0	27	0	0
17	76419076	rs6501210	T	G	17	10	27	0	0	27	0	0
17	76419185	.	C	T	13	4	17	0	0	17	0	0
17	76419187	rs572955542	A	G	17	4	21	0	0	21	0	0
17	76419479	rs72903319	A	G	37	19	56	0	0	56	0	0
17	76419637	rs72903322	T	C	46	29	75	0	0	75	0	0
17	76419882	rs72903323	G	A	33	37	70	0	0	70	0	0
17	76420373	rs12942703	G	A	95	71	166	0	1	167	0	0
17	76420393	rs55973973	G	A	76	96	172	0	0	172	0	0
17	76420437	rs56246296	T	A	75	94	169	0	2	171	0	0
17	76670233	rs6728	C	G	31	19	50	0	0	50	0	0
17	76672002	rs1126607	T	C	110	73	183	0	5	188	0	0
17	76672322	rs12943069	A	T	64	62	126	0	4	130	0	0
17	76672700	rs11658223	T	A	39	58	97	0	2	99	0	0
17	76677744	rs11650504	C	T	4	7	11	0	0	11	0	0
17	76677761	rs11650480	A	G	5	6	11	0	0	11	0	0
17	76678940	rs9895721	T	C	4	4	8	0	0	8	0	0
17	76683515	rs62075563	C	T	7	8	15	0	0	15	0	0
17	76691840	rs7215100	A	G	7	4	11	0	0	11	0	0
17	76703516	rs11654527	G	T	5	1	6	0	0	6	0	0
17	76789754	rs12953123	G	A	0	8	8	0	0	8	0	0
17	76804108	rs7211960	C	T	5	5	10	0	0	10	0	0
17	76805399	rs58951893	A	G	3	3	6	0	1	7	0	0
17	76814782	rs35273233	G	A	169	144	313	0	4	317	0	0
17	76817090	rs3744793	C	T	108	110	218	0	2	220	0	0
17	76853337	rs3786146	C	T	4	2	6	0	0	6	0	0
17	76971226	rs35424237	A	G	2	4	6	0	0	6	0	0
17	76971470	rs3785530	G	A	7	4	11	0	0	11	0	0
17	76972231	rs11548454	G	A	355	342	697	0	1	698	0	0
17	76975555	rs117685473	G	A	4	6	10	0	0	10	0	0
17	76975558	rs11655977	C	T	6	4	10	0	0	10	0	0
17	77076302	rs62063824	G	A	8	11	19	0	3	22	0	0
17	77078109	rs1317421	A	G	15	9	24	0	0	24	0	0
17	77083180	rs57241083	C	G	11	15	26	0	0	27	1	0
17	77083619	rs3744176	T	C	8	11	19	0	0	19	0	0
17	77084654	rs11557	G	T	5	5	10	0	0	10	0	0
17	77758484	rs3751956	G	A	9	4	13	0	0	13	0	0
17	77761186	rs117776109	C	T	20	18	38	0	0	38	0	0
17	77809823	rs1285251	T	C	17	5	22	0	0	22	0	0
17	77809998	rs1285250	C	T	13	10	23	0	0	23	0	0
17	77810143	rs1285249	C	G	13	7	20	0	0	20	0	0
17	77810391	rs73422123	C	T	21	9	30	0	0	30	0	0
17	77811495	rs56223906	G	A	8	5	13	0	0	13	0	0
17	77811854	rs2289728	G	A	6	10	16	0	1	17	0	0
17	77906736	rs12453969	G	A	2	4	6	0	0	6	0	0
17	77907323	rs75533695	C	T	2	4	6	0	0	6	0	0
17	77907491	rs71387959	T	C	6	0	6	0	0	6	0	0
17	77910480	rs12601303	T	G	4	4	8	0	0	8	0	0
17	77910710	rs7502928	T	C	5	2	7	0	0	7	0	0
17	77911923	rs78436252	G	A	5	3	8	0	0	8	0	0
17	77912258	rs17052909	T	C	4	3	7	0	0	7	0	0
17	77914040	rs1663196	C	T	7	4	11	0	0	11	0	0
17	77917818	rs11150821	C	A	6	2	8	0	0	8	0	0
17	77986891	rs146764776	C	T	2	4	6	0	0	6	0	0
17	77987144	rs140228131	A	C	6	3	9	0	0	9	0	0
17	77987239	rs34603877	C	T	5	6	11	0	0	11	0	0
17	78075908	rs4889961	G	C	6	13	19	0	0	19	0	0
17	78078709	rs1800300	T	C	33	27	60	0	0	60	0	0
17	78079597	rs1042393	A	G	32	23	55	0	1	56	0	0
17	78079669	rs1042395	G	A	31	23	54	0	1	55	0	0
17	78081661	rs1800303	A	T	32	33	65	0	1	66	0	0
17	78082504	rs1800304	G	A	44	55	99	0	1	100	0	0
17	78083791	rs1800305	C	T	54	29	83	0	1	84	0	0
17	78085213	rs7221675	C	T	7	4	11	0	0	11	0	0
17	78085214	rs7209921	A	G	7	4	11	0	0	11	0	0
17	78085228	rs4889818	A	G	6	4	10	0	0	10	0	0
17	78091405	rs1126690	G	A	77	40	117	0	1	118	0	0
17	78092063	rs1042397	G	A	87	78	165	0	0	165	0	0
17	78093221	rs2229221	G	A	106	80	186	0	2	188	0	0
17	78110450	.	G	A	7	5	12	0	0	12	0	0
17	78110507	rs72850881	G	A	6	4	10	0	0	10	0	0
17	78110917	rs77319086	C	A	6	6	12	0	1	13	0	0
17	78111449	rs2289535	A	C	3	3	6	0	0	6	0	0
17	78111877	rs2361710	T	C	5	4	9	0	0	9	0	0
17	78115484	rs935117	A	C	3	5	8	0	0	8	0	0
17	78183396	rs1046832	A	G	21	16	37	0	5	42	0	0
17	78183403	rs709677	G	C	24	16	40	0	2	42	0	0
17	78183411	rs709678	T	C	23	19	42	0	1	43	0	0
17	78183936	rs2071148	G	A	12	28	40	0	0	40	0	0
17	78184393	rs7503034	C	T	15	14	29	0	1	30	0	0
17	78185527	rs2269376	T	G	4	3	7	0	1	8	0	0
17	78185556	rs2269375	G	A	4	3	7	0	0	7	0	0
17	78220387	.	C	T	5	1	6	0	1	7	0	0
17	78302157	rs8082521	C	A	5	5	10	0	0	10	0	0
17	78305871	rs10782008	G	A	2	9	11	0	0	11	0	0
17	78306280	rs8074015	A	G	8	2	10	0	0	10	0	0
17	78306308	rs9908287	C	G	10	2	12	0	0	12	0	0
17	78311508	rs4890009	G	A	4	8	12	0	0	12	0	0
17	78313562	rs34399489	C	T	3	3	6	0	0	6	0	0
17	78319136	rs9674961	G	A	9	9	18	0	0	18	0	0
17	78319380	rs4890012	G	C	10	6	16	0	0	16	0	0
17	78337058	rs35332090	G	C	16	13	29	0	0	29	0	0
17	78341776	rs77506504	G	A	14	17	31	0	0	31	0	0
17	78355823	.	A	G	14	13	27	0	0	27	0	0
17	78357478	rs12944088	A	G	15	27	42	0	1	43	0	0
17	78363711	rs36046948	G	A	28	40	68	0	0	68	0	0
17	78390755	rs8065009	A	G	8	6	14	0	0	14	0	0
17	78390833	rs4366758	G	T	5	10	15	0	0	15	0	0
17	78392391	rs8067574	C	T	2	8	10	0	0	10	0	0
17	78518780	rs11547301	C	T	15	8	23	0	0	23	0	0
17	78519169	rs12602885	G	A	9	16	25	0	0	25	0	0
17	78599562	rs17848685	C	G	19	14	33	0	0	33	0	0
17	78820329	rs3751945	C	T	14	14	28	0	0	28	0	0
17	78865630	rs2289765	A	G	13	17	30	0	0	30	0	0
17	78899458	rs2271608	G	A	4	4	8	0	0	8	0	0
17	78899595	rs3817293	G	A	5	10	15	0	0	15	0	0
17	78901443	rs36171362	T	G	8	2	10	0	0	10	0	0
17	78904311	rs62068527	T	C	6	1	7	0	1	8	0	0
17	78906360	rs4969311	C	G	15	6	21	0	0	21	0	0
17	78906844	rs2090202	C	A	9	7	16	0	0	16	0	0
17	78907809	rs35071447	C	A	2	5	7	0	1	8	0	0
17	78910499	rs35635776	C	A	14	13	27	0	0	27	0	0
17	78910748	rs2333885	T	C	14	15	29	0	0	29	0	0
17	78911041	rs1877926	C	T	3	5	8	0	0	8	0	0
17	78919558	rs1567962	C	T	11	15	26	0	0	26	0	0
17	78935197	rs9899178	C	T	15	4	19	0	0	19	0	0
17	78938204	rs3751936	G	C	9	14	23	0	0	23	0	0
17	78938385	rs11547302	G	A	11	8	19	0	0	19	0	0
17	78939414	rs3751932	C	T	22	29	51	0	0	51	0	0
17	78939979	rs572867935	C	T	8	3	11	0	0	11	0	0
17	78972669	rs11650034	C	T	6	2	8	0	0	8	0	0
17	78973474	rs1128687	T	C	49	53	102	0	2	104	0	0
17	78973768	rs13507	T	C	21	50	71	0	0	71	0	0
17	78973901	rs1128705	C	G	4	6	10	0	0	10	0	0
17	79003163	rs113473934	C	G	34	33	67	0	0	67	0	0
17	79003644	rs1137045	G	A	11	15	26	0	0	26	0	0
17	79004271	rs12449867	T	C	24	17	41	0	0	41	0	0
17	79004377	rs72851864	G	A	26	23	49	0	0	49	0	0
17	79005292	rs55762738	G	A	27	22	49	0	1	50	0	0
17	79005746	rs4969238	T	C	6	4	10	0	0	10	0	0
17	79006850	rs11870986	T	C	18	9	27	0	0	27	0	0
17	79007075	rs11150764	C	A	16	17	33	0	0	33	0	0
17	79008975	rs113778053	C	T	30	23	53	0	0	53	0	0
17	79082862	rs11664	G	A	9	4	13	0	0	13	0	0
17	79085335	rs3935648	C	G	6	2	8	0	0	8	0	0
17	79091883	rs7220721	C	T	2	14	16	0	2	18	0	0
17	79093822	rs36000545	A	G	4	2	6	0	0	6	0	0
17	79165171	rs869370	G	A	5	2	7	0	0	7	0	0
17	79165556	rs78466129	G	C	3	10	13	0	0	13	0	0
17	79165618	rs2279921	C	G	6	8	14	0	0	14	0	0
17	79165686	rs2279920	G	A	6	3	9	0	0	9	0	0
17	79165856	rs2279919	C	T	9	3	12	0	0	12	0	0
17	79166384	rs3744150	C	T	18	22	40	0	0	40	0	0
17	79167248	rs77622527	G	A	4	3	7	0	0	7	0	0
17	79167410	rs77909435	T	C	4	2	6	0	0	6	0	0
17	79169641	rs61741559	G	A	27	18	45	0	2	47	0	0
17	79170578	rs4613097	C	T	18	19	37	0	0	37	0	0
17	79182778	rs62075318	T	C	18	25	43	0	0	43	0	0
17	79202329	rs1048775	G	C	66	62	128	0	5	133	0	0
17	79202956	rs2048057	T	C	47	50	97	0	3	100	0	0
17	79207061	rs2292183	C	T	3	3	6	0	0	6	0	0
17	79208535	rs11150778	G	A	13	15	28	0	0	28	0	0
17	79208604	rs11652662	G	A	9	15	24	0	0	24	0	0
17	79213562	rs2255166	T	C	14	5	19	0	1	20	0	0
17	79220016	rs61740863	T	C	56	30	86	0	0	86	0	0
17	79220224	rs2725405	G	C	24	43	67	0	0	67	0	0
17	79226362	rs3803767	G	A	68	49	117	0	0	117	0	0
17	79234588	rs7214678	A	C	5	1	6	0	0	6	0	0
17	79234600	.	G	A	2	5	7	0	0	7	0	0
17	79237900	rs9901514	A	G	2	4	6	0	0	6	0	0
17	79237921	rs66977279	A	G	2	5	7	0	0	7	0	0
17	79238213	rs11651784	C	T	1	9	10	0	0	10	0	0
17	79244802	rs2292184	T	C	73	44	117	0	7	124	0	0
17	79268934	rs117190386	G	A	5	3	8	0	0	8	0	0
17	79363851	rs8068986	T	G	1	12	13	0	0	13	0	0
17	79375360	rs8079052	G	A	5	59	64	0	0	64	0	0
17	79507272	rs12675	G	A	36	49	85	0	3	88	0	0
17	79511135	rs8077430	A	G	33	43	76	0	1	77	0	0
17	79514028	rs74818865	C	G	16	26	42	0	0	42	0	0
17	79514129	rs11552304	G	A	30	40	70	0	0	70	0	0
17	79524790	rs8068511	T	A	138	127	265	0	9	274	0	0
17	79524882	rs8068081	C	T	153	171	324	0	4	329	1	0
17	79525118	rs6565596	T	G	110	76	186	0	9	195	0	0
17	79525660	rs3208787	A	G	66	85	151	0	0	152	1	0
17	79525862	rs3087664	A	G	110	126	236	0	1	237	0	0
17	79526009	rs11541224	G	A	135	127	262	0	2	264	0	0
17	79527953	rs12449763	A	T	7	13	20	0	0	20	0	0
17	79528240	.	C	T	5	4	9	0	0	9	0	0
17	79529315	rs11150798	A	G	5	3	8	0	0	8	0	0
17	79530031	rs9916546	T	C	3	3	6	0	0	6	0	0
17	79530132	rs9916803	T	C	4	2	6	0	0	6	0	0
17	79530967	rs62073395	T	G	18	26	44	0	0	44	0	0
17	79531183	rs72855627	G	T	6	7	13	0	0	13	0	0
17	79531888	rs9912074	A	G	7	8	15	0	0	15	0	0
17	79532109	rs9911739	C	G	7	6	13	0	0	13	0	0
17	79535171	rs7406704	T	C	3	3	6	0	0	6	0	0
17	79535275	rs62073398	A	G	3	5	8	0	0	8	0	0
17	79535532	rs7406408	A	G	7	4	11	0	0	11	0	0
17	79564304	rs62074671	G	T	87	94	181	0	1	182	0	0
17	79580457	rs17852306	C	A	87	92	179	0	8	187	0	0
17	79589242	rs6565604	G	A	73	65	138	0	0	138	0	0
17	79596811	rs9894429	C	T	44	20	64	0	0	64	0	0
17	79603448	rs78983222	C	G	4	2	6	0	0	6	0	0
17	79617534	rs3432	A	G	22	15	37	0	0	37	0	0
17	79617620	rs1126835	A	C	88	72	160	0	0	160	0	0
17	79617705	rs13372	G	A	116	144	260	0	1	261	0	0
17	79617711	rs57654048	G	A	154	127	281	0	0	281	0	0
17	79617788	rs60909116	C	T	188	156	344	0	3	347	0	0
17	79617830	rs1126818	G	A	131	136	267	0	2	269	0	0
17	79617871	rs8908	A	G	170	141	311	0	2	313	0	0
17	79632363	rs1128812	C	T	106	79	185	0	1	186	0	0
17	79634774	rs61742303	A	T	10	11	21	0	0	21	0	0
17	79634813	rs11546632	T	C	16	17	33	0	0	33	0	0
17	79637065	rs57405099	T	C	4	2	6	0	0	6	0	0
17	79638447	rs56892497	T	G	2	4	6	0	0	6	0	0
17	79638805	rs11150805	C	T	26	24	50	0	1	51	0	0
17	79639310	rs12938873	G	A	6	1	7	0	0	7	0	0
17	79639550	rs11546630	G	A	30	21	51	0	0	51	0	0
17	79639708	rs11546631	C	T	44	24	68	0	1	69	0	0
17	79639874	rs34153944	G	C	41	25	66	0	0	66	0	0
17	79639983	rs59853503	C	T	40	36	76	0	0	76	0	0
17	79640563	rs12949741	G	A	52	66	118	0	1	119	0	0
17	79649515	rs7503637	G	A	8	1	9	0	0	9	0	0
17	79649568	rs62077175	G	T	13	7	20	0	1	21	0	0
17	79651490	rs79193599	C	A	7	4	11	0	0	11	0	0
17	79652149	rs35569308	G	A	5	9	14	0	1	15	0	0
17	79652165	rs34709589	A	G	7	8	15	0	0	15	0	0
17	79652265	rs34975185	G	A	12	13	25	0	0	25	0	0
17	79652487	rs34730558	C	T	9	5	14	0	1	15	0	0
17	79653206	rs66508304	C	A	5	3	8	0	0	8	0	0
17	79653259	rs67703038	C	T	6	3	9	0	0	9	0	0
17	79653311	rs72858892	T	C	7	4	11	0	0	11	0	0
17	79653321	rs72858893	T	C	6	5	11	0	0	11	0	0
17	79654285	rs11871678	G	A	9	2	11	0	0	11	0	0
17	79654298	rs67606182	C	T	4	7	11	0	1	12	0	0
17	79654557	rs34264473	C	T	3	5	8	0	1	9	0	0
17	79654737	rs34876268	A	G	4	6	10	0	0	10	0	0
17	79654783	rs34276461	A	G	3	3	6	0	0	6	0	0
17	79655046	rs11867543	C	T	4	2	6	0	0	6	0	0
17	79655251	rs12452113	A	G	3	3	6	0	0	6	0	0
17	79657840	rs34203932	A	G	8	3	11	0	0	11	0	0
17	79658100	rs6565620	C	T	4	5	9	0	0	9	0	0
17	79658249	rs35618583	A	G	4	4	8	0	0	8	0	0
17	79658300	rs34033471	C	T	5	5	10	0	0	10	0	0
17	79658412	rs34784238	T	G	1	5	6	0	0	6	0	0
17	79658940	rs62077183	C	A	1	6	7	0	0	7	0	0
17	79659342	rs12946662	C	T	9	14	23	0	0	23	0	0
17	79659847	rs7215738	C	T	10	6	16	0	1	17	0	0
17	79659859	rs12946356	T	C	6	9	15	0	0	15	0	0
17	79659915	rs12937833	C	T	4	9	13	0	0	13	0	0
17	79660187	rs7216239	C	T	10	10	20	0	0	20	0	0
17	79662067	rs34384005	A	G	90	93	183	0	10	193	0	0
17	79662481	rs36074783	T	C	3	5	8	0	0	8	0	0
17	79663880	rs12951171	T	C	95	72	167	0	2	169	0	0
17	79666933	rs75879032	G	A	3	3	6	0	0	6	0	0
17	79667519	rs373883614	C	T	103	76	179	0	3	182	0	0
17	79668135	rs56058441	G	T	170	137	307	0	1	308	0	0
17	79668552	rs34897798	C	T	144	134	278	0	0	278	0	0
17	79668664	rs1128805	C	T	220	195	415	0	9	424	0	0
17	79668897	rs7189	C	T	273	240	513	0	2	515	0	0
17	79670122	rs8077959	G	A	10	16	26	0	0	26	0	0
17	79671714	rs11546280	T	C	259	236	495	0	2	497	0	0
17	79676011	rs66826982	C	G	4	4	8	0	0	8	0	0
17	79676109	rs62077190	C	A	3	3	6	0	0	6	0	0
17	79677583	rs35387685	G	A	2	4	6	0	0	6	0	0
17	79678063	rs62077191	A	G	4	3	7	0	0	7	0	0
17	79687689	rs114512848	T	A	38	28	66	0	1	67	0	0
17	79687736	rs62077222	G	T	36	41	77	0	0	77	0	0
17	79687860	rs1129921	G	A	31	46	77	0	1	78	0	0
17	79688032	.	G	A	7	4	11	0	0	11	0	0
17	79783321	.	T	G	8	10	18	0	0	18	0	0
17	79785823	rs150115491	A	T	3	3	6	0	0	6	0	0
17	79791131	.	C	T	96	64	160	0	1	161	0	0
17	79861258	.	G	A	18	23	41	0	0	41	0	0
17	79861980	rs68168570	T	C	22	13	35	0	0	35	0	0
17	79862630	rs7405872	G	A	61	42	103	0	2	105	0	0
17	79910765	rs75165065	G	T	10	14	24	0	0	24	0	0
17	79952784	rs117409128	C	A	6	18	24	0	0	24	0	0
17	79954349	.	C	T	26	17	43	0	0	43	0	0
17	79982622	.	G	C	7	6	13	0	0	13	0	0
17	80006504	rs1128009	T	C	112	102	214	0	4	219	1	0
17	80006957	rs12948507	A	C	95	91	186	0	4	190	0	0
17	80007887	rs9915228	A	G	20	19	39	0	2	41	0	0
17	80007897	rs9915742	G	T	20	20	40	0	0	40	0	0
17	80008018	rs9893491	A	G	16	16	32	0	0	32	0	0
17	80008392	rs9916764	G	T	85	76	161	0	2	163	0	0
17	80009156	rs28552909	T	G	3	5	8	0	0	8	0	0
17	80011394	rs4969483	T	C	1	5	6	0	0	6	0	0
17	80012626	rs116882446	G	T	151	151	302	0	0	302	0	0
17	80014861	rs4969484	T	G	6	8	14	0	0	14	0	0
17	80017686	.	C	T	8	7	15	0	1	16	0	0
17	80018081	rs58365150	C	T	9	12	21	0	0	21	0	0
17	80020812	rs11542332	C	T	217	210	427	0	3	430	0	0
17	80022267	rs8068632	C	T	6	1	7	0	0	7	0	0
17	80022361	rs8068796	C	T	5	1	6	0	0	6	0	0
17	80023023	rs58112725	C	T	2	4	6	0	1	7	0	0
17	80023050	rs28374526	T	C	5	3	8	0	0	8	0	0
17	80039465	rs148201644	G	A	11	5	16	0	0	16	0	0
17	80041362	rs45591642	C	T	1	5	6	0	0	6	0	0
17	80043044	rs45573640	C	G	8	4	12	0	0	12	0	0
17	80047162	.	C	T	64	60	124	0	3	127	0	0
17	80111757	rs78787432	T	A	4	7	11	0	0	11	0	0
17	80159260	rs12451196	G	A	5	4	9	0	0	9	0	0
17	80189642	rs12450761	A	G	5	1	6	0	0	6	0	0
17	80189813	rs60910743	G	A	2	4	6	0	0	6	0	0
17	80191755	rs11649866	G	C	1	6	7	0	0	7	0	0
17	80191763	rs11656690	T	C	1	6	7	0	0	7	0	0
17	80195591	.	G	A	25	27	52	0	1	53	0	0
17	80208933	rs11653735	C	T	5	14	19	0	0	19	0	0
17	80212643	rs9675319	G	C	9	9	18	0	0	18	0	0
17	80212769	rs9747923	C	G	27	1	28	0	0	28	0	0
17	80212779	.	G	A	28	3	31	0	1	32	0	0
17	80212780	.	C	T	30	3	33	0	0	33	0	0
17	80212784	.	G	A	32	8	40	0	1	41	0	0
17	80212790	rs9747926	C	G	27	32	59	0	3	62	0	0
17	80212792	.	G	C	53	9	62	0	1	63	0	0
17	80218800	rs35693344	G	A	7	9	16	0	0	16	0	0
17	80230633	rs7209167	G	C	9	3	12	0	1	13	0	0
17	80248220	rs11655036	G	A	9	15	24	0	0	24	0	0
17	80273291	.	G	A	65	58	123	0	0	123	0	0
17	80274081	rs201625874	G	A	57	53	110	0	1	111	0	0
17	80280865	rs11077986	G	A	9	3	12	0	0	12	0	0
17	80350331	rs11903	G	A	56	74	130	0	0	130	0	0
17	80351104	rs7208956	T	C	5	3	8	0	0	8	0	0
17	80354859	rs72857427	G	T	5	9	14	0	0	14	0	0
17	80354870	rs66842398	C	T	2	8	10	0	0	10	0	0
17	80354937	rs59719801	G	C	6	5	11	0	0	11	0	0
17	80373452	rs4789769	C	T	21	14	35	0	0	35	0	0
17	80391684	rs4789773	A	G	24	23	47	0	0	47	0	0
17	80400755	rs8008	C	T	25	10	35	0	5	40	0	0
17	80401946	rs2306758	A	G	16	11	27	0	1	28	0	0
17	80407883	rs12449726	C	T	5	1	6	0	0	6	0	0
17	80407948	rs12450191	C	T	4	2	6	0	0	6	0	0
17	80415242	rs4789692	T	A	2	8	10	0	0	10	0	0
17	80415315	rs6502113	C	T	6	17	23	0	0	23	0	0
17	80415914	rs7209788	A	G	8	22	30	0	0	30	0	0
17	80415981	rs7218534	T	C	8	20	28	0	0	28	0	0
17	80416069	rs12941490	C	T	2	10	12	0	0	12	0	0
17	80416090	rs28365943	C	G	2	11	13	0	0	13	0	0
17	80422693	rs111339730	C	T	1	8	9	0	0	9	0	0
17	80423712	rs12450240	G	T	5	5	10	0	0	10	0	0
17	80424386	rs9891900	T	G	3	7	10	0	0	10	0	0
17	80439733	rs9909476	C	T	6	15	21	0	0	21	0	0
17	80439907	rs9898723	A	G	8	17	25	0	0	25	0	0
17	80439925	rs9905527	T	C	9	21	30	0	0	30	0	0
17	80443309	rs9890316	G	A	9	6	15	0	0	15	0	0
17	80447979	rs901372	C	T	4	6	10	0	0	10	0	0
17	80448017	rs901371	T	A	6	3	9	0	0	9	0	0
17	80478403	rs76235422	C	T	7	4	11	0	0	11	0	0
17	80527356	rs12452440	T	C	5	5	10	0	0	10	0	0
17	80527430	rs72862345	T	G	5	2	7	0	0	7	0	0
17	80527895	rs4789797	G	A	3	3	6	0	0	6	0	0
17	80527909	rs111510017	T	C	3	3	6	0	0	6	0	0
17	80527967	rs111720645	A	G	4	2	6	0	0	6	0	0
17	80529972	rs3751908	A	G	6	4	10	0	0	10	0	0
17	80530134	rs3751907	A	G	15	9	24	0	0	24	0	0
17	80530429	rs3736206	T	C	11	14	25	0	2	27	0	0
17	80536366	rs72862377	C	A	4	2	6	0	0	6	0	0
17	80536908	rs2279396	A	C	9	11	20	0	0	20	0	0
17	80544534	rs12951109	A	T	2	4	6	0	0	6	0	0
17	80546400	rs35748473	C	T	4	2	6	0	0	6	0	0
17	80546696	rs4789702	G	A	6	1	7	0	0	7	0	0
17	80561325	rs3794714	G	A	8	3	11	0	0	11	0	0
17	80561707	rs61740618	A	G	6	4	10	0	0	10	0	0
17	80562219	rs12944611	T	A	1	6	7	0	0	7	0	0
17	80562220	rs12939611	C	T	1	6	7	0	0	7	0	0
17	80572628	rs1059672	A	G	300	337	637	0	2	639	0	0
17	80580231	rs8082615	C	G	8	10	18	0	0	18	0	0
17	80580795	rs12944730	C	G	13	12	25	0	0	25	0	0
17	80580843	rs12949889	T	C	11	7	18	0	0	18	0	0
17	80580986	rs111276463	G	C	3	5	8	0	0	8	0	0
17	80582438	rs112754216	C	T	3	3	6	0	0	6	0	0
17	80583230	rs3826309	A	G	25	25	50	0	0	50	0	0
17	80583711	rs3826310	G	A	22	20	42	0	0	42	0	0
17	80585094	rs2291393	C	T	242	228	470	0	5	475	0	0
17	80585873	rs75359963	C	T	10	7	17	0	0	17	0	0
17	80588575	rs2306755	C	A	17	11	28	0	0	28	0	0
17	80588763	rs12600791	T	G	10	6	16	0	0	16	0	0
17	80615568	rs149376935	A	G	8	11	19	0	0	19	0	0
17	80676111	rs4789711	G	A	8	5	13	0	0	13	0	0
17	80676154	rs4789712	C	T	9	4	13	0	0	13	0	0
17	80677407	rs12941965	A	C	6	7	13	0	0	13	0	0
17	80677587	rs12946071	C	T	7	3	10	0	0	10	0	0
17	80685660	rs7794	G	A	60	42	102	0	1	103	0	0
17	80863857	rs2292971	T	C	42	28	70	0	5	75	0	0
17	80887244	rs1127986	T	C	83	62	145	0	1	146	0	0
17	80897215	rs3744156	C	T	3	3	6	0	0	6	0	0
17	80899281	rs9390	G	A	85	69	154	0	0	154	0	0
17	80901002	rs3603	C	T	11	8	19	0	0	19	0	0
17	80901750	rs11077950	C	T	63	61	124	0	0	124	0	0
17	80904844	rs7225887	C	T	48	49	97	0	2	99	0	0
17	80905299	rs3744157	T	C	17	6	23	0	0	23	0	0
17	80907253	rs7222745	A	G	4	6	10	0	0	10	0	0
17	80907283	rs7222773	A	G	4	7	11	0	0	11	0	0
17	80907728	rs6502021	T	C	11	8	19	0	0	19	0	0
17	80908174	rs9906163	T	C	3	8	11	0	0	11	0	0
17	80908501	rs12949939	C	T	3	5	8	0	0	8	0	0
17	80908652	rs6502022	C	T	9	5	14	0	1	15	0	0
17	80909157	rs2380173	T	G	3	4	7	0	0	7	0	0
17	80910061	rs8076119	A	G	2	5	7	0	0	7	0	0
17	80911405	rs191156681	A	G	7	1	8	0	0	8	0	0
17	80918337	rs113959824	C	A	4	2	6	0	0	6	0	0
17	80923536	rs4986144	C	T	48	22	70	0	1	71	0	0
17	81040847	rs7503602	T	C	7	6	13	0	0	13	0	0
17	81041077	rs6502043	C	T	6	7	13	0	0	13	0	0
17	81041938	rs66468457	A	G	13	10	23	0	0	23	0	0
17	81041976	.	T	C	7	7	14	0	0	14	0	0
17	81042222	rs72854233	A	G	10	10	20	0	0	20	0	0
17	81042402	rs72854234	C	T	16	11	27	0	0	27	0	0
17	81042479	rs72854236	A	G	18	7	25	0	0	25	0	0
17	81042773	rs72854237	C	T	6	5	11	0	0	11	0	0
17	81043039	rs9908756	A	G	154	96	250	0	1	251	0	0
17	81043658	rs72854242	A	G	4	6	10	0	0	10	0	0
17	81045722	rs7406561	T	C	8	4	12	0	0	12	0	0
17	81046413	rs7221348	C	T	2	4	6	0	0	6	0	0
17	81047721	rs7207886	C	T	5	2	7	0	0	7	0	0
17	81048424	rs79859911	T	C	4	4	8	0	0	8	0	0
17	81048786	rs138638574	G	C	4	2	6	0	0	6	0	0
17	81049726	rs4986109	C	T	8	8	16	0	0	16	0	0
17	81049741	rs4986080	G	A	10	11	21	0	0	21	0	0
17	81049792	rs4986081	G	A	11	12	23	0	0	23	0	0
17	81049906	rs62074712	T	C	8	12	20	0	0	20	0	0
17	81050982	rs7501742	G	C	2	7	9	0	0	9	0	0
17	81051007	rs7502442	G	T	4	6	10	0	0	10	0	0
17	81051887	rs7223467	T	G	12	6	18	0	1	19	0	0
17	81052423	rs8269	G	A	62	103	165	0	1	166	0	0
18	193162	rs579219	C	T	3	9	12	0	1	13	0	0
18	196185	rs12454373	A	G	15	16	31	0	0	31	0	0
18	196465	rs1299113	G	A	12	6	18	0	1	19	0	0
18	213151	rs9303891	A	C	19	32	51	0	0	51	0	0
18	213592	rs9951575	A	G	43	45	88	0	0	88	0	0
18	218895	.	T	C	90	79	169	0	1	170	0	0
18	225964	rs9950805	A	G	3	11	14	0	0	14	0	0
18	228147	rs189390561	G	A	4	6	10	0	0	10	0	0
18	260597	rs535992	T	C	6	5	11	0	0	11	0	0
18	261268	rs59364836	A	G	6	7	13	0	0	13	0	0
18	649759	rs1058151	T	C	35	62	97	0	1	98	0	0
18	657474	rs2853742	T	C	13	28	41	0	0	41	0	0
18	658064	rs2853533	G	C	8	3	11	0	0	11	0	0
18	662370	rs2612095	T	C	3	7	10	0	0	10	0	0
18	662623	rs2853541	G	C	4	2	6	0	0	6	0	0
18	662761	rs8093444	A	G	8	3	11	0	0	11	0	0
18	664286	.	G	A	4	5	9	0	0	9	0	0
18	664689	.	C	T	2	4	6	0	0	6	0	0
18	664831	.	T	C	3	4	7	0	0	7	0	0
18	664856	.	C	T	3	4	7	0	0	7	0	0
18	665023	.	C	T	5	5	10	0	0	10	0	0
18	666371	rs2847149	G	A	0	12	12	0	0	12	0	0
18	666507	rs2853543	C	G	0	6	6	0	0	6	0	0
18	666601	rs2612096	A	G	1	5	6	0	0	6	0	0
18	668258	rs15872	C	T	5	6	11	0	0	11	0	0
18	668300	rs2847150	G	A	3	6	9	0	0	9	0	0
18	668376	rs1051527	C	G	4	7	11	0	0	11	0	0
18	668650	rs2853528	C	T	3	4	7	0	0	7	0	0
18	669533	rs2853529	C	T	3	10	13	0	1	14	0	0
18	669684	rs16948322	T	C	5	8	13	0	0	13	0	0
18	670414	rs2853532	C	T	19	21	40	0	0	40	0	0
18	670541	rs2847609	A	G	23	17	40	0	0	40	0	0
18	670995	rs2612098	A	C	4	2	6	0	0	6	0	0
18	671026	rs2853534	C	T	4	2	6	0	0	6	0	0
18	671057	rs2853535	C	T	4	2	6	0	0	6	0	0
18	671520	rs2853536	C	T	4	8	12	0	0	12	0	0
18	671648	.	A	T	0	9	9	0	1	10	0	0
18	671727	rs2612099	G	A	4	6	10	0	0	10	0	0
18	671977	rs60279109	A	G	5	9	14	0	0	14	0	0
18	672043	rs2606245	A	G	6	12	18	0	0	18	0	0
18	672288	rs2853538	C	T	11	9	20	0	0	20	0	0
18	672363	rs2612100	G	A	11	5	16	0	0	16	0	0
18	672590	rs75235880	G	A	15	7	22	0	0	22	0	0
18	672792	rs1059394	C	T	22	16	38	0	0	38	0	0
18	673016	rs699517	C	T	502	549	1051	0	3	1054	0	0
18	673086	rs2790	A	G	397	383	780	0	3	783	0	0
18	673995	rs1059384	T	C	3	5	8	0	0	8	0	0
18	674012	rs8423	T	G	2	12	14	0	1	15	0	0
18	675774	rs2276115	T	A	6	1	7	0	0	7	0	0
18	675903	rs10502290	C	T	7	4	11	0	0	11	0	0
18	676008	rs495139	G	C	9	4	13	0	0	13	0	0
18	676789	rs10502289	A	T	1	5	6	0	0	6	0	0
18	691266	rs2612086	A	G	18	33	51	0	0	51	0	0
18	691439	rs2606250	T	C	3	3	6	0	0	6	0	0
18	691507	rs2606249	G	A	4	3	7	0	0	7	0	0
18	691890	rs2847332	T	C	4	4	8	0	0	8	0	0
18	692082	rs2741180	G	A	6	4	10	0	0	10	0	0
18	692095	rs2847334	A	G	6	2	8	0	0	8	0	0
18	692118	rs9953967	T	C	9	5	14	0	0	14	0	0
18	692152	rs9953980	T	C	10	4	14	0	0	14	0	0
18	692238	rs2612084	T	A	8	4	12	0	0	12	0	0
18	693767	rs2612082	C	T	6	4	10	0	0	10	0	0
18	706558	rs58085394	C	T	11	18	29	0	0	29	0	0
18	712568	rs3786349	G	A	4	3	7	0	0	7	0	0
18	722118	rs1061035	A	G	77	80	157	0	3	160	0	0
18	722644	rs17516202	A	G	74	63	137	0	0	137	0	0
18	722814	rs17551206	T	C	55	36	91	0	2	93	0	0
18	722819	rs17551213	G	A	55	32	87	0	2	89	0	0
18	722867	.	C	T	15	16	31	0	0	31	0	0
18	722874	.	C	T	18	18	36	0	0	36	0	0
18	723024	rs17516223	A	G	56	21	77	0	0	77	0	0
18	723036	rs17516230	G	A	59	24	83	0	0	83	0	0
18	723043	rs17551234	G	C	56	21	77	0	0	77	0	0
18	723048	rs17551241	C	T	55	20	75	0	1	76	0	0
18	723069	rs17551248	G	A	54	11	65	0	0	65	0	0
18	723070	rs17551255	C	T	54	11	65	0	1	66	0	0
18	724107	rs147961527	A	G	51	35	86	0	1	87	0	0
18	725330	rs75588551	A	G	5	2	7	0	0	7	0	0
18	730959	.	T	A	3	3	6	0	0	6	0	0
18	730961	rs79660941	A	T	3	3	6	0	0	6	0	0
18	2538545	rs2347279	C	A	5	4	9	0	0	9	0	0
18	2590864	rs2677883	A	G	6	1	7	0	0	7	0	0
18	2595443	rs12456560	G	T	39	23	62	0	0	62	0	0
18	2596114	rs6506020	C	T	2	5	7	0	0	7	0	0
18	2652364	rs492170	C	T	4	2	6	0	0	6	0	0
18	2656248	rs2430853	G	C	41	27	68	0	1	69	0	0
18	2658082	rs555117	A	G	2	11	13	0	0	13	0	0
18	2707077	rs12968947	C	T	3	12	15	0	0	15	0	0
18	2712757	rs62084222	C	G	6	0	6	0	0	6	0	0
18	2725227	rs11080983	C	G	3	4	7	0	1	8	0	0
18	2727586	rs62084254	G	A	12	2	14	0	1	15	0	0
18	2728686	rs10502304	T	A	6	4	10	0	0	10	0	0
18	2730660	rs62084257	T	C	5	1	6	0	0	6	0	0
18	2734200	rs17627648	C	A	6	1	7	0	0	7	0	0
18	2736069	rs2080663	G	A	4	4	8	0	0	8	0	0
18	2736157	rs117209719	A	G	2	5	7	0	0	7	0	0
18	2736935	rs62085960	G	A	9	3	12	0	0	12	0	0
18	2737002	rs62085961	T	C	8	4	12	0	1	13	0	0
18	2738259	rs8092725	G	A	11	4	15	0	1	16	0	0
18	2780995	rs11659862	C	G	1	5	6	0	0	6	0	0
18	2780997	rs11663198	A	G	2	5	7	0	0	7	0	0
18	2782448	rs56255604	T	C	1	5	6	0	0	6	0	0
18	2782504	rs12967228	A	G	4	3	7	0	0	7	0	0
18	2784926	rs72866583	G	A	35	6	41	0	1	42	0	0
18	2800825	rs10502307	G	A	5	5	10	0	0	10	0	0
18	2800915	rs62077976	G	A	5	1	6	0	0	6	0	0
18	2801151	rs62077977	G	A	11	3	14	0	0	14	0	0
18	2802593	.	C	T	149	221	370	0	1	371	0	0
18	2891847	rs3826638	C	T	66	53	119	0	1	120	0	0
18	2895959	rs1784762	G	C	2	6	8	0	0	8	0	0
18	2912756	rs3745016	C	A	4	2	6	0	0	6	0	0
18	2913896	rs1059281	C	G	80	74	154	0	1	155	0	0
18	2913918	rs1059282	G	A	93	83	176	0	0	176	0	0
18	2915721	rs12954254	G	A	17	12	29	0	0	29	0	0
18	2917152	rs1164	T	C	21	20	41	0	0	41	0	0
18	2917357	rs7980	G	A	37	32	69	0	0	69	0	0
18	2919606	rs607549	A	T	26	19	45	0	1	46	0	0
18	2925359	rs61735393	C	T	12	15	27	0	0	27	0	0
18	3075746	rs1143657	G	A	8	2	10	0	0	10	0	0
18	3173964	rs2230163	G	A	2	5	7	0	0	7	0	0
18	3240962	rs9948779	C	T	4	2	6	0	0	6	0	0
18	3246455	rs77403395	T	C	15	18	33	0	0	33	0	0
18	3246473	rs116282012	G	A	18	22	40	0	0	40	0	0
18	3246486	rs1055549	T	G	18	26	44	0	1	45	0	0
18	3248159	rs2289608	C	T	39	39	78	0	0	78	0	0
18	3248264	rs1056088	C	T	32	30	62	0	0	63	1	0
18	3248615	rs117254626	C	T	12	5	17	0	0	17	0	0
18	3248888	rs9789245	T	C	8	5	13	0	0	13	0	0
18	3249051	rs4581800	G	A	4	2	6	0	0	6	0	0
18	3249866	rs12606063	C	G	27	16	43	0	0	43	0	0
18	3250326	rs1662347	A	C	5	10	15	0	0	15	0	0
18	3250637	rs1662346	G	T	3	7	10	0	0	10	0	0
18	3250715	rs55788151	T	C	7	4	11	0	0	11	0	0
18	3251743	rs1662345	A	G	5	1	6	0	0	6	0	0
18	3251861	rs1791107	T	C	2	4	6	0	0	6	0	0
18	3251862	rs1791106	G	A	2	4	6	0	0	6	0	0
18	3251992	rs1662344	A	G	1	5	6	0	0	6	0	0
18	3251994	rs1662343	A	G	1	5	6	0	0	6	0	0
18	3252130	rs16944555	T	C	4	12	16	0	1	17	0	0
18	3252391	rs56309710	C	A	6	2	8	0	0	8	0	0
18	3252924	rs717183	A	G	11	6	17	0	0	17	0	0
18	3253543	rs1791105	G	A	5	1	6	0	0	6	0	0
18	3255301	rs1662342	G	A	2	5	7	0	0	7	0	0
18	3255700	rs12606445	C	T	5	1	6	0	0	6	0	0
18	3256112	rs7811	A	G	346	497	843	0	5	848	0	0
18	3262193	rs11650	T	C	400	476	876	0	20	896	0	0
18	3262766	rs34603712	A	G	2	4	6	0	0	6	0	0
18	3262784	rs35012773	C	T	4	2	6	0	0	6	0	0
18	3274253	rs1785243	G	C	7	6	13	0	0	13	0	0
18	3607895	rs62083186	G	C	2	4	6	0	0	6	0	0
18	3609884	rs58567439	T	C	3	3	6	0	0	6	0	0
18	5236926	rs10972	G	A	2	5	7	0	0	7	0	0
18	5237049	rs9947320	T	G	2	4	6	0	0	6	0	0
18	5238208	rs1061666	C	T	4	4	8	0	0	8	0	0
18	5238412	rs9627	C	A	9	4	13	0	0	13	0	0
18	5238442	rs11795	G	C	9	6	15	0	0	15	0	0
18	5244487	rs1127991	C	T	2	4	6	0	0	6	0	0
18	5245411	rs4548972	T	G	3	3	6	0	0	6	0	0
18	8069868	rs2230601	C	T	10	10	20	0	0	20	0	0
18	8387195	rs593978	G	A	16	9	25	0	0	25	0	0
18	8387219	rs593950	G	C	13	5	18	0	1	19	0	0
18	8627160	rs321652	A	G	6	7	13	0	0	13	0	0
18	8627221	rs9949275	C	T	6	8	14	0	0	14	0	0
18	8627456	rs9949488	C	T	7	6	13	0	0	13	0	0
18	8629720	rs9947533	T	A	4	3	7	0	0	7	0	0
18	8630981	rs28651634	G	A	5	2	7	0	0	7	0	0
18	8630983	rs28459004	C	T	4	3	7	0	0	7	0	0
18	8708258	rs7230617	C	T	1	9	10	0	0	10	0	0
18	8708262	rs12604892	A	G	1	9	10	0	0	10	0	0
18	9104283	rs78247459	G	A	15	10	25	0	0	25	0	0
18	9136851	.	C	A	10	13	23	0	0	23	0	0
18	9258610	.	A	T	59	43	102	0	1	103	0	0
18	9372470	rs11878163	A	G	13	6	19	0	0	19	0	0
18	9536249	rs10898	C	T	19	13	32	0	2	34	0	0
18	9551359	rs329008	G	T	3	4	7	0	1	8	0	0
18	9561305	rs112616948	C	T	4	8	12	0	0	12	0	0
18	9562042	rs2306134	C	T	89	87	176	0	2	178	0	0
18	9571977	rs329004	G	C	5	4	9	0	0	9	0	0
18	9604498	rs9951382	T	G	4	5	9	0	0	9	0	0
18	9619241	rs2028661	A	G	9	1	10	0	0	10	0	0
18	9708889	.	C	T	5	4	9	0	0	9	0	0
18	9709183	rs8092189	A	G	6	10	16	0	0	16	0	0
18	9710479	rs1455586	A	G	3	5	8	0	0	8	0	0
18	9710830	rs11872189	G	A	2	6	8	0	0	8	0	0
18	9710897	rs11875487	A	G	4	2	6	0	0	6	0	0
18	9711155	rs74634390	C	T	5	3	8	0	1	9	0	0
18	9713094	rs77314548	A	T	7	0	7	0	0	7	0	0
18	9714022	rs4797383	C	T	7	3	10	0	1	11	0	0
18	9714054	rs4798828	T	C	6	2	8	0	0	8	0	0
18	9714143	rs4797384	C	T	11	4	15	0	0	15	0	0
18	9714212	rs4798829	T	C	13	2	15	0	0	15	0	0
18	9714919	rs78926905	G	A	9	6	15	0	1	16	0	0
18	9715125	rs76077006	G	T	4	4	8	0	0	8	0	0
18	9715195	rs113596056	T	C	6	2	8	0	1	9	0	0
18	9715215	rs75412087	A	G	1	8	9	0	0	9	0	0
18	9717229	rs113356897	G	A	3	3	6	0	0	6	0	0
18	9732209	rs8089464	T	G	8	9	17	0	0	17	0	0
18	9732222	rs117645521	C	T	9	6	15	0	0	15	0	0
18	9732239	rs34941590	G	A	10	7	17	0	0	17	0	0
18	9732373	rs6506684	G	A	3	5	8	0	0	8	0	0
18	9734421	rs7240276	C	T	9	10	19	0	0	19	0	0
18	9734536	rs7245082	T	A	6	10	16	0	0	16	0	0
18	9734831	rs72964020	C	T	3	7	10	0	0	10	0	0
18	9735106	rs111466815	C	T	4	8	12	0	0	12	0	0
18	9736926	rs77417270	A	G	9	4	13	0	0	13	0	0
18	9739869	rs1031559	G	C	4	5	9	0	0	9	0	0
18	9742169	rs80343435	C	T	10	1	11	0	0	11	0	0
18	9742224	rs112938859	C	T	7	3	10	0	0	10	0	0
18	9743973	rs11662192	C	T	2	4	6	0	0	6	0	0
18	9816122	rs78741579	T	G	2	10	12	0	0	12	0	0
18	9818237	rs9946261	G	A	2	7	9	0	0	9	0	0
18	9818265	rs73387412	A	G	2	11	13	0	0	13	0	0
18	9860122	rs74887344	G	T	132	101	233	0	1	234	0	0
18	9918025	rs494015	C	G	3	5	8	0	0	8	0	0
18	9922512	rs636407	T	C	13	21	34	0	0	34	0	0
18	9924309	rs29194	G	T	83	1	84	0	1	85	0	0
18	9924617	rs29193	G	A	13	14	27	0	0	27	0	0
18	9926902	rs683942	A	G	9	5	14	0	1	15	0	0
18	9927112	rs683018	A	C	81	214	295	0	1	296	0	0
18	9927208	.	A	T	89	250	339	0	2	341	0	0
18	9944749	rs29134	T	C	12	7	19	0	0	19	0	0
18	9946703	rs600624	A	C	3	6	9	0	0	9	0	0
18	9947960	rs29129	C	G	3	6	9	0	0	9	0	0
18	9949113	rs29071	A	G	9	12	21	0	0	21	0	0
18	9950144	rs29114	C	T	17	17	34	0	0	34	0	0
18	9952527	rs9973082	T	C	6	1	7	0	1	8	0	0
18	9953076	.	G	A	6	1	7	0	0	7	0	0
18	9955960	rs29069	A	G	81	73	154	0	3	157	0	0
18	9957573	rs29068	C	A	7	3	10	0	0	10	0	0
18	9957918	rs29067	T	G	4	4	8	0	0	8	0	0
18	9958522	rs3070	T	A	8	7	15	0	0	15	0	0
18	9959370	rs627262	G	A	27	37	64	0	2	66	0	0
18	9959493	rs3069	A	G	16	33	49	0	0	49	0	0
18	10539739	rs640832	A	G	9	5	14	0	1	15	0	0
18	10541969	rs16974782	T	G	8	3	11	0	0	11	0	0
18	10544799	rs16974816	A	G	8	6	14	0	0	14	0	0
18	10545263	rs501618	G	C	9	3	12	0	0	12	0	0
18	10545918	rs555446	C	G	12	4	16	0	0	16	0	0
18	10551602	rs15937	A	G	27	35	62	0	0	62	0	0
18	10681711	rs3748428	C	T	13	11	24	0	0	24	0	0
18	10699129	rs113682091	G	T	6	4	10	0	0	10	0	0
18	10704619	rs4796901	C	G	4	7	11	0	0	11	0	0
18	10705744	rs7227022	G	A	3	4	7	0	0	7	0	0
18	10748603	rs8096037	A	T	5	3	8	0	0	8	0	0
18	10753487	rs4797480	G	A	2	8	10	0	0	10	0	0
18	11883744	rs655764	G	A	1	8	9	0	0	9	0	0
18	11884833	rs2277730	G	C	3	3	6	0	0	6	0	0
18	11886563	rs662515	C	G	16	17	33	0	1	34	0	0
18	11908654	rs2289630	G	A	28	45	73	0	1	74	0	0
18	12321483	rs76860000	G	A	4	6	10	0	0	10	0	0
18	12449378	rs116860247	A	G	9	0	9	0	0	9	0	0
18	12626420	rs28582228	T	C	11	0	11	0	1	12	0	0
18	12626682	rs28414067	T	C	9	0	9	0	0	9	0	0
18	12785944	rs17656120	A	G	12	11	23	0	1	24	0	0
18	12786032	rs17656142	G	A	11	13	24	0	0	24	0	0
18	12786059	rs8092305	G	A	6	12	18	0	1	19	0	0
18	12786627	rs45626137	C	T	4	4	8	0	0	8	0	0
18	12787318	rs73402502	C	T	5	6	11	0	0	11	0	0
18	12789127	rs16939859	C	T	5	7	12	0	0	12	0	0
18	12789319	rs57528860	T	G	4	4	8	0	0	8	0	0
18	12819616	rs7227207	C	T	8	7	15	0	0	15	0	0
18	12819820	rs2847282	G	T	5	4	9	0	0	9	0	0
18	12820057	rs973767	A	G	3	6	9	0	0	9	0	0
18	12822702	rs10502416	G	T	8	1	9	0	0	9	0	0
18	12840879	rs17657106	T	C	34	24	58	0	0	58	0	0
18	12843993	rs77151712	G	A	5	2	7	0	0	7	0	0
18	12845245	rs74366084	G	A	6	1	7	0	0	7	0	0
18	12966560	rs8096596	T	A	4	2	6	0	0	6	0	0
18	12984345	rs67068160	T	C	4	10	14	0	0	14	0	0
18	12986440	rs3602	T	C	14	23	37	0	0	37	0	0
18	13001523	rs11080618	G	A	6	3	9	0	0	9	0	0
18	13056682	rs2282542	G	A	16	12	28	0	1	29	0	0
18	13068109	rs7228940	G	A	12	10	22	0	0	22	0	0
18	13095591	rs56913743	G	A	35	17	52	0	0	52	0	0
18	13229180	rs9916937	T	C	2	5	7	0	0	7	0	0
18	13498548	rs71353271	C	T	4	2	6	0	0	6	0	0
18	13499638	rs1648599	C	T	7	3	10	0	0	10	0	0
18	13499979	rs34962355	A	G	6	2	8	0	0	8	0	0
18	13612072	rs1284441	C	T	12	16	28	0	0	28	0	0
18	13613077	rs1296366	A	G	21	18	39	0	0	39	0	0
18	13663645	.	C	T	3	6	9	0	1	10	0	0
18	13726682	rs45561441	G	C	4	3	7	0	0	7	0	0
18	13734897	rs9646454	A	G	14	30	44	0	0	44	0	0
18	13734904	rs3819131	C	T	30	14	44	0	0	44	0	0
18	13744984	rs10502424	G	T	5	3	8	0	2	10	0	0
18	13745055	rs17694459	G	A	3	6	9	0	0	9	0	0
18	13749744	rs68098007	C	A	4	4	8	0	0	8	0	0
18	13750741	rs9964959	A	G	5	5	10	0	0	10	0	0
18	13754720	rs74387438	C	T	4	6	10	0	0	10	0	0
18	13757553	rs68006216	G	T	16	14	30	0	0	30	0	0
18	13758255	rs8085581	C	T	15	22	37	0	0	37	0	0
18	13759146	rs7234748	C	T	18	28	46	0	0	46	0	0
18	13761926	rs78482894	G	T	8	12	20	0	0	20	0	0
18	13763114	rs45596939	T	C	47	49	96	0	0	96	0	0
18	19281160	rs117773089	A	C	8	1	9	0	0	9	0	0
18	20716805	rs4800451	C	T	5	5	10	0	0	10	0	0
18	20839632	rs892430	G	A	2	11	13	0	0	13	0	0
18	20873586	rs4800464	A	G	3	3	6	0	1	7	0	0
18	20953720	rs8099409	G	A	7	1	8	0	0	8	0	0
18	21032796	rs6507666	C	A	3	4	7	0	0	7	0	0
18	21045557	rs9957219	G	A	5	2	7	0	0	7	0	0
18	21049202	rs11663360	A	C	3	5	8	0	0	8	0	0
18	21049872	rs8088717	A	G	4	4	8	0	0	8	0	0
18	21052053	rs34466616	C	T	4	6	10	0	0	10	0	0
18	21053204	rs7244132	A	T	13	9	22	0	0	22	0	0
18	21054318	rs1501412	A	G	16	10	26	0	0	26	0	0
18	21057450	rs7227951	A	G	7	6	13	0	1	14	0	0
18	21060556	rs3081705	T	C	1	5	6	0	0	6	0	0
18	21066216	rs73390241	G	A	4	2	6	0	0	6	0	0
18	21086386	rs3196567	G	A	4	2	6	0	0	6	0	0
18	21100240	rs1367083	C	T	95	83	178	0	0	178	0	0
18	21101011	rs2356683	G	A	1	5	6	0	0	6	0	0
18	21101456	rs6507708	C	A	3	10	13	0	0	13	0	0
18	21103909	rs891387	T	C	12	12	24	0	0	24	0	0
18	21103971	rs891386	T	G	6	16	22	0	0	22	0	0
18	21104888	rs1808579	C	T	2	4	6	0	0	6	0	0
18	21108613	rs58609749	T	C	5	6	11	0	0	11	0	0
18	21108614	rs57440424	G	A	5	6	11	0	0	11	0	0
18	21109466	rs1652376	G	T	10	11	21	0	0	21	0	0
18	21113285	rs2510344	T	C	6	4	10	0	0	10	0	0
18	21119777	rs1140458	G	A	7	13	20	0	0	20	0	0
18	21120444	rs1805082	T	C	6	6	12	0	0	12	0	0
18	21140432	rs1805081	T	C	6	18	24	0	0	24	0	0
18	21148863	rs12970899	A	G	8	16	24	0	0	24	0	0
18	21714791	rs11082962	C	A	9	3	12	0	0	12	0	0
18	21714934	rs34452859	C	T	16	7	23	0	0	23	0	0
18	21715084	rs12607257	A	C	12	15	27	0	0	27	0	0
18	21715162	rs1133162	C	T	17	10	27	0	0	27	0	0
18	23598160	rs607404	A	T	67	58	125	0	1	126	0	0
18	23854692	rs17224558	C	T	25	22	47	0	0	47	0	0
18	23866349	rs3744961	G	A	21	31	52	0	0	52	0	0
18	23873463	rs1677016	T	C	12	24	36	0	0	36	0	0
18	23970580	rs1542533	G	A	31	32	63	0	1	64	0	0
18	23970947	rs8820	G	T	15	17	32	0	1	33	0	0
18	29264005	.	G	C	34	22	56	0	0	56	0	0
18	29264182	rs1449081	G	A	42	28	70	0	0	70	0	0
18	29265933	rs8098893	A	T	12	10	22	0	0	22	0	0
18	29410479	rs12327141	T	A	23	27	50	0	0	50	0	0
18	29426714	.	T	C	24	28	52	0	0	52	0	0
18	29432624	rs3737374	T	C	15	15	30	0	0	30	0	0
18	29437668	.	G	A	12	8	20	0	0	20	0	0
18	29487567	rs34176695	C	A	12	14	26	0	0	26	0	0
18	29598809	rs17662563	T	C	8	11	19	0	0	19	0	0
18	29650152	rs661717	C	T	63	39	102	0	1	103	0	0
18	29652129	rs7227909	C	A	97	100	197	0	0	197	0	0
18	29652827	rs7230167	T	C	149	128	277	0	1	278	0	0
18	29652986	.	C	G	95	0	95	0	1	96	0	0
18	29698193	rs7229437	T	C	15	26	41	0	0	41	0	0
18	29702087	rs4239373	T	C	8	12	20	0	0	20	0	0
18	29702225	rs4239374	T	C	9	8	17	0	0	17	0	0
18	29702350	rs4799328	A	T	3	3	6	0	0	6	0	0
18	29702569	rs1814795	T	C	6	8	14	0	0	14	0	0
18	32718597	rs1271784	T	A	4	4	8	0	0	8	0	0
18	32718924	rs518111	G	A	5	3	8	0	0	8	0	0
18	32718970	rs518672	G	T	4	4	8	0	0	8	0	0
18	32719249	rs17737238	A	G	2	4	6	0	0	6	0	0
18	32720359	rs3786313	C	T	75	71	146	0	0	146	0	0
18	32721078	rs3810021	C	T	116	118	234	0	0	235	1	0
18	32721402	rs1050377	G	A	81	87	168	0	2	170	0	0
18	32822382	rs4799374	G	T	5	2	7	0	0	7	0	0
18	32830887	rs12454748	C	T	5	1	6	0	0	6	0	0
18	32832583	rs4799791	T	C	1	5	6	0	0	6	0	0
18	32861277	rs4799380	A	G	7	6	13	0	0	13	0	0
18	32861362	rs3810022	C	T	5	4	9	0	1	10	0	0
18	32862807	rs9949546	T	C	7	3	10	0	0	10	0	0
18	32863518	rs7238665	G	A	5	8	13	0	0	13	0	0
18	32863682	rs574427786	G	A	5	2	7	0	1	8	0	0
18	32883314	rs4497768	T	C	2	8	10	0	0	10	0	0
18	32887933	rs9963614	A	G	9	5	14	0	1	15	0	0
18	32913951	rs55689466	T	G	9	8	17	0	1	18	0	0
18	32916162	rs1064753	T	C	84	111	195	0	1	196	0	0
18	32917644	rs2032729	T	C	64	78	142	0	0	142	0	0
18	32918398	rs1362860	C	G	6	2	8	0	0	8	0	0
18	32918639	rs1362859	G	C	0	6	6	0	0	6	0	0
18	32923824	rs2072626	G	A	5	1	6	0	0	6	0	0
18	33048554	rs3088182	C	T	99	58	157	0	0	157	0	0
18	33291402	rs1050781	A	G	79	61	140	0	2	142	0	0
18	33694120	rs1050631	G	A	30	15	45	0	0	45	0	0
18	33705135	rs2236718	T	G	0	7	7	0	0	7	0	0
18	36915528	rs112450376	T	C	6	0	6	0	0	6	0	0
18	37331298	rs1513680	G	T	0	9	9	0	0	9	0	0
18	42532693	rs1064204	C	A	9	7	16	0	0	16	0	0
18	42533130	rs8096662	A	G	5	13	18	0	0	18	0	0
18	43316538	rs2298718	A	G	6	3	9	0	0	9	0	0
18	43429183	rs1788079	T	A	3	4	7	0	0	7	0	0
18	43430139	rs570975	G	A	10	8	18	0	0	18	0	0
18	43430190	rs492411	C	A	12	7	19	0	0	19	0	0
18	43430409	rs1790299	C	A	10	7	17	0	0	17	0	0
18	43431800	rs566899	C	T	36	31	67	0	0	67	0	0
18	43432292	rs507653	C	T	43	38	81	0	2	83	0	0
18	43432358	rs508915	A	C	33	36	69	0	0	69	0	0
18	43531186	rs117817123	C	T	3	3	6	0	0	6	0	0
18	43534043	rs58246199	T	C	6	6	12	0	0	12	0	0
18	43534824	rs59422275	T	C	4	4	8	0	0	8	0	0
18	43563677	rs67746112	T	C	153	187	340	0	0	340	0	0
18	43563978	rs6507658	G	C	170	59	229	0	2	231	0	0
18	43564050	rs8084943	G	T	144	94	238	0	0	238	0	0
18	43564074	rs8084952	G	A	132	111	243	0	4	247	0	0
18	43564296	rs7229227	G	A	128	179	307	0	0	307	0	0
18	43564506	rs7229264	A	G	93	131	224	0	2	226	0	0
18	43564927	rs1438388	G	C	129	140	269	0	2	271	0	0
18	43565171	rs75348747	T	C	107	94	201	0	3	204	0	0
18	43565195	rs1048827	G	T	121	89	210	0	2	212	0	0
18	43565380	rs57589400	A	G	123	102	225	0	0	225	0	0
18	43565399	rs58786055	C	A	130	111	241	0	0	241	0	0
18	43565514	rs60116181	G	A	5	3	8	0	0	8	0	0
18	43567199	rs7227161	T	C	3	3	6	0	0	6	0	0
18	43567622	rs11082504	A	T	2	5	7	0	0	7	0	0
18	43568168	rs4890611	T	C	2	4	6	0	0	6	0	0
18	43568200	rs4890309	T	C	3	3	6	0	0	6	0	0
18	43568717	rs2276199	T	C	121	117	238	0	0	238	0	0
18	43568904	rs2276197	C	G	5	2	7	0	0	7	0	0
18	43569066	rs2276196	C	G	4	3	7	0	0	7	0	0
18	43569240	rs4081459	T	C	10	5	15	0	0	15	0	0
18	43569401	rs4081460	G	A	3	3	6	0	0	6	0	0
18	43570401	.	T	C	7	2	9	0	0	9	0	0
18	43596825	rs10502871	C	T	9	9	18	0	0	18	0	0
18	43599355	rs6507662	T	C	1	5	6	0	1	7	0	0
18	43600271	rs8097830	T	C	5	3	8	0	0	8	0	0
18	43644002	rs12959752	C	G	5	5	10	0	1	11	0	0
18	43644445	.	A	T	5	6	11	0	1	12	0	0
18	43664883	.	T	C	3	7	10	0	0	10	0	0
18	43664972	rs61261514	T	C	5	2	7	0	0	7	0	0
18	43672940	rs112472135	C	T	12	3	15	0	0	15	0	0
18	43673272	rs72903432	G	A	12	14	26	0	1	27	0	0
18	43673959	rs1964984	C	G	7	6	13	0	0	13	0	0
18	43674646	rs2850646	C	A	12	7	19	0	0	19	0	0
18	43676720	rs2578183	A	G	2	4	6	0	0	6	0	0
18	43678035	rs3753069	T	C	4	5	9	0	0	9	0	0
18	43684330	rs41274318	G	C	2	4	6	0	0	6	0	0
18	43684561	rs72903449	C	A	0	10	10	0	0	10	0	0
18	43684657	rs3744992	C	A	0	9	9	0	0	9	0	0
18	43795895	.	G	A	89	97	186	0	0	186	0	0
18	43796356	rs140926806	G	A	104	124	228	0	4	232	0	0
18	43798077	.	G	A	27	23	50	0	0	50	0	0
18	43810037	rs117383640	G	A	11	5	16	0	0	16	0	0
18	43845177	rs72905367	A	C	70	65	135	0	1	136	0	0
18	44063598	rs1377016	G	A	2	6	8	0	0	8	0	0
18	44120193	rs2156282	G	C	2	6	8	0	0	8	0	0
18	44176303	rs328142	A	G	6	0	6	0	0	6	0	0
18	44401600	rs72907120	G	A	5	6	11	0	0	11	0	0
18	44402316	rs11875703	G	A	6	3	9	0	0	9	0	0
18	44402624	rs72907122	G	C	6	5	11	0	0	11	0	0
18	44434987	rs1893427	C	T	3	3	6	0	0	6	0	0
18	44634314	rs72905444	C	T	14	10	24	0	0	24	0	0
18	44634756	rs13547	A	G	18	25	43	0	0	43	0	0
18	44634904	rs72905446	C	T	19	15	34	0	1	35	0	0
18	44702718	rs2277717	C	A	25	11	36	0	0	36	0	0
18	45365336	rs112132589	G	A	4	2	6	0	0	6	0	0
18	46343666	rs3764481	C	T	27	26	53	0	1	54	0	0
18	47312993	rs542021	A	G	2	4	6	0	0	6	0	0
18	47315555	rs644986	G	C	4	4	8	0	0	9	1	0
18	47315616	rs644897	G	A	5	4	9	0	1	10	0	0
18	47315677	rs544669	A	T	8	2	10	0	0	10	0	0
18	47316993	rs628531	A	G	5	4	9	0	0	9	0	0
18	47319143	rs35793799	T	G	11	5	16	0	0	16	0	0
18	47805845	.	A	G	2	4	6	0	0	6	0	0
18	47908556	rs6507992	G	A	8	10	18	0	0	18	0	0
18	47918639	rs10460085	A	C	6	8	14	0	0	14	0	0
18	47919224	rs9952721	T	C	4	11	15	0	0	15	0	0
18	48407652	rs2665560	C	T	4	8	12	0	0	12	0	0
18	48473753	rs12277	G	A	92	110	202	0	0	202	0	0
18	48557417	rs72913244	T	C	5	2	7	0	0	7	0	0
18	48577782	rs7229678	G	C	17	16	33	0	0	33	0	0
18	48609968	rs12456284	A	G	18	13	31	0	0	31	0	0
18	48610831	rs3819122	A	C	14	10	24	0	0	24	0	0
18	48720526	rs11877810	T	C	23	21	44	0	0	44	0	0
18	48722080	rs62092913	A	G	11	10	21	0	0	21	0	0
18	48723439	rs4396619	C	T	11	10	21	0	0	21	0	0
18	51681244	rs7614	T	C	27	17	44	0	0	44	0	0
18	51880889	rs17292725	G	A	3	3	6	0	0	6	0	0
18	52530018	rs4801103	G	A	1	6	7	0	0	7	0	0
18	52558243	rs56247500	T	G	1	5	6	0	0	6	0	0
18	52895531	rs8766	T	C	15	4	19	0	0	19	0	0
18	54265130	rs12968679	A	G	0	6	6	0	0	6	0	0
18	54694713	rs1787474	T	C	3	6	9	0	0	9	0	0
18	54696383	rs1657397	T	C	3	5	8	0	0	8	0	0
18	54696407	rs1657396	T	C	3	5	8	0	0	8	0	0
18	55268486	rs11356	A	C	29	28	57	0	0	57	0	0
18	55269777	rs2276193	G	A	16	18	34	0	0	34	0	0
18	55270446	rs317831	A	C	1	6	7	0	0	7	0	0
18	55271550	rs11663333	C	T	5	3	8	0	0	8	0	0
18	55271884	rs11660269	A	G	4	4	8	0	0	8	0	0
18	55272366	.	A	T	4	2	6	0	0	6	0	0
18	55272368	.	T	A	4	2	6	0	0	6	0	0
18	55274159	rs2298646	T	G	3	4	7	0	0	7	0	0
18	55297708	rs540680	C	G	15	15	30	0	1	31	0	0
18	55298886	rs411805	C	T	11	5	16	0	0	16	0	0
18	55309018	rs385648	C	T	13	3	16	0	0	16	0	0
18	55405153	rs72948039	G	C	8	8	16	0	0	16	0	0
18	56405131	rs75796509	A	G	7	1	8	0	0	8	0	0
18	56415619	rs7236423	T	G	4	5	9	0	0	9	0	0
18	56416054	rs58169841	T	C	12	7	19	0	0	19	0	0
18	56416693	rs1059442	T	C	11	17	28	0	1	29	0	0
18	56417821	rs6567007	G	A	1	6	7	0	0	7	0	0
18	56420024	rs62093498	G	A	4	4	8	0	0	8	0	0
18	56995396	rs4806	A	G	143	142	285	0	3	288	0	0
18	56995920	rs34753206	G	T	166	146	312	0	3	315	0	0
18	56995938	rs34679996	T	C	157	136	293	0	5	298	0	0
18	56996108	rs7236294	C	T	31	21	52	0	0	52	0	0
18	56996262	rs7239187	G	C	64	63	127	0	2	129	0	0
18	56996526	rs1043334	T	G	99	108	207	0	5	212	0	0
18	56998901	rs12959578	C	T	2	4	6	0	1	7	0	0
18	57018922	rs12963340	G	A	4	4	8	0	0	8	0	0
18	57022754	rs1127220	T	C	51	58	109	0	1	110	0	0
18	57026361	rs33926449	A	G	41	40	81	0	0	81	0	0
18	57567638	rs11663656	G	C	25	45	70	0	1	71	0	0
18	57567699	rs78800940	G	A	59	30	89	0	2	91	0	0
18	59716755	.	T	C	7	1	8	0	0	8	0	0
18	59718126	.	A	G	6	0	6	0	0	6	0	0
18	59719028	rs62096636	A	G	7	1	8	0	0	8	0	0
18	59727386	rs879656	T	A	4	3	7	0	0	7	0	0
18	59814268	rs9320000	G	A	9	3	12	0	0	12	0	0
18	59814324	rs9320001	G	C	8	4	12	0	1	13	0	0
18	59972043	rs2939416	C	T	5	2	7	0	0	7	0	0
18	59973657	rs1045950	C	T	5	4	9	0	0	9	0	0
18	60193405	rs72941624	G	T	8	7	15	0	1	16	0	0
18	60193406	rs72941625	A	T	9	7	16	0	0	16	0	0
18	60193628	rs7227643	T	C	9	6	15	0	2	17	0	0
18	60224101	rs2048794	T	C	19	6	25	0	0	25	0	0
18	60224279	rs2048793	T	A	12	4	16	0	0	16	0	0
18	60226309	rs66726270	A	T	11	11	22	0	0	22	0	0
18	60226545	rs8084879	G	A	17	17	34	0	0	34	0	0
18	60231851	rs12956093	A	G	43	50	93	0	0	93	0	0
18	60233646	rs11152349	G	A	6	3	9	0	0	9	0	0
18	60237388	rs8096750	A	G	49	43	92	0	1	93	0	0
18	60241732	rs3744926	C	T	66	45	111	0	1	112	0	0
18	60243876	rs11557713	G	A	51	49	100	0	1	101	0	0
18	60385082	rs34480656	G	A	4	5	9	0	0	10	1	0
18	60562298	rs624821	A	T	84	92	176	0	0	177	1	0
18	60580371	rs607153	G	A	5	2	7	0	1	8	0	0
18	60612685	rs523478	A	C	4	2	6	0	0	6	0	0
18	60631271	rs567635	A	G	2	26	28	0	1	29	0	0
18	60631277	rs568073	A	G	2	22	24	0	1	25	0	0
18	60794654	rs1564483	C	T	6	6	12	0	0	12	0	0
18	60980871	rs1462129	T	C	4	3	7	0	0	7	0	0
18	60981043	rs2051424	G	T	5	1	6	0	0	6	0	0
18	60981256	rs2051423	T	C	6	3	9	0	0	9	0	0
18	60984964	rs1893806	C	A	25	20	45	0	2	47	0	0
18	60985879	rs1801018	T	C	117	126	243	0	4	247	0	0
18	60986837	rs2279115	G	T	159	157	316	0	0	316	0	0
18	60996360	rs10460159	T	C	10	13	23	0	0	23	0	0
18	60997778	rs11663788	T	C	7	5	12	0	0	12	0	0
18	60998401	rs6810	A	G	56	63	119	0	1	120	0	0
18	61058722	rs6567339	G	A	5	3	8	0	0	8	0	0
18	61059354	rs8095337	G	A	30	5	35	0	0	35	0	0
18	61060873	rs898890	G	A	4	3	7	0	0	7	0	0
18	61061325	rs1810099	G	A	6	6	12	0	0	12	0	0
18	61063107	rs6567340	T	C	8	9	17	0	0	17	0	0
18	61063139	rs6567341	T	C	5	5	10	0	0	10	0	0
18	61066463	rs2276317	A	G	3	5	8	0	0	8	0	0
18	61585302	rs150764677	C	T	57	60	117	0	0	117	0	0
18	61655200	rs9961532	G	A	31	26	57	0	0	57	0	0
18	67685479	rs150254008	T	A	1	5	6	0	0	6	0	0
18	67687860	rs2304378	T	C	10	5	15	0	0	15	0	0
18	67992432	rs2231563	C	T	61	64	125	0	2	127	0	0
18	67997284	rs4541169	A	G	9	20	29	0	0	29	0	0
18	71815965	rs3737510	C	A	9	16	25	0	0	25	0	0
18	71815969	rs3737511	C	G	9	13	22	0	0	22	0	0
18	71816278	rs3737512	G	A	18	9	27	0	0	27	0	0
18	71824884	rs3794949	T	G	5	1	6	0	0	6	0	0
18	72057442	rs62622364	G	T	8	0	8	0	2	10	0	0
18	72178410	rs8088885	C	T	7	3	10	0	0	10	0	0
18	72184237	rs1035760	A	G	5	4	9	0	0	9	0	0
18	72185356	rs9966475	T	C	1	9	10	0	0	10	0	0
18	72185358	rs112316318	T	C	9	1	10	0	0	10	0	0
18	72186404	rs2241508	G	A	4	5	9	0	0	9	0	0
18	72188347	rs7577	T	C	5	9	14	0	0	14	0	0
18	72913920	rs61910717	C	T	89	69	158	0	0	158	0	0
18	74091718	rs17059302	G	A	10	0	10	0	0	10	0	0
18	74091834	.	T	C	10	0	10	0	0	10	0	0
18	74155000	rs3752097	T	C	1	7	8	0	0	8	0	0
18	74610617	rs143540183	C	T	5	9	14	0	0	14	0	0
18	74631933	.	C	T	11	7	18	0	1	19	0	0
18	74680208	rs73968242	C	T	8	13	21	0	0	21	0	0
18	74681192	rs470683	G	A	13	15	28	0	1	29	0	0
18	74725166	rs2282557	C	T	25	13	38	0	0	38	0	0
18	74725854	rs3752069	C	T	17	6	23	0	1	24	0	0
18	74727503	rs7236968	T	A	59	26	85	0	2	87	0	0
18	74727618	rs7232502	C	T	58	24	82	0	0	82	0	0
18	74766804	rs34568117	C	G	3	3	6	0	0	6	0	0
18	74823113	rs68178245	A	C	16	5	21	0	0	21	0	0
18	74826732	rs57586352	A	G	2	6	8	0	0	8	0	0
18	74830827	rs12955050	C	A	3	3	6	0	0	6	0	0
18	74831143	rs34435038	G	C	6	1	7	0	0	7	0	0
18	74835887	rs58506330	T	C	3	3	6	0	0	6	0	0
18	74841548	rs116549372	C	T	5	4	9	0	0	9	0	0
18	74843381	rs77601179	C	T	4	3	7	0	0	7	0	0
18	74843560	rs140879376	G	A	18	13	31	0	0	31	0	0
18	74844467	rs62104563	G	C	5	9	14	0	0	14	0	0
18	74844576	rs138577195	G	A	21	30	51	0	1	52	0	0
18	74844599	rs62104564	G	C	34	20	54	0	0	54	0	0
18	74845353	rs9966986	A	G	5	9	14	0	0	14	0	0
18	76829525	rs4078115	A	G	14	12	26	0	0	26	0	0
18	76872238	rs28432958	G	A	9	5	14	0	0	14	0	0
18	76875151	rs201736365	G	A	10	0	10	0	0	10	0	0
18	76875153	rs199930549	A	G	10	0	10	0	0	10	0	0
18	76875452	rs11081518	T	C	14	13	27	0	0	27	0	0
18	76877107	rs8097017	T	G	13	7	20	0	0	20	0	0
18	76877173	rs1787273	G	T	22	11	33	0	0	33	0	0
18	77172078	rs304932	A	G	5	3	8	0	0	8	0	0
18	77172084	rs552845459	G	A	3	7	10	0	0	10	0	0
18	77211764	rs15350	T	C	8	23	31	0	0	31	0	0
18	77227476	rs25656	A	G	10	16	26	0	0	26	0	0
18	77229438	rs3786198	C	A	4	4	8	0	0	8	0	0
18	77267687	rs1660142	A	G	7	3	10	0	0	10	0	0
18	77267690	rs1660141	C	G	6	3	9	0	1	10	0	0
18	77437805	rs553352	A	G	3	8	11	0	1	12	0	0
18	77437845	rs552569	T	C	2	6	8	0	0	8	0	0
18	77465300	rs681631	G	A	3	4	7	0	0	7	0	0
18	77467191	rs503615	G	A	12	8	20	0	0	20	0	0
18	77467391	rs620112	T	G	5	7	12	0	1	13	0	0
18	77467811	rs530806	C	A	12	5	17	0	0	17	0	0
18	77468948	rs485400	G	A	10	14	24	0	0	24	0	0
18	77469403	rs649763	A	G	5	7	12	0	0	12	0	0
18	77472471	rs586455	A	G	1	5	6	0	0	6	0	0
18	77473086	rs599554	G	A	27	39	66	0	1	67	0	0
18	77474921	rs2126082	G	A	19	14	33	0	1	34	0	0
18	77478364	rs1626962	T	G	8	8	16	0	1	17	0	0
18	77478577	rs3786238	T	C	6	8	14	0	0	14	0	0
18	77491380	rs655503	A	G	4	2	6	0	0	6	0	0
18	77493028	rs58558457	G	A	5	6	11	0	0	11	0	0
18	77493053	rs59331110	G	A	6	5	11	0	0	11	0	0
18	77493435	rs3786240	T	C	3	5	8	0	0	8	0	0
18	77494328	rs3786241	A	C	3	3	6	0	0	6	0	0
18	77663409	rs13838	C	G	247	208	455	0	3	458	0	0
18	77663896	rs13745	A	G	85	83	168	0	1	169	0	0
18	77663940	rs3744881	G	A	111	100	211	0	1	212	0	0
18	77664481	rs3744880	A	G	7	3	10	0	0	10	0	0
18	77694168	rs2277725	T	G	2	4	6	0	1	7	0	0
18	77694294	rs2277724	C	A	8	7	15	0	0	15	0	0
18	77694439	rs59300126	C	A	4	7	11	0	0	11	0	0
18	77695384	rs7230837	T	A	21	19	40	0	0	40	0	0
18	77724726	rs8095764	A	C	6	6	12	0	0	12	0	0
18	77726944	rs9962647	G	C	8	7	15	0	0	15	0	0
18	77727126	rs4799112	T	C	7	4	11	0	0	11	0	0
18	77728045	rs2298644	C	T	21	22	43	0	0	43	0	0
18	77728135	rs2298645	G	T	54	44	98	0	1	99	0	0
18	77728594	rs34937055	A	G	7	2	9	0	0	9	0	0
18	77730197	rs4799113	A	G	1	6	7	0	0	7	0	0
18	77736735	rs4799116	T	C	8	10	18	0	0	18	0	0
18	77745640	rs10438902	A	G	4	6	10	0	0	10	0	0
18	77746623	rs8086024	T	C	34	53	87	0	0	87	0	0
18	77805949	rs3744873	A	C	63	75	138	0	1	139	0	0
18	77876658	rs4798941	G	A	5	3	8	0	0	8	0	0
18	77876701	rs4799134	C	T	6	1	7	0	0	7	0	0
18	77889826	rs7239975	G	C	2	5	7	0	0	7	0	0
18	77894431	.	G	A	117	126	243	0	5	248	0	0
18	77894844	rs3744877	G	A	143	132	275	0	0	275	0	0
18	77897478	rs3809927	C	G	93	91	184	0	1	185	0	0
19	63290	.	C	T	5	5	10	0	0	10	0	0
19	199750	.	C	G	13	0	13	0	1	14	0	0
19	305903	rs115921397	A	C	31	52	83	0	2	85	0	0
19	306304	rs10421358	C	T	4	12	16	0	0	16	0	0
19	308317	rs115623921	C	T	4	6	10	0	0	10	0	0
19	309445	rs72984405	G	A	3	4	7	0	0	7	0	0
19	310404	rs72984420	A	G	1	22	23	0	0	23	0	0
19	342617	rs2166359	C	T	3	3	6	0	0	6	0	0
19	344053	rs4897853	T	C	5	2	7	0	0	7	0	0
19	536426	rs17841750	C	T	3	3	6	0	0	6	0	0
19	536510	rs1108115	A	G	3	3	6	0	1	7	0	0
19	536545	rs17841754	G	A	4	2	6	0	0	6	0	0
19	536681	rs1108113	T	C	5	1	6	0	0	6	0	0
19	537645	rs2011210	G	C	10	5	15	0	1	16	0	0
19	539279	rs2288956	C	T	6	7	13	0	0	13	0	0
19	539593	rs10853978	C	T	11	6	17	0	0	17	0	0
19	539871	rs17672563	C	T	10	13	23	0	0	23	0	0
19	541095	rs16990625	C	T	15	20	35	0	0	35	0	0
19	547871	rs75799132	G	A	6	1	7	0	0	7	0	0
19	549041	rs150398893	C	T	18	12	30	0	1	31	0	0
19	549595	rs1599883	T	C	6	2	8	0	0	8	0	0
19	573205	rs2072308	T	C	8	5	13	0	1	14	0	0
19	574545	rs151237303	C	T	11	2	13	0	0	13	0	0
19	574547	rs140499328	C	T	11	2	13	0	0	13	0	0
19	574573	rs111791696	T	A	13	3	16	0	0	16	0	0
19	574927	rs12609912	C	T	15	4	19	0	0	19	0	0
19	575083	rs12609053	G	C	9	4	13	0	0	13	0	0
19	575159	rs12609063	G	A	6	4	10	0	0	10	0	0
19	575805	rs2238540	G	T	8	1	9	0	0	9	0	0
19	575964	rs2238542	C	T	9	1	10	0	1	11	0	0
19	576675	rs2238543	T	C	5	2	7	0	0	7	0	0
19	576716	rs2238544	A	G	7	2	9	0	0	9	0	0
19	576932	rs2238545	T	C	12	6	18	0	1	19	0	0
19	577321	rs12611131	C	T	17	16	33	0	1	34	0	0
19	577426	rs7252138	T	G	21	13	34	0	0	34	0	0
19	577436	rs7245585	G	C	17	9	26	0	0	26	0	0
19	577760	rs2283569	T	C	8	4	12	0	0	12	0	0
19	578208	rs2283570	C	T	10	8	18	0	0	18	0	0
19	578794	rs1138151	A	G	2	4	6	0	0	6	0	0
19	579010	rs7253615	G	A	7	6	13	0	0	13	0	0
19	579100	rs2283573	C	T	6	6	12	0	0	12	0	0
19	579157	rs28921990	T	C	8	9	17	0	0	17	0	0
19	579450	rs2283574	G	A	16	6	22	0	0	22	0	0
19	579627	rs1803202	C	T	994	720	1714	0	9	1723	0	0
19	579699	rs12608994	C	T	5	9	14	0	1	15	0	0
19	579713	rs12609013	C	T	6	7	13	0	0	13	0	0
19	580012	rs28992471	C	A	6	8	14	0	0	14	0	0
19	580154	rs2041192	A	G	5	2	7	0	1	8	0	0
19	580388	rs2229664	C	G	1038	777	1815	0	9	1824	0	0
19	580575	rs28992474	C	T	12	8	20	0	0	20	0	0
19	582468	rs2074962	A	G	10	3	13	0	0	13	0	0
19	582775	rs8637	A	G	1118	854	1972	0	10	1983	1	0
19	582927	rs8259	T	A	902	749	1651	0	26	1678	1	0
19	583418	rs6757	T	C	713	558	1271	0	3	1274	0	0
19	583460	rs6758	G	A	263	179	442	0	2	444	0	0
19	629639	rs61743197	G	A	20	23	43	0	2	45	0	0
19	652628	rs117231919	C	T	16	25	41	0	0	41	0	0
19	682010	rs13730	G	T	13	22	35	0	0	35	0	0
19	682211	rs62134284	G	A	35	12	47	0	0	47	0	0
19	687078	rs72618587	G	A	1792	1918	3710	0	17	3727	0	0
19	687112	rs72618588	G	A	1871	1826	3697	0	59	3756	0	0
19	687773	rs7359915	A	G	13	39	52	0	1	53	0	0
19	687799	rs7359916	A	C	15	48	63	0	0	63	0	0
19	687835	rs7359958	T	C	12	42	54	0	0	54	0	0
19	688355	rs61602138	G	T	6	22	28	0	1	29	0	0
19	688379	rs12985435	T	C	7	15	22	0	3	25	0	0
19	689004	rs12609586	G	T	6	13	19	0	0	19	0	0
19	689164	rs552320684	G	C	29	4	33	0	0	33	0	0
19	689165	rs570835225	G	A	28	4	32	0	1	33	0	0
19	689440	rs66667242	G	A	14	37	51	0	0	51	0	0
19	689476	rs66502878	C	T	11	37	48	0	0	48	0	0
19	689487	rs67158626	C	T	11	34	45	0	0	45	0	0
19	689590	rs9304936	C	G	41	9	50	0	0	50	0	0
19	689836	rs10408751	T	G	11	3	14	0	0	15	1	0
19	689977	rs10418290	C	T	5	2	7	0	1	8	0	0
19	690039	rs11085170	T	C	5	7	12	0	0	12	0	0
19	690040	rs75328503	G	A	5	7	12	0	0	12	0	0
19	690045	rs11085171	T	G	5	8	13	0	0	13	0	0
19	690167	rs8104993	C	T	4	5	9	0	0	9	0	0
19	690369	rs8100278	T	C	15	6	21	0	0	21	0	0
19	690383	rs8105261	C	T	19	6	25	0	0	25	0	0
19	690761	rs10422514	A	T	9	23	32	0	0	32	0	0
19	690762	rs10402839	T	G	9	23	32	0	0	32	0	0
19	690814	rs10412461	C	T	8	14	22	0	1	23	0	0
19	690902	rs8100936	T	C	17	4	21	0	0	21	0	0
19	691025	rs8108922	C	T	19	3	22	0	0	22	0	0
19	691833	rs66871177	C	T	2	4	6	0	0	6	0	0
19	695455	rs56412202	C	G	280	236	516	0	1	517	0	0
19	731144	rs1050457	A	G	26	38	64	0	0	64	0	0
19	746712	rs10421265	C	T	22	15	37	0	1	38	0	0
19	747245	rs113424036	C	T	22	32	54	0	3	57	0	0
19	799342	rs8100561	G	C	8	7	15	0	0	15	0	0
19	799392	rs62131332	C	T	5	6	11	0	1	12	0	0
19	799770	rs11085226	A	G	6	7	13	0	0	13	0	0
19	801656	rs72982139	T	G	3	7	10	0	0	10	0	0
19	802244	rs4986234	G	T	7	11	18	0	0	18	0	0
19	803220	rs351984	T	C	6	8	14	0	0	14	0	0
19	803945	rs10420407	G	A	9	4	13	0	0	13	0	0
19	804327	rs10420953	C	T	246	295	541	0	5	546	0	0
19	804612	rs4986235	C	T	182	200	382	0	1	383	0	0
19	804959	rs10422347	C	T	4	12	16	0	0	16	0	0
19	806256	rs351978	A	G	6	1	7	0	0	7	0	0
19	806634	rs351977	G	T	17	18	35	0	1	36	0	0
19	806673	rs351976	T	C	17	20	37	0	0	37	0	0
19	807127	rs72982146	T	G	31	17	48	0	0	48	0	0
19	807442	rs123698	G	C	23	27	50	0	1	51	0	0
19	810445	rs10426392	C	T	4	4	8	0	0	8	0	0
19	813220	rs351994	T	C	4	4	8	0	0	8	0	0
19	813350	.	C	G	10	11	21	0	0	21	0	0
19	827975	rs649411	T	C	9	14	23	0	0	23	0	0
19	829408	rs687077	A	G	27	42	69	0	2	71	0	0
19	829568	rs12460890	C	T	1407	2392	3799	0	86	3890	5	0
19	829723	rs678976	A	G	10	38	48	0	1	49	0	0
19	829824	rs6510980	C	T	12	36	48	0	2	50	0	0
19	830121	rs10427153	A	G	7	18	25	0	0	25	0	0
19	830538	rs12981802	G	A	17	68	85	0	1	86	0	0
19	830621	rs653847	A	C	20	63	83	0	2	85	0	0
19	830854	rs595844	T	C	1303	2052	3355	0	24	3379	0	0
19	845535	rs6510982	C	G	3	32	35	0	0	35	0	0
19	855162	rs7250194	T	A	5	14	19	0	0	19	0	0
19	868115	rs13090	C	T	42	30	72	0	3	75	0	0
19	868620	rs1651891	G	A	5	5	10	0	0	10	0	0
19	871135	rs1683569	A	G	20	12	32	0	0	32	0	0
19	871222	rs8100258	G	A	24	28	52	0	0	52	0	0
19	871987	rs78047294	G	A	45	35	80	0	0	80	0	0
19	872089	rs72984031	A	G	38	34	72	0	0	72	0	0
19	875389	rs11546307	G	A	26	34	60	0	0	60	0	0
19	875733	.	C	T	5	1	6	0	0	6	0	0
19	890165	rs6678	G	A	25	11	36	0	0	36	0	0
19	893183	rs56283881	C	T	2	4	6	0	0	6	0	0
19	897215	rs2930883	C	T	394	352	746	0	16	762	0	0
19	897571	rs3746149	G	C	27	26	53	0	1	54	0	0
19	898288	rs12985393	C	T	12	6	18	0	0	18	0	0
19	898392	rs12976746	G	A	16	5	21	0	0	21	0	0
19	898657	rs2062422	G	A	7	4	11	0	0	11	0	0
19	899123	rs11881841	T	A	18	21	39	0	0	39	0	0
19	899567	rs2930885	C	G	3	4	7	0	0	7	0	0
19	899978	rs2306718	G	A	8	8	16	0	0	16	0	0
19	901955	rs4343405	C	T	3	4	7	0	0	7	0	0
19	902247	rs1471815	C	T	72	71	143	0	2	145	0	0
19	902874	rs2365701	A	G	5	3	8	0	0	8	0	0
19	1009883	rs1058603	A	G	152	121	273	0	9	283	1	0
19	1010691	rs2240159	A	G	46	40	86	0	8	94	0	0
19	1011264	rs7246234	C	A	5	11	16	0	0	17	1	0
19	1011846	rs10420656	T	C	9	5	14	0	0	14	0	0
19	1011856	rs113138803	C	A	6	9	15	0	0	15	0	0
19	1012379	rs2240162	C	G	101	84	185	0	3	188	0	0
19	1012381	rs2240163	T	C	97	87	184	0	1	185	0	0
19	1015909	rs3815172	A	G	3	5	8	0	0	8	0	0
19	1020287	rs10414196	A	C	2	5	7	0	0	7	0	0
19	1021627	rs117481827	T	C	25	14	39	0	0	39	0	0
19	1028149	rs75364577	G	A	4	7	11	0	0	11	0	0
19	1030320	rs67476743	G	T	7	3	10	0	0	10	0	0
19	1032689	rs1141534	G	T	767	929	1696	0	11	1707	0	0
19	1035450	rs35190713	C	T	35	26	61	0	0	61	0	0
19	1036314	rs112340731	A	G	6	5	11	0	0	11	0	0
19	1036456	rs1064410	C	G	904	1013	1917	0	17	1934	0	0
19	1036468	rs1064411	A	G	903	972	1875	0	13	1888	0	0
19	1036552	rs2304262	T	C	765	839	1604	0	6	1610	0	0
19	1036575	rs2304260	G	A	18	7	25	0	1	26	0	0
19	1036631	rs11672916	T	C	20	7	27	0	0	27	0	0
19	1036691	rs11670349	C	T	18	5	23	0	1	24	0	0
19	1036704	rs11670373	C	T	18	4	22	0	0	22	0	0
19	1036718	rs11667191	G	A	15	4	19	0	1	20	0	0
19	1036793	rs11672975	T	A	6	2	8	0	0	8	0	0
19	1036913	rs11670441	C	T	227	116	343	0	2	345	0	0
19	1037108	rs5014188	T	C	16	7	23	0	0	23	0	0
19	1037170	rs11665845	T	A	16	6	22	0	1	23	0	0
19	1037551	rs113353568	G	A	14	8	22	0	1	23	0	0
19	1037563	rs111525696	A	G	14	10	24	0	0	24	0	0
19	1037584	rs72973561	C	T	13	11	24	0	1	25	0	0
19	1037932	rs3848639	G	C	609	728	1337	0	21	1359	1	0
19	1038222	rs2020000	C	G	710	849	1559	0	7	1566	0	0
19	1038445	rs10419707	C	T	955	1173	2128	0	13	2141	0	0
19	1038862	rs1141561	C	G	1025	1127	2152	0	7	2159	0	0
19	1038871	rs1135643	C	G	1041	1146	2187	0	5	2192	0	0
19	1038893	rs1057895	C	T	1048	1164	2212	0	6	2218	0	0
19	1038995	rs1057914	A	C	604	774	1378	0	3	1382	1	0
19	1046520	rs3764650	T	G	5	1	6	0	0	6	0	0
19	1049269	rs4147914	G	A	24	17	41	0	2	43	0	0
19	1092504	rs12462743	C	T	3	4	7	0	0	7	0	0
19	1092530	rs10426326	T	C	6	3	9	0	0	9	0	0
19	1095336	rs1046041	C	T	69	123	192	0	1	193	0	0
19	1095352	rs17554924	C	G	41	21	62	0	1	63	0	0
19	1095355	rs17554917	C	T	37	21	58	0	0	58	0	0
19	1104078	rs4807542	G	A	99	138	237	0	4	241	0	0
19	1104874	rs117193629	C	T	7	16	23	0	0	23	0	0
19	1105672	.	G	A	1165	1205	2370	0	24	2394	0	0
19	1127615	rs2074915	G	C	50	61	111	0	0	111	0	0
19	1127720	rs2074916	G	A	44	51	95	0	0	95	0	0
19	1219129	rs35113943	G	A	2	4	6	0	0	6	0	0
19	1219274	rs34928889	G	A	2	4	6	0	0	6	0	0
19	1219553	rs11084889	G	T	16	10	26	0	1	27	0	0
19	1220004	rs35369365	A	G	14	10	24	0	0	24	0	0
19	1224286	rs35004890	G	T	5	4	9	0	0	9	0	0
19	1224518	rs34072429	C	T	7	1	8	0	0	8	0	0
19	1225054	rs7253853	T	G	2	4	6	0	0	6	0	0
19	1225547	rs59436472	C	T	4	2	6	0	0	6	0	0
19	1228191	rs10415095	T	C	9	18	27	0	0	27	0	0
19	1250109	rs3746106	C	A	127	121	248	0	1	250	1	0
19	1251781	rs2285811	A	G	6	13	19	0	1	20	0	0
19	1252311	rs10416809	C	T	3	6	9	0	1	10	0	0
19	1252451	rs10423391	T	C	8	6	14	0	0	14	0	0
19	1254122	rs2301761	G	A	3	5	8	0	0	8	0	0
19	1255253	rs10412640	C	T	8	3	11	0	0	11	0	0
19	1256205	rs112211582	G	T	11	12	23	0	0	23	0	0
19	1256368	rs113350795	G	A	9	8	17	0	0	17	0	0
19	1256998	rs9823	C	T	276	249	525	0	8	533	0	0
19	1258287	rs58612681	C	T	628	608	1236	0	5	1241	0	0
19	1274107	.	C	T	5	9	14	0	1	15	0	0
19	1357082	rs713042	T	C	29	22	51	0	0	51	0	0
19	1360575	rs3826942	G	A	25	23	48	0	0	48	0	0
19	1370675	rs12608765	C	G	47	30	77	0	2	79	0	0
19	1376723	rs266805	G	A	47	34	81	0	0	81	0	0
19	1377158	rs11084893	C	T	13	16	29	0	0	29	0	0
19	1377173	rs4807907	A	G	17	14	31	0	0	31	0	0
19	1386889	rs34885619	C	T	4	2	6	0	0	6	0	0
19	1387299	rs502121	T	C	2	5	7	0	0	7	0	0
19	1388538	rs1142530	C	T	107	88	195	0	1	196	0	0
19	1433981	rs113241033	G	A	9	6	15	0	1	16	0	0
19	1435496	rs76800339	C	T	312	287	599	0	5	604	0	0
19	1806667	rs45574836	C	T	10	3	13	0	0	13	0	0
19	1811547	rs12609187	A	G	4	2	6	0	0	6	0	0
19	1821637	rs4807145	A	G	87	90	177	0	3	180	0	0
19	1823535	rs118047467	G	A	12	11	23	0	2	25	0	0
19	1853667	rs3746043	C	G	57	54	111	0	0	111	0	0
19	1854151	rs12972720	G	C	115	99	214	0	0	214	0	0
19	1856186	rs12974664	G	A	5	7	12	0	0	12	0	0
19	1876009	rs8607	T	C	22	15	37	0	0	37	0	0
19	1877727	rs2289287	G	T	5	4	9	0	0	9	0	0
19	1878507	rs10402026	C	T	36	29	65	0	2	67	0	0
19	1879720	rs548701716	G	A	2	16	18	0	1	19	0	0
19	1880372	rs11669774	G	C	14	14	28	0	0	28	0	0
19	1880523	rs12461295	G	A	17	16	33	0	0	33	0	0
19	1880548	rs72975668	G	A	12	10	22	0	0	22	0	0
19	1880557	rs10410369	T	C	11	7	18	0	0	18	0	0
19	1880586	rs4807159	A	C	5	5	10	0	0	10	0	0
19	1880950	rs4807160	T	C	6	7	13	0	0	13	0	0
19	1881919	rs893542	A	G	12	21	33	0	0	33	0	0
19	1881920	rs893543	G	A	13	21	34	0	0	34	0	0
19	1882762	rs3810416	G	A	26	21	47	0	0	47	0	0
19	1883433	rs1610107	C	T	23	26	49	0	2	51	0	0
19	1883654	rs1610108	G	A	20	22	42	0	0	42	0	0
19	1883951	rs12978348	T	C	33	33	66	0	0	66	0	0
19	1884552	rs7246402	G	A	28	27	55	0	0	55	0	0
19	2038819	rs2287002	G	A	419	375	794	0	3	797	0	0
19	2041032	rs2287003	T	C	12	23	35	0	1	36	0	0
19	2042886	rs7253052	A	G	7	7	14	0	0	14	0	0
19	2043271	rs2302585	G	A	4	5	9	0	0	9	0	0
19	2044175	rs1599860	A	C	13	6	19	0	0	19	0	0
19	2045291	rs7248631	G	C	8	3	11	0	0	11	0	0
19	2045300	rs7250047	A	G	6	4	10	0	0	10	0	0
19	2045805	rs8103466	G	A	12	4	16	0	0	16	0	0
19	2047688	rs11665732	A	C	3	3	6	0	1	7	0	0
19	2049314	rs880183	G	A	4	12	16	0	0	16	0	0
19	2099362	rs1051767	C	T	15	9	24	0	0	24	0	0
19	2165091	rs138459839	C	T	2	11	13	0	0	13	0	0
19	2191145	.	C	T	136	106	242	0	7	249	0	0
19	2202245	rs12985448	C	T	7	4	11	0	0	11	0	0
19	2207175	.	G	A	3	8	11	0	0	11	0	0
19	2229361	rs144208077	C	T	11	11	22	0	0	22	0	0
19	2270368	rs2523172	C	T	4	8	12	0	0	12	0	0
19	2272309	rs2523176	C	T	57	37	94	0	2	96	0	0
19	2292293	rs145366197	A	G	3	4	7	0	0	7	0	0
19	2292741	rs7252541	C	G	4	3	7	0	0	7	0	0
19	2294260	rs8113792	C	G	14	9	23	0	1	24	0	0
19	2295629	rs11879876	T	G	5	4	9	0	0	9	0	0
19	2325659	rs73916924	G	A	11	7	18	0	1	19	0	0
19	2327266	rs60425320	T	C	6	5	11	0	0	11	0	0
19	2337468	rs3752205	G	A	30	32	62	0	2	64	0	0
19	2341059	rs11880345	G	A	9	9	18	0	0	18	0	0
19	2341577	rs62119742	G	A	28	31	59	0	0	59	0	0
19	2426828	rs6945	G	C	366	456	822	0	9	833	2	0
19	2431272	rs4807263	T	G	1	5	6	0	0	6	0	0
19	2477277	rs2024144	C	T	24	19	43	0	1	44	0	0
19	2477316	rs3783501	G	A	21	22	43	0	1	44	0	0
19	2512606	rs7258864	G	A	34	10	44	0	0	44	0	0
19	2512795	rs7248417	T	C	30	20	50	0	1	51	0	0
19	2514360	rs917414	C	T	19	15	34	0	0	34	0	0
19	2514373	rs917415	A	C	21	13	34	0	1	35	0	0
19	2514565	rs3752174	C	T	55	72	127	0	0	127	0	0
19	2520716	rs1133692	T	C	118	85	203	0	0	203	0	0
19	2714666	rs14713	G	A	2	10	12	0	0	12	0	0
19	2714720	rs8737	A	G	4	12	16	0	0	16	0	0
19	2714771	rs2014626	T	C	4	12	16	0	0	16	0	0
19	2715287	rs12461076	T	C	5	12	17	0	0	17	0	0
19	2715556	rs28435794	G	C	2	15	17	0	0	17	0	0
19	2715741	rs62121111	G	C	8	8	16	0	0	16	0	0
19	2717256	rs3745812	C	G	6	6	12	0	0	12	0	0
19	2732741	rs9160	G	A	29	32	61	0	0	61	0	0
19	2735363	rs62121118	C	T	60	43	103	0	0	103	0	0
19	2735891	rs61386578	G	C	32	43	75	0	0	75	0	0
19	2754792	rs7009	G	A	112	162	274	0	6	280	0	0
19	2754810	rs13282	C	T	118	164	282	0	0	282	0	0
19	2754978	rs7008	T	C	296	365	661	0	15	676	0	0
19	2755339	rs2238614	G	A	285	333	618	0	3	622	1	0
19	2757049	rs7255969	T	C	3	4	7	0	0	7	0	0
19	2758122	rs10424287	A	G	6	9	15	0	0	15	0	0
19	2758171	rs10403752	T	C	6	15	21	0	0	21	0	0
19	2758808	rs116913805	G	A	8	6	14	0	0	14	0	0
19	2759107	rs9304899	A	G	10	15	25	0	0	25	0	0
19	2759513	rs12459369	C	T	5	7	12	0	0	12	0	0
19	2760059	rs57681989	G	T	5	4	9	0	0	9	0	0
19	2760878	rs1860938	A	C	7	8	15	0	0	15	0	0
19	2761334	rs3745813	C	A	6	1	7	0	0	7	0	0
19	2762585	rs2302491	A	C	170	177	347	0	3	350	0	0
19	2767192	rs1128925	G	T	212	191	403	0	6	409	0	0
19	2776982	rs7253128	C	T	5	3	8	0	0	8	0	0
19	2777484	rs4807329	G	A	2	4	6	0	0	6	0	0
19	2777662	rs4807330	G	A	5	5	10	0	0	10	0	0
19	2786726	rs2537854	A	C	5	1	6	0	0	6	0	0
19	2789337	rs1640267	T	C	2	4	6	0	0	6	0	0
19	2790394	rs1736176	G	A	14	5	19	0	0	19	0	0
19	2809672	rs1736183	A	G	7	5	12	0	0	12	0	0
19	2824377	rs1860570	C	T	6	0	6	0	0	6	0	0
19	2824413	rs1860571	G	A	8	0	8	0	0	8	0	0
19	2834808	rs8102063	T	C	7	9	16	0	0	16	0	0
19	2835419	rs2317036	G	A	3	3	6	0	0	6	0	0
19	2853566	rs10412087	A	G	40	35	75	0	0	75	0	0
19	2853650	rs45587443	G	A	42	41	83	0	0	83	0	0
19	2856375	rs6510708	T	G	8	1	9	0	0	9	0	0
19	2856491	rs10407088	C	T	5	2	7	0	0	7	0	0
19	2857239	rs4806880	C	T	10	4	14	0	0	14	0	0
19	2857287	rs4807347	A	C	9	3	12	0	0	12	0	0
19	2859707	rs6510709	A	G	5	4	9	0	0	9	0	0
19	2860091	rs10413272	A	G	14	1	15	0	0	15	0	0
19	2860166	rs10418996	T	G	12	4	16	0	0	16	0	0
19	2917178	rs61742111	G	A	13	8	21	0	0	21	0	0
19	2917186	rs2288959	T	C	12	8	20	0	0	20	0	0
19	2917509	rs61754927	G	A	11	8	19	0	0	19	0	0
19	2917522	rs61754924	G	A	11	6	17	0	1	18	0	0
19	2917798	rs61755868	A	G	3	11	14	0	1	15	0	0
19	2918343	rs113742858	C	T	8	10	18	0	1	19	0	0
19	2933480	rs3786948	C	T	10	9	19	0	0	19	0	0
19	2935743	rs60447818	G	A	4	2	6	0	1	7	0	0
19	3053802	rs425485	T	C	23	18	41	0	3	44	0	0
19	3054567	rs4807391	C	T	5	9	14	0	0	14	0	0
19	3056041	rs3930008	G	C	4	5	9	0	0	9	0	0
19	3057228	rs307716	A	C	5	4	9	0	0	9	0	0
19	3058021	rs307717	T	C	4	8	12	0	0	12	0	0
19	3061344	rs62125457	G	A	4	2	6	0	0	6	0	0
19	3061768	rs307719	A	G	6	3	9	0	0	9	0	0
19	3119239	rs4900	C	T	8	6	14	0	0	14	0	0
19	3121908	rs308040	C	G	5	3	8	0	0	8	0	0
19	3122655	rs16989608	A	G	9	13	22	0	0	22	0	0
19	3122941	rs2240564	T	C	8	14	22	0	0	22	0	0
19	3122945	rs2240565	C	G	17	8	25	0	0	25	0	0
19	3123113	rs415647	C	T	10	6	16	0	0	16	0	0
19	3123635	rs8092	C	T	9	21	30	0	0	30	0	0
19	3136962	rs399204	A	G	2	4	6	0	0	6	0	0
19	3138331	rs8112632	T	C	4	3	7	0	0	7	0	0
19	3138487	rs11880040	G	T	7	3	10	0	0	10	0	0
19	3141406	rs11881273	A	T	3	3	6	0	0	6	0	0
19	3141550	rs2283599	T	C	4	4	8	0	0	8	0	0
19	3141640	rs2283600	T	A	4	2	6	0	0	6	0	0
19	3150418	rs2302063	C	A	9	11	20	0	0	20	0	0
19	3151440	rs2074862	C	T	10	10	20	0	1	21	0	0
19	3151458	rs2074863	G	A	10	13	23	0	0	23	0	0
19	3152101	rs11882719	C	T	43	42	85	0	1	86	0	0
19	3152982	rs2238628	G	A	28	25	53	0	0	53	0	0
19	3153752	rs111174144	G	A	10	15	25	0	0	25	0	0
19	3155394	rs57457493	C	T	46	43	89	0	0	89	0	0
19	3155736	rs2074864	T	C	39	49	88	0	3	91	0	0
19	3155902	rs2074865	G	A	1770	2060	3830	0	39	3870	1	0
19	3158116	rs1682802	C	G	6	4	10	0	0	10	0	0
19	3159320	rs11880735	T	C	7	4	11	0	0	11	0	0
19	3160028	rs55788734	C	T	14	8	22	0	0	22	0	0
19	3160385	rs17347521	A	G	18	10	28	0	0	28	0	0
19	3160472	rs62125873	A	G	17	10	27	0	1	28	0	0
19	3160528	rs62125874	C	T	18	14	32	0	0	32	0	0
19	3160709	rs62125875	G	A	11	10	21	0	1	22	0	0
19	3160761	rs62125876	T	C	14	12	26	0	0	26	0	0
19	3162009	rs7257374	T	C	4	3	7	0	0	7	0	0
19	3162072	rs12610831	G	A	5	7	12	0	0	12	0	0
19	3162097	rs59257645	G	T	7	9	16	0	0	16	0	0
19	3162532	rs56340317	C	G	25	17	42	0	0	42	0	0
19	3176170	rs3760960	A	G	5	3	8	0	0	8	0	0
19	3176274	rs3760959	A	G	6	5	11	0	0	11	0	0
19	3176418	rs520548	G	A	2	5	7	0	0	7	0	0
19	3178599	rs311633	A	G	8	7	15	0	0	15	0	0
19	3186085	rs11551095	G	T	21	11	32	0	0	32	0	0
19	3193484	rs499877	A	G	10	12	22	0	1	23	0	0
19	3194193	rs568441	C	A	8	3	11	0	0	11	0	0
19	3194240	rs527451	G	C	9	3	12	0	0	12	0	0
19	3194243	rs527453	C	T	9	2	11	0	0	11	0	0
19	3194595	rs482740	T	A	22	17	39	0	0	39	0	0
19	3195135	rs56971413	T	G	12	9	21	0	0	21	0	0
19	3195243	rs311614	G	T	12	7	19	0	0	19	0	0
19	3196122	rs311615	T	C	13	7	20	0	0	20	0	0
19	3196999	rs186339	G	C	3	3	6	0	0	6	0	0
19	3199940	rs519266	T	C	7	4	11	0	0	11	0	0
19	3199945	rs519271	T	A	7	4	11	0	0	11	0	0
19	3200790	rs311622	A	G	5	2	7	0	0	7	0	0
19	3201323	rs311624	C	T	4	3	7	0	0	7	0	0
19	3202624	rs311626	C	T	8	10	18	0	0	18	0	0
19	3202710	rs311627	A	T	11	8	19	0	1	21	1	0
19	3208350	rs312070	A	G	134	101	235	0	1	236	0	0
19	3208418	rs312071	T	C	159	78	237	0	24	262	1	0
19	3208430	rs312072	T	C	124	78	202	0	21	223	0	0
19	3208827	rs312073	A	G	154	132	286	0	3	289	0	0
19	3208890	rs312074	T	C	148	158	306	0	1	307	0	0
19	3209483	rs4594	T	G	120	78	198	0	0	198	0	0
19	3462849	rs8047	C	T	27	34	61	0	0	61	0	0
19	3464048	rs74656266	G	A	17	10	27	0	1	28	0	0
19	3464320	rs3746298	G	C	6	16	22	0	1	23	0	0
19	3464321	rs3746299	G	C	7	16	23	0	0	23	0	0
19	3465118	rs713043	T	C	26	18	44	0	0	44	0	0
19	3468503	rs4807475	T	C	7	10	17	0	0	17	0	0
19	3478646	rs10413312	C	G	6	4	10	0	0	10	0	0
19	3523795	rs3746129	G	A	6	5	11	0	0	11	0	0
19	3524311	rs4807485	C	A	2	10	12	0	2	14	0	0
19	3527110	rs10420193	G	T	45	43	88	0	2	90	0	0
19	3534268	rs2369190	T	C	26	8	34	0	1	35	0	0
19	3534655	rs740685	G	A	3	10	13	0	0	13	0	0
19	3534696	rs740686	C	T	3	11	14	0	0	14	0	0
19	3535525	rs67967456	C	A	153	167	320	0	3	323	0	0
19	3535582	rs8109960	T	C	167	167	334	0	1	335	0	0
19	3535606	rs10415238	G	A	181	164	345	0	2	347	0	0
19	3536816	rs8100223	T	C	7	8	15	0	0	15	0	0
19	3537977	rs10406138	C	T	6	9	15	0	0	15	0	0
19	3538090	rs7248746	G	C	11	9	20	0	0	20	0	0
19	3538646	rs114420443	A	G	67	49	116	0	2	118	0	0
19	3538654	rs1128872	G	C	64	36	100	0	0	100	0	0
19	3539488	rs7253540	G	A	10	5	15	0	0	15	0	0
19	3540287	rs8105403	A	G	5	3	8	0	0	8	0	0
19	3544120	rs11667842	G	C	5	7	12	0	0	12	0	0
19	3545067	rs10424086	C	A	2	4	6	0	0	6	0	0
19	3545763	rs10426380	A	C	15	8	23	0	0	23	0	0
19	3545850	rs10424296	G	A	6	5	11	0	0	11	0	0
19	3546340	rs11555328	G	A	88	126	214	0	2	217	1	0
19	3548057	rs6510759	T	C	5	4	9	0	0	9	0	0
19	3554702	rs4807487	C	T	2	4	6	0	0	6	0	0
19	3554783	rs1715093	A	G	3	3	6	0	0	6	0	0
19	3557005	rs1715092	A	G	1	6	7	0	0	7	0	0
19	3575422	rs10420721	T	C	25	36	61	0	0	61	0	0
19	3578287	.	A	G	8	4	12	0	0	12	0	0
19	3578773	rs13269	C	T	432	527	959	0	10	969	0	0
19	3590334	rs17348907	A	G	13	4	17	0	0	17	0	0
19	3591590	rs2108389	T	C	4	10	14	0	0	14	0	0
19	3592730	rs10410258	C	T	10	15	25	0	2	27	0	0
19	3592731	rs10410259	C	T	10	17	27	0	0	27	0	0
19	3593004	rs17433775	A	G	10	6	16	0	1	17	0	0
19	3595006	rs34486470	A	G	7	3	10	0	0	10	0	0
19	3595032	rs5758	C	T	2	6	8	0	0	8	0	0
19	3595522	rs13306046	G	A	6	3	9	0	3	12	0	0
19	3611146	rs2074786	A	G	30	58	88	0	0	88	0	0
19	3611186	rs758016	C	T	32	58	90	0	0	90	0	0
19	3611190	rs758017	C	A	27	56	83	0	2	85	0	0
19	3611548	rs2369189	A	G	30	68	98	0	2	100	0	0
19	3611765	rs2369188	A	G	16	45	61	0	0	61	0	0
19	3611972	rs2158935	G	A	37	95	132	0	0	132	0	0
19	3613346	rs2074789	G	A	3	4	7	0	0	7	0	0
19	3613596	rs57918402	A	G	4	8	12	0	0	12	0	0
19	3614136	rs2074791	C	T	3	8	11	0	0	11	0	0
19	3614850	rs2074792	G	T	0	10	10	0	0	10	0	0
19	3615164	rs768962	A	G	2	4	6	0	0	6	0	0
19	3615407	rs768963	G	A	3	5	8	0	0	8	0	0
19	3616103	rs4806943	T	C	2	6	8	0	1	9	0	0
19	3616229	rs11085027	T	G	0	9	9	0	0	9	0	0
19	3616241	rs4806944	A	C	1	9	10	0	0	10	0	0
19	3616850	rs2369187	A	G	2	4	6	0	0	6	0	0
19	3617549	rs2024132	G	A	3	6	9	0	0	9	0	0
19	3617906	rs11085028	A	C	1	10	11	0	0	11	0	0
19	3618489	rs2041050	T	G	1	5	6	0	0	6	0	0
19	3622535	rs4807492	G	A	2	4	6	0	0	6	0	0
19	3623229	rs7252821	A	T	5	1	6	0	0	6	0	0
19	3623323	rs7252517	C	G	3	4	7	0	0	7	0	0
19	3624005	rs55862054	G	A	19	9	28	0	0	28	0	0
19	3631419	rs77309456	G	A	17	23	40	0	1	41	0	0
19	3631694	rs4806946	G	A	20	24	44	0	0	44	0	0
19	3653525	rs2074957	C	T	5	4	9	0	1	10	0	0
19	3664491	rs79025514	G	A	4	5	9	0	0	9	0	0
19	3762698	rs13960	C	T	81	118	199	0	2	201	0	0
19	3766720	rs4807508	A	G	1	8	9	0	0	9	0	0
19	3767265	rs7239	C	T	533	450	983	0	6	989	0	0
19	3783585	rs74541557	G	T	3	4	7	0	1	8	0	0
19	3977486	rs36527	A	G	2615	2485	5100	0	47	5147	0	0
19	3979408	rs36526	A	G	3064	3151	6215	0	74	6290	1	0
19	3980824	rs36525	A	G	22	17	39	0	0	39	0	0
19	4013322	rs2289865	T	C	16	12	28	0	0	28	0	0
19	4028783	rs2289863	C	T	23	35	58	0	2	60	0	0
19	4037966	rs72976977	T	C	10	7	17	0	0	17	0	0
19	4044424	rs59208569	G	C	3	5	8	0	0	8	0	0
19	4044579	rs7351050	G	A	4	5	9	0	0	9	0	0
19	4048561	rs67868323	G	T	6	3	9	0	0	9	0	0
19	4050424	rs72976986	G	A	12	12	24	0	0	24	0	0
19	4050832	rs57904377	C	T	6	1	7	0	0	7	0	0
19	4052920	rs72976987	C	T	6	8	14	0	0	14	0	0
19	4053013	rs7245642	G	A	11	5	16	0	0	16	0	0
19	4053428	rs12978130	C	T	7	7	14	0	1	15	0	0
19	4090572	rs6629	G	A	219	300	519	0	3	522	0	0
19	4251069	rs1045750	T	C	143	168	311	0	2	313	0	0
19	4254375	rs11085068	C	T	174	192	366	0	5	371	0	0
19	4255010	rs11671473	G	A	1	5	6	0	0	6	0	0
19	4280186	rs10419363	C	T	2	4	6	0	0	6	0	0
19	4288332	rs888930	A	G	5	3	8	0	0	8	0	0
19	4292362	rs6510800	G	A	41	41	82	0	1	83	0	0
19	4292597	rs888932	C	T	46	49	95	0	2	97	0	0
19	4325433	rs1138253	G	A	2	9	11	0	0	11	0	0
19	4352959	rs11882587	A	G	66	47	113	0	1	114	0	0
19	4357892	rs4807584	C	T	3	3	6	0	0	6	0	0
19	4362691	rs243261	G	C	275	254	529	0	4	533	0	0
19	4363289	rs62129346	C	T	6	8	14	0	1	15	0	0
19	4363477	rs111805435	G	A	2	5	7	0	0	7	0	0
19	4363960	rs112536459	C	G	35	34	69	0	1	70	0	0
19	4395676	rs141564230	G	A	7	7	14	0	0	14	0	0
19	4396251	rs243411	C	T	10	7	17	0	1	18	0	0
19	4410789	rs243348	A	G	4	3	7	0	0	7	0	0
19	4411442	rs243350	A	G	8	4	12	0	0	12	0	0
19	4412106	rs243352	T	G	6	5	11	0	0	11	0	0
19	4412496	rs243353	G	A	14	12	26	0	1	27	0	0
19	4412713	rs243354	A	G	22	17	39	0	0	39	0	0
19	4443046	rs2992	T	C	64	57	121	0	1	122	0	0
19	4449287	rs760369	T	C	20	28	48	0	1	50	1	0
19	4450071	rs147563273	G	A	12	15	27	0	0	27	0	0
19	4450742	rs243393	C	T	6	4	10	0	0	10	0	0
19	4451560	rs243394	A	T	4	3	7	0	0	7	0	0
19	4452497	rs243395	G	A	9	5	14	0	1	15	0	0
19	4453229	rs243396	C	T	7	5	12	0	0	12	0	0
19	4454083	rs1127888	C	T	113	119	232	0	2	234	0	0
19	4454104	rs117885408	G	T	3	10	13	0	0	13	0	0
19	4454736	rs72990643	C	T	6	10	16	0	0	16	0	0
19	4457650	rs1044510	C	T	76	71	147	0	3	150	0	0
19	4511830	.	A	G	6	2	8	0	1	9	0	0
19	4525046	rs1610090	A	G	3	3	6	0	0	6	0	0
19	4538599	rs966384	G	A	71	52	123	0	2	126	1	0
19	4553225	rs919799	T	G	3	3	6	0	0	6	0	0
19	4558431	rs2304213	C	G	2	5	7	0	0	7	0	0
19	4651911	rs143527230	T	C	8	3	11	0	0	11	0	0
19	4652822	rs1060555	C	G	11	12	23	0	0	23	0	0
19	4653351	rs111777530	C	G	5	6	11	0	0	11	0	0
19	4653370	rs4806994	C	G	4	7	11	0	0	11	0	0
19	4653420	rs9783964	A	G	5	2	7	0	0	7	0	0
19	4654163	rs8110873	A	C	11	11	22	0	0	22	0	0
19	4654757	rs8110359	G	A	14	11	25	0	0	25	0	0
19	4657016	rs66891175	T	C	2	4	6	0	0	6	0	0
19	4657957	rs11148	A	C	466	604	1070	0	4	1074	0	0
19	4670236	rs10401515	C	G	94	91	185	0	3	188	0	0
19	4670313	rs2270090	C	G	7	5	12	0	0	12	0	0
19	4676140	rs10425839	T	G	74	67	141	0	10	151	0	0
19	4678396	rs6510820	G	A	5	6	11	0	1	12	0	0
19	4685276	rs10421782	A	C	5	3	8	0	0	8	0	0
19	4687075	rs10415651	T	C	8	11	19	0	0	19	0	0
19	4690259	rs2885734	T	C	4	2	6	0	1	7	0	0
19	4703457	rs111495237	G	A	1	6	7	0	0	7	0	0
19	4794257	rs11085099	T	G	56	46	102	0	2	104	0	0
19	4816160	rs8120	A	C	90	132	222	0	1	224	1	0
19	4816719	rs2292151	G	A	74	101	175	0	2	177	0	0
19	4818378	rs7255265	T	C	51	71	122	0	4	126	0	0
19	4838590	.	T	C	338	161	499	0	54	553	0	0
19	4841123	.	G	A	4	3	7	0	0	7	0	0
19	4847713	rs9973235	A	G	285	303	588	0	3	592	1	0
19	4847874	rs9304915	A	G	237	287	524	0	6	530	0	0
19	4852106	rs2271058	A	G	248	280	528	0	8	536	0	0
19	4867701	rs262558	G	T	5	1	6	0	0	6	0	0
19	4909629	rs8103849	C	G	3	6	9	0	0	9	0	0
19	4910889	rs2261988	G	T	7	13	20	0	0	20	0	0
19	4910924	rs2261986	C	T	11	18	29	0	0	29	0	0
19	4915716	rs3852915	C	T	2	7	9	0	0	9	0	0
19	4929413	rs2251520	T	C	10	8	18	0	0	18	0	0
19	4929473	rs2123731	A	G	13	7	20	0	2	22	0	0
19	4961790	rs403399	A	T	11	11	22	0	1	23	0	0
19	4961791	rs16992727	A	T	13	10	23	0	0	23	0	0
19	5152125	.	G	T	20	12	32	0	1	33	0	0
19	5587240	rs73920021	G	A	137	130	267	0	13	280	0	0
19	5588441	rs2240236	A	G	23	33	56	0	0	56	0	0
19	5589132	rs57618432	G	A	10	11	21	0	1	22	0	0
19	5589383	rs59704629	C	T	14	21	35	0	0	35	0	0
19	5589964	rs73920022	A	G	12	21	33	0	0	33	0	0
19	5590927	rs4807793	A	G	6	2	8	0	0	9	1	0
19	5591006	rs4807794	T	C	4	7	11	0	0	11	0	0
19	5591701	rs56222752	C	T	11	9	20	0	0	20	0	0
19	5592547	rs10417622	T	C	4	3	7	0	0	7	0	0
19	5593771	rs3213651	A	G	9	8	17	0	1	18	0	0
19	5597026	rs2285965	C	A	16	10	26	0	0	26	0	0
19	5598357	rs7260385	A	G	9	4	13	0	0	13	0	0
19	5625269	rs3760767	A	G	4	4	8	0	0	8	0	0
19	5645444	rs2436502	G	A	7	4	11	0	0	11	0	0
19	5666182	rs2002985	A	G	15	14	29	0	0	29	0	0
19	5694349	rs2485256	G	A	3	6	9	0	0	9	0	0
19	5696245	rs4073993	A	G	22	13	35	0	1	36	0	0
19	5706395	rs148692591	G	A	12	4	16	0	0	16	0	0
19	5709412	rs1890098	C	T	22	16	38	0	0	38	0	0
19	5711217	rs2436508	T	C	6	12	18	0	0	18	0	0
19	5786410	rs139351537	C	T	32	44	76	0	1	77	0	0
19	5867128	.	G	A	5	8	13	0	0	13	0	0
19	5867177	rs778970	G	A	8	7	15	0	0	15	0	0
19	5867191	rs10412834	G	A	7	7	14	0	0	14	0	0
19	5867748	rs778971	G	T	5	8	13	0	0	13	0	0
19	5910095	rs7260578	G	A	8	10	18	0	1	19	0	0
19	5914605	rs7249419	A	G	12	18	30	0	0	30	0	0
19	5914625	rs7248090	G	A	13	16	29	0	0	29	0	0
19	5915151	rs74174355	C	T	12	12	24	0	0	24	0	0
19	5917616	rs4807058	G	A	10	10	20	0	0	20	0	0
19	5994333	rs79314920	C	G	63	60	123	0	1	124	0	0
19	6211876	rs11085164	C	T	19	16	35	0	0	35	0	0
19	6212282	rs11553930	T	G	37	39	76	0	0	76	0	0
19	6214291	rs11669692	A	G	4	5	9	0	0	9	0	0
19	6214295	rs11673633	C	G	3	5	8	0	0	8	0	0
19	6214725	rs4807849	T	C	4	4	8	0	0	8	0	0
19	6214866	rs3827013	G	A	3	7	10	0	0	10	0	0
19	6273140	rs4807858	A	G	1	5	6	0	0	6	0	0
19	6276235	rs6510880	G	A	2	4	6	0	0	6	0	0
19	6385518	.	C	T	7	0	7	0	0	7	0	0
19	6468331	rs62107586	T	C	125	95	220	0	1	221	0	0
19	6494371	rs1053395	G	C	7	8	15	0	0	15	0	0
19	6494915	rs3099129	C	G	25	41	66	0	0	66	0	0
19	6495064	rs446199	C	G	26	27	53	0	1	54	0	0
19	6495736	rs2071347	A	G	24	14	38	0	0	38	0	0
19	6535637	rs348389	C	T	118	116	234	0	2	236	0	0
19	6731746	rs143266929	G	T	7	4	11	0	0	11	0	0
19	6755179	.	C	T	9	10	19	0	0	19	0	0
19	6760974	rs7258236	T	C	6	1	7	0	0	7	0	0
19	6763718	rs2305805	A	G	12	5	17	0	1	18	0	0
19	6772872	rs45448796	G	C	41	48	89	0	1	90	0	0
19	6827356	rs3844451	A	G	1	5	6	0	0	6	0	0
19	6831355	rs3786686	G	A	3	5	8	0	0	8	0	0
19	6831655	rs3786688	G	A	6	4	10	0	0	10	0	0
19	6832126	.	G	A	100	92	192	0	2	194	0	0
19	6847974	rs331680	A	G	4	2	6	0	0	6	0	0
19	6849906	rs331677	A	T	3	3	6	0	1	7	0	0
19	6972357	rs252579	C	T	9	14	23	0	1	24	0	0
19	6983737	rs12972066	C	A	3	3	6	0	0	6	0	0
19	7083629	rs966591	A	G	12	19	31	0	0	31	0	0
19	7083761	rs8110740	A	G	16	18	34	0	0	34	0	0
19	7083818	rs17637922	C	T	16	16	32	0	0	32	0	0
19	7084087	rs117266473	C	T	19	14	33	0	0	33	0	0
19	7084089	rs118095691	C	G	19	14	33	0	0	33	0	0
19	7084307	rs6510944	T	C	13	16	29	0	0	29	0	0
19	7084747	rs2352958	C	T	15	18	33	0	0	33	0	0
19	7085442	rs72986677	T	C	12	21	33	0	0	33	0	0
19	7085480	rs768489	T	G	15	10	25	0	0	25	0	0
19	7086436	rs117478339	G	A	8	6	14	0	0	14	0	0
19	7086651	rs8108168	C	T	1	8	9	0	0	9	0	0
19	7086971	rs8108545	C	T	14	8	22	0	0	22	0	0
19	7087710	rs36089479	A	T	41	29	70	0	4	74	0	0
19	7087712	.	A	T	40	32	72	0	2	74	0	0
19	7112645	rs12642	C	A	15	12	27	0	0	27	0	0
19	7113444	rs77859571	T	C	8	11	19	0	0	19	0	0
19	7114213	rs1864193	C	A	10	9	19	0	1	20	0	0
19	7114288	rs3745551	C	T	6	10	16	0	0	16	0	0
19	7115057	rs55972112	C	T	13	5	18	0	0	18	0	0
19	7115573	rs3745550	C	T	11	6	17	0	0	17	0	0
19	7116283	rs1051651	G	C	10	9	19	0	0	19	0	0
19	7125297	rs1799817	G	A	7	3	10	0	0	10	0	0
19	7125998	rs55856124	T	A	4	2	6	0	0	6	0	0
19	7141775	rs2229431	G	A	3	3	6	0	0	6	0	0
19	7166376	rs2059806	C	T	7	9	16	0	0	16	0	0
19	7166388	rs2229429	G	A	10	8	18	0	0	18	0	0
19	7593048	rs73003348	C	T	35	31	66	0	0	66	0	0
19	7621648	rs489056	C	T	4	2	6	0	0	6	0	0
19	7622226	rs1645800	G	A	10	13	23	0	0	24	1	0
19	7622360	rs8110625	C	T	9	11	20	0	0	20	0	0
19	7622528	rs503336	A	G	7	8	15	0	1	16	0	0
19	7622542	rs518321	T	C	7	7	14	0	0	14	0	0
19	7622744	rs7245592	G	A	9	5	14	0	0	14	0	0
19	7622831	rs521032	T	C	8	5	13	0	1	14	0	0
19	7622835	rs506104	C	A	8	6	14	0	0	14	0	0
19	7622936	rs12609642	C	T	14	9	23	0	1	24	0	0
19	7622967	rs11878263	G	A	10	15	25	0	0	25	0	0
19	7623039	rs11880908	C	T	8	14	22	0	1	23	0	0
19	7623131	rs508786	G	A	7	8	15	0	0	15	0	0
19	7623410	rs546909	T	C	15	19	34	0	1	35	0	0
19	7623474	rs547713	T	C	13	17	30	0	0	30	0	0
19	7623584	rs548664	T	C	7	15	22	0	1	23	0	0
19	7623700	rs535208	G	A	7	15	22	0	0	22	0	0
19	7625723	rs62111318	C	T	3	4	7	0	0	7	0	0
19	7688614	rs2335521	T	C	0	18	18	0	0	18	0	0
19	7691001	rs4134838	G	C	21	9	30	0	0	30	0	0
19	7691465	rs1035465	G	A	18	8	26	0	1	27	0	0
19	7691749	rs142676580	C	T	4	6	10	0	1	11	0	0
19	7691867	rs794083	C	G	24	14	38	0	0	38	0	0
19	7691949	rs4134831	A	G	22	15	37	0	0	37	0	0
19	7692058	rs794084	G	A	21	16	37	0	0	37	0	0
19	7692076	rs4134826	T	C	15	14	29	0	0	29	0	0
19	7692083	rs4134825	G	A	17	14	31	0	0	31	0	0
19	7694393	rs4134809	G	A	79	71	150	0	0	150	0	0
19	7695336	rs3760676	A	G	17	16	33	0	0	33	0	0
19	7695620	rs11260004	T	C	6	13	19	0	0	19	0	0
19	7695977	rs3760677	C	G	27	19	46	0	1	47	0	0
19	7696138	rs11882197	G	A	46	42	88	0	3	91	0	0
19	7698320	rs1862514	C	T	6	9	15	0	0	15	0	0
19	7698384	rs72994436	G	A	5	6	11	0	0	11	0	0
19	7698653	rs1862515	A	G	2	5	7	0	0	7	0	0
19	7698760	rs4804756	A	G	1	7	8	0	0	8	0	0
19	7701748	rs7359905	T	C	5	6	11	0	0	11	0	0
19	7702575	rs8103237	G	A	27	28	55	0	1	56	0	0
19	7703605	rs8104339	C	T	15	10	25	0	0	25	0	0
19	7709271	rs3815754	A	G	27	33	60	0	0	60	0	0
19	7710040	rs929807	T	C	3	7	10	0	0	10	0	0
19	7710210	rs889187	A	G	32	27	59	0	1	60	0	0
19	7710269	rs710951	A	G	32	29	61	0	0	61	0	0
19	7710343	rs889185	G	A	34	28	62	0	1	63	0	0
19	7710603	rs889184	C	G	32	35	67	0	1	68	0	0
19	7711221	rs10001	T	C	596	754	1350	0	11	1361	0	0
19	7712161	rs55954306	C	T	61	72	133	0	1	134	0	0
19	7712277	rs6791	A	G	420	497	917	0	10	927	0	0
19	7712425	rs34976997	G	C	38	31	69	0	2	71	0	0
19	7712474	rs794074	G	A	37	45	82	0	1	83	0	0
19	7712585	.	T	G	53	38	91	0	6	97	0	0
19	7743821	rs72996468	A	G	144	78	222	0	1	223	0	0
19	7744220	rs56229793	A	G	154	75	229	0	2	231	0	0
19	7747293	rs6952	T	G	26	5	31	0	0	31	0	0
19	7754194	rs8102872	C	T	2	4	6	0	0	6	0	0
19	7969904	rs58075492	T	C	10	7	17	0	0	17	0	0
19	7970082	rs74515633	C	T	4	5	9	0	0	9	0	0
19	7970139	.	C	T	3	3	6	0	0	6	0	0
19	7971122	rs41284498	T	C	6	5	11	0	0	11	0	0
19	7975586	rs2303701	C	T	74	57	131	0	1	132	0	0
19	7976112	rs7260355	G	A	16	0	16	0	0	16	0	0
19	7976127	rs56358830	C	G	0	12	12	0	0	12	0	0
19	7977268	.	G	T	45	56	101	0	0	101	0	0
19	7977870	rs3745386	G	A	66	67	133	0	0	133	0	0
19	7978491	rs151231797	T	G	51	63	114	0	0	114	0	0
19	7988117	rs7788	T	C	1	5	6	0	0	6	0	0
19	7994233	rs3810213	G	A	8	11	19	0	1	20	0	0
19	8028960	.	T	C	3	3	6	0	0	6	0	0
19	8041383	rs10401186	G	A	2	4	6	0	0	6	0	0
19	8041418	rs2081172	G	C	3	3	6	0	0	6	0	0
19	8041700	rs17444755	G	A	6	2	8	0	0	8	0	0
19	8049583	rs79388440	C	T	7	7	14	0	0	14	0	0
19	8052646	rs7251814	C	T	5	1	6	0	0	6	0	0
19	8054840	rs75813060	G	A	8	2	10	0	0	10	0	0
19	8464799	.	C	T	278	207	485	0	2	487	0	0
19	8537113	rs112387416	G	T	11	3	14	0	2	16	0	0
19	8565043	rs28527176	A	T	11	2	13	0	0	13	0	0
19	8567475	rs968502	T	C	21	23	44	0	0	44	0	0
19	8567500	rs968501	G	A	7	7	14	0	0	14	0	0
19	8576307	rs2910443	A	G	18	22	40	0	1	41	0	0
19	8576670	rs7175	C	T	17	20	37	0	2	39	0	0
19	8576862	rs2287865	G	C	4	7	11	0	0	11	0	0
19	8576888	rs2042302	C	G	5	6	11	0	0	11	0	0
19	8577868	rs2967578	T	C	6	5	11	0	0	11	0	0
19	8578000	rs1064010	G	A	93	58	151	0	0	151	0	0
19	8578118	rs1064009	A	G	57	58	115	0	2	117	0	0
19	8578199	rs1141019	T	C	77	60	137	0	1	138	0	0
19	8578388	rs2967580	A	G	18	18	36	0	1	37	0	0
19	8578498	rs2910444	C	T	20	14	34	0	1	35	0	0
19	8579011	rs2287863	T	C	36	27	63	0	0	63	0	0
19	8585755	rs2913922	C	T	36	13	49	0	0	49	0	0
19	8586086	rs1054623	C	A	216	251	467	0	24	491	0	0
19	8596621	rs11882393	G	T	12	7	19	0	0	19	0	0
19	8597628	rs2967591	T	C	5	4	9	0	0	9	0	0
19	8607641	rs2967767	C	T	1	5	6	0	0	6	0	0
19	8607949	rs11881473	G	A	3	10	13	0	0	13	0	0
19	8608165	.	G	A	0	8	8	0	0	8	0	0
19	8608399	rs28432269	T	C	3	14	17	0	0	17	0	0
19	8610313	rs2967776	A	G	1	6	7	0	0	7	0	0
19	8615589	rs4804311	A	G	8	40	48	0	2	50	0	0
19	8615995	rs147912338	G	T	14	6	20	0	0	20	0	0
19	8616392	rs2013694	C	T	14	18	32	0	0	32	0	0
19	8617106	rs7251254	G	A	1	5	6	0	0	6	0	0
19	8619953	rs143108385	C	T	5	9	14	0	0	14	0	0
19	8620179	rs113312019	G	A	4	6	10	0	0	10	0	0
19	8639093	rs12611122	C	T	7	6	13	0	0	13	0	0
19	8640516	rs4804314	C	T	5	7	12	0	0	12	0	0
19	8641486	rs117665505	G	A	7	8	15	0	0	15	0	0
19	8645568	.	G	A	13	8	21	0	0	21	0	0
19	8651562	rs4476282	A	G	18	24	42	0	1	43	0	0
19	8657871	rs34134669	G	C	5	4	9	0	0	9	0	0
19	8658744	rs12985470	T	A	5	6	11	0	0	11	0	0
19	8669931	rs7255721	G	C	7	8	15	0	0	15	0	0
19	8920629	rs11787	A	G	9	5	14	0	0	14	0	0
19	8920984	rs2910344	T	C	14	10	24	0	0	24	0	0
19	8921033	rs250316	C	T	9	12	21	0	0	21	0	0
19	8921219	.	A	C	5	8	13	0	0	13	0	0
19	8921486	rs1582532	T	C	6	4	10	0	0	10	0	0
19	9267319	rs3752199	G	T	110	83	193	0	3	196	0	0
19	9267646	rs2163816	T	A	69	61	130	0	1	131	0	0
19	9268261	rs3829682	G	A	10	5	15	0	0	15	0	0
19	9270050	rs10418591	G	A	2	4	6	0	0	6	0	0
19	9270156	rs60707873	G	A	2	4	6	0	0	6	0	0
19	9273800	rs10129	A	G	199	180	379	0	2	382	1	0
19	9402877	rs10422910	T	C	8	12	20	0	0	20	0	0
19	9405068	rs10412061	T	C	10	13	23	0	0	23	0	0
19	9454173	rs13535	A	G	6	3	9	0	0	9	0	0
19	9490814	rs2217652	C	T	3	3	6	0	0	6	0	0
19	9492141	rs3826783	C	T	3	3	6	0	0	6	0	0
19	9523724	rs10515	A	G	134	140	274	0	3	277	0	0
19	9524185	rs2241356	A	G	108	110	218	0	3	221	0	0
19	9529783	rs1978713	G	C	15	37	52	0	1	53	0	0
19	9530070	rs1978712	T	C	17	17	34	0	2	36	0	0
19	9530081	rs1978711	G	C	15	15	30	0	2	32	0	0
19	9530342	rs2277931	G	A	12	15	27	0	0	27	0	0
19	9530597	rs8109853	G	A	6	1	7	0	0	7	0	0
19	9531116	rs1978435	C	T	6	5	11	0	0	11	0	0
19	9531245	rs1978436	T	C	5	6	11	0	0	11	0	0
19	9531342	rs1978437	A	G	7	3	10	0	0	10	0	0
19	9531393	rs1978438	G	T	7	3	10	0	0	10	0	0
19	9531425	rs28711703	C	G	6	3	9	0	1	10	0	0
19	9531446	rs34450188	A	G	6	8	14	0	0	14	0	0
19	9531541	rs58900528	C	T	6	9	15	0	0	15	0	0
19	9531693	rs11880207	C	T	5	4	9	0	0	9	0	0
19	9532083	rs2112528	G	A	3	6	9	0	0	9	0	0
19	9532156	rs2112529	A	G	2	4	6	0	0	6	0	0
19	9532258	rs8100415	C	T	7	9	16	0	0	16	0	0
19	9533805	rs6512121	G	T	5	5	10	0	0	10	0	0
19	9534301	rs7254750	C	T	0	8	8	0	0	8	0	0
19	9535127	rs56046222	T	G	2	5	7	0	0	7	0	0
19	9535130	rs56221935	T	C	3	5	8	0	0	8	0	0
19	9536418	rs10406056	C	T	2	4	6	0	0	6	0	0
19	9581467	rs9305087	A	T	0	6	6	0	0	6	0	0
19	9695008	rs7253981	A	G	1	7	8	0	0	8	0	0
19	9763152	rs12977468	T	C	19	14	33	0	1	34	0	0
19	9924907	rs62105744	G	A	8	4	12	0	0	12	0	0
19	9959014	rs2287838	G	A	4	4	8	0	0	8	0	0
19	10222195	rs12460842	A	G	39	45	84	0	0	84	0	0
19	10222558	rs2010353	G	T	16	22	38	0	0	38	0	0
19	10222862	rs112647895	G	A	25	35	60	0	0	60	0	0
19	10223296	rs73011220	G	A	49	48	97	0	0	97	0	0
19	10224131	rs12462506	T	G	28	46	74	0	4	78	0	0
19	10224548	rs3745601	G	A	57	65	122	0	3	125	0	0
19	10225682	rs3816556	G	C	109	84	193	0	8	201	0	0
19	10226052	rs2305795	G	A	13	4	17	0	0	17	0	0
19	10227010	rs3826784	A	G	21	26	47	0	1	48	0	0
19	10227149	rs3826785	C	T	38	29	67	0	0	67	0	0
19	10244554	rs73013012	G	A	5	8	13	0	0	13	0	0
19	10246029	rs8101626	G	A	6	4	10	0	0	10	0	0
19	10251747	rs2290684	A	G	15	27	42	0	1	43	0	0
19	10265593	rs2228613	G	T	98	101	199	0	2	201	0	0
19	10267077	rs2228611	T	C	78	81	159	0	1	160	0	0
19	10284778	rs759920	A	G	6	10	16	0	0	16	0	0
19	10332547	rs55818584	T	A	5	5	10	0	1	11	0	0
19	10395683	rs5498	A	G	134	133	267	0	4	271	0	0
19	10397131	rs281436	G	A	77	144	221	0	0	221	0	0
19	10397133	rs114170067	C	T	75	144	219	0	1	220	0	0
19	10397223	rs923366	C	T	101	55	156	0	0	156	0	0
19	10397238	rs281437	C	T	44	58	102	0	0	102	0	0
19	10401607	rs2075742	G	C	9	1	10	0	0	10	0	0
19	10402938	rs1056538	G	A	20	1	21	0	0	21	0	0
19	10403368	rs2228615	G	A	23	1	24	0	1	25	0	0
19	10404227	rs2569703	C	G	8	1	9	0	0	9	0	0
19	10404519	rs17852402	G	A	24	2	26	0	0	26	0	0
19	10406635	rs885743	T	A	7	3	10	0	0	10	0	0
19	10426422	rs378395	A	C	5	5	10	0	0	10	0	0
19	10428790	rs12459144	C	T	1	5	6	0	0	6	0	0
19	10429455	rs34157869	C	G	4	4	8	0	0	8	0	0
19	10432924	rs4804500	A	G	4	2	6	0	0	6	0	0
19	10441850	rs12460902	C	T	7	0	7	0	0	7	0	0
19	10444603	rs2230399	C	G	1218	1267	2485	0	8	2494	1	0
19	10445165	rs61198164	C	A	20	12	32	0	0	32	0	0
19	10463308	rs149329233	G	A	13	19	32	0	1	33	0	0
19	10464540	rs12720358	C	T	63	64	127	0	0	127	0	0
19	10488926	rs55762744	C	T	54	33	87	0	1	89	1	0
19	10579474	rs7256672	T	G	5	7	12	0	0	12	0	0
19	10600418	rs35074907	G	A	86	57	143	0	0	143	0	0
19	10658435	rs75120078	C	T	5	3	8	0	0	8	0	0
19	10660058	rs34479588	C	A	10	3	13	0	0	13	0	0
19	10660240	rs8103305	T	C	4	3	7	0	0	7	0	0
19	10660250	rs35041134	C	T	4	3	7	0	0	7	0	0
19	10661620	rs12973308	T	G	7	7	14	0	0	14	0	0
19	10661775	rs8108051	T	C	5	6	11	0	0	11	0	0
19	10662068	rs10411361	A	G	3	4	7	0	0	7	0	0
19	10668383	rs3745256	T	C	15	12	27	0	0	27	0	0
19	10668673	rs1982074	A	G	33	59	92	0	1	93	0	0
19	10668953	rs875569	G	A	19	15	34	0	1	35	0	0
19	10669172	rs2018810	A	G	13	19	32	0	0	32	0	0
19	10669824	rs2002538	G	A	6	7	13	0	0	13	0	0
19	10670184	rs3826709	C	G	53	45	98	0	2	100	0	0
19	10670794	rs3745250	G	A	4	3	7	0	0	7	0	0
19	10670992	rs3745249	C	T	39	41	80	0	0	80	0	0
19	10672493	rs12984043	C	T	45	55	100	0	1	101	0	0
19	10676423	rs3745245	G	A	21	27	48	0	0	48	0	0
19	10678842	rs1465701	T	C	14	15	29	0	0	29	0	0
19	10715154	rs12982370	C	A	7	2	9	0	0	9	0	0
19	10738639	rs3087969	C	T	53	44	97	0	1	98	0	0
19	10742170	rs2288904	A	G	41	42	83	0	0	83	0	0
19	10742287	rs1560711	C	T	4	2	6	0	0	6	0	0
19	10798547	.	G	A	2	4	6	0	0	6	0	0
19	10907286	rs34516961	A	G	7	4	11	0	0	11	0	0
19	10907425	rs11672991	T	A	7	5	12	0	0	12	0	0
19	11029314	rs2053065	T	C	4	2	6	0	0	6	0	0
19	11029736	rs4804547	G	A	1	5	6	0	0	6	0	0
19	11041052	rs12978180	T	C	1	6	7	0	0	7	0	0
19	11041538	rs4804548	T	G	13	11	24	0	0	24	0	0
19	11041736	rs74179958	C	T	6	5	11	0	0	11	0	0
19	11041877	rs35942222	A	G	4	3	7	0	0	7	0	0
19	11105608	rs7935	T	C	98	89	187	0	3	190	0	0
19	11136215	rs2075021	C	G	12	9	21	0	0	21	0	0
19	11146338	rs12460706	T	C	13	4	17	0	1	18	0	0
19	11146499	rs3786721	T	C	10	8	18	0	0	18	0	0
19	11147615	rs4804562	G	A	5	7	12	0	0	12	0	0
19	11147694	rs4804563	T	G	6	4	10	0	0	10	0	0
19	11151330	rs6511717	T	C	6	11	17	0	1	18	0	0
19	11163562	rs1529729	C	T	2	4	6	0	1	7	0	0
19	11167219	rs12609863	C	T	5	4	9	0	0	9	0	0
19	11167440	rs73502604	C	G	3	4	7	0	0	7	0	0
19	11170839	rs7275	T	C	203	197	400	0	3	403	0	0
19	11213531	rs56084625	C	T	6	3	9	0	0	9	0	0
19	11214556	rs192651205	G	A	8	8	16	0	0	16	0	0
19	11224181	rs1003723	C	T	11	11	22	0	0	22	0	0
19	11224265	rs5930	A	G	126	114	240	0	1	241	0	0
19	11227602	rs688	C	T	178	159	337	0	5	342	0	0
19	11228512	rs28786710	G	A	4	6	10	0	0	10	0	0
19	11228726	rs2738448	C	G	9	7	16	0	0	16	0	0
19	11228745	rs2569550	T	C	8	4	12	0	0	12	0	0
19	11228783	rs2738449	C	T	7	4	11	0	0	11	0	0
19	11229218	rs2738452	A	G	7	13	20	0	1	21	0	0
19	11229577	rs2915967	T	C	3	3	6	0	0	6	0	0
19	11229765	rs35878749	G	A	6	2	8	0	0	8	0	0
19	11229850	rs34444274	C	G	9	3	12	0	0	12	0	0
19	11229968	rs9789302	C	T	7	9	16	0	0	16	0	0
19	11230002	rs9789303	C	T	8	9	17	0	0	17	0	0
19	11230214	rs34554139	T	C	7	8	15	0	0	15	0	0
19	11230332	rs12611153	C	T	6	3	9	0	1	10	0	0
19	11230362	rs12609673	A	C	6	3	9	0	0	9	0	0
19	11230402	rs12611067	G	T	5	6	11	0	0	11	0	0
19	11230645	rs2569549	T	C	8	10	18	0	0	18	0	0
19	11230881	rs5925	T	C	211	147	358	0	1	359	0	0
19	11237269	rs2738457	G	A	4	2	6	0	0	6	0	0
19	11237296	rs2738458	T	C	5	2	7	0	0	7	0	0
19	11238399	rs2569539	G	A	3	3	6	0	0	6	0	0
19	11238473	rs2738459	A	C	3	3	6	0	0	6	0	0
19	11238492	rs12459476	A	G	4	4	8	0	1	9	0	0
19	11238807	rs2738460	C	T	4	5	9	0	0	9	0	0
19	11239439	rs68141833	T	C	8	5	13	0	0	13	0	0
19	11240053	rs2569537	G	A	5	3	8	0	0	8	0	0
19	11241780	rs2116899	G	A	3	3	6	0	0	6	0	0
19	11241810	rs2116898	G	A	3	3	6	0	0	6	0	0
19	11241877	rs2116897	G	A	2	4	6	0	0	6	0	0
19	11242044	rs14158	G	A	217	190	407	0	7	414	0	0
19	11242496	rs2738465	G	A	286	256	542	0	9	551	0	0
19	11242765	rs2738466	A	G	260	251	511	0	6	517	0	0
19	11243160	rs17242683	G	A	98	68	166	0	0	166	0	0
19	11243260	rs2978615	C	T	34	41	75	0	0	75	0	0
19	11243328	rs72658877	C	G	97	54	151	0	1	152	0	0
19	11243368	rs55903358	T	C	133	51	184	0	4	188	0	0
19	11243411	rs55971831	C	A	164	93	257	0	5	262	0	0
19	11243445	rs5742911	A	G	162	114	276	0	10	286	0	0
19	11243502	rs17249057	T	C	170	156	326	0	4	330	0	0
19	11243592	rs17249064	G	T	264	194	458	0	19	477	0	0
19	11243735	rs2738467	C	T	254	263	517	0	11	528	0	0
19	11256285	rs4804147	A	G	1	6	7	0	0	7	0	0
19	11257243	.	C	A	6	4	10	0	0	10	0	0
19	11257299	rs9749350	C	G	6	5	11	0	0	11	0	0
19	11444131	rs896412	C	G	1	5	6	0	0	6	0	0
19	11465316	rs6887	G	C	32	41	73	0	2	75	0	0
19	11488727	rs62638745	T	C	22	12	34	0	1	35	0	0
19	11560347	rs755000	T	G	34	29	63	0	4	67	0	0
19	11598240	rs36103734	G	A	3	3	6	0	0	6	0	0
19	11708361	rs11551815	C	T	10	28	38	0	0	38	0	0
19	11725413	rs12151212	G	A	24	9	33	0	1	34	0	0
19	11728802	rs4804611	A	G	17	30	47	0	1	48	0	0
19	11893555	rs286217	T	C	3	4	7	0	0	7	0	0
19	11893862	rs286218	C	T	6	1	7	0	0	7	0	0
19	11894535	rs286219	C	G	2	6	8	0	0	8	0	0
19	11935492	rs2685667	A	C	3	3	6	0	0	6	0	0
19	11937118	rs378030	C	A	4	2	6	0	0	6	0	0
19	11938125	rs2685664	G	A	1	5	6	0	0	6	0	0
19	11938141	rs375534	G	A	1	5	6	0	0	6	0	0
19	11938262	rs11671713	A	G	5	5	10	0	0	10	0	0
19	11939779	rs445012	A	G	3	3	6	0	0	6	0	0
19	11939808	rs417093	T	A	3	3	6	0	0	6	0	0
19	11939906	rs406262	A	G	3	3	6	0	0	6	0	0
19	11940234	rs416491	G	A	7	4	11	0	0	11	0	0
19	11940270	rs413333	A	G	6	4	10	0	0	10	0	0
19	11940863	rs406386	G	A	10	6	16	0	0	16	0	0
19	11941221	rs424132	T	A	25	26	51	0	0	51	0	0
19	11942771	rs436411	G	A	29	38	67	0	0	67	0	0
19	11943823	rs375049	G	A	52	33	85	0	0	85	0	0
19	11943852	rs3745669	T	C	44	45	89	0	1	90	0	0
19	11944066	rs430965	A	G	61	60	121	0	1	122	0	0
19	11944070	rs381973	A	G	62	49	111	0	1	112	0	0
19	11944322	rs434048	G	A	54	32	86	0	0	86	0	0
19	11944400	rs1062258	A	T	57	70	127	0	0	127	0	0
19	11944906	rs598006	C	A	5	11	16	0	1	17	0	0
19	11944989	rs74181615	T	A	14	15	29	0	1	30	0	0
19	11945266	rs2685659	A	T	14	18	32	0	0	32	0	0
19	11945466	rs2545808	C	T	16	12	28	0	0	28	0	0
19	11945487	rs600636	A	G	14	18	32	0	1	33	0	0
19	11960015	.	G	A	12	17	29	0	0	29	0	0
19	11960480	rs10439165	C	T	22	25	47	0	1	48	0	0
19	11960588	rs74181617	T	A	26	7	33	0	0	33	0	0
19	11960619	rs2545820	A	G	26	4	30	0	0	30	0	0
19	11960676	rs74181618	G	C	35	19	54	0	1	55	0	0
19	11960912	rs12977095	G	A	54	22	76	0	2	78	0	0
19	11960915	rs12977096	G	A	60	21	81	0	0	81	0	0
19	11960939	rs12986409	T	A	54	31	85	0	0	85	0	0
19	11979164	rs10500209	T	C	4	4	8	0	0	8	0	0
19	11979636	rs72994216	T	C	2	12	14	0	0	14	0	0
19	11979703	rs138404339	A	G	7	3	10	0	0	10	0	0
19	12054516	rs279256	C	A	6	2	8	0	0	8	0	0
19	12059645	rs12327617	A	G	13	19	32	0	0	32	0	0
19	12129758	rs11672566	A	C	20	28	48	0	1	49	0	0
19	12189379	rs11670621	C	T	15	15	30	0	2	32	0	0
19	12242460	rs1036593	A	T	4	2	6	0	0	6	0	0
19	12253327	rs3760779	C	T	18	19	37	0	1	38	0	0
19	12254686	rs112823962	T	C	4	2	6	0	1	7	0	0
19	12254854	rs67726460	T	C	5	5	10	0	0	10	0	0
19	12256358	rs12972621	T	G	4	4	8	0	0	8	0	0
19	12256912	rs7258368	C	T	6	9	15	0	0	15	0	0
19	12383090	rs112612717	T	C	166	102	268	0	1	269	0	0
19	12383540	rs56056044	G	C	135	126	261	0	2	263	0	0
19	12384580	rs11879168	T	C	111	94	205	0	1	206	0	0
19	12385989	rs2459041	A	G	4	5	9	0	0	9	0	0
19	12387337	rs2438528	A	G	24	11	35	0	0	35	0	0
19	12388152	rs2438527	C	T	6	3	9	0	0	9	0	0
19	12388942	rs11880121	G	A	12	7	19	0	0	19	0	0
19	12393144	rs12610228	T	A	5	3	8	0	0	8	0	0
19	12393941	rs12610305	A	G	3	4	7	0	0	7	0	0
19	12394554	rs73004277	G	C	4	4	8	0	0	8	0	0
19	12395479	rs2438590	T	C	5	4	9	0	1	10	0	0
19	12400264	rs2438520	G	A	5	2	7	0	0	7	0	0
19	12403740	rs533121	A	G	5	2	7	0	0	7	0	0
19	12405552	rs386901	T	C	71	67	138	0	1	140	1	0
19	12460783	rs117020952	G	C	3	10	13	0	2	15	0	0
19	12535949	rs35409614	G	C	4	3	7	0	0	7	0	0
19	12540748	.	C	T	5	3	8	0	1	9	0	0
19	12540771	rs1025025	G	T	6	4	10	0	1	11	0	0
19	12540784	.	G	A	6	5	11	0	0	11	0	0
19	12540818	rs706547	G	C	6	5	11	0	0	11	0	0
19	12541214	rs7256321	G	T	2	12	14	0	0	14	0	0
19	12541542	rs34507016	C	T	7	15	22	0	0	22	0	0
19	12541544	rs35055629	A	C	6	16	22	0	0	22	0	0
19	12541547	rs10402252	T	G	16	6	22	0	0	22	0	0
19	12541795	rs35699767	C	A	6	10	16	0	1	17	0	0
19	12542355	rs4804183	A	G	1	7	8	0	0	8	0	0
19	12542653	rs4239550	T	G	3	11	14	0	0	14	0	0
19	12542654	rs28599549	T	A	3	11	14	0	0	14	0	0
19	12542772	rs1134389	C	T	5	1	6	0	0	6	0	0
19	12562702	rs10401289	T	C	4	4	8	0	0	8	0	0
19	12568344	rs2862169	G	T	4	29	33	0	0	33	0	0
19	12574576	rs11085814	A	C	23	13	36	0	1	37	0	0
19	12576049	rs7259240	G	A	18	17	35	0	0	36	1	0
19	12635933	rs6511823	T	C	7	5	12	0	0	12	0	0
19	12690062	.	A	C	4	5	9	0	0	9	0	0
19	12690226	rs11669637	G	T	0	6	6	0	0	6	0	0
19	12692001	rs3745651	G	A	3	5	8	0	0	8	0	0
19	12768948	rs35836657	T	C	239	213	452	0	4	456	0	0
19	12782090	rs2861396	C	T	4	2	6	0	0	6	0	0
19	12782418	rs35542154	A	G	7	4	11	0	0	11	0	0
19	12786370	.	G	A	38	27	65	0	1	66	0	0
19	12810279	.	A	T	34	18	52	0	0	52	0	0
19	12811045	rs722572	T	C	41	52	93	0	2	95	0	0
19	12811379	rs722571	T	C	28	24	52	0	0	52	0	0
19	12989560	rs2293682	G	A	80	75	155	0	0	155	0	0
19	13010520	rs8012	A	G	19	38	57	0	1	58	0	0
19	13015399	.	C	A	44	37	81	0	0	81	0	0
19	13019554	rs11667458	C	T	4	2	6	0	0	6	0	0
19	13061450	rs2974753	A	G	4	2	6	0	0	6	0	0
19	13061983	rs2974754	C	T	2	4	6	0	1	7	0	0
19	13207284	rs11555274	G	C	14	29	43	0	0	43	0	0
19	13212199	rs3810317	C	T	9	2	11	0	0	11	0	0
19	13248856	rs12981904	T	C	21	29	50	0	0	50	0	0
19	13249244	rs8112067	A	G	65	55	120	0	6	126	0	0
19	13249580	.	G	A	49	52	101	0	2	103	0	0
19	13250340	rs8105087	T	A	28	18	46	0	2	48	0	0
19	13251160	rs74180202	G	A	56	49	105	0	3	108	0	0
19	13261085	rs4926138	C	G	2	5	7	0	0	7	0	0
19	13264481	.	C	A	414	447	861	0	7	868	0	0
19	13264549	rs77645585	C	T	140	167	307	0	0	307	0	0
19	13264751	rs567734015	C	T	318	360	678	0	9	687	0	0
19	13317980	rs7254351	G	T	5	3	8	0	0	8	0	0
19	13878063	rs346150	A	G	2	4	6	0	1	7	0	0
19	13878480	rs346151	G	A	3	3	6	0	0	6	0	0
19	13883099	rs1469071	A	G	135	113	248	0	1	249	0	0
19	13884312	rs1559153	A	G	77	53	130	0	1	131	0	0
19	13884321	rs1559152	C	T	80	48	128	0	0	128	0	0
19	13884655	rs1128028	G	A	88	54	142	0	1	143	0	0
19	13884724	rs1128030	G	C	121	79	200	0	3	203	0	0
19	13884800	rs1044733	T	C	109	97	206	0	1	207	0	0
19	13885127	rs346155	A	G	6	2	8	0	0	8	0	0
19	13885309	rs1128749	C	T	188	181	369	0	1	370	0	0
19	13885437	rs1559149	C	A	14	15	29	0	0	29	0	0
19	13885484	rs10104	A	G	389	376	765	0	10	775	0	0
19	13936385	rs62620757	C	T	7	6	13	0	0	13	0	0
19	13941597	rs112676900	C	T	4	4	8	0	0	8	0	0
19	13942221	rs3745453	A	G	5	9	14	0	0	14	0	0
19	13942587	rs12610873	G	A	13	15	28	0	0	28	0	0
19	13947292	rs895819	T	C	41	54	95	0	0	95	0	0
19	14041371	rs2290664	G	C	37	34	71	0	0	71	0	0
19	14041601	rs1059721	G	A	25	30	55	0	0	55	0	0
19	14065341	rs10409785	T	C	59	73	132	0	0	132	0	0
19	14065488	rs1056143	A	G	13	26	39	0	0	39	0	0
19	14065534	rs1056142	A	C	12	22	34	0	0	34	0	0
19	14162740	rs148749814	A	G	23	24	47	0	0	47	0	0
19	14207727	rs41296298	C	T	3	5	8	0	0	8	0	0
19	14231256	rs3745463	T	C	33	24	57	0	0	57	0	0
19	14492219	rs28366013	C	A	41	18	59	0	5	64	0	0
19	14504481	rs190437845	C	T	10	6	16	0	1	17	0	0
19	14507307	.	C	T	41	1	42	0	0	42	0	0
19	14509770	rs7255389	G	C	6	6	12	0	2	14	0	0
19	14512828	rs12974314	A	C	37	17	54	0	0	54	0	0
19	14514784	rs185392747	G	A	34	27	61	0	0	61	0	0
19	14524651	rs8109605	T	C	115	95	210	0	0	210	0	0
19	14574764	rs139622328	C	T	521	535	1056	0	13	1069	0	0
19	14676578	rs61732092	C	T	302	307	609	0	2	611	0	0
19	14681046	rs11673123	C	G	3	4	7	0	0	7	0	0
19	14682804	rs9543	G	C	340	327	667	0	2	669	0	0
19	15226970	rs2074262	G	A	55	56	111	0	0	111	0	0
19	15233581	rs2074265	C	A	41	41	82	0	0	82	0	0
19	15233631	rs2074266	G	A	5	8	13	0	0	13	0	0
19	15234635	rs718100	T	G	6	5	11	0	0	11	0	0
19	15235147	rs4808213	A	G	9	6	15	0	1	16	0	0
19	15235932	rs4141356	G	A	8	6	14	0	0	14	0	0
19	15270583	rs1044123	G	A	2	4	6	0	0	6	0	0
19	15270805	rs1044055	C	A	4	3	7	0	0	7	0	0
19	15300136	rs61749020	A	G	2	4	6	0	0	6	0	0
19	15350594	rs11669901	G	A	50	52	102	0	3	105	0	0
19	15359153	rs11673209	G	A	37	16	53	0	1	54	0	0
19	15359259	rs3787030	G	A	30	35	65	0	1	66	0	0
19	15464920	rs10413241	G	C	74	104	178	0	0	178	0	0
19	15469197	rs7248490	A	G	7	11	18	0	0	18	0	0
19	15485829	rs8106751	A	G	5	1	6	0	1	7	0	0
19	15492848	rs2366267	T	C	5	12	17	0	0	17	0	0
19	15504382	rs4809188	G	A	1	7	8	0	0	8	0	0
19	15504766	rs7257156	G	A	5	1	6	0	0	6	0	0
19	15508130	rs7247749	G	A	2	5	7	0	0	7	0	0
19	15512720	rs10854143	T	C	6	4	10	0	0	10	0	0
19	15512731	rs10775618	A	G	5	5	10	0	0	10	0	0
19	15512844	rs10775619	A	T	2	4	6	0	1	7	0	0
19	15533821	rs7254099	A	G	78	63	141	0	3	144	0	0
19	15763248	rs2733749	A	T	3	4	7	0	0	7	0	0
19	15763270	rs2683038	C	G	3	3	6	0	0	6	0	0
19	15763721	rs1805042	G	A	7	2	9	0	0	9	0	0
19	15770784	rs3087897	G	A	5	2	7	0	0	7	0	0
19	15771257	rs28371516	T	C	3	4	7	0	0	7	0	0
19	15771773	rs7255242	C	T	5	4	9	0	0	9	0	0
19	15771808	rs7255356	C	T	6	4	10	0	0	10	0	0
19	15771811	rs28371522	T	C	6	4	10	0	0	10	0	0
19	15771971	rs7255510	C	T	5	1	6	0	0	6	0	0
19	15771978	rs2683042	G	A	5	1	6	0	0	6	0	0
19	15772233	rs1063803	T	G	9	3	12	0	0	12	0	0
19	15974687	rs2079290	T	C	2	8	10	0	0	10	0	0
19	16185188	rs10414221	C	G	3	3	6	0	0	6	0	0
19	16185371	rs10426103	T	C	0	9	9	0	0	9	0	0
19	16185419	rs10418402	G	T	3	5	8	0	0	8	0	0
19	16185757	rs12609899	T	C	8	6	14	0	0	14	0	0
19	16186030	rs11086022	G	A	11	3	14	0	0	14	0	0
19	16186465	rs8113101	G	T	9	8	17	0	0	17	0	0
19	16186598	rs1363950	T	C	6	11	17	0	0	17	0	0
19	16186772	rs7260235	G	A	6	4	10	0	0	10	0	0
19	16187854	rs62116852	G	A	10	5	15	0	0	15	0	0
19	16188555	rs4808032	A	G	22	18	40	0	0	40	0	0
19	16188556	rs4808451	A	C	22	18	40	0	0	40	0	0
19	16189243	rs2278006	A	T	30	19	49	0	0	49	0	0
19	16189320	rs8105102	A	G	39	26	65	0	0	65	0	0
19	16189583	rs1055886	C	G	32	24	56	0	4	60	0	0
19	16189882	rs77808283	G	A	34	26	60	0	2	62	0	0
19	16190701	rs8108396	G	C	20	11	31	0	0	31	0	0
19	16190702	rs8109182	C	T	20	11	31	0	0	31	0	0
19	16190802	rs3826723	G	A	43	31	74	0	0	74	0	0
19	16190906	rs56123108	A	G	45	22	67	0	1	68	0	0
19	16190912	rs17641735	G	A	44	27	71	0	1	72	0	0
19	16191338	rs10424913	C	T	41	20	61	0	0	61	0	0
19	16191579	rs10426172	A	G	23	13	36	0	0	36	0	0
19	16192407	rs9789272	C	T	30	20	50	0	0	50	0	0
19	16192625	rs7247875	G	A	56	27	83	0	3	86	0	0
19	16193617	rs3786574	T	C	4	2	6	0	0	6	0	0
19	16194504	rs17708984	G	A	1	5	6	0	0	6	0	0
19	16195037	rs8110506	G	A	4	2	6	0	0	6	0	0
19	16200378	rs11086023	C	T	4	2	6	0	0	6	0	0
19	16235046	rs11665996	G	T	5	3	8	0	0	8	0	0
19	16261451	rs166948	A	G	4	2	6	0	0	6	0	0
19	16264771	rs106048	T	C	6	7	13	0	0	13	0	0
19	16265017	rs2258476	C	T	11	5	16	0	1	17	0	0
19	16265494	rs111524	G	A	4	9	13	0	0	13	0	0
19	16268727	rs74965546	G	A	452	433	885	0	8	894	1	0
19	16345822	rs8374	G	A	64	73	137	0	6	143	0	0
19	16438013	rs15336	C	A	793	802	1595	0	6	1601	0	0
19	16438315	rs8810	A	T	99	70	169	0	0	169	0	0
19	16628850	rs17029	G	A	78	41	119	0	3	122	0	0
19	16629189	rs7783	A	G	137	127	264	0	2	266	0	0
19	16631481	rs2303118	C	A	6	6	12	0	0	12	0	0
19	16631776	rs8111801	G	C	1	5	6	0	0	6	0	0
19	16643043	rs8101084	G	A	4	4	8	0	0	8	0	0
19	16660852	.	C	G	59	83	142	0	1	143	0	0
19	16660928	.	G	T	70	81	151	0	2	153	0	0
19	16664264	rs1985857	A	G	171	199	370	0	0	370	0	0
19	16967638	.	C	T	6	6	12	0	0	12	0	0
19	16983253	rs62128037	T	G	3	4	7	0	0	7	0	0
19	16989699	rs77368007	C	T	12	17	29	0	3	32	0	0
19	17163661	rs2305758	C	T	34	28	62	0	5	67	0	0
19	17170885	rs1130222	C	T	24	16	40	0	0	40	0	0
19	17212992	rs3745349	C	T	78	74	152	0	2	154	0	0
19	17214172	rs529384273	G	A	2	12	14	0	0	14	0	0
19	17214833	rs140048224	T	C	2	4	6	0	0	6	0	0
19	17215381	rs4808567	G	A	10	3	13	0	0	13	0	0
19	17215648	rs12977269	G	T	16	2	18	0	0	18	0	0
19	17217207	rs8100351	T	C	6	2	8	0	0	8	0	0
19	17218970	rs4808569	C	A	4	2	6	0	1	7	0	0
19	17220720	rs4808570	G	A	4	8	12	0	0	12	0	0
19	17283768	.	T	C	68	67	135	0	1	136	0	0
19	17293800	rs10411578	G	A	5	1	6	0	0	6	0	0
19	17295023	rs3786515	A	G	16	11	27	0	0	27	0	0
19	17295170	rs10421975	A	G	10	9	19	0	0	19	0	0
19	17295424	rs10425356	G	A	14	8	22	0	0	22	0	0
19	17295516	rs7245842	A	G	18	8	26	0	1	27	0	0
19	17303774	rs1545620	T	G	87	62	149	0	1	150	0	0
19	17305440	rs1064305	T	C	93	72	165	0	0	165	0	0
19	17305781	rs45541337	T	G	108	78	186	0	1	187	0	0
19	17306797	rs11879844	A	G	4	2	6	0	0	6	0	0
19	17307523	rs34413168	A	G	3	3	6	0	1	7	0	0
19	17308105	rs4808596	A	G	9	2	11	0	1	12	0	0
19	17308292	rs75843980	C	A	8	5	13	0	0	13	0	0
19	17314961	rs73931844	C	T	4	6	10	0	0	10	0	0
19	17316261	rs10423542	G	A	4	5	9	0	0	9	0	0
19	17318018	rs17535005	G	A	210	234	444	0	4	448	0	0
19	17320308	rs76331713	C	T	2	5	7	0	0	7	0	0
19	17321462	rs55888795	C	A	14	17	31	0	0	31	0	0
19	17322070	rs111742808	G	A	3	3	6	0	0	6	0	0
19	17322800	rs117297085	T	C	33	15	48	0	0	48	0	0
19	17323426	rs3842959	A	C	107	104	211	0	2	213	0	0
19	17323674	rs56318210	A	T	153	158	311	0	3	314	0	0
19	17326567	rs388484	A	T	5	2	7	0	0	7	0	0
19	17337555	rs3745163	C	A	6	2	8	0	0	8	0	0
19	17337733	rs3745164	C	T	8	5	13	0	0	13	0	0
19	17337871	rs891204	A	G	12	8	20	0	0	20	0	0
19	17337882	rs891203	C	G	13	7	20	0	0	20	0	0
19	17339112	rs14129	G	A	16	23	39	0	1	40	0	0
19	17339411	rs736127	G	T	3	3	6	0	0	6	0	0
19	17339435	rs736128	G	A	4	3	7	0	0	7	0	0
19	17351535	rs2288539	G	A	13	8	21	0	0	21	0	0
19	17379558	rs10424178	C	T	8	4	12	0	0	12	0	0
19	17386464	rs74758437	G	T	6	3	9	0	0	9	0	0
19	17388016	.	T	C	9	1	10	0	0	10	0	0
19	17388065	rs4808613	T	C	4	4	8	0	0	8	0	0
19	17388790	rs56028644	C	T	6	4	10	0	0	10	0	0
19	17388923	rs112582668	C	T	3	3	6	0	0	6	0	0
19	17388938	rs35348255	G	A	4	2	6	0	0	6	0	0
19	17389203	rs138497565	C	T	1	6	7	0	0	7	0	0
19	17389648	rs10406920	C	T	10	12	22	0	0	22	0	0
19	17389704	rs8170	G	A	236	203	439	0	4	443	0	0
19	17394839	rs66753001	A	G	5	5	10	0	0	10	0	0
19	17397244	rs10425939	C	T	10	16	26	0	0	26	0	0
19	17403414	rs113634768	C	G	15	13	28	0	0	28	0	0
19	17412883	rs34272905	G	A	2	5	7	0	0	7	0	0
19	17412947	rs35371421	T	C	3	4	7	0	0	7	0	0
19	17414126	rs3745187	C	T	4	5	9	0	0	9	0	0
19	17417080	rs11548548	C	T	30	51	81	0	2	83	0	0
19	17417565	rs6903	C	T	21	40	61	0	0	61	0	0
19	17421617	.	C	T	3	3	6	0	0	6	0	0
19	17426501	rs3826700	T	G	3	6	9	0	0	9	0	0
19	17430846	rs13238	C	T	176	123	299	0	1	300	0	0
19	17430915	rs10259	G	A	158	171	329	0	3	332	0	0
19	17431362	rs76045424	G	T	8	6	14	0	0	14	0	0
19	17432085	rs113575926	C	T	8	9	17	0	0	17	0	0
19	17432152	rs145531168	G	T	4	7	11	0	0	11	0	0
19	17432153	rs146424375	C	T	4	7	11	0	0	11	0	0
19	17432161	rs2363962	G	A	7	6	13	0	0	13	0	0
19	17435851	rs755124	G	T	13	12	25	0	0	25	0	0
19	17439320	rs76655932	C	T	1	7	8	0	0	8	0	0
19	17441909	rs61734355	T	G	10	3	13	0	0	13	0	0
19	17451189	rs111346509	A	G	5	6	11	0	1	12	0	0
19	17451369	rs60397819	G	T	4	3	7	0	0	7	0	0
19	17452527	rs919333	G	T	50	37	87	0	2	89	0	0
19	17452993	rs113487706	A	G	20	12	32	0	0	32	0	0
19	17453014	rs7508138	G	A	22	15	37	0	0	37	0	0
19	17453366	rs1045010	T	C	24	16	40	0	0	40	0	0
19	17453377	rs9637	C	A	24	17	41	0	0	41	0	0
19	17513926	rs13485	G	C	378	479	857	0	3	861	1	0
19	17516620	rs28413174	C	T	11	7	18	0	1	19	0	0
19	17516628	rs12609479	G	A	6	14	20	0	0	20	0	0
19	17516689	rs12971834	T	C	11	19	30	0	0	30	0	0
19	17516764	rs12979773	C	T	17	21	38	0	2	40	0	0
19	17525314	rs12972417	T	C	6	10	16	0	0	16	0	0
19	17525420	rs10420449	G	A	4	4	8	0	0	8	0	0
19	17525503	rs10422271	C	T	5	5	10	0	0	10	0	0
19	17525586	rs10420713	G	A	8	5	13	0	0	13	0	0
19	17525921	rs10421592	G	A	8	9	17	0	0	17	0	0
19	17526009	rs2364551	C	G	24	17	41	0	0	41	0	0
19	17531450	rs2303680	G	A	5	4	9	0	0	9	0	0
19	17692929	rs8110571	G	A	97	67	164	0	2	166	0	0
19	17837090	rs12975100	C	T	32	22	54	0	0	54	0	0
19	17837512	rs12983721	G	A	26	23	49	0	1	50	0	0
19	17844229	.	G	C	30	56	86	0	1	87	0	0
19	17844637	rs3787026	T	C	4	7	11	0	0	11	0	0
19	17844894	rs7253117	A	G	5	4	9	0	0	9	0	0
19	17861506	rs12980192	A	G	3	19	22	0	0	22	0	0
19	17862131	rs12979056	G	A	5	13	18	0	0	18	0	0
19	17885270	rs2287859	A	G	49	21	70	0	0	70	0	0
19	17885880	rs2287855	C	T	19	43	62	0	1	63	0	0
19	17886940	rs2287854	G	A	24	15	39	0	0	39	0	0
19	17927400	rs1003887	C	T	3	5	8	0	0	8	0	0
19	17935626	rs11888	T	C	19	19	38	0	0	38	0	0
19	17936259	rs73014967	G	A	37	44	81	0	1	82	0	0
19	17936898	.	T	A	11	5	16	0	0	16	0	0
19	17937104	rs3212802	G	T	12	8	20	0	0	20	0	0
19	17947194	rs3212764	T	C	4	4	8	0	0	8	0	0
19	17947409	rs3212762	A	G	6	7	13	0	0	13	0	0
19	17947546	rs3212760	A	G	6	5	11	0	0	11	0	0
19	18186575	rs17852635	G	A	6	3	9	0	0	9	0	0
19	18186618	rs11575934	T	C	9	2	11	0	0	11	0	0
19	18234441	rs740691	C	T	6	4	10	0	0	10	0	0
19	18245512	rs2270623	C	T	7	9	16	0	0	16	0	0
19	18255359	rs8108738	G	A	8	12	20	0	0	20	0	0
19	18257750	rs2072490	C	T	6	8	14	0	0	14	0	0
19	18260840	rs112170279	G	C	16	5	21	0	1	22	0	0
19	18280502	rs117871617	G	A	28	28	56	0	2	58	0	0
19	18285944	rs11554159	G	A	137	142	279	0	2	281	0	0
19	18286546	rs200373	T	A	5	2	7	0	0	7	0	0
19	18288069	rs7125	A	G	162	150	312	0	2	314	0	0
19	18304700	rs874628	A	G	6	9	15	0	0	15	0	0
19	18305824	rs2271881	C	T	15	22	37	0	1	38	0	0
19	18306751	rs62120383	G	A	2	5	7	0	0	7	0	0
19	18306990	rs17683509	G	C	30	22	52	0	1	54	1	0
19	18307108	rs1044821	C	T	28	26	54	0	0	54	0	0
19	18307468	rs1128099	G	A	8	9	17	0	0	17	0	0
19	18311199	rs1046565	A	G	7	5	12	0	0	12	0	0
19	18315629	rs2049050	C	T	4	2	6	0	0	6	0	0
19	18368810	rs999813	G	T	2	5	7	0	0	7	0	0
19	18391171	rs7249	C	T	826	771	1597	0	29	1627	1	0
19	18417154	rs7258697	G	A	5	5	10	0	0	10	0	0
19	18432607	rs116461727	G	A	8	6	14	0	0	14	0	0
19	18474587	rs3746184	T	A	14	18	32	0	0	32	0	0
19	18474888	rs73009437	G	T	13	3	16	0	0	16	0	0
19	18474892	rs73923106	G	T	10	3	13	0	0	13	0	0
19	18474925	rs71332126	G	T	4	7	11	0	0	11	0	0
19	18474941	.	G	T	4	7	11	0	0	11	0	0
19	18475073	rs73009442	C	A	24	16	40	0	0	40	0	0
19	18475304	rs148038170	G	A	18	17	35	0	1	36	0	0
19	18479019	rs28568614	A	G	7	11	18	0	0	18	0	0
19	18479047	rs12610811	C	G	8	19	27	0	0	27	0	0
19	18479647	rs749451	T	C	26	57	83	0	1	84	0	0
19	18480171	rs1043063	C	T	45	37	82	0	1	83	0	0
19	18480609	rs7226	C	T	87	81	168	0	0	168	0	0
19	18497141	rs1059369	T	A	5	9	14	0	0	14	0	0
19	18502075	rs12461382	C	T	42	22	64	0	0	64	0	0
19	18502282	rs145536188	A	G	31	28	59	0	0	59	0	0
19	18502374	rs116399833	C	A	36	19	55	0	1	56	0	0
19	18503194	rs45543339	C	T	5	2	7	0	0	7	0	0
19	18546944	rs145333990	G	A	95	104	199	0	4	203	0	0
19	18964510	rs2238656	G	A	1	5	6	0	0	6	0	0
19	18966824	rs150324027	C	T	65	55	120	0	1	121	0	0
19	18968658	rs7250661	T	C	1	8	9	0	1	10	0	0
19	18970357	rs757114	G	A	4	10	14	0	0	14	0	0
19	18970732	rs4808861	A	G	7	5	12	0	0	12	0	0
19	18973697	rs7257086	T	C	5	1	6	0	0	6	0	0
19	18977937	rs10410987	G	C	79	84	163	0	4	167	0	0
19	19032637	rs2231997	T	C	2	4	6	0	0	6	0	0
19	19041779	rs143249440	T	C	5	1	6	0	0	6	0	0
19	19050957	rs1122821	A	G	8	7	15	0	0	15	0	0
19	19103986	rs3810444	T	A	49	69	118	0	0	118	0	0
19	19104843	rs73006908	C	A	54	56	110	0	1	111	0	0
19	19223252	rs75185638	C	G	21	18	39	0	0	39	0	0
19	19459967	.	G	A	72	59	131	0	0	131	0	0
19	19772852	rs142077949	C	G	3	4	7	0	0	7	0	0
19	19904119	rs116324412	T	A	10	10	20	0	1	21	0	0
19	19976701	rs2304169	A	T	4	6	10	0	0	10	0	0
19	19977273	rs7250258	A	T	4	5	9	0	0	9	0	0
19	19981955	rs28664038	A	T	4	3	7	0	1	8	0	0
19	20003109	rs8106559	A	G	14	10	24	0	0	24	0	0
19	20019931	rs11878883	G	A	2	13	15	0	0	15	0	0
19	20020876	rs8108528	T	C	4	23	27	0	0	27	0	0
19	20021046	rs13344370	C	T	6	19	25	0	0	25	0	0
19	20044886	rs10401345	T	C	31	15	46	0	1	47	0	0
19	20046102	rs10407807	C	A	49	38	87	0	0	87	0	0
19	20046147	rs1048421	G	A	47	34	81	0	0	81	0	0
19	20046796	rs10414795	G	A	4	3	7	0	0	7	0	0
19	20046926	rs10416399	T	C	8	2	10	0	0	10	0	0
19	20230264	rs1654275	T	A	3	4	7	0	1	8	0	0
19	20230492	rs1627721	C	T	8	5	13	0	1	14	0	0
19	20235929	rs1654280	G	A	4	3	7	0	0	7	0	0
19	20236764	rs1654281	C	A	3	8	11	0	0	11	0	0
19	20237611	rs1626334	C	T	11	17	28	0	0	28	0	0
19	20280148	rs1725907	C	G	3	3	6	0	0	6	0	0
19	20284132	rs836892	C	T	3	4	7	0	0	7	0	0
19	20286078	rs836895	C	T	3	3	6	0	0	6	0	0
19	20309702	rs836903	T	C	16	16	32	0	0	32	0	0
19	20310134	rs836904	G	A	26	10	36	0	0	36	0	0
19	20959168	rs7251612	C	G	3	3	6	0	0	6	0	0
19	20959177	rs7251614	C	G	4	3	7	0	0	7	0	0
19	21474935	rs28688205	C	T	42	32	74	0	1	75	0	0
19	21475297	rs7246339	T	C	23	29	52	0	1	53	0	0
19	21477403	rs1781872	T	G	17	26	43	0	1	44	0	0
19	21477431	rs1781873	T	C	27	15	42	0	0	42	0	0
19	21503891	rs11882553	A	C	3	17	20	0	0	20	0	0
19	21504032	rs61445561	A	G	4	2	6	0	0	6	0	0
19	21504128	rs57299552	C	T	6	2	8	0	0	8	0	0
19	21512191	rs62107534	C	G	10	6	16	0	0	16	0	0
19	21544571	rs1142653	G	A	27	34	61	0	0	61	0	0
19	21566195	rs55875743	G	T	5	5	10	0	0	10	0	0
19	21566680	rs7254436	C	G	10	2	12	0	0	12	0	0
19	21567360	rs1827225	A	G	8	8	16	0	1	17	0	0
19	21585284	rs62110418	A	G	4	3	7	0	0	7	0	0
19	21586236	rs8107999	T	C	4	3	7	0	0	7	0	0
19	21586797	rs7249412	C	T	2	7	9	0	0	9	0	0
19	21587918	rs7254059	G	T	5	3	8	0	0	8	0	0
19	21589126	rs6511239	C	T	5	3	8	0	0	8	0	0
19	21589179	rs10424079	G	A	7	8	15	0	0	15	0	0
19	21590636	rs2359144	C	T	5	2	7	0	0	7	0	0
19	21591035	rs12983787	C	T	2	6	8	0	0	8	0	0
19	21596327	rs35773446	G	A	7	4	11	0	0	11	0	0
19	21625454	rs2562428	G	C	8	7	15	0	0	15	0	0
19	21626540	rs35761227	C	T	5	8	13	0	0	13	0	0
19	21630108	rs35994743	C	T	18	18	36	0	0	36	0	0
19	21630768	rs9973240	C	T	11	11	22	0	1	23	0	0
19	21630798	rs2650814	C	T	13	14	27	0	0	28	1	0
19	21631304	rs2562421	T	G	4	5	9	0	0	9	0	0
19	21631305	rs2562420	T	A	4	5	9	0	0	9	0	0
19	21631409	rs924487	T	G	16	6	22	0	0	22	0	0
19	21688473	rs62108288	C	A	17	14	31	0	0	31	0	0
19	21688495	rs73017722	C	T	17	19	36	0	0	36	0	0
19	21688602	rs10420016	C	G	6	7	13	0	0	13	0	0
19	21769377	rs143015070	G	C	0	19	19	0	0	19	0	0
19	21860597	rs12461329	G	T	56	185	241	0	0	241	0	0
19	21860723	rs12973337	G	A	53	170	223	0	0	223	0	0
19	21860793	rs12973147	C	G	59	133	192	0	0	192	0	0
19	21860974	rs12975447	T	G	17	87	104	0	0	104	0	0
19	21907214	rs61544147	C	G	5	4	9	0	0	9	0	0
19	21910451	rs35587380	A	C	17	20	37	0	0	37	0	0
19	21911116	rs12982134	G	A	5	1	6	0	0	6	0	0
19	21927243	rs35923238	C	T	4	2	6	0	0	6	0	0
19	21939143	rs35110018	C	T	2	4	6	0	0	6	0	0
19	21939145	rs34617884	T	A	2	4	6	0	0	6	0	0
19	21950058	rs36097084	G	A	8	18	26	0	0	26	0	0
19	22017492	rs10420548	T	C	4	5	9	0	0	9	0	0
19	22235307	rs415291	C	G	5	9	14	0	0	14	0	0
19	22243422	rs10423881	G	A	11	27	38	0	0	38	0	0
19	22246913	rs8104144	T	C	10	31	41	0	0	41	0	0
19	22246952	rs8103518	G	C	11	26	37	0	0	37	0	0
19	22272397	rs62111028	A	T	19	2	21	0	0	21	0	0
19	22272615	rs10417916	T	C	10	2	12	0	0	12	0	0
19	22272845	rs4932955	T	A	3	7	10	0	0	10	0	0
19	22273797	rs4932956	T	G	2	5	7	0	0	7	0	0
19	22574818	rs201005223	T	C	10	5	15	0	1	16	0	0
19	22575488	rs7247735	C	T	10	3	13	0	0	13	0	0
19	22586192	rs1368476	A	G	19	11	30	0	0	30	0	0
19	22605103	rs11669353	G	C	4	6	10	0	0	10	0	0
19	22605120	rs11669356	G	T	4	4	8	0	0	8	0	0
19	22697177	rs12609304	G	A	10	1	11	0	0	11	0	0
19	23284350	rs1473419	C	T	3	3	6	0	0	6	0	0
19	23303700	.	C	T	3	3	6	0	0	6	0	0
19	23404423	rs4932834	C	T	9	13	22	0	2	24	0	0
19	23405457	rs10411741	T	G	13	4	17	0	1	18	0	0
19	23405580	rs10412126	T	C	17	9	26	0	0	26	0	0
19	23406742	rs117473206	T	G	5	1	6	0	0	6	0	0
19	23406801	rs8110795	G	C	7	4	11	0	0	11	0	0
19	23433107	rs10405424	G	C	4	4	8	0	0	8	0	0
19	23438039	rs295357	T	A	11	6	17	0	4	21	0	0
19	23438530	rs77827419	T	C	13	13	26	0	1	27	0	0
19	23438838	rs295356	T	C	11	11	22	0	0	22	0	0
19	23441936	rs295367	T	C	5	2	7	0	0	7	0	0
19	23442527	rs295366	G	A	7	3	10	0	0	10	0	0
19	23444483	rs3180232	A	T	26	22	48	0	0	48	0	0
19	23542201	rs377238175	T	G	3	9	12	0	0	12	0	0
19	23542271	.	C	T	9	1	10	0	1	11	0	0
19	23835401	rs12971987	G	A	5	5	10	0	0	10	0	0
19	23837145	rs11671053	A	G	28	24	52	0	0	52	0	0
19	23842501	rs12609935	G	C	6	5	11	0	0	11	0	0
19	23842566	rs8100146	G	A	3	8	11	0	0	11	0	0
19	23865653	rs12971879	C	T	2	14	16	0	0	16	0	0
19	24009993	rs34364867	G	T	251	0	251	0	11	262	0	0
19	24223649	rs117810864	G	A	10	3	13	0	0	13	0	0
19	28221474	rs10408331	C	T	4	4	8	0	0	8	0	0
19	28391946	rs6510401	G	A	6	0	6	0	0	6	0	0
19	29282427	rs16961899	A	G	2	4	6	0	0	6	0	0
19	29700345	rs74654030	A	T	8	1	9	0	0	9	0	0
19	29703089	rs10420904	C	T	7	9	16	0	0	16	0	0
19	30106659	rs7283	G	A	8	9	17	0	0	17	0	0
19	30192475	rs9566	G	A	9	5	14	0	0	14	0	0
19	30192505	rs1048123	G	C	12	5	17	0	0	17	0	0
19	30192599	rs1140197	G	T	12	4	16	0	0	17	1	0
19	30192738	rs3926	C	T	5	4	9	0	0	9	0	0
19	30193182	rs1048104	G	C	10	8	18	0	0	18	0	0
19	30193721	rs10424582	G	A	6	10	16	0	0	16	0	0
19	30308385	rs3218045	T	C	27	36	63	0	0	63	0	0
19	30314666	rs7257694	C	T	38	53	91	0	0	91	0	0
19	30433514	.	T	A	61	0	61	0	6	67	0	0
19	30434063	rs1990904	G	C	4	6	10	0	0	10	0	0
19	30504816	rs10756	T	C	7	19	26	0	0	26	0	0
19	30505697	rs75312381	T	C	3	4	7	0	0	7	0	0
19	30506306	rs75998333	T	A	32	64	96	0	1	97	0	0
19	31829903	rs924150	A	C	1	5	6	0	0	6	0	0
19	32874722	rs7248160	T	A	7	7	14	0	0	14	0	0
19	32874725	rs2111503	G	A	7	7	14	0	0	14	0	0
19	32877125	rs12596	G	A	18	16	34	0	0	34	0	0
19	32877259	rs3746016	T	C	4	6	10	0	0	10	0	0
19	32903654	rs61407864	G	A	5	2	7	0	0	7	0	0
19	32930069	rs6510249	G	A	5	4	9	0	0	9	0	0
19	32959453	rs7254107	C	T	4	2	6	0	0	6	0	0
19	32973077	rs7253039	C	T	10	15	25	0	2	27	0	0
19	32974298	rs3746017	C	T	7	2	9	0	0	9	0	0
19	32974738	rs1057395	A	T	9	8	17	0	1	18	0	0
19	32974913	rs1057397	A	G	4	3	7	0	1	8	0	0
19	33072118	rs11084660	C	G	34	43	77	0	0	77	0	0
19	33073431	rs4499344	G	A	2	4	6	0	0	6	0	0
19	33074614	rs34040260	A	C	5	3	8	0	0	8	0	0
19	33075134	rs17833075	G	C	8	2	10	0	0	10	0	0
19	33076973	rs10500262	T	A	7	7	14	0	0	14	0	0
19	33088366	rs2277927	T	C	45	39	84	0	0	84	0	0
19	33098632	rs2302970	G	C	21	11	32	0	0	32	0	0
19	33100338	rs7250272	T	C	2	4	6	0	0	6	0	0
19	33106621	rs405858	C	T	12	19	31	0	1	32	0	0
19	33110204	rs2287669	T	C	14	28	42	0	0	42	0	0
19	33117666	rs6510271	T	C	19	15	34	0	0	34	0	0
19	33126778	rs4805789	T	C	2	4	6	0	0	6	0	0
19	33127022	rs4805790	T	C	0	7	7	0	0	7	0	0
19	33127138	rs4805791	C	T	1	6	7	0	0	7	0	0
19	33182320	rs881273	G	A	7	6	13	0	0	13	0	0
19	33183669	rs6510277	C	A	5	2	7	0	0	7	0	0
19	33203675	rs11879169	A	G	11	20	31	0	0	31	0	0
19	33204251	rs34870938	G	C	38	27	65	0	1	66	0	0
19	33204544	rs1061686	T	C	8	13	21	0	0	21	0	0
19	33370070	rs745961	A	G	8	1	9	0	0	9	0	0
19	33370084	rs745960	T	A	10	2	12	0	0	12	0	0
19	33370161	rs745959	A	C	7	2	9	0	0	9	0	0
19	33414420	rs4805825	A	G	2	4	6	0	0	6	0	0
19	33444707	rs10411735	C	T	9	8	17	0	1	18	0	0
19	33460196	rs34821689	C	T	11	9	20	0	0	20	0	0
19	33460536	rs2404713	A	G	4	5	9	0	0	9	0	0
19	33461109	rs934419	C	T	5	6	11	0	0	11	0	0
19	33463245	rs11084686	A	G	3	7	10	0	0	10	0	0
19	33467357	rs2304102	G	A	5	2	7	0	0	7	0	0
19	33468160	rs73037461	A	C	3	11	14	0	0	14	0	0
19	33605312	rs10421769	T	C	5	7	12	0	0	12	0	0
19	33608733	rs2287681	C	A	5	7	12	0	0	12	0	0
19	33695885	rs139036056	T	G	3	4	7	0	0	7	0	0
19	33696897	rs11084712	C	T	85	60	145	0	1	146	0	0
19	33699718	.	A	C	18	8	26	0	0	26	0	0
19	33791127	rs12691	G	A	383	409	792	0	7	799	0	0
19	33791529	rs707656	G	C	587	478	1065	0	10	1076	1	0
19	33791807	rs1049969	T	C	247	215	462	0	3	465	0	0
19	33865323	rs79824755	G	T	0	8	8	0	1	9	0	0
19	33869175	rs16968029	C	T	4	3	7	0	0	7	0	0
19	33870906	rs76738473	T	C	21	12	33	0	0	33	0	0
19	33872125	rs115732024	T	G	17	15	32	0	0	32	0	0
19	33872150	rs117236383	G	C	19	16	35	0	0	35	0	0
19	33872410	rs3745968	A	G	15	21	36	0	0	36	0	0
19	33878039	rs3556	A	G	61	66	127	0	1	128	0	0
19	33878198	rs1061338	A	G	85	116	201	0	2	203	0	0
19	33878837	rs17570	G	A	47	61	108	0	0	108	0	0
19	34666389	rs580137	A	G	4	6	10	0	0	10	0	0
19	34717674	rs670286	T	G	3	6	9	0	0	9	0	0
19	34883100	.	T	G	20	1	21	0	0	21	0	0
19	34883104	.	T	A	20	1	21	0	0	21	0	0
19	34883110	.	C	A	20	0	20	0	0	20	0	0
19	34883112	.	C	A	20	0	20	0	0	20	0	0
19	34883113	.	C	A	21	0	21	0	0	21	0	0
19	34883114	.	T	G	21	0	21	0	0	21	0	0
19	34883127	.	A	G	24	0	24	0	0	24	0	0
19	35168172	rs2290654	A	G	3	3	6	0	0	6	0	0
19	35169295	rs3179420	T	C	3	3	6	0	0	6	0	0
19	35175208	rs2290652	A	G	14	11	25	0	0	25	0	0
19	35175775	rs11543232	C	T	19	23	42	0	0	42	0	0
19	35175877	rs117665320	G	A	24	21	45	0	0	45	0	0
19	35307193	rs12982419	G	A	2	4	6	0	0	6	0	0
19	35454604	rs2546028	A	C	25	15	40	0	0	40	0	0
19	35454605	rs2546029	A	G	25	15	40	0	0	40	0	0
19	35495400	rs73038362	G	A	5	7	12	0	0	12	0	0
19	35505164	.	G	A	113	82	195	0	5	201	1	0
19	35513050	rs66984916	G	A	3	5	8	0	0	8	0	0
19	35513123	rs66892261	C	T	4	4	8	0	0	8	0	0
19	35513142	rs2290644	G	C	4	5	9	0	0	9	0	0
19	35513237	rs66528626	T	C	2	5	7	0	0	7	0	0
19	35513553	rs57030435	A	G	5	1	6	0	0	6	0	0
19	35514545	rs3761075	A	G	1	5	6	0	0	6	0	0
19	35514593	rs60137717	C	A	2	7	9	0	0	9	0	0
19	35514811	rs73038399	C	T	5	2	7	0	0	7	0	0
19	35516288	rs77992361	C	T	2	4	6	0	0	6	0	0
19	35516329	rs113026725	G	T	2	4	6	0	0	6	0	0
19	35516422	rs73038402	A	G	7	2	9	0	0	9	0	0
19	35516458	rs11879585	T	C	3	6	9	0	0	9	0	0
19	35530737	rs2278995	T	C	3	7	10	0	1	11	0	0
19	35530781	rs2278996	A	C	4	9	13	0	0	13	0	0
19	35648365	rs1688005	T	G	1229	1340	2569	0	23	2594	2	0
19	35650593	rs4806093	G	A	4	8	12	0	0	12	0	0
19	35652248	rs1627280	G	A	6	14	20	0	0	20	0	0
19	35653642	rs2901967	A	G	5	7	12	0	1	13	0	0
19	35658380	rs12461097	T	G	9	10	19	0	2	21	0	0
19	35658622	rs11084801	C	G	10	11	21	0	0	21	0	0
19	35658628	rs11084802	T	C	11	12	23	0	1	24	0	0
19	35658728	rs11084803	C	T	7	16	23	0	0	23	0	0
19	35658759	rs12611051	C	T	10	15	25	0	1	26	0	0
19	35658951	rs12609891	A	G	5	5	10	0	1	11	0	0
19	35659379	rs12978479	T	C	4	5	9	0	0	9	0	0
19	35660450	rs2285515	T	C	14	24	38	0	0	38	0	0
19	35660546	rs1046294	T	C	1751	1514	3265	0	13	3278	0	0
19	35660670	rs3458	G	A	766	898	1664	0	4	1668	0	0
19	35660752	rs1046345	C	T	225	191	416	0	2	418	0	0
19	35741456	rs2073900	T	C	12	17	29	0	0	29	0	0
19	35757427	rs34259399	G	A	25	12	37	0	2	39	0	0
19	35764978	rs117966332	G	A	10	6	16	0	0	16	0	0
19	35765041	rs2284147	G	A	13	10	23	0	0	23	0	0
19	35765424	rs2284148	G	C	3	6	9	0	0	9	0	0
19	35768155	rs73030000	G	A	14	8	22	0	0	22	0	0
19	35837694	rs73031792	C	T	22	7	29	0	0	29	0	0
19	35837705	rs35529786	A	G	7	22	29	0	0	29	0	0
19	35850560	.	G	A	18	31	49	0	0	49	0	0
19	35850672	.	T	C	13	0	13	0	0	13	0	0
19	35850914	rs10425675	C	T	4	7	11	0	0	11	0	0
19	35940919	rs61744093	G	A	5	8	13	0	0	13	0	0
19	35941993	rs55695970	G	A	14	5	19	0	0	19	0	0
19	36032301	rs2239944	A	G	14	15	29	0	0	29	0	0
19	36033460	rs2239945	C	T	4	4	8	0	0	8	0	0
19	36038390	rs7599	A	G	90	104	194	0	2	196	0	0
19	36122441	rs2285415	G	A	2	4	6	0	0	6	0	0
19	36123403	rs2239914	T	C	1	5	6	0	0	6	0	0
19	36207510	rs1052491	G	A	7	3	10	0	0	10	0	0
19	36210405	.	C	T	14	15	29	0	0	29	0	0
19	36213461	rs11084828	C	T	3	10	13	0	0	13	0	0
19	36218478	rs11670414	C	T	20	19	39	0	0	39	0	0
19	36220430	rs66747537	A	G	15	20	35	0	0	35	0	0
19	36224705	rs231591	A	G	100	103	203	0	1	204	0	0
19	36224973	rs17776911	T	C	3	3	6	0	0	6	0	0
19	36229500	.	C	T	149	137	286	0	1	287	0	0
19	36229643	rs3848664	C	T	79	76	155	0	0	155	0	0
19	36233470	rs3746278	G	A	39	29	68	0	2	70	0	0
19	36234652	rs17638853	T	C	19	17	36	0	2	38	0	0
19	36236000	rs2293687	C	A	44	13	57	0	0	57	0	0
19	36253317	rs807479	C	T	5	1	6	0	0	6	0	0
19	36259494	rs231216	C	A	11	6	17	0	3	20	0	0
19	36260111	rs231214	T	C	31	18	49	0	0	49	0	0
19	36260872	rs56693576	T	A	15	12	27	0	1	28	0	0
19	36260996	rs57770499	G	A	26	8	34	0	1	35	0	0
19	36261373	rs2619197	C	T	32	29	61	0	0	61	0	0
19	36261928	rs10420134	A	G	5	13	18	0	1	19	0	0
19	36276403	rs120959	T	G	8	4	12	0	0	12	0	0
19	36276767	rs120960	A	G	4	5	9	0	0	9	0	0
19	36278470	rs231235	C	G	20	7	27	0	0	27	0	0
19	36395169	.	A	G	125	132	257	0	1	258	0	0
19	36487146	rs7925	A	G	19	11	30	0	0	30	0	0
19	36523759	rs62109714	G	T	5	6	11	0	0	11	0	0
19	36549690	rs11538454	C	T	15	18	33	0	1	34	0	0
19	36558113	rs12608517	T	C	2	5	7	0	0	7	0	0
19	36574063	rs45567532	C	T	17	14	31	0	0	31	0	0
19	36575645	rs2301734	G	A	10	11	21	0	1	22	0	0
19	36583651	rs61494900	G	A	26	17	43	0	0	43	0	0
19	36584904	rs2301737	C	T	4	2	6	0	0	6	0	0
19	36590329	rs2285745	T	C	18	27	45	0	0	45	0	0
19	36593088	rs117696985	G	A	8	13	21	0	0	21	0	0
19	36594063	rs17851502	C	T	45	43	88	0	0	88	0	0
19	36594659	rs2074435	A	T	62	70	132	0	1	133	0	0
19	36605647	rs2227260	T	C	5	14	19	0	0	19	0	0
19	36605794	rs2231568	C	T	35	17	52	0	0	52	0	0
19	36610190	rs4555271	G	A	4	2	6	0	0	6	0	0
19	36616394	.	T	A	345	306	651	0	3	654	0	0
19	36640769	rs14100	T	C	1021	1412	2433	0	79	2515	3	0
19	36674305	rs4805162	A	G	1	5	6	0	0	6	0	0
19	36727365	rs2070132	G	A	29	45	74	0	0	74	0	0
19	36728290	rs4806293	A	G	65	49	114	0	3	117	0	0
19	36806866	.	T	C	13	2	15	0	0	15	0	0
19	36806870	.	G	C	14	2	16	0	0	16	0	0
19	36806871	.	A	T	12	2	14	0	2	16	0	0
19	36807249	.	A	T	5	2	7	0	0	7	0	0
19	36807255	.	G	A	5	1	6	0	0	6	0	0
19	36807717	rs34218717	C	T	4	5	9	0	0	9	0	0
19	36813084	rs2972632	A	G	12	23	35	0	0	35	0	0
19	36821198	rs3111556	T	G	58	68	126	0	3	129	0	0
19	36821209	rs3098393	A	G	56	72	128	0	2	130	0	0
19	36883444	rs2945961	T	C	12	3	15	0	0	15	0	0
19	36940760	rs2967532	G	T	12	6	18	0	0	18	0	0
19	36981816	rs3111551	T	G	5	1	6	0	0	6	0	0
19	37004737	rs17238977	T	A	15	7	22	0	0	22	0	0
19	37007542	rs2967434	A	G	4	6	10	0	0	10	0	0
19	37007707	rs145434095	C	T	5	2	7	0	0	7	0	0
19	37035534	.	T	G	3	11	14	0	0	14	0	0
19	37035923	rs61259689	C	T	23	16	39	0	0	39	0	0
19	37036003	rs61396420	T	G	14	14	28	0	0	28	0	0
19	37036068	rs3096637	T	G	7	13	20	0	0	20	0	0
19	37036345	rs2912443	C	T	19	14	33	0	0	33	0	0
19	37038092	rs2278168	T	C	29	30	59	0	0	59	0	0
19	37039069	rs2912444	A	C	64	52	116	0	0	116	0	0
19	37040013	rs2912446	C	A	21	19	40	0	0	40	0	0
19	37065732	rs2912406	A	C	19	15	34	0	1	35	0	0
19	37070243	rs3096620	G	A	6	0	6	0	0	6	0	0
19	37071639	rs2967470	C	T	8	5	13	0	0	13	0	0
19	37085354	rs55634974	T	G	20	13	33	0	0	33	0	0
19	37085469	rs2967427	A	G	20	15	35	0	1	36	0	0
19	37180297	rs17272386	A	G	12	0	12	0	0	12	0	0
19	37210529	rs3108200	A	G	41	32	73	0	0	73	0	0
19	37237338	rs826985	C	T	16	23	39	0	0	39	0	0
19	37237710	rs826986	C	G	11	9	20	0	0	20	0	0
19	37238081	rs826987	C	T	7	4	11	0	0	11	0	0
19	37820230	rs62109235	G	A	8	7	15	0	0	15	0	0
19	37881411	rs183997065	G	A	33	26	59	0	2	61	0	0
19	37882486	.	A	T	3	7	10	0	1	11	0	0
19	37882490	.	A	T	3	7	10	0	1	11	0	0
19	37935859	.	A	G	31	21	52	0	0	52	0	0
19	38055681	.	C	T	55	45	100	0	0	100	0	0
19	38576657	rs1654356	A	C	6	3	9	0	1	10	0	0
19	38652993	rs332864	C	T	12	14	26	0	1	27	0	0
19	38673353	rs61729145	G	A	6	10	16	0	0	16	0	0
19	38697054	rs3745946	G	A	12	11	23	0	0	23	0	0
19	38698260	rs11881219	C	T	8	14	22	0	0	22	0	0
19	38794895	rs2304176	T	C	2	8	10	0	0	10	0	0
19	38798086	rs3178327	T	C	194	211	405	0	3	409	1	0
19	38800165	rs3900981	C	T	291	326	617	0	2	619	0	0
19	38817486	rs3745951	T	C	24	60	84	0	0	84	0	0
19	38817876	rs34989303	G	A	39	51	90	0	0	90	0	0
19	38818299	rs3745952	C	T	64	83	147	0	6	153	0	0
19	38818751	rs931750	T	C	61	87	148	0	2	150	0	0
19	38818925	rs931749	C	T	53	79	132	0	0	132	0	0
19	38819098	rs73041302	A	G	41	56	97	0	0	97	0	0
19	38819463	rs61160177	C	G	35	32	67	0	0	67	0	0
19	38827960	rs2302182	T	C	5	3	8	0	0	8	0	0
19	38839732	rs4804046	G	T	7	3	10	0	0	10	0	0
19	38853659	rs11666449	C	T	3	4	7	0	0	7	0	0
19	38861333	rs1052375	G	A	3	4	7	0	0	7	0	0
19	38872778	rs1131182	C	T	812	617	1429	0	9	1439	1	0
19	38910063	rs12611194	T	C	4	4	8	0	0	8	0	0
19	38912764	rs892055	A	G	81	59	140	0	3	143	0	0
19	39100737	rs13345885	A	G	5	6	11	0	0	11	0	0
19	39101669	rs2287733	A	G	4	2	6	0	0	6	0	0
19	39119494	rs12976749	A	C	2	6	8	0	0	8	0	0
19	39122276	.	A	G	6	5	11	0	1	12	0	0
19	39122923	rs1862371	T	C	14	8	22	0	1	23	0	0
19	39126466	rs3786834	T	G	4	2	6	0	0	6	0	0
19	39204981	rs117968873	T	A	31	26	57	0	0	57	0	0
19	39306425	rs2075588	A	C	13	17	30	0	2	32	0	0
19	39306803	rs2075587	G	C	34	18	52	0	1	53	0	0
19	39307103	rs2229259	C	T	673	524	1197	0	6	1203	0	0
19	39308602	rs10426289	T	C	5	1	6	0	0	6	0	0
19	39322087	rs9419	T	G	471	478	949	0	5	954	0	0
19	39326754	rs2318459	G	C	4	4	8	0	0	8	0	0
19	39326809	rs2318460	G	C	2	4	6	0	0	6	0	0
19	39327856	rs2278009	A	T	17	23	40	0	0	40	0	0
19	39328145	rs2278010	A	C	16	11	27	0	0	27	0	0
19	39330058	rs10403012	A	G	9	15	24	0	0	24	0	0
19	39334811	rs2278011	T	A	25	15	40	0	0	40	0	0
19	39334830	rs2278012	C	T	24	17	41	0	0	41	0	0
19	39335274	rs7255774	T	C	25	26	51	0	0	51	0	0
19	39335744	rs55932233	A	G	17	10	27	0	0	27	0	0
19	39338125	rs862454	G	A	17	13	30	0	0	30	0	0
19	39338142	rs862455	A	G	17	14	31	0	0	31	0	0
19	39338496	.	T	C	22	18	40	0	0	40	0	0
19	39338663	rs862456	G	A	20	10	30	0	0	30	0	0
19	39338865	rs862457	G	C	12	12	24	0	1	25	0	0
19	39367111	rs1001413	T	C	5	3	8	0	0	8	0	0
19	39369369	rs2015	T	G	123	140	263	0	8	271	0	0
19	39372244	rs2082435	C	G	5	9	14	0	0	14	0	0
19	39394915	rs8108039	C	T	4	7	11	0	0	11	0	0
19	39399277	rs3136646	C	T	118	143	261	0	0	261	0	0
19	39819527	rs3837980	C	A	25	17	42	0	0	42	0	0
19	39819802	rs28668750	G	T	4	6	10	0	0	10	0	0
19	39821080	rs34615060	G	A	4	4	8	0	0	8	0	0
19	39824955	rs12975430	C	G	5	1	6	0	0	6	0	0
19	39826479	rs3786949	G	A	9	16	25	0	1	26	0	0
19	39835498	rs30458	A	G	10	8	18	0	0	18	0	0
19	39840549	rs30457	C	G	5	8	13	0	0	13	0	0
19	39840701	rs30456	T	A	7	3	10	0	0	10	0	0
19	39842396	rs55811458	G	A	14	7	21	0	0	21	0	0
19	39843285	rs34677348	C	G	13	8	21	0	0	21	0	0
19	39843623	rs30455	G	A	12	7	19	0	0	19	0	0
19	39844176	rs30454	G	A	3	4	7	0	0	7	0	0
19	39845544	rs30453	T	G	7	1	8	0	0	8	0	0
19	39847132	rs11669586	C	T	5	5	10	0	0	10	0	0
19	39849789	rs562638	A	G	13	5	18	0	0	18	0	0
19	39850102	rs685125	T	C	2	4	6	0	0	6	0	0
19	39858948	.	C	G	3	4	7	0	0	7	0	0
19	39870528	rs11667792	C	G	4	3	7	0	0	7	0	0
19	39874945	rs36270	T	C	137	130	267	0	2	269	0	0
19	39878006	rs40441	G	A	7	4	11	0	0	11	0	0
19	39886177	rs10402122	G	A	3	3	6	0	0	6	0	0
19	39886196	rs10403504	T	C	3	3	6	0	0	6	0	0
19	39886218	rs1629174	G	A	4	3	7	0	0	7	0	0
19	39889044	rs10423565	A	T	36	48	84	0	2	86	0	0
19	39889691	rs10425594	G	A	57	51	108	0	0	108	0	0
19	39890030	rs35070003	C	T	49	54	103	0	4	107	0	0
19	39891161	rs10414216	T	C	5	2	7	0	1	8	0	0
19	39898667	rs3746083	C	T	1250	1244	2494	0	57	2551	0	0
19	39913634	rs10407035	G	A	35	43	78	0	2	80	0	0
19	39918483	rs75283644	G	T	18	19	37	0	0	37	0	0
19	39918600	rs148962475	C	T	14	17	31	0	0	31	0	0
19	39923952	rs17627	G	A	3467	3571	7038	0	19	7058	1	0
19	39925056	rs74712803	A	G	59	63	122	0	1	123	0	0
19	39957563	rs144798894	A	G	7	5	12	0	0	12	0	0
19	39965235	.	G	A	251	252	503	0	66	569	0	0
19	39965670	rs76779297	G	T	9	12	21	0	0	21	0	0
19	39976043	rs56145082	C	G	7	4	11	0	0	11	0	0
19	39976278	rs115056647	C	T	2	4	6	0	0	6	0	0
19	39981786	rs11880201	G	C	12	11	23	0	0	23	0	0
19	39983405	rs74381372	G	A	17	10	27	0	0	27	0	0
19	40021759	rs17795475	T	G	7	4	11	0	0	11	0	0
19	40021803	rs17641508	C	T	4	5	9	0	0	9	0	0
19	40030654	rs76765165	G	C	18	11	29	0	0	29	0	0
19	40030704	rs7252027	C	T	20	31	51	0	0	51	0	0
19	40222408	rs2074926	C	T	68	71	139	0	0	139	0	0
19	40223272	rs62121702	G	A	5	4	9	0	0	9	0	0
19	40223550	rs62121704	A	C	5	5	10	0	0	10	0	0
19	40224297	rs389708	T	A	73	69	142	0	0	142	0	0
19	40226710	rs2238678	C	G	19	21	40	0	0	40	0	0
19	40226728	rs1985359	G	A	18	20	38	0	0	38	0	0
19	40228436	rs368009	C	G	9	13	22	0	0	22	0	0
19	40228437	rs395969	C	T	11	13	24	0	0	24	0	0
19	40448598	rs3887030	G	A	7	7	14	0	0	14	0	0
19	40485230	rs234340	G	A	5	3	8	0	0	8	0	0
19	40742105	rs2304188	T	C	10	11	21	0	1	22	0	0
19	40742320	rs2304189	T	C	4	2	6	0	0	6	0	0
19	40788641	rs11880261	T	C	6	0	6	0	0	6	0	0
19	40790059	rs118098588	G	C	5	3	8	0	0	8	0	0
19	40871801	rs10417488	T	A	24	19	43	0	0	43	0	0
19	40872964	rs7258698	G	A	3	3	6	0	1	7	0	0
19	40964447	.	C	T	176	139	315	0	4	319	0	0
19	41082868	rs16974365	T	C	106	123	229	0	4	233	0	0
19	41086309	rs11555272	G	C	221	194	415	0	2	417	0	0
19	41089082	rs62107874	G	A	5	8	13	0	0	13	0	0
19	41089390	rs890935	G	C	248	179	427	0	3	430	0	0
19	41090260	rs413901	C	G	4	2	6	0	1	7	0	0
19	41091145	rs404584	A	G	3	3	6	0	0	6	0	0
19	41094838	rs393569	A	G	51	63	114	0	0	114	0	0
19	41095782	.	A	C	15	4	19	0	1	20	0	0
19	41095818	rs392726	T	C	14	6	20	0	0	20	0	0
19	41096189	rs396118	A	G	107	137	244	0	2	246	0	0
19	41097276	rs7171	C	G	110	90	200	0	2	202	0	0
19	41116251	rs919307	G	C	2	9	11	0	0	11	0	0
19	41117869	rs1131620	A	G	1	12	13	0	0	13	0	0
19	41118056	rs1051303	A	G	2	16	18	0	0	18	0	0
19	41129842	rs7367	C	T	4	47	51	0	0	51	0	0
19	41173880	rs2604901	C	T	4	9	13	0	0	13	0	0
19	41209477	rs11538385	C	T	30	27	57	0	0	57	0	0
19	41211056	rs3865452	T	C	40	35	75	0	0	75	0	0
19	41223769	.	G	T	20	12	32	0	0	32	0	0
19	41244887	rs2607420	G	A	3	5	8	0	0	8	0	0
19	41245742	rs2290693	C	T	15	21	36	0	0	36	0	0
19	41246378	rs2290692	G	C	36	12	48	0	0	48	0	0
19	41247114	rs11548478	A	G	9	9	18	0	0	18	0	0
19	41255500	rs2254343	C	G	14	10	24	0	0	24	0	0
19	41256131	rs1870087	G	T	11	7	18	0	0	18	0	0
19	41257176	rs1457141	G	C	101	118	219	0	3	222	0	0
19	41265315	.	G	A	4	2	6	0	0	6	0	0
19	41332832	rs73048932	A	G	3	5	8	0	0	8	0	0
19	41333284	rs11878604	T	C	2	6	8	0	1	9	0	0
19	41712424	rs338583	A	G	17	30	47	0	0	47	0	0
19	41712941	rs8192798	C	A	45	65	110	0	0	110	0	0
19	41782194	rs144718578	C	T	464	388	852	0	2	854	0	0
19	41818545	rs117953671	T	G	5	1	6	0	0	6	0	0
19	41836419	.	C	T	14	7	21	0	0	21	0	0
19	41847860	rs1800472	G	A	781	741	1522	0	42	1564	0	0
19	41889748	rs12602	T	C	31	28	59	0	1	60	0	0
19	41897674	rs878082	G	A	5	1	6	0	0	6	0	0
19	41897688	rs878083	G	A	5	1	6	0	0	6	0	0
19	41903220	rs10853751	G	A	70	58	128	0	0	128	0	0
19	41926098	rs166925	T	C	6	0	6	0	0	6	0	0
19	41928652	rs284652	C	T	151	146	297	0	2	299	0	0
19	41928701	rs284653	C	T	11	13	24	0	0	24	0	0
19	41928724	rs284654	G	A	8	11	19	0	0	19	0	0
19	41928765	rs284655	C	T	6	3	9	0	0	9	0	0
19	41929251	rs284656	T	C	3	3	6	0	0	6	0	0
19	41930396	rs4674	A	G	166	182	348	0	5	353	0	0
19	41932084	rs284660	G	T	14	14	28	0	0	28	0	0
19	41932120	rs284661	C	T	14	10	24	0	0	24	0	0
19	41932275	rs284662	T	C	16	9	25	0	0	25	0	0
19	41932612	rs284663	C	T	15	7	22	0	1	23	0	0
19	41939297	rs1043413	C	G	34	52	86	0	0	86	0	0
19	41944237	rs2231940	T	C	73	70	143	0	1	144	0	0
19	42062307	rs2317314	C	T	8	6	14	0	0	14	0	0
19	42125660	rs1041994	T	C	24	54	78	0	1	79	0	0
19	42265889	rs11548735	G	T	225	273	498	0	3	504	3	0
19	42274895	rs10403840	G	T	313	253	566	0	3	569	0	0
19	42275099	rs2701	A	G	272	281	553	0	4	557	0	0
19	42315281	rs899662	G	T	4	17	21	0	1	22	0	0
19	42315300	rs2008808	G	T	5	18	23	0	0	23	0	0
19	42315406	rs2008798	A	G	0	7	7	0	0	7	0	0
19	42365944	rs12461131	G	A	13	7	20	0	0	20	0	0
19	42365964	rs12461099	C	T	8	6	14	0	0	14	0	0
19	42366247	rs3786538	T	G	10	9	19	0	1	20	0	0
19	42366658	rs139867843	G	A	12	5	17	0	0	17	0	0
19	42367621	rs7250787	T	A	11	9	20	0	0	20	0	0
19	42367906	rs873282	T	C	5	7	12	0	0	12	0	0
19	42368016	rs12972552	G	A	35	3	38	0	0	38	0	0
19	42368738	rs7254214	A	G	13	16	29	0	1	30	0	0
19	42369393	rs7258163	A	G	6	3	9	0	0	9	0	0
19	42369743	rs7259596	T	C	2	5	7	0	0	7	0	0
19	42371522	rs12984383	G	C	5	6	11	0	0	11	0	0
19	42371842	rs8102670	T	C	7	9	16	0	0	16	0	0
19	42372457	rs3786536	C	A	16	15	31	0	0	31	0	0
19	42372807	rs61762290	C	T	17	14	31	0	0	31	0	0
19	42373298	rs1366610	G	A	6	11	17	0	0	17	0	0
19	42373679	rs2075750	C	T	9	4	13	0	0	13	0	0
19	42374836	rs2075752	T	G	13	9	22	0	0	22	0	0
19	42375244	rs2075754	C	T	24	17	41	0	0	41	0	0
19	42387803	rs891167	G	A	5	2	7	0	4	11	0	0
19	43833532	rs8110154	T	C	2	6	8	0	0	8	0	0
19	43979589	rs1055099	G	T	24	22	46	0	0	46	0	0
19	44001057	rs2682547	T	C	4	4	8	0	0	8	0	0
19	44031324	rs3810381	C	T	72	64	136	0	0	136	0	0
19	44047550	rs3547	T	C	64	58	122	0	1	123	0	0
19	44052616	rs3213387	T	C	5	1	6	0	0	6	0	0
19	44055726	rs25487	T	C	47	44	91	0	2	93	0	0
19	44056052	rs25485	A	G	7	0	7	0	1	8	0	0
19	44056106	rs25493	G	A	1	5	6	0	0	6	0	0
19	44057227	rs915927	T	C	76	78	154	0	0	154	0	0
19	44079687	rs3213245	G	A	1	8	9	0	0	9	0	0
19	44088818	rs59975994	T	C	3	3	6	0	0	6	0	0
19	44090195	rs3817	A	C	52	42	94	0	1	95	0	0
19	44095077	rs8113762	A	G	11	14	25	0	0	25	0	0
19	44098963	rs304725	C	G	5	4	9	0	0	9	0	0
19	44099667	rs113927234	C	T	4	2	6	0	0	6	0	0
19	44152286	rs4251951	T	A	18	12	30	0	0	30	0	0
19	44162954	rs2239372	A	G	20	13	33	0	2	35	0	0
19	44163033	rs2239373	T	G	26	11	37	0	2	39	0	0
19	44163061	rs2283628	T	C	29	23	52	0	0	52	0	0
19	44166187	rs4251842	A	C	5	6	11	0	0	11	0	0
19	44166375	rs4251841	C	T	5	6	11	0	0	11	0	0
19	44167953	rs60664277	A	C	4	6	10	0	0	10	0	0
19	44169738	rs4251831	G	C	38	15	53	0	0	53	0	0
19	44170586	rs344787	A	T	9	10	19	0	0	19	0	0
19	44171142	rs344786	T	C	10	8	18	0	0	18	0	0
19	44171349	rs344785	C	T	12	24	36	0	0	36	0	0
19	44171582	rs344784	T	A	19	28	47	0	1	48	0	0
19	44172188	rs344783	T	C	5	6	11	0	0	11	0	0
19	44238955	.	C	T	4	2	6	0	0	6	0	0
19	44280342	rs2163860	A	G	3	6	9	0	0	9	0	0
19	44280509	rs1207132	G	T	4	8	12	0	1	13	0	0
19	44283031	rs56681946	T	C	1	6	7	0	0	7	0	0
19	44300884	rs349047	G	A	3	4	7	0	0	7	0	0
19	44300937	rs349048	C	T	2	5	7	0	0	7	0	0
19	44303066	rs11547806	C	G	4	3	7	0	0	7	0	0
19	44417295	rs376069	T	C	10	24	34	0	1	35	0	0
19	44417575	rs417699	A	G	14	16	30	0	0	30	0	0
19	44418077	rs407731	C	T	9	14	23	0	1	24	0	0
19	44418343	rs406968	C	T	9	9	18	0	0	18	0	0
19	44418544	rs425221	A	G	13	19	32	0	0	32	0	0
19	44418680	rs388685	G	C	8	10	18	0	0	18	0	0
19	44418693	rs388706	T	C	8	7	15	0	0	15	0	0
19	44418824	rs399098	C	T	12	13	25	0	0	25	0	0
19	44428406	rs117082389	G	A	10	5	15	0	0	15	0	0
19	44570393	rs6509138	C	A	11	18	29	0	1	30	0	0
19	44571154	rs4433920	T	C	36	23	59	0	1	60	0	0
19	44613701	.	G	A	28	21	49	0	1	50	0	0
19	44652954	rs2293587	G	A	5	4	9	0	0	9	0	0
19	44741827	rs1233454	A	G	5	4	9	0	0	9	0	0
19	44930738	rs1062098	T	C	6	13	19	0	0	19	0	0
19	44931995	rs1062093	C	G	3	6	9	0	0	9	0	0
19	44932323	rs204554	G	A	12	7	19	0	0	19	0	0
19	44932972	rs1434579	C	T	7	9	16	0	0	16	0	0
19	44933947	rs12151338	G	A	9	4	13	0	0	13	0	0
19	44947050	rs204548	T	C	3	5	8	0	0	8	0	0
19	44947184	rs204547	T	C	4	3	7	0	0	7	0	0
19	44981375	rs954314	T	C	20	21	41	0	0	41	0	0
19	44981883	rs1897820	C	G	8	14	22	0	0	22	0	0
19	44983567	rs2253563	C	G	7	11	18	0	0	18	0	0
19	45001346	rs2571108	G	A	6	11	17	0	0	17	0	0
19	45065290	rs1661162	G	A	0	18	18	0	0	18	0	0
19	45066029	rs12459712	G	A	17	0	17	0	0	17	0	0
19	45166466	rs73035576	G	A	16	28	44	0	0	44	0	0
19	45167531	rs203711	G	A	2	6	8	0	0	8	0	0
19	45168497	rs203713	A	G	10	9	19	0	0	19	0	0
19	45186965	rs2289494	G	C	45	27	72	0	0	72	0	0
19	45251156	rs2965169	A	C	5	5	10	0	0	10	0	0
19	45252439	rs7257231	T	A	3	3	6	0	0	6	0	0
19	45253104	rs8100239	T	A	14	9	23	0	0	23	0	0
19	45253582	rs8100197	G	A	4	3	7	0	0	7	0	0
19	45377842	rs41290108	G	C	12	9	21	0	0	21	0	0
19	45382966	rs3852860	C	T	5	1	6	0	0	6	0	0
19	45383037	rs11673139	A	T	2	4	6	0	0	6	0	0
19	45383061	rs3852861	G	T	4	3	7	0	0	7	0	0
19	45384105	rs11083749	C	T	7	4	11	0	1	12	0	0
19	45387034	rs283808	A	C	4	3	7	0	0	7	0	0
19	45387057	rs283809	A	G	2	4	6	0	0	6	0	0
19	45389174	rs283813	T	A	4	2	6	0	0	6	0	0
19	45395714	rs157581	T	C	270	244	514	0	0	515	1	0
19	45397229	rs1160983	G	A	295	333	628	0	4	632	0	0
19	45404691	rs405697	A	G	2	7	9	0	0	9	0	0
19	45404972	rs1038025	T	C	6	3	9	0	0	9	0	0
19	45487178	rs204474	C	T	7	2	9	0	0	9	0	0
19	45490065	rs11083755	C	T	16	17	33	0	1	34	0	0
19	45490192	rs11672748	A	G	9	10	19	0	0	19	0	0
19	45490570	rs3786505	A	G	76	64	140	0	0	140	0	0
19	45490636	rs204468	T	C	73	85	158	0	2	160	0	0
19	45492559	rs11669173	G	A	4	10	14	0	0	14	0	0
19	45493635	rs875255	C	G	2	9	11	0	0	11	0	0
19	45495668	rs2075618	G	C	10	2	12	0	0	12	0	0
19	45495682	rs2075619	A	G	10	1	11	0	0	11	0	0
19	45508847	rs34647054	C	G	4	5	9	0	0	9	0	0
19	45513498	rs62117214	T	G	3	3	6	0	0	6	0	0
19	45517879	.	G	A	3	3	6	0	0	6	0	0
19	45519100	rs35891370	G	A	23	17	40	0	0	40	0	0
19	45519264	rs56394437	A	T	5	2	7	0	0	7	0	0
19	45521426	rs7246245	A	G	4	2	6	0	0	6	0	0
19	45522181	rs12981350	G	A	4	5	9	0	0	9	0	0
19	45522732	rs35912475	C	T	4	4	8	0	0	8	0	0
19	45522998	rs6509175	C	G	6	7	13	0	0	13	0	0
19	45523583	rs4803791	G	A	3	4	7	0	0	7	0	0
19	45534041	rs1076986	C	T	4	8	12	0	0	12	0	0
19	45536036	rs10424046	C	G	18	11	29	0	0	29	0	0
19	45541168	.	A	G	219	221	440	0	7	447	0	0
19	45568795	rs7256279	G	A	4	7	11	0	1	12	0	0
19	45569009	rs10419815	C	T	5	6	11	0	1	12	0	0
19	45570051	rs3786509	G	C	9	11	20	0	0	20	0	0
19	45571781	rs10445571	T	C	3	4	7	0	0	7	0	0
19	45571903	rs36097205	G	C	4	2	6	0	0	6	0	0
19	45571972	rs77372956	T	A	3	3	6	0	0	6	0	0
19	45971961	rs2282695	C	G	572	598	1170	0	10	1181	1	0
19	45972408	rs12976374	C	G	38	38	76	0	0	76	0	0
19	45973056	rs2238686	T	C	161	104	265	0	0	265	0	0
19	45973166	rs2238687	G	C	160	113	273	0	1	274	0	0
19	45975402	.	G	A	27	12	39	0	0	39	0	0
19	45976718	rs3170167	T	C	392	244	636	0	9	645	0	0
19	45978375	rs1049739	A	G	399	479	878	0	2	880	0	0
19	46002456	rs3745821	G	T	4	2	6	0	0	6	0	0
19	46029819	rs28584568	A	T	425	364	789	0	4	793	0	0
19	46052898	rs62109650	C	T	3	4	7	0	0	7	0	0
19	46053385	rs3760844	C	T	2	5	7	0	0	7	0	0
19	46056620	rs3826861	C	T	5	3	8	0	0	8	0	0
19	46057081	rs3826860	A	G	4	5	9	0	0	9	0	0
19	46145661	rs35384424	C	T	7	2	9	0	0	9	0	0
19	46206262	rs17850756	G	A	49	55	104	0	1	105	0	0
19	46214291	rs3837965	G	T	21	27	48	0	1	49	0	0
19	46234155	rs17878252	G	A	6	3	9	0	0	9	0	0
19	46287200	rs617988	C	G	2	4	6	0	0	6	0	0
19	46319415	rs1132645	G	C	41	73	114	0	0	114	0	0
19	46322391	rs56243424	G	A	3	3	6	0	0	6	0	0
19	46322585	rs4803857	C	T	12	13	25	0	0	25	0	0
19	46322830	rs4802279	T	C	9	6	15	0	0	15	0	0
19	46328179	rs4803861	C	T	1	5	6	0	0	6	0	0
19	46404579	rs10423899	A	G	5	6	11	0	1	12	0	0
19	46405590	rs67709010	T	C	4	5	9	0	0	9	0	0
19	46526298	rs2072562	T	G	74	46	120	0	1	121	0	0
19	46885977	rs11670522	C	T	5	4	9	0	1	10	0	0
19	47030234	rs62136886	T	C	4	4	8	0	0	8	0	0
19	47110841	rs10853780	A	C	15	14	29	0	0	29	0	0
19	47112648	rs10113	T	C	444	450	894	0	13	907	0	0
19	47182842	rs78320072	G	A	2	10	12	0	0	12	0	0
19	47184356	rs8105742	G	A	6	2	8	0	0	8	0	0
19	47211778	rs10404836	T	C	7	2	9	0	1	10	0	0
19	47212343	rs443081	C	T	1	5	6	0	0	6	0	0
19	47212593	rs10423365	A	G	3	3	6	0	0	6	0	0
19	47223949	rs313841	G	A	199	180	379	0	2	381	0	0
19	47224607	rs3786705	C	T	9	6	15	0	0	15	0	0
19	47227295	rs4803996	C	A	3	3	6	0	0	6	0	0
19	47227821	rs11668987	G	A	2	7	9	0	0	9	0	0
19	47230113	rs10411851	C	T	13	17	30	0	0	30	0	0
19	47258674	rs3201779	C	T	10	6	16	0	0	16	0	0
19	47258842	rs2287717	C	T	12	8	20	0	0	20	0	0
19	47259048	rs143793528	C	G	4	2	6	0	0	6	0	0
19	47260148	.	C	G	30	21	51	0	1	52	0	0
19	47278859	rs3027961	C	G	195	194	389	0	4	393	0	0
19	47342867	rs312185	A	C	8	12	20	0	0	20	0	0
19	47506363	rs6509305	C	T	17	12	29	0	1	30	0	0
19	47507434	rs1052667	C	T	5	6	11	0	1	12	0	0
19	47507468	rs1052668	G	A	4	5	9	0	0	9	0	0
19	47730119	.	T	C	10	12	22	0	0	22	0	0
19	47730581	rs112701711	C	A	5	3	8	0	1	9	0	0
19	47767643	rs4804036	G	A	6	3	9	0	0	9	0	0
19	47768128	rs2032811	G	C	28	22	50	0	2	52	0	0
19	47769120	rs7248282	C	T	11	18	29	0	0	29	0	0
19	47769165	rs10407675	T	G	11	8	19	0	0	19	0	0
19	47769244	.	T	C	7	0	7	0	1	8	0	0
19	47769839	rs9304666	A	G	3	10	13	0	0	13	0	0
19	47770015	rs10413121	A	C	58	84	142	0	1	143	0	0
19	47770507	rs3786709	C	T	2	7	9	0	0	9	0	0
19	47770524	rs3786710	C	T	4	6	10	0	0	10	0	0
19	47770938	rs883030	C	A	5	3	8	0	0	8	0	0
19	47771499	rs884537	G	A	5	10	15	0	0	15	0	0
19	47772932	rs4802336	T	G	6	3	9	0	0	9	0	0
19	47773348	rs60379489	C	T	9	4	13	0	0	13	0	0
19	47774447	rs66726054	G	A	7	4	11	0	0	11	0	0
19	47774572	rs60930438	C	T	147	170	317	0	9	326	0	0
19	47774680	rs117519030	C	G	122	137	259	0	0	259	0	0
19	47774772	rs888836	T	C	148	120	268	0	2	270	0	0
19	47778221	rs10407367	A	C	9	4	13	0	0	13	0	0
19	47778412	rs1055218	G	T	7	6	13	0	0	13	0	0
19	47778857	rs6612	C	G	126	106	232	0	0	232	0	0
19	47883126	rs151213663	C	T	40	27	67	0	0	67	0	0
19	47884684	.	G	A	8	1	9	0	0	9	0	0
19	47980153	rs2293424	G	A	48	41	89	0	3	92	0	0
19	48182787	rs4802382	C	T	2	4	6	0	0	6	0	0
19	48183771	rs1035938	C	T	2	8	10	0	1	11	0	0
19	48184474	rs3745762	C	T	8	6	14	0	0	14	0	0
19	48198675	rs13346368	A	G	16	25	41	0	0	41	0	0
19	48200803	rs9797554	C	T	4	3	7	0	0	7	0	0
19	48219893	rs11550017	C	T	4	3	7	0	0	7	0	0
19	48229169	rs8111184	A	G	6	5	11	0	0	11	0	0
19	48244569	rs3745758	G	A	6	8	14	0	1	15	0	0
19	48245075	rs28384119	T	C	14	9	23	0	0	23	0	0
19	48248834	rs10404034	T	C	365	333	698	0	0	698	0	0
19	48250203	rs2334292	T	A	17	32	49	0	0	49	0	0
19	48255804	.	A	G	1272	966	2238	0	23	2261	0	0
19	48257869	rs200463741	C	T	1170	935	2105	0	12	2117	0	0
19	48259478	rs10414116	T	C	64	70	134	0	4	138	0	0
19	48261001	rs28501100	G	A	3	5	8	0	0	8	0	0
19	48618711	rs251692	A	G	4	9	13	0	0	13	0	0
19	48621036	rs13436	C	G	115	125	240	0	0	240	0	0
19	48622427	rs20581	A	G	108	108	216	0	1	217	0	0
19	48627262	rs156633	G	A	6	3	9	0	0	9	0	0
19	48630763	rs156640	G	C	10	7	17	0	0	17	0	0
19	48641574	rs411073	A	G	5	9	14	0	0	14	0	0
19	48641693	.	C	T	10	5	15	0	0	15	0	0
19	48642266	rs380487	T	C	7	5	12	0	0	12	0	0
19	48642811	rs3730951	G	C	8	4	12	0	0	12	0	0
19	48654553	rs20580	G	T	106	79	185	0	1	186	0	0
19	48744545	rs61187741	C	T	2	6	8	0	0	8	0	0
19	48745309	rs12984929	G	T	2	8	10	0	0	10	0	0
19	48745633	rs112533881	G	A	8	9	17	0	0	17	0	0
19	48759028	rs7258674	A	G	23	29	52	0	0	52	0	0
19	48759677	rs7259589	C	T	28	23	51	0	1	52	0	0
19	48759727	rs10427120	T	C	26	25	51	0	0	51	0	0
19	48759731	rs7260636	T	C	25	27	52	0	0	52	0	0
19	48759978	rs12459322	C	G	27	30	57	0	0	57	0	0
19	48760005	rs12459359	G	C	30	26	56	0	0	56	0	0
19	48760022	rs12459323	A	G	34	28	62	0	0	62	0	0
19	48760229	rs7248320	G	A	30	31	61	0	0	61	0	0
19	48760342	rs7248246	C	A	1	6	7	0	1	8	0	0
19	48760676	rs7343088	A	T	7	10	17	0	0	17	0	0
19	48760744	rs7248752	C	T	18	25	43	0	1	44	0	0
19	48760771	rs7248766	C	T	23	26	49	0	1	50	0	0
19	48760890	rs10412163	A	G	24	23	47	0	0	47	0	0
19	48761065	rs10412609	A	G	15	27	42	0	0	42	0	0
19	48762913	rs7253258	G	C	38	16	54	0	1	55	0	0
19	48762925	rs10414340	C	T	37	17	54	0	0	54	0	0
19	48762956	rs7253271	G	A	28	12	40	0	1	41	0	0
19	48766302	rs73061558	C	T	7	2	9	0	0	9	0	0
19	48766329	rs12462140	T	G	4	2	6	0	0	6	0	0
19	48825103	rs10403090	G	C	11	2	13	0	0	13	0	0
19	48826490	rs8105159	C	T	6	0	6	0	0	6	0	0
19	48829228	rs8182501	T	C	14	17	31	0	0	31	0	0
19	48829630	rs8182495	C	T	11	5	16	0	1	17	0	0
19	48830286	rs10415654	T	A	5	8	13	0	0	13	0	0
19	48830446	rs10414314	A	C	18	17	35	0	1	36	0	0
19	48831777	rs12463018	G	A	21	21	42	0	1	43	0	0
19	48831792	rs55876324	A	T	21	24	45	0	0	45	0	0
19	48832554	rs8102349	A	G	50	54	104	0	1	105	0	0
19	48833800	rs8355	C	T	81	47	128	0	1	129	0	0
19	48833806	rs11665	C	G	61	22	83	0	0	85	2	0
19	48836082	rs3745720	A	C	9	3	12	0	0	12	0	0
19	48836673	rs3826828	G	T	3	4	7	0	0	7	0	0
19	48984060	rs73050916	A	G	12	7	19	0	1	20	0	0
19	48998038	.	G	A	5	7	12	0	0	12	0	0
19	48998055	rs115038136	C	T	5	5	10	0	0	10	0	0
19	49303070	rs11548193	G	C	17	16	33	0	0	33	0	0
19	49375676	rs638050	T	C	8	10	18	0	0	18	0	0
19	49375900	rs626974	T	C	805	1709	2514	0	4	2518	0	0
19	49376968	.	G	T	2132	782	2914	0	14	2931	3	0
19	49377319	rs610308	A	G	902	2000	2902	0	29	2931	0	0
19	49377424	rs11541192	G	A	1039	2355	3394	0	22	3416	0	0
19	49377436	rs556052	G	C	1011	2263	3274	0	24	3298	0	0
19	49377873	rs35023389	G	A	1174	2422	3596	0	23	3619	0	0
19	49377918	rs35087747	G	T	1206	2533	3739	0	26	3766	1	0
19	49378245	rs595982	T	C	31	41	72	0	3	75	0	0
19	49378308	rs595516	A	G	37	55	92	0	0	92	0	0
19	49378408	rs595051	A	G	49	67	116	0	0	116	0	0
19	49378514	rs594600	A	G	56	46	102	0	1	103	0	0
19	49378517	rs594597	A	G	56	43	99	0	1	100	0	0
19	49378994	rs500079	A	G	559	849	1408	0	9	1417	0	0
19	49379167	rs524	C	T	877	1671	2548	0	10	2558	0	0
19	49379182	rs527	G	C	794	1408	2202	0	10	2214	2	0
19	49407660	rs1058483	G	A	212	216	428	0	7	435	0	0
19	49421966	rs2287836	T	C	4	2	6	0	0	6	0	0
19	49422437	rs12460533	A	T	4	8	12	0	0	12	0	0
19	49605705	rs73046792	G	A	116	132	248	0	0	248	0	0
19	49606449	rs734570	C	T	131	118	249	0	0	249	0	0
19	49606680	rs1062250	G	A	138	106	244	0	4	248	0	0
19	49610389	rs3795055	T	C	59	54	113	0	4	117	0	0
19	49611319	rs1058882	C	T	76	69	145	0	4	149	0	0
19	49843107	.	C	T	65	84	149	0	1	150	0	0
19	49989424	rs1042122	T	C	18	17	35	0	0	35	0	0
19	49991445	.	G	T	3	9	12	0	0	12	0	0
19	49991800	rs2681570	G	A	6	5	11	0	0	11	0	0
19	49992093	rs2517977	C	G	4	7	11	0	0	11	0	0
19	49994829	rs139958890	G	C	13	63	76	0	0	76	0	0
19	50001929	rs939349	C	G	18	21	39	0	0	39	0	0
19	50002265	.	C	T	23	22	45	0	1	46	0	0
19	50017277	.	G	A	183	129	312	0	3	315	0	0
19	50017724	rs2878342	C	T	248	186	434	0	3	437	0	0
19	50028040	rs3810194	T	C	11	11	22	0	0	22	0	0
19	50028163	rs1132990	A	G	14	10	24	0	1	25	0	0
19	50028541	rs73582442	G	A	21	6	27	0	0	27	0	0
19	50028620	rs73582446	G	A	17	9	26	0	0	26	0	0
19	50040986	rs61102029	C	T	4	2	6	0	0	6	0	0
19	50045916	rs34459162	T	C	3	3	6	0	0	6	0	0
19	50046365	rs3187346	T	C	3	3	6	0	0	6	0	0
19	50046437	rs1129459	C	T	4	2	6	0	0	6	0	0
19	50046473	rs1129460	A	C	4	2	6	0	0	6	0	0
19	50046718	rs115485202	A	C	7	4	11	0	0	11	0	0
19	50059982	rs4594362	C	G	142	152	294	0	1	295	0	0
19	50067508	rs10412446	A	G	4	7	11	0	0	11	0	0
19	50082466	rs7255842	C	T	5	3	8	0	0	8	0	0
19	50093876	rs56345999	T	C	4	6	10	0	0	10	0	0
19	50098423	rs12462756	G	A	6	10	16	0	0	16	0	0
19	50099359	rs146167986	C	T	26	16	42	0	0	42	0	0
19	50100484	rs77535345	G	A	12	11	23	0	0	23	0	0
19	50101542	rs28720835	A	G	6	2	8	0	0	8	0	0
19	50104948	rs142810131	C	A	9	19	28	0	0	28	0	0
19	50106029	rs10413099	G	A	10	10	20	0	0	20	0	0
19	50188714	.	C	T	14	9	23	0	0	23	0	0
19	50190529	rs35270176	G	A	4	5	9	0	0	9	0	0
19	50271502	rs1674139	T	C	3	7	10	0	0	10	0	0
19	50283379	rs1273646	C	G	3	3	6	0	0	6	0	0
19	50295342	.	C	T	5	7	12	0	0	12	0	0
19	50305688	rs2159984	G	C	9	5	14	0	0	14	0	0
19	50307344	rs11879607	C	T	11	14	25	0	1	26	0	0
19	50307408	rs11879637	G	A	11	11	22	0	1	23	0	0
19	50308134	rs2241040	G	C	18	26	44	0	0	44	0	0
19	50308893	rs8101959	T	C	4	2	6	0	1	7	0	0
19	50340399	rs528390430	G	A	0	7	7	0	0	7	0	0
19	50367493	rs145904995	C	T	73	19	92	0	0	92	0	0
19	50367526	rs202138901	G	A	17	14	31	0	0	31	0	0
19	50370066	rs2257103	C	T	4	3	7	0	0	7	0	0
19	50370106	rs2305922	T	G	4	4	8	0	0	8	0	0
19	50375446	rs8112937	C	G	3	5	8	0	0	8	0	0
19	50375447	rs8112830	A	G	3	5	8	0	0	8	0	0
19	50377757	rs4802634	C	T	8	5	13	0	1	14	0	0
19	50377835	rs8110265	G	A	7	4	11	0	0	11	0	0
19	50379053	rs3810267	A	G	6	5	11	0	0	11	0	0
19	50379193	rs3810268	C	T	4	2	6	0	0	6	0	0
19	50383636	rs3745486	T	C	29	28	57	0	1	58	0	0
19	50385031	rs7248744	A	G	4	5	9	0	0	9	0	0
19	50387729	rs35681527	C	T	60	44	104	0	3	107	0	0
19	50391301	rs2305916	T	G	11	15	26	0	1	27	0	0
19	50410363	rs11083988	C	T	54	76	130	0	1	131	0	0
19	50410577	rs56779488	G	A	36	40	76	0	0	76	0	0
19	50411742	rs892028	A	G	45	63	108	0	2	110	0	0
19	50412417	rs999583	G	A	32	40	72	0	0	72	0	0
19	50435139	rs283524	G	C	7	7	14	0	0	14	0	0
19	50435747	rs283525	T	C	19	12	31	0	3	34	0	0
19	50481000	.	T	C	5	2	7	0	0	7	0	0
19	50881326	rs28514894	T	C	37	56	93	0	0	93	0	0
19	50882172	rs41432149	C	T	6	10	16	0	0	16	0	0
19	50883927	rs116926156	G	A	3	3	6	0	0	6	0	0
19	50884885	rs4802703	C	A	6	4	10	0	0	10	0	0
19	50918229	rs3218775	G	A	82	96	178	0	2	180	0	0
19	50983051	rs73058212	G	T	3	5	8	0	0	8	0	0
19	50983930	rs10409679	C	T	404	369	773	0	8	781	0	0
19	50986092	rs1046246	C	T	448	478	926	0	8	934	0	0
19	51212552	rs35743451	C	T	18	16	34	0	1	35	0	0
19	51226590	rs11666008	C	G	21	12	33	0	0	33	0	0
19	51228634	rs11084024	G	A	1339	1396	2735	0	24	2759	0	0
19	51228746	rs13866	C	T	2261	2911	5172	0	122	5295	1	0
19	51630482	rs2258983	C	A	3	3	6	0	0	6	0	0
19	51728641	rs2455069	A	G	87	118	205	0	1	206	0	0
19	51744556	.	C	A	5	6	11	0	0	11	0	0
19	51829098	rs68055760	T	C	3	8	11	0	0	11	0	0
19	51850290	rs1130426	G	A	375	437	812	0	7	819	0	0
19	51871195	rs3745403	G	A	4	6	10	0	0	10	0	0
19	51874950	rs3009	G	A	169	139	308	0	1	309	0	0
19	51917470	rs1610073	G	A	12	12	24	0	0	24	0	0
19	51917735	rs1974821	G	A	87	84	171	0	1	172	0	0
19	51918112	rs3810099	A	G	27	37	64	0	0	64	0	0
19	51918135	rs1833785	G	T	22	34	56	0	0	56	0	0
19	51918360	rs61741672	A	G	20	27	47	0	0	47	0	0
19	51918394	rs35546227	T	G	8	5	13	0	0	13	0	0
19	51919507	rs62114257	T	C	5	3	8	0	0	8	0	0
19	51919998	rs61741677	T	C	78	73	151	0	1	152	0	0
19	51920613	rs1010425	C	T	22	58	80	0	0	80	0	0
19	51994813	rs16982733	G	T	3	4	7	0	0	7	0	0
19	51994851	rs16982735	C	G	3	6	9	0	0	9	0	0
19	52076481	rs2305371	C	A	8	3	11	0	0	11	0	0
19	52076960	rs8111685	T	C	7	1	8	0	0	8	0	0
19	52077069	rs16982846	G	A	10	1	11	0	0	11	0	0
19	52130830	rs8107754	C	A	16	21	37	0	0	37	0	0
19	52215316	rs7252881	G	A	2	13	15	0	0	15	0	0
19	52215343	rs7252595	A	C	2	12	14	0	0	14	0	0
19	52217174	.	C	T	1	10	11	0	0	11	0	0
19	52249211	rs867228	T	G	72	100	172	0	0	172	0	0
19	52249942	rs28930680	A	G	66	78	144	0	2	146	0	0
19	52250216	rs5030878	A	G	86	72	158	0	0	158	0	0
19	52375424	rs1055408	C	T	14	9	23	0	0	23	0	0
19	52376507	rs2288868	T	C	9	12	21	0	0	21	0	0
19	52376952	rs8107969	T	A	16	4	20	0	1	21	0	0
19	52381862	rs12150982	C	A	4	4	8	0	0	8	0	0
19	52382560	rs10413726	C	T	4	2	6	0	0	6	0	0
19	52383123	rs8110073	C	A	4	2	6	0	0	6	0	0
19	52383556	rs8110546	C	A	5	2	7	0	0	7	0	0
19	52383569	rs8110461	A	C	4	2	6	0	0	6	0	0
19	52383938	rs8113768	C	T	10	10	20	0	0	20	0	0
19	52384061	rs8100716	T	C	13	8	21	0	0	21	0	0
19	52390710	rs1433081	A	C	3	5	8	0	0	8	0	0
19	52390726	rs1433082	C	A	3	5	8	0	0	8	0	0
19	52390958	rs143963498	G	T	2	11	13	0	0	13	0	0
19	52391769	rs7247017	T	C	8	5	13	0	0	13	0	0
19	52391940	rs6509591	A	T	9	7	16	0	0	16	0	0
19	52391988	rs7256926	A	G	6	7	13	0	0	13	0	0
19	52392439	rs138332681	G	C	6	10	16	0	0	16	0	0
19	52402093	rs111312408	A	G	7	2	9	0	0	9	0	0
19	52402357	rs55633023	A	G	10	3	13	0	0	13	0	0
19	52403516	rs1549931	T	C	17	14	31	0	1	32	0	0
19	52447624	rs33998555	C	T	11	7	18	0	0	18	0	0
19	52462880	rs147203253	T	C	2	5	7	0	0	7	0	0
19	52467497	rs79804260	A	T	12	14	26	0	0	26	0	0
19	52467934	rs4986769	A	T	93	99	192	0	2	194	0	0
19	52468278	rs4988336	G	A	137	104	241	0	0	241	0	0
19	52471872	rs2278420	A	G	121	108	229	0	1	230	0	0
19	52472295	rs4986773	A	G	124	127	251	0	3	254	0	0
19	52473823	rs7253957	C	A	5	4	9	0	0	9	0	0
19	52477980	rs11668463	C	G	41	30	71	0	1	72	0	0
19	52480037	rs8103682	C	G	5	2	7	0	0	7	0	0
19	52480168	rs146741244	C	T	3	3	6	0	1	7	0	0
19	52482193	rs73067001	T	A	8	0	8	0	0	8	0	0
19	52483343	rs116909547	C	T	6	8	14	0	0	14	0	0
19	52484177	rs117334793	T	G	5	1	6	0	0	6	0	0
19	52484220	rs7259556	C	T	6	3	9	0	0	9	0	0
19	52484221	rs7260510	T	G	6	3	9	0	0	9	0	0
19	52486626	rs59351632	T	C	4	3	7	0	0	7	0	0
19	52487127	rs58116420	G	C	4	13	17	0	0	17	0	0
19	52487161	rs8110542	A	G	6	10	16	0	1	17	0	0
19	52495109	rs1835999	T	C	27	9	36	0	0	36	0	0
19	52495114	rs1836000	T	C	26	9	35	0	0	35	0	0
19	52495312	rs1433090	C	T	7	5	12	0	1	13	0	0
19	52495380	rs11084127	C	T	10	2	12	0	0	12	0	0
19	52495646	rs11084128	A	T	57	62	119	0	0	119	0	0
19	52495648	rs2288885	A	G	57	62	119	0	0	119	0	0
19	52495684	rs2288886	A	T	53	57	110	0	2	112	0	0
19	52495803	rs2288887	A	G	52	42	94	0	1	95	0	0
19	52496149	rs16983353	C	T	69	49	118	0	1	119	0	0
19	52497250	rs1978717	G	A	32	31	63	0	0	63	0	0
19	52497943	rs10500311	G	A	31	20	51	0	1	52	0	0
19	52498330	rs8105622	G	A	5	2	7	0	0	7	0	0
19	52498344	rs1836001	C	T	4	2	6	0	0	6	0	0
19	52507661	rs2867966	T	C	2	4	6	0	0	6	0	0
19	52507882	rs4516337	C	G	11	3	14	0	0	14	0	0
19	52516360	rs11671702	C	T	18	7	25	0	0	25	0	0
19	52517243	rs118069111	C	A	12	8	20	0	0	20	0	0
19	52517520	rs8111873	T	C	19	18	37	0	0	37	0	0
19	52517894	rs11665783	G	A	14	17	31	0	0	31	0	0
19	52517973	rs148770931	C	T	20	17	37	0	0	37	0	0
19	52519608	rs8104890	C	T	41	25	66	0	3	69	0	0
19	52520518	rs73934728	T	C	24	30	54	0	1	55	0	0
19	52520607	rs61574510	C	T	31	20	51	0	0	51	0	0
19	52521296	rs9636139	G	A	23	31	54	0	0	54	0	0
19	52525684	rs116953435	C	T	2	7	9	0	0	9	0	0
19	52529074	rs6509613	T	C	23	24	47	0	1	48	0	0
19	52534899	rs116901922	G	A	63	44	107	0	1	108	0	0
19	52535172	rs58329304	A	G	73	24	97	0	0	97	0	0
19	52535421	rs12462359	T	G	10	3	13	0	0	13	0	0
19	52535803	rs12460118	C	T	51	41	92	0	0	92	0	0
19	52535834	rs12460617	G	A	60	41	101	0	1	102	0	0
19	52536117	rs73053909	C	A	44	29	73	0	3	76	0	0
19	52537576	rs11666149	T	G	50	64	114	0	2	116	0	0
19	52538278	rs6509616	A	C	60	47	107	0	0	107	0	0
19	52539487	rs28379522	C	T	5	1	6	0	0	6	0	0
19	52540694	rs11673450	G	T	8	5	13	0	0	13	0	0
19	52540697	rs11673398	C	T	7	5	12	0	0	12	0	0
19	52542344	rs117525768	T	A	2	4	6	0	0	6	0	0
19	52550401	rs17779341	G	T	5	2	7	0	0	7	0	0
19	52551042	rs17835716	A	G	5	3	8	0	0	8	0	0
19	52551486	rs3752118	G	C	3	7	10	0	0	10	0	0
19	52551498	rs3752119	C	T	3	5	8	0	0	8	0	0
19	52552419	rs79443764	C	T	11	7	18	0	1	19	0	0
19	52552669	rs11667001	G	C	13	2	15	0	0	15	0	0
19	52552999	rs3450	T	C	2	4	6	0	0	6	0	0
19	52567852	rs142353757	G	A	4	5	9	0	0	9	0	0
19	52568422	rs61743893	T	G	11	2	13	0	0	13	0	0
19	52660783	rs17696575	A	G	4	3	7	0	0	7	0	0
19	52665989	rs12460375	C	G	4	21	25	0	0	25	0	0
19	52666071	rs35897677	C	T	5	20	25	0	0	25	0	0
19	52666085	rs12460432	G	A	4	19	23	0	0	23	0	0
19	52679960	rs10403414	C	A	4	4	8	0	0	8	0	0
19	52704312	rs373893662	A	G	7	1	8	0	0	8	0	0
19	52704366	rs113961156	C	T	2	6	8	0	0	8	0	0
19	52709992	rs3826653	G	T	4	4	8	0	0	8	0	0
19	52710097	rs3786487	A	G	4	5	9	0	0	9	0	0
19	52795682	rs1048399	G	A	118	122	240	0	3	243	0	0
19	52825235	rs8102373	A	G	12	11	23	0	0	23	0	0
19	52826270	rs62110459	T	G	4	9	13	0	0	13	0	0
19	52828913	rs75388459	G	A	33	30	63	0	0	63	0	0
19	52915816	rs1585207	G	C	0	7	7	0	0	7	0	0
19	52915967	rs113365590	G	T	5	1	6	0	0	6	0	0
19	52916988	rs1820691	T	G	6	2	8	0	0	8	0	0
19	52917198	rs1824245	C	A	3	5	8	0	0	8	0	0
19	52917590	rs162124	G	A	5	3	8	0	0	8	0	0
19	52921057	rs8106133	A	G	8	11	19	0	1	20	0	0
19	52921344	rs2608515	T	G	8	14	22	0	0	22	0	0
19	52960707	rs4802948	C	T	3	5	8	0	0	8	0	0
19	53056953	rs329965	G	A	23	8	31	0	0	31	0	0
19	53059235	rs9676916	T	G	47	32	79	0	0	79	0	0
19	53077411	rs162832	T	C	12	7	19	0	0	19	0	0
19	53079984	rs162827	C	T	3	3	6	0	0	6	0	0
19	53080823	rs802862	G	C	3	3	6	0	0	6	0	0
19	53080928	rs586746	A	G	4	2	6	0	0	6	0	0
19	53085659	rs366793	C	T	4	6	10	0	0	10	0	0
19	53085813	rs3745101	T	C	2	6	8	0	0	8	0	0
19	53086063	.	G	T	11	7	18	0	0	18	0	0
19	53086124	rs373554	C	A	7	5	12	0	0	12	0	0
19	53086598	rs3745102	G	A	7	2	9	0	0	9	0	0
19	53087622	rs587238	T	C	7	13	20	0	0	20	0	0
19	53088269	rs3810120	G	T	4	2	6	0	0	6	0	0
19	53088274	rs567273	T	C	4	2	6	0	0	6	0	0
19	53089639	rs329933	G	A	3	4	7	0	0	7	0	0
19	53090073	rs10402576	T	C	4	2	6	0	0	6	0	0
19	53090078	rs11558050	T	C	4	2	6	0	0	6	0	0
19	53104601	rs10401627	G	C	10	5	15	0	1	16	0	0
19	53115785	rs4664	T	A	12	22	34	0	0	34	0	0
19	53115842	rs1046679	C	T	10	21	31	0	1	32	0	0
19	53116060	rs1046648	G	A	26	20	46	0	0	46	0	0
19	53117531	rs1056185	C	T	13	13	26	0	1	27	0	0
19	53117809	rs10406458	C	A	10	15	25	0	0	25	0	0
19	53120249	rs10402789	T	A	4	8	12	0	0	12	0	0
19	53120393	rs57287728	C	T	3	7	10	0	0	10	0	0
19	53121171	rs1015304	A	G	5	2	7	0	1	8	0	0
19	53121851	rs67710655	T	C	3	3	6	0	0	6	0	0
19	53121965	rs34309553	A	G	4	3	7	0	0	7	0	0
19	53122002	rs35068187	T	C	4	3	7	0	0	7	0	0
19	53122009	rs10402372	C	T	3	4	7	0	0	7	0	0
19	53122295	.	A	G	14	20	34	0	0	34	0	0
19	53130369	rs12982142	G	C	20	13	33	0	0	33	0	0
19	53130451	rs11671080	C	T	7	3	10	0	0	10	0	0
19	53144820	rs329953	T	C	1	5	6	0	0	6	0	0
19	53145297	rs10406117	C	T	2	6	8	0	0	8	0	0
19	53147590	rs329951	C	G	6	6	12	0	0	12	0	0
19	53150962	rs802877	G	C	3	4	7	0	0	7	0	0
19	53301677	rs17770620	A	G	16	11	27	0	1	28	0	0
19	53303705	rs10417163	T	G	6	4	10	0	0	10	0	0
19	53304563	rs13382164	T	C	3	6	9	0	0	9	0	0
19	53357192	rs58476100	C	A	6	1	7	0	0	7	0	0
19	53360861	rs11673701	A	G	7	9	16	0	0	16	0	0
19	53380444	.	G	A	1	5	6	0	0	6	0	0
19	53384197	rs61745485	A	G	9	11	20	0	0	20	0	0
19	53391329	.	A	G	14	7	21	0	0	21	0	0
19	53394562	rs67704458	G	T	11	5	16	0	0	16	0	0
19	53424324	rs7251313	G	A	3	3	6	0	0	6	0	0
19	53425723	rs11672498	C	T	4	2	6	0	0	6	0	0
19	53430896	rs8104434	G	C	6	7	13	0	0	13	0	0
19	53430969	rs8104237	A	G	6	7	13	0	0	13	0	0
19	53431000	rs8104567	G	C	7	10	17	0	1	18	0	0
19	53431048	rs7250641	G	A	16	10	26	0	0	26	0	0
19	53431263	rs7250706	C	T	13	15	28	0	0	28	0	0
19	53431458	rs12982323	C	T	20	13	33	0	0	33	0	0
19	53431472	rs12982775	G	T	18	13	31	0	0	31	0	0
19	53431516	rs12984436	T	C	11	12	23	0	0	23	0	0
19	53431977	rs8110693	T	C	24	15	39	0	0	39	0	0
19	53431978	rs79589270	G	A	24	15	39	0	0	39	0	0
19	53431994	rs8109900	C	T	22	16	38	0	0	38	0	0
19	53451228	rs9304741	T	C	7	3	10	0	0	10	0	0
19	53451291	rs9304742	T	C	6	3	9	0	0	9	0	0
19	53452769	rs1044467	A	G	16	11	27	0	1	28	0	0
19	53452944	rs1808106	T	G	24	26	50	0	0	50	0	0
19	53453777	.	C	T	16	20	36	0	1	37	0	0
19	53454789	rs12459008	A	T	9	13	22	0	0	22	0	0
19	53454963	rs12461778	T	A	1	6	7	0	0	7	0	0
19	53455088	rs12461796	T	A	3	8	11	0	1	12	0	0
19	53455221	rs12150933	A	G	3	3	6	0	0	6	0	0
19	53455877	rs2011496	C	T	7	1	8	0	0	8	0	0
19	53570867	rs10405102	C	T	14	23	37	0	2	39	0	0
19	53571306	rs2288421	T	C	38	18	56	0	0	56	0	0
19	53682561	rs13382118	G	A	5	5	10	0	0	10	0	0
19	53682862	rs12971967	T	C	9	4	13	0	0	13	0	0
19	53682957	rs57993569	A	T	15	17	32	0	0	32	0	0
19	53742153	rs1129002	T	A	2	10	12	0	0	12	0	0
19	53743117	rs7260595	A	G	5	5	10	0	0	10	0	0
19	53743134	rs7246435	T	C	5	3	8	0	0	8	0	0
19	53743161	rs7245436	C	A	5	4	9	0	0	9	0	0
19	53743336	rs3097248	C	T	2	8	10	0	0	10	0	0
19	53743799	rs8100627	C	T	3	3	6	0	0	6	0	0
19	53848779	rs75887836	T	C	13	11	24	0	0	24	0	0
19	53848837	rs56683540	C	T	13	10	23	0	0	23	0	0
19	53848845	rs57319493	G	A	14	10	24	0	0	24	0	0
19	53857438	rs10413231	T	G	40	25	65	0	0	65	0	0
19	53885276	rs60179423	C	A	8	4	12	0	0	12	0	0
19	53885352	rs58896082	C	T	6	2	8	0	0	8	0	0
19	53885512	rs112464508	C	A	7	3	10	0	0	10	0	0
19	53885667	rs62115355	G	A	2	5	7	0	0	7	0	0
19	53888388	rs2708713	T	A	4	6	10	0	1	11	0	0
19	53889551	.	C	G	13	16	29	0	0	29	0	0
19	53911973	rs10425136	A	G	12	4	16	0	0	16	0	0
19	53912242	rs10426347	G	A	3	5	8	0	0	8	0	0
19	53912548	rs7246019	T	C	6	5	11	0	0	11	0	0
19	53912770	rs12461238	G	A	10	7	17	0	0	17	0	0
19	53913555	rs6509753	C	G	19	14	33	0	0	34	1	0
19	53914108	rs2068630	C	T	9	13	22	0	0	22	0	0
19	53914425	rs7253508	C	A	12	13	25	0	0	25	0	0
19	53928911	rs12978873	G	C	5	1	6	0	0	6	0	0
19	53937570	rs2708787	G	A	0	9	9	0	0	9	0	0
19	53937669	rs3975039	C	T	11	0	11	0	0	11	0	0
19	53939965	rs12609110	C	T	2	4	6	0	0	6	0	0
19	53942953	rs59449128	G	T	5	1	6	0	0	6	0	0
19	53947083	rs7260078	G	A	6	2	8	0	0	8	0	0
19	53947086	rs7259748	A	T	7	2	9	0	0	9	0	0
19	53947775	rs11669685	C	A	5	3	8	0	1	9	0	0
19	53949480	rs2708751	A	G	11	19	30	0	0	30	0	0
19	53950475	rs8111707	G	T	35	24	59	0	0	59	0	0
19	53958126	rs2708743	T	G	4	5	9	0	0	9	0	0
19	53989975	.	C	T	13	4	17	0	0	17	0	0
19	53990044	.	G	A	5	2	7	0	0	7	0	0
19	53995750	rs2708843	C	T	4	3	7	0	1	8	0	0
19	53997114	rs2708840	T	C	5	2	7	0	0	7	0	0
19	53997179	rs67149430	T	C	4	3	7	0	0	7	0	0
19	54025194	rs8100338	C	G	3	4	7	0	0	7	0	0
19	54025288	rs8100455	C	G	6	4	10	0	0	10	0	0
19	54080279	rs1351	T	C	0	215	215	0	4	219	0	0
19	54080780	rs16985052	C	T	6	299	305	0	3	308	0	0
19	54080999	rs1056393	A	G	2	324	326	0	0	326	0	0
19	54081518	rs73051595	C	T	1	177	178	0	0	178	0	0
19	54082669	rs1061422	G	C	0	106	106	0	0	106	0	0
19	54371257	rs10411316	A	G	12	10	22	0	1	23	0	0
19	54372368	rs8103284	T	C	11	6	17	0	0	17	0	0
19	54373081	rs8106162	C	T	448	435	883	0	2	885	0	0
19	54374527	rs3916463	G	A	3	3	6	0	2	9	1	0
19	54375217	rs112675959	A	G	7	2	9	0	0	9	0	0
19	54375728	rs61127220	T	C	5	4	9	0	0	9	0	0
19	54375768	rs10404559	T	A	5	1	6	0	0	6	0	0
19	54375780	rs10403321	G	T	3	3	6	0	1	7	0	0
19	54376363	rs143582466	C	T	5	8	13	0	0	13	0	0
19	54378030	rs200046918	T	C	591	57	648	0	50	698	0	0
19	54378099	rs437403	G	A	475	104	579	0	13	592	0	0
19	54378100	rs379364	A	G	482	104	586	0	5	591	0	0
19	54378156	rs146800015	A	T	556	451	1007	0	28	1036	1	0
19	54378218	rs114749560	T	C	571	560	1131	0	16	1147	0	0
19	54378242	rs13869	G	A	541	543	1084	0	9	1093	0	0
19	54378248	rs12035	C	T	593	538	1131	0	12	1143	0	0
19	54378627	rs307935	T	A	268	255	523	0	11	534	0	0
19	54378789	rs307936	C	G	364	293	657	0	110	770	3	0
19	54379573	rs8604	C	T	174	144	318	0	2	320	0	0
19	54379585	rs115895569	G	A	133	141	274	0	0	274	0	0
19	54544177	rs1035829	C	T	281	349	630	0	0	630	0	0
19	54552080	rs4806698	G	C	6	1	7	0	0	7	0	0
19	54554438	rs35538041	C	T	6	0	6	0	0	6	0	0
19	54601603	rs12980182	T	G	22	34	56	0	0	57	1	0
19	54601916	rs12985255	A	G	13	13	26	0	0	27	1	0
19	54603130	rs4806708	C	G	13	7	20	0	0	20	0	0
19	54613420	rs12609379	G	A	5	1	6	0	0	6	0	0
19	54614323	rs73062626	C	G	6	3	9	0	0	9	0	0
19	54614840	rs57911619	C	G	2	5	7	0	0	7	0	0
19	54657877	rs4806718	T	C	17	10	27	0	0	27	0	0
19	54658001	rs1055234	C	G	17	11	28	0	0	28	0	0
19	54677189	rs8736	C	T	165	219	384	0	3	387	0	0
19	54678818	rs57171876	C	T	8	9	17	0	0	17	0	0
19	54679479	rs7259243	C	T	18	17	35	0	1	36	0	0
19	54679511	rs7259361	C	T	24	9	33	0	0	33	0	0
19	54679770	rs686229	C	T	10	4	14	0	0	14	0	0
19	54680927	rs78881568	C	T	5	4	9	0	0	9	0	0
19	54682867	rs2278499	T	C	100	94	194	0	1	195	0	0
19	54704720	rs10048513	G	C	6	8	14	0	4	19	1	0
19	54704997	rs3810229	G	T	4	3	7	0	0	7	0	0
19	54705182	rs2304525	G	C	12	15	27	0	0	27	0	0
19	54705207	rs36615	G	A	16	16	32	0	0	32	0	0
19	54707248	rs12980600	A	T	39	27	66	0	0	66	0	0
19	54707845	.	C	T	32	24	56	0	1	57	0	0
19	54708129	rs71365432	G	T	42	36	78	0	1	79	0	0
19	54708430	rs3852889	A	G	21	44	65	0	1	66	0	0
19	54708646	rs3844452	A	G	33	43	76	0	1	77	0	0
19	54709277	rs10424181	C	A	36	37	73	0	0	73	0	0
19	54709328	rs17273267	T	C	34	31	65	0	1	66	0	0
19	54709443	rs17207321	T	G	56	53	109	0	1	110	0	0
19	54709944	rs3852890	G	A	157	76	233	0	4	237	0	0
19	54710673	rs3786631	T	C	95	119	214	0	1	215	0	0
19	54711032	rs4806499	A	G	81	123	204	0	0	204	0	0
19	54711258	rs2304523	T	G	98	139	237	0	0	237	0	0
19	54718604	rs11673607	G	C	17	2	19	0	0	19	0	0
19	54719858	rs12971951	T	C	9	3	12	0	1	13	0	0
19	54721814	rs12971973	A	G	4	2	6	0	0	6	0	0
19	54722275	rs1132609	G	A	27	17	44	0	0	44	0	0
19	54723355	rs255774	A	G	6	8	14	0	0	14	0	0
19	54723546	rs255773	C	T	5	5	10	0	0	10	0	0
19	54726861	.	C	T	12	0	12	0	0	12	0	0
19	54726872	.	C	G	11	0	11	0	0	11	0	0
19	54743758	.	C	A	2	5	7	0	0	7	0	0
19	54744361	rs2361801	A	C	7	4	11	0	0	11	0	0
19	54744387	.	C	T	10	4	14	0	1	15	0	0
19	54745907	.	A	G	30	2	32	0	0	32	0	0
19	54745978	.	T	C	10	12	22	0	0	22	0	0
19	54745989	rs1052963	G	C	10	9	19	0	0	19	0	0
19	54746051	.	A	C	20	12	32	0	1	33	0	0
19	54746081	.	T	C	16	18	34	0	0	34	0	0
19	54781569	rs184032968	C	T	3	3	6	0	0	6	0	0
19	54782407	rs1128646	C	T	48	55	103	0	0	103	0	0
19	54782704	rs7247451	G	C	45	16	61	0	2	63	0	0
19	54782710	rs7247208	A	G	43	16	59	0	0	59	0	0
19	54782724	rs7247538	G	A	44	15	59	0	1	60	0	0
19	54784898	rs13345054	A	C	18	14	32	0	1	33	0	0
19	54784908	rs13345069	C	A	17	13	30	0	1	31	0	0
19	54784922	rs13347078	T	C	15	10	25	0	1	26	0	0
19	54784928	rs13347079	T	C	13	8	21	0	0	21	0	0
19	54803504	rs6509862	A	C	25	7	32	0	0	32	0	0
19	54871664	rs35781676	G	C	105	34	139	0	0	139	0	0
19	54875791	rs73604725	T	C	5	9	14	0	0	14	0	0
19	54879975	rs1985841	T	C	6	3	9	0	0	9	0	0
19	54880811	rs11084332	T	C	2	6	8	0	0	8	0	0
19	54881850	.	G	T	12	3	15	0	0	15	0	0
19	54973280	rs10423424	C	G	4	2	6	0	0	6	0	0
19	54973307	rs115799049	C	T	2	4	6	0	0	6	0	0
19	55085304	rs111997702	G	A	42	52	94	0	2	96	0	0
19	55085925	rs61739166	T	G	86	90	176	0	0	176	0	0
19	55087313	rs7249811	T	G	127	93	220	0	1	221	0	0
19	55101148	rs9304761	G	C	3	4	7	0	0	7	0	0
19	55101173	rs9676790	C	G	4	6	10	0	0	10	0	0
19	55106317	rs10416917	A	G	5	5	10	0	0	10	0	0
19	55106663	rs10417589	A	G	3	6	9	0	0	9	0	0
19	55106773	rs2182092	G	A	11	11	22	0	1	23	0	0
19	55106865	rs373854	T	C	5	7	12	0	0	12	0	0
19	55107854	rs116973751	G	T	5	6	11	0	0	11	0	0
19	55110773	rs45541031	G	A	3	6	9	0	0	9	0	0
19	55112296	rs74905518	G	A	5	1	6	0	0	6	0	0
19	55112865	rs4078790	T	C	7	1	8	0	0	8	0	0
19	55144623	rs61739171	C	T	4	2	6	0	0	6	0	0
19	55148242	rs1061684	C	T	2	4	6	0	0	6	0	0
19	55148299	rs41548213	C	A	4	4	8	0	0	8	0	0
19	55148331	rs8101240	C	T	6	3	9	0	0	9	0	0
19	55148487	rs8101605	G	A	3	3	6	0	0	6	0	0
19	55149254	rs1056452	G	A	6	5	11	0	0	11	0	0
19	55175740	rs3745871	C	T	6	1	7	0	0	7	0	0
19	55378490	rs1865095	A	G	2	4	6	0	0	6	0	0
19	55392957	rs73932253	G	T	4	7	11	0	0	11	0	0
19	55402085	.	C	T	140	141	281	0	4	285	0	0
19	55533845	rs4806632	C	G	1	6	7	0	0	7	0	0
19	55553647	rs1654439	T	G	4	2	6	0	0	6	0	0
19	55554232	rs1671217	A	G	8	4	12	0	0	12	0	0
19	55594996	rs1628576	C	G	4	6	10	0	0	10	0	0
19	55598724	rs1054940	A	G	6	11	17	0	0	17	0	0
19	55609374	rs2603698	C	T	3	6	9	0	0	9	0	0
19	55609588	rs2532058	C	A	2	12	14	0	0	14	0	0
19	55614923	rs2532060	T	C	56	42	98	0	0	98	0	0
19	55628609	rs66707428	A	G	13	4	17	0	0	17	0	0
19	55658088	rs11669534	G	A	9	47	56	0	0	56	0	0
19	55738181	rs3826884	G	A	41	16	57	0	1	58	0	0
19	55738425	rs3745919	G	A	48	15	63	0	0	63	0	0
19	55738746	rs4374298	G	A	13	8	21	0	2	23	0	0
19	55739605	rs4606850	C	T	19	17	36	0	0	36	0	0
19	55739813	rs10419308	G	A	10	8	18	0	0	18	0	0
19	55741205	rs3826886	G	A	172	126	298	0	1	299	0	0
19	55746013	rs7508606	C	T	12	8	20	0	0	20	0	0
19	55746955	rs7248953	T	C	5	3	8	0	0	8	0	0
19	55832427	rs10412726	T	G	4	4	8	0	0	8	0	0
19	55843654	rs60978141	A	C	6	1	7	0	0	7	0	0
19	55897964	.	T	C	4475	4601	9076	0	118	9194	0	0
19	55911321	rs62128216	C	T	6	5	11	0	0	11	0	0
19	55912332	rs11669732	C	T	5	6	11	0	0	11	0	0
19	55913038	rs7608	C	T	170	206	376	0	1	378	1	0
19	55913678	rs12709950	C	A	15	11	26	0	1	27	0	0
19	55914374	rs11672075	C	T	41	20	61	0	0	61	0	0
19	55916059	rs10853877	C	A	5	2	7	0	0	7	0	0
19	55993961	.	C	A	10	4	14	0	0	14	0	0
19	55998742	.	T	G	114	98	212	0	2	215	1	0
19	56089219	rs1053817	C	T	93	83	176	0	9	185	0	0
19	56089353	rs2292812	C	T	78	85	163	0	3	166	0	0
19	56090493	rs12974617	A	C	2	5	7	0	0	7	0	0
19	56091437	rs12610510	A	C	10	8	18	0	0	18	0	0
19	56091674	rs34937940	T	C	4	4	8	0	0	8	0	0
19	56091768	rs76516526	G	A	7	2	9	0	0	9	0	0
19	56091782	rs78670840	G	A	7	2	9	0	0	9	0	0
19	56104136	rs7247236	T	C	4	2	6	0	0	6	0	0
19	56109916	rs497264	C	T	5	7	12	0	0	12	0	0
19	56114237	rs310459	G	A	35	51	86	0	3	89	0	0
19	56118243	rs11667786	C	T	2	4	6	0	0	6	0	0
19	56122852	rs310466	A	C	3	5	8	0	1	9	0	0
19	56128243	rs73058308	C	G	113	124	237	0	2	239	0	0
19	56132661	rs751729	G	A	43	69	112	0	0	112	0	0
19	56146469	rs8108198	G	A	6	9	15	0	0	15	0	0
19	56146924	rs8111497	G	C	10	7	17	0	0	17	0	0
19	56160399	rs7246799	T	C	48	57	105	0	1	106	0	0
19	56165544	rs504003	T	C	13	25	38	0	0	38	0	0
19	56165921	rs2280255	G	A	35	28	63	0	1	64	0	0
19	56171778	rs507498	A	C	12	3	15	0	1	16	0	0
19	56173377	rs79546472	G	C	26	12	38	0	1	39	0	0
19	56173551	rs310445	C	T	11	13	24	0	0	24	0	0
19	56175147	rs2303087	C	A	6	6	12	0	0	12	0	0
19	56175149	rs310444	G	A	6	6	12	0	0	12	0	0
19	56175245	rs310443	C	A	9	2	11	0	0	11	0	0
19	56175414	rs310442	G	T	3	6	9	0	0	9	0	0
19	56176272	rs310440	G	C	3	5	8	0	0	8	0	0
19	56176345	rs310439	G	A	5	5	10	0	0	10	0	0
19	56177298	rs310438	T	C	4	3	7	0	0	7	0	0
19	56179746	rs58490076	G	A	13	5	18	0	0	18	0	0
19	56180281	rs679577	T	C	52	44	96	0	0	96	0	0
19	56180307	rs630491	C	T	53	43	96	0	0	96	0	0
19	56181900	rs1308835	C	G	4	3	7	0	0	7	0	0
19	56182472	rs600106	A	G	5	3	8	0	0	8	0	0
19	56184914	rs78831089	T	C	3	4	7	0	0	7	0	0
19	56187179	rs78041391	C	T	7	12	19	0	0	19	0	0
19	56188985	rs74369843	C	G	4	5	9	0	0	9	0	0
19	56189341	rs77820224	C	G	13	10	23	0	0	23	0	0
19	56189412	rs76206632	A	G	9	7	16	0	2	18	0	0
19	56198059	rs76080867	G	A	5	4	9	0	0	9	0	0
19	56199605	rs74587635	C	T	5	7	12	0	0	12	0	0
19	56199770	rs77250423	C	T	5	4	9	0	0	9	0	0
19	56202366	.	C	T	5	9	14	0	1	15	0	0
19	56203985	rs66906879	A	G	2	8	10	0	0	10	0	0
19	56206137	rs11545669	G	C	172	145	317	0	1	319	1	0
19	56274424	.	C	A	14	3	17	0	0	17	0	0
19	56274453	.	G	A	14	1	15	0	0	15	0	0
19	56671019	rs181632973	C	T	14	7	21	0	0	21	0	0
19	56882697	rs11665972	A	G	2	4	6	0	0	6	0	0
19	56887208	rs2304123	C	T	5	3	8	0	0	8	0	0
19	56888101	rs1860568	C	T	3	4	7	0	0	7	0	0
19	56888450	rs2304124	A	G	22	32	54	0	0	54	0	0
19	56888454	rs2304125	A	C	33	22	55	0	0	55	0	0
19	56888650	rs33949495	C	T	52	24	76	0	0	76	0	0
19	56889608	rs14049	C	T	7	12	19	0	0	19	0	0
19	56889833	rs12981331	T	A	2	4	6	0	0	6	0	0
19	56890093	rs35086353	C	T	15	10	25	0	0	25	0	0
19	56890176	rs73621238	T	C	8	9	17	0	0	17	0	0
19	56951374	rs7248278	C	T	28	38	66	0	0	66	0	0
19	56952109	rs2165048	G	A	18	18	36	0	0	36	0	0
19	56953585	rs3760849	T	C	19	25	44	0	1	45	0	0
19	56953963	rs35914474	G	A	18	14	32	0	1	33	0	0
19	56985396	rs35461173	C	A	7	3	10	0	0	10	0	0
19	57006415	rs17207481	A	G	24	1	25	0	0	25	0	0
19	57006721	rs7253	G	C	83	23	106	0	0	106	0	0
19	57066013	rs10409531	C	T	4	7	11	0	0	11	0	0
19	57066908	rs35189154	C	T	3	7	10	0	0	10	0	0
19	57068039	rs7258886	C	T	1	5	6	0	0	6	0	0
19	57068663	rs7259577	A	C	3	3	6	0	0	6	0	0
19	57068749	rs4801174	C	T	4	2	6	0	0	6	0	0
19	57068986	rs10405702	G	C	5	5	10	0	0	10	0	0
19	57069080	rs11670421	G	T	7	5	12	0	0	12	0	0
19	57085769	rs10421285	G	C	6	2	8	0	0	8	0	0
19	57703077	rs2302058	T	G	14	10	24	0	0	24	0	0
19	57703209	rs2302059	T	C	9	7	16	0	3	19	0	0
19	57703369	rs7250511	T	C	3	6	9	0	0	9	0	0
19	57703565	rs3787031	T	C	2	4	6	0	1	7	0	0
19	57704262	rs8107613	A	G	5	6	11	0	0	11	0	0
19	57704516	rs10417807	T	C	4	6	10	0	0	10	0	0
19	57705033	rs924020	C	T	9	7	16	0	0	16	0	0
19	57706254	rs4801439	G	A	19	21	40	0	1	41	0	0
19	57723007	rs2074858	G	C	14	11	25	0	0	25	0	0
19	57723013	rs917340	G	A	13	11	24	0	1	25	0	0
19	57760018	rs2014572	G	A	15	11	26	0	0	26	0	0
19	57760057	rs3746231	G	A	20	7	27	0	0	27	0	0
19	57764770	rs10421632	G	A	14	10	24	0	0	24	0	0
19	57765432	rs8100154	A	G	11	16	27	0	0	27	0	0
19	57766301	rs74851517	G	A	15	13	28	0	1	29	0	0
19	57903918	rs76608813	C	T	5	3	8	0	0	8	0	0
19	57908945	rs55706256	G	T	6	9	15	0	0	15	0	0
19	57909297	rs55789053	C	T	7	18	25	0	0	25	0	0
19	57909872	rs4801478	G	A	59	56	115	0	0	115	0	0
19	57912334	rs12978811	G	A	47	43	90	0	1	91	0	0
19	57913872	rs10407882	C	T	5	7	12	0	0	12	0	0
19	57931553	rs10417533	C	T	5	5	10	0	0	10	0	0
19	57933003	rs2023761	T	C	2	4	6	0	0	6	0	0
19	57946924	rs56241253	G	C	2	5	7	0	0	7	0	0
19	57957166	rs111741823	A	G	3	3	6	0	0	6	0	0
19	57957193	rs73635371	G	A	4	2	6	0	0	6	0	0
19	57966080	rs8101158	C	A	2	5	7	0	0	7	0	0
19	57981687	rs56278798	C	T	8	6	14	0	0	14	0	0
19	57982983	rs12985337	T	C	9	9	18	0	0	18	0	0
19	57983897	rs10407309	T	C	5	6	11	0	0	11	0	0
19	57984037	rs12977532	G	A	12	6	18	0	0	18	0	0
19	57984063	rs10406544	G	A	5	11	16	0	0	16	0	0
19	57984096	rs10406026	A	C	5	10	15	0	0	15	0	0
19	57984190	rs12977381	C	A	8	4	12	0	0	12	0	0
19	57984426	rs10407042	C	A	5	7	12	0	0	12	0	0
19	57984918	rs2074058	A	G	6	7	13	0	0	13	0	0
19	58002575	rs6510083	G	C	7	4	11	0	0	11	0	0
19	58002964	rs1135692	G	C	7	7	14	0	0	14	0	0
19	58011421	rs12463137	G	T	7	11	18	0	0	18	0	0
19	58018848	rs2066936	A	G	36	31	67	0	0	67	0	0
19	58053313	rs45533235	A	G	5	3	8	0	0	8	0	0
19	58058739	rs10410631	T	C	15	11	26	0	0	26	0	0
19	58200099	rs3746208	T	C	23	28	51	0	1	52	0	0
19	58200628	rs12608585	G	T	47	43	90	0	1	91	0	0
19	58201360	rs12981782	C	T	43	51	94	0	1	95	0	0
19	58202501	rs10406484	T	C	6	0	6	0	0	6	0	0
19	58205188	rs9304799	T	A	2	6	8	0	0	8	0	0
19	58209064	rs1052850	G	C	3	4	7	0	0	7	0	0
19	58210841	rs56241609	G	A	2	6	8	0	0	8	0	0
19	58213693	rs61730373	C	T	3	4	7	0	0	7	0	0
19	58213773	rs2188736	G	C	4	4	8	0	0	8	0	0
19	58231541	rs1059397	A	G	31	20	51	0	0	51	0	0
19	58231807	rs2239986	A	G	33	17	50	0	0	50	0	0
19	58233008	rs3746207	G	A	28	15	43	0	1	44	0	0
19	58234218	rs1544358	A	G	8	4	12	0	0	12	0	0
19	58234915	rs9676736	T	C	2	4	6	0	0	6	0	0
19	58266192	rs12609667	C	T	46	64	110	0	0	110	0	0
19	58269173	rs13037	G	C	73	84	157	0	1	158	0	0
19	58288169	rs2285615	C	T	5	1	6	0	0	6	0	0
19	58290550	.	G	T	78	58	136	0	2	138	0	0
19	58291228	rs2158013	A	G	70	76	146	0	1	147	0	0
19	58291847	rs10419004	G	A	92	75	167	0	0	167	0	0
19	58411834	rs10804	C	G	6	1	7	0	0	7	0	0
19	58413648	.	G	A	3	4	7	0	0	7	0	0
19	58417899	rs111616082	G	A	11	12	23	0	1	24	0	0
19	58418818	rs34513698	G	A	16	13	29	0	0	29	0	0
19	58419180	rs73068597	G	A	5	9	14	0	0	14	0	0
19	58419841	rs10414704	G	T	10	10	20	0	1	21	0	0
19	58419874	rs10415951	T	C	15	12	27	0	1	28	0	0
19	58420152	rs17845779	C	A	12	10	22	0	0	22	0	0
19	58420162	rs10416584	T	C	10	10	20	0	1	21	0	0
19	58420167	rs17852300	T	C	11	11	22	0	0	22	0	0
19	58420699	rs3745133	C	A	13	6	19	0	0	19	0	0
19	58421128	rs3826671	C	T	2	12	14	0	0	14	0	0
19	58426026	rs57417413	T	C	2	4	6	0	1	7	0	0
19	58453342	rs959231	T	C	61	61	122	0	1	123	0	0
19	58489387	rs525221	A	G	25	22	47	0	1	48	0	0
19	58491627	rs11673029	T	C	25	24	49	0	0	49	0	0
19	58509332	rs75731757	A	C	3	5	8	0	0	8	0	0
19	58510258	rs16988351	T	C	6	5	11	0	0	11	0	0
19	58510882	rs1035521	G	A	6	1	7	0	0	7	0	0
19	58511150	rs10451433	C	T	10	2	12	0	0	12	0	0
19	58513807	rs4801243	A	C	6	5	11	0	0	11	0	0
19	58513878	rs113843235	A	G	1	7	8	0	0	8	0	0
19	58517681	rs12462562	C	T	4	4	8	0	0	8	0	0
19	58547449	rs159872	C	A	1	22	23	0	0	23	0	0
19	58547516	rs159873	G	A	1	18	19	0	0	19	0	0
19	58548431	rs159874	T	C	0	11	11	0	0	11	0	0
19	58548658	rs193390	C	T	1	7	8	0	0	8	0	0
19	58548760	rs184128	A	G	1	10	11	0	0	11	0	0
19	58549366	rs159870	C	G	0	7	7	0	0	7	0	0
19	58549593	rs2241406	C	G	0	10	10	0	0	10	0	0
19	58596449	rs2258557	C	T	17	11	28	0	0	28	0	0
19	58596925	rs295350	G	A	4	5	9	0	0	9	0	0
19	58598784	rs2260914	A	G	2	6	8	0	0	8	0	0
19	58604114	rs10409388	A	G	2	7	9	0	0	9	0	0
19	58604319	rs6510116	G	T	2	6	8	0	0	8	0	0
19	58610107	rs2547257	A	G	16	3	19	0	0	19	0	0
19	58610720	rs2547352	A	T	4	6	10	0	0	10	0	0
19	58619847	rs933670	C	T	1	5	6	0	0	6	0	0
19	58620103	rs918544	T	A	1	5	6	0	0	6	0	0
19	58638399	rs2547360	G	A	68	49	117	0	0	117	0	0
19	58638685	rs2547258	C	T	43	44	87	0	2	89	0	0
19	58720236	rs75597	A	G	6	7	13	0	0	13	0	0
19	58720717	rs101447	A	G	7	11	18	0	0	18	0	0
19	58720918	rs260418	G	A	9	8	17	0	1	18	0	0
19	58720992	rs10415286	G	A	13	5	18	0	0	18	0	0
19	58721952	rs260419	A	C	2	10	12	0	0	12	0	0
19	58740490	rs63283	G	A	5	6	11	0	0	11	0	0
19	58740606	rs260439	C	T	9	11	20	0	0	20	0	0
19	58748630	rs260481	A	G	3	5	8	0	0	8	0	0
19	58770883	rs260461	G	A	7	6	13	0	0	13	0	0
19	58808709	rs931258	A	C	2	6	8	0	0	8	0	0
19	58809007	rs8106692	G	A	11	3	14	0	0	14	0	0
19	58809154	rs8107581	T	G	16	9	25	0	0	25	0	0
19	58809647	rs8107546	G	A	8	7	15	0	0	15	0	0
19	58821664	rs11879274	G	A	29	35	64	0	0	64	0	0
19	58826521	rs11084541	T	G	90	50	140	0	0	140	0	0
19	58900399	rs73060256	A	G	16	10	26	0	0	26	0	0
19	58944605	.	A	G	5	7	12	0	0	12	0	0
19	58978517	rs4801595	G	A	13	21	34	0	0	34	0	0
19	58983551	.	G	A	15	20	35	0	0	35	0	0
19	58986799	rs3794968	G	C	12	10	22	0	0	22	0	0
19	58989495	rs893185	A	C	36	24	60	0	0	60	0	0
19	58990041	rs2011665	A	C	9	5	14	0	0	14	0	0
19	58990045	rs2011666	A	C	9	5	14	0	0	14	0	0
19	58991479	rs882609	G	A	6	4	10	0	0	10	0	0
19	58991900	rs882610	G	A	35	34	69	0	0	69	0	0
19	59028162	rs35430780	G	C	21	19	40	0	0	40	0	0
19	59058083	rs7249714	G	T	27	21	48	0	0	48	0	0
19	59065952	rs873104	T	C	11	7	18	0	0	18	0	0
19	59069353	rs3794965	T	C	6	6	12	0	0	12	0	0
19	59082605	rs3752109	C	T	8	7	15	0	0	15	0	0
19	59084306	rs1867726	T	G	3	3	6	0	0	6	0	0
19	59093239	rs10448	T	C	16	22	38	0	0	38	0	0
19	59093464	rs7910	C	T	25	41	66	0	0	66	0	0
19	59093484	rs3499	G	T	22	35	57	0	1	58	0	0
19	59094453	rs3211055	A	C	19	6	25	0	0	25	0	0
19	59094709	rs3752108	C	G	19	25	44	0	0	44	0	0
19	59095126	rs8110595	G	T	13	11	24	0	0	24	0	0
19	59098587	rs3892843	G	A	1	5	6	0	0	6	0	0
19	59100589	rs3190203	A	G	15	5	20	0	0	20	0	0
19	59110517	.	G	A	6	4	10	0	0	10	0	0
19	59110529	.	C	A	6	0	6	0	0	6	0	0
2	218386	rs9213	G	A	8	3	11	0	0	11	0	0
2	224919	rs2290911	A	G	8	0	8	0	0	8	0	0
2	272203	rs11553746	C	T	165	220	385	0	3	388	0	0
2	273070	rs12714403	A	G	7	3	10	0	0	10	0	0
2	274672	rs62114548	C	G	5	2	7	0	0	7	0	0
2	276908	rs7568288	C	G	6	7	13	0	0	13	0	0
2	277003	rs79716074	A	G	318	368	686	0	7	693	0	0
2	277314	rs77927634	G	A	410	331	741	0	7	748	0	0
2	668618	rs17729501	T	C	8	15	23	0	0	23	0	0
2	669023	rs3187671	C	T	7	15	22	0	0	22	0	0
2	670125	rs73153245	C	T	4	3	7	0	0	7	0	0
2	671137	rs150714352	C	A	3	4	7	0	0	7	0	0
2	671260	rs10172821	T	C	4	2	6	0	0	6	0	0
2	671939	rs12714416	A	G	3	5	8	0	0	8	0	0
2	672080	rs73153249	T	G	3	4	7	0	0	7	0	0
2	676177	rs2293083	C	G	4	6	10	0	0	10	0	0
2	677295	rs3210390	C	T	80	109	189	0	1	190	0	0
2	1542749	rs28913042	C	T	2	5	7	0	0	7	0	0
2	1542758	rs10188260	A	G	2	6	8	0	0	8	0	0
2	3193040	rs17682	G	A	63	56	119	0	0	119	0	0
2	3469463	rs4971514	G	C	31	24	55	0	0	55	0	0
2	3483205	rs6767	C	T	31	22	53	0	0	53	0	0
2	3606469	rs6715189	C	A	31	20	51	0	1	52	0	0
2	3609064	rs12629	G	A	21	25	46	0	0	46	0	0
2	3622912	rs11558965	G	T	72	78	150	0	0	151	1	0
2	3624303	rs80103345	G	A	5	5	10	0	1	11	0	0
2	3624615	rs62106035	T	C	4	5	9	0	1	10	0	0
2	3624917	rs62106036	C	T	5	6	11	0	0	11	0	0
2	3625147	rs62106037	G	C	9	3	12	0	0	12	0	0
2	3626020	rs62106038	T	A	14	6	20	0	0	20	0	0
2	3626418	rs11123626	T	C	17	11	28	0	1	29	0	0
2	3626440	rs62106039	T	G	18	12	30	0	0	30	0	0
2	3627302	rs62106040	A	T	15	10	25	0	0	25	0	0
2	3627648	rs7576238	G	C	10	13	23	0	1	24	0	0
2	7164578	rs376219	A	G	13	14	27	0	0	27	0	0
2	7179925	.	C	T	14	14	28	0	1	29	0	0
2	7180245	.	C	A	10	9	19	0	0	19	0	0
2	7180924	.	C	T	14	7	21	0	0	21	0	0
2	7181272	.	A	G	5	4	9	0	1	10	0	0
2	7181560	rs309303	G	A	17	17	34	0	1	35	0	0
2	7181790	.	C	T	26	20	46	0	0	46	0	0
2	7183787	rs17668081	G	A	29	25	54	0	0	54	0	0
2	7183977	rs1050563	G	A	17	12	29	0	0	29	0	0
2	8871342	rs1044280	C	A	22	36	58	0	0	58	0	0
2	8929759	rs13411410	G	C	5	5	10	0	0	10	0	0
2	8933641	rs7587623	C	G	7	10	17	0	0	17	0	0
2	8960809	rs13390283	C	T	3	6	9	0	1	10	0	0
2	8964580	rs7563832	G	A	5	3	8	0	0	8	0	0
2	8996442	rs199666547	A	C	5	3	8	0	0	8	0	0
2	9459406	rs4627537	C	T	2	4	6	0	0	6	0	0
2	9528536	rs2715860	G	C	20	15	35	0	0	35	0	0
2	9543852	rs11537589	G	A	18	15	33	0	1	34	0	0
2	9546805	rs4798	C	T	13	7	20	0	0	20	0	0
2	9547171	rs10929579	G	A	3	3	6	0	0	6	0	0
2	9547363	rs10929580	C	A	5	1	6	0	0	6	0	0
2	9581666	rs7607741	G	A	8	9	17	0	0	17	0	0
2	9581741	rs7582154	C	T	4	5	9	0	0	9	0	0
2	9629367	rs13008101	T	G	35	47	82	0	3	85	0	0
2	9629731	rs10063	T	C	40	41	81	0	1	82	0	0
2	9630016	rs1130094	T	C	30	43	73	0	1	74	0	0
2	9630231	rs6705408	C	T	47	59	106	0	0	106	0	0
2	9631340	rs10495562	T	C	7	3	10	0	0	10	0	0
2	9631834	rs56198091	A	G	9	7	16	0	0	16	0	0
2	9632718	rs12473402	C	A	5	3	8	0	0	8	0	0
2	9633137	rs4622692	T	G	8	5	13	0	0	13	0	0
2	9634856	rs1048610	A	G	50	46	96	0	0	96	0	0
2	9640526	rs6745500	T	C	2	4	6	0	0	6	0	0
2	9695888	rs55790676	G	T	6	4	10	0	0	10	0	0
2	9695906	rs12692386	A	G	4	2	6	0	1	7	0	0
2	9696564	rs2177639	T	G	7	3	10	0	0	10	0	0
2	9727726	.	G	C	6	11	17	0	0	17	0	0
2	9728574	rs67724256	A	G	6	6	12	0	0	12	0	0
2	9729165	rs13024142	C	T	6	2	8	0	0	8	0	0
2	9730208	rs17362734	A	G	7	11	18	0	0	18	0	0
2	9767441	rs16867083	T	C	4	2	6	0	0	6	0	0
2	9767771	rs1524667	T	C	5	1	6	0	0	6	0	0
2	9767944	rs60319753	A	G	7	1	8	0	0	8	0	0
2	9770613	rs1130874	G	A	149	63	212	0	0	232	20	0
2	9983529	rs114421205	G	A	6	1	7	0	0	7	0	0
2	9983530	rs114862830	C	A	6	1	7	0	0	7	0	0
2	9983686	rs2303914	G	T	12	14	26	0	1	27	0	0
2	10050947	rs1054561	T	C	18	13	31	0	0	31	0	0
2	10050960	rs1054565	A	G	15	12	27	0	0	27	0	0
2	10059770	rs1820965	G	T	23	9	32	0	0	32	0	0
2	10061592	rs2357391	C	T	5	1	6	0	0	6	0	0
2	10188649	rs11687357	A	T	6	3	9	0	0	9	0	0
2	10194487	rs7632	T	C	9	8	17	0	0	17	0	0
2	10262920	rs1130609	T	G	4	7	11	0	0	11	0	0
2	10455153	rs4081662	C	T	3	6	9	0	0	9	0	0
2	10455155	rs4081663	C	T	3	6	9	0	0	9	0	0
2	10455287	rs1861230	C	T	6	4	10	0	0	10	0	0
2	10455625	rs1861231	G	A	5	8	13	0	0	13	0	0
2	10456099	rs6706155	C	T	11	9	20	0	0	20	0	0
2	10498736	rs6734890	T	C	1	8	9	0	0	9	0	0
2	10537018	rs2270302	A	G	4	10	14	0	0	14	0	0
2	10541373	rs3771144	A	G	2	4	6	0	0	6	0	0
2	10541375	rs3771143	A	C	2	4	6	0	0	6	0	0
2	10541712	rs9917245	T	G	4	3	7	0	0	7	0	0
2	10544007	rs62130187	G	T	2	4	6	0	0	6	0	0
2	10580967	rs1049500	G	A	552	499	1051	0	4	1055	0	0
2	10585311	rs2302614	A	C	280	227	507	0	3	510	0	0
2	10711112	rs78463923	G	A	8	5	13	0	0	13	0	0
2	10711197	rs35551831	A	G	6	3	9	0	0	9	0	0
2	10711446	rs13028945	T	C	4	4	8	0	0	8	0	0
2	10711494	rs12998328	C	T	4	4	8	0	0	8	0	0
2	10711922	rs1045600	G	A	45	35	80	0	4	84	0	0
2	10711964	rs1045598	T	C	54	46	100	0	2	102	0	0
2	10711981	rs1045597	C	T	54	50	104	0	1	105	0	0
2	10711987	rs1045596	C	T	50	40	90	0	10	100	0	0
2	10712278	rs3732114	C	T	88	116	204	0	2	206	0	0
2	10715169	rs56038505	C	T	6	0	6	0	0	6	0	0
2	10715720	rs9973572	C	G	1	5	6	0	0	6	0	0
2	10715777	rs12692410	G	A	1	11	12	0	0	12	0	0
2	10715847	rs9973898	G	A	2	19	21	0	0	21	0	0
2	10717806	rs2287059	C	T	112	82	194	0	1	195	0	0
2	10748343	rs6432115	G	T	3	8	11	0	0	11	0	0
2	10774531	rs77767350	C	T	5	2	7	0	0	7	0	0
2	10784491	rs3732111	A	G	72	58	130	0	0	130	0	0
2	10924524	rs1198873	T	C	38	19	57	0	1	58	0	0
2	10926444	rs6432145	T	C	5	7	12	0	0	12	0	0
2	10926767	rs17455708	A	G	21	9	30	0	0	30	0	0
2	10927218	rs56138270	C	A	5	10	15	0	0	15	0	0
2	10929133	rs1734430	A	G	4	3	7	0	0	7	0	0
2	10929342	rs1734429	A	G	5	1	6	0	0	6	0	0
2	10929867	rs11904084	T	C	4	2	6	0	0	6	0	0
2	10932748	rs1734424	T	C	6	2	8	0	0	8	0	0
2	10932765	rs55648622	C	T	6	2	8	0	0	8	0	0
2	10933249	rs4799	C	T	527	473	1000	0	4	1004	0	0
2	10933421	rs1686517	G	A	5	1	6	0	0	6	0	0
2	10942687	rs4758	C	T	283	244	527	0	3	530	0	0
2	11318477	rs3911110	C	T	49	38	87	0	1	88	0	0
2	11586035	rs11203	G	A	10	8	18	0	0	18	0	0
2	11586219	rs1047392	A	G	5	7	12	0	0	12	0	0
2	11586556	rs112341910	G	A	6	3	9	0	0	9	0	0
2	11924293	rs3762583	G	A	6	3	9	0	0	9	0	0
2	12857916	.	G	A	3	3	6	0	0	6	0	0
2	12858078	rs77773048	G	A	6	7	13	0	0	13	0	0
2	15643833	rs13032011	G	A	2	5	7	0	0	7	0	0
2	15746975	rs7579604	A	T	5	3	8	0	0	8	0	0
2	15768010	rs72780880	A	G	4	4	8	0	0	8	0	0
2	15768876	rs11900266	G	A	4	9	13	0	0	13	0	0
2	20097874	rs12328613	T	C	32	26	58	0	0	58	0	0
2	20100988	rs7572167	A	C	23	12	35	0	1	36	0	0
2	20101229	rs60084614	C	A	16	14	30	0	0	30	0	0
2	20101363	rs7584726	G	A	22	19	41	0	1	42	0	0
2	20101487	rs2304589	G	A	26	18	44	0	0	44	0	0
2	20131079	rs1191778	T	C	21	30	51	0	0	51	0	0
2	20135283	rs6741091	T	C	35	16	51	0	0	51	0	0
2	20164291	rs62109418	C	T	3	3	6	0	0	6	0	0
2	20189015	rs1060742	T	C	21	11	32	0	0	32	0	0
2	20233135	rs1191824	T	C	6	6	12	0	0	12	0	0
2	20233573	rs1191823	A	G	12	11	23	0	0	23	0	0
2	20233929	rs936509	C	T	7	9	16	0	0	16	0	0
2	20235199	rs1016317	T	A	27	27	54	0	0	54	0	0
2	20235393	rs1016318	A	T	16	12	28	0	1	29	0	0
2	20235917	rs1028051	A	G	17	7	24	0	0	24	0	0
2	20236330	rs1147116	T	C	16	16	32	0	0	32	0	0
2	20448561	rs1043419	A	G	11	8	19	0	0	19	0	0
2	20465218	rs55747711	G	A	6	3	9	0	0	9	0	0
2	20467929	rs4666299	C	T	4	3	7	0	0	7	0	0
2	20490841	rs917904	T	A	9	3	12	0	0	12	0	0
2	20491212	rs11096655	G	A	8	5	13	0	1	14	0	0
2	20492952	rs4666379	T	C	3	3	6	0	0	6	0	0
2	20493207	rs4666300	C	T	4	5	9	0	0	9	0	0
2	20521647	rs719148	G	A	6	4	10	0	0	10	0	0
2	20648211	rs1062292	G	T	94	101	195	0	0	195	0	0
2	20817673	rs1047176	G	A	9	6	15	0	0	15	0	0
2	20818193	rs3732154	G	A	14	12	26	0	0	26	0	0
2	20818286	rs3821217	A	C	3	10	13	0	0	13	0	0
2	20818454	rs3732152	T	A	1	5	6	0	0	6	0	0
2	20818517	rs3732150	T	C	5	4	9	0	0	9	0	0
2	20818764	rs3732149	C	T	13	12	25	0	0	25	0	0
2	20838222	rs3796065	C	T	25	29	54	0	4	58	0	0
2	23972049	rs573567893	A	C	5	5	10	0	0	10	0	0
2	23973603	rs2712065	A	G	6	6	12	0	0	12	0	0
2	24046426	rs75866363	G	A	5	2	7	0	0	7	0	0
2	24150163	rs78332127	C	G	6	4	10	0	0	10	0	0
2	24150632	rs13021384	G	A	2	6	8	0	0	8	0	0
2	24150783	rs112139157	A	C	8	7	15	0	0	15	0	0
2	24162663	rs72796369	G	T	1	7	8	0	0	8	0	0
2	24223202	rs114494076	A	G	75	69	144	0	1	145	0	0
2	24223362	rs114795698	A	G	53	70	123	0	1	124	0	0
2	24223456	rs116135489	G	A	43	35	78	0	1	79	0	0
2	24223609	rs115354092	T	C	22	25	47	0	0	47	0	0
2	24224087	rs113365896	C	T	13	12	25	0	0	25	0	0
2	24225073	rs149960879	G	A	23	13	36	0	1	37	0	0
2	24225621	rs1044277	T	C	29	13	42	0	0	42	0	0
2	24226907	rs117245337	G	A	30	27	57	0	0	57	0	0
2	24226986	rs116442880	C	T	15	25	40	0	1	41	0	0
2	24290671	rs61742149	G	A	963	1155	2118	0	8	2126	0	0
2	24323610	rs55816106	T	C	48	38	86	0	0	86	0	0
2	24439048	rs3731625	A	G	16	12	28	0	1	29	0	0
2	24524958	rs7603997	C	T	22	36	58	0	2	60	0	0
2	25141434	rs61732745	G	A	8	11	19	0	1	20	0	0
2	25141538	rs11676272	A	G	5	8	13	0	0	13	0	0
2	25195577	rs76286777	T	C	9	17	26	0	0	26	0	0
2	25469502	rs2276598	C	T	9	25	34	0	0	34	0	0
2	25470905	.	C	T	3	10	13	0	0	13	0	0
2	25655772	rs7583475	T	C	16	15	31	0	1	32	0	0
2	25961583	rs10153560	A	G	3	7	10	0	0	10	0	0
2	26257382	rs75606451	C	T	115	104	219	0	6	225	0	0
2	26359315	rs3177055	G	A	6	5	11	0	0	11	0	0
2	26415093	rs1865323	A	C	2	11	13	0	0	13	0	0
2	26424384	rs13004974	G	A	3	3	6	0	0	6	0	0
2	26467666	rs3806516	G	A	3	4	7	0	1	8	0	0
2	26481459	rs35488195	G	A	8	4	12	0	0	12	0	0
2	26512957	rs1056471	G	C	267	207	474	0	4	478	0	0
2	26569972	rs28551035	C	G	1	6	7	0	1	8	0	0
2	26612465	rs62128674	G	A	47	33	80	0	2	82	0	0
2	26614190	rs78937178	A	G	7	5	12	0	0	12	0	0
2	26614367	rs138550090	C	T	2	7	9	0	0	9	0	0
2	26615902	rs6739625	G	A	5	2	7	0	0	7	0	0
2	26616356	rs6730112	A	G	5	7	12	0	1	13	0	0
2	26617209	rs1127261	A	G	6	4	10	0	0	10	0	0
2	26617832	rs75253063	G	C	12	6	18	0	0	18	0	0
2	26618543	rs7092	G	A	22	15	37	0	0	37	0	0
2	26618560	rs139434831	C	T	14	23	37	0	0	37	0	0
2	27003021	rs10186142	T	C	3	4	7	0	0	7	0	0
2	27258251	rs2304714	T	G	4	7	11	0	0	11	0	0
2	27258761	rs2304713	C	G	6	2	8	0	0	8	0	0
2	27260469	rs1124649	G	A	53	51	104	0	1	105	0	0
2	27279013	rs2278593	A	G	7	3	10	0	0	10	0	0
2	27280092	rs6711384	T	A	6	3	9	0	1	10	0	0
2	27280127	rs6721395	G	A	7	2	9	0	0	9	0	0
2	27355991	rs2289358	G	T	14	18	32	0	0	32	0	0
2	27356278	rs2289359	T	C	3	3	6	0	0	6	0	0
2	27356929	rs72810711	G	C	4	2	6	0	0	6	0	0
2	27424636	rs1395	G	A	42	47	89	0	0	89	0	0
2	27435374	rs11608	G	A	97	103	200	0	1	202	1	0
2	27437496	rs1275535	C	T	5	3	8	0	0	8	0	0
2	27438817	rs2840026	G	A	2	4	6	0	0	6	0	0
2	27460968	rs1141313	A	G	18	16	34	0	0	34	0	0
2	27462076	rs3739092	C	T	45	30	75	0	0	75	0	0
2	27581250	rs62130720	G	A	3	5	8	0	0	8	0	0
2	27591804	rs80051818	T	C	5	5	10	0	0	10	0	0
2	27598155	rs4665973	G	A	6	3	9	0	0	9	0	0
2	27657681	rs77005271	C	T	13	25	38	0	0	38	0	0
2	27668298	.	C	T	16	11	27	0	0	27	0	0
2	27910041	.	T	C	8	5	13	0	0	13	0	0
2	27995781	rs3736594	A	C	4	4	8	0	0	8	0	0
2	28002002	rs3792253	T	C	3	3	6	0	0	6	0	0
2	28168415	rs7577437	A	G	4	4	8	0	0	8	0	0
2	28555567	rs11889275	C	T	1	5	6	0	0	6	0	0
2	28555909	rs72786762	C	T	3	3	6	0	0	6	0	0
2	28561757	rs58720304	C	T	14	6	20	0	0	20	0	0
2	28561758	rs55977836	T	C	14	6	20	0	0	20	0	0
2	28614794	rs925255	C	T	9	2	11	0	0	11	0	0
2	28617932	rs62143061	C	T	46	31	77	0	1	78	0	0
2	28618248	rs115497605	T	C	34	40	74	0	1	75	0	0
2	28621000	rs78120558	G	T	10	6	16	0	0	16	0	0
2	28622209	rs144435229	G	T	6	5	11	0	0	11	0	0
2	28624532	rs115198848	C	T	7	2	9	0	0	9	0	0
2	28624833	rs4666070	A	G	3	3	6	0	0	6	0	0
2	28625133	rs11689770	G	C	5	5	10	0	0	10	0	0
2	28625671	rs115227287	A	T	6	4	10	0	0	10	0	0
2	28626860	rs11900743	G	A	8	2	10	0	0	10	0	0
2	28630765	rs115586255	T	C	3	5	8	0	0	8	0	0
2	28632377	rs7606480	G	A	59	61	120	0	0	120	0	0
2	28633204	rs113849934	G	A	59	45	104	0	7	111	0	0
2	28633223	rs139094744	A	G	51	44	95	0	1	96	0	0
2	28633251	rs192381456	C	T	51	34	85	0	4	89	0	0
2	28633967	rs13397642	G	A	16	7	23	0	0	23	0	0
2	28634790	rs12624279	G	A	69	36	105	0	1	106	0	0
2	28636644	rs4666072	A	G	304	310	614	0	4	618	0	0
2	28636740	rs2279990	A	G	337	292	629	0	25	654	0	0
2	28639641	rs4426489	C	G	30	21	51	0	1	52	0	0
2	28985674	rs4558548	C	G	3	3	6	0	0	6	0	0
2	28998077	rs10204329	G	C	5	5	10	0	0	10	0	0
2	29001691	rs1128416	A	G	324	334	658	0	2	660	0	0
2	29005303	rs562823818	C	A	5	1	6	0	0	6	0	0
2	29005602	rs3768665	G	A	5	3	8	0	0	8	0	0
2	29007349	rs6742291	T	C	10	12	22	0	0	22	0	0
2	29008175	rs62129843	T	C	4	6	10	0	0	10	0	0
2	29008220	rs147684450	G	A	10	6	16	0	0	16	0	0
2	29008425	rs4632297	T	A	12	6	18	0	0	18	0	0
2	29009089	rs4477866	C	A	4	2	6	0	0	6	0	0
2	29009840	rs6747852	A	T	20	7	27	0	0	27	0	0
2	29010066	rs6547878	T	C	5	8	13	0	0	13	0	0
2	29010339	rs6419696	G	A	8	5	13	0	0	13	0	0
2	29010361	rs531342928	A	G	9	10	19	0	0	19	0	0
2	29012201	rs75000701	C	T	28	8	36	0	0	36	0	0
2	29012431	rs114241479	T	G	10	14	24	0	0	24	0	0
2	29012454	rs145583039	T	C	5	4	9	0	3	12	0	0
2	29012574	rs13016112	T	C	16	5	21	0	0	21	0	0
2	29012657	rs141190576	G	T	20	11	31	0	0	31	0	0
2	29013005	rs7608105	A	G	65	63	128	0	2	130	0	0
2	29013391	rs150477535	A	T	26	24	50	0	1	51	0	0
2	29016233	rs56342375	A	C	43	30	73	0	0	73	0	0
2	29022959	rs11687800	T	C	352	336	688	0	6	694	0	0
2	29025479	rs3190	A	G	60	60	120	0	0	120	0	0
2	29092679	rs4233729	T	C	33	28	61	0	3	64	0	0
2	29092850	rs4666122	G	T	34	40	74	0	1	75	0	0
2	29129418	rs11688605	A	G	109	109	218	0	12	230	0	0
2	29135468	rs6715296	C	G	151	121	272	0	0	272	0	0
2	29137567	rs4666135	C	T	6	1	7	0	0	7	0	0
2	29138167	rs12623400	A	G	3	5	8	0	1	9	0	0
2	29138436	rs4273183	G	A	5	2	7	0	0	7	0	0
2	29138978	rs6728138	C	T	4	3	7	0	0	7	0	0
2	29139542	rs4456657	A	G	4	4	8	0	0	8	0	0
2	29140021	rs10175980	G	A	5	5	10	0	0	10	0	0
2	29140085	rs7419369	G	A	4	4	8	0	1	9	0	0
2	29140711	rs4389288	G	A	6	4	10	0	0	10	0	0
2	29148315	rs10164596	C	G	3	3	6	0	0	6	0	0
2	29148507	rs4666138	G	C	5	2	7	0	0	7	0	0
2	29150981	rs6755185	C	G	2	7	9	0	0	9	0	0
2	29160421	rs6734079	T	A	2	4	6	0	0	6	0	0
2	29161010	rs4233731	G	A	5	2	7	0	0	7	0	0
2	29161707	rs67612857	G	C	6	7	13	0	0	13	0	0
2	29161763	rs7423095	A	G	3	5	8	0	0	8	0	0
2	29163159	rs7603749	G	A	5	2	7	0	0	7	0	0
2	29164022	rs4666141	G	T	6	8	14	0	0	14	0	0
2	29167678	rs3924272	C	T	4	3	7	0	0	7	0	0
2	29167692	rs3924271	G	A	4	3	7	0	0	7	0	0
2	29168214	rs4413120	G	A	1	6	7	0	0	7	0	0
2	29169612	rs3087649	T	C	241	218	459	0	5	464	0	0
2	29170623	rs11680458	G	T	7	9	16	0	0	16	0	0
2	29170676	rs1131880	G	C	13	17	30	0	1	31	0	0
2	30371358	rs7588777	T	C	28	56	84	0	0	84	0	0
2	30372327	rs3768667	T	C	7	7	14	0	0	14	0	0
2	30376345	rs13017699	A	T	14	20	34	0	1	35	0	0
2	30377884	rs6743004	T	C	11	11	22	0	0	22	0	0
2	30380923	rs7600457	A	G	10	8	18	0	0	18	0	0
2	30381187	rs7603324	A	G	12	14	26	0	0	26	0	0
2	30381505	rs1137288	T	C	1050	1007	2057	0	11	2068	0	0
2	30482099	rs906864	G	A	15	7	22	0	0	22	0	0
2	31178818	rs2288100	C	T	2	11	13	0	0	13	0	0
2	32142520	rs11124272	C	A	14	12	26	0	1	27	0	0
2	32234656	rs875167	G	A	3	13	16	0	1	17	0	0
2	32381110	rs9789593	T	G	14	4	18	0	0	18	0	0
2	32448506	rs77890389	C	A	2	4	6	0	0	6	0	0
2	32460512	.	A	G	5	6	11	0	0	11	0	0
2	32582999	rs115105995	G	A	15	9	24	0	0	24	0	0
2	32613854	.	T	C	32	33	65	0	0	65	0	0
2	32690189	rs35682129	A	G	3	13	16	0	1	17	0	0
2	32843295	rs1043463	A	T	22	8	30	0	0	30	0	0
2	32961858	rs2273660	A	G	12	34	46	0	1	47	0	0
2	32985073	rs2218898	T	C	4	2	6	0	0	6	0	0
2	32985666	rs13008476	G	A	6	0	6	0	0	6	0	0
2	32986422	rs77099554	A	T	1	9	10	0	0	10	0	0
2	33174072	rs150654	A	C	5	3	8	0	0	8	0	0
2	33181959	rs150660	A	G	0	8	8	0	0	8	0	0
2	33182618	rs462047	T	A	4	5	9	0	1	10	0	0
2	33182791	rs72789865	C	T	7	3	10	0	0	10	0	0
2	33400814	rs75040566	A	G	4	3	7	0	0	7	0	0
2	33400983	rs4574096	G	A	2	5	7	0	0	7	0	0
2	33623720	rs8970	A	G	100	78	178	0	1	179	0	0
2	33623734	rs622716	A	G	85	68	153	0	6	159	0	0
2	33701410	rs11124321	C	T	5	5	10	0	0	10	0	0
2	33701632	rs17594260	C	T	18	15	33	0	0	33	0	0
2	33702102	rs12613020	T	G	3	4	7	0	0	7	0	0
2	33702486	rs61334194	C	G	6	8	14	0	0	14	0	0
2	33702679	rs2367735	G	T	2	4	6	0	0	6	0	0
2	33703003	rs11693332	C	T	4	3	7	0	0	7	0	0
2	33703217	rs17648308	C	G	7	5	12	0	0	12	0	0
2	33717555	rs151131774	C	G	10	10	20	0	0	20	0	0
2	33747285	rs2305573	G	A	12	3	15	0	0	15	0	0
2	33747565	rs7581376	A	G	10	4	14	0	0	14	0	0
2	33747586	rs13030503	T	C	10	5	15	0	0	15	0	0
2	33748348	rs11679194	G	A	7	7	14	0	0	14	0	0
2	33764286	rs7592762	T	C	42	28	70	0	0	70	0	0
2	33764600	rs67624702	G	T	2	4	6	0	0	6	0	0
2	33788655	rs1046038	C	T	44	39	83	0	3	86	0	0
2	33809294	rs11066	A	G	49	57	106	0	1	107	0	0
2	33811516	rs935625	C	G	2	4	6	0	0	6	0	0
2	36810586	rs14291	T	C	15	12	27	0	0	27	0	0
2	37075013	rs1861435	T	A	17	28	45	0	0	45	0	0
2	37225706	rs75219072	C	T	5	3	8	0	0	8	0	0
2	37226299	rs62133078	C	T	17	4	21	0	0	21	0	0
2	37226319	rs111522844	G	A	15	5	20	0	0	20	0	0
2	37226903	rs4670181	G	C	13	6	19	0	0	19	0	0
2	37230734	rs17497654	C	T	56	41	97	0	1	98	0	0
2	37233538	rs2110998	T	C	7	5	12	0	0	12	0	0
2	37233638	rs2110997	C	G	4	3	7	0	0	7	0	0
2	37325510	rs34698441	T	G	68	61	129	0	6	135	0	0
2	37325512	rs35272517	T	G	49	78	127	0	3	130	0	0
2	37327244	rs1127906	A	G	55	27	82	0	2	84	0	0
2	37327684	rs35978346	A	C	41	32	73	0	0	73	0	0
2	37329049	rs35175701	C	A	20	19	39	0	1	40	0	0
2	37375932	rs2270414	G	A	8	3	11	0	0	11	0	0
2	37376291	rs2254958	G	A	20	13	33	0	1	34	0	0
2	37428577	.	A	G	5	2	7	0	0	7	0	0
2	37431646	rs1137453	C	G	79	91	170	0	1	171	0	0
2	37438993	rs1137437	G	A	256	246	502	0	10	512	0	0
2	37458711	rs3213745	G	A	18	13	31	0	1	32	0	0
2	37472804	rs2110965	T	C	4	5	9	0	1	10	0	0
2	37475976	rs4670679	G	C	7	0	7	0	0	7	0	0
2	37477794	rs8243	C	A	3	7	10	0	0	10	0	0
2	37479756	rs10184179	C	T	8	15	23	0	0	23	0	0
2	37479862	rs2160395	C	T	10	11	21	0	0	21	0	0
2	37479959	rs2110964	A	C	4	2	6	0	0	6	0	0
2	37480249	rs1056021	A	G	31	50	81	0	0	81	0	0
2	37486527	rs2714470	A	G	4	4	8	0	0	8	0	0
2	37487723	rs10176949	G	A	3	3	6	0	0	6	0	0
2	37518045	rs10177176	G	C	7	14	21	0	0	21	0	0
2	37869494	rs9742	G	T	60	73	133	0	1	134	0	0
2	37870508	rs3731854	C	G	25	35	60	0	0	60	0	0
2	37870937	rs3731852	C	G	37	45	82	0	1	83	0	0
2	37872508	rs7735	G	A	129	120	249	0	2	251	0	0
2	37899418	rs9309014	A	G	1	6	7	0	0	7	0	0
2	37900020	rs2041506	T	C	3	4	7	0	0	7	0	0
2	38530754	rs138986838	A	C	6	8	14	0	0	14	0	0
2	38789508	rs12329205	T	A	6	8	14	0	1	15	0	0
2	38791920	rs7584547	C	G	4	2	6	0	0	6	0	0
2	38793326	.	G	A	6	3	9	0	0	9	0	0
2	38805596	rs13431551	C	T	5	5	10	0	0	10	0	0
2	38806857	rs115844327	G	A	9	5	14	0	1	15	0	0
2	38807441	rs17022951	G	A	19	11	30	0	1	31	0	0
2	38808035	rs2278359	T	C	24	27	51	0	0	51	0	0
2	38809162	rs2253519	C	T	13	12	25	0	0	25	0	0
2	38809668	rs150771626	T	C	6	5	11	0	0	11	0	0
2	38810004	rs6736320	A	G	7	1	8	0	0	8	0	0
2	38820942	rs139087239	C	T	3	3	6	0	0	6	0	0
2	38827457	rs78157277	A	G	12	12	24	0	0	24	0	0
2	38895083	rs191108063	G	A	4	4	8	0	0	8	0	0
2	38972796	rs3134637	C	G	21	13	34	0	2	36	0	0
2	39046072	.	G	A	6	2	8	0	0	8	0	0
2	39109558	rs3099950	G	A	34	27	61	0	0	61	0	0
2	39281312	rs7604229	C	G	6	6	12	0	0	12	0	0
2	42509025	rs58282075	C	G	6	3	9	0	1	10	0	0
2	42509245	rs10490556	T	C	5	3	8	0	0	8	0	0
2	42512638	rs6544531	T	C	4	10	14	0	0	14	0	0
2	42512997	rs1837357	C	A	7	6	13	0	0	13	0	0
2	42530331	rs35669886	C	A	44	26	70	0	0	70	0	0
2	42552284	rs56315033	G	C	0	6	6	0	0	6	0	0
2	42558476	rs56790956	C	T	12	7	19	0	0	19	0	0
2	42559256	rs6716767	A	C	23	33	56	0	0	56	0	0
2	42562787	rs12613284	C	G	7	1	8	0	0	8	0	0
2	42562821	rs10194796	A	C	9	1	10	0	0	10	0	0
2	42578071	rs17389715	T	C	534	516	1050	0	8	1059	1	0
2	42581989	rs58519571	C	T	4	4	8	0	1	9	0	0
2	42989994	rs2278585	G	T	8	6	14	0	0	14	0	0
2	42990010	rs12617777	C	A	10	5	15	0	0	15	0	0
2	42990101	rs2278586	G	C	8	2	10	0	0	10	0	0
2	43015704	rs3816182	T	A	31	43	74	0	1	75	0	0
2	43015719	rs3816183	T	C	33	42	75	0	0	75	0	0
2	43449820	.	A	T	1181	1318	2499	0	6	2505	0	0
2	43453086	rs35064085	G	A	53	60	113	0	1	114	0	0
2	43625184	rs33979934	T	A	15	14	29	0	0	29	0	0
2	44118428	rs12473732	C	T	3	3	6	0	0	6	0	0
2	44119416	rs7597379	T	C	3	5	8	0	0	8	0	0
2	44123073	rs6720846	A	T	7	5	12	0	0	12	0	0
2	44177948	rs4245798	T	C	6	2	8	0	0	8	0	0
2	44209477	rs6741066	C	T	37	36	73	0	0	73	0	0
2	44429353	.	G	C	7	16	23	0	0	23	0	0
2	44548282	rs11124988	T	C	6	4	10	0	0	10	0	0
2	44628529	rs1067327	C	G	7	4	11	0	0	11	0	0
2	44628605	rs1067326	T	A	5	2	7	0	0	7	0	0
2	45880035	.	G	A	17	19	36	0	1	37	0	0
2	46577644	rs10187368	G	A	3	4	7	0	0	7	0	0
2	46602251	rs3088359	G	A	2	4	6	0	0	6	0	0
2	46608333	rs35145595	C	A	3	5	8	0	0	8	0	0
2	46608542	rs13006131	C	G	3	5	8	0	0	8	0	0
2	46610680	rs7590087	A	C	3	3	6	0	0	6	0	0
2	46805373	rs13404342	A	G	3	3	6	0	0	6	0	0
2	46807051	rs112387842	C	T	3	3	6	0	0	6	0	0
2	46808802	rs144395549	A	G	8	7	15	0	1	16	0	0
2	46809241	rs11306	T	C	21	25	46	0	1	47	0	0
2	46809621	rs1057899	T	C	34	34	68	0	0	68	0	0
2	46852076	rs112560095	A	G	9	5	14	0	1	15	0	0
2	46986416	rs6738426	A	G	71	90	161	0	0	161	0	0
2	46987300	rs3768720	T	G	24	32	56	0	0	56	0	0
2	46987935	rs3768719	T	G	28	29	57	0	1	58	0	0
2	46988275	rs1058157	G	A	13	15	28	0	0	28	0	0
2	47130814	rs115043642	G	A	65	66	131	0	1	132	0	0
2	47131335	rs7596245	C	A	50	64	114	0	2	116	0	0
2	47251469	rs2304290	G	C	63	58	121	0	1	122	0	0
2	47277207	rs3816066	C	A	18	19	37	0	0	37	0	0
2	47277208	rs3816065	A	G	18	19	37	0	0	37	0	0
2	47302095	rs1046267	T	C	75	81	156	0	0	156	0	0
2	47302829	rs1573958	C	G	38	25	63	0	0	63	0	0
2	47390026	rs1027478	C	T	2	4	6	0	0	6	0	0
2	47601106	rs1126497	T	C	0	212	212	0	2	214	0	0
2	47643457	rs4987188	G	A	26	31	57	0	0	57	0	0
2	48035993	rs17036971	T	G	12	14	26	0	0	26	0	0
2	48038331	rs6713506	G	A	20	15	35	0	0	35	0	0
2	48039223	rs17323768	T	G	25	17	42	0	0	42	0	0
2	48039484	rs10490303	T	G	18	14	32	0	0	32	0	0
2	48039744	rs10490302	C	T	19	6	25	0	0	25	0	0
2	48041386	rs77292789	T	C	9	5	14	0	3	17	0	0
2	48043974	rs80136244	T	C	11	6	17	0	0	17	0	0
2	48133037	.	G	A	24	33	57	0	1	58	0	0
2	48713777	rs33994624	C	T	10	12	22	0	0	22	0	0
2	48807976	rs3828340	T	C	3	4	7	0	0	7	0	0
2	53897251	rs80029529	A	G	7	6	13	0	0	13	0	0
2	53955850	rs17521008	C	T	17	17	34	0	0	34	0	0
2	53975436	rs17045176	T	C	6	1	7	0	0	7	0	0
2	54035447	rs1127362	A	G	158	142	300	0	5	305	0	0
2	54053872	rs698853	A	G	5	6	11	0	0	11	0	0
2	54053921	rs698854	G	C	6	7	13	0	0	13	0	0
2	54078491	.	G	C	2	4	6	0	0	6	0	0
2	54091688	rs698855	C	T	7	5	12	0	0	12	0	0
2	54092984	rs805379	C	T	46	29	75	0	2	77	0	0
2	54095317	rs805383	G	T	8	4	12	0	1	13	0	0
2	54097112	rs805385	C	T	73	60	133	0	1	134	0	0
2	54098539	rs805386	C	T	29	16	45	0	0	45	0	0
2	54099121	rs805387	C	A	29	14	43	0	1	44	0	0
2	54100160	rs805388	G	T	14	10	24	0	0	24	0	0
2	54114762	rs805398	G	A	14	11	25	0	0	25	0	0
2	54114967	rs805399	G	A	7	4	11	0	1	12	0	0
2	54115904	rs805400	A	G	99	126	225	0	0	225	0	0
2	54116003	rs805401	C	T	5	2	7	0	0	7	0	0
2	54116349	rs805402	T	C	5	4	9	0	0	9	0	0
2	54116800	rs805404	A	C	3	3	6	0	0	6	0	0
2	54118151	rs805405	A	G	3	4	7	0	0	7	0	0
2	54119043	rs805406	T	C	6	1	7	0	0	7	0	0
2	54119057	rs805407	G	A	5	1	6	0	0	6	0	0
2	54120025	rs805408	A	T	127	126	253	0	0	253	0	0
2	54120820	rs805412	G	A	80	79	159	0	0	159	0	0
2	54122625	rs805413	C	T	6	12	18	0	0	18	0	0
2	54127041	rs805423	C	T	69	62	131	0	0	131	0	0
2	54129482	rs805425	T	C	4	4	8	0	1	9	0	0
2	54130532	rs805426	G	A	5	4	9	0	0	9	0	0
2	54133744	rs805316	T	C	57	83	140	0	1	141	0	0
2	54198295	rs2949815	G	T	16	9	25	0	1	26	0	0
2	54200930	rs10168293	G	A	19	22	41	0	1	42	0	0
2	54844790	rs2229506	C	T	115	104	219	0	1	220	0	0
2	54855137	rs2971887	T	C	5	6	11	0	0	11	0	0
2	54875799	rs2941594	G	A	3	3	6	0	0	6	0	0
2	54882713	rs28710338	G	C	3	4	7	0	0	7	0	0
2	54884870	rs966003	C	T	15	5	20	0	0	20	0	0
2	54888497	rs2941587	C	T	108	85	193	0	2	195	0	0
2	54888533	rs2971879	T	C	82	62	144	0	2	146	0	0
2	54888778	rs2971878	T	C	86	54	140	0	4	144	0	0
2	54889015	rs1047465	A	G	93	82	175	0	2	177	0	0
2	54889136	rs2971877	G	A	115	91	206	0	1	207	0	0
2	54889390	rs1047499	C	T	31	35	66	0	0	66	0	0
2	54892800	rs2292356	G	A	23	11	34	0	0	34	0	0
2	54892805	rs2292357	G	A	24	10	34	0	0	34	0	0
2	54894043	rs907135	T	C	8	1	9	0	0	9	0	0
2	54894649	rs907136	G	A	6	7	13	0	0	13	0	0
2	55207063	rs73936513	C	T	9	15	24	0	1	25	0	0
2	55208432	rs569012054	A	T	6	3	9	0	0	9	0	0
2	55208869	rs61621549	T	C	6	3	9	0	0	9	0	0
2	55209235	rs143753052	G	A	5	7	12	0	0	12	0	0
2	55216993	rs114783222	A	T	4	2	6	0	0	6	0	0
2	55220584	rs17046570	C	T	1	5	6	0	0	6	0	0
2	55252795	rs80121116	G	T	29	19	48	0	0	49	1	0
2	55277641	rs6545468	C	G	7	10	17	0	2	19	0	0
2	55460284	rs150005663	C	T	10	9	19	0	0	19	0	0
2	55461053	rs80273115	A	G	11	12	23	0	0	23	0	0
2	55470115	rs11357	C	T	41	23	64	0	0	64	0	0
2	55516090	rs1045613	C	T	36	40	76	0	1	77	0	0
2	55517287	rs17347807	G	A	5	10	15	0	0	15	0	0
2	55528855	rs2920973	A	T	7	1	8	0	0	8	0	0
2	55608866	rs4233960	A	T	5	1	6	0	0	6	0	0
2	55608913	rs73939645	T	C	1	6	7	0	0	7	0	0
2	55646761	rs3748943	T	C	15	7	22	0	0	22	0	0
2	55843730	rs150318495	G	A	23	13	36	0	0	36	0	0
2	58143438	rs2717003	A	G	2	4	6	0	0	6	0	0
2	58316814	rs1051061	A	G	28	13	41	0	0	41	0	0
2	58388696	rs848291	A	G	16	16	32	0	0	32	0	0
2	58951109	rs993531	G	T	4	3	7	0	0	7	0	0
2	58951187	rs2708149	A	G	4	3	7	0	0	7	0	0
2	60687959	rs7569946	A	G	6	5	11	0	1	12	0	0
2	60694273	.	T	G	5	4	9	0	2	11	0	0
2	60694285	.	G	A	4	4	8	0	2	10	0	0
2	60694296	.	G	A	5	3	8	0	1	9	0	0
2	60768978	rs2665668	G	A	28	19	47	0	2	49	0	0
2	60769455	rs3771270	G	A	32	27	59	0	0	59	0	0
2	60770454	rs6739994	C	T	19	18	37	0	0	37	0	0
2	60771729	rs45565333	G	C	18	14	32	0	1	33	0	0
2	61108829	rs67574266	G	A	21	64	85	0	1	86	0	0
2	61112552	rs6545835	G	T	5	3	8	0	1	9	0	0
2	61116241	rs13422089	C	G	7	3	10	0	0	10	0	0
2	61118739	rs10185028	A	G	4	6	10	0	0	10	0	0
2	61126664	rs10193964	A	G	35	24	59	0	1	60	0	0
2	61130883	rs13027883	G	C	3	5	8	0	0	8	0	0
2	61136129	rs13031237	G	T	4	4	8	0	0	8	0	0
2	61153803	rs34518355	G	A	61	74	135	0	1	136	0	0
2	61154510	rs72807491	T	C	93	118	211	0	1	212	0	0
2	61156142	.	G	A	123	26	149	0	0	150	1	0
2	61164331	rs13017599	G	A	9	11	20	0	1	21	0	0
2	61170621	rs33986372	A	C	6	11	17	0	1	18	0	0
2	61237739	rs13026685	C	G	9	18	27	0	0	27	0	0
2	61245551	rs12996059	G	C	4	8	12	0	0	12	0	0
2	61248575	rs4564760	T	C	1	5	6	0	0	6	0	0
2	61278052	rs2564097	A	G	19	11	30	0	0	30	0	0
2	61370819	rs11498	A	G	17	1	18	0	0	18	0	0
2	61372298	rs3213944	C	G	8	13	21	0	0	21	0	0
2	61404905	rs3821224	C	G	9	8	17	0	0	17	0	0
2	61404931	rs2600667	A	T	12	6	18	0	0	18	0	0
2	61405795	rs2600665	G	T	9	5	14	0	0	14	0	0
2	61415492	rs14170	A	G	123	122	245	0	0	245	0	0
2	61416404	rs370286913	T	G	10	8	18	0	0	18	0	0
2	61417145	rs777590	C	G	12	7	19	0	0	19	0	0
2	61417617	rs777591	A	G	9	7	16	0	0	16	0	0
2	61442075	rs2123112	T	G	4	10	14	0	0	14	0	0
2	61533267	rs7370889	G	A	31	9	40	0	0	40	0	0
2	61533480	rs7369217	A	G	21	26	47	0	0	47	0	0
2	61533557	rs11694516	G	C	26	22	48	0	2	50	0	0
2	61533616	rs11677986	T	G	22	21	43	0	0	43	0	0
2	61595291	rs2694639	G	A	13	15	28	0	0	28	0	0
2	61596180	rs2694642	A	G	1	6	7	0	0	7	0	0
2	61618311	rs2463099	T	C	4	4	8	0	0	8	0	0
2	61618574	rs2593627	T	C	5	3	8	0	0	8	0	0
2	61619588	rs7560978	G	A	4	4	8	0	0	8	0	0
2	61621307	rs10865324	G	A	4	2	6	0	0	6	0	0
2	61647901	rs778155	A	G	17	19	36	0	0	36	0	0
2	61707438	rs6709112	A	G	0	7	7	0	1	8	0	0
2	61707476	rs189456907	G	A	0	11	11	0	0	11	0	0
2	61709975	.	T	G	10	2	12	0	0	12	0	0
2	61710573	rs11125883	A	C	0	13	13	0	0	13	0	0
2	61711815	rs2421200	G	T	8	0	8	0	0	8	0	0
2	61720497	rs12473030	T	A	7	10	17	0	0	17	0	0
2	61761774	rs9989775	A	G	5	1	6	0	0	6	0	0
2	61765074	rs3087898	G	A	4	8	12	0	0	12	0	0
2	62112540	rs34887496	C	G	4	4	8	0	1	9	0	0
2	63272724	rs2018650	T	C	14	14	28	0	0	28	0	0
2	64323975	.	G	A	12	17	29	0	0	29	0	0
2	64324908	.	C	T	18	9	27	0	0	27	0	0
2	64327544	rs329498	G	T	277	211	488	0	5	493	0	0
2	64327592	rs329497	T	C	239	204	443	0	7	450	0	0
2	64329043	.	C	A	21	15	36	0	0	36	0	0
2	64334456	rs6718082	G	A	19	10	29	0	0	29	0	0
2	64334879	rs329481	T	C	8	15	23	0	0	23	0	0
2	64335394	rs17753351	A	G	147	140	287	0	1	288	0	0
2	64479060	rs1025209	G	A	5	5	10	0	0	10	0	0
2	64479079	rs1025210	G	A	5	6	11	0	0	11	0	0
2	64479606	rs2020377	T	C	5	5	10	0	0	10	0	0
2	64479841	rs1963382	G	C	12	6	18	0	0	18	0	0
2	64687665	rs10496117	C	A	2	9	11	0	0	11	0	0
2	64749754	rs6723555	A	T	6	5	11	0	0	11	0	0
2	64752294	rs11684941	T	C	8	9	17	0	1	18	0	0
2	64762465	rs7576132	C	T	6	3	9	0	1	10	0	0
2	64772849	rs58128502	C	G	5	2	7	0	0	7	0	0
2	64811793	rs6755438	T	G	5	3	8	0	0	8	0	0
2	64818824	rs3770722	C	T	4	2	6	0	0	6	0	0
2	64819380	rs12987864	G	A	16	13	29	0	0	29	0	0
2	64859679	rs7451	T	C	112	97	209	0	0	209	0	0
2	64862055	rs2070063	A	G	124	172	296	0	2	298	0	0
2	64863592	.	G	A	131	98	229	0	2	231	0	0
2	64881997	rs3755189	G	A	4	5	9	0	0	9	0	0
2	65245365	rs759458	G	A	23	15	38	0	1	39	0	0
2	65296798	rs7572857	G	A	13	12	25	0	0	25	0	0
2	65298282	rs2723087	T	A	4	3	7	0	0	7	0	0
2	65298839	rs17849707	A	G	24	24	48	0	1	49	0	0
2	65310831	rs1050676	A	T	2	12	14	0	0	14	0	0
2	65311031	rs1050675	A	G	8	4	12	0	0	12	0	0
2	65311438	rs1229	G	A	8	4	12	0	1	13	0	0
2	65311555	rs1228	C	T	2	10	12	0	0	12	0	0
2	65312217	rs4671638	C	T	8	4	12	0	0	12	0	0
2	65313758	rs61758846	G	C	11	7	18	0	0	18	0	0
2	65315880	rs1420184	G	C	63	52	115	0	0	115	0	0
2	65315903	rs1420185	G	A	65	62	127	0	2	130	1	0
2	65317117	rs1055903	G	A	30	37	67	0	1	68	0	0
2	65318807	rs112029776	A	G	12	17	29	0	1	30	0	0
2	65321046	rs113413623	G	A	7	10	17	0	0	17	0	0
2	65322667	.	T	G	20	4	24	0	0	24	0	0
2	65323326	rs7607025	A	G	7	7	14	0	1	15	0	0
2	65323350	rs7607039	A	G	7	8	15	0	0	15	0	0
2	65324492	rs6713746	G	C	15	9	24	0	0	24	0	0
2	65432486	rs11887168	T	A	8	0	8	0	0	8	0	0
2	65432857	rs11887325	T	C	42	0	42	0	1	43	0	0
2	65432952	rs35295972	T	C	60	0	60	0	3	63	0	0
2	65433187	rs34004866	G	A	19	0	19	0	0	19	0	0
2	65455301	rs7566950	C	T	6	9	15	0	0	15	0	0
2	65456245	rs6546137	G	C	9	8	17	0	0	17	0	0
2	65456687	rs6546138	T	C	7	3	10	0	0	10	0	0
2	65458048	rs13018840	T	C	5	1	6	0	0	6	0	0
2	65467784	rs1547970	G	A	2	4	6	0	0	6	0	0
2	65467849	rs35346281	A	G	5	3	8	0	0	8	0	0
2	65470166	rs268860	G	A	4	2	6	0	0	6	0	0
2	65470896	rs268859	G	A	3	3	6	0	0	6	0	0
2	65473027	rs12467321	C	A	2	5	7	0	0	7	0	0
2	65475511	rs60955726	G	A	6	2	8	0	0	8	0	0
2	65475950	rs268856	C	T	5	4	9	0	0	9	0	0
2	65496075	rs8771	C	T	295	272	567	0	6	573	0	0
2	65497634	rs7246	T	C	412	447	859	0	7	866	0	0
2	65497682	rs13812	A	G	477	399	876	0	6	882	0	0
2	66783128	rs113411993	G	A	7	9	16	0	0	16	0	0
2	66784943	rs72824824	G	A	2	4	6	0	0	6	0	0
2	66785149	rs138046747	C	T	4	2	6	0	0	6	0	0
2	66786094	rs182095738	C	T	3	4	7	0	0	7	0	0
2	66794095	rs115610217	C	T	1	5	6	0	0	6	0	0
2	66796700	rs6745338	T	C	40	13	53	0	0	53	0	0
2	67631831	rs61740794	G	A	26	35	61	0	0	61	0	0
2	68269974	.	G	T	78	111	189	0	54	243	0	0
2	68276201	rs76078044	C	A	3	3	6	0	0	6	0	0
2	68410388	rs75521359	T	C	6	6	12	0	0	12	0	0
2	68451213	rs184609083	A	G	3	4	7	0	0	7	0	0
2	68511584	rs735815	A	G	0	7	7	0	1	8	0	0
2	68546374	rs4671898	T	C	20	2	22	0	2	24	0	0
2	68595680	rs1373199	G	A	19	31	50	0	0	50	0	0
2	68607271	rs17035388	G	A	3	3	6	0	0	6	0	0
2	68607293	rs72894177	C	G	4	3	7	0	0	7	0	0
2	68607947	rs3816281	G	T	1149	1122	2271	0	25	2296	0	0
2	68610120	rs10496164	A	G	29	27	56	0	1	57	0	0
2	68610228	rs58005032	T	G	20	20	40	0	0	40	0	0
2	68612177	rs17529520	C	T	47	39	86	0	0	86	0	0
2	68612292	rs4671914	G	A	23	22	45	0	0	45	0	0
2	68612378	rs72894191	T	C	17	20	37	0	3	40	0	0
2	68616085	rs2120334	C	T	36	33	69	0	0	69	0	0
2	68616438	rs3770650	A	G	13	23	36	0	0	36	0	0
2	68617695	rs17035409	T	C	14	24	38	0	0	38	0	0
2	68617914	rs6718855	A	G	22	20	42	0	0	42	0	0
2	68618216	rs6750761	G	C	27	31	58	0	1	59	0	0
2	68618728	rs17035420	C	G	39	28	67	0	1	68	0	0
2	68618744	rs72894202	A	G	43	31	74	0	0	74	0	0
2	68619363	rs3770649	A	G	23	20	43	0	0	47	4	0
2	68619392	rs3770648	C	T	32	25	57	0	0	57	0	0
2	68619446	rs17035431	A	G	33	34	67	0	0	67	0	0
2	68619981	rs1867312	C	A	33	27	60	0	1	61	0	0
2	68620151	rs2289689	C	T	30	28	58	0	0	58	0	0
2	68620463	rs2289688	G	A	14	13	27	0	1	28	0	0
2	68622239	rs2165920	T	C	24	38	62	0	0	62	0	0
2	68622318	rs60061601	T	C	17	19	36	0	0	36	0	0
2	68622658	rs1373200	C	T	31	27	58	0	0	58	0	0
2	68622952	rs1050181	G	C	1392	1228	2620	0	20	2641	1	0
2	68622990	rs6725743	T	C	1306	1312	2618	0	15	2633	0	0
2	68623147	rs11891290	C	T	1283	1179	2462	0	13	2475	0	0
2	68623274	rs6728995	T	C	1319	1019	2338	0	57	2395	0	0
2	68623302	rs6742200	A	G	1203	977	2180	0	27	2209	2	0
2	68623915	rs3732044	T	C	1667	1516	3183	0	18	3201	0	0
2	68624260	rs8761	G	A	1774	1379	3153	0	25	3178	0	0
2	68753240	rs35002937	T	A	5	1	6	0	0	6	0	0
2	68962259	rs34504087	T	C	44	64	108	0	4	112	0	0
2	68974262	rs75867742	G	C	3	4	7	0	0	7	0	0
2	68975706	rs4854506	T	C	3	3	6	0	0	6	0	0
2	68975854	rs4068867	C	A	5	1	6	0	0	6	0	0
2	68975902	rs4854507	T	C	0	6	6	0	0	6	0	0
2	68980738	rs71413160	T	A	7	5	12	0	0	12	0	0
2	68980769	rs4316972	G	A	4	6	10	0	0	10	0	0
2	68980962	rs34334511	G	A	13	24	37	0	0	37	0	0
2	68981257	rs10171786	G	C	11	11	22	0	0	22	0	0
2	69002281	rs11685672	C	G	13	7	20	0	0	20	0	0
2	69033717	rs78196889	C	T	5	2	7	0	0	7	0	0
2	69046406	rs17604346	C	T	34	27	61	0	0	61	0	0
2	69051853	rs4854523	A	G	4	7	11	0	1	12	0	0
2	69051854	rs111820014	A	G	7	5	12	0	0	12	0	0
2	69737379	rs11692488	C	T	16	14	30	0	0	30	0	0
2	69737948	rs2002879	G	A	7	3	10	0	0	10	0	0
2	69738093	rs2002878	C	T	9	5	14	0	0	14	0	0
2	69739675	rs4852799	C	T	6	1	7	0	0	7	0	0
2	69740091	rs6752846	C	T	5	1	6	0	0	6	0	0
2	69740227	rs11126233	G	C	4	2	6	0	1	7	0	0
2	69740279	rs11126234	T	G	7	3	10	0	0	10	0	0
2	69741609	rs2276689	C	T	14	9	23	0	0	23	0	0
2	69779963	rs6546531	C	A	5	4	9	0	0	9	0	0
2	69826532	.	T	A	6	5	11	0	0	11	0	0
2	70161910	.	T	C	4	6	10	0	0	10	0	0
2	70524351	.	A	T	250	0	250	0	0	250	0	0
2	71300516	rs17616553	T	C	5	5	10	0	0	10	0	0
2	71301167	rs10179316	G	A	3	3	6	0	0	6	0	0
2	71305456	rs6713	C	T	56	35	91	0	0	91	0	0
2	71351487	rs11541017	G	A	19	16	35	0	0	35	0	0
2	71357710	rs981947	G	C	4	4	8	0	0	8	0	0
2	71360144	rs10199088	A	C	40	18	58	0	0	58	0	0
2	71360625	rs1813160	G	T	45	35	80	0	1	81	0	0
2	71365676	rs357756	G	A	43	32	75	0	0	75	0	0
2	71365998	rs357755	C	T	8	11	19	0	0	19	0	0
2	71376999	rs6574	G	A	41	37	78	0	1	79	0	0
2	71614783	rs560395344	A	G	3	3	6	0	0	6	0	0
2	71680950	rs6741336	C	A	9	10	19	0	0	19	0	0
2	71747923	rs36122356	C	T	13	12	25	0	1	26	0	0
2	71795460	rs34836829	G	A	21	14	35	0	0	35	0	0
2	71838443	rs11558179	C	T	16	23	39	0	0	39	0	0
2	71838597	rs2303606	C	A	16	13	29	0	0	29	0	0
2	71838657	rs2303607	C	T	21	13	34	0	0	34	0	0
2	73454256	rs3188114	G	A	32	46	78	0	0	78	0	0
2	73455747	rs2288631	C	T	7	7	14	0	0	14	0	0
2	73461483	rs1053329	C	A	158	158	316	0	0	316	0	0
2	73478461	rs7851	A	T	323	259	582	0	12	594	0	0
2	73482517	rs11548978	T	C	32	35	67	0	2	69	0	0
2	73482673	rs55693343	G	A	56	63	119	0	1	120	0	0
2	73483057	rs1045902	T	C	27	22	49	0	0	49	0	0
2	73483769	rs3817459	G	A	33	22	55	0	0	55	0	0
2	73490412	rs34363861	A	G	13	14	27	0	0	27	0	0
2	73685800	rs115251873	C	T	6	3	9	0	0	9	0	0
2	73685852	rs6749680	G	A	8	2	10	0	0	10	0	0
2	73828538	rs1052161	G	A	16	4	20	0	1	21	0	0
2	73927931	rs4852974	A	G	6	4	10	0	0	10	0	0
2	73928098	rs2001490	C	G	7	2	9	0	0	9	0	0
2	73956744	rs13020517	C	T	8	5	13	0	0	13	0	0
2	73956846	rs12713794	A	G	9	4	13	0	0	13	0	0
2	73956881	rs12997568	T	C	10	4	14	0	0	14	0	0
2	73957124	rs7210	A	G	225	225	450	0	3	453	0	0
2	73977609	rs2272178	C	T	5	4	9	0	0	9	0	0
2	74007136	rs2272051	T	C	124	101	225	0	1	227	1	0
2	74056564	rs3813229	A	G	8	3	11	0	0	11	0	0
2	74091327	rs6726010	T	C	7	0	7	0	0	7	0	0
2	74091805	rs3738846	C	T	3	6	9	0	0	9	0	0
2	74097476	rs17009430	C	T	4	4	8	0	0	8	0	0
2	74174396	rs940298	G	A	3	3	6	0	0	6	0	0
2	74174904	rs940299	A	G	4	2	6	0	0	6	0	0
2	74185876	rs4777	A	T	249	249	498	0	3	501	0	0
2	74334462	rs828867	G	A	19	30	49	0	0	49	0	0
2	74334790	rs6546891	A	G	25	29	54	0	1	55	0	0
2	74348979	rs1667614	A	G	3	3	6	0	0	6	0	0
2	84655782	rs77287147	G	T	4	8	12	0	0	12	0	0
2	84657726	rs189796861	T	C	3	3	6	0	0	6	0	0
2	85271871	rs62162801	A	G	9	5	14	0	0	14	0	0
2	85537010	rs79028776	G	A	5	5	10	0	0	10	0	0
2	85542686	rs7608881	G	C	9	23	32	0	0	32	0	0
2	85542718	rs7608892	G	A	7	21	28	0	0	28	0	0
2	85542862	rs200386582	T	C	5	9	14	0	0	14	0	0
2	85546192	rs1053560	C	T	237	268	505	0	5	510	0	0
2	85546615	rs1061782	C	T	196	156	352	0	3	355	0	0
2	85546932	rs4832164	A	C	249	220	469	0	1	470	0	0
2	85547376	rs7607284	C	G	216	192	408	0	2	410	0	0
2	85547429	rs4459734	G	T	195	203	398	0	4	402	0	0
2	85547849	rs76047845	G	C	220	215	435	0	1	436	0	0
2	85547963	rs1554110	C	T	216	231	447	0	2	449	0	0
2	85548639	rs6547611	A	G	163	155	318	0	0	318	0	0
2	85549595	rs139028057	T	C	70	95	165	0	0	165	0	0
2	85549744	rs1112848	G	A	72	86	158	0	0	158	0	0
2	85549868	rs4240199	A	G	8	11	19	0	0	19	0	0
2	85551184	rs6547612	C	T	7	8	15	0	0	15	0	0
2	85553784	rs1044973	C	T	133	124	257	0	0	257	0	0
2	85555210	rs56742524	A	G	8	11	19	0	0	19	0	0
2	85555262	rs10460585	T	G	9	9	18	0	0	18	0	0
2	85555277	rs10460586	G	A	8	11	19	0	0	19	0	0
2	85569877	rs9808566	C	T	14	4	18	0	1	19	0	0
2	85569925	rs145057327	G	A	19	3	22	0	1	23	0	0
2	85569942	rs572423656	G	A	17	1	18	0	0	18	0	0
2	85569995	rs59202292	G	C	20	4	24	0	0	24	0	0
2	85570442	.	C	T	32	10	42	0	0	42	0	0
2	85572223	rs3755019	A	T	4	7	11	0	0	11	0	0
2	85572227	rs3755018	C	T	4	6	10	0	0	10	0	0
2	85577310	rs139043592	C	T	15	6	21	0	0	21	0	0
2	85614930	rs139580731	C	T	5	1	6	0	0	6	0	0
2	85618569	rs139731692	C	G	7	7	14	0	0	14	0	0
2	85622583	rs73945742	C	A	13	14	27	0	0	27	0	0
2	85625222	rs6885	T	G	1067	832	1899	0	8	1907	0	0
2	85767735	rs2028900	C	T	3	8	11	0	0	11	0	0
2	85767969	rs2028899	C	A	7	7	14	0	1	15	0	0
2	85769711	rs1078004	C	G	74	70	144	0	0	144	0	0
2	85772548	rs7605975	C	T	4	3	7	0	0	7	0	0
2	85776832	rs72843839	C	T	5	3	8	0	0	8	0	0
2	85807082	.	T	A	6	4	10	0	0	10	0	0
2	85820373	rs1049359	A	G	24	37	61	0	1	62	0	0
2	85824078	rs41290037	C	T	19	10	29	0	1	30	0	0
2	85824084	rs2232748	G	C	20	11	31	0	0	31	0	0
2	85826132	rs1044158	G	A	30	24	54	0	0	54	0	0
2	85833326	rs56367745	C	T	9	10	19	0	1	20	0	0
2	85837569	rs114334045	G	A	11	7	18	0	1	19	0	0
2	85843348	rs11544042	C	T	23	35	58	0	1	59	0	0
2	85843908	rs146621739	C	G	8	7	15	0	0	15	0	0
2	85853463	rs62166774	G	C	4	5	9	0	0	9	0	0
2	85854476	rs13406807	T	C	16	13	29	0	0	29	0	0
2	85870831	rs188171043	C	T	6	0	6	0	0	6	0	0
2	85870839	rs139534581	C	T	6	0	6	0	0	6	0	0
2	85874922	rs114783427	C	T	6	6	12	0	1	13	0	0
2	85921992	rs2043760	T	C	4	5	9	0	0	9	0	0
2	85923936	rs13408224	C	T	8	6	14	0	0	14	0	0
2	85923997	rs34943381	A	G	9	4	13	0	0	13	0	0
2	85924295	rs1561284	C	A	14	13	27	0	0	27	0	0
2	85924384	rs1561285	C	G	7	6	13	0	0	13	0	0
2	85924729	rs11127	C	T	79	53	132	0	4	136	0	0
2	85924899	rs1437742	T	A	7	8	15	0	1	16	0	0
2	85924989	rs1437743	C	T	3	4	7	0	0	7	0	0
2	85925084	rs1437744	G	A	7	7	14	0	0	14	0	0
2	85925386	rs1866141	T	C	9	10	19	0	0	19	0	0
2	85925529	rs4240200	A	G	12	2	14	0	1	15	0	0
2	85925667	rs4240201	G	A	18	6	24	0	1	25	0	0
2	85925680	rs4240202	T	G	21	6	27	0	1	28	0	0
2	85925756	rs7908	C	G	248	98	346	0	0	346	0	0
2	85925848	rs12845	C	G	65	26	91	0	0	91	0	0
2	86248379	.	C	A	17	7	24	0	0	24	0	0
2	86251148	rs6707736	A	G	5	4	9	0	0	9	0	0
2	86251951	rs58077381	T	C	29	18	47	0	0	47	0	0
2	86254268	rs12997506	G	A	12	10	22	0	0	22	0	0
2	86259443	rs2276626	C	T	1	5	6	0	0	6	0	0
2	86360225	rs2241438	A	G	3	6	9	0	0	9	0	0
2	86365607	rs11395	T	C	4	4	8	0	0	8	0	0
2	86371883	rs8244	T	C	109	78	187	0	0	187	0	0
2	86376089	rs1124685	T	C	3	5	8	0	0	8	0	0
2	86385668	rs1057893	T	C	29	14	43	0	1	44	0	0
2	86385728	rs1131071	C	T	62	97	159	0	0	159	0	0
2	86388605	rs6737950	T	G	2	4	6	0	0	6	0	0
2	86396719	rs2278083	C	T	12	13	25	0	2	27	0	0
2	86397090	rs12714171	G	T	13	14	27	0	0	27	0	0
2	86400824	rs1050301	G	A	66	118	184	0	0	184	0	0
2	86422416	rs17551822	T	C	5	7	12	0	0	12	0	0
2	86422421	rs17551815	T	G	4	7	11	0	0	11	0	0
2	86422793	rs34809504	G	C	2	5	7	0	0	7	0	0
2	86422816	rs9653508	T	G	3	9	12	0	0	12	0	0
2	86422945	rs4402761	G	A	4	5	9	0	0	9	0	0
2	86423019	rs4422155	C	T	6	13	19	0	0	19	0	0
2	86423031	rs4450596	A	C	7	13	20	0	0	20	0	0
2	86423154	rs4374375	G	A	9	5	14	0	0	14	0	0
2	86433240	rs10901	C	T	42	51	93	0	1	94	0	0
2	86438146	rs2241432	A	G	11	6	17	0	0	17	0	0
2	86438600	rs17438451	T	C	6	12	18	0	2	20	0	0
2	86670200	rs75084119	G	A	9	15	24	0	0	24	0	0
2	86693826	rs34605051	T	C	119	145	264	0	1	265	0	0
2	86706693	rs59255035	A	G	15	14	29	0	0	29	0	0
2	86706834	rs60717666	G	A	17	9	26	0	1	27	0	0
2	86710359	rs3770058	G	C	15	20	35	0	0	35	0	0
2	86712731	rs72932310	G	C	6	6	12	0	0	12	0	0
2	86712820	rs72932311	A	T	4	5	9	0	0	9	0	0
2	86714277	rs3755002	T	C	5	4	9	0	0	9	0	0
2	86714431	rs56085540	C	T	7	6	13	0	0	13	0	0
2	86715696	rs1518812	C	T	4	13	17	0	0	17	0	0
2	86715894	rs17027265	T	C	8	14	22	0	0	22	0	0
2	86716081	rs61028062	C	A	7	3	10	0	0	10	0	0
2	86717869	rs17027270	G	T	7	10	17	0	0	17	0	0
2	86717927	rs72932316	C	A	7	7	14	0	0	14	0	0
2	86731290	rs1137684	T	C	103	149	252	0	2	254	0	0
2	86731477	rs75976189	G	C	95	97	192	0	1	193	0	0
2	86731632	.	T	G	70	2	72	0	7	79	0	0
2	86732524	rs3201448	C	T	62	69	131	0	2	133	0	0
2	86732576	rs3731812	A	G	57	57	114	0	1	115	0	0
2	86756381	rs11548929	T	G	182	147	329	0	3	332	0	0
2	86775189	rs10187880	T	C	33	26	59	0	0	59	0	0
2	86775305	.	T	C	42	3	45	0	4	49	0	0
2	86776125	rs11890027	G	A	13	9	22	0	1	23	0	0
2	86776139	rs11890032	G	A	10	9	19	0	1	21	1	0
2	86776235	rs181394970	C	T	3	5	8	0	1	9	0	0
2	86776240	rs4832299	C	T	6	3	9	0	0	9	0	0
2	86776466	rs4832041	G	A	5	11	16	0	0	16	0	0
2	86776683	rs6710780	G	T	11	14	25	0	0	25	0	0
2	86778868	rs72932380	G	C	2	9	11	0	0	11	0	0
2	86780087	rs59613942	A	G	4	3	7	0	0	7	0	0
2	86780582	rs59521243	G	A	5	2	7	0	0	7	0	0
2	86782957	rs6750226	T	C	4	5	9	0	0	9	0	0
2	86784081	rs12613282	G	A	3	3	6	0	0	6	0	0
2	86789525	rs61465748	T	G	2	6	8	0	0	8	0	0
2	86789596	rs12987172	G	A	6	3	9	0	1	10	0	0
2	86840286	rs4240204	A	G	10	11	21	0	0	21	0	0
2	86840294	rs737463	A	T	9	12	21	0	0	21	0	0
2	86841069	rs745109	T	A	10	11	21	0	0	21	0	0
2	86841586	rs218059	C	T	7	7	14	0	0	14	0	0
2	86842174	rs4832045	G	A	17	27	44	0	1	45	0	0
2	86843488	rs308903	C	T	5	11	16	0	0	16	0	0
2	86843758	rs308902	C	G	49	54	103	0	0	103	0	0
2	86845509	rs74443614	G	C	27	39	66	0	1	67	0	0
2	86846399	rs56304923	T	C	26	34	60	0	1	61	0	0
2	86847269	rs308900	T	C	20	22	42	0	3	45	0	0
2	86947783	rs76239019	C	T	51	43	94	0	0	94	0	0
2	86979093	rs10186663	G	A	179	156	335	0	8	343	0	0
2	86987771	rs6726451	T	C	14	2	16	0	0	16	0	0
2	86987983	rs6711696	G	C	7	4	11	0	0	11	0	0
2	86996360	.	C	T	5	1	6	0	0	6	0	0
2	87002229	rs1193	C	T	181	164	345	0	1	346	0	0
2	87002706	rs13297	G	A	42	44	86	0	1	87	0	0
2	87003028	rs1049457	C	T	63	50	113	0	2	115	0	0
2	87003197	rs1049458	C	G	68	57	125	0	2	127	0	0
2	87068782	rs15800	T	G	6	1	7	0	0	7	0	0
2	87068827	rs1803262	G	A	7	1	8	0	0	8	0	0
2	87069379	rs4322832	G	A	7	1	8	0	0	8	0	0
2	87069431	rs4514875	C	T	4	2	6	0	0	6	0	0
2	87279109	rs10205992	C	T	12	9	21	0	0	21	0	0
2	87816037	rs4426534	C	G	4	6	10	0	0	10	0	0
2	87816737	rs139473148	A	G	3	6	9	0	0	9	0	0
2	87817807	rs62138021	T	C	6	5	11	0	0	11	0	0
2	88124821	rs374448391	C	T	22	0	22	0	0	22	0	0
2	88315980	rs185600898	G	C	1	6	7	0	0	7	0	0
2	89309542	rs150068501	T	G	6	1	7	0	0	7	0	0
2	89309554	rs147109427	T	A	6	1	7	0	0	7	0	0
2	89309735	rs80322626	A	G	7	0	7	0	0	7	0	0
2	89309762	rs77800356	T	G	8	0	8	0	0	8	0	0
2	91805928	.	T	C	8	0	8	0	0	8	0	0
2	91805938	.	A	G	8	0	8	0	0	8	0	0
2	91805943	.	T	C	8	0	8	0	0	8	0	0
2	96516050	.	C	T	6	0	6	0	0	6	0	0
2	96516082	.	G	A	7	0	7	0	0	7	0	0
2	96516084	.	A	G	7	0	7	0	0	7	0	0
2	96516096	.	A	G	7	0	7	0	0	7	0	0
2	96516117	.	A	G	6	0	6	0	0	6	0	0
2	96516125	.	T	C	6	0	6	0	1	7	0	0
2	96523096	rs10211258	T	C	10	5	15	0	0	15	0	0
2	96523194	.	A	C	15	7	22	0	0	22	0	0
2	96809331	rs1724120	T	C	750	714	1464	0	9	1473	0	0
2	96851119	rs11164062	C	A	147	143	290	0	2	292	0	0
2	96851617	rs11539223	T	C	85	64	149	0	2	151	0	0
2	96874626	rs80229301	C	A	5	2	7	0	0	7	0	0
2	96914636	rs11551400	T	C	55	52	107	0	3	110	0	0
2	96915677	rs78775537	G	A	58	30	88	0	0	88	0	0
2	96917588	rs7058	T	G	172	174	346	0	6	352	0	0
2	96934504	rs62153033	T	C	29	14	43	0	1	44	0	0
2	96934791	rs76009821	A	T	28	15	43	0	0	43	0	0
2	96937296	rs1044594	G	C	54	43	97	0	0	97	0	0
2	96943473	rs3214063	T	C	14	22	36	0	0	36	0	0
2	96948273	rs76047826	C	T	7	8	15	0	0	15	0	0
2	96953922	rs74902679	C	T	1	5	6	0	0	6	0	0
2	96993757	rs2279105	C	T	6	3	9	0	0	9	0	0
2	96993884	rs1048675	A	G	10	4	14	0	0	14	0	0
2	97030247	rs2305935	T	C	34	30	64	0	1	65	0	0
2	97203137	rs749027	A	C	4	3	7	0	0	7	0	0
2	97209159	rs13026942	C	T	4	3	7	0	0	7	0	0
2	97210083	.	C	T	3	6	9	0	0	9	0	0
2	97212693	rs2278563	C	T	7	8	15	0	0	15	0	0
2	97212755	rs1011040	T	C	6	9	15	0	0	15	0	0
2	97213150	rs200584052	A	G	81	91	172	0	3	175	0	0
2	97217435	.	C	T	132	86	218	0	2	220	0	0
2	97467489	rs111163458	C	A	5	2	7	0	0	7	0	0
2	97476219	rs3731941	A	G	21	34	55	0	1	56	0	0
2	97477374	rs12846	C	T	30	27	57	0	1	58	0	0
2	97493877	rs1320149	T	C	17	12	29	0	1	30	0	0
2	97498481	rs9973492	T	A	14	18	32	0	0	32	0	0
2	97500800	rs9948	G	C	27	23	50	0	0	50	0	0
2	97500852	rs12172	C	G	23	21	44	0	0	44	0	0
2	97501632	rs59244622	C	T	2	4	6	0	0	6	0	0
2	97504863	rs62152834	C	G	5	3	8	0	0	8	0	0
2	97508140	rs139314354	G	A	4	4	8	0	0	8	0	0
2	97757347	rs147890593	G	A	31	18	49	0	0	49	0	0
2	97783831	rs200765455	C	T	16	8	24	0	0	24	0	0
2	97851069	rs11164115	A	G	4	5	9	0	0	9	0	0
2	97860487	.	T	C	7	4	11	0	0	11	0	0
2	97864333	rs61218502	C	A	6	3	9	0	0	9	0	0
2	97864334	rs56835800	C	T	6	3	9	0	0	9	0	0
2	97864374	rs60795069	G	T	6	4	10	0	0	10	0	0
2	97877440	rs35711845	T	C	9	27	36	0	3	39	0	0
2	97883087	.	A	G	19	0	19	0	1	20	0	0
2	98089310	.	T	C	33	12	45	0	0	45	0	0
2	98164020	rs13001324	C	T	8	1	9	0	0	9	0	0
2	98164021	rs13017573	T	C	7	1	8	0	1	9	0	0
2	98164184	rs13001728	C	G	9	3	12	0	0	12	0	0
2	98165911	rs1839230	T	C	7	9	16	0	0	16	0	0
2	98186674	rs10194311	T	A	3	9	12	0	0	12	0	0
2	98186699	rs57591191	G	T	4	7	11	0	1	12	0	0
2	98187101	rs10197171	T	C	9	14	23	0	0	23	0	0
2	98189615	rs9678893	C	G	3	6	9	0	0	9	0	0
2	98189857	rs13005018	C	T	3	3	6	0	0	6	0	0
2	98190115	rs138745404	G	C	1	7	8	0	0	8	0	0
2	98190132	rs141158708	T	C	6	1	7	0	0	7	0	0
2	98191883	rs11687727	G	T	4	2	6	0	0	6	0	0
2	98195010	rs13423787	A	G	8	6	14	0	0	14	0	0
2	98195213	rs13427163	T	C	4	5	9	0	0	9	0	0
2	98196707	.	G	T	3	3	6	0	0	6	0	0
2	98196849	rs34131105	G	A	4	2	6	0	0	6	0	0
2	98196859	rs35904593	T	G	4	4	8	0	0	8	0	0
2	98206188	rs1868445	C	G	15	24	39	0	1	40	0	0
2	98206282	rs28415903	C	T	9	18	27	0	0	27	0	0
2	98206293	rs1814505	G	A	9	15	24	0	0	24	0	0
2	98272491	rs2290123	A	G	123	130	253	0	1	254	0	0
2	98272634	rs3475	G	A	234	223	457	0	4	461	0	0
2	98274783	rs7608385	C	T	7	6	13	0	0	13	0	0
2	98276724	rs72949085	C	T	5	9	14	0	0	14	0	0
2	98277090	rs79616802	T	C	147	133	280	0	3	283	0	0
2	98278435	rs58184071	G	A	12	14	26	0	0	26	0	0
2	98278845	rs58738348	G	T	6	12	18	0	1	19	0	0
2	98279076	rs11886025	G	A	8	9	17	0	0	17	0	0
2	98279574	rs11886239	G	A	14	15	29	0	1	30	0	0
2	98280400	rs112904064	C	G	11	15	26	0	0	26	0	0
2	98351592	rs113588261	G	A	3	3	6	0	0	6	0	0
2	98354293	.	G	A	12	13	25	0	0	25	0	0
2	98356250	rs2278699	G	C	2	5	7	0	0	7	0	0
2	98511611	rs10175129	G	A	2	6	8	0	0	8	0	0
2	98600082	rs10210880	C	A	12	13	25	0	1	26	0	0
2	98600861	rs72944839	T	C	4	6	10	0	1	11	0	0
2	98611994	rs2279824	G	T	2	5	7	0	0	7	0	0
2	99123177	rs3820943	G	C	7	11	18	0	0	18	0	0
2	99149946	rs2278211	G	A	1	6	7	0	1	8	0	0
2	99172244	rs2278206	A	G	4	9	13	0	0	13	0	0
2	99187433	rs3769709	A	T	1	6	7	0	0	7	0	0
2	99187650	rs3769708	T	C	1	7	8	0	0	8	0	0
2	99193496	rs2230388	C	T	5	13	18	0	0	18	0	0
2	99204428	rs6736755	C	T	7	3	10	0	0	10	0	0
2	99205962	rs2276603	T	C	2	5	7	0	0	7	0	0
2	99216158	rs75434845	G	A	11	16	27	0	0	27	0	0
2	99216531	rs11537554	A	G	5	9	14	0	0	14	0	0
2	99216593	rs72823794	T	A	6	10	16	0	0	16	0	0
2	99220707	rs4851144	T	C	14	4	18	0	0	18	0	0
2	99221088	rs76525766	A	G	10	6	16	0	0	16	0	0
2	99221095	rs17034171	A	G	9	6	15	0	0	15	0	0
2	99222916	rs4851145	C	T	4	3	7	0	0	7	0	0
2	99223925	rs3754872	A	T	8	1	9	0	0	9	0	0
2	99224309	rs3754871	A	T	6	8	14	0	0	14	0	0
2	99225165	rs570585020	G	A	20	28	48	0	0	48	0	0
2	99225168	rs1139829	C	T	29	19	48	0	0	48	0	0
2	99225645	rs11896729	T	C	6	2	8	0	0	8	0	0
2	99225666	rs188051574	C	G	3	7	10	0	0	10	0	0
2	99226021	rs3203856	C	T	9	6	15	0	0	15	0	0
2	99226173	rs1062847	T	A	11	13	24	0	0	24	0	0
2	99231805	rs7595120	C	G	7	4	11	0	0	11	0	0
2	99231856	rs143474605	C	T	5	9	14	0	0	14	0	0
2	99232312	rs1516085	G	A	10	8	18	0	0	18	0	0
2	99233781	rs3820941	C	T	9	3	12	0	0	12	0	0
2	99233894	rs3769698	T	C	11	9	20	0	0	20	0	0
2	99613924	rs1453561	C	T	3	4	7	0	0	7	0	0
2	99614396	rs1054042	G	T	3	4	7	0	0	7	0	0
2	99740175	rs6751927	T	C	3	5	8	0	0	8	0	0
2	99771268	rs2516832	G	C	10	11	21	0	0	21	0	0
2	99771272	rs2632261	C	T	9	10	19	0	1	20	0	0
2	99772875	rs2516828	T	C	10	15	25	0	0	25	0	0
2	99778985	rs2632277	T	C	12	16	28	0	0	28	0	0
2	99779131	rs2516835	T	C	19	29	48	0	0	48	0	0
2	99812070	rs1044575	G	A	49	65	114	0	0	114	0	0
2	99813614	rs13798	T	C	63	37	100	0	0	100	0	0
2	99814797	.	A	G	2	7	9	0	0	9	0	0
2	99815146	rs7349217	T	G	5	9	14	0	1	15	0	0
2	99921205	rs13008948	C	G	5	2	7	0	0	7	0	0
2	99929028	rs2141908	A	T	4	2	6	0	0	6	0	0
2	99932255	rs7589893	C	T	4	3	7	0	0	7	0	0
2	99936685	rs7609108	T	G	4	3	7	0	0	7	0	0
2	99948805	rs112900993	C	G	6	5	11	0	0	11	0	0
2	99992822	rs7558074	A	C	58	57	115	0	2	117	0	0
2	99995517	rs11896520	C	T	108	70	178	0	1	179	0	0
2	99995804	rs1376443	T	C	78	62	140	0	2	142	0	0
2	100015124	rs2305352	C	G	7	3	10	0	0	10	0	0
2	100016713	rs2290257	G	C	3	4	7	0	0	7	0	0
2	100018304	rs28382977	G	A	10	0	10	0	0	10	0	0
2	100019496	rs2305354	A	G	17	30	47	0	0	47	0	0
2	100020742	rs6711073	G	A	8	5	13	0	0	13	0	0
2	100021184	rs2290261	A	G	7	5	12	0	1	13	0	0
2	100022270	rs1053544	G	A	1	9	10	0	1	11	0	0
2	100022772	rs717454	T	C	13	13	26	0	0	26	0	0
2	100055506	rs3087386	A	G	68	56	124	0	0	124	0	0
2	100058870	rs3087403	C	T	51	84	135	0	1	136	0	0
2	101009326	rs1530031	T	C	50	53	103	0	0	103	0	0
2	101009600	rs1530030	G	A	45	43	88	0	0	88	0	0
2	101010082	rs3748930	G	C	27	35	62	0	0	62	0	0
2	101011877	rs2241810	T	C	3	4	7	0	1	8	0	0
2	101018130	rs17024216	A	G	11	21	32	0	0	32	0	0
2	101018411	rs4149516	C	G	8	18	26	0	0	26	0	0
2	101031561	rs3828193	G	T	9	18	27	0	1	28	0	0
2	101869588	rs2272320	G	T	8	9	17	0	0	17	0	0
2	101889306	rs750783	A	G	19	30	49	0	0	49	0	0
2	101892105	rs1192808	G	A	22	17	39	0	2	41	0	0
2	101892138	rs13017536	C	T	21	22	43	0	0	43	0	0
2	101903536	rs1192797	C	T	8	3	11	0	0	11	0	0
2	101904107	rs17020684	C	T	9	11	20	0	0	20	0	0
2	102013928	rs115333912	G	A	3	4	7	0	0	7	0	0
2	102029646	rs12620464	T	C	15	9	24	0	0	24	0	0
2	102029739	rs7603471	G	A	5	9	14	0	0	14	0	0
2	102031489	rs4851435	C	G	6	7	13	0	0	13	0	0
2	102031680	rs1107975	G	A	4	10	14	0	0	14	0	0
2	102032171	rs6543042	C	T	6	7	13	0	0	13	0	0
2	102035192	rs6709913	C	T	4	2	6	0	0	6	0	0
2	102067065	rs188952239	C	T	7	3	10	0	2	12	0	0
2	102068872	rs4851449	T	A	9	11	20	0	0	20	0	0
2	102079446	rs6705707	T	A	11	12	23	0	1	24	0	0
2	102079525	rs9678978	C	T	31	21	52	0	0	52	0	0
2	102079624	rs11904192	A	C	7	12	19	0	0	19	0	0
2	102079764	rs11904250	A	G	15	8	23	0	0	23	0	0
2	102079769	rs11884069	T	C	15	9	24	0	0	24	0	0
2	102079919	rs11884154	T	C	10	5	15	0	0	15	0	0
2	102080047	rs11690908	C	T	7	7	14	0	0	14	0	0
2	102080075	rs11674398	A	G	6	7	13	0	0	13	0	0
2	102080078	rs11679468	G	A	5	8	13	0	0	13	0	0
2	102080119	rs11674434	A	G	3	11	14	0	0	14	0	0
2	102080307	rs11123887	G	T	8	7	15	0	0	15	0	0
2	102080308	rs11123888	C	T	7	7	14	0	1	15	0	0
2	102080528	rs4851454	C	A	10	3	13	0	0	13	0	0
2	102080926	rs6720584	G	A	13	7	20	0	0	20	0	0
2	102081119	rs7574003	G	A	6	5	11	0	0	11	0	0
2	102493546	rs150787735	A	G	283	300	583	0	2	585	0	0
2	102793533	rs3917324	C	G	9	1	10	0	0	10	0	0
2	102855831	rs12993937	G	T	7	0	7	0	0	7	0	0
2	102945927	rs185554938	A	G	7	4	11	0	0	11	0	0
2	102992576	.	A	T	5	2	7	0	0	7	0	0
2	103332590	rs1051783	T	G	8	6	14	0	0	14	0	0
2	103333638	rs6725185	G	A	15	3	18	0	0	18	0	0
2	103333705	rs6712229	A	G	15	4	19	0	0	19	0	0
2	103334969	rs1052431	G	A	28	16	44	0	0	44	0	0
2	103349807	rs2540317	A	G	1	5	6	0	0	6	0	0
2	105883471	.	A	T	151	8	159	0	52	211	0	0
2	105954054	.	G	A	8	11	19	0	0	19	0	0
2	106368188	rs35264290	G	A	3	3	6	0	0	6	0	0
2	106375740	rs12616493	C	T	3	5	8	0	0	8	0	0
2	106376199	rs13031598	C	T	2	5	7	0	0	7	0	0
2	106376569	rs1114882	A	G	4	4	8	0	0	8	0	0
2	106376963	rs1986014	G	A	8	10	18	0	0	18	0	0
2	106377082	rs1986015	G	A	7	8	15	0	0	15	0	0
2	106377083	rs2134082	G	C	7	8	15	0	0	15	0	0
2	106378341	rs4851843	T	C	6	3	9	0	0	9	0	0
2	106378488	rs4851844	C	A	6	4	10	0	0	10	0	0
2	106378613	rs4851845	A	C	5	3	8	0	0	8	0	0
2	106379559	rs12479197	T	A	10	6	16	0	0	16	0	0
2	106379692	rs13003995	C	A	6	6	12	0	0	12	0	0
2	106380105	rs3769485	T	C	0	6	6	0	0	6	0	0
2	106380201	rs3769486	C	G	3	5	8	0	0	8	0	0
2	106715939	rs7564295	G	T	3	4	7	0	0	7	0	0
2	106715998	rs13383417	T	C	5	3	8	0	0	8	0	0
2	106716088	rs10198354	C	A	6	4	10	0	0	10	0	0
2	106716529	rs1901458	T	C	4	5	9	0	0	9	0	0
2	106716792	rs1901457	A	G	5	8	13	0	0	13	0	0
2	106717171	rs3739135	T	C	1	5	6	0	0	6	0	0
2	106740632	rs13018816	C	G	13	16	29	0	0	29	0	0
2	108994808	rs1402467	C	G	9	11	20	0	1	21	0	0
2	109004356	rs1967572	T	C	9	8	17	0	0	17	0	0
2	109089695	rs2718705	G	A	1	11	12	0	0	12	0	0
2	109089745	rs2577621	A	G	4	10	14	0	1	15	0	0
2	109089952	rs2577620	A	G	8	4	12	0	0	12	0	0
2	109090267	rs2577619	G	C	2	4	6	0	0	6	0	0
2	109091816	rs2577618	G	A	18	8	26	0	0	26	0	0
2	109092546	rs2718701	T	G	5	2	7	0	0	7	0	0
2	109092662	rs2577617	C	T	9	6	15	0	0	15	0	0
2	109125164	rs12779	A	G	43	62	105	0	0	105	0	0
2	109301074	rs826590	C	A	15	4	19	0	1	20	0	0
2	109301687	rs700879	G	C	21	15	36	0	0	36	0	0
2	109302388	rs700878	G	A	44	45	89	0	1	90	0	0
2	109302699	rs826592	C	T	36	34	70	0	1	71	0	0
2	109384494	.	C	T	189	204	393	0	3	396	0	0
2	111886332	rs13429049	C	T	20	8	28	0	0	28	0	0
2	111909247	rs3789068	A	G	3	5	8	0	0	8	0	0
2	111923630	rs6753785	T	G	40	34	74	0	0	74	0	0
2	111954082	rs1056737	T	C	5	3	8	0	0	8	0	0
2	111954117	rs1056736	T	C	7	5	12	0	1	13	0	0
2	111954323	rs1056735	T	C	10	2	12	0	0	12	0	0
2	112123574	.	G	A	6	0	6	0	0	6	0	0
2	112188885	rs4848520	C	T	5	4	9	0	0	9	0	0
2	112190858	rs981965	G	C	4	2	6	0	0	6	0	0
2	112526866	rs1044864	G	A	47	63	110	0	1	111	0	0
2	112551673	.	G	A	30	19	49	0	0	49	0	0
2	112552427	rs56780932	C	T	33	30	63	0	1	64	0	0
2	112605302	rs4848197	C	T	22	7	29	0	0	29	0	0
2	112637504	rs7563616	T	C	4	5	9	0	0	9	0	0
2	112641666	rs3814026	T	C	7	13	20	0	0	20	0	0
2	112686988	rs13027171	G	A	9	8	17	0	0	17	0	0
2	112751928	rs7604639	G	A	9	8	17	0	0	17	0	0
2	112754943	rs3811634	C	T	8	10	18	0	0	18	0	0
2	112755001	rs2230515	A	G	12	4	16	0	0	16	0	0
2	112763640	rs7583987	C	G	2	6	8	0	0	8	0	0
2	112763710	rs4511729	T	C	1	7	8	0	0	8	0	0
2	112765973	rs1131244	A	G	16	10	26	0	0	26	0	0
2	112875039	rs1045300	A	G	7	7	14	0	0	14	0	0
2	113147159	.	G	A	20	0	20	0	0	20	0	0
2	113147238	.	A	G	7	0	7	0	0	7	0	0
2	113162596	.	C	G	3	4	7	0	0	7	0	0
2	113166279	.	C	T	4	2	6	0	0	6	0	0
2	113243321	rs3961919	G	A	5	7	12	0	0	12	0	0
2	113309473	rs1545133	C	T	12	8	20	0	0	20	0	0
2	113312117	rs11689338	A	G	5	8	13	0	0	13	0	0
2	113334178	rs66487864	A	T	6	4	10	0	0	10	0	0
2	113334357	rs7578724	G	A	6	4	10	0	0	10	0	0
2	113346480	rs41278942	G	A	80	83	163	0	1	164	0	0
2	113413404	.	G	T	10	6	16	0	0	16	0	0
2	113494596	rs148811971	C	T	4	2	6	0	0	6	0	0
2	113591275	rs3136558	A	G	11	5	16	0	0	16	0	0
2	113887335	rs2232354	T	G	4	5	9	0	1	10	0	0
2	113887483	rs2071459	C	T	7	3	10	0	0	10	0	0
2	113888900	rs380092	T	A	6	2	8	0	0	8	0	0
2	113889100	rs3087266	C	T	3	5	8	0	0	8	0	0
2	113889119	rs4252019	C	T	3	5	8	0	0	8	0	0
2	113889134	rs973635	G	A	5	5	10	0	0	10	0	0
2	113890003	rs315953	C	T	4	3	7	0	0	7	0	0
2	113890304	rs315952	T	C	75	91	166	0	1	167	0	0
2	113890586	rs315951	C	G	95	102	197	0	2	199	0	0
2	113891412	rs9005	G	A	91	92	183	0	1	184	0	0
2	113940681	rs3748914	T	C	15	21	36	0	0	36	0	0
2	113940839	rs4849167	G	C	7	11	18	0	0	18	0	0
2	113942903	rs1975535	A	C	6	2	8	0	0	8	0	0
2	113943470	rs2241976	A	G	13	14	27	0	0	27	0	0
2	113956371	rs2276561	G	C	5	5	10	0	0	10	0	0
2	113962071	rs3811059	C	T	4	2	6	0	0	6	0	0
2	114201728	.	C	G	5	4	9	0	0	9	0	0
2	114343971	.	T	C	5	3	8	0	0	8	0	0
2	114343984	.	C	A	8	4	12	0	0	12	0	0
2	114343997	.	T	C	7	3	10	0	0	10	0	0
2	114344061	.	C	T	6	1	7	0	0	7	0	0
2	114345865	rs7355563	C	G	4	2	6	0	0	6	0	0
2	114349556	.	A	T	4	7	11	0	0	11	0	0
2	114349599	.	C	T	9	2	11	0	0	11	0	0
2	114349739	.	C	T	4	3	7	0	0	7	0	0
2	114350105	.	T	G	4	4	8	0	0	8	0	0
2	114351412	.	A	G	10	5	15	0	1	16	0	0
2	114352638	.	A	G	6	3	9	0	0	9	0	0
2	114352643	.	G	A	8	6	14	0	1	15	0	0
2	114354325	.	C	T	32	16	48	0	1	49	0	0
2	114355167	.	A	G	165	159	324	0	2	328	2	0
2	114355200	.	A	G	206	20	226	0	5	231	0	0
2	114355237	.	C	T	3	6	9	0	0	9	0	0
2	114355740	.	G	A	10	2	12	0	0	12	0	0
2	114356059	.	G	A	19	4	23	0	0	23	0	0
2	114356221	.	C	T	60	7	67	0	2	69	0	0
2	114357393	.	G	A	14	8	22	0	0	22	0	0
2	114357847	.	T	A	9	6	15	0	0	15	0	0
2	114691342	rs13396357	C	T	2	5	7	0	0	7	0	0
2	115918855	rs186574338	C	T	0	6	6	0	0	6	0	0
2	115918857	rs6729043	G	C	6	0	6	0	0	6	0	0
2	116510817	rs2053724	G	C	0	16	16	0	0	16	0	0
2	116600118	rs35586568	G	A	28	0	28	0	0	28	0	0
2	116601631	rs272008	C	T	0	14	14	0	0	14	0	0
2	118580670	rs6715763	A	G	6	10	16	0	0	16	0	0
2	118581294	rs2551887	A	G	4	6	10	0	0	10	0	0
2	118586360	rs6731372	G	A	9	5	14	0	2	16	0	0
2	118588640	rs1863041	C	T	68	77	145	0	3	148	0	0
2	118589029	rs13030497	T	G	114	105	219	0	3	222	0	0
2	118589808	rs7369	C	T	31	18	49	0	4	53	0	0
2	118589843	rs571	C	T	19	9	28	0	1	29	0	0
2	118594392	rs13423919	C	T	4	2	6	0	0	6	0	0
2	118594469	rs2570197	C	G	4	2	6	0	0	6	0	0
2	118673663	rs1046330	T	C	42	26	68	0	0	68	0	0
2	118673738	rs1046328	G	A	49	32	81	0	0	81	0	0
2	118673859	.	C	T	39	35	74	0	2	76	0	0
2	118675578	rs12711888	C	T	17	20	37	0	0	37	0	0
2	118675743	rs11123466	G	A	28	22	50	0	1	51	0	0
2	118676111	rs6755016	T	C	31	20	51	0	2	53	0	0
2	118676836	rs1863040	T	C	12	6	18	0	1	19	0	0
2	118677916	rs35891278	T	C	37	40	77	0	0	77	0	0
2	118694393	rs2303333	C	G	6	3	9	0	0	9	0	0
2	118708284	rs7578387	C	T	11	10	21	0	0	21	0	0
2	118708813	rs3771941	C	T	9	5	14	0	0	14	0	0
2	118708850	rs3771942	C	G	8	11	19	0	0	19	0	0
2	118709122	rs3771943	T	G	10	13	23	0	0	23	0	0
2	118743630	rs33975708	G	A	20	16	36	0	2	38	0	0
2	118750407	rs7564075	A	T	5	6	11	0	0	11	0	0
2	118771566	rs11545372	C	A	19	30	49	0	0	49	0	0
2	118863874	rs9308762	C	T	5	2	7	0	0	7	0	0
2	118866392	rs78663648	A	C	4	3	7	0	0	7	0	0
2	120059988	rs1890	T	C	19	11	30	0	0	30	0	0
2	120060082	rs1052500	T	C	20	21	41	0	0	41	0	0
2	120078778	rs1132267	T	C	23	12	35	0	0	35	0	0
2	120124178	rs140555495	A	G	4	4	8	0	0	8	0	0
2	120125053	rs3731608	C	G	8	1	9	0	0	9	0	0
2	120125058	rs3731607	C	T	8	1	9	0	0	9	0	0
2	120125689	rs8192503	A	T	6	0	6	0	0	6	0	0
2	120125910	rs2276596	C	A	5	2	7	0	0	7	0	0
2	120125973	rs3091407	G	C	4	6	10	0	0	10	0	0
2	120126749	rs3769664	G	A	6	2	8	0	0	8	0	0
2	120126753	rs3769663	G	A	5	1	6	0	1	7	0	0
2	120127180	rs11123518	A	G	9	1	10	0	0	10	0	0
2	120127276	rs12466117	C	T	1	7	8	0	0	8	0	0
2	120128482	rs956309	C	T	5	1	6	0	0	6	0	0
2	120979463	rs76403228	A	G	40	40	80	0	2	82	0	0
2	120980428	rs11550347	G	C	16	27	43	0	0	43	0	0
2	121014223	rs149421085	C	T	12	1	13	0	0	13	0	0
2	121016064	rs77638978	G	A	3	4	7	0	0	7	0	0
2	121016507	rs6735554	G	A	5	6	11	0	0	11	0	0
2	121026582	rs11688038	A	G	5	27	32	0	0	32	0	0
2	121036333	rs11545293	G	A	169	140	309	0	2	311	0	0
2	121044922	rs79742700	G	A	5	3	8	0	0	8	0	0
2	121045113	rs75883745	C	T	9	4	13	0	0	13	0	0
2	121976214	rs6541770	C	T	4	2	6	0	0	6	0	0
2	122096018	rs934940	C	A	33	39	72	0	2	74	0	0
2	122515214	rs11122867	G	T	5	3	8	0	0	8	0	0
2	127420931	rs2016257	A	G	4	4	8	0	1	9	0	0
2	127421391	rs12692114	C	G	7	8	15	0	0	15	0	0
2	127421701	rs12468957	G	A	9	7	16	0	0	16	0	0
2	127422573	rs4662685	G	A	11	8	19	0	0	19	0	0
2	127422593	rs7589096	C	T	10	8	18	0	0	18	0	0
2	127422910	rs7597905	T	C	2	4	6	0	0	6	0	0
2	127443958	rs17741936	T	G	6	5	11	0	0	11	0	0
2	127446489	rs935019	A	G	3	5	8	0	0	8	0	0
2	127446528	rs893798	T	C	2	4	6	0	0	6	0	0
2	127446529	rs28647563	G	A	2	4	6	0	0	6	0	0
2	127447051	rs2165227	G	C	3	6	9	0	0	9	0	0
2	127447763	rs6709803	G	A	7	4	11	0	0	11	0	0
2	127448415	rs74499727	C	T	11	6	17	0	0	17	0	0
2	127448632	rs382844	G	A	8	0	8	0	0	8	0	0
2	127448989	rs2280238	G	A	18	14	32	0	1	33	0	0
2	127449117	rs2280239	C	T	17	21	38	0	0	38	0	0
2	127449149	rs2280240	G	T	17	17	34	0	0	34	0	0
2	127449447	.	C	G	9	5	14	0	0	14	0	0
2	127449532	rs6713909	T	G	6	1	7	0	0	7	0	0
2	127449666	rs2176429	C	T	6	3	9	0	0	9	0	0
2	127449705	rs2176428	C	T	4	5	9	0	1	10	0	0
2	127453664	rs1050967	A	C	1083	936	2019	0	8	2029	2	0
2	127808532	rs2043798	G	A	8	10	18	0	0	18	0	0
2	127808909	rs6745677	G	A	5	4	9	0	0	9	0	0
2	127810697	rs17014818	C	T	5	2	7	0	0	7	0	0
2	127812468	rs3768863	A	G	3	4	7	0	0	7	0	0
2	127816632	rs2276579	G	A	92	142	234	0	8	242	0	0
2	127826533	rs1060743	A	G	149	158	307	0	2	309	0	0
2	127841930	rs17014923	C	T	3	3	6	0	1	7	0	0
2	128018063	rs3738948	A	G	5	6	11	0	1	12	0	0
2	128050000	rs4150404	A	G	3	3	6	0	0	6	0	0
2	128063846	rs9923	C	T	51	49	100	0	1	101	0	0
2	128063945	rs10850	T	C	35	49	84	0	2	86	0	0
2	128079806	rs3732209	A	G	21	20	41	0	0	41	0	0
2	128140500	rs1518760	T	G	4	2	6	0	0	6	0	0
2	128144286	rs7607907	T	C	0	6	6	0	0	6	0	0
2	128144731	rs12989081	T	C	4	2	6	0	0	6	0	0
2	128146762	rs2276683	G	C	2	61	63	0	0	63	0	0
2	128240302	rs3732205	A	G	4	3	7	0	0	7	0	0
2	128243335	rs334160	T	C	5	2	7	0	0	7	0	0
2	128246984	rs2288655	A	G	5	7	12	0	0	12	0	0
2	128283410	rs1864554	A	T	6	1	7	0	0	7	0	0
2	128393800	rs2255161	T	C	3	5	8	0	0	8	0	0
2	128394955	rs11686946	A	G	4	2	6	0	0	6	0	0
2	128458958	rs6713423	A	G	47	40	87	0	1	88	0	0
2	128459039	rs1048211	A	G	33	28	61	0	1	62	0	0
2	128459214	rs10206957	C	G	3	3	6	0	0	6	0	0
2	128461524	rs7584783	G	T	17	15	32	0	1	33	0	0
2	128461556	rs7575478	A	G	20	16	36	0	1	37	0	0
2	128562813	rs7578247	A	G	2	4	6	0	0	6	0	0
2	128601490	rs11688522	T	C	11	11	22	0	0	22	0	0
2	128602341	rs6746537	T	C	6	5	11	0	0	11	0	0
2	128603026	rs71420810	C	T	5	1	6	0	0	6	0	0
2	128604232	rs1061056	A	T	11	8	19	0	0	19	0	0
2	128608290	rs6713679	T	C	6	4	10	0	0	10	0	0
2	128699750	rs2304519	G	C	3	4	7	0	0	7	0	0
2	128934400	rs2290111	T	C	9	7	16	0	1	17	0	0
2	128939799	rs17178720	C	T	26	15	41	0	0	41	0	0
2	128939817	rs1699	G	A	25	11	36	0	0	36	0	0
2	128947505	rs11542865	G	A	8	9	17	0	0	17	0	0
2	128947895	rs9973651	T	C	9	5	14	0	0	14	0	0
2	128949208	rs13028303	G	A	16	12	28	0	0	28	0	0
2	128949893	rs1054317	A	G	14	15	29	0	0	29	0	0
2	128950217	rs11542864	C	T	18	8	26	0	0	26	0	0
2	129023282	rs1043521	G	C	79	51	130	0	1	131	0	0
2	129075961	rs1133923	T	C	8	5	13	0	1	14	0	0
2	130897234	rs3177472	C	T	0	8	8	0	0	8	0	0
2	130909061	rs6985	G	T	83	0	83	0	5	88	0	0
2	130909081	rs139458844	C	A	82	0	82	0	6	88	0	0
2	130909819	rs3192417	G	C	146	107	253	0	2	255	0	0
2	130909882	rs3192414	C	G	167	156	323	0	1	324	0	0
2	130910847	rs4511676	G	A	3	4	7	0	0	7	0	0
2	130912326	rs111583358	G	A	6	5	11	0	0	11	0	0
2	130912514	rs10928960	A	G	4	9	13	0	0	13	0	0
2	130913460	rs11679878	C	T	4	5	9	0	0	9	0	0
2	130914655	rs13024697	G	A	6	2	8	0	0	8	0	0
2	130914797	.	T	C	4	2	6	0	0	6	0	0
2	130916286	rs11684431	C	T	23	15	38	0	0	38	0	0
2	130916415	rs2084784	A	G	13	11	24	0	0	24	0	0
2	130918026	rs3990508	G	A	15	7	22	0	0	22	0	0
2	130918458	rs13427291	A	G	21	6	27	0	0	27	0	0
2	130919226	rs34463896	C	T	5	6	11	0	0	11	0	0
2	130919308	rs13411684	A	G	7	5	12	0	0	12	0	0
2	130920763	rs12620443	A	G	5	4	9	0	0	9	0	0
2	130920774	rs10198100	A	G	5	4	9	0	0	9	0	0
2	130924500	.	C	T	1	6	7	0	0	7	0	0
2	130925088	rs10909567	C	T	74	78	152	0	3	156	1	0
2	130930819	rs2290295	C	T	2	4	6	0	0	6	0	0
2	130931678	rs7601693	C	T	4	2	6	0	0	6	0	0
2	130939288	rs1968676	A	G	17	11	28	0	0	28	0	0
2	130939348	rs1817097	G	A	29	15	44	0	1	45	0	0
2	130940090	rs1968675	G	T	8	9	17	0	0	17	0	0
2	131805984	rs11541220	G	T	221	212	433	0	0	433	0	0
2	131809197	rs7598890	C	T	50	30	80	0	1	81	0	0
2	131865064	rs11901794	A	G	8	13	21	0	0	21	0	0
2	131865223	rs184938861	A	G	4	6	10	0	0	10	0	0
2	131877646	rs57947210	G	A	3	3	6	0	0	6	0	0
2	131898811	rs11899277	A	G	6	6	12	0	0	12	0	0
2	131903240	rs16856542	A	G	15	8	23	0	0	23	0	0
2	131905028	.	A	G	68	84	152	0	1	153	0	0
2	131905296	rs3203233	A	G	78	53	131	0	3	134	0	0
2	131906250	rs16856546	C	G	191	162	353	0	5	358	0	0
2	132227543	rs2621961	A	G	25	9	34	0	0	34	0	0
2	132227549	rs373299402	G	T	12	23	35	0	0	35	0	0
2	132241452	rs59965165	T	C	5	1	6	0	0	6	0	0
2	132241704	rs11553182	C	T	369	79	448	0	2	450	0	0
2	132241731	rs75021268	T	C	389	77	466	0	2	468	0	0
2	132243658	rs10196576	G	A	10	1	11	0	0	11	0	0
2	132243661	rs10196582	G	C	11	1	12	0	0	12	0	0
2	132248336	rs59539470	C	G	2	4	6	0	0	6	0	0
2	132249600	rs2272357	G	A	9	8	17	0	1	18	0	0
2	132249605	rs2272358	G	A	9	9	18	0	0	18	0	0
2	132250578	rs2272359	G	C	13	5	18	0	0	18	0	0
2	132250656	rs2272360	C	G	4	9	13	0	0	13	0	0
2	132257830	rs13035779	C	T	36	35	71	0	2	73	0	0
2	132258593	rs13415770;rs76033185	A	G	37	51	88	0	0	88	0	0
2	132260032	rs7579864	C	T	15	8	23	0	2	25	0	0
2	132260256	rs10928713	A	G	14	6	20	0	0	20	0	0
2	132260263	rs10928714	A	G	17	4	21	0	0	21	0	0
2	132263518	rs10197597	T	A	2	4	6	0	0	6	0	0
2	132263793	rs10190283	C	G	3	3	6	0	0	6	0	0
2	132264180	rs2872424	C	G	3	12	15	0	0	15	0	0
2	132264187	rs2313828	G	T	3	11	14	0	0	14	0	0
2	132264243	rs2313829	G	A	2	13	15	0	0	15	0	0
2	132264308	rs2313830	G	C	4	16	20	0	0	20	0	0
2	132264474	rs2313831	G	A	1	6	7	0	0	7	0	0
2	132265089	rs12617520	G	A	5	5	10	0	0	10	0	0
2	132266303	rs13011046	C	A	4	2	6	0	1	7	0	0
2	132266315	rs13020752	A	T	6	3	9	0	0	9	0	0
2	132266340	rs12691989	A	G	6	4	10	0	0	10	0	0
2	132266419	rs12691990	C	T	4	2	6	0	0	6	0	0
2	132266738	rs10200100	C	A	8	3	11	0	0	11	0	0
2	132266794	rs10204869	A	C	9	3	12	0	0	12	0	0
2	132266916	rs2622059	A	G	6	0	6	0	0	6	0	0
2	132267439	rs2013060	C	T	7	3	10	0	1	11	0	0
2	132267456	rs2313834	G	C	7	3	10	0	0	10	0	0
2	132267458	rs2872426	T	G	7	3	10	0	0	10	0	0
2	132267459	rs2872427	C	T	7	3	10	0	0	10	0	0
2	132267689	rs6430835	G	A	5	17	22	0	0	22	0	0
2	132267749	rs1815206	C	T	12	3	15	0	0	15	0	0
2	132267871	rs10194268	G	A	11	4	15	0	0	15	0	0
2	132267882	rs28494479	A	C	7	3	10	0	1	11	0	0
2	132267895	rs10208334	A	T	7	2	9	0	1	10	0	0
2	132268094	rs10196931	G	A	12	2	14	0	0	14	0	0
2	132268145	rs13417103	G	A	8	1	9	0	0	9	0	0
2	132268741	rs28464425	T	A	5	4	9	0	0	9	0	0
2	132269230	rs4145988	G	C	9	2	11	0	1	12	0	0
2	132269231	rs4145987	G	A	10	2	12	0	0	12	0	0
2	132269281	rs12691991	T	A	12	4	16	0	0	16	0	0
2	132269567	rs13421148	G	C	6	5	11	0	0	11	0	0
2	132269570	rs13388497	T	C	4	6	10	0	0	10	0	0
2	132270136	rs2103256	C	T	23	7	30	0	1	31	0	0
2	132270145	rs4464325	C	T	24	6	30	0	1	31	0	0
2	132270175	rs2091456	C	T	27	8	35	0	1	36	0	0
2	132270282	rs2178042	G	A	32	5	37	0	0	37	0	0
2	132270576	rs12691993	A	G	26	6	32	0	1	33	0	0
2	132270805	rs12691995	A	G	16	9	25	0	1	26	0	0
2	132270857	rs13389273	A	G	11	2	13	0	0	13	0	0
2	132270862	rs13389274	A	G	9	2	11	0	0	11	0	0
2	132270868	rs13389275	A	G	9	2	11	0	0	11	0	0
2	132270940	rs13384327	C	T	12	0	12	0	0	12	0	0
2	132271199	rs66665966	T	C	28	4	32	0	1	33	0	0
2	132271409	rs12989425	G	A	18	2	20	0	0	20	0	0
2	132271429	rs13025036	T	G	20	3	23	0	0	23	0	0
2	132271566	rs13025246	T	C	25	3	28	0	0	28	0	0
2	132272009	rs13025011	A	G	17	4	21	0	0	21	0	0
2	132272052	rs12995688	G	A	13	5	18	0	0	18	0	0
2	132272095	rs12995855	G	A	7	1	8	0	0	8	0	0
2	132272114	rs12995872	G	A	11	1	12	0	0	12	0	0
2	132272149	rs12995906	G	A	17	2	19	0	0	19	0	0
2	132272158	rs13031436	T	A	18	4	22	0	0	22	0	0
2	132272160	rs12995918	G	A	18	4	22	0	1	23	0	0
2	132272326	rs12477742	A	G	35	8	43	0	1	44	0	0
2	132272472	rs12476228	C	T	25	6	31	0	0	31	0	0
2	132272512	rs9973902	A	T	22	5	27	0	0	31	4	0
2	132272563	rs9973833	C	T	20	5	25	0	0	25	0	0
2	132272664	rs9973837	C	T	26	10	36	0	0	36	0	0
2	132272800	rs4380288	A	G	19	4	23	0	0	23	0	0
2	132272856	rs2622007	A	C	17	8	25	0	1	26	0	0
2	132272917	rs190335258	G	A	20	5	25	0	0	25	0	0
2	132273092	rs2950565	T	G	34	7	41	0	1	42	0	0
2	132273493	rs941329	C	T	2	7	9	0	0	9	0	0
2	132273621	rs1815205	G	A	11	13	24	0	1	25	0	0
2	132273801	.	C	T	6	0	6	0	0	6	0	0
2	132274474	rs13010688	G	A	74	35	109	0	0	109	0	0
2	132276254	rs28621583	A	G	100	8	108	0	1	109	0	0
2	132276359	rs7608954	T	C	27	11	38	0	0	38	0	0
2	132276412	rs7605741	A	G	25	14	39	0	0	39	0	0
2	132276435	rs7600509	C	T	24	11	35	0	1	36	0	0
2	132276530	rs12052334	C	T	45	10	55	0	0	55	0	0
2	132276650	.	G	C	136	10	146	0	4	150	0	0
2	132277686	rs9287520	C	T	83	60	143	0	2	145	0	0
2	132277984	rs10209980	G	A	89	57	146	0	4	150	0	0
2	132278118	rs143759515	C	T	83	123	206	0	0	206	0	0
2	132278419	rs59594934	G	A	79	106	185	0	0	185	0	0
2	132278713	rs12692003	T	C	23	13	36	0	1	37	0	0
2	134883353	rs2277882	C	G	3	5	8	0	0	8	0	0
2	134885073	rs11900650	C	A	3	5	8	0	1	9	0	0
2	135206340	rs2230908	C	A	16	21	37	0	0	37	0	0
2	135206639	rs62170042	G	T	34	27	61	0	1	62	0	0
2	135206934	rs681148	C	T	7	13	20	0	0	20	0	0
2	135208077	rs651970	A	G	15	15	30	0	0	30	0	0
2	135208213	rs626540	A	G	24	17	41	0	0	41	0	0
2	135209142	rs2439568	G	A	27	17	44	0	0	44	0	0
2	135209154	rs636975	A	G	26	19	45	0	0	45	0	0
2	135209591	rs669740	C	T	10	19	29	0	1	30	0	0
2	135209617	rs113670398	C	T	22	11	33	0	1	34	0	0
2	135210390	rs2290483	A	G	16	12	28	0	0	28	0	0
2	135211544	rs1041938	A	T	18	27	45	0	0	45	0	0
2	135214017	rs78198285	C	A	9	13	22	0	0	22	0	0
2	135214042	rs2289469	G	A	14	9	23	0	0	23	0	0
2	135214259	rs2289470	G	A	11	19	30	0	1	31	0	0
2	135704649	rs78307670	G	A	7	3	10	0	0	10	0	0
2	135893372	rs10445686	A	G	42	41	83	0	0	83	0	0
2	135911422	rs17261772	T	C	74	68	142	0	0	142	0	0
2	136393658	rs961360	A	G	38	35	73	0	1	74	0	0
2	136407479	rs1446585	A	G	5	2	7	0	0	7	0	0
2	136500475	rs73958618	A	G	86	102	188	0	3	191	0	0
2	136501509	rs6732236	T	G	14	7	21	0	0	21	0	0
2	136501840	rs10928545	A	G	7	33	40	0	0	40	0	0
2	136502792	rs1438305	C	G	15	36	51	0	2	53	0	0
2	136504101	rs7589832	A	C	3	4	7	0	1	8	0	0
2	136511575	rs3213889	A	G	23	13	36	0	0	36	0	0
2	136511817	rs1050115	A	G	52	51	103	0	1	104	0	0
2	136532225	rs58301703	G	A	7	9	16	0	0	16	0	0
2	136538939	rs9677760	T	A	9	3	12	0	0	12	0	0
2	136539122	rs11684545	G	T	38	5	43	0	0	43	0	0
2	136539330	rs1865452	C	T	5	9	14	0	1	15	0	0
2	136539513	rs10188066	G	A	16	11	27	0	1	28	0	0
2	136539670	rs60963894	T	G	7	10	17	0	0	17	0	0
2	136540083	rs10496737	A	G	3	11	14	0	0	14	0	0
2	136542559	rs1469995	G	A	31	42	73	0	0	73	0	0
2	136542560	rs1469996	A	G	31	42	73	0	0	73	0	0
2	136603276	rs3754686	T	C	3	3	6	0	0	6	0	0
2	136610598	rs4988226	A	G	7	3	10	0	0	10	0	0
2	136611624	rs309178	C	T	7	0	7	0	0	7	0	0
2	136614255	rs309180	G	A	5	8	13	0	0	13	0	0
2	136633962	rs1057031	G	A	12	19	31	0	0	31	0	0
2	136743143	rs2278682	G	C	7	3	10	0	0	10	0	0
2	136873341	.	T	G	2129	2188	4317	0	63	4381	1	0
2	136873549	rs2680880	A	T	159	142	301	0	1	302	0	0
2	139308127	rs35257103	G	A	22	24	46	0	0	46	0	0
2	139309768	rs4954715	G	A	2	4	6	0	0	6	0	0
2	139314522	rs34724499	C	G	10	6	16	0	0	16	0	0
2	139327055	rs7598316	A	G	29	20	49	0	0	49	0	0
2	139329354	rs78238900	A	G	54	112	166	0	0	166	0	0
2	139368806	rs56131519	C	A	5	3	8	0	0	8	0	0
2	139369567	rs13001826	T	C	12	4	16	0	0	16	0	0
2	139370544	rs72860891	C	T	20	12	32	0	0	32	0	0
2	143886437	rs354707	T	A	13	8	21	0	0	21	0	0
2	143886535	rs354708	A	T	8	6	14	0	0	14	0	0
2	143886953	rs354709	T	C	77	82	159	0	0	159	0	0
2	144363104	rs12612108	G	C	1	5	6	0	0	6	0	0
2	144372247	rs11900928	A	T	2	5	7	0	0	7	0	0
2	144372769	rs10928189	G	A	4	5	9	0	0	9	0	0
2	144422012	rs28809530	T	A	5	1	6	0	0	6	0	0
2	144422708	rs202214726	C	T	4	4	8	0	0	8	0	0
2	144423600	rs201544413	C	G	2	5	7	0	0	7	0	0
2	144424581	.	C	T	6	4	10	0	0	10	0	0
2	144428663	rs55938142	T	A	4	4	8	0	0	8	0	0
2	144496478	rs12691690	A	T	3	3	6	0	1	7	0	0
2	144500243	rs77858359	G	A	3	7	10	0	0	10	0	0
2	144526114	rs13426469	A	G	4	2	6	0	0	6	0	0
2	144899559	rs3731958	C	A	21	23	44	0	0	44	0	0
2	144968700	rs76524628	C	T	7	3	10	0	0	10	0	0
2	145076775	rs77378499	T	C	3	5	8	0	0	8	0	0
2	148696560	rs568854701	C	G	5	2	7	0	0	7	0	0
2	148730367	rs2307397	G	C	52	69	121	0	0	121	0	0
2	149270710	rs16828708	A	G	3	4	7	0	0	7	0	0
2	149468145	rs34676510	G	A	7	7	14	0	0	14	0	0
2	149469411	rs13035649	T	C	4	6	10	0	0	10	0	0
2	149469813	rs13010514	G	T	5	4	9	0	0	9	0	0
2	149529212	rs16829255	C	T	3	3	6	0	0	6	0	0
2	152127011	rs11730	A	G	7	2	9	0	0	9	0	0
2	152127699	rs13004590	G	T	3	5	8	0	0	8	0	0
2	152138522	rs3771886	T	C	167	171	338	0	2	340	0	0
2	152139416	rs1048135	G	A	123	122	245	0	0	245	0	0
2	152146194	rs2194492	G	C	28	40	68	0	0	68	0	0
2	152303171	rs2432941	G	A	5	2	7	0	0	7	0	0
2	152306035	rs2432944	T	C	5	2	7	0	0	7	0	0
2	152311570	rs2444263	G	A	13	20	33	0	0	33	0	0
2	152320118	rs2123465	G	A	17	18	35	0	0	35	0	0
2	152322095	rs2444257	A	T	29	31	60	0	0	60	0	0
2	152324789	rs2444274	G	C	6	0	6	0	0	6	0	0
2	152329212	rs2432953	G	A	8	10	18	0	0	18	0	0
2	152331418	rs1065177	C	G	60	63	123	0	1	124	0	0
2	152331999	rs2432955	G	T	12	13	25	0	1	26	0	0
2	152333304	rs13555	C	A	5	8	13	0	0	13	0	0
2	152655471	rs1799	C	T	10	8	18	0	0	18	0	0
2	152655652	rs2293222	G	A	15	4	19	0	0	19	0	0
2	152657849	rs1054883	T	A	28	33	61	0	1	62	0	0
2	152658577	rs13428623	T	C	5	8	13	0	1	14	0	0
2	152683459	rs10190733	T	C	5	12	17	0	0	17	0	0
2	152683731	rs1357468	T	C	11	9	20	0	0	20	0	0
2	152976002	rs10497094	G	C	8	12	20	0	1	21	0	0
2	153000337	rs12617139	T	A	5	1	6	0	0	6	0	0
2	153511027	rs9789505	T	C	16	8	24	0	1	25	0	0
2	153513258	rs71417235	C	T	18	20	38	0	0	38	0	0
2	153513857	rs17400456	T	C	12	15	27	0	0	27	0	0
2	153521356	rs146164312	A	G	4	5	9	0	1	10	0	0
2	153522963	rs3762503	T	C	6	6	12	0	0	12	0	0
2	153524293	rs7582253	G	A	2	4	6	0	0	6	0	0
2	153524311	rs7556673	C	A	2	4	6	0	0	6	0	0
2	153549819	rs13003670	C	T	29	28	57	0	1	58	0	0
2	153574266	rs7598878	G	A	9	4	13	0	0	13	0	0
2	153575305	rs116506483	G	T	58	60	118	0	1	119	0	0
2	153575729	rs1135617	T	G	27	60	87	0	2	89	0	0
2	153575962	rs13006652	T	C	26	81	107	0	0	107	0	0
2	153575972	rs3748938	A	G	76	26	102	0	0	102	0	0
2	153576006	rs3748937	T	C	88	27	115	0	1	116	0	0
2	153576279	rs7594309	A	C	23	8	31	0	0	31	0	0
2	157183635	rs834834	C	T	6	6	12	0	1	13	0	0
2	158175558	.	T	C	28	27	55	0	2	57	0	0
2	158971237	rs13418976	C	T	5	2	7	0	0	7	0	0
2	158974155	rs10176046	T	G	2	5	7	0	0	7	0	0
2	159313666	rs3755401	G	A	3	3	6	0	0	6	0	0
2	159660870	rs17810398	C	T	10	9	19	0	0	19	0	0
2	159672442	rs10016	G	A	4	6	10	0	0	10	0	0
2	159946913	rs56234202	C	A	7	7	14	0	0	14	0	0
2	159947655	rs264625	T	C	7	4	11	0	0	11	0	0
2	159947739	rs35952094	T	C	3	6	9	0	0	9	0	0
2	159954175	rs34588551	C	T	3	6	9	0	0	9	0	0
2	160035195	rs12988603	C	T	2	5	7	0	0	7	0	0
2	160084713	rs73967250	A	G	5	3	8	0	0	8	0	0
2	160086640	rs111652024	G	T	5	5	10	0	0	10	0	0
2	160086653	rs4664276	C	T	6	5	11	0	0	11	0	0
2	160086654	rs4664277	A	G	5	5	10	0	0	10	0	0
2	160088607	rs10929938	A	G	6	6	12	0	1	13	0	0
2	160093149	rs6432519	C	T	4	2	6	0	0	6	0	0
2	160139284	rs73968307	A	C	20	11	31	0	1	32	0	0
2	160182302	rs415793	C	T	51	36	87	0	0	87	0	0
2	160287504	rs35695911	A	C	14	13	27	0	0	27	0	0
2	160294842	rs3213790	A	G	9	17	26	0	0	26	0	0
2	160460161	rs72960300	A	G	5	2	7	0	0	7	0	0
2	160472950	rs13388082	C	T	80	78	158	0	2	160	0	0
2	160473399	rs1046496	A	T	55	43	98	0	0	98	0	0
2	160551862	rs1134023	T	C	1	9	10	0	0	10	0	0
2	160567230	rs3821300	T	C	3	16	19	0	0	19	0	0
2	160588484	rs10201985	G	A	5	5	10	0	0	10	0	0
2	160589153	rs139965013	A	G	4	4	8	0	0	8	0	0
2	160589309	rs76216015	A	G	5	10	15	0	0	15	0	0
2	160589343	rs10170336	T	C	3	10	13	0	2	15	0	0
2	160589818	rs78545024	A	G	5	4	9	0	1	10	0	0
2	160591648	rs6432555	T	G	23	22	45	0	0	45	0	0
2	160591847	rs6432556	A	G	7	12	19	0	0	19	0	0
2	160592046	rs6722764	A	T	10	15	25	0	0	25	0	0
2	160599717	rs17813964	C	G	78	71	149	0	2	151	0	0
2	160621739	rs2059699	G	T	11	4	15	0	1	16	0	0
2	160622630	rs12469866	G	C	4	13	17	0	0	17	0	0
2	160622961	rs10929952	C	T	8	8	16	0	0	16	0	0
2	160624689	rs73967909	T	G	31	36	67	0	2	69	0	0
2	160625841	rs10206114	T	C	73	52	125	0	1	126	0	0
2	160626622	rs1042666	C	T	50	64	114	0	0	114	0	0
2	160626898	rs17815029	T	C	28	39	67	0	0	67	0	0
2	160627914	rs73967910	G	A	8	2	10	0	0	10	0	0
2	160628463	rs34068933	G	T	62	28	90	0	1	91	0	0
2	160654198	rs73967921	C	A	5	5	10	0	0	10	0	0
2	160659996	rs13307	G	A	6	6	12	0	0	12	0	0
2	160673526	rs2059696	A	G	8	7	15	0	0	15	0	0
2	160698826	rs6721024	C	T	4	5	9	0	0	9	0	0
2	160710922	rs2729705	T	C	4	7	11	0	0	11	0	0
2	160711045	rs3951216	G	C	8	4	12	0	0	12	0	0
2	160759168	rs2292391	G	A	2	5	7	0	0	7	0	0
2	161158738	rs4278892	A	G	1	5	6	0	0	6	0	0
2	161174693	rs1430	C	T	30	20	50	0	0	50	0	0
2	162018643	rs1267059	A	C	7	10	17	0	0	17	0	0
2	162020386	rs28715881	T	C	4	2	6	0	0	6	0	0
2	162087835	rs10183668	G	A	39	41	80	0	0	80	0	0
2	163124051	rs1990760	C	T	13	12	25	0	0	25	0	0
2	163128824	rs3747517	T	C	9	5	14	0	0	14	0	0
2	163210343	rs7587426	C	T	6	9	15	0	0	15	0	0
2	163212331	rs7589119	T	C	2	6	8	0	1	9	0	0
2	163212405	rs7575414	G	T	3	7	10	0	0	10	0	0
2	163213723	rs7608315	A	C	14	14	28	0	0	28	0	0
2	163216109	rs3213843	C	T	10	5	15	0	0	15	0	0
2	163216368	rs73014824	T	G	6	8	14	0	0	14	0	0
2	166605010	rs13429321	A	T	35	33	68	0	1	69	0	0
2	166605927	rs2303394	A	C	3	4	7	0	0	7	0	0
2	166606993	rs11686403	G	T	7	2	9	0	0	9	0	0
2	166614577	rs13431319	T	C	8	12	20	0	0	20	0	0
2	166616667	rs62174820	A	G	13	3	16	0	0	16	0	0
2	166621236	rs6721582	G	A	5	4	9	0	0	9	0	0
2	166622598	rs13430211	C	G	3	5	8	0	0	8	0	0
2	166624469	rs11674422	C	T	4	8	12	0	0	12	0	0
2	166626606	rs4667836	G	A	28	9	37	0	0	37	0	0
2	166666650	rs1863199	G	C	5	9	14	0	0	14	0	0
2	166666793	rs1863198	C	T	2	5	7	0	0	7	0	0
2	166730748	rs77199262	C	T	3	4	7	0	0	7	0	0
2	166747785	rs13404648	A	G	2	4	6	0	0	6	0	0
2	166770120	rs10176588	A	G	3	3	6	0	0	6	0	0
2	166776844	rs6704620	G	C	3	3	6	0	0	6	0	0
2	169094056	.	G	C	5	5	10	0	0	10	0	0
2	169314620	rs4143278	A	G	9	10	19	0	0	19	0	0
2	169351496	rs78502254	C	T	5	1	6	0	0	6	0	0
2	169578321	rs62174437	G	A	3	4	7	0	0	7	0	0
2	169627271	rs16855819	A	G	22	20	42	0	0	42	0	0
2	169630483	rs1063729	G	A	44	42	86	0	0	86	0	0
2	169630835	rs8304	G	T	62	49	111	0	0	111	0	0
2	170483749	rs12986448	C	T	6	0	6	0	0	6	0	0
2	170497421	rs11552896	G	A	9	21	30	0	0	30	0	0
2	170535962	rs9751461	G	T	1	7	8	0	0	8	0	0
2	170544469	rs13002460	C	T	27	15	42	0	0	42	0	0
2	170545000	rs13008569	A	C	26	14	40	0	0	40	0	0
2	170592709	rs2288331	A	G	1	8	9	0	0	9	0	0
2	170608152	rs1045375	A	G	3	6	9	0	0	9	0	0
2	170608220	rs11675616	A	G	1	6	7	0	0	7	0	0
2	170665108	rs2556352	G	A	11	29	40	0	0	40	0	0
2	170801509	rs185044136	G	C	2	6	8	0	0	8	0	0
2	172340215	.	A	G	10	9	19	0	0	19	0	0
2	172374000	rs6433295	T	G	0	25	25	0	2	27	0	0
2	172374078	rs6433296	C	G	11	0	11	0	1	12	0	0
2	172407755	rs12999785	A	G	10	10	20	0	0	20	0	0
2	172411273	rs10455	G	A	27	40	67	0	0	67	0	0
2	172411644	rs1060248	C	T	8	14	22	0	0	22	0	0
2	172411737	rs950163	C	A	8	6	14	0	0	14	0	0
2	172413018	rs2542939	A	G	9	12	21	0	1	22	0	0
2	172414102	rs72884394	G	A	1	11	12	0	0	12	0	0
2	172641660	rs13035825	C	T	9	8	17	0	0	17	0	0
2	172779877	rs62182435	C	A	7	7	14	0	0	14	0	0
2	172780132	rs10202823	T	C	9	9	18	0	0	18	0	0
2	172850488	rs12987929	A	G	2	5	7	0	0	7	0	0
2	172929205	rs788162	A	G	4	3	7	0	0	7	0	0
2	173188228	rs4507062	A	G	1	7	8	0	0	8	0	0
2	173188230	rs4271740	T	C	1	6	7	0	1	8	0	0
2	173339808	rs11895564	G	A	12	7	19	0	0	19	0	0
2	173352103	rs2293649	C	T	5	12	17	0	0	17	0	0
2	173353318	rs1344272	G	A	6	0	6	0	0	6	0	0
2	173354957	rs7609465	C	T	5	1	6	0	0	6	0	0
2	173369231	rs17664	A	G	18	19	37	0	2	39	0	0
2	173479345	rs75545866	G	C	14	10	24	0	0	24	0	0
2	173958482	rs538316116	T	C	1	10	11	0	0	11	0	0
2	174005328	.	T	C	27	14	41	0	1	42	0	0
2	174055646	rs35853276	T	C	23	31	54	0	1	55	0	0
2	174075341	rs79923447	A	G	4	11	15	0	0	15	0	0
2	174075446	rs79195395	C	T	6	7	13	0	0	13	0	0
2	174076273	rs4972536	T	C	26	19	45	0	0	45	0	0
2	174076457	rs10185321	A	G	16	15	31	0	0	31	0	0
2	174077015	rs12693019	G	A	3	6	9	0	0	9	0	0
2	174078413	rs6717067	G	A	8	12	20	0	1	21	0	0
2	174086672	rs11249	G	A	4	2	6	0	0	6	0	0
2	174088514	.	C	A	13	9	22	0	0	22	0	0
2	174091088	rs11887008	T	C	11	7	18	0	0	18	0	0
2	174091200	rs4972399	A	G	23	14	37	0	0	37	0	0
2	174097106	rs16861406	A	G	9	3	12	0	0	12	0	0
2	174104211	.	G	A	2	5	7	0	0	7	0	0
2	174128595	rs16861466	T	C	5	4	9	0	2	11	0	0
2	174131525	rs111588144	A	G	3	6	9	0	0	9	0	0
2	174228744	rs1529887	T	C	10	16	26	0	0	26	0	0
2	174229122	rs11078	G	A	8	7	15	0	0	15	0	0
2	174229226	rs2288995	C	T	8	7	15	0	0	15	0	0
2	174232845	rs10193202	T	C	91	59	150	0	0	150	0	0
2	174233041	rs1047885	A	G	138	93	231	0	1	232	0	0
2	174775687	rs62172767	A	G	1	10	11	0	0	11	0	0
2	174820750	rs1047640	T	C	225	251	476	0	6	482	0	0
2	174939984	.	G	A	114	249	363	0	73	437	1	0
2	174939985	.	G	T	320	100	420	0	29	452	3	0
2	174944105	rs16862333	C	T	4	2	6	0	0	6	0	0
2	174946760	rs11558990	T	C	296	254	550	0	5	555	0	0
2	174965611	rs75107833	A	G	5	8	13	0	0	13	0	0
2	175213041	rs3192048	T	C	28	26	54	0	0	54	0	0
2	175217236	rs4972649	A	G	3	9	12	0	0	12	0	0
2	175218333	rs12162360	T	C	5	3	8	0	0	8	0	0
2	175218368	rs12162327	G	C	5	4	9	0	0	9	0	0
2	175218473	rs4972437	C	T	4	4	8	0	0	8	0	0
2	175223701	rs141661031	C	T	1	5	6	0	0	6	0	0
2	175230862	rs7606312	G	A	6	6	12	0	0	12	0	0
2	175289314	rs17255817	T	C	3	4	7	0	0	7	0	0
2	175436940	rs4972450	G	A	182	164	346	0	3	350	1	0
2	175469786	rs72914542	C	T	2	4	6	0	0	6	0	0
2	175487267	rs7590328	C	A	3	3	6	0	0	6	0	0
2	175491116	rs2033314	T	C	7	2	9	0	0	9	0	0
2	175491199	.	A	G	4	2	6	0	1	7	0	0
2	175494056	rs28485554	C	T	2	4	6	0	0	6	0	0
2	175494057	rs28458405	A	T	2	4	6	0	0	6	0	0
2	175495311	rs1991600	C	T	13	2	15	0	0	15	0	0
2	175496835	rs1864453	T	C	6	5	11	0	0	11	0	0
2	175498386	rs6707162	G	T	3	4	7	0	0	7	0	0
2	175498390	rs6735680	A	C	3	4	7	0	0	7	0	0
2	175584977	rs200267384	T	C	869	0	869	0	5	874	0	0
2	175585095	.	T	A	3944	1	3945	0	115	4060	0	0
2	175943281	rs212352	T	C	4	2	6	0	0	6	0	0
2	178126127	rs56718550	C	T	4	2	6	0	0	6	0	0
2	178127040	rs34551701	A	C	6	4	10	0	0	10	0	0
2	178128003	rs7564947	T	C	5	7	12	0	0	12	0	0
2	178128693	rs17524059	A	C	8	2	10	0	0	10	0	0
2	178130071	rs6706649	C	T	48	48	96	0	2	98	0	0
2	178148470	rs6745756	A	T	6	14	20	0	1	21	0	0
2	178152463	rs56951837	G	C	6	1	7	0	0	7	0	0
2	178196885	rs10179975	G	A	6	0	6	0	0	6	0	0
2	178303897	rs76096651	G	C	3	3	6	0	0	6	0	0
2	178306584	rs952746	A	G	2	6	8	0	0	8	0	0
2	178329935	rs9789580	C	T	14	27	41	0	0	41	0	0
2	178330173	rs9789582	C	G	5	1	6	0	0	6	0	0
2	178330604	rs2084967	T	C	4	3	7	0	0	7	0	0
2	178331206	rs2084233	G	A	3	4	7	0	0	7	0	0
2	178406481	rs8941	C	T	21	22	43	0	0	43	0	0
2	178407176	rs10803912	C	A	12	22	34	0	0	34	0	0
2	178407897	rs2293475	T	C	25	41	66	0	0	66	0	0
2	178417142	rs11694988	C	T	5	2	7	0	0	7	0	0
2	178417225	rs11695035	C	T	4	2	6	0	0	6	0	0
2	179296511	.	C	T	460	1	461	0	4	465	0	0
2	179296624	rs141995027	C	T	384	0	384	0	4	388	0	0
2	179296626	rs3997878	G	A	370	0	370	0	4	374	0	0
2	179296666	.	T	C	312	0	312	0	2	314	0	0
2	179296821	.	G	A	466	0	466	0	0	466	0	0
2	179300971	.	G	A	439	0	439	0	3	442	0	0
2	179300979	.	A	T	438	0	438	0	0	438	0	0
2	179311360	rs72953355	G	C	5	4	9	0	0	9	0	0
2	181895471	rs2887186	A	G	6	1	7	0	0	7	0	0
2	181897956	rs149195105	C	G	80	59	139	0	0	139	0	0
2	181898087	rs6713336	T	C	96	37	133	0	1	134	0	0
2	181898115	rs12620004	T	C	99	38	137	0	1	138	0	0
2	181899325	rs10930948	G	A	26	14	40	0	0	40	0	0
2	181918756	rs7603027	T	C	3	5	8	0	0	8	0	0
2	181918896	rs7562697	A	G	5	4	9	0	0	9	0	0
2	181919490	rs10171998	G	C	8	6	14	0	1	15	0	0
2	181920222	rs10432490	T	C	5	3	8	0	0	8	0	0
2	181920446	.	G	A	5	5	10	0	0	10	0	0
2	181921723	rs10930951	G	C	10	6	16	0	0	16	0	0
2	181921999	rs7371639	A	G	13	7	20	0	0	20	0	0
2	182322220	rs113276800	C	A	72	56	128	0	3	131	0	0
2	182323665	rs12988934	C	T	49	94	143	0	0	143	0	0
2	182323766	rs1375493	G	A	43	105	148	0	2	150	0	0
2	182325296	rs73974899	G	A	5	2	7	0	0	7	0	0
2	182336884	rs3770126	A	G	6	1	7	0	0	7	0	0
2	182345389	rs155096	A	G	5	7	12	0	0	12	0	0
2	182350743	rs155103	A	G	12	19	31	0	0	31	0	0
2	182351172	rs79965377	T	G	9	15	24	0	0	24	0	0
2	182351312	rs155105	C	A	10	7	17	0	2	19	0	0
2	182351780	rs155107	A	G	1	5	6	0	0	6	0	0
2	182352469	rs3770120	A	G	9	8	17	0	0	17	0	0
2	182360182	rs2305586	T	C	7	6	13	0	0	13	0	0
2	182373363	rs4368293	T	C	5	4	9	0	0	9	0	0
2	182373880	.	A	T	13	1	14	0	2	16	0	0
2	182374534	rs1143674	A	G	103	73	176	0	1	177	0	0
2	182375795	rs17304344	C	T	1	6	7	0	0	7	0	0
2	182375834	rs1037624	T	C	0	7	7	0	0	7	0	0
2	182379723	rs12469449	T	C	1	7	8	0	0	8	0	0
2	182381307	rs2887191	C	T	4	2	6	0	0	6	0	0
2	182392143	rs56095368	G	C	7	10	17	0	0	17	0	0
2	182393068	rs6757312	A	G	10	10	20	0	0	20	0	0
2	182393109	rs6728886	C	T	7	4	11	0	0	11	0	0
2	182393759	rs3770105	C	T	10	3	13	0	0	13	0	0
2	182394145	rs3770104	C	T	10	10	20	0	0	20	0	0
2	182394954	rs6707704	A	G	3	4	7	0	0	7	0	0
2	182395345	rs1143676	G	A	169	116	285	0	3	288	0	0
2	182396032	rs6433921	T	G	11	17	28	0	0	28	0	0
2	182396054	rs6433922	C	T	11	13	24	0	0	24	0	0
2	182399097	rs7562325	T	C	224	172	396	0	1	397	0	0
2	182401752	rs1047307	G	A	278	213	491	0	7	498	0	0
2	182402790	rs6747500	G	A	20	24	44	0	0	44	0	0
2	182766083	rs13027534	A	G	17	21	38	0	0	38	0	0
2	182789266	rs116367004	T	C	8	4	12	0	0	12	0	0
2	182792965	rs34728960	G	A	185	163	348	0	0	348	0	0
2	182794534	rs1051085	G	A	55	47	102	0	0	102	0	0
2	183584755	rs6729801	G	A	29	17	46	0	1	47	0	0
2	183593697	rs288280	C	T	35	29	64	0	0	64	0	0
2	183622547	rs288334	T	G	53	47	100	0	0	100	0	0
2	183627504	rs192618	A	G	68	60	128	0	1	129	0	0
2	183642628	rs288283	C	T	36	27	63	0	0	63	0	0
2	183642878	rs13509	G	A	3	8	11	0	1	12	0	0
2	183643889	rs3738945	T	C	5	1	6	0	0	6	0	0
2	183643905	rs288241	A	T	5	1	6	0	0	6	0	0
2	183644191	rs288240	T	C	5	3	8	0	0	8	0	0
2	185463185	rs359895	T	A	10	14	24	0	0	24	0	0
2	185474789	rs72897737	A	G	3	3	6	0	0	6	0	0
2	185478566	rs148516959	C	T	3	7	10	0	0	10	0	0
2	185497170	rs72897758	C	T	2	7	9	0	0	9	0	0
2	185497226	rs359891	A	G	7	8	15	0	0	15	0	0
2	185499138	rs72625293	T	C	11	8	19	0	0	19	0	0
2	185499482	rs62176172	C	T	7	4	11	0	1	12	0	0
2	185499540	rs62176173	G	T	7	5	12	0	0	12	0	0
2	185803364	rs3731834	C	G	4	3	7	0	0	7	0	0
2	187361357	rs76904816	C	T	4	2	6	0	0	6	0	0
2	187362158	rs6741184	C	A	3	5	8	0	0	8	0	0
2	187363033	rs6434183	G	A	7	1	8	0	0	8	0	0
2	187363779	rs4666705	G	A	7	7	14	0	0	14	0	0
2	187366502	rs13017038	G	A	6	2	8	0	0	8	0	0
2	187367534	rs3768776	T	C	16	8	24	0	0	24	0	0
2	187367752	rs2119861	G	A	4	5	9	0	1	10	0	0
2	187368072	rs7586276	A	C	23	13	36	0	1	37	0	0
2	187368194	rs1470230	T	C	21	22	43	0	0	43	0	0
2	187369832	rs988110	T	C	9	10	19	0	0	19	0	0
2	187455278	rs9333287	C	T	4	7	11	0	0	11	0	0
2	187456121	rs3768777	A	G	6	4	10	0	0	10	0	0
2	187492742	rs10174098	G	A	5	2	7	0	0	7	0	0
2	187493841	rs2197138	A	G	3	4	7	0	0	7	0	0
2	187543374	rs1839123	C	T	12	7	19	0	0	19	0	0
2	187626338	rs13026081	C	T	1	8	9	0	0	9	0	0
2	190339632	rs72916214	T	C	4	2	6	0	0	6	0	0
2	191513070	.	C	A	3	4	7	0	0	7	0	0
2	191745569	rs115938555	G	A	13	16	29	0	1	30	0	0
2	191824627	rs115973189	A	G	2	4	6	0	0	6	0	0
2	191829329	.	A	C	3	3	6	0	0	6	0	0
2	191918987	rs541469063	G	A	4	2	6	0	0	6	0	0
2	191996518	rs1551443	T	C	1	11	12	0	0	12	0	0
2	192015072	rs7572482	A	G	3	8	11	0	0	11	0	0
2	192250726	rs13018796	G	A	4	2	6	0	0	6	0	0
2	192279327	rs2271767	T	C	9	22	31	0	0	31	0	0
2	192699699	rs12477095	G	A	3	4	7	0	0	7	0	0
2	192700398	rs11681727	A	C	27	29	56	0	0	56	0	0
2	192711385	rs35883486	G	A	35	35	70	0	0	70	0	0
2	196536505	rs1866452	A	G	9	2	11	0	0	11	0	0
2	196536677	rs2375524	G	A	3	7	10	0	0	10	0	0
2	196998971	rs72919164	C	T	311	278	589	0	1	590	0	0
2	196999139	rs6745041	C	T	299	306	605	0	4	609	0	0
2	196999237	rs6760432	T	C	234	215	449	0	9	458	0	0
2	196999310	rs6760556	T	A	220	211	431	0	8	439	0	0
2	196999649	rs12467988	C	T	80	67	147	0	0	147	0	0
2	197000455	rs7559080	T	C	190	181	371	0	0	371	0	0
2	197000907	rs7581626	G	A	315	345	660	0	3	663	0	0
2	197001673	rs4850664	T	C	184	182	366	0	2	368	0	0
2	197002663	rs11676514	C	T	7	3	10	0	0	10	0	0
2	197002818	rs4850665	C	T	10	10	20	0	0	20	0	0
2	197003588	rs6755713	T	A	11	13	24	0	0	24	0	0
2	197003784	rs6743693	G	A	9	5	14	0	2	16	0	0
2	197004439	rs1054537	A	G	1092	1340	2432	0	18	2450	0	0
2	197005195	rs7557842	T	G	11	5	16	0	0	16	0	0
2	197005446	rs78252231	G	A	5	4	9	0	0	9	0	0
2	197005544	rs4447619	C	T	6	5	11	0	0	11	0	0
2	197006869	rs10207644	A	G	26	8	34	0	0	34	0	0
2	197007029	rs10184485	G	C	20	6	26	0	0	26	0	0
2	197007059	rs7422042	A	G	20	6	26	0	0	26	0	0
2	197007326	rs4563244	T	C	8	1	9	0	0	9	0	0
2	197008529	rs1568368	C	T	3	3	6	0	0	6	0	0
2	197008921	rs117866441	A	T	9	1	10	0	0	10	0	0
2	197009043	rs10191029	C	T	5	8	13	0	0	13	0	0
2	197010021	rs6726084	T	C	1	5	6	0	0	6	0	0
2	197010823	rs2271888	C	T	11	8	19	0	0	19	0	0
2	197010962	rs7599244	G	A	23	6	29	0	0	29	0	0
2	197011693	rs10182983	C	T	10	2	12	0	0	12	0	0
2	197011835	rs10206645	A	G	10	2	12	0	0	12	0	0
2	197012314	rs13026507	A	T	17	5	22	0	0	22	0	0
2	197012460	rs72919185	A	T	6	3	9	0	0	9	0	0
2	197012673	rs138097368	C	T	8	1	9	0	0	9	0	0
2	197012752	rs10931724	G	A	5	3	8	0	0	8	0	0
2	197014022	rs113402691	G	A	5	6	11	0	0	11	0	0
2	197014224	rs1996619	T	C	9	6	15	0	0	15	0	0
2	197014692	rs10804069	G	A	7	6	13	0	0	13	0	0
2	197015141	.	A	C	7	6	13	0	0	13	0	0
2	197016251	rs4850384	A	G	5	1	6	0	0	6	0	0
2	197017123	rs4850668	C	G	3	8	11	0	0	11	0	0
2	197018278	rs11890540	A	G	9	5	14	0	0	14	0	0
2	197018402	rs7586917	T	C	15	6	21	0	0	21	0	0
2	197018914	rs13025305	C	T	3	4	7	0	0	7	0	0
2	197019260	rs4850669	G	A	12	1	13	0	0	13	0	0
2	197019353	rs13025968	A	C	9	4	13	0	0	13	0	0
2	197019412	rs13026714	G	A	16	4	20	0	0	20	0	0
2	197020639	rs3792232	T	C	5	4	9	0	0	9	0	0
2	197021086	rs6712631	C	T	26	8	34	0	0	34	0	0
2	197021141	rs6712829	G	A	17	6	23	0	0	23	0	0
2	197021276	rs10931726	T	C	950	955	1905	0	9	1914	0	0
2	197021372	rs12478353	T	A	840	837	1677	0	8	1685	0	0
2	197024466	rs6753808	A	G	2	4	6	0	0	6	0	0
2	197026716	rs1519600	T	C	6	6	12	0	0	12	0	0
2	197026769	rs1519601	A	G	3	7	10	0	0	10	0	0
2	197027405	rs4850674	T	C	6	3	9	0	0	9	0	0
2	197027792	rs1519602	T	G	6	2	8	0	0	8	0	0
2	197029090	rs12693786	T	C	3	3	6	0	1	7	0	0
2	197035827	rs1401723	C	T	35	34	69	0	0	69	0	0
2	197035846	rs872734	G	A	36	33	69	0	1	70	0	0
2	197853567	rs2256931	A	G	6	7	13	0	0	13	0	0
2	197954717	rs35539834	G	A	4	3	7	0	0	7	0	0
2	198001319	rs3731569	A	G	7	8	15	0	0	15	0	0
2	198115078	rs116157006	C	G	12	1	13	0	0	13	0	0
2	198116017	rs62279243	A	T	9	4	13	0	0	13	0	0
2	198257795	rs4685	T	C	866	991	1857	0	11	1869	1	0
2	198258388	rs3115366	G	A	5	6	11	0	0	11	0	0
2	198260098	rs2564389	A	T	9	11	20	0	0	20	0	0
2	198265173	rs788017	T	A	16	15	31	0	0	31	0	0
2	198265350	rs12621129	T	C	7	13	20	0	0	20	0	0
2	198265526	rs788018	A	G	697	702	1399	0	12	1412	1	0
2	198283305	rs788023	T	C	463	462	925	0	6	931	0	0
2	198352293	rs788016	G	A	6	2	8	0	0	8	0	0
2	198354414	rs2565163	T	C	11	7	18	0	0	18	0	0
2	198356065	rs2564384	T	C	8	9	17	0	1	18	0	0
2	198356496	.	C	T	3	8	11	0	0	11	0	0
2	198362018	rs8539	T	C	320	336	656	0	18	674	0	0
2	198365043	rs1116734	C	G	2	6	8	0	0	8	0	0
2	200669520	rs4519507	T	C	8	6	14	0	0	14	0	0
2	200776353	rs62178345	T	G	9	6	15	0	0	15	0	0
2	200793784	rs16832051	T	C	4	12	16	0	0	16	0	0
2	200794445	rs13389195	T	C	6	2	8	0	0	8	0	0
2	200795571	rs6435036	A	G	6	7	13	0	0	13	0	0
2	200809493	rs16832086	G	A	4	4	8	0	0	8	0	0
2	200823523	rs76225625	C	T	3	3	6	0	0	6	0	0
2	200838410	rs62180490	C	T	3	3	6	0	0	6	0	0
2	200844834	rs7608757	T	G	5	2	7	0	0	7	0	0
2	201354244	rs17630981	G	A	36	37	73	0	0	73	0	0
2	201354676	rs16833578	A	G	40	42	82	0	1	83	0	0
2	201354935	rs3795969	C	G	34	34	68	0	0	68	0	0
2	201355106	rs13018579	G	A	28	17	45	0	0	45	0	0
2	201358423	rs11884301	C	T	4	2	6	0	0	6	0	0
2	201371768	rs3739116	G	T	13	12	25	0	0	25	0	0
2	201437328	rs35987478	C	A	8	7	15	0	0	15	0	0
2	201437334	rs12052989	T	C	7	7	14	0	0	14	0	0
2	201675353	rs3754937	G	C	4	3	7	0	0	7	0	0
2	201676441	rs2270282	G	A	15	3	18	0	0	18	0	0
2	201690994	rs17467616	A	T	35	28	63	0	0	63	0	0
2	201721134	rs13405189	G	A	14	20	34	0	0	34	0	0
2	201721876	.	A	G	57	55	112	0	1	113	0	0
2	201724360	rs12465952	A	G	37	56	93	0	1	94	0	0
2	201728141	rs6757272	A	G	14	17	31	0	2	33	0	0
2	202025621	rs1594	A	G	17	21	38	0	1	39	0	0
2	202029160	rs2881929	G	T	17	6	23	0	0	23	0	0
2	202029711	rs13035714	G	A	15	9	24	0	0	24	0	0
2	202029803	rs11545280	A	G	8	6	14	0	0	14	0	0
2	202031204	rs9277311	G	A	10	8	18	0	1	19	0	0
2	202031516	rs13033140	T	C	12	9	21	0	2	23	0	0
2	202032171	rs11899871	A	G	13	12	25	0	0	25	0	0
2	202032184	rs13013222	A	G	10	11	21	0	0	21	0	0
2	202032427	rs10200857	A	G	14	16	30	0	0	30	0	0
2	202033322	rs76410935	T	C	7	12	19	0	0	19	0	0
2	202035064	rs13034255	G	A	9	6	15	0	0	15	0	0
2	202036292	rs1071678	G	C	19	23	42	0	0	42	0	0
2	202050677	rs3900115	A	G	12	10	22	0	0	22	0	0
2	202082459	rs13006529	T	A	20	25	45	0	0	45	0	0
2	202106032	rs6704688	C	T	3	12	15	0	0	15	0	0
2	202143032	rs8179786	C	T	19	6	25	0	0	25	0	0
2	202143257	rs13027605	T	A	15	5	20	0	0	20	0	0
2	202143928	rs10931936	T	C	20	15	35	0	0	35	0	0
2	202145606	rs11681399	A	G	29	10	39	0	0	39	0	0
2	202145612	rs10804111	C	T	29	10	39	0	0	39	0	0
2	202151163	rs3769818	A	G	6	9	15	0	0	15	0	0
2	202151400	rs17860428	G	A	286	124	410	0	3	413	0	0
2	202151439	rs3185378	G	C	157	256	413	0	2	415	0	0
2	202152162	rs13113	T	A	59	96	155	0	1	156	0	0
2	202245244	rs3795966	A	G	15	4	19	0	0	19	0	0
2	202252478	rs35620793	A	G	8	14	22	0	0	22	0	0
2	202252539	rs2244438	G	A	7	16	23	0	0	23	0	0
2	202264156	rs13022344	C	T	12	10	22	0	0	22	0	0
2	202337730	rs1019299	A	G	71	89	160	0	1	161	0	0
2	202342402	rs12990557	G	T	68	103	171	0	0	171	0	0
2	202507353	rs2241133	G	C	6	7	13	0	0	13	0	0
2	202566411	rs3219172	T	C	48	32	80	0	0	80	0	0
2	202598113	rs2276615	C	T	18	26	44	0	1	45	0	0
2	202625402	rs116568613	A	C	34	21	55	0	1	56	0	0
2	202626437	rs3219154	T	C	50	56	106	0	4	110	0	0
2	202901235	rs13034206	C	T	49	46	95	0	3	98	0	0
2	202901279	rs13034579	G	T	52	39	91	0	4	95	0	0
2	203086871	rs6742786	G	A	3	4	7	0	0	7	0	0
2	203089268	rs7599810	G	A	0	6	6	0	0	6	0	0
2	203631359	rs11680951	G	A	4	2	6	0	0	6	0	0
2	203631445	rs60626957	T	C	9	4	13	0	0	13	0	0
2	203632067	rs6712108	T	G	5	3	8	0	0	8	0	0
2	203632510	rs11544338	T	C	8	5	13	0	0	13	0	0
2	203740270	rs146973310	A	C	5	1	6	0	1	7	0	0
2	203740861	rs72934738	T	C	5	1	6	0	0	6	0	0
2	203740938	rs79539678	G	C	3	3	6	0	0	6	0	0
2	203744445	rs115953525	G	A	4	4	8	0	0	8	0	0
2	203744454	rs72934745	C	T	5	3	8	0	0	8	0	0
2	203744610	rs148513392	G	A	6	6	12	0	0	12	0	0
2	203747522	rs72934751	A	G	3	7	10	0	0	10	0	0
2	203749439	rs6738618	T	C	8	4	12	0	0	12	0	0
2	203756677	rs72934762	G	A	5	3	8	0	0	8	0	0
2	203765756	rs35212307	T	C	22	16	38	0	0	38	0	0
2	203811902	rs116773016	A	T	4	2	6	0	0	6	0	0
2	203811912	rs114604411	A	C	4	2	6	0	0	6	0	0
2	203848402	rs72932561	G	A	3	3	6	0	0	6	0	0
2	204055528	.	A	T	135	0	135	0	7	142	0	0
2	204055698	.	A	G	124	0	124	0	6	130	0	0
2	204085635	rs12693982	C	T	1	6	7	0	0	7	0	0
2	204154552	rs1048013	C	T	34	45	79	0	0	79	0	0
2	204257926	rs55692341	C	T	1	5	6	0	0	6	0	0
2	204292517	rs2469954	T	C	2	7	9	0	0	9	0	0
2	204294412	rs2254175	A	G	5	5	10	0	0	10	0	0
2	206862015	rs10192718	G	A	25	11	36	0	0	36	0	0
2	206863874	rs818026	C	T	32	23	55	0	0	55	0	0
2	206864764	rs818025	C	T	14	7	21	0	0	21	0	0
2	206865246	rs115189804	A	G	20	21	41	0	1	42	0	0
2	206866780	rs4675582	C	T	12	13	25	0	0	25	0	0
2	206867762	rs17309042	A	G	6	9	15	0	2	17	0	0
2	206868722	rs1062344	C	T	8	9	17	0	0	17	0	0
2	206890848	rs13003004	C	T	6	4	10	0	0	10	0	0
2	206892406	rs2199570	C	T	4	11	15	0	0	15	0	0
2	206921451	rs818009	G	A	24	25	49	0	0	49	0	0
2	206979680	rs10479	C	T	5	2	7	0	0	7	0	0
2	207006676	rs1801318	T	C	82	65	147	0	1	148	0	0
2	207026491	rs3755228	C	T	0	7	7	0	0	7	0	0
2	207941850	rs1263599	C	T	11	16	27	0	0	27	0	0
2	207942862	rs13035688	T	A	14	4	18	0	0	18	0	0
2	207942894	rs6725221	C	G	15	4	19	0	1	20	0	0
2	207944358	rs79159981	G	A	15	16	31	0	0	31	0	0
2	207981781	rs1263623	T	C	5	2	7	0	0	7	0	0
2	207983805	rs10170608	A	G	4	5	9	0	0	9	0	0
2	207985071	rs2254807	T	G	7	2	9	0	0	9	0	0
2	207985464	rs2284935	C	A	12	9	21	0	0	21	0	0
2	207986109	rs2254694	C	T	9	7	16	0	0	16	0	0
2	207986297	rs2269077	C	T	12	7	19	0	0	19	0	0
2	207986713	rs2543596	C	T	17	13	30	0	0	30	0	0
2	207986933	rs10204517	G	A	6	8	14	0	0	14	0	0
2	207987403	rs2254502	C	T	11	7	18	0	0	18	0	0
2	208010353	rs3791995	C	G	2	9	11	0	0	11	0	0
2	208012509	rs2284932	G	A	6	7	13	0	0	13	0	0
2	208013555	rs12466923	C	A	9	23	32	0	0	32	0	0
2	208031471	rs57314858	C	T	6	1	7	0	0	7	0	0
2	208031796	rs2037893	C	G	6	8	14	0	0	14	0	0
2	208465546	rs114892556	A	G	8	12	20	0	0	20	0	0
2	209108317	rs34218846	C	T	23	25	48	0	0	48	0	0
2	209108718	rs11685614	G	A	4	2	6	0	0	6	0	0
2	209108758	rs10202116	T	C	4	2	6	0	0	6	0	0
2	209113192	rs11554137	G	A	11	17	28	0	0	28	0	0
2	209170416	rs41311599	T	C	3	4	7	0	0	7	0	0
2	209190632	rs999890	T	G	20	20	40	0	0	40	0	0
2	209190649	rs999891	A	G	20	15	35	0	0	35	0	0
2	209193497	rs67965883	G	A	5	3	8	0	0	8	0	0
2	209194979	rs1866046	A	G	3	6	9	0	1	10	0	0
2	209198000	rs11885913	C	T	7	2	9	0	0	9	0	0
2	209212707	rs2304545	G	A	73	54	127	0	3	130	0	0
2	209218189	rs10177810	A	G	1	5	6	0	0	6	0	0
2	209221291	rs6725527	T	G	94	106	200	0	1	201	0	0
2	209222202	rs11538998	C	T	117	114	231	0	2	233	0	0
2	210885022	rs7585265	C	T	13	14	27	0	0	27	0	0
2	211296188	rs76305970	G	A	32	32	64	0	0	64	0	0
2	211341349	rs10932334	C	T	2	5	7	0	0	7	0	0
2	213866353	rs12996008	A	G	7	6	13	0	1	14	0	0
2	213866803	rs73087329	T	C	11	5	16	0	1	17	0	0
2	213868435	rs72944379	A	G	10	11	21	0	0	21	0	0
2	213869354	rs17277107	C	T	14	12	26	0	0	26	0	0
2	213870535	rs72944382	C	T	8	20	28	0	0	28	0	0
2	213870678	rs7607184	T	C	8	0	8	0	0	8	0	0
2	213870875	rs12622131	T	C	10	10	20	0	0	20	0	0
2	213870894	rs7593379	C	T	11	9	20	0	0	20	0	0
2	213870965	rs72944387	C	T	7	13	20	0	0	20	0	0
2	213895964	rs11888736	G	C	1	7	8	0	0	8	0	0
2	214012508	rs6709554	C	T	22	25	47	0	4	51	0	0
2	214016984	rs62189579	T	A	2	5	7	0	0	7	0	0
2	214017117	rs10209675	G	A	4	5	9	0	0	9	0	0
2	214017736	rs3754590	C	T	1	9	10	0	0	10	0	0
2	214018126	rs1922792	G	A	8	2	10	0	1	11	0	0
2	215590609	rs1048171	G	C	13	4	17	0	0	17	0	0
2	215602900	rs10932566	C	A	10	5	15	0	0	15	0	0
2	215645464	rs2229571	C	G	20	25	45	0	1	46	0	0
2	215645545	rs2070096	C	G	19	17	36	0	0	36	0	0
2	215674224	rs1048108	G	A	5	6	11	0	0	11	0	0
2	215674323	rs1129804	C	G	6	3	9	0	0	9	0	0
2	215674341	rs17489363	A	G	5	4	9	0	0	9	0	0
2	215674371	rs34732883	C	T	5	2	7	0	0	7	0	0
2	216176807	rs4535042	T	G	3	7	10	0	0	10	0	0
2	216190020	rs2372536	C	G	51	79	130	0	2	132	0	0
2	216212339	rs4673993	T	C	8	7	15	0	0	15	0	0
2	217315664	rs2066526	C	T	10	14	24	0	0	24	0	0
2	217364539	rs284572	C	T	20	19	39	0	0	39	0	0
2	217366995	rs3108223	G	A	112	87	199	0	0	199	0	0
2	217528951	rs6413492	T	A	238	184	422	0	8	430	0	0
2	218665745	.	T	A	4	4	8	0	0	8	0	0
2	218682474	rs12694422	A	G	3	6	9	0	0	9	0	0
2	218682771	rs3796026	A	G	4	3	7	0	0	7	0	0
2	218683257	rs2571442	A	G	4	3	7	0	0	7	0	0
2	219115080	rs149752174	T	C	3	3	6	0	0	6	0	0
2	219205954	rs58042983	T	C	13	9	22	0	0	22	0	0
2	219209885	rs73088173	G	C	50	51	101	0	0	101	0	0
2	219210606	rs1052578	T	C	70	73	143	0	4	147	0	0
2	219210781	rs9076	G	A	64	69	133	0	2	135	0	0
2	219252630	rs17221959	C	T	8	4	12	0	0	12	0	0
2	219255423	rs2695343	A	G	3	3	6	0	0	6	0	0
2	219259732	rs17235409	G	A	46	23	69	0	1	70	0	0
2	219265396	rs3795985	C	T	5	3	8	0	0	8	0	0
2	219266423	rs2227251	C	A	144	151	295	0	2	298	1	0
2	219269729	rs3770211	G	T	104	139	243	0	3	246	0	0
2	219316303	rs2178019	G	A	2	4	6	0	0	6	0	0
2	219317248	rs3755042	T	C	11	20	31	0	0	31	0	0
2	219318078	rs4674310	T	C	6	11	17	0	0	17	0	0
2	219318248	rs80085898	C	T	12	5	17	0	2	19	0	0
2	219334636	rs642950	C	T	2	5	7	0	0	7	0	0
2	219335935	rs659185	C	T	12	5	17	0	0	17	0	0
2	219335944	rs10200507	C	A	4	4	8	0	0	8	0	0
2	219336108	rs545779	A	G	2	7	9	0	0	9	0	0
2	219339283	rs549026	T	C	5	2	7	0	0	7	0	0
2	219390967	rs10179708	T	A	12	15	27	0	0	27	0	0
2	219427597	rs593888	A	G	6	12	18	0	0	18	0	0
2	219427625	rs566082	G	A	7	11	18	0	0	18	0	0
2	219428299	rs483172	T	C	4	3	7	0	0	7	0	0
2	219431535	rs1516086	G	A	4	4	8	0	0	8	0	0
2	219432953	rs500317	G	C	24	10	34	0	0	34	0	0
2	219432995	rs500422	C	A	16	8	24	0	0	24	0	0
2	219433597	rs526897	G	A	15	15	30	0	0	30	0	0
2	219457731	rs10190250	C	T	10	10	20	0	1	21	0	0
2	219457741	rs585185	G	A	11	11	22	0	0	22	0	0
2	219458656	rs538483	T	C	6	10	16	0	0	16	0	0
2	219501328	rs1055816	G	A	6	6	12	0	0	12	0	0
2	219508372	rs3770213	A	T	13	11	24	0	0	24	0	0
2	219508988	rs3770214	T	C	13	8	21	0	0	21	0	0
2	219509618	rs2230115	C	A	20	11	31	0	1	32	0	0
2	219513947	rs61733647	C	T	10	15	25	0	0	25	0	0
2	219523433	rs4674324	T	G	16	5	21	0	0	21	0	0
2	219527005	rs2303561	C	T	17	13	30	0	0	30	0	0
2	219555262	rs1344642	G	A	12	7	19	0	0	19	0	0
2	219562675	rs1863704	G	A	6	8	14	0	0	14	0	0
2	219610433	rs586194	A	G	6	8	14	0	0	14	0	0
2	219612282	rs2272188	A	G	4	4	8	0	0	8	0	0
2	219613249	rs6722216	G	A	4	3	7	0	0	7	0	0
2	219618237	rs6436073	A	C	3	4	7	0	0	7	0	0
2	219618708	rs55900247	T	C	4	4	8	0	0	8	0	0
2	219619550	rs3770220	C	T	2	4	6	0	0	6	0	0
2	220043220	.	T	C	4	3	7	0	1	8	0	0
2	220084938	rs10799	C	T	109	103	212	0	1	213	0	0
2	220100553	rs150402081	C	A	25	16	41	0	3	44	0	0
2	220113384	rs8447	G	A	47	43	90	0	2	92	0	0
2	220113728	rs885854	G	A	26	17	43	0	0	43	0	0
2	220371035	rs1046474	C	G	51	67	118	0	1	119	0	0
2	220420172	rs35372421	T	C	7	6	13	0	0	13	0	0
2	220422583	rs145485683	G	A	6	2	8	0	0	8	0	0
2	220473355	rs673951	G	A	41	43	84	0	0	84	0	0
2	223432097	rs16863886	T	C	2	8	10	0	0	10	0	0
2	223511751	rs11695525	T	C	3	4	7	0	0	7	0	0
2	223765491	rs2119160	C	T	13	24	37	0	0	37	0	0
2	223797166	rs146872605	C	T	4	5	9	0	0	9	0	0
2	223797188	rs6722786	A	G	6	4	10	0	0	10	0	0
2	223805495	rs6734103	A	G	8	4	12	0	0	12	0	0
2	224743373	rs571111	C	T	54	42	96	0	1	97	0	0
2	224832136	rs1138616	C	G	210	173	383	0	5	388	0	0
2	224832161	rs1142417	G	A	189	176	365	0	2	367	0	0
2	224832346	rs10980	G	C	79	35	114	0	0	114	0	0
2	225243783	rs72968568	A	G	38	44	82	0	1	83	0	0
2	225244352	rs61732371	G	A	37	56	93	0	0	93	0	0
2	225347270	rs3820763	G	A	4	2	6	0	0	6	0	0
2	225350420	rs2396093	T	C	5	1	6	0	1	7	0	0
2	225365635	rs4674916	C	A	3	3	6	0	0	6	0	0
2	225373666	rs13026411	A	G	4	2	6	0	0	6	0	0
2	225373897	rs7585047	C	T	2	6	8	0	0	8	0	0
2	225377574	rs6748341	C	G	1	6	7	0	0	7	0	0
2	225384862	rs116446684	C	T	3	4	7	0	0	7	0	0
2	225385542	rs6759332	C	T	3	5	8	0	0	8	0	0
2	225630233	rs1045654	C	T	18	37	55	0	0	55	0	0
2	225634693	rs1565073	T	G	3	3	6	0	0	6	0	0
2	225669996	rs4674940	A	G	7	18	25	0	0	25	0	0
2	225670901	rs4674941	G	C	5	13	18	0	0	18	0	0
2	225675763	rs58993949	T	C	39	23	62	0	0	62	0	0
2	225675806	rs56345843	A	C	36	10	46	0	0	46	0	0
2	225675809	rs55818618	C	G	37	7	44	0	0	44	0	0
2	225677087	rs77962839	A	C	24	27	51	0	0	51	0	0
2	225677667	rs7596144	C	T	14	7	21	0	1	22	0	0
2	225727431	rs7589474	T	C	20	19	39	0	1	40	0	0
2	225750861	rs2304336	C	T	8	12	20	0	0	20	0	0
2	228213060	rs12613290	G	A	6	6	12	0	1	13	0	0
2	228222000	.	G	C	208	0	208	0	2	210	0	0
2	228420193	rs4402755	A	T	8	11	19	0	0	19	0	0
2	230630691	rs11696097	G	A	16	14	30	0	1	31	0	0
2	230861519	rs1035834	G	T	3	5	8	0	0	8	0	0
2	231041780	rs10933327	A	G	7	6	13	0	0	13	0	0
2	231041940	rs41543719	G	C	7	2	9	0	0	9	0	0
2	231042276	rs1135791	A	G	32	24	56	0	0	56	0	0
2	231050715	rs3948464	A	G	38	26	64	0	0	64	0	0
2	231077725	rs1129411	A	G	32	18	50	0	1	51	0	0
2	231322125	rs62193413	C	T	1	5	6	0	0	6	0	0
2	231327220	rs75519436	G	A	215	216	431	0	1	432	0	0
2	231328696	rs2306274	C	T	3	4	7	0	0	7	0	0
2	231331694	rs1678159	A	G	9	11	20	0	0	20	0	0
2	231331799	rs1649869	T	C	17	14	31	0	1	32	0	0
2	231331896	rs1050224	G	A	134	165	299	0	3	302	0	0
2	231332317	rs1622283	C	G	8	9	17	0	0	17	0	0
2	231333257	rs12617536	C	T	3	8	11	0	0	11	0	0
2	231333285	rs56136530	T	C	8	3	11	0	0	11	0	0
2	231333416	rs62193415	C	T	6	10	16	0	0	16	0	0
2	231335159	rs7878	A	G	13	17	30	0	0	30	0	0
2	231409760	rs6728689	G	A	43	38	81	0	0	81	0	0
2	231409854	rs1678185	C	T	30	51	81	0	0	81	0	0
2	231410149	rs1649901	G	A	20	20	40	0	0	40	0	0
2	231579273	rs2459925	A	G	4	6	10	0	0	10	0	0
2	231581077	rs55639025	T	C	5	3	8	0	0	8	0	0
2	231586340	rs13411251	T	G	6	3	9	0	0	9	0	0
2	231589603	rs11686413	C	T	7	0	7	0	0	7	0	0
2	231667381	rs28814056	G	C	4	3	7	0	0	7	0	0
2	231668397	rs9752613	G	A	4	5	9	0	0	9	0	0
2	231668814	rs61142155	C	T	2	5	7	0	0	7	0	0
2	231676041	rs10209007	C	G	8	6	14	0	0	14	0	0
2	231678185	rs2244954	A	C	6	2	8	0	0	8	0	0
2	231683849	rs7596575	A	G	85	75	160	0	0	160	0	0
2	231685198	rs726379	A	G	96	100	196	0	1	197	0	0
2	231685205	rs10006	T	C	97	103	200	0	2	202	0	0
2	231733703	rs3111754	T	C	6	3	9	0	0	9	0	0
2	231734799	rs3098331	A	G	4	2	6	0	0	6	0	0
2	231734997	rs3098332	A	G	6	3	9	0	0	9	0	0
2	231735308	rs3111752	T	A	6	1	7	0	0	7	0	0
2	231736107	rs3111751	G	A	6	2	8	0	0	8	0	0
2	231736156	rs3098334	C	T	5	1	6	0	0	6	0	0
2	231736211	rs3098335	T	G	5	1	6	0	0	6	0	0
2	231738038	rs3111750	C	T	10	1	11	0	0	11	0	0
2	231739564	rs1561324	A	G	10	6	16	0	0	16	0	0
2	231742711	rs60237566	T	G	3	5	8	0	0	8	0	0
2	231921660	rs538680730	A	T	8	9	17	0	2	19	0	0
2	232030861	rs2303349	A	G	2	4	6	0	0	6	0	0
2	232034342	rs1025107	C	T	4	5	9	0	0	9	0	0
2	232035429	rs6749	G	A	103	137	240	0	8	248	0	0
2	232035793	rs2032953	C	T	21	10	31	0	2	33	0	0
2	232036396	rs12463656	G	A	8	5	13	0	1	14	0	0
2	232036843	rs12468767	T	G	9	14	23	0	0	23	0	0
20	256727	rs3827147	T	A	43	28	71	0	0	71	0	0
20	256866	rs3827149	G	A	1	7	8	0	0	8	0	0
20	256886	rs3827150	A	G	1	5	6	0	0	6	0	0
20	256992	rs3827151	A	G	3	5	8	0	0	8	0	0
20	257032	rs3827153	A	G	2	5	7	0	1	8	0	0
20	257733	rs2277781	A	G	41	28	69	0	0	69	0	0
20	259969	rs7271033	G	C	30	33	63	0	0	63	0	0
20	277832	rs1997793	C	T	24	24	48	0	1	49	0	0
20	278515	rs2223665	T	C	3	4	7	0	0	7	0	0
20	278806	rs1057189	C	T	110	89	199	0	2	201	0	0
20	279483	rs1046560	T	C	150	115	265	0	2	267	0	0
20	279774	rs1046561	A	C	20	6	26	0	1	27	0	0
20	371972	rs6051637	T	C	15	41	56	0	2	58	0	0
20	377226	rs6115830	C	T	21	64	85	0	1	86	0	0
20	391170	rs7059	C	T	105	82	187	0	2	189	0	0
20	397928	rs6115906	C	T	5	3	8	0	0	8	0	0
20	400872	rs35073025	A	C	6	7	13	0	0	13	0	0
20	401205	rs4635591	A	T	8	9	17	0	0	17	0	0
20	417612	rs6052005	T	C	38	23	61	0	2	63	0	0
20	418199	rs3746793	T	A	55	40	95	0	1	96	0	0
20	419067	rs3746794	C	T	23	33	56	0	0	56	0	0
20	425434	rs2273463	C	T	17	12	29	0	3	32	0	0
20	425606	rs2273465	C	A	31	19	50	0	0	50	0	0
20	442323	rs157800	T	A	12	9	21	0	1	22	0	0
20	462008	rs459012	T	C	77	87	164	0	0	164	0	0
20	463995	rs459710	T	C	154	124	278	0	2	280	0	0
20	478390	.	C	T	147	137	284	0	2	286	0	0
20	628890	rs6053666	T	C	55	19	74	0	0	74	0	0
20	629213	rs3746799	T	C	44	27	71	0	0	71	0	0
20	740833	rs1053018	G	C	2	4	6	0	1	7	0	0
20	740919	rs2295431	G	T	2	4	6	0	0	6	0	0
20	819030	rs516685	G	C	3	4	7	0	1	8	0	0
20	820738	rs41301746	T	C	6	3	9	0	0	9	0	0
20	823436	rs552151	T	C	8	6	14	0	0	14	0	0
20	823648	rs8121246	G	C	9	5	14	0	0	14	0	0
20	823668	rs8117660	T	C	10	6	16	0	0	16	0	0
20	823791	rs6055271	A	T	6	4	10	0	0	10	0	0
20	823792	rs6038939	C	T	5	4	9	0	1	10	0	0
20	824251	rs7262185	C	T	13	7	20	0	1	21	0	0
20	826492	rs2282050	G	C	182	134	316	0	5	321	0	0
20	826513	rs2282051	C	G	132	159	291	0	0	291	0	0
20	826710	rs1045412	C	T	82	115	197	0	3	200	0	0
20	1146136	rs2072965	T	C	26	31	57	0	0	57	0	0
20	1147410	rs3087751	A	C	121	135	256	0	5	261	0	0
20	1148640	rs62186930	A	G	21	18	39	0	0	39	0	0
20	1148783	rs4813044	A	G	7	14	21	0	0	21	0	0
20	1148897	rs1053653	T	C	9	14	23	0	0	23	0	0
20	1350508	rs11712	A	G	488	527	1015	0	25	1040	0	0
20	1350672	rs6041749	T	C	663	601	1264	0	35	1299	0	0
20	1357852	rs1323135	G	T	4	2	6	0	0	6	0	0
20	1423533	rs3210915	A	T	105	95	200	0	0	200	0	0
20	1425078	rs910620	A	G	8	5	13	0	0	13	0	0
20	1428407	rs78022814	T	G	6	2	8	0	0	8	0	0
20	1428408	rs76408530	T	C	6	2	8	0	0	8	0	0
20	1429135	rs6042354	C	T	7	6	13	0	0	13	0	0
20	1430371	rs188851010	C	T	6	5	11	0	0	11	0	0
20	1430392	rs75339623	T	A	4	5	9	0	0	9	0	0
20	1543409	rs2263664	T	G	5	3	8	0	0	8	0	0
20	1559233	rs41275424	C	A	8	4	12	0	0	12	0	0
20	1592215	rs41289057	C	G	56	20	76	0	1	77	0	0
20	1592265	rs45471597	A	G	54	29	83	0	2	85	0	0
20	1592284	rs1135196	G	A	49	26	75	0	1	76	0	0
20	1592312	rs72484087	T	C	41	8	49	0	2	51	0	0
20	1600537	rs144045134	C	T	24	12	36	0	0	36	0	0
20	1911609	rs2267915	G	A	3	3	6	0	0	6	0	0
20	1913737	rs6045511	G	C	2	4	6	0	0	6	0	0
20	1918305	rs2235747	G	A	62	38	100	0	0	100	0	0
20	1918487	rs3197744	G	T	62	66	128	0	2	130	0	0
20	2098424	rs2875736	C	T	5	6	11	0	0	11	0	0
20	2106355	rs6112930	G	A	4	2	6	0	0	6	0	0
20	2116764	rs4814980	G	C	4	3	7	0	0	7	0	0
20	2117365	rs4814982	G	A	5	4	9	0	0	9	0	0
20	2117462	rs4814983	C	T	4	3	7	0	0	7	0	0
20	2121147	rs6137099	C	T	4	4	8	0	0	8	0	0
20	2121192	rs6132337	A	G	3	4	7	0	2	9	0	0
20	2121211	rs6137100	A	G	4	3	7	0	0	7	0	0
20	2121214	rs6137101	T	C	4	3	7	0	0	7	0	0
20	2121228	rs6137102	C	T	5	4	9	0	0	9	0	0
20	2121249	rs6137103	G	A	5	5	10	0	0	10	0	0
20	2125104	rs6047011	A	G	15	22	37	0	0	38	1	0
20	2125553	rs3748512	C	T	16	11	27	0	0	27	0	0
20	2125837	rs2153739	A	G	20	17	37	0	0	37	0	0
20	2126089	rs2153740	A	G	9	18	27	0	0	27	0	0
20	2126096	rs2153741	A	G	11	19	30	0	1	31	0	0
20	2126180	rs2185675	G	C	15	15	30	0	2	32	0	0
20	2126567	rs2153742	T	C	15	20	35	0	0	35	0	0
20	2126584	rs2153743	A	C	13	15	28	0	0	28	0	0
20	2127609	rs6035685	A	G	12	11	23	0	0	23	0	0
20	2127684	rs11087326	C	T	14	13	27	0	0	27	0	0
20	2127930	rs6112998	C	T	27	21	48	0	1	49	0	0
20	2443116	rs6036572	G	A	14	15	29	0	0	29	0	0
20	2443441	rs2143862	G	A	9	10	19	0	0	19	0	0
20	2444744	rs6076161	C	T	20	37	57	0	2	59	0	0
20	2450669	rs6049283	C	A	4	10	14	0	0	14	0	0
20	2450953	rs6049285	G	A	3	4	7	0	0	7	0	0
20	2451451	rs6049288	G	T	10	8	18	0	0	18	0	0
20	2481314	rs6083475	T	G	3	5	8	0	0	8	0	0
20	2633296	rs6138678	G	C	41	29	70	0	0	70	0	0
20	2637071	rs8958	T	C	318	362	680	0	4	684	0	0
20	2638982	rs11553611	C	G	78	87	165	0	2	167	0	0
20	2775872	rs41306788	T	C	6	13	19	0	1	20	0	0
20	2777459	rs1985525	T	C	62	47	109	0	3	112	0	0
20	2777828	rs742707	G	T	8	7	15	0	0	15	0	0
20	2778363	rs215540	C	T	55	45	100	0	0	100	0	0
20	2779747	rs215542	A	G	4	5	9	0	0	9	0	0
20	2872458	rs6138927	T	C	2	6	8	0	0	8	0	0
20	2872860	rs585035	T	C	4	4	8	0	0	8	0	0
20	2873460	rs598147	A	G	2	6	8	0	0	8	0	0
20	2873606	.	T	G	16	42	58	0	0	58	0	0
20	2873629	.	G	C	15	37	52	0	0	52	0	0
20	3088938	rs41281238	G	A	5	7	12	0	0	12	0	0
20	3089969	rs6051581	C	A	4	3	7	0	0	7	0	0
20	3090496	rs111759886	T	C	17	26	43	0	1	44	0	0
20	3090942	rs34205880	A	G	20	15	35	0	0	35	0	0
20	3091110	rs45592236	G	A	5	1	6	0	0	6	0	0
20	3101779	.	C	G	4	4	8	0	1	9	0	0
20	3127579	rs73573808	T	C	166	124	290	0	4	294	0	0
20	3128578	rs41304800	A	C	138	137	275	0	3	278	0	0
20	3131247	rs41304822	C	A	14	27	41	0	0	41	0	0
20	3136511	rs74832142	T	C	16	27	43	0	0	43	0	0
20	3143752	rs3087802	G	A	12	21	33	0	0	33	0	0
20	3193978	rs8362	G	A	179	211	390	0	5	395	0	0
20	3235916	rs2281496	T	C	9	10	19	0	0	19	0	0
20	3275239	rs2281504	G	A	22	17	39	0	1	40	0	0
20	3285140	rs2422864	T	C	10	10	20	0	0	20	0	0
20	3735436	rs2295342	A	G	2	10	12	0	0	12	0	0
20	3843027	rs7262903	C	A	21	32	53	0	0	53	0	0
20	3846397	rs7269320	C	T	13	12	25	0	0	25	0	0
20	3847325	rs3746662	A	C	15	16	31	0	0	31	0	0
20	3889124	rs2282131	A	G	59	53	112	0	0	112	0	0
20	3892886	rs67356712	A	G	1	5	6	0	0	6	0	0
20	3899640	rs241594	G	A	6	7	13	0	0	13	0	0
20	3901024	rs113800135	G	A	6	5	11	0	0	11	0	0
20	3903634	rs11906612	C	T	20	5	25	0	0	25	0	0
20	3910406	rs3746665	T	C	95	92	187	0	1	188	0	0
20	3910861	rs3746666	A	G	69	62	131	0	2	133	0	0
20	3912637	rs397095	G	T	90	78	168	0	0	168	0	0
20	3912638	rs443168	C	G	90	77	167	0	3	170	0	0
20	3914215	rs14047	G	A	73	55	128	0	0	128	0	0
20	3914302	rs17286349	G	A	92	88	180	0	0	180	0	0
20	3915064	rs241605	C	T	11	6	17	0	0	17	0	0
20	3916380	rs73084594	T	G	4	4	8	0	0	8	0	0
20	3918517	rs241616	C	T	1	5	6	0	1	7	0	0
20	3921659	rs241622	G	A	11	0	11	0	0	11	0	0
20	3921715	rs73086508	C	T	2	5	7	0	0	7	0	0
20	3940952	rs17214949	T	C	5	5	10	0	0	10	0	0
20	3942906	rs140990590	G	A	2	4	6	0	0	6	0	0
20	3943380	rs181106124	G	A	4	4	8	0	0	8	0	0
20	3944150	rs73086535	T	C	9	8	17	0	0	17	0	0
20	3970144	rs150383699	A	T	3	4	7	0	0	7	0	0
20	3970173	rs17215340	C	G	5	3	8	0	0	8	0	0
20	3970212	rs6052218	A	G	6	1	7	0	0	7	0	0
20	3970307	rs6052219	A	G	72	61	133	0	0	133	0	0
20	3980276	rs6084542	C	T	1	5	6	0	0	6	0	0
20	4158356	rs1622950	A	G	5	4	9	0	0	9	0	0
20	4158749	rs1741321	C	T	3	6	9	0	0	9	0	0
20	4159022	rs1741322	C	A	3	3	6	0	0	6	0	0
20	4159107	rs1741323	C	T	9	2	11	0	0	11	0	0
20	4159320	rs6052418	T	C	7	3	10	0	1	11	0	0
20	4159394	rs147959746	G	A	6	4	10	0	0	10	0	0
20	4159584	rs1741324	T	C	10	7	17	0	0	17	0	0
20	4159775	rs1765017	T	G	7	5	12	0	0	12	0	0
20	4162700	rs45610331	G	A	86	78	164	0	2	166	0	0
20	4163302	rs1051904	A	G	480	428	908	0	8	916	0	0
20	4163684	rs1337281	C	A	5	3	8	0	0	8	0	0
20	4164283	rs1741327	A	G	462	478	940	0	25	965	0	0
20	4165089	rs4815663	A	G	2	4	6	0	0	6	0	0
20	4166795	rs1310181	T	A	3	5	8	0	0	8	0	0
20	4167833	rs79924807	G	A	5	8	13	0	0	13	0	0
20	4675980	rs6052772	G	A	3	6	9	0	0	9	0	0
20	4677207	rs6116474	T	C	6	4	10	0	0	10	0	0
20	4680251	rs1799990	A	G	250	258	508	0	1	509	0	0
20	4681564	rs76116805	C	T	397	484	881	0	5	886	0	0
20	4762577	rs3746673	C	G	188	194	382	0	4	386	0	0
20	4763093	rs2422977	T	C	162	172	334	0	2	336	0	0
20	4766197	rs2422982	G	A	6	9	15	0	0	15	0	0
20	4768136	rs55900827	T	C	7	9	16	0	0	16	0	0
20	4768503	rs111805756	C	T	27	23	50	0	0	50	0	0
20	4769177	rs6139553	G	C	12	19	31	0	1	32	0	0
20	4769183	rs2422987	G	A	12	19	31	0	1	32	0	0
20	4769374	rs6139554	T	C	10	6	16	0	0	16	0	0
20	4769834	rs3787445	C	A	14	12	26	0	1	27	0	0
20	4773597	rs1998292	T	C	4	6	10	0	1	11	0	0
20	4779774	rs1547618	G	A	4	2	6	0	0	6	0	0
20	4784124	rs113987765	G	C	4	15	19	0	0	19	0	0
20	4802986	rs1885311	G	C	22	36	58	0	0	58	0	0
20	4803494	rs2246735	C	T	5	7	12	0	1	13	0	0
20	4803592	rs2281642	G	T	7	18	25	0	0	25	0	0
20	4803608	rs2326552	C	T	7	19	26	0	0	26	0	0
20	4804131	rs1104902	C	A	5	3	8	0	1	9	0	0
20	4834338	rs1131382	C	T	19	20	39	0	0	39	0	0
20	4834894	rs35560557	G	A	18	29	47	0	0	47	0	0
20	4880308	rs1776964	G	A	5	12	17	0	0	17	0	0
20	4948389	rs1879176	T	C	6	2	8	0	0	8	0	0
20	4948435	rs1879177	C	T	4	2	6	0	0	6	0	0
20	4951534	.	G	T	15	3	18	0	0	18	0	0
20	5081049	rs2715	T	C	150	242	392	0	6	398	0	0
20	5099636	rs25406	G	A	30	24	54	0	1	55	0	0
20	5158729	rs2281557	G	C	4	3	7	0	0	7	0	0
20	5160829	rs1040759	G	A	5	2	7	0	0	7	0	0
20	5161251	rs6053178	G	A	5	1	6	0	0	6	0	0
20	5169877	rs6038087	A	G	29	7	36	0	1	37	0	0
20	5170373	rs41282118	T	G	21	21	42	0	1	43	0	0
20	5172034	rs3746677	C	T	35	25	60	0	1	61	0	0
20	5172751	rs2295510	C	T	38	45	83	0	0	83	0	0
20	5173008	rs6133193	G	C	2	5	7	0	1	8	0	0
20	5173378	rs2295511	T	C	23	28	51	0	0	51	0	0
20	5174039	rs6053188	C	T	25	21	46	0	0	46	0	0
20	5174600	rs6038088	G	A	47	49	96	0	0	96	0	0
20	5175237	rs732817	C	T	38	49	87	0	0	87	0	0
20	5176667	rs6107592	T	A	33	23	56	0	1	57	0	0
20	5273382	rs2234397	G	A	0	8	8	0	0	8	0	0
20	5529875	rs368642491	T	C	6	2	8	0	0	8	0	0
20	5590915	rs76101426	A	G	25	36	61	0	0	61	0	0
20	5731711	rs6116933	A	G	1	5	6	0	0	6	0	0
20	5731803	rs6116934	T	C	19	17	36	0	0	36	0	0
20	5731955	rs6107683	C	T	15	14	29	0	1	30	0	0
20	5753579	rs237422	C	T	11	18	29	0	0	29	0	0
20	5753865	rs13043139	C	A	30	14	44	0	1	45	0	0
20	5843812	rs1699233	T	C	4	2	6	0	0	6	0	0
20	5843952	rs41282138	G	A	4	3	7	0	0	7	0	0
20	5933108	rs236110	C	A	5	2	7	0	0	7	0	0
20	6751034	rs1049007	A	G	4	7	11	0	0	11	0	0
20	6759115	rs235768	A	T	7	7	14	0	0	14	0	0
20	6760201	rs3178250	T	C	6	9	15	0	0	15	0	0
20	6760344	rs235769	A	G	10	11	21	0	0	21	0	0
20	7967980	rs17425725	G	C	57	63	120	0	2	122	0	0
20	7999642	rs2294248	G	A	65	25	90	0	1	91	0	0
20	7999850	rs6055462	G	C	4	2	6	0	0	6	0	0
20	8156391	rs59903441	T	C	1	5	6	0	0	6	0	0
20	8195162	rs73082276	G	A	5	2	7	0	0	7	0	0
20	8388545	rs4813860	T	C	2	5	7	0	0	7	0	0
20	8388977	rs62195958	C	T	5	11	16	0	0	16	0	0
20	8617582	rs6086544	A	G	5	2	7	0	0	7	0	0
20	8633262	rs8115504	G	A	5	7	12	0	0	12	0	0
20	8633398	rs8115555	G	A	5	8	13	0	0	13	0	0
20	8727648	rs6056055	C	A	3	4	7	0	0	7	0	0
20	8737734	rs2076413	G	A	13	9	22	0	5	27	0	0
20	8755243	rs2235613	T	C	14	17	31	0	0	31	0	0
20	8770822	rs2294597	C	T	25	13	38	0	2	40	0	0
20	8864177	rs1047381	T	C	13	12	25	0	0	25	0	0
20	8864203	rs708910	A	G	10	7	17	0	1	18	0	0
20	8865006	rs1047383	C	T	20	27	47	0	0	47	0	0
20	8942954	rs6086714	G	A	4	5	9	0	0	9	0	0
20	10386013	rs1545	C	A	8	18	26	0	0	26	0	0
20	10386059	rs1547	G	A	10	15	25	0	0	25	0	0
20	10393629	rs17852625	G	A	5	1	6	0	0	6	0	0
20	10394046	rs16991547	G	A	6	2	8	0	0	8	0	0
20	10619014	rs7828	A	C	152	190	342	0	3	345	0	0
20	10620275	rs1051421	G	A	253	236	489	0	5	494	0	0
20	10621213	rs6040050	C	T	12	10	22	0	0	22	0	0
20	10621305	rs6074164	A	C	5	7	12	0	0	12	0	0
20	10622834	rs73075341	G	T	8	3	11	0	0	11	0	0
20	10622862	rs73075342	C	T	7	5	12	0	0	12	0	0
20	10624046	rs3817996	G	A	8	7	15	0	0	15	0	0
20	10639385	rs2273060	A	G	0	9	9	0	0	9	0	0
20	10639543	rs2273061	G	A	1	6	7	0	0	7	0	0
20	10640800	rs66504061	A	G	2	7	9	0	0	9	0	0
20	10640846	rs6040062	G	A	4	2	6	0	1	7	0	0
20	10641228	rs34101498	T	C	2	5	7	0	0	7	0	0
20	10641633	rs3748479	C	A	4	19	23	0	0	23	0	0
20	10642129	rs7265068	A	G	1	25	26	0	0	26	0	0
20	10643051	rs6040065	C	T	16	3	19	0	0	19	0	0
20	10643201	rs8119569	C	T	11	2	13	0	0	13	0	0
20	10643659	rs3748480	T	G	11	6	17	0	0	17	0	0
20	10643913	.	G	A	14	2	16	0	0	16	0	0
20	10644074	rs11907050	A	G	7	0	7	0	2	9	0	0
20	10654563	rs1051412	A	C	43	32	75	0	0	75	0	0
20	13695680	rs6110019	C	T	15	15	30	0	0	30	0	0
20	13766251	rs79372179	A	C	6	13	19	0	1	20	0	0
20	13766447	rs6110037	A	G	3	4	7	0	0	7	0	0
20	13768079	rs6042361	T	G	1	11	12	0	0	12	0	0
20	13769062	rs73612314	T	C	5	4	9	0	0	9	0	0
20	13775032	rs4814260	A	T	9	11	20	0	0	20	0	0
20	13793874	rs4813145	G	A	3	4	7	0	0	7	0	0
20	13796900	rs2273320	T	C	4	7	11	0	0	11	0	0
20	13798676	rs2423751	C	T	6	1	7	0	0	7	0	0
20	16711466	rs6131860	A	G	5	7	12	0	0	12	0	0
20	16717293	rs17759234	C	T	2	4	6	0	0	6	0	0
20	16717380	rs17759239	G	A	5	3	8	0	0	8	0	0
20	16721892	rs1051179	T	G	11	9	20	0	1	21	0	0
20	17474791	rs6080717	G	A	4	4	8	0	0	8	0	0
20	17585552	rs2273616	G	A	8	6	14	0	0	14	0	0
20	17595329	rs7261001	G	A	7	8	15	0	1	16	0	0
20	17596731	rs2236250	C	T	12	12	24	0	0	24	0	0
20	17597045	rs2236251	C	T	11	13	24	0	0	24	0	0
20	17597134	rs911345	C	T	9	5	14	0	0	14	0	0
20	17597331	rs911347	C	T	9	12	21	0	1	22	0	0
20	17599049	rs911349	G	T	9	10	19	0	0	19	0	0
20	17599752	rs6080750	G	C	31	12	43	0	1	44	0	0
20	17600022	rs9768	C	T	27	27	54	0	0	54	0	0
20	17600144	rs6599	G	A	24	27	51	0	2	53	0	0
20	17600357	rs11960	G	A	138	115	253	0	0	253	0	0
20	17600564	rs1052965	C	A	27	17	44	0	1	45	0	0
20	17607058	rs3790327	A	G	10	6	16	0	0	16	0	0
20	17607213	rs3790326	G	C	11	5	16	0	0	16	0	0
20	17639857	.	G	T	103	51	154	0	4	158	0	0
20	17923717	rs145873414	A	C	7	7	14	0	0	14	0	0
20	17924591	rs2145020	T	C	7	7	14	0	1	15	0	0
20	17926263	.	T	A	6	2	8	0	0	8	0	0
20	17927028	rs6136233	C	T	11	8	19	0	0	19	0	0
20	17927210	rs62208130	A	G	5	4	9	0	0	9	0	0
20	17930092	rs2295456	G	A	4	3	7	0	0	7	0	0
20	17931095	rs3736771	C	T	6	5	11	0	0	11	0	0
20	17931513	rs6111754	C	T	2	5	7	0	0	7	0	0
20	17931519	rs8120332	T	C	4	3	7	0	0	7	0	0
20	17932210	rs2273448	C	T	208	206	414	0	3	417	0	0
20	17932415	rs2273449	T	C	20	22	42	0	2	44	0	0
20	17932978	rs6111755	A	T	1	5	6	0	0	6	0	0
20	17934961	rs2236158	T	C	21	26	47	0	1	48	0	0
20	17935271	rs7268634	G	A	13	22	35	0	0	35	0	0
20	17935560	rs55981157	T	G	14	14	28	0	0	28	0	0
20	17935822	rs10485575	T	C	22	19	41	0	0	41	0	0
20	17942616	rs2328231	T	C	4	7	11	0	0	11	0	0
20	17942651	rs2328232	C	T	3	7	10	0	0	10	0	0
20	17942792	rs2328233	G	T	9	14	23	0	0	23	0	0
20	17943138	rs2004931	G	A	6	6	12	0	0	12	0	0
20	17943492	rs753213	A	T	8	9	17	0	0	17	0	0
20	17947738	rs62208159	G	A	30	29	59	0	0	59	0	0
20	17948082	rs2295457	T	C	25	29	54	0	0	54	0	0
20	17948171	rs34208662	C	A	17	14	31	0	0	31	0	0
20	17948894	rs6111762	G	A	51	82	133	0	0	133	0	0
20	17949452	rs910902	C	T	3	5	8	0	0	8	0	0
20	17950545	rs11551768	A	T	15	9	24	0	0	24	0	0
20	17968923	rs28455091	T	C	74	89	163	0	0	163	0	0
20	17971553	rs7010	T	G	57	103	160	0	5	165	0	0
20	17980831	rs6136258	C	A	5	1	6	0	0	6	0	0
20	18296473	rs1050475	C	T	2	6	8	0	0	8	0	0
20	18297193	rs1050476	T	C	5	2	7	0	0	7	0	0
20	18393312	rs6075337	C	G	8	10	18	0	0	18	0	0
20	18468917	rs6081168	T	A	7	1	8	0	0	8	0	0
20	18469576	rs6136389	A	G	5	4	9	0	1	10	0	0
20	18513605	rs2295556	C	T	8	5	13	0	1	14	0	0
20	18529233	rs3736775	T	A	3	3	6	0	0	6	0	0
20	18584332	.	G	A	5	4	9	0	0	9	0	0
20	18586737	.	C	A	5	2	7	0	0	7	0	0
20	18586772	.	G	C	6	7	13	0	0	13	0	0
20	18586995	.	G	A	7	1	8	0	0	8	0	0
20	18587381	.	A	G	6	0	6	0	0	6	0	0
20	18608937	rs3818221	C	G	32	27	59	0	1	60	0	0
20	18608945	rs3818220	G	C	25	26	51	0	0	51	0	0
20	18609016	rs2295574	T	C	30	29	59	0	0	59	0	0
20	18609314	rs2295573	T	C	17	15	32	0	0	32	0	0
20	18611962	rs6081260	A	G	4	5	9	0	0	9	0	0
20	18611987	rs6081261	A	G	4	6	10	0	0	10	0	0
20	18612282	rs6081262	A	C	8	12	20	0	0	20	0	0
20	19197918	rs80062405	G	A	5	2	7	0	0	7	0	0
20	19215642	rs723768	A	G	45	8	53	0	0	53	0	0
20	19216528	rs6035261	G	A	30	7	37	0	1	38	0	0
20	19216776	rs6081544	G	A	5	2	7	0	0	7	0	0
20	19220837	rs3790166	A	G	4	3	7	0	0	7	0	0
20	19261623	rs1569767	G	A	39	38	77	0	3	80	0	0
20	19268933	rs4813351	C	T	4	3	7	0	0	7	0	0
20	19280606	rs140347290	T	G	3	4	7	0	0	7	0	0
20	19280659	rs6081560	A	G	3	3	6	0	0	6	0	0
20	19283272	rs12481174	T	C	2	5	7	0	0	7	0	0
20	19323901	rs2024617	C	T	1	5	6	0	1	7	0	0
20	19341389	rs4814842	A	T	9	1	10	0	0	10	0	0
20	19341442	rs2009871	A	G	9	2	11	0	0	11	0	0
20	19341841	rs3790191	T	C	9	0	9	0	0	9	0	0
20	19344512	rs3790193	A	G	7	1	8	0	0	8	0	0
20	19388679	rs6035327	G	A	13	4	17	0	0	17	0	0
20	19634732	rs3790278	G	A	27	18	45	0	0	45	0	0
20	19634747	rs3790279	T	C	23	16	39	0	0	39	0	0
20	19642681	rs3790285	G	T	3	3	6	0	0	6	0	0
20	19702049	rs3828002	G	A	36	36	72	0	1	73	0	0
20	19702171	rs6046271	G	A	42	38	80	0	0	80	0	0
20	20003196	rs74802177	A	C	8	11	19	0	0	19	0	0
20	20010182	rs112502337	A	C	12	5	17	0	0	17	0	0
20	20017643	rs13037134	T	C	7	0	7	0	0	7	0	0
20	20028172	rs6081847	T	C	6	7	13	0	0	13	0	0
20	20032998	rs2255255	T	C	42	55	97	0	0	97	0	0
20	21106804	.	C	T	30	32	62	0	0	62	0	0
20	21111710	rs6075769	A	G	2	5	7	0	1	8	0	0
20	21120162	.	G	A	9	9	18	0	0	18	0	0
20	21142813	rs2236178	T	C	37	43	80	0	0	80	0	0
20	21150153	rs145395690	C	G	3	4	7	0	0	7	0	0
20	21326098	rs13043724	T	C	8	6	14	0	0	14	0	0
20	21329780	rs1958122	T	C	8	11	19	0	0	19	0	0
20	21339857	rs1409816	A	G	3	4	7	0	0	7	0	0
20	21342970	rs713479	G	C	6	3	9	0	0	9	0	0
20	21343944	rs3848794	G	A	5	4	9	0	0	9	0	0
20	21344454	rs4815040	G	A	7	2	9	0	0	9	0	0
20	21345573	rs73130999	A	C	5	4	9	0	0	9	0	0
20	21348430	rs6082397	C	G	2	5	7	0	0	7	0	0
20	21366260	rs6035864	T	C	6	8	14	0	0	14	0	0
20	23026496	rs1962	C	T	8	15	23	0	0	23	0	0
20	23027621	rs1042580	T	C	47	62	109	0	1	110	0	0
20	23062984	rs2749813	T	C	7	21	28	0	0	28	0	0
20	23064279	rs6076019	G	A	5	16	21	0	0	21	0	0
20	23064578	.	A	C	15	3	18	0	1	19	0	0
20	23065209	rs3746731	G	A	8	20	28	0	0	28	0	0
20	23065342	rs3746732	A	G	3	11	14	0	0	14	0	0
20	24930801	rs227654	T	C	3	5	8	0	0	8	0	0
20	24931446	rs227655	T	C	3	4	7	0	0	7	0	0
20	24935048	rs6050198	T	G	39	9	48	0	0	48	0	0
20	24935092	rs6050199	T	C	32	5	37	0	0	37	0	0
20	24939590	rs1056033	G	C	1583	1665	3248	0	32	3281	1	0
20	24940521	rs1056036	A	G	360	358	718	0	6	724	0	0
20	24944933	rs761368	T	C	11	9	20	0	0	20	0	0
20	24945581	rs6138435	G	C	7	13	20	0	0	20	0	0
20	24947476	rs6083697	C	A	9	9	18	0	0	18	0	0
20	24948435	.	T	C	6	7	13	0	1	14	0	0
20	24948630	rs6050214	A	G	6	4	10	0	0	10	0	0
20	24948851	rs4815351	T	C	11	6	17	0	2	19	0	0
20	24949159	rs6138437	G	A	10	6	16	0	0	16	0	0
20	24950373	rs2064404	A	C	8	2	10	0	0	10	0	0
20	24957164	rs2387572	C	T	4	4	8	0	0	8	0	0
20	24966619	rs765834	C	T	3	3	6	0	0	6	0	0
20	24987438	rs6083718	C	T	68	62	130	0	2	132	0	0
20	25011423	rs6050259	T	C	38	25	63	0	1	64	0	0
20	25203312	rs111399370	C	T	6	4	10	0	0	10	0	0
20	25277244	rs9927	A	G	42	43	85	0	0	85	0	0
20	25282967	rs746748	C	T	144	126	270	0	3	273	0	0
20	25594020	rs242130	C	A	6	12	18	0	0	18	0	0
20	25675108	.	T	C	5	6	11	0	0	11	0	0
20	25675602	rs4815445	T	C	3	4	7	0	0	7	0	0
20	29623223	.	T	C	136	0	136	0	0	136	0	0
20	29625876	.	C	T	131	0	131	0	2	133	0	0
20	29625935	.	A	G	148	0	148	0	2	150	0	0
20	29626720	.	C	T	9	0	9	0	0	9	0	0
20	29626773	.	A	T	0	10	10	0	0	10	0	0
20	29626826	.	A	T	8	0	8	0	0	8	0	0
20	29628271	.	C	T	137	0	137	0	1	138	0	0
20	29633583	rs35821765	A	G	3	4	7	0	0	7	0	0
20	29633916	.	G	T	62	0	62	0	0	64	2	0
20	29633927	rs62196372	C	A	47	0	47	0	2	49	0	0
20	29633929	rs7509092	A	G	46	0	46	0	1	47	0	0
20	29633952	.	C	T	30	0	30	0	1	31	0	0
20	29633986	rs2379676	A	C	10	0	10	0	1	11	0	0
20	30150324	rs73116296	G	A	5	4	9	0	0	9	0	0
20	30535466	rs6058499	T	C	0	6	6	0	0	6	0	0
20	30641529	rs57242437	G	A	4	5	9	0	0	9	0	0
20	30642850	rs78937021	G	C	10	7	17	0	0	17	0	0
20	30668544	rs242605	G	C	2	6	8	0	0	8	0	0
20	30668633	rs242606	G	A	4	2	6	0	0	6	0	0
20	30753270	rs14316	T	C	33	24	57	0	1	58	0	0
20	30780644	rs138055631	G	A	136	94	230	0	1	231	0	0
20	30782113	rs6061216	A	G	57	29	86	0	1	87	0	0
20	30795819	rs1923095	T	C	7	4	11	0	0	11	0	0
20	30920947	rs2151437	A	C	11	16	27	0	0	27	0	0
20	30921343	rs139816293	C	T	12	9	21	0	0	21	0	0
20	30922398	rs14353	C	T	31	31	62	0	0	62	0	0
20	30948281	rs2208131	A	G	6	1	7	0	1	8	0	0
20	30953162	rs6141294	T	C	4	3	7	0	0	7	0	0
20	31024274	rs4911231	T	C	129	111	240	0	2	242	0	0
20	31025163	rs2295764	A	G	12	8	20	0	0	20	0	0
20	31025231	rs2295763	T	C	7	11	18	0	0	18	0	0
20	31025535	rs2295762	A	G	15	24	39	0	0	39	0	0
20	31033574	rs3746611	G	A	31	27	58	0	2	60	0	0
20	31054702	rs1737894	C	G	3	3	6	0	0	6	0	0
20	31059748	.	A	G	5	1	6	0	0	6	0	0
20	31062176	rs1742983	T	C	4	2	6	0	0	6	0	0
20	31291161	rs9421	C	T	322	366	688	0	3	691	0	0
20	31291483	rs28482886	C	A	41	53	94	0	0	94	0	0
20	31386347	rs6058891	T	C	40	26	66	0	0	66	0	0
20	31386449	rs2424922	T	C	43	27	70	0	0	70	0	0
20	31392366	rs4911110	A	G	3	5	8	0	0	8	0	0
20	31427635	rs2070090	C	T	501	545	1046	0	2	1048	0	0
20	31435108	.	A	G	27	32	59	0	0	59	0	0
20	31435260	rs242536	T	G	28	50	78	0	1	79	0	0
20	31436747	rs242538	C	T	503	548	1051	0	3	1054	0	0
20	31961860	rs291676	T	C	12	10	22	0	0	22	0	0
20	31981849	rs291700	T	C	50	42	92	0	1	93	0	0
20	32232296	rs45563732	C	T	2	4	6	0	0	6	0	0
20	32232949	rs2075734	G	T	3	4	7	0	0	7	0	0
20	32248163	rs3746460	C	T	15	8	23	0	0	23	0	0
20	32265513	rs2071056	A	G	3	3	6	0	0	6	0	0
20	32265839	rs2071054	A	G	4	4	8	0	0	8	0	0
20	32376745	rs140105337	C	T	7	5	12	0	0	12	0	0
20	32403641	rs6119407	A	G	3	3	6	0	0	6	0	0
20	33345747	rs41290900	T	C	14	9	23	0	1	24	0	0
20	33592122	rs113338276	T	C	32	17	49	0	0	49	0	0
20	33593955	.	G	A	6	4	10	0	0	10	0	0
20	33594646	.	C	T	13	12	25	0	0	25	0	0
20	33856429	rs2425037	A	T	3	3	6	0	0	6	0	0
20	33865895	rs2425042	G	A	15	16	31	0	0	31	0	0
20	33866753	rs7004	G	C	137	104	241	0	2	244	1	0
20	33867248	rs2297789	A	T	5	3	8	0	0	8	0	0
20	33867924	rs2250205	G	A	3	6	9	0	1	10	0	0
20	33868702	rs2425043	T	C	3	3	6	0	0	6	0	0
20	33871310	rs932562	T	C	5	1	6	0	0	6	0	0
20	33871661	rs2425046	T	C	5	1	6	0	0	6	0	0
20	33871675	rs2425047	A	C	5	1	6	0	0	6	0	0
20	33872311	rs2275275	G	C	23	25	48	0	0	48	0	0
20	34329372	rs75743831	G	A	6	10	16	0	0	16	0	0
20	34394963	.	C	T	5	4	9	0	0	9	0	0
20	34444056	rs77679513	C	A	4	3	7	0	0	7	0	0
20	34637182	rs555218159	G	A	54	57	111	0	0	111	0	0
20	34833615	.	A	T	1	6	7	0	0	7	0	0
20	35224897	rs6028274	G	A	4	15	19	0	0	19	0	0
20	35507542	rs3748459	G	A	6	5	11	0	0	11	0	0
20	35517984	rs34143163	T	C	3	4	7	0	0	7	0	0
20	35518879	rs1129218	T	C	15	23	38	0	0	38	0	0
20	35539858	rs3762214	C	G	2	7	9	0	0	9	0	0
20	35540337	.	C	T	5	4	9	0	0	9	0	0
20	35552423	.	G	A	6	6	12	0	0	12	0	0
20	35626847	rs41279264	G	A	6	7	13	0	0	13	0	0
20	35660298	rs6103326	T	C	2	7	9	0	0	9	0	0
20	35661837	rs6030887	C	T	3	5	8	0	0	8	0	0
20	35663657	.	T	C	14	19	33	0	0	33	0	0
20	35723516	rs62206491	C	T	11	20	31	0	0	31	0	0
20	35807125	rs2880502	C	A	3	5	8	0	0	8	0	0
20	35807154	rs2880503	A	T	3	5	8	0	0	8	0	0
20	35807237	rs2880504	C	T	2	4	6	0	0	6	0	0
20	35925296	rs6074018	G	A	2	4	6	0	0	6	0	0
20	35926852	rs6032665	T	G	3	4	7	0	0	7	0	0
20	35927179	rs1127262	G	A	4	2	6	0	0	6	0	0
20	35945174	rs1806940	G	T	16	15	31	0	2	33	0	0
20	36032628	rs41282798	T	C	5	8	13	0	0	13	0	0
20	36148497	rs3795148	T	C	7	4	11	0	0	11	0	0
20	36148985	rs6019062	T	C	2	9	11	0	1	12	0	0
20	36153344	rs6019102	C	T	5	1	6	0	0	6	0	0
20	36154462	rs12481150	C	A	7	2	9	0	0	9	0	0
20	36475345	.	G	A	2	6	8	0	0	8	0	0
20	36475512	rs9679780	G	A	4	6	10	0	0	10	0	0
20	36475515	rs9680012	T	G	4	6	10	0	0	10	0	0
20	36476220	rs2294438	T	A	4	2	6	0	0	6	0	0
20	36482773	rs6126298	T	G	3	3	6	0	0	6	0	0
20	36485266	rs2235456	C	T	4	2	6	0	0	6	0	0
20	36486207	rs4811232	A	G	8	2	10	0	0	10	0	0
20	36486220	rs4811233	G	C	8	3	11	0	0	11	0	0
20	36486369	rs149273107	G	A	2	4	6	0	0	6	0	0
20	36486568	rs4811234	C	T	3	4	7	0	0	7	0	0
20	36486633	rs73292682	C	G	5	3	8	0	0	8	0	0
20	36495377	rs4811245	T	C	3	4	7	0	0	7	0	0
20	36495757	rs4811246	A	G	5	4	9	0	0	9	0	0
20	36498045	rs753215	T	C	6	6	12	0	0	12	0	0
20	36498767	rs79513413	G	A	6	4	10	0	0	10	0	0
20	36498927	rs910759	G	A	7	4	11	0	0	11	0	0
20	36499238	rs1884502	G	A	9	8	17	0	0	17	0	0
20	36499995	rs910760	A	C	6	14	20	0	0	20	0	0
20	36500313	rs717599	C	A	4	12	16	0	1	17	0	0
20	36611647	rs2036	C	A	27	21	48	0	0	48	0	0
20	36712577	.	G	C	7	6	13	0	0	13	0	0
20	36718503	.	C	G	35	32	67	0	0	67	0	0
20	36720204	rs187170319	G	A	70	65	135	0	2	137	0	0
20	36965617	rs1131847	A	G	1027	1019	2046	0	7	2053	0	0
20	36965906	rs2256754	G	A	25	3	28	0	0	28	0	0
20	37049878	rs1739653	T	C	15	26	41	0	0	41	0	0
20	37050753	rs3752277	A	G	11	45	56	0	0	56	0	0
20	37050817	rs3752278	T	C	14	33	47	0	0	47	0	0
20	37050959	rs3752279	A	C	91	10	101	0	1	102	0	0
20	37051007	rs3752280	G	A	104	15	119	0	0	119	0	0
20	37053583	rs1780636	C	T	4	7	11	0	0	11	0	0
20	37054781	rs752775	C	T	2	6	8	0	0	8	0	0
20	37055015	rs752774	A	G	3	5	8	0	0	8	0	0
20	37055875	rs707578	T	C	9	1	10	0	0	10	0	0
20	37058895	rs788342	C	T	10	9	19	0	1	20	0	0
20	37059070	rs788343	T	C	10	7	17	0	0	17	0	0
20	37059349	rs788344	C	T	11	12	23	0	0	23	0	0
20	37059444	rs788345	T	G	13	17	30	0	0	30	0	0
20	37059749	rs788346	T	G	265	235	500	0	2	502	0	0
20	37063671	rs1578462	C	T	29	117	146	0	1	147	0	0
20	37079050	rs186797557	A	G	44	50	94	0	1	95	0	0
20	37079237	rs12397	T	C	65	49	114	0	2	116	0	0
20	37129241	rs1303574	G	T	4	2	6	0	0	6	0	0
20	37200322	rs2206783	A	G	5	8	13	0	0	13	0	0
20	37202173	rs1115600	T	G	3	6	9	0	0	9	0	0
20	37396114	rs111586858	A	G	116	102	218	0	2	220	0	0
20	37399407	rs11699516	C	T	6	5	11	0	0	11	0	0
20	37536119	rs4812333	T	A	2	4	6	0	0	6	0	0
20	37547207	rs34350985	G	A	78	58	136	0	0	136	0	0
20	37548730	rs748063	A	G	76	54	130	0	3	134	1	0
20	37549061	rs116314179	G	T	91	103	194	0	1	195	0	0
20	37549309	rs4810245	G	A	103	106	209	0	0	209	0	0
20	37551468	rs10477	A	G	61	80	141	0	1	142	0	0
20	37555116	rs3752290	G	C	7	4	11	0	0	11	0	0
20	37570725	rs3752293	C	T	33	40	73	0	1	74	0	0
20	37581506	rs1733	G	A	13	13	26	0	1	27	0	0
20	37599717	.	C	T	5	1	6	0	0	6	0	0
20	39660608	rs75534547	G	T	61	26	87	0	2	89	0	0
20	39660687	rs6129731	A	C	26	13	39	0	0	39	0	0
20	39663329	rs10485678	C	T	5	1	6	0	0	6	0	0
20	39665750	rs4810309	A	G	8	3	11	0	0	11	0	0
20	39718209	rs78668007	G	A	7	4	11	0	0	11	0	0
20	39719202	rs6124315	A	G	4	5	9	0	0	9	0	0
20	39721373	rs2076574	A	G	17	9	26	0	0	26	0	0
20	39723683	rs6129753	T	A	10	10	20	0	0	20	0	0
20	39724338	rs6065311	T	C	29	22	51	0	0	51	0	0
20	39797465	rs753381	T	C	2	5	7	0	0	7	0	0
20	39811275	rs4297946	G	C	6	5	11	0	0	11	0	0
20	40031293	rs1047772	T	G	3	6	9	0	0	9	0	0
20	40032421	rs3827038	A	G	29	14	43	0	1	44	0	0
20	40095031	rs4810320	G	T	6	3	9	0	0	9	0	0
20	40115364	rs6072386	C	G	40	41	81	0	0	81	0	0
20	40141295	rs2145040	G	A	21	23	44	0	0	44	0	0
20	42087454	rs6103330	T	C	13	12	25	0	0	25	0	0
20	42089511	rs2235611	T	C	354	380	734	0	10	745	1	0
20	42179184	rs2269621	C	T	13	1	14	0	0	14	0	0
20	42839175	rs41307187	T	C	9	2	11	0	1	12	0	0
20	43530234	rs4931	A	C	319	297	616	0	6	622	0	0
20	43532388	rs6031860	A	G	4	7	11	0	0	11	0	0
20	43532438	rs12481468	T	C	2	6	8	0	0	8	0	0
20	43533286	rs3761188	T	G	4	2	6	0	0	6	0	0
20	43534903	rs16989481	G	A	5	12	17	0	0	17	0	0
20	43536455	rs8356	C	T	244	159	403	0	5	408	0	0
20	43559767	rs13041777	C	G	3	3	6	0	0	6	0	0
20	43561002	.	A	G	9	1	10	0	0	10	0	0
20	43589041	rs2234197	G	A	9	1	10	0	0	10	0	0
20	43601653	rs6073581	C	T	2	5	7	0	0	7	0	0
20	43601921	rs910671	G	T	7	11	18	0	0	18	0	0
20	43603533	rs6073582	A	C	7	5	12	0	0	12	0	0
20	43604003	rs6017452	C	T	18	10	28	0	0	28	0	0
20	43605040	rs75508136	G	A	5	4	9	0	0	9	0	0
20	43626696	rs7271519	T	C	90	71	161	0	0	161	0	0
20	43627127	rs34131103	G	A	72	44	116	0	1	117	0	0
20	43629135	rs17420378	G	A	51	31	82	0	2	84	0	0
20	43629512	rs6073597	T	C	4	2	6	0	0	6	0	0
20	43696456	rs2267861	A	T	5	3	8	0	0	8	0	0
20	43704937	rs6017482	A	G	63	65	128	0	1	129	0	0
20	43704943	rs6031972	T	C	63	63	126	0	2	128	0	0
20	43704963	rs6031973	C	G	70	66	136	0	1	137	0	0
20	43708297	rs8000	T	G	80	71	151	0	8	159	0	0
20	43975145	rs75798327	G	A	8	11	19	0	0	19	0	0
20	43992746	rs6017554	C	T	5	2	7	0	0	7	0	0
20	43995410	rs6032142	C	T	3	3	6	0	0	6	0	0
20	43996012	rs2664543	G	T	185	155	340	0	2	342	0	0
20	43996132	rs2664583	C	T	142	151	293	0	3	296	0	0
20	43996189	rs1046612	G	A	135	168	303	0	2	305	0	0
20	43996454	rs2743430	G	T	139	122	261	0	1	262	0	0
20	43996466	rs707576	C	T	125	131	256	0	3	259	0	0
20	43996807	rs3827039	C	T	61	55	116	0	0	116	0	0
20	43997502	rs7098	C	T	54	69	123	0	4	127	0	0
20	44004631	rs760642	A	G	5	8	13	0	0	13	0	0
20	44004777	rs760641	T	C	8	3	11	0	0	11	0	0
20	44006078	rs2231614	C	G	4	2	6	0	0	6	0	0
20	44006601	rs2249728	A	G	1	6	7	0	0	7	0	0
20	44007255	.	G	A	5	1	6	0	0	6	0	0
20	44007674	rs2231610	C	T	4	4	8	0	0	8	0	0
20	44047260	.	C	T	10	19	29	0	0	29	0	0
20	44050342	rs4812899	T	C	27	20	47	0	0	47	0	0
20	44050566	.	A	G	21	31	52	0	0	52	0	0
20	44051036	rs6032172	C	A	29	17	46	0	2	48	0	0
20	44051444	rs4810449	G	A	20	26	46	0	1	47	0	0
20	44051497	rs4812900	T	C	20	25	45	0	1	46	0	0
20	44052992	rs13217	G	A	781	655	1436	0	8	1444	0	0
20	44439150	.	C	G	4	2	6	0	0	6	0	0
20	44485483	.	C	T	7	4	11	0	0	11	0	0
20	44574658	rs62213347	C	T	10	7	17	0	0	17	0	0
20	44582435	rs41280276	G	T	30	20	50	0	0	50	0	0
20	44757814	rs11569343	C	G	11	3	14	0	0	14	0	0
20	44987318	rs1044369	C	G	49	29	78	0	0	78	0	0
20	45025749	rs147450384	T	C	5	6	11	0	0	11	0	0
20	45027364	rs6065979	C	T	55	38	93	0	0	93	0	0
20	45867854	rs143086919	C	T	1	7	8	0	0	8	0	0
20	46284584	rs2179591	A	G	13	5	18	0	0	18	0	0
20	46365571	rs3810526	A	G	10	13	23	0	0	23	0	0
20	46399577	rs60510778	G	A	4	2	6	0	0	6	0	0
20	47240985	rs8114388	G	A	73	67	140	0	1	141	0	0
20	47241034	rs8114341	C	T	106	102	208	0	0	208	0	0
20	47241117	rs7403	G	A	106	84	190	0	1	191	0	0
20	47241358	rs2664570	C	T	109	105	214	0	1	216	1	0
20	47241805	rs41283442	G	A	176	109	285	0	4	289	0	0
20	47242313	rs11553082	G	A	108	141	249	0	3	252	0	0
20	47243027	rs7265343	G	A	8	6	14	0	0	14	0	0
20	47243597	rs13043635	A	G	6	2	8	0	0	8	0	0
20	47253043	rs11553083	G	A	73	70	143	0	3	147	1	0
20	47256479	rs4611698	T	C	14	4	18	0	0	18	0	0
20	47258763	rs16993997	C	T	120	108	228	0	1	229	0	0
20	47260458	rs6066800	G	A	4	2	6	0	0	6	0	0
20	47261017	rs6066802	T	C	83	50	133	0	1	134	0	0
20	47267480	rs41283556	A	G	92	55	147	0	1	148	0	0
20	47267940	rs61748372	G	A	59	75	134	0	0	134	0	0
20	47269233	rs41283558	C	G	79	79	158	0	1	159	0	0
20	47273726	rs55904123	C	T	78	50	128	0	1	129	0	0
20	47275133	rs16994003	T	C	4	4	8	0	0	8	0	0
20	47277187	rs56172784	A	G	7	3	10	0	0	10	0	0
20	47279133	rs56125202	C	T	2	5	7	0	0	7	0	0
20	47307618	rs3746820	G	A	63	58	121	0	0	121	0	0
20	47351095	rs6122720	G	A	92	69	161	0	0	161	0	0
20	47601509	rs1569749	A	G	8	14	22	0	0	22	0	0
20	47626847	rs2295580	T	C	66	54	120	0	1	121	0	0
20	47627170	rs6095396	G	T	4	3	7	0	0	7	0	0
20	47648854	rs1022687	C	T	4	2	6	0	0	6	0	0
20	47648856	rs1022688	G	A	4	2	6	0	0	6	0	0
20	47651492	rs6019602	G	A	74	55	129	0	3	132	0	0
20	47652254	rs707533	A	G	76	81	157	0	4	161	0	0
20	47652338	rs707534	A	G	79	74	153	0	1	154	0	0
20	47707944	rs6063351	C	T	8	1	9	0	1	10	0	0
20	47713063	rs17632	C	T	68	72	140	0	2	142	0	0
20	47731158	rs1043361	T	C	216	217	433	0	3	436	0	0
20	47731228	rs1043357	A	C	217	206	423	0	8	434	3	0
20	47731767	rs11697370	C	T	6	0	6	0	0	6	0	0
20	47746974	rs34841991	T	C	6	6	12	0	0	12	0	0
20	47760856	rs6066979	A	G	25	37	62	0	1	63	0	0
20	47760857	rs6066980	G	C	25	38	63	0	0	63	0	0
20	47762700	rs13044900	G	A	4	2	6	0	0	6	0	0
20	47763558	rs6066982	C	A	2	4	6	0	0	6	0	0
20	47847587	rs6012624	C	T	153	104	257	0	0	257	0	0
20	47848037	rs238171	G	A	1	5	6	0	0	6	0	0
20	47849526	rs761497	G	A	3	3	6	0	0	6	0	0
20	47850182	rs238148	C	T	222	227	449	0	3	452	0	0
20	47850614	rs1079661	A	T	9	10	19	0	1	20	0	0
20	47850757	rs238149	T	G	7	5	12	0	0	12	0	0
20	47852320	rs138514835	G	A	12	8	20	0	1	21	0	0
20	47852349	rs487639	T	C	10	7	17	0	0	17	0	0
20	47852354	rs487644	T	C	10	8	18	0	0	18	0	0
20	47855082	rs238154	G	A	4	2	6	0	0	6	0	0
20	47859015	rs238204	A	G	5	5	10	0	0	10	0	0
20	47859217	rs1130146	G	A	337	245	582	0	0	582	0	0
20	47865509	rs238209	G	A	44	50	94	0	2	96	0	0
20	47866306	.	T	C	6	8	14	0	0	14	0	0
20	47866411	rs6063378	G	A	3	3	6	0	0	6	0	0
20	47866880	rs190220	A	G	4	2	6	0	0	6	0	0
20	47867028	rs171131	A	T	2	5	7	0	0	7	0	0
20	47867599	rs11696801	T	G	2	4	6	0	0	6	0	0
20	47868595	rs73113562	C	A	4	4	8	0	0	8	0	0
20	47868862	rs238214	A	T	5	2	7	0	0	7	0	0
20	47870506	rs238215	T	C	1	5	6	0	0	6	0	0
20	47871729	rs238219	G	A	5	1	6	0	0	6	0	0
20	47872327	rs238220	A	G	2	6	8	0	1	9	0	0
20	47872377	rs238221	C	G	33	20	53	0	0	53	0	0
20	47880954	rs73113584	T	G	2	4	6	0	0	6	0	0
20	47895408	rs73116127	G	A	1	7	8	0	0	8	0	0
20	47899486	rs238199	C	T	9	8	17	0	0	17	0	0
20	47900164	rs6067034	G	A	12	12	24	0	0	24	0	0
20	47900336	rs238202	G	C	7	10	17	0	0	17	0	0
20	47902776	rs237744	T	C	3	4	7	0	1	8	0	0
20	47903826	rs6122781	T	G	11	16	27	0	0	27	0	0
20	47904298	rs6125610	C	T	21	18	39	0	0	39	0	0
20	47904734	rs6125611	G	T	8	8	16	0	0	16	0	0
20	47905008	rs237737	G	A	20	16	36	0	0	36	0	0
20	47905508	rs8197	G	A	38	28	66	0	0	66	0	0
20	48250747	rs235032	C	A	54	52	106	0	0	106	0	0
20	48251231	rs235033	T	C	37	26	63	0	0	63	0	0
20	48252338	rs235034	T	A	13	13	26	0	0	26	0	0
20	48252769	.	A	T	42	44	86	0	1	87	0	0
20	48257149	rs421801	C	T	38	35	73	0	1	74	0	0
20	48259034	rs2235855	A	G	38	33	71	0	1	72	0	0
20	48318306	rs913477	T	C	3	4	7	0	0	7	0	0
20	48319572	rs6012716	G	T	4	2	6	0	0	6	0	0
20	48462083	rs73125642	C	T	11	9	20	0	0	20	0	0
20	48466438	rs581456	A	T	4	5	9	0	0	9	0	0
20	48480254	rs627898	A	C	9	13	22	0	0	22	0	0
20	48491258	rs542234	T	G	20	18	38	0	0	38	0	0
20	48498704	rs601849	T	C	8	7	15	0	0	15	0	0
20	48498719	rs601878	T	C	8	6	14	0	0	14	0	0
20	48499085	rs488255	C	T	7	9	16	0	0	16	0	0
20	48499259	rs487096	G	C	5	2	7	0	0	7	0	0
20	48501351	rs536092	C	T	6	3	9	0	1	10	0	0
20	48501606	rs645544	A	G	6	5	11	0	0	11	0	0
20	48520610	rs632376	A	G	7	8	15	0	0	15	0	0
20	48522330	rs495337	G	A	154	144	298	0	4	302	0	0
20	48522585	rs492702	G	A	105	99	204	0	1	205	0	0
20	48523628	rs624115	C	T	3	7	10	0	0	10	0	0
20	48523755	rs571694	G	A	5	9	14	0	0	14	0	0
20	48523786	rs624647	T	C	6	11	17	0	0	17	0	0
20	48524827	rs2769982	A	G	43	57	100	0	1	101	0	0
20	48525378	rs2769980	A	G	4	8	12	0	0	12	0	0
20	48525460	rs2745078	C	T	5	7	12	0	0	12	0	0
20	48527107	rs2254930	T	A	6	3	9	0	0	9	0	0
20	48527423	rs2769978	T	C	7	3	10	0	0	10	0	0
20	48527464	rs2769977	T	C	5	2	7	0	0	7	0	0
20	48554977	rs2235617	C	G	2	7	9	0	0	9	0	0
20	48556229	rs1056198	C	T	3	4	7	0	2	9	0	0
20	48556248	rs1056200	A	G	4	4	8	0	1	9	0	0
20	48557172	rs13039965	G	A	3	6	9	0	0	9	0	0
20	48559339	rs4809766	T	C	19	15	34	0	0	34	0	0
20	48560184	.	T	C	8	5	13	0	0	13	0	0
20	48560372	rs57717749	C	T	15	5	20	0	0	20	0	0
20	48561280	rs2056991	T	C	23	13	36	0	1	37	0	0
20	48561893	rs4810993	A	G	46	39	85	0	0	85	0	0
20	48568929	rs6125829	G	T	136	131	267	0	3	270	0	0
20	48569127	rs2235616	G	A	105	143	248	0	3	252	1	0
20	48569278	rs6067282	T	C	77	114	191	0	1	192	0	0
20	48604799	rs1543442	A	G	12	19	31	0	1	32	0	0
20	48604985	rs1063211	A	C	16	4	20	0	1	21	0	0
20	48698783	rs1049679	A	G	134	165	299	0	4	303	0	0
20	48698923	rs8585	G	A	124	171	295	0	4	299	0	0
20	48699651	rs6125888	T	G	9	12	21	0	0	21	0	0
20	48699796	rs2073053	C	A	7	9	16	0	0	16	0	0
20	48700189	rs78450391	A	G	3	11	14	0	0	14	0	0
20	48700947	rs67366514	T	C	4	4	8	0	0	8	0	0
20	48705216	rs6012829	C	G	128	20	148	0	1	149	0	0
20	48706165	rs2269218	G	A	6	13	19	0	0	19	0	0
20	48706395	rs2269217	G	C	5	6	11	0	0	11	0	0
20	48707556	rs6020247	C	T	14	3	17	0	1	18	0	0
20	48707730	rs2301019	T	C	4	5	9	0	1	10	0	0
20	48707834	rs6020250	C	T	4	6	10	0	0	10	0	0
20	48708747	rs3819905	G	A	4	4	8	0	0	8	0	0
20	48711425	rs6020256	C	T	6	1	7	0	1	8	0	0
20	48711570	rs6020257	G	T	7	2	9	0	1	10	0	0
20	48735077	rs12624795	G	A	5	5	10	0	0	10	0	0
20	48740545	rs2664558	G	A	16	17	33	0	0	33	0	0
20	48742509	rs61656463	G	A	1	6	7	0	0	7	0	0
20	48746189	rs6122878	C	T	142	104	246	0	3	249	0	0
20	49127282	rs6067471	A	C	5	3	8	0	0	8	0	0
20	49130119	rs2206656	C	G	2	4	6	0	0	6	0	0
20	49191228	rs1885177	A	C	9	6	15	0	0	15	0	0
20	49191904	rs754118	T	C	4	9	13	0	0	13	0	0
20	49194096	rs2426162	T	C	9	14	23	0	0	23	0	0
20	49194607	rs6020611	A	G	12	13	25	0	0	25	0	0
20	49194615	rs2426163	A	G	14	15	29	0	0	29	0	0
20	49195248	rs968701	G	A	30	18	48	0	0	48	0	0
20	49195493	rs4809800	C	A	23	24	47	0	0	47	0	0
20	49196167	rs2282147	T	C	12	13	25	0	0	25	0	0
20	49196599	rs718049	C	T	16	13	29	0	1	30	0	0
20	49196602	rs718053	G	A	13	13	26	0	0	26	0	0
20	49196930	rs718050	A	G	13	22	35	0	0	35	0	0
20	49196998	rs3787348	G	T	15	27	42	0	0	42	0	0
20	49197203	rs914460	C	T	9	26	35	0	1	36	0	0
20	49198327	rs2426164	G	A	24	23	47	0	0	47	0	0
20	49225953	rs73615305	A	G	3	3	6	0	0	6	0	0
20	49457269	rs16995521	A	G	41	0	41	0	1	42	0	0
20	49577530	rs147086478	C	T	9	6	15	0	0	15	0	0
20	50004654	rs1052653	T	C	8	8	16	0	0	16	0	0
20	50006322	rs1569736	C	A	10	8	18	0	1	19	0	0
20	50091557	rs6021230	G	A	3	3	6	0	0	6	0	0
20	50091787	rs111838448	C	T	19	9	28	0	0	28	0	0
20	50092027	rs6013193	T	G	15	14	29	0	0	29	0	0
20	50140627	rs3746420	G	C	5	7	12	0	0	12	0	0
20	50213549	rs1048807	A	G	5	7	12	0	0	12	0	0
20	50768406	rs3179314	T	C	10	2	12	0	0	12	0	0
20	50768476	rs3179313	T	C	15	4	19	0	0	19	0	0
20	52184384	rs718889	T	A	77	80	157	0	4	161	0	0
20	52186784	rs2766672	A	G	3	3	6	0	0	6	0	0
20	52187612	rs8184575	G	C	4	9	13	0	0	13	0	0
20	53267593	rs2841	G	A	5	4	9	0	0	9	0	0
20	53267627	rs15899	T	C	6	4	10	0	0	10	0	0
20	53267635	rs2843	C	G	6	4	10	0	0	10	0	0
20	54935728	rs6092308	A	G	4	6	10	0	0	10	0	0
20	54941140	rs6099115	C	T	38	39	77	0	0	77	0	0
20	54941268	rs6099116	G	A	54	65	119	0	1	120	0	0
20	54941905	rs1044377	G	T	39	53	92	0	1	93	0	0
20	54943532	rs12150	C	G	83	96	179	0	0	179	0	0
20	54944791	rs8173	C	G	4	7	11	0	0	11	0	0
20	54961541	rs2273535	A	T	4	8	12	0	0	12	0	0
20	55045843	rs6014740	T	C	19	15	34	0	0	34	0	0
20	55070539	rs3827107	G	C	3	3	6	0	0	6	0	0
20	55070946	rs6064405	C	G	6	2	8	0	0	8	0	0
20	55071192	rs4811709	C	T	3	3	6	0	0	6	0	0
20	55071253	rs6099171	A	G	4	2	6	0	0	6	0	0
20	55071620	rs6014752	T	G	4	4	8	0	0	8	0	0
20	55079380	rs34983295	G	A	7	5	12	0	0	12	0	0
20	55085484	rs75604840	C	T	4	5	9	0	0	9	0	0
20	55086281	rs34953792	G	T	3	3	6	0	0	6	0	0
20	55087041	rs11699883	A	C	6	3	9	0	0	9	0	0
20	55087964	rs11699551	T	C	10	12	22	0	0	22	0	0
20	55088798	rs13043526	T	C	3	4	7	0	0	7	0	0
20	55089031	rs1061532	G	A	6	4	10	0	0	10	0	0
20	55093901	rs6999	A	G	102	122	224	0	4	228	0	0
20	55094507	rs2056	G	A	3	4	7	0	0	7	0	0
20	55096042	rs4811711	T	G	4	6	10	0	1	11	0	0
20	55096136	rs4810024	A	G	6	5	11	0	0	11	0	0
20	55096228	rs6099183	T	G	7	6	13	0	0	13	0	0
20	55097048	rs4810025	G	A	10	3	13	0	0	13	0	0
20	55097478	rs6099184	A	G	11	6	17	0	0	17	0	0
20	55097788	rs6092325	C	T	9	5	14	0	0	14	0	0
20	55108617	rs3209183	C	A	45	47	92	0	1	93	0	0
20	55111371	rs2296130	G	A	44	37	81	0	0	81	0	0
20	55927472	rs2038612	C	G	8	6	14	0	0	14	0	0
20	55929881	rs4811837	T	C	1	6	7	0	0	7	0	0
20	55940921	rs6025517	T	C	4	4	8	0	0	8	0	0
20	55946446	rs75125314	A	G	10	5	15	0	0	15	0	0
20	55946487	rs117431847	A	C	8	5	13	0	0	13	0	0
20	55951474	rs7270995	A	G	4	5	9	0	0	9	0	0
20	55952187	rs911901	A	G	5	7	12	0	0	12	0	0
20	55952591	rs4810064	G	A	3	4	7	0	0	7	0	0
20	55952702	rs2426710	T	A	9	5	14	0	0	14	0	0
20	55966904	rs117963839	C	T	3	4	7	0	0	7	0	0
20	55969116	rs6092472	A	G	2	4	6	0	0	6	0	0
20	55969492	rs328491	C	T	6	5	11	0	0	11	0	0
20	55971501	rs2426717	T	A	4	2	6	0	0	6	0	0
20	55974779	rs6128020	C	T	7	0	7	0	0	7	0	0
20	55975099	rs6014986	T	A	5	9	14	0	0	14	0	0
20	55975714	rs6014987	T	C	1	5	6	0	1	7	0	0
20	55976910	rs62204186	C	T	2	6	8	0	0	8	0	0
20	55977759	rs11905479	G	A	6	2	8	0	0	8	0	0
20	55978153	rs13037066	A	G	6	6	12	0	0	12	0	0
20	55980747	rs73917118	G	A	4	4	8	0	0	8	0	0
20	55982579	rs3764719	T	C	6	6	12	0	1	13	0	0
20	55983073	rs11546710	C	T	285	177	462	0	5	467	0	0
20	55983695	rs11546711	T	C	228	220	448	0	10	458	0	0
20	56822536	rs4811972	G	A	11	3	14	0	0	14	0	0
20	56888641	rs551988	T	C	20	12	32	0	0	32	0	0
20	56888728	rs113682518	A	C	10	12	22	0	1	23	0	0
20	56942082	rs1045408	A	T	3	6	9	0	0	9	0	0
20	56942312	rs707557	C	T	2	4	6	0	0	6	0	0
20	57020573	rs1802459	A	G	4	5	9	0	1	10	0	0
20	57244493	rs2296524	G	A	33	35	68	0	0	68	0	0
20	57250986	rs6123819	G	C	5	5	10	0	0	10	0	0
20	57253132	rs6128397	A	G	110	99	209	0	0	209	0	0
20	57253275	rs11578	C	T	81	78	159	0	2	161	0	0
20	57253404	rs7683	G	A	82	71	153	0	4	157	0	0
20	57266781	rs6128402	C	T	13	12	25	0	0	25	0	0
20	57266913	rs6123823	T	C	9	15	24	0	0	24	0	0
20	57267433	rs35882666	A	G	8	8	16	0	0	16	0	0
20	57268867	rs3746396	C	A	28	26	54	0	0	54	0	0
20	57278022	rs77212705	G	A	8	14	22	0	0	22	0	0
20	57278450	rs6100172	G	A	15	17	32	0	0	32	0	0
20	57278967	rs3746395	C	A	21	10	31	0	0	31	0	0
20	57280575	rs6100174	T	C	0	7	7	0	0	7	0	0
20	57288744	rs1570894	G	A	12	15	27	0	2	29	0	0
20	57290347	.	C	G	105	80	185	0	3	188	0	0
20	57290705	rs12220	T	C	56	38	94	0	1	95	0	0
20	57290846	rs8978	C	T	25	15	40	0	0	40	0	0
20	57562420	rs117366384	T	A	8	9	17	0	0	17	0	0
20	57564070	rs2273360	C	T	150	115	265	0	2	267	0	0
20	57564448	rs12479566	C	T	15	15	30	0	0	30	0	0
20	57565943	rs163782	G	C	21	23	44	0	0	44	0	0
20	57566637	rs149265	C	T	21	8	29	0	0	29	0	0
20	57569816	rs7341	G	T	185	183	368	0	5	373	0	0
20	57569860	rs1043219	C	G	198	192	390	0	1	391	0	0
20	57570456	rs10369	C	T	188	230	418	0	2	420	0	0
20	57570568	rs13720	G	A	174	206	380	0	2	382	0	0
20	57571763	rs9760	A	G	170	193	363	0	16	379	0	0
20	57609590	rs7474	A	G	99	98	197	0	1	198	0	0
20	58520296	rs6071037	C	T	7	7	14	0	0	14	0	0
20	58576432	rs41310817	A	G	9	6	15	0	0	15	0	0
20	58644995	rs6071100	T	C	4	6	10	0	0	10	0	0
20	60550073	.	A	G	10	5	15	0	0	15	0	0
20	60550536	rs147000978	A	G	5	7	12	0	0	12	0	0
20	60572663	rs2296081	C	A	12	12	24	0	1	25	0	0
20	60637637	rs4925337	T	C	2	6	8	0	2	10	0	0
20	60698957	rs965490	G	A	5	2	7	0	0	7	0	0
20	60700129	rs2002239	G	T	4	2	6	0	0	6	0	0
20	60700554	rs4538273	C	T	11	10	21	0	0	21	0	0
20	60706922	rs4925347	A	T	3	4	7	0	0	7	0	0
20	60708216	rs6089657	G	A	12	0	12	0	0	12	0	0
20	60708734	rs6089658	T	C	6	2	8	0	0	8	0	0
20	60708882	rs6089660	G	A	4	8	12	0	0	12	0	0
20	60708909	rs6142961	G	C	5	5	10	0	0	10	0	0
20	60712284	rs2057169	G	A	33	23	56	0	0	56	0	0
20	60712347	rs2057168	G	A	42	27	69	0	0	69	0	0
20	60712511	rs2281740	A	G	19	18	37	0	0	37	0	0
20	60712778	rs73307256	G	A	19	20	39	0	0	39	0	0
20	60713038	rs2281739	T	C	20	20	40	0	1	41	0	0
20	60713311	rs7076	G	A	1295	1216	2511	0	7	2518	0	0
20	60713571	rs6062077	G	A	14	8	22	0	0	22	0	0
20	60713906	rs3827118	G	A	9	9	18	0	0	18	0	0
20	60714525	rs6089664	G	A	81	71	152	0	2	154	0	0
20	60717203	rs6089665	G	T	8	10	18	0	1	19	0	0
20	60718420	rs3746651	C	T	46	39	85	0	3	88	0	0
20	60737908	rs61744430	G	A	2	4	6	0	0	6	0	0
20	60738566	rs73309164	C	T	2	5	7	0	0	7	0	0
20	60755649	rs73307492	T	C	5	3	8	0	0	8	0	0
20	60768497	rs2236527	C	T	10	7	17	0	0	17	0	0
20	60776182	rs1054885	G	A	12	11	23	0	0	23	0	0
20	60776302	rs2184160	G	A	2	4	6	0	0	6	0	0
20	60778208	rs1047154	G	T	11	3	14	0	0	14	0	0
20	60778225	rs1047156	G	T	9	4	13	0	0	13	0	0
20	60778301	rs1047164	G	A	11	6	17	0	0	17	0	0
20	60832906	rs138280731	G	A	28	18	46	0	0	46	0	0
20	60855002	rs143847710	G	A	4	6	10	0	0	10	0	0
20	60861911	rs145762195	G	A	8	11	19	0	0	19	0	0
20	60883375	rs114373359	G	A	8	21	29	0	0	29	0	0
20	60887581	rs944895	G	A	17	9	26	0	0	26	0	0
20	60889385	rs117480847	G	T	7	8	15	0	0	15	0	0
20	60890375	rs6062210	C	T	5	4	9	0	0	9	0	0
20	60894278	rs35265388	C	T	8	7	15	0	0	15	0	0
20	60894470	rs2297588	C	T	7	12	19	0	1	20	0	0
20	60895697	rs2297587	C	T	5	6	11	0	0	11	0	0
20	60899182	rs11698080	C	T	9	8	17	0	0	17	0	0
20	60899206	rs2427283	C	T	8	8	16	0	0	16	0	0
20	60903419	rs7262393	C	T	8	4	12	0	0	12	0	0
20	60905878	rs3810548	A	G	7	2	9	0	0	9	0	0
20	60907675	rs6142734	G	A	4	4	8	0	0	8	0	0
20	60908964	rs13044266	G	A	6	0	6	0	0	6	0	0
20	60908969	rs13042941	T	C	6	0	6	0	0	6	0	0
20	60909060	rs13038331	A	G	6	4	10	0	0	10	0	0
20	60909316	rs6062223	C	T	5	2	7	0	0	7	0	0
20	60912683	rs2427289	T	C	6	5	11	0	0	11	0	0
20	60921643	rs4925229	T	C	6	4	10	0	0	10	0	0
20	60927412	rs624313	G	A	4	3	7	0	0	7	0	0
20	60962624	rs755726	T	C	10	14	24	0	0	24	0	0
20	60963055	rs911077	T	C	8	23	31	0	0	31	0	0
20	60964064	rs8668	A	G	21	17	38	0	0	38	0	0
20	60968596	rs1570027	A	G	13	8	21	0	0	21	0	0
20	60973432	rs62196294	T	G	4	2	6	0	0	6	0	0
20	61302510	rs6062771	C	T	5	4	9	0	0	9	0	0
20	61302834	rs73145493	C	T	6	3	9	0	0	9	0	0
20	61467800	rs760087	A	G	7	3	10	0	0	10	0	0
20	61468571	rs2294995	T	C	5	6	11	0	0	11	0	0
20	61472808	rs1046784	G	C	8	6	14	0	0	14	0	0
20	61475824	rs8116995	A	G	9	4	13	0	0	13	0	0
20	61483739	rs111540074	A	G	4	5	9	0	0	9	0	0
20	61484142	rs73157353	A	G	7	6	13	0	0	13	0	0
20	61491494	rs17854409	T	C	13	15	28	0	0	28	0	0
20	61528074	rs910149	T	C	5	4	9	0	0	9	0	0
20	61528271	rs1883847	C	T	6	4	10	0	0	10	0	0
20	61528306	rs1883848	A	G	6	6	12	0	0	12	0	0
20	61537999	rs6010781	C	T	18	12	30	0	0	30	0	0
20	61538069	.	G	T	16	0	16	0	1	17	0	0
20	61538090	rs6011465	G	A	16	11	27	0	0	27	0	0
20	61538110	rs6011466	C	T	13	12	25	0	0	25	0	0
20	61540319	rs6010784	T	C	12	10	22	0	0	22	0	0
20	61541028	rs2295001	C	G	6	5	11	0	0	11	0	0
20	61553980	rs1079074	A	G	3	3	6	0	0	6	0	0
20	61561153	rs6010789	G	A	5	2	7	0	1	8	0	0
20	61564901	rs73619441	T	G	3	3	6	0	0	6	0	0
20	61565511	rs749813	C	T	2	4	6	0	0	6	0	0
20	61567076	rs998086	C	T	5	1	6	0	0	6	0	0
20	61571721	rs6062380	A	G	3	7	10	0	0	10	0	0
20	61571723	rs6062381	A	G	2	7	9	0	1	10	0	0
20	61573062	rs76902055	C	T	11	5	16	0	0	16	0	0
20	61576777	rs1052826	A	G	160	127	287	0	3	290	0	0
20	61588159	rs2245341	A	G	66	43	109	0	1	110	0	0
20	61598731	rs7271712	C	T	83	111	194	0	2	196	0	0
20	61847068	rs6090310	C	G	3	4	7	0	0	7	0	0
20	61909041	rs6011715	A	G	5	5	10	0	0	10	0	0
20	61914465	rs911065	A	G	19	17	36	0	0	36	0	0
20	61915375	rs11086161	G	T	14	8	22	0	0	22	0	0
20	61916286	rs73153583	C	A	4	5	9	0	0	9	0	0
20	61916379	rs13042357	C	T	8	4	12	0	0	12	0	0
20	62121820	rs45510898	G	A	3	3	6	0	0	6	0	0
20	62126185	rs310617	A	G	3	7	10	0	0	10	0	0
20	62189554	rs548106818	G	A	8	10	18	0	0	18	0	0
20	62190345	rs310627	G	A	26	28	54	0	0	54	0	0
20	62190402	rs4809581	T	C	28	20	48	0	1	49	0	0
20	62190459	rs45515601	C	G	25	10	35	0	0	35	0	0
20	62191321	rs3810477	A	G	18	19	37	0	0	37	0	0
20	62193019	rs11551684	C	T	19	11	30	0	1	31	0	0
20	62193445	rs3810481	G	A	12	6	18	0	0	18	0	0
20	62194030	rs3810483	G	C	10	6	16	0	0	16	0	0
20	62194103	rs3810484	A	G	8	1	9	0	0	9	0	0
20	62194713	rs3810486	A	C	9	1	10	0	0	10	0	0
20	62195087	rs310630	A	G	7	10	17	0	0	17	0	0
20	62195220	rs3827022	C	T	5	1	6	0	0	6	0	0
20	62195672	rs3827023	C	T	4	3	7	0	0	7	0	0
20	62196182	rs3810488	G	C	7	9	16	0	0	16	0	0
20	62196253	rs310631	C	A	10	16	26	0	0	26	0	0
20	62198236	rs415304	G	A	8	8	16	0	0	16	0	0
20	62200576	rs6090457	G	A	9	2	11	0	0	11	0	0
20	62202301	rs3746346	A	G	5	1	6	0	0	6	0	0
20	62219679	rs6089929	C	T	76	116	192	0	2	194	0	0
20	62219740	rs3810492	G	A	87	125	212	0	0	212	0	0
20	62221249	rs311497	A	G	54	58	112	0	2	114	0	0
20	62221364	rs2297427	G	A	72	76	148	0	0	148	0	0
20	62221766	rs2297428	C	T	63	68	131	0	0	131	0	0
20	62224595	rs2236503	G	A	2	4	6	0	0	6	0	0
20	62225508	rs16983844	G	A	1	7	8	0	0	8	0	0
20	62227180	rs2282157	C	G	1	5	6	0	0	6	0	0
20	62228745	rs4809310	G	A	3	5	8	0	0	8	0	0
20	62229989	rs381331	G	A	5	4	9	0	0	9	0	0
20	62230576	rs3787107	G	A	3	5	8	0	1	9	0	0
20	62230706	rs453481	G	A	7	4	11	0	0	11	0	0
20	62230933	rs445328	G	A	1	5	6	0	0	6	0	0
20	62230974	rs432717	G	A	1	6	7	0	0	7	0	0
20	62232342	rs384683	T	C	6	0	6	0	0	6	0	0
20	62233020	rs34533955	A	C	4	3	7	0	0	7	0	0
20	62233190	rs1151619	C	T	4	7	11	0	0	12	1	0
20	62233638	rs35897249	G	A	5	4	9	0	0	9	0	0
20	62233764	rs4809311	G	T	2	5	7	0	0	7	0	0
20	62234240	rs4809312	C	T	12	5	17	0	0	17	0	0
20	62234858	rs6090470	C	A	8	3	11	0	0	11	0	0
20	62258892	rs35096459	C	G	22	16	38	0	0	38	0	0
20	62272583	rs3865523	G	T	38	51	89	0	6	95	0	0
20	62272658	rs2150910	T	C	67	96	163	0	2	165	0	0
20	62290663	rs2297432	C	T	21	19	40	0	1	41	0	0
20	62312497	rs4809323	A	G	3	3	6	0	0	6	0	0
20	62320968	rs6062302	T	C	13	24	37	0	0	37	0	0
20	62321655	rs2236506	G	A	24	20	44	0	0	44	0	0
20	62322288	rs3208007	T	C	13	21	34	0	1	35	0	0
20	62326110	rs3208008	A	C	20	26	46	0	2	48	0	0
20	62327582	rs2297441	G	A	8	12	20	0	0	20	0	0
20	62328267	rs2257440	C	T	19	24	43	0	0	43	0	0
20	62328453	rs2258056	T	C	16	12	28	0	0	28	0	0
20	62328742	rs909341	C	T	47	32	79	0	2	81	0	0
20	62328829	rs1291205	C	G	50	29	79	0	1	80	0	0
20	62329099	rs6062496	G	A	9	6	15	0	0	15	0	0
20	62329169	rs1291206	G	A	7	11	18	0	0	18	0	0
20	62329412	rs1291207	G	A	11	18	29	0	0	29	0	0
20	62329579	.	C	T	4	9	13	0	0	13	0	0
20	62331989	rs1048665	T	G	35	27	62	0	2	64	0	0
20	62365556	rs1151622	A	G	26	34	60	0	2	62	0	0
20	62365866	rs2427533	C	T	22	19	41	0	0	41	0	0
20	62366478	rs2427534	A	G	4	4	8	0	0	8	0	0
20	62368277	.	C	G	5	3	8	0	0	8	0	0
20	62369300	rs914559	C	G	6	9	15	0	0	15	0	0
20	62370349	rs1056441	T	C	4	7	11	0	0	11	0	0
20	62372041	rs1741708	G	T	11	9	20	0	0	20	0	0
20	62372148	rs6062510	G	C	4	12	16	0	0	16	0	0
20	62372706	rs4809221	G	A	9	20	29	0	1	30	0	0
20	62373707	rs8957	G	T	206	211	417	0	2	419	0	0
20	62373983	rs2256814	G	A	9	14	23	0	0	23	0	0
20	62374389	rs1058319	C	T	142	124	266	0	7	273	0	0
20	62376227	rs2427537	T	C	7	4	11	0	0	11	0	0
20	62376329	.	C	T	4	4	8	0	1	9	0	0
20	62376939	rs2296763	A	C	4	6	10	0	0	10	0	0
20	62492772	rs6011193	C	G	6	8	14	0	0	14	0	0
20	62492922	rs2281534	T	A	4	7	11	0	0	11	0	0
20	62517744	.	T	C	13	8	21	0	0	21	0	0
20	62517867	rs190527325	G	A	5	6	11	0	0	11	0	0
20	62517997	rs148195991	C	T	9	13	22	0	2	24	0	0
20	62518441	rs3795154	C	T	17	18	35	0	0	35	0	0
20	62518689	rs3795155	C	G	18	22	40	0	0	40	0	0
20	62518729	rs3795156	A	G	19	22	41	0	0	41	0	0
20	62518766	rs3795157	C	T	21	19	40	0	0	40	0	0
20	62520671	rs6062569	T	C	7	2	9	0	0	9	0	0
20	62520674	rs6010690	G	T	8	2	10	0	0	10	0	0
20	62521657	rs11556473	A	G	312	291	603	0	1	604	0	0
20	62522466	rs7000	A	G	325	309	634	0	8	642	0	0
20	62529985	rs6011211	G	A	4	2	6	0	0	6	0	0
20	62565129	rs11554631	C	T	62	59	121	0	0	121	0	0
20	62573064	rs817370	T	C	14	15	29	0	1	30	0	0
20	62577209	.	A	G	86	100	186	0	1	187	0	0
20	62595169	rs817325	A	G	33	31	64	0	0	64	0	0
20	62597694	rs817329	T	G	26	29	55	0	0	55	0	0
20	62599357	rs56015416	C	T	5	2	7	0	1	8	0	0
20	62605984	rs817339	G	A	17	9	26	0	0	26	0	0
20	62606024	rs817340	C	A	15	5	20	0	0	20	0	0
20	62606765	rs817341	C	T	6	8	14	0	0	14	0	0
20	62607160	rs817343	C	T	3	6	9	0	1	10	0	0
20	62609670	rs817348	A	G	4	9	13	0	0	13	0	0
20	62609766	rs817349	C	T	6	5	11	0	0	11	0	0
20	62610447	rs817351	T	C	4	2	6	0	0	6	0	0
20	62641575	rs2427588	G	A	110	128	238	0	1	240	1	0
20	62661027	rs816932	G	C	6	9	15	0	0	15	0	0
20	62662515	rs816933	T	G	7	10	17	0	0	17	0	0
20	62663048	rs28680252	C	A	3	3	6	0	2	8	0	0
20	62663143	rs816934	G	C	11	11	22	0	0	22	0	0
20	62714783	rs6010717	C	G	7	6	13	0	0	13	0	0
20	62730678	rs6010721	T	G	5	6	11	0	0	11	0	0
20	62896665	rs17878941	G	A	16	14	30	0	0	30	0	0
20	62905851	rs41279358	C	A	20	25	45	0	0	45	0	0
20	62906433	rs11907846	T	C	13	19	32	0	0	32	0	0
20	62906514	rs10485816	G	A	24	12	36	0	0	36	0	0
21	15599466	rs7280643	A	G	2	4	6	0	0	6	0	0
21	15685452	rs887772	T	G	5	1	6	0	0	6	0	0
21	15744767	rs11088017	G	A	87	86	173	0	1	174	0	0
21	15744859	rs78283728	C	T	53	60	113	0	1	114	0	0
21	15745122	rs7275514	G	T	25	24	49	0	0	49	0	0
21	15745890	rs17002670	G	A	135	100	235	0	0	235	0	0
21	15749857	rs6516754	G	T	6	3	9	0	0	9	0	0
21	15754578	rs2822648	A	G	3	3	6	0	0	6	0	0
21	15859450	rs406209	C	T	23	15	38	0	1	39	0	0
21	15863523	rs415503	G	A	8	2	10	0	1	11	0	0
21	15867135	rs405792	T	A	6	21	27	0	0	27	0	0
21	15867746	rs2822704	G	A	24	6	30	0	0	30	0	0
21	15867826	rs427307	C	T	12	20	32	0	1	33	0	0
21	15868095	rs2822705	G	T	52	29	81	0	1	82	0	0
21	15869061	rs67163592	T	C	21	12	33	0	0	33	0	0
21	15869685	rs7276231	A	G	11	3	14	0	0	14	0	0
21	15870171	rs13051520	C	T	6	13	19	0	0	19	0	0
21	15870638	rs2274796	C	T	9	3	12	0	0	12	0	0
21	15873448	rs115962266	A	G	2	14	16	0	0	16	0	0
21	15884949	rs3761320	A	T	8	12	20	0	0	20	0	0
21	15884955	rs3761321	A	T	6	10	16	0	0	16	0	0
21	15885034	rs8127371	T	A	4	6	10	0	0	10	0	0
21	15885104	rs2049857	C	T	4	10	14	0	0	14	0	0
21	15885238	rs75237614	T	C	11	40	51	0	0	51	0	0
21	15886616	rs2822711	T	C	11	22	33	0	0	33	0	0
21	15886950	rs7282220	A	G	10	23	33	0	1	34	0	0
21	15886991	rs7282239	A	C	10	24	34	0	1	35	0	0
21	15887223	rs6516844	T	C	11	21	32	0	0	32	0	0
21	15887545	rs991249	A	G	6	18	24	0	0	24	0	0
21	15887747	rs2049859	A	T	4	9	13	0	0	13	0	0
21	15889304	rs34607574	C	G	244	348	592	0	5	598	1	0
21	15890220	rs2822715	T	C	11	9	20	0	0	20	0	0
21	15890874	rs2822716	G	A	5	5	10	0	1	11	0	0
21	15893134	rs2822719	G	C	10	7	17	0	0	17	0	0
21	15916715	rs141135461	A	G	3	4	7	0	0	7	0	0
21	15970716	rs466541	A	G	2	4	6	0	0	6	0	0
21	16338060	.	C	T	212	190	402	0	0	402	0	0
21	16352710	.	G	A	5	2	7	0	0	7	0	0
21	18968320	rs9977638	C	T	3	8	11	0	0	11	0	0
21	18971359	rs7276872	A	C	4	11	15	0	0	15	0	0
21	18973620	rs35432050	G	A	6	14	20	0	0	20	0	0
21	18976385	rs67787603	C	A	2	5	7	0	1	8	0	0
21	18978176	rs2824389	G	C	17	18	35	0	0	35	0	0
21	18978429	rs7349019	G	C	4	2	6	0	0	6	0	0
21	18980268	rs2824397	C	A	3	10	13	0	0	13	0	0
21	19161548	rs243608	C	T	167	44	211	0	4	215	0	0
21	19163707	rs7277763	C	T	41	25	66	0	0	66	0	0
21	19163805	rs2257907	T	C	51	36	87	0	1	88	0	0
21	19164528	rs1062204	C	G	20	19	39	0	0	39	0	0
21	19164642	rs1062202	A	G	21	18	39	0	0	39	0	0
21	19164911	rs2220511	C	T	35	25	60	0	0	60	0	0
21	19165090	rs1352601	C	T	5	6	11	0	0	11	0	0
21	19169218	rs2824495	G	C	132	70	202	0	2	204	0	0
21	19182996	rs61323262	G	A	6	6	12	0	1	13	0	0
21	19186238	rs243555	A	G	3	3	6	0	0	6	0	0
21	19186614	rs12627264	G	A	5	6	11	0	1	12	0	0
21	19190427	rs243556	C	T	13	9	22	0	1	23	0	0
21	19191317	rs2298674	C	T	2	6	8	0	0	8	0	0
21	20230102	rs2825212	C	T	130	0	130	0	6	136	0	0
21	21629450	rs9974943	A	G	24	20	44	0	0	44	0	0
21	21630425	rs2826108	C	T	11	7	18	0	0	18	0	0
21	21630537	rs2826109	C	T	12	11	23	0	0	23	0	0
21	21630788	rs2826110	G	T	8	7	15	0	1	16	0	0
21	27840297	rs2830239	G	A	30	54	84	0	0	84	0	0
21	27933810	rs62216528	C	T	5	12	17	0	0	17	0	0
21	30341891	rs2254796	A	G	7	4	11	0	0	11	0	0
21	30422543	rs116927602	A	G	7	7	14	0	0	14	0	0
21	30444607	rs71319483	T	C	6	3	9	0	0	9	0	0
21	30717151	rs368322	C	T	127	109	236	0	0	236	0	0
21	30718201	rs15092	G	A	70	58	128	0	0	128	0	0
21	32492492	rs2070409	T	C	2	5	7	0	0	7	0	0
21	32493031	rs762194	A	G	2	4	6	0	0	6	0	0
21	33040654	rs117304270	G	C	9	4	13	0	0	13	0	0
21	33068962	rs7280330	T	C	36	46	82	0	1	83	0	0
21	33069126	rs11701923	T	C	5	4	9	0	0	9	0	0
21	33074633	rs2202128	A	G	37	36	73	0	0	73	0	0
21	33641152	rs8129993	A	G	37	29	66	0	0	66	0	0
21	33686548	rs1128337	C	T	3	5	8	0	0	8	0	0
21	33688865	rs7279896	A	G	3	4	7	0	1	8	0	0
21	33694586	rs2833766	A	T	5	7	12	0	0	12	0	0
21	33695165	rs9983465	G	A	3	4	7	0	0	7	0	0
21	33717877	rs2833779	G	A	2	7	9	0	0	9	0	0
21	33719400	rs9981151	A	G	5	4	9	0	0	9	0	0
21	33750771	.	T	C	5	4	9	0	0	9	0	0
21	33755763	rs2833795	G	A	3	4	7	0	0	7	0	0
21	33765496	rs112644530	A	C	8	13	21	0	0	21	0	0
21	33765560	rs11702306	C	T	16	39	55	0	1	56	0	0
21	33951068	rs9622	T	C	4	2	6	0	0	6	0	0
21	34001496	rs13554	G	A	76	67	143	0	1	144	0	0
21	34058996	rs844974	C	T	6	1	7	0	0	7	0	0
21	34059207	rs844975	C	T	6	2	8	0	0	8	0	0
21	34059352	rs2254562	T	C	9	15	24	0	0	24	0	0
21	34071893	rs1783099	T	G	3	5	8	0	0	8	0	0
21	34111230	rs8129734	G	C	7	7	14	0	0	14	0	0
21	34111945	rs74887393	C	T	4	3	7	0	0	7	0	0
21	34113480	rs73196252	C	T	4	3	7	0	0	7	0	0
21	34128717	rs7279405	G	A	9	7	16	0	0	16	0	0
21	34443760	rs11554599	C	T	3	5	8	0	0	8	0	0
21	34602305	rs17860115	C	A	9	5	14	0	0	14	0	0
21	34614250	rs2229207	T	C	21	44	65	0	1	66	0	0
21	34614255	rs1051393	T	G	24	44	68	0	0	68	0	0
21	34625037	rs147496374	C	G	60	51	111	0	1	112	0	0
21	34634878	rs1131668	G	A	50	48	98	0	0	98	0	0
21	34638031	rs999788	C	T	5	6	11	0	0	11	0	0
21	34640788	rs2834167	A	G	13	31	44	0	0	44	0	0
21	34696867	rs16997869	C	T	13	6	19	0	0	19	0	0
21	34800872	rs8130924	A	G	6	9	15	0	0	15	0	0
21	34801876	rs8128362	T	C	4	6	10	0	0	10	0	0
21	34804966	rs1532	T	C	16	28	44	0	1	45	0	0
21	34821807	rs1044195	C	T	31	39	70	0	1	71	0	0
21	34822452	rs2834218	T	C	9	7	16	0	0	16	0	0
21	34822511	rs13047361	C	T	14	15	29	0	1	30	0	0
21	34822582	rs11088254	A	G	13	16	29	0	0	29	0	0
21	34833329	rs2248355	G	A	7	5	12	0	0	12	0	0
21	34833553	rs2834228	T	C	4	5	9	0	0	9	0	0
21	34834938	rs35531797	C	A	3	3	6	0	0	6	0	0
21	34836091	rs13046185	A	C	2	4	6	0	0	6	0	0
21	34877070	rs7283354	T	C	3	3	6	0	0	6	0	0
21	34883618	rs8971	T	C	27	18	45	0	0	45	0	0
21	34896962	rs1804385	C	G	10	11	21	0	0	21	0	0
21	34897113	rs8788	C	T	30	29	59	0	0	59	0	0
21	34924243	rs16990760	T	C	92	83	175	0	0	175	0	0
21	34925689	rs61739710	G	A	167	177	344	0	3	347	0	0
21	34926260	rs13047599	C	T	174	178	352	0	3	355	0	0
21	34929422	rs2070389	T	C	3	3	6	0	0	6	0	0
21	34945721	rs3174808	T	C	43	52	95	0	0	95	0	0
21	34988745	rs6517184	T	C	24	27	51	0	0	51	0	0
21	35277080	rs13052095	T	C	5	8	13	0	0	13	0	0
21	35279500	rs62226669	G	A	7	6	13	0	1	14	0	0
21	35279604	rs62226670	T	C	15	6	21	0	1	22	0	0
21	35281113	rs2834295	C	T	5	4	9	0	0	9	0	0
21	35281183	rs2040113	G	A	5	2	7	0	0	7	0	0
21	35281421	rs4842	T	C	1161	1169	2330	0	13	2343	0	0
21	35286999	rs2284572	T	C	2	6	8	0	0	8	0	0
21	35447840	rs139406961	G	C	8	2	10	0	0	10	0	0
21	35466375	rs2834378	C	G	5	4	9	0	0	9	0	0
21	35474410	rs2244724	G	A	7	5	12	0	0	12	0	0
21	35515117	rs7115	G	A	48	51	99	0	0	99	0	0
21	35774898	rs8742	C	T	5	1	6	0	0	6	0	0
21	36163294	rs55744508	G	T	119	122	241	0	2	243	0	0
21	36164405	rs13051066	G	T	6	0	6	0	0	6	0	0
21	36165041	rs11700756	T	C	12	14	26	0	1	27	0	0
21	36186396	rs2834643	A	G	4	3	7	0	0	7	0	0
21	36187686	rs2834645	T	C	1	5	6	0	0	6	0	0
21	36198190	rs73201053	A	G	25	19	44	0	1	45	0	0
21	36203846	rs2246738	G	A	8	8	16	0	2	18	0	0
21	36205452	rs139200660	G	C	7	8	15	0	0	15	0	0
21	36227547	rs77367874	T	A	6	3	9	0	0	9	0	0
21	36229637	rs2834652	G	A	5	1	6	0	0	6	0	0
21	36232156	rs2248720	C	A	11	10	21	0	0	21	0	0
21	36233176	rs4817696	T	C	7	4	11	0	0	11	0	0
21	36233756	rs79760373	T	G	7	10	17	0	0	17	0	0
21	36234423	rs76826924	G	C	6	6	12	0	0	12	0	0
21	36234697	rs74493943	T	C	7	7	14	0	1	15	0	0
21	36235047	rs1003574	G	T	5	4	9	0	0	9	0	0
21	36235311	rs2834654	T	C	6	7	13	0	0	13	0	0
21	36235341	rs138807819	A	G	10	7	17	0	0	17	0	0
21	36235568	rs9979015	C	A	17	10	27	0	0	27	0	0
21	36235739	rs2251826	A	G	14	4	18	0	0	18	0	0
21	36258223	rs2734472	T	C	7	7	14	0	0	14	0	0
21	36340396	rs2834702	G	A	6	29	35	0	0	35	0	0
21	36340816	rs9974986	T	C	8	20	28	0	0	28	0	0
21	36340856	rs2834703	C	T	3	14	17	0	0	17	0	0
21	36341040	rs9975183	T	C	19	2	21	0	1	22	0	0
21	36341045	rs9975188	T	C	20	2	22	0	0	22	0	0
21	36386727	rs2834732	C	T	6	7	13	0	0	13	0	0
21	36386766	rs2242885	C	T	7	9	16	0	0	16	0	0
21	36410908	.	C	G	5	1	6	0	0	6	0	0
21	36410910	.	C	G	4	2	6	0	0	6	0	0
21	36421036	rs8133634	T	C	2	7	9	0	0	9	0	0
21	37529180	rs11088341	C	G	5	4	9	0	0	9	0	0
21	37709667	rs2835337	A	C	3	5	8	0	0	8	0	0
21	37733063	rs2835340	T	C	2	4	6	0	0	6	0	0
21	40378632	rs2836822	G	A	3	5	8	0	0	8	0	0
21	40548087	rs2245455	A	T	6	2	8	0	0	8	0	0
21	40548852	rs12482181	A	G	2	4	6	0	0	6	0	0
21	40548855	rs34176878	C	A	2	4	6	0	0	6	0	0
21	40549466	rs14194	T	C	302	331	633	0	1	634	0	0
21	40551588	rs6517521	A	G	17	9	26	0	0	26	0	0
21	40551943	rs34227163	A	G	5	11	16	0	0	16	0	0
21	40552307	rs3171465	A	G	213	198	411	0	1	412	0	0
21	40552408	rs7280375	A	G	9	13	22	0	0	22	0	0
21	40553845	rs6517522	T	C	6	7	13	0	0	13	0	0
21	40553980	rs1571709	T	C	4	7	11	0	0	11	0	0
21	40554355	rs4817999	C	A	20	14	34	0	0	34	0	0
21	40554693	rs73221193	C	T	9	4	13	0	0	13	0	0
21	40555160	rs34294410	C	G	3	6	9	0	0	9	0	0
21	40555351	rs13052882	G	C	20	24	44	0	0	44	0	0
21	40558421	rs2297256	G	A	27	26	53	0	0	53	0	0
21	40560262	rs11910151	T	C	10	6	16	0	0	16	0	0
21	40561012	rs13048178	G	T	3	3	6	0	0	6	0	0
21	40564202	rs2836933	C	G	5	7	12	0	0	12	0	0
21	40564885	rs2836934	A	C	9	2	11	0	0	11	0	0
21	40567716	rs1065242	C	G	36	16	52	0	0	52	0	0
21	40574305	rs2183573	A	G	14	15	29	0	0	29	0	0
21	40652142	rs2836972	G	A	6	3	9	0	0	9	0	0
21	40669083	rs13625	G	T	67	72	139	0	1	140	0	0
21	40670460	rs2056844	G	C	63	71	134	0	1	135	0	0
21	40676307	rs719230	C	T	27	26	53	0	0	53	0	0
21	40677046	rs35769610	T	C	3	3	6	0	0	6	0	0
21	40683740	rs62223042	A	G	12	19	31	0	0	31	0	0
21	40685662	rs11910906	T	C	5	2	7	0	0	7	0	0
21	40714478	rs3167757	C	T	1645	1244	2889	0	33	2922	0	0
21	40715175	rs2776308	A	G	1	7	8	0	0	8	0	0
21	40715313	rs2735309	C	T	7	6	13	0	1	14	0	0
21	40715519	rs2070865	C	T	12	12	24	0	0	24	0	0
21	40715791	rs2776309	A	G	11	12	23	0	0	23	0	0
21	40715946	rs12482979	C	T	9	5	14	0	0	14	0	0
21	40715947	rs9980890	A	G	9	5	14	0	0	14	0	0
21	40716075	rs2989329	A	G	4	2	6	0	0	6	0	0
21	40717478	rs914156	C	A	15	18	33	0	0	34	1	0
21	40718440	rs741795	T	C	30	23	53	0	0	53	0	0
21	40718518	rs2776312	A	G	47	68	115	0	0	115	0	0
21	40719027	rs2249651	A	G	62	62	124	0	7	131	0	0
21	40719241	rs2249666	C	T	27	22	49	0	1	50	0	0
21	40763895	rs2837001	T	C	2	5	7	0	0	7	0	0
21	40769017	rs1060180	G	T	40	24	64	0	2	66	0	0
21	40769290	rs13230	A	G	15	9	24	0	0	24	0	0
21	42519356	rs2837963	T	C	3	20	23	0	0	23	0	0
21	42597387	rs28629220	T	C	4	2	6	0	0	6	0	0
21	42622786	rs1046210	C	T	141	142	283	0	0	283	0	0
21	42647821	rs12149	C	T	50	95	145	0	2	147	0	0
21	42742212	rs398800	C	A	3	7	10	0	0	10	0	0
21	42742529	rs371453	A	G	1	6	7	0	0	7	0	0
21	42748952	rs139890954	C	T	7	1	8	0	0	8	0	0
21	42780200	rs73370182	A	G	7	1	8	0	0	8	0	0
21	42803840	rs456657	C	T	2	4	6	0	0	6	0	0
21	42830792	rs116752870	C	T	5	6	11	0	0	11	0	0
21	43219728	rs2298642	A	T	2	4	6	0	0	6	0	0
21	43220380	rs2236692	C	A	5	6	11	0	1	12	0	0
21	43220724	rs2838127	G	C	4	5	9	0	0	9	0	0
21	43236107	rs114337111	C	T	4	2	6	0	0	6	0	0
21	43305435	rs3168	C	T	5	9	14	0	0	14	0	0
21	43306075	rs2236439	G	C	3	4	7	0	0	7	0	0
21	43306101	rs2236440	A	G	3	3	6	0	0	6	0	0
21	43307329	rs2282109	A	G	3	3	6	0	0	6	0	0
21	43307900	rs2839402	C	T	2	4	6	0	0	6	0	0
21	43408618	rs2839430	T	A	4	8	12	0	0	12	0	0
21	43422525	rs928874	C	T	25	33	58	0	1	59	0	0
21	43424864	rs117594012	G	A	10	5	15	0	0	15	0	0
21	43428025	rs7277270	G	C	4	5	9	0	0	9	0	0
21	43431575	rs1054526	C	T	18	29	47	0	1	48	0	0
21	43650779	rs3827225	G	A	10	8	18	0	0	18	0	0
21	43713779	rs62651390	C	T	6	3	9	0	0	9	0	0
21	43714579	rs474142	G	A	4	3	7	0	0	7	0	0
21	43716022	rs3788010	G	A	9	6	15	0	0	15	0	0
21	43716901	rs1044317	A	G	17	25	42	0	1	43	0	0
21	43944573	rs875061	C	T	5	1	6	0	0	6	0	0
21	43954542	rs228055	T	C	3	5	8	0	0	8	0	0
21	43981658	rs12483424	G	A	11	0	11	0	0	11	0	0
21	43985955	rs228104	G	A	38	35	73	0	1	74	0	0
21	43987326	rs113853144	C	T	12	7	19	0	0	19	0	0
21	43987329	rs9979646	G	C	11	7	18	0	0	18	0	0
21	43987470	rs113634156	G	A	10	10	20	0	1	21	0	0
21	43987480	rs112995017	A	G	10	9	19	0	1	20	0	0
21	43987550	rs2839554	T	A	5	5	10	0	0	10	0	0
21	43989391	rs9941856	T	C	6	9	15	0	0	15	0	0
21	43990079	rs116859718	G	A	3	4	7	0	1	8	0	0
21	43990322	rs111362590	A	G	7	6	13	0	1	14	0	0
21	43990435	rs3827236	G	C	3	6	9	0	0	9	0	0
21	43990441	rs3827237	T	C	3	6	9	0	0	9	0	0
21	43990699	rs3788032	A	C	4	10	14	0	1	15	0	0
21	43990726	rs113220497	T	C	5	11	16	0	0	16	0	0
21	43991025	rs111941720	C	G	11	12	23	0	1	24	0	0
21	43991319	rs2839558	A	G	9	10	19	0	0	19	0	0
21	43992088	rs112597933	C	T	1	5	6	0	0	6	0	0
21	43996236	rs113351722	A	G	2	5	7	0	0	7	0	0
21	43998296	rs365443	A	G	2	7	9	0	0	9	0	0
21	43998583	rs79536236	G	A	0	6	6	0	0	6	0	0
21	43999418	rs17767630	G	T	6	6	12	0	0	12	0	0
21	43999896	.	G	A	42	24	66	0	1	67	0	0
21	43999983	rs453592	T	C	2	5	7	0	0	7	0	0
21	44000366	rs388907	A	G	3	5	8	0	0	8	0	0
21	44000861	rs17178345	A	G	39	35	74	0	0	74	0	0
21	44000901	rs390840	A	G	46	49	95	0	1	96	0	0
21	44001064	rs454849	T	C	68	73	141	0	2	143	0	0
21	44001164	rs398717	A	G	68	97	165	0	2	167	0	0
21	44189166	rs1045382	T	C	6	6	12	0	0	12	0	0
21	44189172	rs3087994	A	C	6	6	12	0	0	12	0	0
21	44263239	rs112475042	C	T	7	2	9	0	0	9	0	0
21	44269518	.	C	T	15	19	34	0	0	34	0	0
21	44269654	rs2156314	C	T	10	18	28	0	0	28	0	0
21	44269743	rs7281655	A	G	19	10	29	0	0	29	0	0
21	44269860	rs60406170	A	C	9	8	17	0	0	17	0	0
21	44270229	rs6586250	C	T	22	18	40	0	0	40	0	0
21	44270309	rs17115515	G	A	21	22	43	0	0	43	0	0
21	44273763	rs61729406	G	A	25	25	50	0	0	50	0	0
21	44273858	rs15736	G	A	22	27	49	0	2	51	0	0
21	44283574	rs11911090	C	T	16	25	41	0	0	41	0	0
21	44293744	rs2248490	C	G	18	20	38	0	1	39	0	0
21	44310364	rs11203163	G	A	5	7	12	0	0	12	0	0
21	44310374	rs73233322	G	A	6	7	13	0	0	13	0	0
21	44310630	rs11203164	A	G	8	8	16	0	0	16	0	0
21	44311517	rs13047779	C	T	8	12	20	0	0	20	0	0
21	44312597	rs1316879	G	A	5	4	9	0	0	9	0	0
21	44331677	rs4920009	T	C	13	13	26	0	0	26	0	0
21	44331724	rs4920010	C	G	20	15	35	0	1	36	0	0
21	44450938	rs3403	T	C	4	2	6	0	0	6	0	0
21	44451057	rs17179001	G	A	4	3	7	0	0	7	0	0
21	44452813	rs234738	A	G	4	3	7	0	0	7	0	0
21	44452838	rs234739	C	A	4	3	7	0	0	7	0	0
21	44452948	rs234740	G	C	3	3	6	0	0	6	0	0
21	44453277	rs438889	C	T	3	5	8	0	0	8	0	0
21	44453278	rs373477	A	G	3	5	8	0	0	8	0	0
21	44453372	rs7936	G	C	2	4	6	0	0	6	0	0
21	44473867	rs1051319	G	C	6	7	13	0	0	13	0	0
21	44473980	rs9978104	G	T	11	6	17	0	0	17	0	0
21	44518921	rs181223814	T	C	27	21	48	0	1	49	0	0
21	44836213	rs229343	C	T	256	218	474	0	6	480	0	0
21	44837829	rs229345	C	T	4	10	14	0	0	14	0	0
21	44838661	rs492340	C	T	3	8	11	0	0	11	0	0
21	44841036	rs2006191	A	G	6	13	19	0	0	19	0	0
21	44841052	rs2006112	T	C	7	14	21	0	1	22	0	0
21	45096206	rs2155722	G	A	54	42	96	0	2	98	0	0
21	45107562	rs9306160	T	C	25	22	47	0	2	49	0	0
21	45108987	rs2236665	C	A	13	15	28	0	1	29	0	0
21	45109856	rs2236666	T	C	9	15	24	0	0	24	0	0
21	45109972	rs2838350	T	C	10	12	22	0	0	22	0	0
21	45113629	rs762400	C	G	6	7	13	0	0	13	0	0
21	45173068	rs59255746	T	A	5	1	6	0	0	6	0	0
21	45174041	rs7276848	C	T	2	4	6	0	0	6	0	0
21	45175958	rs7527	T	C	64	61	125	0	2	127	0	0
21	45176268	rs8126928	T	C	10	6	16	0	0	16	0	0
21	45176304	rs2070535	T	C	8	7	15	0	0	15	0	0
21	45176621	rs17004606	C	T	8	6	14	0	1	15	0	0
21	45177719	rs77753871	G	A	10	8	18	0	2	20	0	0
21	45178995	rs79015423	C	T	4	11	15	0	0	15	0	0
21	45180053	rs2018381	T	G	10	2	12	0	0	12	0	0
21	45180064	.	T	C	5	8	13	0	0	13	0	0
21	45180206	rs3211245	C	A	13	12	25	0	0	25	0	0
21	45180380	rs3211246	A	G	17	12	29	0	0	29	0	0
21	45180708	rs3204323	G	A	21	24	45	0	0	45	0	0
21	45181189	rs3194230	C	G	22	18	40	0	0	40	0	0
21	45181311	rs8377	G	A	19	14	33	0	0	33	0	0
21	45193990	rs9446	T	C	297	337	634	0	6	641	1	0
21	45217929	rs2838379	T	C	43	53	96	0	1	98	1	0
21	45219524	rs4566449	T	C	49	37	86	0	0	86	0	0
21	45220483	rs915770	A	G	44	42	86	0	1	87	0	0
21	45223060	rs2838385	C	T	7	4	11	0	0	11	0	0
21	45223930	rs2070539	C	T	9	10	19	0	0	19	0	0
21	45402820	rs13847	G	A	24	19	43	0	0	43	0	0
21	45502844	rs915877	T	G	147	102	249	0	1	250	0	0
21	45524814	.	C	T	9	6	15	0	0	15	0	0
21	45587936	rs57683928	C	T	18	8	26	0	1	27	0	0
21	45588012	rs9979788	G	A	8	7	15	0	2	17	0	0
21	45592258	rs116021723	G	A	2	4	6	0	0	6	0	0
21	45621560	rs2329709	G	A	2	6	8	0	0	8	0	0
21	45643008	rs1048710	A	G	25	40	65	0	3	68	0	0
21	45643396	rs2298565	G	C	58	68	126	0	1	127	0	0
21	45644504	rs8127114	T	C	25	41	66	0	1	67	0	0
21	45644950	rs4818887	T	C	31	21	52	0	0	52	0	0
21	45645307	rs4818888	C	T	20	26	46	0	0	46	0	0
21	45645308	rs4818889	A	G	21	26	47	0	0	47	0	0
21	45646256	rs4818890	C	A	28	24	52	0	1	54	1	0
21	45646698	rs6518352	A	G	23	36	59	0	0	59	0	0
21	45647202	rs4819387	C	T	53	46	99	0	0	99	0	0
21	45647421	rs4819388	T	C	46	53	99	0	3	102	0	0
21	45648992	rs7278940	T	C	28	20	48	0	1	49	0	0
21	45649209	rs7283769	A	G	24	18	42	0	1	43	0	0
21	45649778	rs4568033	A	G	15	16	31	0	0	31	0	0
21	45649848	rs13052840	T	C	13	10	23	0	0	23	0	0
21	45652514	rs2329716	C	T	3	5	8	0	0	8	0	0
21	45654725	rs2070556	C	T	6	6	12	0	0	12	0	0
21	45657302	rs55653035	C	T	6	2	8	0	0	8	0	0
21	45658538	rs55815224	C	T	4	3	7	0	0	7	0	0
21	45732116	rs1057034	C	T	172	183	355	0	3	358	0	0
21	45732173	.	G	A	223	215	438	0	2	440	0	0
21	45745416	rs9981333	G	A	23	25	48	0	0	48	0	0
21	45750248	rs11552067	G	A	11	13	24	0	0	24	0	0
21	45750346	rs2070573	C	A	37	7	44	0	0	44	0	0
21	45755004	.	T	C	7	9	16	0	0	16	0	0
21	45755360	rs2236441	C	T	11	10	21	0	0	21	0	0
21	45755808	rs62220411	G	A	3	3	6	0	0	6	0	0
21	45756069	rs66916924	T	C	4	4	8	0	0	8	0	0
21	45757905	rs2070572	T	C	4	4	8	0	0	8	0	0
21	45861790	rs1055540	T	C	26	33	59	0	0	59	0	0
21	46194919	.	C	A	11	8	19	0	0	19	0	0
21	46221715	.	C	T	5	8	13	0	0	13	0	0
21	46287765	.	T	A	4	5	9	0	0	9	0	0
21	46328026	rs3746973	G	A	206	3	209	0	0	209	0	0
21	46328099	rs760462	T	C	7	1	8	0	0	8	0	0
21	46328488	rs2011655	C	G	17	5	22	0	0	22	0	0
21	46328820	rs760460	C	T	11	0	11	0	0	11	0	0
21	46328835	rs760459	A	T	12	1	13	0	0	13	0	0
21	46329312	rs760457	T	C	21	2	23	0	1	24	0	0
21	46501346	rs3788154	G	A	2	4	6	0	0	6	0	0
21	46642162	rs12627516	A	G	4	2	6	0	0	6	0	0
21	46642764	rs2253763	T	C	7	12	19	0	1	20	0	0
21	46646005	rs2838820	T	C	36	35	71	0	0	71	0	0
21	46684517	rs2838859	C	T	52	50	102	0	0	102	0	0
21	46684904	rs2838860	A	G	50	62	112	0	0	112	0	0
21	46685175	rs11558445	A	G	48	61	109	0	1	110	0	0
21	46685909	rs2256000	T	C	10	11	21	0	0	21	0	0
21	46686494	rs6518220	T	C	9	10	19	0	0	19	0	0
21	46686499	rs6518221	A	G	9	10	19	0	0	19	0	0
21	46686619	rs2838861	C	T	10	11	21	0	0	21	0	0
21	46686726	rs2838862	C	T	10	15	25	0	1	26	0	0
21	46688690	rs200043293	G	A	5	4	9	0	0	9	0	0
21	46689140	.	C	T	7	2	9	0	0	9	0	0
21	46689546	rs140195034	A	C	5	1	6	0	0	6	0	0
21	46689547	rs150360740	T	C	5	1	6	0	0	6	0	0
21	46689999	rs2246697	G	A	7	10	17	0	0	17	0	0
21	46690633	rs8128636	G	T	1	11	12	0	0	12	0	0
21	46690968	rs2330102	C	G	5	14	19	0	1	20	0	0
21	46697820	rs914214	G	T	5	3	8	0	0	8	0	0
21	46698256	rs914215	T	C	0	9	9	0	0	9	0	0
21	46698298	rs914216	T	G	0	9	9	0	0	9	0	0
21	46698445	rs914218	G	C	2	5	7	0	0	7	0	0
21	46702553	rs2236450	T	C	3	4	7	0	0	7	0	0
21	46702822	rs74961332	A	G	0	8	8	0	0	8	0	0
21	46705354	rs75381084	C	T	6	28	34	0	1	35	0	0
21	46708930	rs73371030	T	C	6	3	9	0	0	9	0	0
21	46711357	rs4819053	T	C	4	4	8	0	1	9	0	0
21	46711474	rs2838864	T	A	3	3	6	0	0	6	0	0
21	46716848	rs1058229	C	G	5	3	8	0	0	8	0	0
21	46900703	.	C	T	27	35	62	0	0	62	0	0
21	46935311	.	C	T	16	10	26	0	0	26	0	0
21	47155316	rs914243	A	G	9	7	16	0	0	16	0	0
21	47329352	rs2277812	T	C	12	22	34	0	1	35	0	0
21	47352535	rs384068	C	T	9	2	11	0	0	11	0	0
21	47410331	rs201525908	G	A	5	12	17	0	0	17	0	0
21	47545768	rs1042917	G	A	5	3	8	0	0	8	0	0
21	47545823	rs13052956	G	A	7	4	11	0	0	11	0	0
21	47545826	rs13046639	C	T	7	4	11	0	0	11	0	0
21	47608710	rs76408279	C	T	5	1	6	0	0	6	0	0
21	47614553	rs35785446	G	A	36	50	86	0	0	86	0	0
21	47653422	rs8133857	T	C	5	2	7	0	0	7	0	0
21	47654301	rs16979001	C	T	1	5	6	0	0	6	0	0
21	47666332	rs2839169	A	G	11	7	18	0	1	19	0	0
21	47676711	rs2839173	G	A	23	18	41	0	0	41	0	0
21	47676837	rs17183017	C	T	24	24	48	0	1	49	0	0
21	47685939	rs2839181	A	G	26	18	44	0	0	44	0	0
21	47690068	rs2839186	C	T	5	2	7	0	0	7	0	0
21	47693014	rs55774624	G	A	5	3	8	0	0	8	0	0
21	47705237	rs17176131	T	C	7	14	21	0	0	21	0	0
21	47705673	rs17182538	C	A	5	7	12	0	0	12	0	0
21	47717616	rs8651	G	A	2	5	7	0	0	7	0	0
21	47721661	rs3747006	T	C	6	1	7	0	0	7	0	0
21	47754541	rs61735824	A	G	11	17	28	0	0	28	0	0
21	47754563	rs61735822	A	G	9	18	27	0	2	29	0	0
21	47773177	rs2249060	C	T	15	22	37	0	0	37	0	0
21	47777063	rs2839223	G	A	20	14	34	0	0	34	0	0
21	47783796	rs8131546	T	C	14	14	28	0	1	29	0	0
21	47786524	rs2839227	A	G	13	13	26	0	0	26	0	0
21	47786817	rs2839228	C	G	26	20	46	0	1	47	0	0
21	47787002	rs6518289	T	C	32	18	50	0	1	51	0	0
21	47808679	rs7279204	C	T	23	17	40	0	0	40	0	0
21	47808772	rs35044802	G	A	14	17	31	0	0	31	0	0
21	47821588	rs6518291	A	G	24	23	47	0	2	49	0	0
21	47831509	rs35940413	A	G	4	10	14	0	1	15	0	0
21	47836403	rs34151633	T	C	19	26	45	0	0	45	0	0
21	47836750	rs61738290	T	C	10	25	35	0	0	35	0	0
21	47850631	rs116217795	C	T	1	5	6	0	0	6	0	0
21	47851796	rs9983522	G	A	29	32	61	0	0	61	0	0
21	47855876	rs17371795	A	G	34	31	65	0	1	66	0	0
21	47862624	rs2839262	A	G	16	14	30	0	0	30	0	0
21	47863682	.	T	C	5	13	18	0	0	18	0	0
21	47864456	rs743347	G	A	13	19	32	0	2	34	0	0
21	47910523	rs7279002	A	G	10	12	22	0	0	22	0	0
21	47961711	rs2070435	G	A	26	17	43	0	0	43	0	0
21	47966016	rs4818845	C	G	6	6	12	0	0	12	0	0
21	47966977	rs16979358	C	T	10	6	16	0	0	16	0	0
21	47982389	rs117911182	G	T	1	6	7	0	0	7	0	0
21	47985655	rs2248636	C	T	10	8	18	0	0	18	0	0
21	47987412	rs146953731	G	A	11	9	20	0	1	21	0	0
21	47988364	rs8132624	C	T	9	9	18	0	0	18	0	0
21	48055602	rs2277829	G	T	25	18	43	0	0	43	0	0
22	17589246	rs879576	G	A	37	19	56	0	1	57	0	0
22	17590180	rs41323645	G	A	10	7	17	0	1	18	0	0
22	17628809	rs149569711	G	A	7	3	10	0	0	10	0	0
22	17630486	rs1034859	C	A	69	45	114	0	0	114	0	0
22	18075263	rs3532	T	C	330	296	626	0	6	632	0	0
22	18077829	rs1296821	G	T	6	1	7	0	0	7	0	0
22	18081136	rs2287228	G	A	4	2	6	0	0	6	0	0
22	18081156	rs2072555	G	T	6	5	11	0	0	11	0	0
22	18083167	rs5747251	C	T	4	4	8	0	0	8	0	0
22	18083197	rs41303851	T	C	6	3	9	0	0	9	0	0
22	18101834	rs5746446	C	T	8	5	13	0	0	13	0	0
22	18105027	.	G	A	5	2	7	0	0	7	0	0
22	18105306	rs9605349	C	G	16	2	18	0	0	18	0	0
22	18111431	rs7751	T	C	151	129	280	0	1	281	0	0
22	18165995	rs2587070	T	G	105	103	208	0	3	211	0	0
22	18209718	rs2535688	C	T	35	39	74	0	1	75	0	0
22	18209920	rs9306198	C	T	43	34	77	0	0	77	0	0
22	18210560	rs725769	T	G	25	28	53	0	0	53	0	0
22	18210704	rs2587100	G	C	19	24	43	0	0	43	0	0
22	18211021	.	T	C	32	19	51	0	0	51	0	0
22	18220831	rs11538	A	G	274	267	541	0	3	544	0	0
22	18221167	rs181388	A	G	3	3	6	0	0	6	0	0
22	18221966	rs181389	A	G	6	2	8	0	0	8	0	0
22	18222263	rs181390	A	G	5	2	7	0	0	7	0	0
22	18226997	rs406388	C	G	6	1	7	0	0	7	0	0
22	18234535	rs372655	G	A	5	3	8	0	0	8	0	0
22	18238291	rs181411	G	A	1	5	6	0	0	6	0	0
22	18256129	rs8190274	C	T	5	1	6	0	0	6	0	0
22	18270779	rs7675	C	T	32	23	55	0	1	56	0	0
22	18271078	rs1045588	G	A	32	20	52	0	0	52	0	0
22	18271437	rs11541674	C	A	12	17	29	0	0	29	0	0
22	18271710	rs11541676	G	A	19	10	29	0	0	29	0	0
22	18271943	rs35516923	G	A	26	24	50	0	0	51	1	0
22	18273256	rs11912641	G	C	9	14	23	0	0	23	0	0
22	18273463	rs62238879	G	A	8	9	17	0	1	18	0	0
22	18300240	rs5992854	T	C	2	5	7	0	0	7	0	0
22	18560825	rs62239019	A	G	11	12	23	0	0	23	0	0
22	18571008	rs464385	G	A	32	33	65	0	2	67	0	0
22	18572106	rs456551	T	A	12	10	22	0	0	22	0	0
22	18573912	rs361777	T	C	6	4	10	0	0	10	0	0
22	18893631	rs407895	T	C	3	3	6	0	0	6	0	0
22	18894600	rs416659	G	C	8	5	13	0	0	13	0	0
22	18895006	rs417616	A	C	4	2	6	0	0	6	0	0
22	18895227	rs418623	C	T	6	5	11	0	0	11	0	0
22	18895563	rs1974680	G	A	6	9	15	0	0	15	0	0
22	18895694	rs1974681	T	G	7	7	14	0	0	14	0	0
22	18895703	rs424512	T	C	7	6	13	0	0	13	0	0
22	18896169	rs426065	C	T	10	9	19	0	0	19	0	0
22	18896189	rs425576	T	C	11	8	19	0	0	19	0	0
22	18896301	rs5746636	G	T	12	7	19	0	0	19	0	0
22	18896429	rs5747925	T	C	12	3	15	0	0	15	0	0
22	18896529	rs430748	C	T	4	4	8	0	0	8	0	0
22	18896530	rs430899	A	C	4	4	8	0	0	8	0	0
22	18896709	rs431289	T	C	7	7	14	0	0	14	0	0
22	18897228	rs413280	C	A	4	7	11	0	0	11	0	0
22	18897292	rs419208	G	A	2	11	13	0	2	15	0	0
22	18908875	rs1808320	A	G	24	25	49	0	0	49	0	0
22	19024651	rs2073776	C	T	28	24	52	0	0	52	0	0
22	19025330	rs8399	A	C	22	17	39	0	0	39	0	0
22	19025897	rs1894262	C	T	23	18	41	0	0	41	0	0
22	19026025	rs10160	A	G	22	20	42	0	0	42	0	0
22	19026613	rs2072123	A	G	14	8	22	0	0	22	0	0
22	19027582	rs55813720	G	A	4	3	7	0	0	7	0	0
22	19028320	rs9618453	C	G	7	1	8	0	0	8	0	0
22	19028476	rs2073775	T	C	4	2	6	0	0	6	0	0
22	19034829	rs2000996	A	G	4	6	10	0	0	10	0	0
22	19035072	rs17810649	A	G	4	5	9	0	0	9	0	0
22	19109764	rs11550626	A	G	9	7	16	0	0	16	0	0
22	19109812	rs11550627	A	G	14	6	20	0	0	20	0	0
22	19122665	rs2240111	C	T	111	98	209	0	18	227	0	0
22	19123075	rs2240112	T	C	4	7	11	0	0	11	0	0
22	19123952	rs16983371	T	C	5	7	12	0	0	12	0	0
22	19125136	rs3765612	G	A	5	5	10	0	0	10	0	0
22	19125383	rs56326510	A	C	6	6	12	0	1	13	0	0
22	19126631	rs2298273	T	C	7	5	12	0	0	12	0	0
22	19128169	rs7285177	G	A	11	14	25	0	1	26	0	0
22	19128559	rs55754617	C	T	18	15	33	0	0	33	0	0
22	19129672	rs55694607	A	G	14	9	23	0	1	24	0	0
22	19166263	rs8141941	G	A	6	5	11	0	0	11	0	0
22	19430259	rs2006242	T	A	5	2	7	0	0	7	0	0
22	19430472	rs885975	C	T	3	9	12	0	0	12	0	0
22	19431038	rs712979	A	G	10	18	28	0	0	28	0	0
22	19431396	rs756649	T	C	16	16	32	0	0	32	0	0
22	19431485	rs756648	G	A	19	17	36	0	0	36	0	0
22	19432456	rs885976	G	A	8	4	12	0	0	12	0	0
22	19437938	rs2073731	C	T	3	3	6	0	0	6	0	0
22	19439165	rs1057457	C	T	17	26	43	0	0	43	0	0
22	19439540	rs7292006	G	A	13	22	35	0	1	36	0	0
22	19442013	rs2073727	C	T	13	6	19	0	1	20	0	0
22	19776019	rs2073768	G	A	7	10	17	0	0	17	0	0
22	19789541	rs2073770	A	C	8	8	16	0	0	16	0	0
22	19808769	rs5748449	C	T	5	2	7	0	0	7	0	0
22	19833781	rs1053001	G	A	6	6	12	0	0	12	0	0
22	19833989	rs1052988	G	A	6	6	12	0	0	12	0	0
22	19834026	rs1052978	A	G	5	7	12	0	0	12	0	0
22	19835110	rs75127693	C	T	6	4	10	0	0	10	0	0
22	19836908	.	T	G	8	1	9	0	1	10	0	0
22	19837575	rs3747066	C	T	6	1	7	0	0	7	0	0
22	19868218	rs1139793	A	G	88	73	161	0	6	167	0	0
22	19871204	rs5992492	T	C	3	4	7	0	0	7	0	0
22	19871778	rs3788305	A	G	4	9	13	0	0	13	0	0
22	19872009	rs3788306	T	C	3	3	6	0	0	6	0	0
22	19874209	rs9606171	T	C	4	2	6	0	0	6	0	0
22	19949952	rs6269	A	G	14	22	36	0	0	36	0	0
22	19950235	rs4633	C	T	246	245	491	0	10	501	0	0
22	19951207	rs4818	C	G	350	269	619	0	2	621	0	0
22	19951271	rs4680	G	A	313	368	681	0	2	683	0	0
22	19956781	rs165599	G	A	11	16	27	0	0	27	0	0
22	19957631	rs9265	C	A	25	28	53	0	0	53	0	0
22	19957763	rs165655	G	A	23	33	56	0	2	58	0	0
22	19958022	rs73150820	G	A	5	5	10	0	0	10	0	0
22	19958669	rs165849	G	A	8	4	12	0	0	12	0	0
22	19959011	rs13056165	G	A	8	5	13	0	0	13	0	0
22	19959033	rs12329964	G	A	4	7	11	0	0	11	0	0
22	19967068	rs887204	G	A	4	4	8	0	0	8	0	0
22	19968971	rs2073748	G	A	4	2	6	0	0	6	0	0
22	19969075	rs2073747	A	G	5	5	10	0	1	11	0	0
22	19969106	rs2240717	A	G	6	6	12	0	0	12	0	0
22	19971391	rs9618724	C	T	6	3	9	0	0	9	0	0
22	19971552	rs758374	T	C	1	5	6	0	0	6	0	0
22	19972452	rs2238783	C	G	4	2	6	0	0	6	0	0
22	19973597	rs62223687	C	T	4	4	8	0	0	8	0	0
22	19974032	rs4819526	T	C	6	2	8	0	0	8	0	0
22	19974654	rs7292055	G	A	2	4	6	0	0	6	0	0
22	20055082	rs391310	G	T	5	1	6	0	0	6	0	0
22	20055100	rs452981	A	G	6	1	7	0	0	7	0	0
22	20089880	rs9605062	T	C	6	3	9	0	0	9	0	0
22	20090038	rs9605063	G	T	5	3	8	0	0	8	0	0
22	20091628	rs2904565	C	T	4	3	7	0	0	7	0	0
22	20092293	rs146392041	G	T	3	4	7	0	0	7	0	0
22	20092777	rs9606251	C	A	3	3	6	0	0	6	0	0
22	20097730	rs41281423	C	T	31	19	50	0	1	51	0	0
22	20098882	rs720014	T	C	44	30	74	0	2	76	0	0
22	20099331	rs3757	G	A	9	4	13	0	0	13	0	0
22	20099654	rs9605066	C	T	17	12	29	0	0	29	0	0
22	20113253	rs175162	T	G	5	12	17	0	0	17	0	0
22	20113566	rs142904981	C	T	12	7	19	0	1	20	0	0
22	20113777	rs175163	T	C	6	5	11	0	0	11	0	0
22	20127554	rs175174	A	G	10	14	24	0	0	24	0	0
22	20131115	rs9605069	C	T	15	17	32	0	0	32	0	0
22	20132638	rs175178	T	A	9	7	16	0	0	16	0	0
22	20132972	rs175179	A	G	16	15	31	0	4	35	0	0
22	20133234	.	G	A	36	43	79	0	1	80	0	0
22	20133290	rs11556521	T	C	51	38	89	0	1	90	0	0
22	20133301	rs74464271	C	T	53	38	91	0	0	91	0	0
22	20134147	rs1974652	A	G	5	3	8	0	0	8	0	0
22	20134350	rs1974653	C	A	5	2	7	0	0	7	0	0
22	20134739	rs9605070	C	T	4	9	13	0	1	14	0	0
22	20135211	rs7290959	T	C	10	14	24	0	3	27	0	0
22	20135383	rs7286804	C	T	10	9	19	0	0	19	0	0
22	20935392	rs113999489	G	A	25	29	54	0	0	54	0	0
22	21065447	.	C	T	15	17	32	0	0	32	0	0
22	21321364	rs12170987	T	C	5	4	9	0	0	9	0	0
22	21330787	rs7285694	C	T	11	13	24	0	0	24	0	0
22	21332409	rs744931	G	A	1	6	7	0	0	7	0	0
22	21332441	rs739525	T	C	1	6	7	0	0	7	0	0
22	21332443	rs739524	G	A	1	6	7	0	0	7	0	0
22	21352181	rs178296	T	C	25	21	46	0	1	47	0	0
22	21354970	rs426938	C	G	38	41	79	0	1	80	0	0
22	21356538	rs368989	A	T	4	3	7	0	0	7	0	0
22	21357006	rs4822808	C	T	4	4	8	0	0	8	0	0
22	21474675	rs77488211	G	A	0	11	11	0	0	11	0	0
22	21474717	.	C	T	32	0	32	0	0	32	0	0
22	21474734	.	C	T	45	0	45	0	0	45	0	0
22	21474774	.	T	A	44	0	44	0	0	44	0	0
22	21800269	rs80230662	C	T	4	2	6	0	0	6	0	0
22	21802961	rs3747086	T	G	13	5	18	0	0	18	0	0
22	21804293	.	C	T	17	17	34	0	0	34	0	0
22	21804903	rs41282591	C	T	23	18	41	0	1	42	0	0
22	21976932	rs11537777	A	G	29	47	76	0	0	76	0	0
22	21984205	rs710177	A	G	14	19	33	0	0	33	0	0
22	21998509	rs1947	T	C	27	35	62	0	0	62	0	0
22	22015144	rs9941935	A	G	28	24	52	0	1	53	0	0
22	22015242	rs45502092	C	T	25	21	46	0	0	46	0	0
22	22044240	rs8142802	G	T	4	2	6	0	0	6	0	0
22	22044713	rs79815876	C	T	4	4	8	0	0	8	0	0
22	22045027	rs861827	T	C	5	2	7	0	0	7	0	0
22	22045603	rs861826	C	T	5	1	6	0	0	6	0	0
22	22050234	rs11912412	G	A	9	2	11	0	1	12	0	0
22	22050727	rs77238932	T	A	18	22	40	0	2	42	0	0
22	22051548	rs3209602	G	A	44	56	100	0	0	100	0	0
22	22312315	.	C	T	12	0	12	0	0	12	0	0
22	22312350	.	G	C	6	0	6	0	0	6	0	0
22	22315353	rs77086209	A	T	1	5	6	0	0	6	0	0
22	22599705	rs5995720	G	A	2	4	6	0	0	6	0	0
22	22661173	rs7410785	T	C	6	87	93	0	4	97	0	0
22	22661181	rs73880611	C	G	4	86	90	0	3	93	0	0
22	22661318	.	T	C	21	68	89	0	1	90	0	0
22	22661626	rs2329974	T	C	14	70	84	0	0	84	0	0
22	22661662	rs1044448	A	T	9	40	49	0	0	49	0	0
22	22662770	rs10427551	T	A	1	6	7	0	0	7	0	0
22	22663414	rs184736697	G	T	1	14	15	0	0	15	0	0
22	22663668	rs3966372	G	A	1	13	14	0	0	14	0	0
22	22664158	.	G	A	5	7	12	0	0	12	0	0
22	22664215	.	C	T	5	7	12	0	0	12	0	0
22	22664639	rs9306349	G	A	9	9	18	0	0	18	0	0
22	22673639	rs737765	T	C	1	6	7	0	0	7	0	0
22	22674600	rs2012017	A	C	6	4	10	0	0	10	0	0
22	22674650	rs6001780	C	T	7	6	13	0	0	13	0	0
22	22675412	rs8142426	T	C	4	10	14	0	0	14	0	0
22	22839424	rs398182	G	A	3	3	6	0	0	6	0	0
22	22841049	rs6002485	C	G	4	2	6	0	0	6	0	0
22	22841161	rs5758473	C	A	4	2	6	0	0	6	0	0
22	22892314	.	G	A	98	40	138	0	1	139	0	0
22	22899234	rs1129172	A	G	56	35	91	0	0	91	0	0
22	22899363	rs8139318	G	A	11	6	17	0	1	18	0	0
22	22899364	rs2283799	A	G	10	7	17	0	0	17	0	0
22	22899414	rs2283800	A	G	13	9	22	0	0	22	0	0
22	22901408	rs6002723	A	G	10	3	13	0	0	13	0	0
22	23237860	rs28477498	A	G	14	22	36	0	0	36	0	0
22	23247169	rs527511481	T	G	7	1	8	0	1	9	0	0
22	23247170	rs540954398	G	T	9	0	9	0	0	9	0	0
22	23247174	rs17851780	G	A	13	0	13	0	0	13	0	0
22	23248549	.	G	A	12	1	13	0	0	13	0	0
22	23248758	.	G	A	20	29	49	0	2	51	0	0
22	23248839	rs7117	A	T	9	18	27	0	0	27	0	0
22	23261726	rs5759529	C	A	8	0	8	0	0	8	0	0
22	23264785	rs4822348	C	A	12	0	12	0	0	12	0	0
22	23542535	rs4820543	A	G	0	6	6	0	0	6	0	0
22	23603957	rs5759667	T	G	3	11	14	0	0	14	0	0
22	23606384	rs5759668	C	T	131	104	235	0	2	237	0	0
22	23606747	rs6003593	C	A	107	113	220	0	5	225	0	0
22	23606958	rs1811017	A	G	172	137	309	0	1	310	0	0
22	23606965	rs1811018	G	A	179	140	319	0	2	321	0	0
22	23607442	rs2330369	C	G	5	1	6	0	0	6	0	0
22	23631801	rs2227939	T	C	320	325	645	0	5	650	0	0
22	23632257	rs9608100	A	G	1	6	7	0	0	7	0	0
22	23632513	rs16802	A	G	5	22	27	0	0	27	0	0
22	23643212	rs6003605	C	T	11	4	15	0	0	15	0	0
22	23643247	rs5751625	T	C	11	7	18	0	0	18	0	0
22	23643482	rs5759690	G	A	4	2	6	0	0	6	0	0
22	23644425	rs12168342	A	G	16	14	30	0	0	30	0	0
22	23644677	rs4822378	T	G	6	13	19	0	0	19	0	0
22	23644794	rs9608102	C	T	8	13	21	0	0	21	0	0
22	23650622	rs131701	A	T	5	4	9	0	0	9	0	0
22	23652201	rs131703	A	G	10	4	14	0	0	14	0	0
22	23652212	rs140509	C	T	12	5	17	0	0	17	0	0
22	23652956	rs180797	C	T	27	11	38	0	0	38	0	0
22	23653210	rs201686347	G	C	6	3	9	0	0	9	0	0
22	23653555	.	T	C	29	7	36	0	0	36	0	0
22	23653880	rs180801	G	A	24	12	36	0	0	36	0	0
22	23654747	rs28394603	C	T	15	4	19	0	0	19	0	0
22	23654993	rs180805	A	G	16	11	27	0	0	27	0	0
22	23655219	rs180806	G	A	10	18	28	0	0	28	0	0
22	23655620	rs180807	T	C	5	4	9	0	0	9	0	0
22	23657735	rs180812	G	A	573	452	1025	0	2	1027	0	0
22	23657874	rs392389	A	G	497	322	819	0	3	822	0	0
22	23657875	rs440531	A	C	478	323	801	0	14	816	1	0
22	23657939	rs113629387	T	C	463	350	813	0	11	824	0	0
22	23657966	rs28379041	G	A	510	330	840	0	20	862	2	0
22	23657980	rs180816	G	A	464	324	788	0	5	793	0	0
22	23658007	rs180817	G	A	342	283	625	0	5	630	0	0
22	23658063	rs180818	T	A	219	160	379	0	5	385	1	0
22	23915340	rs1064417	T	G	0	61	61	0	0	61	0	0
22	23915657	.	C	T	1	249	250	0	1	251	0	0
22	23980755	rs3207409	C	G	23	20	43	0	0	43	0	0
22	23980868	rs16994633	C	A	44	52	96	0	0	96	0	0
22	23980968	rs13056126	T	A	44	68	112	0	3	115	0	0
22	23982724	rs56397271	T	C	4	2	6	0	0	6	0	0
22	23982727	rs28645846	A	G	4	2	6	0	0	6	0	0
22	23995056	rs879980630	G	A	6	6	12	0	0	12	0	0
22	23995213	rs3747106	C	T	5	1	6	0	0	6	0	0
22	23995540	rs3747107	C	G	3	3	6	0	0	6	0	0
22	23995561	rs8136455	T	C	4	2	6	0	0	6	0	0
22	23995609	rs8136473	T	C	5	5	10	0	0	10	0	0
22	23995950	rs8140205	G	A	6	0	6	0	0	6	0	0
22	23996259	rs6003830	T	C	3	3	6	0	0	6	0	0
22	23996261	rs6003831	A	G	3	3	6	0	0	6	0	0
22	23998894	rs715035	G	A	2	6	8	0	1	9	0	0
22	24001094	rs6519465	C	T	2	5	7	0	0	7	0	0
22	24027648	rs1539768	A	C	3	3	6	0	0	6	0	0
22	24027650	rs1539769	C	G	3	3	6	0	0	6	0	0
22	24028186	rs7293229	G	A	4	4	8	0	0	8	0	0
22	24028412	rs11090280	T	C	5	1	6	0	0	6	0	0
22	24029646	rs8140340	T	G	4	4	8	0	0	8	0	0
22	24034288	rs738786	A	G	6	9	15	0	0	15	0	0
22	24035970	rs2070446	C	T	5	11	16	0	0	16	0	0
22	24038847	rs1007298	T	C	190	129	319	0	1	320	0	0
22	24044515	rs8140076	C	T	3	5	8	0	0	8	0	0
22	24052031	rs9608174	C	T	46	25	71	0	1	72	0	0
22	24056537	rs2070444	G	A	10	7	17	0	0	17	0	0
22	24083873	rs9612413	C	T	1	5	6	0	0	6	0	0
22	24177912	.	A	G	5	8	13	0	0	13	0	0
22	24224655	rs9608213	G	A	3	11	14	0	0	14	0	0
22	24224659	rs9612499	C	A	3	11	14	0	1	15	0	0
22	24226890	rs60699980	G	A	4	5	9	0	0	9	0	0
22	24227246	rs6003939	A	C	8	2	10	0	0	10	0	0
22	24227928	rs5996626	A	T	5	3	8	0	0	8	0	0
22	24228125	rs1129067	T	C	6	5	11	0	0	11	0	0
22	24313868	rs79966373	C	G	4	4	8	0	0	8	0	0
22	24833164	rs11704811	C	T	3	3	6	0	0	6	0	0
22	24909346	rs145749836	G	A	14	7	21	0	0	21	0	0
22	24917852	rs2232868	G	A	4	2	6	0	0	6	0	0
22	24918447	rs6004175	G	A	5	1	6	0	1	7	0	0
22	24922452	rs1314	T	G	13	13	26	0	0	26	0	0
22	24936970	rs9704	A	G	231	238	469	0	6	475	0	0
22	24937487	rs2011947	A	G	102	88	190	0	3	193	0	0
22	24937678	rs1984310	G	A	194	179	373	0	4	377	0	0
22	24938455	rs1004134	T	A	169	146	315	0	3	318	0	0
22	24938908	rs8139822	A	G	152	128	280	0	5	285	0	0
22	24940242	rs2012772	G	T	10	7	17	0	1	18	0	0
22	24943294	rs12170895	C	T	17	13	30	0	0	30	0	0
22	24943658	rs762284	T	C	12	3	15	0	0	15	0	0
22	24944782	rs1003580	A	G	18	27	45	0	0	45	0	0
22	24945361	rs16978651	C	A	5	2	7	0	0	7	0	0
22	24946522	rs7292105	G	C	5	3	8	0	0	8	0	0
22	24946618	rs9624495	G	C	9	2	11	0	0	11	0	0
22	24947452	rs738820	C	T	3	5	8	0	0	8	0	0
22	24948172	rs4820595	A	G	5	4	9	0	0	9	0	0
22	24949306	rs12160660	T	C	4	4	8	0	0	8	0	0
22	24950544	rs184628109	A	G	5	3	8	0	0	8	0	0
22	24964128	rs4597	T	C	327	431	758	0	12	770	0	0
22	24968526	rs6004187	C	T	37	28	65	0	1	66	0	0
22	24970107	rs762286	A	G	30	46	76	0	1	77	0	0
22	24970486	rs9830	A	G	76	58	134	0	1	135	0	0
22	24979447	rs2236626	C	T	8	2	10	0	0	10	0	0
22	25748718	rs133188	A	G	8	3	11	0	0	11	0	0
22	25753231	rs133194	G	A	34	12	46	0	0	46	0	0
22	25756674	rs133198	C	T	6	7	13	0	0	13	0	0
22	25756785	rs133199	A	T	10	5	15	0	0	15	0	0
22	25757268	rs133201	A	G	4	7	11	0	0	11	0	0
22	25757786	rs133203	T	C	6	8	14	0	0	14	0	0
22	25758259	rs117394366	C	T	8	9	17	0	0	17	0	0
22	25758473	rs469996	T	C	8	9	17	0	0	17	0	0
22	25758790	rs133204	C	G	8	7	15	0	0	15	0	0
22	25759104	rs133205	T	C	7	8	15	0	1	16	0	0
22	25760254	rs133209	A	G	5	4	9	0	0	9	0	0
22	25770473	rs133215	T	C	6	1	7	0	0	7	0	0
22	25778013	rs6004611	G	A	4	6	10	0	0	10	0	0
22	25778021	rs11704353	C	T	4	6	10	0	0	10	0	0
22	25780531	rs139933686	G	A	3	4	7	0	0	7	0	0
22	25853368	rs6423498	T	C	8	128	136	0	0	136	0	0
22	25855459	rs12345	G	A	11	144	155	0	0	155	0	0
22	25855629	rs6004655	G	A	7	28	35	0	0	35	0	0
22	25855710	rs6004656	C	T	6	1	7	0	0	7	0	0
22	25855714	rs6004657	C	T	6	0	6	0	1	7	0	0
22	26123092	rs78756825	G	C	4	3	7	0	0	7	0	0
22	26831624	rs2105952	C	T	2	5	7	0	0	7	0	0
22	26860269	rs2014410	G	C	83	47	130	0	0	130	0	0
22	26862041	rs3747129	G	A	37	16	53	0	1	54	0	0
22	26883875	rs145455368	T	C	8	4	12	0	0	12	0	0
22	26884039	rs4820682	G	A	36	25	61	0	2	63	0	0
22	26886594	rs4822725	A	G	6	3	9	0	1	10	0	0
22	26889564	rs4822727	C	T	12	16	28	0	0	28	0	0
22	26891808	rs4822728	C	T	2	4	6	0	0	6	0	0
22	26891823	rs4822729	C	G	2	4	6	0	0	6	0	0
22	26908433	rs3213558	C	T	7	2	9	0	0	9	0	0
22	26909750	rs134145	A	G	3	5	8	0	0	8	0	0
22	26919613	rs134163	T	C	16	13	29	0	0	29	0	0
22	26921725	rs4275	A	G	15	21	36	0	1	37	0	0
22	26931221	rs4149478	C	T	4	2	6	0	0	6	0	0
22	26932150	rs3752523	G	A	17	7	24	0	0	24	0	0
22	26957136	rs41281589	T	C	58	0	58	0	10	68	0	0
22	26957284	rs3966171	C	A	17	0	17	0	0	17	0	0
22	26981802	rs9608509	C	G	3	4	7	0	0	7	0	0
22	26983287	rs73163239	G	T	7	5	12	0	0	12	0	0
22	28196910	rs34343183	G	A	41	50	91	0	1	92	0	0
22	28306070	rs1807581	C	T	13	4	17	0	0	17	0	0
22	28315465	rs16985722	T	C	3	5	8	0	0	8	0	0
22	28319511	rs12483793	G	A	4	9	13	0	0	13	0	0
22	28374219	rs7625	G	A	3	3	6	0	0	6	0	0
22	28398528	rs138657	A	G	2	8	10	0	0	10	0	0
22	29182500	rs5762795	C	A	61	41	102	0	1	103	0	0
22	29183133	rs6005881	A	G	34	23	57	0	0	57	0	0
22	29185113	rs1222	A	C	53	48	101	0	2	103	0	0
22	29191879	rs2097461	T	C	16	17	33	0	0	33	0	0
22	29192670	rs2239815	T	C	65	47	112	0	0	112	0	0
22	29193638	rs5762803	G	C	11	6	17	0	0	17	0	0
22	29196494	rs5762809	C	T	73	86	159	0	0	159	0	0
22	29196757	rs2269577	G	C	7	2	9	0	0	9	0	0
22	29196843	rs2269578	G	C	10	7	17	0	0	17	0	0
22	29612481	rs132381	G	A	22	59	81	0	0	81	0	0
22	29628741	rs1997719	C	T	17	3	20	0	0	20	0	0
22	29655371	rs8550	C	T	341	325	666	0	30	696	0	0
22	29656697	rs114640172	C	A	57	51	108	0	2	110	0	0
22	29659715	rs2231396	G	A	4	3	7	0	0	7	0	0
22	29669712	rs55801595	C	G	14	15	29	0	0	29	0	0
22	29676832	rs141031975	T	G	6	2	8	0	0	8	0	0
22	29676877	rs577980215	T	G	7	1	8	0	3	11	0	0
22	29677967	rs5752899	C	A	5	3	8	0	0	8	0	0
22	29685752	rs5763131	A	G	17	20	37	0	0	37	0	0
22	29688632	rs3761426	T	G	2	4	6	0	0	6	0	0
22	29693990	rs3747142	A	G	3	6	9	0	0	9	0	0
22	29707955	rs9613860	A	T	2	6	8	0	0	8	0	0
22	29728854	rs9613864	A	T	15	17	32	0	0	32	0	0
22	29737413	.	C	T	4	9	13	0	1	14	0	0
22	29834766	rs465736	A	G	1	6	7	0	0	7	0	0
22	29913272	rs737976	C	T	74	53	127	0	2	129	0	0
22	29949509	rs469189	G	A	5	2	7	0	0	7	0	0
22	29957570	rs1058642	G	A	71	80	151	0	0	151	0	0
22	30091765	rs8140096	C	T	12	17	29	0	0	29	0	0
22	30163526	rs76013375	A	G	452	444	896	0	2	898	0	0
22	30164511	rs12158466	T	C	6	9	15	0	0	15	0	0
22	30165412	rs140139	A	G	1	6	7	0	0	7	0	0
22	30184950	rs7954	A	G	200	244	444	0	2	446	0	0
22	30203599	rs5997530	C	G	5	18	23	0	0	23	0	0
22	30232024	rs76925843	G	A	3	5	8	0	0	8	0	0
22	30234218	rs7289250	A	T	13	0	13	0	0	13	0	0
22	30367014	rs16988135	A	T	123	105	228	0	2	230	0	0
22	30367857	rs737906	T	C	88	100	188	0	0	188	0	0
22	30371651	rs9614124	G	A	8	3	11	0	0	11	0	0
22	30397346	rs9614128	T	C	1	12	13	0	0	13	0	0
22	30398078	rs9614129	T	C	10	14	24	0	0	24	0	0
22	30403996	rs2074204	C	T	58	45	103	0	0	103	0	0
22	30412759	rs17647135	T	C	9	15	24	0	0	24	0	0
22	30423744	rs9983	G	A	46	54	100	0	0	100	0	0
22	30426335	rs15888	T	A	9	2	11	0	0	11	0	0
22	30429664	rs12330007	G	C	3	5	8	0	0	8	0	0
22	30432502	rs12627944	G	A	2	5	7	0	0	7	0	0
22	30638226	rs929271	T	G	56	76	132	0	0	132	0	0
22	30638292	rs929272	C	G	69	82	151	0	2	153	0	0
22	30638721	rs3753082	G	A	54	75	129	0	0	129	0	0
22	30639110	rs737812	C	A	87	48	135	0	1	137	1	0
22	30640595	rs929273	G	A	8	10	18	0	0	18	0	0
22	30659566	rs2070889	G	A	357	341	698	0	1	699	0	0
22	30661184	rs5763918	T	C	27	25	52	0	1	53	0	0
22	30662813	rs112031212	C	T	82	72	154	0	5	159	0	0
22	30681257	rs1043099	C	G	18	10	28	0	0	28	0	0
22	30688985	rs7289384	C	T	5	9	14	0	0	14	0	0
22	30689998	rs11089442	G	A	88	71	159	0	2	161	0	0
22	30691307	rs737805	G	A	9	3	12	0	0	12	0	0
22	30692353	rs929454	A	T	4	4	8	0	0	8	0	0
22	30728356	rs10376	A	C	28	37	65	0	0	65	0	0
22	30729507	rs2839998	G	A	36	33	69	0	0	69	0	0
22	30738161	rs9608885	C	T	1	5	6	0	0	6	0	0
22	30738587	rs2074733	T	C	11	9	20	0	0	20	0	0
22	30738737	rs5753080	G	A	5	10	15	0	0	15	0	0
22	30774340	rs9619104	A	G	7	2	9	0	0	9	0	0
22	30782731	rs12171261	G	A	6	5	11	0	0	11	0	0
22	30820077	rs17658686	C	G	6	0	6	0	0	6	0	0
22	30823196	rs5753130	T	C	28	17	45	0	0	45	0	0
22	30981984	rs111338112	C	T	7	9	16	0	0	16	0	0
22	30987861	.	G	C	22	26	48	0	0	48	0	0
22	31006860	rs9606756	A	G	8	2	10	0	0	10	0	0
22	31011610	rs1801198	G	C	8	5	13	0	0	13	0	0
22	31013419	rs9621049	C	T	9	10	19	0	1	20	0	0
22	31022590	rs12169610	C	T	16	13	29	0	0	29	0	0
22	31032309	rs4820891	C	T	7	1	8	0	0	8	0	0
22	31043766	rs3179442	G	A	7	2	9	0	0	9	0	0
22	31355354	rs2285918	G	A	4	2	6	0	0	6	0	0
22	31491295	rs3205187	G	C	11	7	18	0	0	18	0	0
22	31577704	rs55888048	G	A	5	3	8	0	0	8	0	0
22	31602406	rs190772433	C	T	28	25	53	0	0	53	0	0
22	31602772	rs6651	C	T	38	51	89	0	1	90	0	0
22	31602868	rs8242	T	G	33	25	58	0	0	58	0	0
22	31631314	rs5753518	G	A	3	3	6	0	0	6	0	0
22	31659101	rs739427	G	C	3	3	6	0	0	6	0	0
22	31665044	rs7285773	T	G	3	3	6	0	0	6	0	0
22	31677744	rs4615	A	G	66	63	129	0	0	129	0	0
22	31678958	rs4618154	C	G	36	48	84	0	0	84	0	0
22	31679449	rs4820961	C	T	4	4	8	0	0	8	0	0
22	31679669	rs7288643	C	A	5	3	8	0	0	8	0	0
22	31679741	rs5997940	T	C	2	5	7	0	0	7	0	0
22	31680239	rs140506853	C	T	5	4	9	0	0	9	0	0
22	31680240	rs1034587	G	T	5	4	9	0	0	9	0	0
22	31680348	rs2239906	T	C	2	4	6	0	0	6	0	0
22	31680624	rs2239905	G	A	4	4	8	0	1	9	0	0
22	31681062	rs5749246	A	G	3	4	7	0	0	7	0	0
22	31686102	rs2413048	G	A	10	5	15	0	1	16	0	0
22	31737436	rs62236170	G	A	30	26	56	0	0	56	0	0
22	31743999	rs62236171	G	A	4	2	6	0	0	6	0	0
22	31838085	rs5997988	G	A	44	67	111	0	0	111	0	0
22	31839151	rs16989617	T	C	3	4	7	0	0	7	0	0
22	31839244	rs16989620	G	A	3	4	7	0	0	7	0	0
22	31840379	rs16989623	A	G	3	3	6	0	0	6	0	0
22	31850607	rs16989638	A	G	3	3	6	0	0	6	0	0
22	31917415	rs4820980	A	G	1	5	6	0	0	6	0	0
22	31918260	rs62236257	G	T	5	2	7	0	0	7	0	0
22	31918822	rs62236258	A	G	3	3	6	0	0	6	0	0
22	31946282	rs16989753	T	C	26	27	53	0	0	53	0	0
22	31971258	rs5753700	T	C	13	22	35	0	0	35	0	0
22	31976299	rs55894054	T	C	15	8	23	0	0	23	0	0
22	31998612	rs2006771	G	A	11	14	25	0	1	26	0	0
22	32003798	rs8139560	C	T	3	3	6	0	0	6	0	0
22	32007153	rs9621295	G	A	16	13	29	0	0	29	0	0
22	32008039	rs7291918	A	G	7	3	10	0	0	10	0	0
22	32009984	rs73160679	C	T	8	3	11	0	0	11	0	0
22	32010042	rs7285893	A	G	9	8	17	0	0	17	0	0
22	32011225	rs12171042	T	C	19	18	37	0	2	39	0	0
22	32013365	rs7293143	G	A	5	3	8	0	0	8	0	0
22	32013442	rs7287509	C	T	9	12	21	0	0	21	0	0
22	32013459	rs7287516	C	T	10	11	21	0	0	21	0	0
22	32013505	rs7287417	A	G	11	6	17	0	0	17	0	0
22	32013745	rs7289075	T	C	7	7	14	0	0	14	0	0
22	32013816	rs7288051	C	T	14	9	23	0	0	23	0	0
22	32015314	rs62237834	A	G	35	53	88	0	0	88	0	0
22	32015406	rs14034	T	C	36	49	85	0	0	85	0	0
22	32015450	rs9956	T	G	37	47	84	0	0	84	0	0
22	32016092	rs16989334	A	G	7	3	10	0	0	10	0	0
22	32016159	rs60359561	G	A	6	2	8	0	0	8	0	0
22	32020314	rs62237836	T	C	5	2	7	0	0	7	0	0
22	32020413	rs67935422	G	A	3	3	6	0	0	6	0	0
22	32022709	rs62237839	A	G	3	3	6	0	0	6	0	0
22	32036332	rs12165609	T	C	4	6	10	0	0	10	0	0
22	32079303	rs3804087	T	C	9	7	16	0	0	16	0	0
22	32079447	rs3804088	C	A	4	5	9	0	0	9	0	0
22	32080244	rs5998086	G	A	4	7	11	0	0	11	0	0
22	32081681	rs8142355	C	T	4	3	7	0	0	7	0	0
22	32108475	rs16989427	C	T	7	11	18	0	0	18	0	0
22	32108824	rs131224	T	A	4	3	7	0	0	7	0	0
22	32110163	rs140078	G	A	2	4	6	0	0	6	0	0
22	32205632	rs5998135	A	C	9	13	22	0	0	22	0	0
22	32756460	rs73166365	G	C	15	17	32	0	0	32	0	0
22	32756744	.	A	G	2	14	16	0	0	16	0	0
22	32777364	rs9619261	G	A	5	6	11	0	1	12	0	0
22	32778254	rs7287452	G	A	7	4	11	0	1	12	0	0
22	32779244	rs73166400	C	T	3	3	6	0	0	6	0	0
22	32791495	rs2281036	T	C	4	4	8	0	0	8	0	0
22	32795641	rs5749426	C	T	120	141	261	0	0	261	0	0
22	32808078	rs11545749	G	A	93	116	209	0	2	211	0	0
22	32870806	rs11538371	C	T	81	84	165	0	0	165	0	0
22	32875190	rs11107	G	A	526	485	1011	0	13	1024	0	0
22	32882121	rs5749447	G	A	7	3	10	0	0	10	0	0
22	32882414	rs5749448	A	G	10	4	14	0	0	14	0	0
22	32882440	rs5749449	C	G	8	6	14	0	0	14	0	0
22	32882808	rs3788448	A	G	6	4	10	0	0	10	0	0
22	32883103	rs3788449	G	A	13	5	18	0	0	18	0	0
22	32883128	rs3788450	G	A	12	4	16	0	0	16	0	0
22	32883282	rs3827335	A	G	11	4	15	0	0	15	0	0
22	32883344	rs4821066	A	G	14	3	17	0	0	17	0	0
22	32884036	rs5998513	T	A	2	7	9	0	0	9	0	0
22	32884381	rs7354804	C	T	15	17	32	0	1	33	0	0
22	32884821	rs2267176	C	T	20	22	42	0	1	43	0	0
22	32884964	rs2267177	T	C	18	23	41	0	1	42	0	0
22	32885549	rs2267178	C	T	28	27	55	0	0	55	0	0
22	32885780	rs2267179	C	T	4	5	9	0	0	9	0	0
22	32886477	rs5749450	G	T	27	33	60	0	2	62	0	0
22	32886785	rs738981	C	T	36	37	73	0	0	73	0	0
22	32886998	rs738982	T	C	19	51	70	0	0	70	0	0
22	32887150	rs9726	C	T	802	394	1196	0	12	1208	0	0
22	32887498	rs6518786	T	C	14	19	33	0	1	34	0	0
22	32887661	rs17772071	A	G	4	8	12	0	1	13	0	0
22	32887732	rs17698823	C	T	4	8	12	0	0	12	0	0
22	32887782	rs1029298	A	G	2	8	10	0	0	10	0	0
22	32887949	rs1029299	T	C	28	52	80	0	0	80	0	0
22	32888084	rs1029301	G	A	31	39	70	0	2	72	0	0
22	32888622	rs1029302	A	G	26	43	69	0	2	71	0	0
22	32892307	rs5998516	A	C	5	1	6	0	1	7	0	0
22	33253280	rs9862	T	C	9	13	22	0	0	22	0	0
22	33255893	.	G	A	42	26	68	0	1	69	0	0
22	33258777	rs11287	C	T	7	8	15	0	0	15	0	0
22	35660875	rs1053593	G	T	19	23	42	0	2	44	0	0
22	35663523	rs2413338	C	T	3	4	7	0	0	7	0	0
22	35664327	rs2235147	T	C	4	9	13	0	1	14	0	0
22	35664941	rs2235148	T	C	7	5	12	0	0	12	0	0
22	35689415	rs2272791	G	T	3	3	6	0	0	6	0	0
22	35690179	rs1474557	T	C	36	50	86	0	0	86	0	0
22	35690183	rs1474558	A	G	34	48	82	0	1	83	0	0
22	35690532	rs4821392	A	G	37	38	75	0	0	75	0	0
22	35696077	rs138728	G	C	6	5	11	0	0	11	0	0
22	35796257	rs4645731	G	T	4	3	7	0	0	7	0	0
22	35796652	rs743813	C	G	5	6	11	0	0	11	0	0
22	35797116	.	T	G	12	9	21	0	0	21	0	0
22	35797333	rs743815	T	C	12	12	24	0	0	24	0	0
22	35798935	rs4645747	G	A	25	31	56	0	2	58	0	0
22	35802893	rs2071737	A	G	5	6	11	0	1	12	0	0
22	35803720	rs4645768	C	T	5	10	15	0	0	15	0	0
22	35817597	rs133431	C	A	7	4	11	0	0	11	0	0
22	36055406	rs34014315	A	C	15	15	30	0	0	30	0	0
22	36059330	rs5755840	C	G	11	7	18	0	0	18	0	0
22	36061156	.	T	C	6	6	12	0	1	13	0	0
22	36064087	rs5750147	T	C	12	5	17	0	1	18	0	0
22	36064164	rs5755849	C	T	13	10	23	0	1	24	0	0
22	36064414	rs5999926	T	G	3	4	7	0	0	7	0	0
22	36136945	rs5750173	T	C	3	3	6	0	0	6	0	0
22	36138455	rs141298442	T	C	4	2	6	0	0	6	0	0
22	36679531	rs2008328	C	T	10	9	19	0	1	20	0	0
22	36679652	rs762964	T	A	3	3	6	0	1	7	0	0
22	36680825	rs2071733	C	G	5	5	10	0	0	10	0	0
22	36682873	.	A	G	850	782	1632	0	7	1639	0	0
22	36683555	rs9610482	C	T	11	16	27	0	1	28	0	0
22	36684331	rs5756130	C	T	743	623	1366	0	7	1373	0	0
22	36684354	rs2269529	T	C	602	687	1289	0	9	1298	0	0
22	36684358	rs2269530	C	A	605	669	1274	0	7	1282	1	0
22	36687007	rs572379829	G	A	3	3	6	0	0	6	0	0
22	36690113	rs4821478	G	A	4	5	9	0	0	9	0	0
22	36696777	rs117734021	T	C	6	2	8	0	0	8	0	0
22	36699306	rs2009930	G	A	3	3	6	0	0	6	0	0
22	36707047	rs2157253	C	A	6	73	79	0	1	80	0	0
22	36707200	rs2157254	G	C	4	79	83	0	1	84	0	0
22	36707403	rs2157255	T	A	0	38	38	0	4	42	0	0
22	36707661	rs2157256	A	G	2	94	96	0	0	96	0	0
22	36707712	rs2187778	G	A	3	97	100	0	2	102	0	0
22	36707758	rs2187779	G	C	2	95	97	0	1	98	0	0
22	36707862	rs9622376	G	A	0	74	74	0	0	74	0	0
22	36707873	rs9622377	C	T	1	72	73	0	0	73	0	0
22	36707951	rs5756138	T	C	3	71	74	0	4	78	0	0
22	36716029	rs6000239	T	C	14	13	27	0	0	27	0	0
22	36716209	rs3752463	G	A	5	13	18	0	0	18	0	0
22	36718858	rs2071731	G	A	16	8	24	0	0	24	0	0
22	36719012	rs5756153	G	A	6	9	15	0	0	15	0	0
22	36719387	rs9610491	C	T	6	5	11	0	0	11	0	0
22	36720041	rs73167632	T	C	10	6	16	0	0	16	0	0
22	36720424	rs5756154	C	T	45	34	79	0	1	80	0	0
22	36720569	rs5756155	C	T	41	25	66	0	2	68	0	0
22	36720779	rs5756156	C	T	4	7	11	0	0	11	0	0
22	36722490	rs8136069	C	A	9	5	14	0	0	14	0	0
22	36727551	rs8143119	G	T	7	5	12	0	0	12	0	0
22	36727674	rs144800568	C	T	4	9	13	0	0	13	0	0
22	36728256	rs5750252	A	G	9	7	16	0	0	16	0	0
22	36729074	rs4820234	A	G	3	3	6	0	0	6	0	0
22	36729413	rs78012052	G	A	5	1	6	0	0	6	0	0
22	36732537	rs1557540	C	T	4	3	7	0	0	7	0	0
22	37257855	rs2413426	G	A	12	9	21	0	0	21	0	0
22	37320873	rs2284030	T	C	5	8	13	0	0	13	0	0
22	37321080	rs2284031	T	C	11	4	15	0	0	15	0	0
22	37321263	rs181523341	C	T	9	4	13	0	0	13	0	0
22	37328751	rs2075936	A	G	18	34	52	0	1	53	0	0
22	37329111	rs1534880	G	C	3	3	6	0	0	6	0	0
22	37329448	rs1534881	G	A	3	3	6	0	0	6	0	0
22	37329545	rs1534882	A	G	3	4	7	0	0	7	0	0
22	37330082	rs2075937	T	C	29	39	68	0	0	68	0	0
22	37330249	rs738149	A	G	47	44	91	0	0	91	0	0
22	37330721	rs2179051	C	T	54	45	99	0	3	102	0	0
22	37330779	rs5756414	G	C	57	40	97	0	0	97	0	0
22	37330811	rs5756415	C	G	47	45	92	0	0	92	0	0
22	37331305	rs2239749	A	G	40	42	82	0	0	82	0	0
22	37333367	rs7292430	G	A	46	52	98	0	0	98	0	0
22	37333794	rs131840	A	G	518	507	1025	0	17	1043	1	0
22	37407194	rs4764	G	A	67	47	114	0	5	119	0	0
22	37416800	rs5756487	A	T	1	5	6	0	0	6	0	0
22	37421702	rs5756491	A	G	3	4	7	0	0	7	0	0
22	37423094	rs111965320	A	G	10	5	15	0	0	15	0	0
22	37425031	rs5750373	G	A	4	5	9	0	0	9	0	0
22	37586961	rs229532	T	A	6	1	7	0	0	7	0	0
22	37621358	rs12166968	C	G	262	263	525	0	3	528	0	0
22	37621951	rs9610680	G	A	499	492	991	0	15	1006	0	0
22	37622486	rs9622584	G	A	8	4	12	0	0	12	0	0
22	37628145	rs2285110	A	G	10	10	20	0	0	20	0	0
22	37870771	rs2071841	G	A	5	5	10	0	0	10	0	0
22	38013809	rs4456799	G	A	13	9	22	0	0	22	0	0
22	38022622	rs6000847	A	C	5	10	15	0	0	15	0	0
22	38025375	rs2071766	T	C	11	11	22	0	0	22	0	0
22	38028441	rs202112368	G	A	147	115	262	0	1	263	0	0
22	38039312	rs117732653	C	T	3	3	6	0	0	6	0	0
22	38046695	rs12170939	C	A	244	176	420	0	4	424	0	0
22	38051355	rs762989	G	A	34	36	70	0	7	78	1	0
22	38164106	rs4821708	C	T	62	44	106	0	2	108	0	0
22	38170026	rs1129448	G	A	47	62	109	0	0	109	0	0
22	38172213	rs3171656	G	A	48	40	88	0	0	88	0	0
22	38172380	rs15691	C	A	30	16	46	0	0	46	0	0
22	38202399	rs6000898	T	C	822	563	1385	0	73	1458	0	0
22	38204089	rs710187	C	T	46	46	92	0	0	92	0	0
22	38204540	rs2246503	C	A	3	7	10	0	0	10	0	0
22	38205989	rs2285178	T	C	4	32	36	0	0	36	0	0
22	38212762	rs13911	A	G	173	109	282	0	1	283	0	0
22	38213102	rs2269617	T	C	13	3	16	0	0	16	0	0
22	38227821	rs3091367	C	G	44	44	88	0	0	88	0	0
22	38267446	rs1009045	G	C	3	8	11	0	0	11	0	0
22	38267619	rs4820310	T	A	10	4	14	0	0	15	1	0
22	38268922	rs139838	G	A	8	3	11	0	1	12	0	0
22	38273749	rs9466	T	C	1150	1102	2252	0	20	2272	0	0
22	38285300	rs6000926	T	C	20	23	43	0	0	43	0	0
22	38323507	rs9610875	G	T	12	8	20	0	1	21	0	0
22	38351986	rs139862	T	C	1	12	13	0	0	13	0	0
22	38364205	rs3026641	G	A	5	3	8	0	0	8	0	0
22	38364339	rs5756866	T	C	9	6	15	0	0	15	0	0
22	38364552	rs139879	T	C	1	7	8	0	0	8	0	0
22	38463968	rs2076370	A	G	3	6	9	0	0	9	0	0
22	38507818	rs11570770	G	T	35	33	68	0	2	70	0	0
22	38519513	rs2076117	T	C	1	6	7	0	0	7	0	0
22	38519689	rs11570730	A	G	5	3	8	0	0	8	0	0
22	38522887	rs2235347	A	G	23	27	50	0	0	50	0	0
22	38523211	rs3788532	G	A	14	8	22	0	0	22	0	0
22	38598041	rs11703601	C	T	96	84	180	0	1	181	0	0
22	38608241	rs2064104	G	C	5	3	8	0	0	8	0	0
22	38610257	rs4821765	C	T	2	9	11	0	0	11	0	0
22	38612211	rs4821766	A	G	466	481	947	0	3	950	0	0
22	38612372	rs5995550	A	C	403	399	802	0	14	816	0	0
22	38615536	rs1059804	A	T	24	18	42	0	1	43	0	0
22	38617333	rs2235265	T	C	21	19	40	0	0	40	0	0
22	38763792	rs4821785	A	G	4	4	8	0	0	8	0	0
22	38887642	rs191309792	G	C	5	7	12	0	0	12	0	0
22	39082847	.	G	T	340	382	722	0	3	725	0	0
22	39109333	rs143547765	G	A	7	4	11	0	0	11	0	0
22	39116706	rs73157180	G	A	4	2	6	0	0	6	0	0
22	39144573	rs7290004	G	A	7	6	13	0	0	13	0	0
22	39178701	rs760482	A	G	5	4	9	0	1	10	0	0
22	39258078	rs733107	C	T	40	28	68	0	0	68	0	0
22	39260001	rs735305	G	A	18	18	36	0	0	36	0	0
22	39261135	rs2235140	C	G	28	25	53	0	0	53	0	0
22	39388486	rs150925968	T	A	14	16	30	0	0	30	0	0
22	39414934	rs9611079	C	T	84	95	179	0	2	181	0	0
22	39475386	rs141846968	G	A	12	3	15	0	0	15	0	0
22	39475964	rs5757464	G	A	15	3	18	0	0	18	0	0
22	39477566	rs8177832	A	G	44	33	77	0	1	78	0	0
22	39479353	rs2294366	T	A	4	3	7	0	0	7	0	0
22	39482486	.	G	A	52	32	84	0	0	84	0	0
22	39487722	rs139274	C	T	46	43	89	0	2	91	0	0
22	39488393	rs1569649	T	A	9	15	24	0	0	24	0	0
22	39709776	rs137620	T	C	53	67	120	0	1	121	0	0
22	39710244	rs137621	G	A	31	36	67	0	0	67	0	0
22	39712936	rs12484030	G	A	268	294	562	0	2	564	0	0
22	39713128	rs2072872	A	G	59	74	133	0	1	134	0	0
22	39714216	rs738331	A	G	3	4	7	0	0	7	0	0
22	39714490	rs6509	C	T	3127	3093	6220	0	54	6274	0	0
22	39715140	rs470082	C	T	6	5	11	0	0	11	0	0
22	39715262	rs5757613	G	A	5	5	10	0	0	10	0	0
22	39770597	rs4821888	A	G	5	5	10	0	0	10	0	0
22	39771920	rs1297231	G	C	10	3	13	0	0	13	0	0
22	39775047	rs5757647	C	A	5	4	9	0	0	9	0	0
22	39775156	rs5757648	G	A	2	4	6	0	0	6	0	0
22	39778167	rs1010169	A	G	5	1	6	0	0	6	0	0
22	39779300	rs756640	G	A	8	3	11	0	0	11	0	0
22	39820885	rs5750818	A	G	4	2	6	0	0	6	0	0
22	39826788	rs5750822	G	A	36	17	53	0	0	53	0	0
22	39827553	rs7949	G	A	51	40	91	0	0	91	0	0
22	40417571	rs35823589	G	A	6	4	10	0	0	10	0	0
22	40762619	.	C	T	10	8	18	0	0	18	0	0
22	40947458	rs9623184	C	T	5	11	16	0	0	16	0	0
22	41221432	.	A	G	164	159	323	0	3	326	0	0
22	41325068	rs2899341	G	A	2	6	8	0	0	8	0	0
22	41548008	rs20551	A	G	105	94	199	0	2	201	0	0
22	41565827	rs9611509	A	G	1	5	6	0	0	6	0	0
22	41569887	rs2076580	G	A	55	51	106	0	1	107	0	0
22	41570745	rs5758251	T	C	32	40	72	0	1	73	0	0
22	41613188	rs9611519	C	T	11	14	25	0	0	25	0	0
22	41617318	rs139472	G	C	5	2	7	0	0	7	0	0
22	41626663	rs139480	C	T	18	19	37	0	1	38	0	0
22	41642212	rs3171692	C	T	128	124	252	0	6	258	0	0
22	41645757	rs71948	C	G	120	91	211	0	0	211	0	0
22	41651704	rs139508	G	A	5	2	7	0	0	7	0	0
22	41726053	rs4822021	G	A	39	34	73	0	0	73	0	0
22	41752747	rs12484074	G	A	69	63	132	0	1	133	0	0
22	41753603	rs11090045	G	A	27	16	43	0	6	50	1	0
22	41755105	rs5751084	A	G	93	77	170	0	4	174	0	0
22	41755857	rs9538	G	T	71	61	132	0	0	132	0	0
22	41829794	rs6609	C	G	134	84	218	0	3	221	0	0
22	41830212	rs9611591	G	A	79	54	133	0	1	134	0	0
22	41832333	.	G	A	62	77	139	0	0	139	0	0
22	41833116	rs202641	C	T	73	58	131	0	2	133	0	0
22	41842203	rs202656	T	A	5	2	7	0	0	7	0	0
22	41855923	rs9423	A	C	23	6	29	0	3	32	0	0
22	41856137	rs202639	T	A	208	145	353	0	5	358	0	0
22	41858035	rs5751108	T	C	5	2	7	0	0	7	0	0
22	41864700	rs112844862	G	C	3	7	10	0	0	10	0	0
22	41865809	rs19573	C	A	4	2	6	0	1	7	0	0
22	41903813	rs137831	A	C	110	93	203	0	3	206	0	0
22	41911525	rs1799932	C	T	68	80	148	0	3	151	0	0
22	41913413	rs9619974	C	T	9	5	14	0	0	14	0	0
22	41913477	rs203320	T	C	2	9	11	0	0	11	0	0
22	41913844	rs17367716	A	G	2	7	9	0	0	9	0	0
22	41915329	rs11090049	C	T	4	2	6	0	0	6	0	0
22	41923644	rs17367849	G	A	15	9	24	0	2	26	0	0
22	41925535	rs4822032	T	C	5	3	8	0	0	8	0	0
22	41927227	rs74972231	C	T	17	6	23	0	0	23	0	0
22	41927700	rs1810460	C	T	6	13	19	0	0	19	0	0
22	41927820	rs1810461	G	A	8	6	14	0	1	15	0	0
22	41928320	rs73178625	G	C	8	6	14	0	0	14	0	0
22	41928371	rs73178626	T	G	13	6	19	0	0	19	0	0
22	41929175	rs2076198	T	G	6	12	18	0	0	18	0	0
22	41929960	rs4822033	T	G	9	14	23	0	1	24	0	0
22	41930522	rs9623414	G	A	14	11	25	0	0	25	0	0
22	41931010	rs4822034	T	C	8	8	16	0	1	17	0	0
22	41931074	rs9611606	A	G	13	14	27	0	0	27	0	0
22	41932323	rs9611607	C	T	5	3	8	0	0	8	0	0
22	41939739	rs12484228	A	G	4	4	8	0	0	8	0	0
22	41995335	rs8139993	T	C	12	15	27	0	0	27	0	0
22	41996131	rs148894219	C	T	6	0	6	0	0	6	0	0
22	42058846	rs132786	G	A	3	3	6	0	0	6	0	0
22	42058949	rs132787	G	A	6	6	12	0	0	12	0	0
22	42059768	rs132788	G	T	1220	1080	2300	0	5	2305	0	0
22	42070276	rs8779	T	C	82	183	265	0	1	266	0	0
22	42070793	rs132806	C	T	62	129	191	0	2	193	0	0
22	42071584	rs132807	T	C	8	31	39	0	1	40	0	0
22	42072912	rs1807497	C	A	5	21	26	0	0	26	0	0
22	42073134	rs1811113	C	T	4	23	27	0	0	27	0	0
22	42074042	rs949438	A	C	6	5	11	0	1	12	0	0
22	42074214	rs7285944	C	T	3	3	6	0	0	6	0	0
22	42074215	rs5996050	A	G	3	3	6	0	0	6	0	0
22	42075083	rs113633852	G	A	9	2	11	0	0	11	0	0
22	42075300	rs5758404	G	A	1	7	8	0	0	8	0	0
22	42075581	rs5751136	T	A	2	4	6	0	0	6	0	0
22	42076381	rs5758405	C	A	1	17	18	0	0	18	0	0
22	42076641	rs5758406	A	G	5	3	8	0	0	8	0	0
22	42076956	rs5758407	C	T	3	7	10	0	1	11	0	0
22	42092225	rs2187795	C	A	2	7	9	0	0	9	0	0
22	42177453	rs4822050	G	C	15	17	32	0	0	32	0	0
22	42190309	rs738247	A	G	6	5	11	0	0	11	0	0
22	42221846	rs41277466	C	T	4	7	11	0	0	11	0	0
22	42221951	rs41277467	C	T	11	6	17	0	0	17	0	0
22	42274034	rs9623465	G	T	151	143	294	0	2	296	0	0
22	42276742	rs2228314	G	C	267	249	516	0	4	520	0	0
22	42287454	rs2267443	A	G	4	2	6	0	0	6	0	0
22	42299535	rs17379759	A	G	8	7	15	0	0	15	0	0
22	42301133	rs1894710	T	C	9	3	12	0	0	12	0	0
22	42301712	rs2157590	T	C	287	249	536	0	11	547	0	0
22	42302311	rs4822067	G	A	48	35	83	0	1	84	0	0
22	42321251	rs7290134	A	G	9	6	15	0	0	15	0	0
22	42334953	rs1047997	C	G	38	30	68	0	0	68	0	0
22	42341308	rs7293091	A	G	57	36	93	0	1	94	0	0
22	42343091	rs6002555	G	A	36	18	54	0	0	54	0	0
22	42428727	rs133349	A	T	6	8	14	0	0	14	0	0
22	42454950	rs1063392	A	G	32	38	70	0	1	71	0	0
22	42463814	rs133369	C	T	77	88	165	0	0	165	0	0
22	42466509	rs133375	C	G	24	13	37	0	0	37	0	0
22	42477650	rs2071711	G	C	1	5	6	0	0	6	0	0
22	42481849	rs7245	G	A	124	114	238	0	0	238	0	0
22	42482502	rs4147641	C	G	5	7	12	0	0	12	0	0
22	42484466	rs6002596	G	A	5	5	10	0	0	10	0	0
22	42485292	rs4147640	T	C	12	7	19	0	0	19	0	0
22	42485671	rs2284087	T	C	4	4	8	0	0	8	0	0
22	42486723	rs1801311	G	A	305	318	623	0	2	625	0	0
22	42523659	.	A	C	2	4	6	0	0	6	0	0
22	42534051	rs28712237	A	G	6	1	7	0	0	7	0	0
22	42534075	rs4993393	G	A	8	1	9	0	0	9	0	0
22	42534148	rs2743449	C	T	1	5	6	0	0	6	0	0
22	42534276	rs28570317	C	G	0	7	7	0	0	7	0	0
22	42534600	rs6002633	T	C	3	5	8	0	0	8	0	0
22	42534682	rs2743451	T	C	6	4	10	0	1	11	0	0
22	42537271	rs2743458	T	C	4	4	8	0	0	8	0	0
22	42537597	rs1800754	A	G	1	5	6	0	0	6	0	0
22	42780457	.	A	G	7	6	13	0	0	13	0	0
22	42902872	rs2003671	C	T	7	0	7	0	0	7	0	0
22	42903579	rs2413693	G	T	11	1	12	0	0	12	0	0
22	42903852	rs5751290	T	C	5	3	8	0	0	8	0	0
22	42905177	rs1056566	T	C	79	24	103	0	7	110	0	0
22	42905495	rs6002775	C	G	36	1	37	0	1	38	0	0
22	42905681	rs7291176	T	C	39	7	46	0	0	46	0	0
22	42906738	.	G	A	56	16	72	0	2	74	0	0
22	42906838	rs2003672	C	T	75	22	97	0	1	98	0	0
22	42906958	rs1064877	C	T	57	13	70	0	1	71	0	0
22	42912029	rs3201001	G	T	287	83	370	0	7	377	0	0
22	42912136	rs8139383	G	T	280	115	395	0	2	397	0	0
22	42976249	rs141413836	A	G	26	22	48	0	0	48	0	0
22	43011403	rs137115	T	C	5	2	7	0	1	8	0	0
22	43024410	rs137139	C	T	3	4	7	0	0	7	0	0
22	43025942	rs2267453	T	G	5	3	8	0	0	8	0	0
22	43025950	rs2267454	C	T	5	3	8	0	0	8	0	0
22	43026296	rs737733	A	C	4	5	9	0	0	9	0	0
22	43026616	rs2285138	C	T	3	3	6	0	0	6	0	0
22	43026690	rs2285139	G	A	3	4	7	0	0	7	0	0
22	43026792	rs5758820	A	G	3	5	8	0	0	8	0	0
22	43088261	rs1053026	C	T	3	3	6	0	0	6	0	0
22	43088549	rs3747194	C	T	5	14	19	0	0	19	0	0
22	43088971	rs9623659	C	T	2	4	6	0	0	6	0	0
22	43089055	rs6002904	G	C	3	8	11	0	0	11	0	0
22	43193323	rs5751372	T	C	70	81	151	0	3	154	0	0
22	43193915	rs1811846	A	T	5	6	11	0	0	11	0	0
22	43195147	rs1128013	A	G	60	67	127	0	0	127	0	0
22	43203137	rs738535	C	T	51	53	104	0	0	104	0	0
22	43206950	rs1018448	A	C	26	33	59	0	0	59	0	0
22	43265827	rs7074	G	T	19	8	27	0	0	27	0	0
22	43266363	rs7073	C	T	64	64	128	0	3	131	0	0
22	43266774	rs8569	C	T	46	44	90	0	0	90	0	0
22	43267831	rs4822211	G	T	4	3	7	0	0	7	0	0
22	43267873	rs4822212	G	T	2	4	6	0	1	7	0	0
22	43268009	rs13433641	T	C	1	6	7	0	0	7	0	0
22	43268502	rs9607973	A	G	3	3	6	0	0	6	0	0
22	43269547	rs2267461	C	T	2	4	6	0	0	6	0	0
22	43272085	rs5751396	G	C	5	2	7	0	0	7	0	0
22	43272792	rs5751397	C	T	15	6	21	0	0	21	0	0
22	43273740	rs5759006	C	G	8	4	12	0	0	12	0	0
22	43273891	rs4822215	T	G	8	5	13	0	0	13	0	0
22	43274283	rs5759007	C	T	6	2	8	0	0	8	0	0
22	43274367	rs5759008	A	T	4	2	6	0	0	6	0	0
22	43274722	rs9611950	G	A	6	2	8	0	0	8	0	0
22	43274772	rs9611951	A	G	7	5	12	0	0	12	0	0
22	43274889	rs9611952	G	A	9	4	13	0	0	13	0	0
22	43275250	rs2073199	G	A	5	7	12	0	0	12	0	0
22	43275968	rs8141676	G	C	9	4	13	0	0	13	0	0
22	43276030	rs4820492	A	C	7	2	9	0	0	9	0	0
22	43277147	rs4822216	A	G	4	4	8	0	0	8	0	0
22	43277922	rs738537	G	A	6	2	8	0	0	8	0	0
22	43278220	rs2899365	C	T	46	38	84	0	0	84	0	0
22	43289473	rs5759013	G	A	40	30	70	0	0	70	0	0
22	43548155	rs138908	T	G	7	9	16	0	0	16	0	0
22	43551836	rs2284099	T	C	5	2	7	0	0	7	0	0
22	43558972	rs6972	G	A	870	928	1798	0	22	1820	0	0
22	43559137	rs6973	G	T	728	852	1580	0	12	1592	0	0
22	43562829	rs47340	G	T	63	63	126	0	1	127	0	0
22	43568512	rs34074034	C	T	64	48	112	0	2	114	0	0
22	43570463	rs2269525	A	G	2	6	8	0	0	8	0	0
22	43579081	rs59963284	C	T	20	21	41	0	1	42	0	0
22	43594138	rs138974	T	C	24	20	44	0	1	45	0	0
22	43594227	rs138975	A	G	22	26	48	0	1	49	0	0
22	43594916	rs114733657	T	C	17	20	37	0	1	38	0	0
22	43595806	rs115432544	G	A	10	6	16	0	0	16	0	0
22	43596125	rs138978	T	G	8	5	13	0	0	13	0	0
22	43596245	rs138979	C	T	5	2	7	0	0	7	0	0
22	43596827	rs115586296	C	T	5	3	8	0	0	8	0	0
22	43597610	rs74516270	C	T	12	6	18	0	0	18	0	0
22	43599023	rs9623778	G	C	10	9	19	0	0	19	0	0
22	43599838	rs41277513	G	A	34	21	55	0	0	55	0	0
22	43599917	rs138983	T	C	30	20	50	0	0	50	0	0
22	43606143	rs5759217	C	T	16	28	44	0	0	44	0	0
22	43607031	rs76683475	G	A	22	16	38	0	0	38	0	0
22	43608531	rs7284575	C	T	19	11	30	0	0	30	0	0
22	43610106	rs34893532	C	T	21	7	28	0	0	28	0	0
22	43610207	rs138993	A	G	24	12	36	0	0	36	0	0
22	43613766	rs12053785	G	C	4	2	6	0	0	6	0	0
22	43613773	rs12053783	C	A	4	2	6	0	0	6	0	0
22	43613871	rs66935080	C	T	5	2	7	0	0	7	0	0
22	43614316	rs9620123	C	G	20	13	33	0	0	33	0	0
22	43633960	rs141542020	G	A	5	3	8	0	1	9	0	0
22	43655427	rs5751457	A	G	3	5	8	0	0	8	0	0
22	43657982	rs5759234	T	C	6	1	7	0	1	8	0	0
22	44222345	rs763119	C	T	5	6	11	0	1	12	0	0
22	44222807	rs138060	A	C	4	9	13	0	0	13	0	0
22	44223066	rs4149444	T	C	2	7	9	0	0	9	0	0
22	44489896	rs738479	T	C	225	178	403	0	5	408	0	0
22	44558459	rs2744984	A	C	6	1	7	0	0	7	0	0
22	44567740	rs6006689	C	T	9	14	23	0	0	23	0	0
22	44567854	rs1127721	G	T	10	19	29	0	0	29	0	0
22	44585128	.	G	A	301	310	611	0	3	614	0	0
22	44590726	rs2748871	T	C	7	2	9	0	0	9	0	0
22	44595190	rs79614150	G	A	5	1	6	0	0	6	0	0
22	44600496	rs189549229	C	T	6	4	10	0	0	10	0	0
22	44602668	rs550778121	C	T	78	52	130	0	0	130	0	0
22	44889342	rs3747218	G	C	39	13	52	0	2	54	0	0
22	45253321	rs6007329	C	G	3	3	6	0	0	6	0	0
22	45253333	rs6007330	A	G	2	4	6	0	0	6	0	0
22	45255630	rs61756769	T	C	4	3	7	0	0	7	0	0
22	45255637	rs6007344	G	C	4	3	7	0	0	7	0	0
22	45258333	rs9614957	C	G	3	3	6	0	0	6	0	0
22	45258495	rs8777	A	G	1	9	10	0	0	10	0	0
22	45559908	rs132849	C	T	17	13	30	0	0	30	0	0
22	45559997	rs132850	T	C	21	18	39	0	2	41	0	0
22	45568419	rs8135904	G	A	1	6	7	0	0	7	0	0
22	45569845	rs2138156	C	T	3	3	6	0	0	6	0	0
22	45570105	rs132887	G	C	1	6	7	0	0	7	0	0
22	45570594	rs132891	C	T	3	5	8	0	0	8	0	0
22	45570969	rs9615052	C	T	6	6	12	0	0	12	0	0
22	45571446	rs17548707	C	T	6	9	15	0	0	15	0	0
22	45572864	rs147666272	A	C	3	4	7	0	0	7	0	0
22	45573154	rs2238800	C	T	4	2	6	0	0	6	0	0
22	45573406	rs9615053	C	A	3	5	8	0	0	8	0	0
22	45573450	rs17548742	A	C	7	4	11	0	0	11	0	0
22	45576140	rs12483881	C	T	6	5	11	0	0	11	0	0
22	45580836	rs9614613	G	C	74	72	146	0	1	147	0	0
22	45580899	rs2673084	G	C	81	89	170	0	1	171	0	0
22	45581521	rs1811817	C	T	38	35	73	0	0	73	0	0
22	45582860	rs1058024	G	C	60	45	105	0	1	106	0	0
22	45583606	rs1058033	G	T	214	194	408	0	5	415	2	0
22	45583740	rs1058040	G	C	71	61	132	0	1	133	0	0
22	45583803	rs1058043	A	G	37	31	68	0	0	68	0	0
22	45635216	rs2138149	C	T	3	3	6	0	0	6	0	0
22	45718627	rs7286605	G	A	4	2	6	0	0	6	0	0
22	45723807	rs11556482	G	C	3	28	31	0	2	33	0	0
22	45723842	rs17851057	G	A	3	32	35	0	0	35	0	0
22	45723854	rs9615108	C	G	34	2	36	0	0	36	0	0
22	45724727	rs6007592	G	A	0	15	15	0	0	15	0	0
22	45724999	rs736037	G	A	0	22	22	0	2	24	0	0
22	45725106	rs6006988	T	C	0	12	12	0	0	12	0	0
22	45728370	rs6007594	G	A	13	4	17	0	0	17	0	0
22	45736434	rs1056322	C	G	24	5	29	0	0	29	0	0
22	45736485	rs2064068	C	T	8	23	31	0	0	31	0	0
22	45736871	rs5766662	T	C	3	12	15	0	0	15	0	0
22	45737290	rs1044742	G	A	8	18	26	0	0	26	0	0
22	45737310	rs1044744	A	G	19	8	27	0	0	27	0	0
22	45737481	rs6007600	T	C	22	5	27	0	0	27	0	0
22	45737487	rs10343	G	A	8	22	30	0	0	30	0	0
22	46474200	rs7410764	A	C	7	1	8	0	0	8	0	0
22	46476665	.	T	C	8	5	13	0	0	13	0	0
22	46493852	rs3747243	C	T	1	5	6	0	0	6	0	0
22	46637511	rs41355347	G	A	4	2	6	0	0	6	0	0
22	46638128	rs45550937	C	G	4	2	6	0	0	6	0	0
22	46638159	rs10154348	C	A	4	2	6	0	0	6	0	0
22	46638171	rs45552534	G	A	3	3	6	0	0	6	0	0
22	46638211	rs79700435	G	A	3	3	6	0	0	6	0	0
22	46638636	.	A	G	7	2	9	0	0	9	0	0
22	46638638	rs572183855	A	G	7	2	9	0	0	9	0	0
22	46639457	rs14842	A	T	3	3	6	0	0	6	0	0
22	46639462	rs14843	A	T	3	3	6	0	0	6	0	0
22	46640179	rs1053332	A	G	16	12	28	0	0	28	0	0
22	46640581	rs571207188	T	C	3	6	9	0	0	9	0	0
22	46664431	rs9627359	C	G	43	57	100	0	2	102	0	0
22	46677003	rs73886789	C	T	15	20	35	0	0	35	0	0
22	46677997	rs11090858	G	A	3	3	6	0	0	6	0	0
22	46680021	rs6008506	T	G	16	11	27	0	0	27	0	0
22	46680067	rs6008507	T	C	22	16	38	0	0	38	0	0
22	46685249	rs6008534	G	A	7	1	8	0	0	8	0	0
22	46687460	rs11090859	T	G	8	0	8	0	0	8	0	0
22	46687758	rs147696491	C	A	3	3	6	0	0	6	0	0
22	46688208	rs6008552	C	A	64	8	72	0	1	73	0	0
22	46689229	rs57866552	C	T	89	104	193	0	4	197	0	0
22	46689347	rs58980421	G	A	121	145	266	0	5	271	0	0
22	46704577	rs141501144	T	G	14	16	30	0	0	30	0	0
22	46704771	rs145330697	C	T	21	10	31	0	0	31	0	0
22	46748946	rs6007889	C	T	5	2	7	0	1	8	0	0
22	46753179	rs13585	G	A	11	14	25	0	0	25	0	0
22	46756833	rs6007891	C	T	4	4	8	0	0	8	0	0
22	46982955	rs79627293	G	A	2	5	7	0	0	7	0	0
22	46986733	rs5767280	G	A	4	4	8	0	0	8	0	0
22	46986748	rs5768999	G	A	4	4	8	0	0	8	0	0
22	46987302	rs5767284	C	T	4	4	8	0	0	8	0	0
22	47069223	rs2073274	A	G	3	5	8	0	0	8	0	0
22	47069336	rs36030561	C	G	7	4	11	0	0	11	0	0
22	47071531	rs2073276	T	C	6	6	12	0	0	12	0	0
22	47071860	rs2748341	A	C	5	8	13	0	0	13	0	0
22	47072070	rs17821673	C	T	6	1	7	0	0	7	0	0
22	47072477	rs2236028	G	A	3	8	11	0	0	11	0	0
22	47073721	rs5769068	C	T	29	33	62	0	0	62	0	0
22	47073875	rs2748343	T	C	22	36	58	0	0	58	0	0
22	47074258	rs3747253	G	A	11	5	16	0	0	16	0	0
22	47074281	rs3747255	G	A	9	8	17	0	0	17	0	0
22	47074937	rs2542026	T	C	48	52	100	0	0	100	0	0
22	47075462	rs3179	C	T	54	31	85	0	0	85	0	0
22	47080801	rs1047123	G	C	29	26	55	0	0	55	0	0
22	47081088	rs2236029	A	G	23	25	48	0	0	48	0	0
22	47082159	rs801720	C	A	18	15	33	0	0	33	0	0
22	47083010	rs2542014	T	C	8	18	26	0	1	27	0	0
22	47083012	rs2748349	T	A	8	19	27	0	0	27	0	0
22	47087670	rs36211083	G	A	11	14	25	0	0	25	0	0
22	47130078	rs2080581	T	A	2	6	8	0	0	8	0	0
22	47130651	rs1548977	A	G	5	7	12	0	0	12	0	0
22	47130782	rs1548978	A	T	8	6	14	0	0	14	0	0
22	47158179	rs12389	G	A	155	93	248	0	1	249	0	0
22	47570544	rs2207680	G	A	4	3	7	0	0	7	0	0
22	47571085	rs2294295	C	T	5	2	7	0	0	7	0	0
22	48989851	rs28385606	A	G	4	4	8	0	0	8	0	0
22	49988815	rs2007024	C	T	5	6	11	0	2	13	0	0
22	49989106	rs1109320	G	A	9	9	18	0	0	18	0	0
22	49989272	rs75772261	T	C	9	9	18	0	0	18	0	0
22	49989649	rs73176988	G	T	8	3	11	0	0	11	0	0
22	50050468	rs739239	G	A	13	18	31	0	0	31	0	0
22	50050847	rs9616333	G	A	18	36	54	0	0	54	0	0
22	50050859	rs9616714	G	A	18	36	54	0	0	54	0	0
22	50050914	rs150881946	C	T	32	16	48	0	1	49	0	0
22	50051007	rs6009803	A	G	2	18	20	0	0	20	0	0
22	50278584	rs146411541	C	T	45	32	77	0	0	77	0	0
22	50498885	rs9628320	G	A	53	43	96	0	1	97	0	0
22	50499964	rs137919	T	C	84	76	160	0	0	160	0	0
22	50512514	rs2272832	T	G	35	21	56	0	0	56	0	0
22	50512617	rs2038048	C	T	45	26	71	0	0	71	0	0
22	50610628	rs6010198	G	A	6	9	15	0	0	15	0	0
22	50611311	rs9628300	C	A	4	3	7	0	0	7	0	0
22	50613202	rs4838859	G	A	12	13	25	0	0	25	0	0
22	50613714	rs2294397	A	G	12	8	20	0	0	20	0	0
22	50616806	rs5771206	A	G	7	6	13	0	2	15	0	0
22	50625166	rs7288889	T	G	6	10	16	0	0	16	0	0
22	50625271	rs73187244	T	C	3	9	12	0	0	12	0	0
22	50625449	rs73187245	C	T	3	7	10	0	0	10	0	0
22	50626791	rs5771215	C	A	11	6	17	0	0	17	0	0
22	50627188	rs11912419	C	T	7	6	13	0	0	13	0	0
22	50627253	rs1555050	C	T	11	10	21	0	0	21	0	0
22	50627704	rs5771217	G	T	5	4	9	0	0	9	0	0
22	50628451	rs4838812	A	G	16	14	30	0	0	30	0	0
22	50628746	rs735119	T	G	2	8	10	0	0	10	0	0
22	50628996	rs56036086	G	A	8	2	10	0	0	10	0	0
22	50629292	rs732405	T	G	16	13	29	0	1	30	0	0
22	50629872	rs73187247	C	T	18	23	41	0	1	42	0	0
22	50630670	rs738339	C	T	35	24	59	0	1	60	0	0
22	50630794	rs56308603	G	A	34	38	72	0	0	72	0	0
22	50631226	rs2341367	T	C	38	22	60	0	2	62	0	0
22	50633686	rs6537639	T	C	7	10	17	0	0	17	0	0
22	50634526	rs73187249	G	A	12	10	22	0	1	23	0	0
22	50634552	rs73187250	G	A	14	13	27	0	0	27	0	0
22	50635120	rs4084289	A	G	8	5	13	0	0	13	0	0
22	50637193	rs3747941	A	G	84	84	168	0	3	171	0	0
22	50637597	rs8238	G	C	281	268	549	0	5	554	0	0
22	50637922	rs6712	G	C	190	215	405	0	4	409	0	0
22	50638172	rs563890950	G	C	19	18	37	0	1	38	0	0
22	50638953	rs1009610	A	G	6	5	11	0	1	12	0	0
22	50639965	rs2272846	C	A	2	4	6	0	0	6	0	0
22	50641351	rs4395345	G	A	7	18	25	0	0	25	0	0
22	50642359	rs73187254	C	T	15	14	29	0	0	29	0	0
22	50642777	rs4838861	C	T	15	11	26	0	0	26	0	0
22	50642793	rs4838814	C	G	13	11	24	0	0	24	0	0
22	50644480	rs56109781	T	C	14	16	30	0	0	30	0	0
22	50645219	rs11913090	G	A	18	20	38	0	2	40	0	0
22	50647448	rs55958053	T	G	12	6	18	0	0	18	0	0
22	50647966	rs4602327	A	G	19	16	35	0	1	36	0	0
22	50649545	rs4838863	A	G	7	7	14	0	0	14	0	0
22	50650418	rs75505866	C	T	3	4	7	0	0	7	0	0
22	50651785	rs73187263	C	T	5	7	12	0	0	12	0	0
22	50657112	rs11912397	C	T	4	5	9	0	0	9	0	0
22	50658053	rs6537642	A	G	16	10	26	0	0	26	0	0
22	50661869	rs5771242	T	C	6	10	16	0	0	16	0	0
22	50664612	rs4838865	A	G	19	18	37	0	1	38	0	0
22	50683792	rs7292864	A	G	20	9	29	0	1	30	0	0
22	50684296	rs13058062	T	C	9	10	19	0	1	20	0	0
22	50688348	rs1555048	A	G	130	110	240	0	4	244	0	0
22	50690322	rs2341111	G	C	3	4	7	0	0	7	0	0
22	50692562	rs5771276	G	A	25	3	28	0	0	28	0	0
22	50692848	rs2009816	G	A	21	1	22	0	0	22	0	0
22	50692853	rs2880034	G	A	21	1	22	0	0	22	0	0
22	50692856	rs2009815	C	T	21	1	22	0	1	23	0	0
22	50692878	rs1810456	G	A	23	2	25	0	0	25	0	0
22	50692908	rs4077315	C	T	24	2	26	0	1	27	0	0
22	50693340	rs5771280	A	T	6	2	8	0	0	8	0	0
22	50693479	rs5771281	A	G	7	5	12	0	0	12	0	0
22	50693534	rs6010218	A	G	6	0	6	0	0	6	0	0
22	50693538	rs6010219	G	A	6	0	6	0	0	6	0	0
22	50694297	rs1129880	A	G	107	80	187	0	2	189	0	0
22	50695270	rs5771284	A	C	26	16	42	0	0	42	0	0
22	50695908	rs5771285	G	T	61	20	81	0	0	81	0	0
22	50695946	rs5771111	C	G	66	25	91	0	0	91	0	0
22	50714491	rs6010224	A	C	5	9	14	0	0	14	0	0
22	50714541	rs6010225	A	G	5	7	12	0	0	12	0	0
22	50716167	rs1127000	G	A	75	86	161	0	0	161	0	0
22	50717547	rs28633213	T	C	3	3	6	0	0	6	0	0
22	50719251	rs11547734	A	G	54	60	114	0	0	114	0	0
22	50719976	rs111925803	C	T	3	22	25	0	0	25	0	0
22	50720622	rs11547728	C	T	49	52	101	0	0	101	0	0
22	50722408	rs79966207	T	C	34	24	58	0	1	59	0	0
22	50747995	rs35729162	C	T	8	5	13	0	0	13	0	0
22	50748325	rs35197053	C	T	10	8	18	0	0	18	0	0
22	50748930	rs68069258	T	C	11	5	16	0	0	16	0	0
22	50748943	rs67286232	T	C	9	5	14	0	0	14	0	0
22	50749153	rs113848466	T	C	14	6	20	0	0	20	0	0
22	50749197	rs62241223	C	T	12	8	20	0	0	20	0	0
22	50749241	rs62241224	T	C	18	8	26	0	0	26	0	0
22	50749352	rs62241225	A	G	9	1	10	0	0	10	0	0
22	50751529	rs67248662	G	C	82	57	139	0	2	141	0	0
22	50752150	rs68178377	C	T	73	56	129	0	0	129	0	0
22	50752169	rs73891220	G	A	6	3	9	0	0	9	0	0
22	50753334	rs73439311	G	A	21	7	28	0	0	28	0	0
22	50754466	rs62241230	C	T	24	11	35	0	1	36	0	0
22	50754648	.	T	C	20	9	29	0	0	29	0	0
22	50754970	.	C	T	7	3	10	0	0	10	0	0
22	50761999	rs62241241	A	G	7	0	7	0	0	7	0	0
22	50762000	rs62241242	A	C	7	0	7	0	0	7	0	0
22	50764057	rs4074135	T	C	7	1	8	0	0	8	0	0
22	50879447	rs2273260	T	G	42	37	79	0	0	79	0	0
22	50879931	rs5770930	G	A	9	7	16	0	0	16	0	0
22	50883728	rs761744	G	A	34	23	57	0	0	57	0	0
22	50884462	.	G	A	25	22	47	0	0	47	0	0
22	50885775	rs1053744	A	G	103	109	212	0	2	214	0	0
22	50895133	rs4824117	A	G	7	1	8	0	0	8	0	0
22	50941985	rs6009975	T	C	71	86	157	0	3	160	0	0
22	50942121	rs13056405	C	T	121	89	210	0	3	213	0	0
22	50944128	rs743615	G	A	44	42	86	0	1	87	0	0
22	50944163	rs128941	G	A	41	41	82	0	0	82	0	0
22	50946691	.	C	T	64	47	111	0	0	111	0	0
22	50961169	rs131813	A	G	10	2	12	0	0	12	0	0
22	50961786	rs41282347	C	T	154	105	259	0	3	262	0	0
22	50961854	rs2782	T	C	67	49	116	0	0	116	0	0
22	50962208	rs12148	T	G	56	70	126	0	2	128	0	0
22	50962782	rs140523	C	G	30	44	74	0	1	75	0	0
22	50964862	rs131804	G	A	4	4	8	0	0	8	0	0
22	50966634	rs131801	G	T	6	6	12	0	0	12	0	0
22	50966914	rs470119	T	C	4	3	7	0	0	7	0	0
22	50967269	rs131800	A	G	4	6	10	0	0	10	0	0
22	50970068	rs141953471	C	T	5	4	9	0	0	9	0	0
22	50988062	rs140519	G	T	5	6	11	0	1	12	0	0
22	50989326	rs131778	A	G	4	2	6	0	0	6	0	0
22	51007452	rs15195	C	T	18	51	69	0	2	71	0	0
22	51017082	rs131758	T	A	6	27	33	0	0	33	0	0
22	51062222	rs131717	G	C	0	9	9	0	0	9	0	0
22	51062891	rs7288338	C	G	1	7	8	0	0	8	0	0
22	51063987	rs762674	G	C	0	6	6	0	1	7	0	0
22	51064039	rs743616	G	C	30	94	124	0	0	124	0	0
22	51117580	rs9616915	T	C	51	48	99	0	0	99	0	0
22	51123467	rs9616815	T	C	1	6	7	0	0	7	0	0
22	51143606	rs76179018	C	G	3	4	7	0	0	7	0	0
22	51162814	.	G	T	9	14	23	0	0	23	0	0
22	51171497	rs2301584	G	A	72	77	149	0	2	151	0	0
22	51206413	rs3888556	T	A	17	15	32	0	0	32	0	0
22	51206426	rs3888555	T	C	16	12	28	0	0	28	0	0
3	3171897	rs6788122	T	C	7	5	12	0	0	12	0	0
3	3189279	rs1705805	A	G	4	4	8	0	0	8	0	0
3	3190240	rs12107469	T	C	5	5	10	0	1	11	0	0
3	3192927	rs1620675	T	G	11	4	15	0	0	15	0	0
3	3193826	rs1055926	T	A	10	5	15	0	1	16	0	0
3	3195369	rs73005226	A	G	12	10	22	0	1	23	0	0
3	3195574	rs3846135	C	T	20	8	28	0	0	28	0	0
3	3197035	rs2291398	T	G	5	10	15	0	0	15	0	0
3	3199635	rs1669338	A	C	7	0	7	0	0	7	0	0
3	3201432	rs1705832	T	C	2	5	7	0	0	7	0	0
3	3209242	rs4685612	G	T	21	21	42	0	0	42	0	0
3	4403153	rs14275	T	G	21	12	33	0	0	33	0	0
3	4403536	rs74979662	A	T	6	6	12	0	0	12	0	0
3	4403537	rs4685744	C	T	6	6	12	0	0	12	0	0
3	4403818	rs35083095	T	C	8	11	19	0	0	19	0	0
3	4829732	rs13079522	A	G	34	32	66	0	0	66	0	0
3	4856234	rs901854	G	A	45	52	97	0	0	97	0	0
3	5025541	.	A	G	356	651	1007	0	24	1031	0	0
3	5212903	rs3856889	C	T	4	9	13	0	0	13	0	0
3	5216744	.	C	A	1	5	6	0	0	6	0	0
3	5225783	rs455832	T	G	75	54	129	0	0	129	0	0
3	5231037	rs343422	G	C	10	3	13	0	0	13	0	0
3	5231478	rs13069221	G	A	4	9	13	0	0	13	0	0
3	5231826	rs343420	T	C	2	5	7	0	0	7	0	0
3	5232074	rs343419	A	C	9	3	12	0	0	12	0	0
3	5232080	rs343418	C	T	9	4	13	0	0	13	0	0
3	5232489	rs343417	C	G	8	7	15	0	1	16	0	0
3	5246166	rs13085849	C	T	9	4	13	0	0	13	0	0
3	5253361	.	G	A	11	8	19	0	1	20	0	0
3	5256169	rs341987	G	A	4	5	9	0	0	9	0	0
3	5256856	rs341985	G	A	7	2	9	0	0	9	0	0
3	5258078	rs341984	G	A	63	55	118	0	1	119	0	0
3	9099989	rs61747289	A	G	5	1	6	0	0	6	0	0
3	9422720	rs1129869	A	G	2	4	6	0	0	6	0	0
3	9727002	rs787836	G	C	7	6	13	0	0	13	0	0
3	9730868	rs159142	G	C	4	3	7	0	0	7	0	0
3	9775160	rs159146	G	A	3	8	11	0	0	11	0	0
3	9779855	rs159155	A	G	4	7	11	0	1	12	0	0
3	9841382	.	C	T	6	13	19	0	0	19	0	0
3	9933100	rs77424266	A	G	7	7	14	0	0	14	0	0
3	9935263	rs279543	A	G	93	73	166	0	1	167	0	0
3	9957455	rs1056286	C	T	9	7	16	0	0	16	0	0
3	9960070	rs708567	C	T	10	12	22	0	0	22	0	0
3	9970158	rs279548	C	T	16	16	32	0	0	32	0	0
3	9981952	.	T	C	9	7	16	0	2	18	0	0
3	9983196	rs138666607	T	C	6	6	12	0	1	13	0	0
3	10005161	.	A	T	2	10	12	0	0	12	0	0
3	10006936	.	A	T	2	5	7	0	0	7	0	0
3	10040546	.	T	G	12	7	19	0	0	19	0	0
3	10059436	rs8411	T	C	65	53	118	0	1	119	0	0
3	10063555	rs79945990	T	C	2	5	7	0	0	7	0	0
3	10142949	rs3172417	C	T	24	34	58	0	0	58	0	0
3	10251340	rs464286	C	G	7	9	16	0	1	17	0	0
3	10255002	rs35060588	C	G	7	11	18	0	0	18	0	0
3	10264480	rs3844283	C	G	16	16	32	0	0	32	0	0
3	10304624	rs6781468	A	G	4	2	6	0	0	6	0	0
3	10304701	rs9851266	C	A	6	1	7	0	0	7	0	0
3	10311939	rs2075352	C	T	33	39	72	0	0	72	0	0
3	10312507	rs2075353	A	G	60	48	108	0	1	109	0	0
3	10319262	rs242729	G	T	5	7	12	0	0	12	0	0
3	10319274	rs3774202	C	T	7	5	12	0	0	12	0	0
3	10319540	rs242728	C	T	7	5	12	0	0	12	0	0
3	10319720	rs4684675	G	T	9	11	20	0	0	20	0	0
3	10321229	rs3204477	G	T	28	36	64	0	0	64	0	0
3	10321517	rs10285	G	A	48	50	98	0	3	101	0	0
3	10321551	rs77318135	T	C	58	44	102	0	1	103	0	0
3	10321734	rs514658	C	T	59	62	121	0	0	121	0	0
3	10322521	rs2072578	T	C	68	58	126	0	2	128	0	0
3	10325950	rs11718213	A	C	3	3	6	0	0	6	0	0
3	10326686	rs35684	A	G	5	2	7	0	0	7	0	0
3	10331457	rs696217	G	T	6	2	8	0	0	8	0	0
3	10334021	rs27498	G	A	6	3	9	0	0	9	0	0
3	10342876	rs696221	C	T	298	294	592	0	18	610	0	0
3	10344111	rs696220	G	A	8	13	21	0	0	21	0	0
3	10344689	rs697233	G	A	9	4	13	0	0	13	0	0
3	10345527	rs697232	G	A	4	8	12	0	1	13	0	0
3	10347707	rs154235	G	A	2	4	6	0	0	6	0	0
3	10356223	.	C	T	5	3	8	0	0	8	0	0
3	10356314	rs154236	C	T	6	10	16	0	0	16	0	0
3	10359628	rs1642977	T	A	5	1	6	0	0	6	0	0
3	10362292	rs154240	T	C	9	17	26	0	0	26	0	0
3	11320169	rs77207623	C	G	11	8	19	0	0	19	0	0
3	11324080	rs77996146	G	A	16	15	31	0	0	31	0	0
3	11324794	rs921226	C	T	17	24	41	0	0	41	0	0
3	11400019	rs36117895	T	C	21	21	42	0	0	42	0	0
3	11687852	rs9310387	G	A	12	4	16	0	0	16	0	0
3	11687863	rs9310388	A	G	9	5	14	0	0	14	0	0
3	12544829	rs33955793	G	A	7	5	12	0	0	12	0	0
3	12613866	rs2648307	T	C	47	53	100	0	2	102	0	0
3	12620720	rs2454429	G	A	5	5	10	0	0	10	0	0
3	12622623	rs9849171	G	C	6	9	15	0	0	15	0	0
3	12622943	rs2596825	G	C	7	4	11	0	0	11	0	0
3	12624070	rs15997	C	T	37	50	87	0	0	87	0	0
3	12625747	rs1051208	G	A	250	268	518	0	4	522	0	0
3	12626516	rs3729931	G	A	7	8	15	0	1	16	0	0
3	12629892	rs148153324	C	T	2	8	10	0	0	10	0	0
3	12633552	rs2442808	T	C	4	5	9	0	0	9	0	0
3	12634518	rs2016492	T	C	3	3	6	0	0	6	0	0
3	12878465	rs3773304	C	A	14	12	26	0	1	27	0	0
3	12880030	rs3821608	G	C	11	14	25	0	0	25	0	0
3	12939546	rs9211	G	A	86	75	161	0	0	161	0	0
3	12940346	rs14191	G	A	67	50	117	0	2	119	0	0
3	12941094	rs3773308	G	A	51	50	101	0	1	102	0	0
3	12945664	.	G	A	4	2	6	0	0	6	0	0
3	12952111	rs2596903	A	G	2	6	8	0	0	8	0	0
3	12954868	rs2600322	A	G	4	4	8	0	0	8	0	0
3	12959342	rs2596901	G	A	4	2	6	0	0	6	0	0
3	12959695	rs2596900	T	C	3	6	9	0	0	9	0	0
3	12962074	rs35319679	G	A	39	23	62	0	1	63	0	0
3	12963445	rs2252275	T	A	6	2	8	0	0	8	0	0
3	13057144	rs56102901	G	A	7	4	11	0	2	13	0	0
3	13545697	rs17038240	C	T	8	5	13	0	0	13	0	0
3	14154231	rs2731316	T	G	3	5	8	0	1	9	0	0
3	14177194	rs2607765	T	C	12	20	32	0	0	32	0	0
3	14178088	rs144356815	G	A	11	6	17	0	0	17	0	0
3	14179422	rs2731329	A	G	12	7	19	0	0	19	0	0
3	14179453	rs2731328	C	G	13	7	20	0	0	20	0	0
3	14180552	rs2607767	A	G	8	5	13	0	0	13	0	0
3	14180633	rs2731320	C	T	7	5	12	0	1	13	0	0
3	14183410	rs1043943	T	C	44	51	95	0	0	95	0	0
3	14183758	rs1043953	A	G	73	74	147	0	6	153	0	0
3	14184074	rs13069	A	C	43	69	112	0	3	115	0	0
3	14184669	rs8516	T	C	34	54	88	0	0	88	0	0
3	14184719	rs10468	T	C	42	55	97	0	2	99	0	0
3	14186757	rs1126547	C	G	34	19	53	0	1	54	0	0
3	14186823	rs2470458	T	C	103	95	198	0	1	199	0	0
3	14186830	rs2470352	A	T	95	101	196	0	1	197	0	0
3	14187345	rs2229090	G	C	108	105	213	0	1	214	0	0
3	14187449	rs2228001	G	T	79	89	168	0	2	170	0	0
3	14187699	rs2733532	T	C	2	4	6	0	0	6	0	0
3	14188700	rs2733533	C	A	5	8	13	0	0	13	0	0
3	14188762	rs2733534	G	C	1	9	10	0	0	10	0	0
3	14189147	rs2257984	A	G	10	15	25	0	1	26	0	0
3	14189340	rs2607749	A	G	4	12	16	0	0	16	0	0
3	14190237	rs2279017	T	G	24	20	44	0	0	44	0	0
3	14190268	rs2470353	G	C	29	16	45	0	0	45	0	0
3	14191237	rs2733535	G	A	7	4	11	0	0	11	0	0
3	14192504	rs2607734	A	G	15	7	22	0	0	22	0	0
3	14192933	rs2607736	A	G	5	5	10	0	0	10	0	0
3	14193168	rs2607737	C	T	5	7	12	0	0	12	0	0
3	14198275	rs3731137	G	A	5	2	7	0	0	7	0	0
3	14199887	rs2228000	G	A	49	74	123	0	0	123	0	0
3	14211101	rs2733537	A	G	4	5	9	0	0	9	0	0
3	14218737	.	T	G	4	4	8	0	0	8	0	0
3	14219002	rs2607772	A	G	10	9	19	0	0	19	0	0
3	14240501	rs2733552	A	G	9	4	13	0	0	13	0	0
3	14240535	rs2733553	C	T	6	1	7	0	0	7	0	0
3	14241290	rs2607773	G	A	3	4	7	0	0	7	0	0
3	14242442	rs1127122	A	G	7	8	15	0	0	15	0	0
3	14447460	rs111506028	G	C	3	5	8	0	1	9	0	0
3	14485484	rs36107877	C	A	2	4	6	0	0	6	0	0
3	14489370	rs2304511	G	T	276	409	685	0	9	694	0	0
3	14492215	rs3773186	G	A	14	15	29	0	1	30	0	0
3	14494855	rs3773182	G	A	13	18	31	0	1	32	0	0
3	14495455	rs1529942	G	A	20	29	49	0	0	49	0	0
3	14496074	rs11919644	G	A	20	24	44	0	0	44	0	0
3	14496147	rs9834629	C	T	14	20	34	0	1	35	0	0
3	14496162	rs11128699	G	A	12	20	32	0	0	32	0	0
3	14496929	rs3773181	G	A	15	44	59	0	0	59	0	0
3	14496974	rs3773180	G	T	18	42	60	0	0	60	0	0
3	14497019	rs3773179	G	T	47	17	64	0	1	65	0	0
3	14497631	rs11128700	T	C	17	49	66	0	2	68	0	0
3	14498046	rs1469879	A	G	4	7	11	0	0	11	0	0
3	14511840	rs11928756	T	C	5	2	7	0	0	7	0	0
3	14513456	rs55853390	C	T	9	11	20	0	0	20	0	0
3	14517006	rs2164575	A	G	7	7	14	0	0	14	0	0
3	14522194	rs11710744	T	C	1	5	6	0	0	6	0	0
3	14522330	rs17039655	C	T	0	6	6	0	0	6	0	0
3	14526538	rs1062540	G	A	34	53	87	0	1	88	0	0
3	14526656	rs1126666	A	G	29	63	92	0	5	97	0	0
3	14527363	rs2327896	G	A	53	80	133	0	5	138	0	0
3	14527939	rs2341983	C	G	30	63	93	0	0	94	1	0
3	14528004	rs2341984	T	C	21	63	84	0	0	84	0	0
3	14528256	rs4685165	C	T	43	77	120	0	1	121	0	0
3	14530133	rs11128702	C	T	90	64	154	0	1	155	0	0
3	14703862	rs3936360	A	G	2	4	6	0	0	6	0	0
3	14705814	rs73139860	G	A	4	6	10	0	0	10	0	0
3	14708918	rs2280383	A	G	4	7	11	0	0	11	0	0
3	14712473	rs1901	G	A	63	76	139	0	1	140	0	0
3	14712732	rs61316466	C	G	19	38	57	0	2	59	0	0
3	14712868	rs17040096	C	T	31	33	64	0	0	64	0	0
3	14713058	rs11717438	G	T	27	45	72	0	2	74	0	0
3	14713121	rs11717411	C	G	20	39	59	0	0	59	0	0
3	14719946	rs7633080	C	T	6	11	17	0	0	17	0	0
3	14720135	rs6442466	T	C	6	4	10	0	0	10	0	0
3	14720477	rs6442467	G	A	17	15	32	0	0	32	0	0
3	14720791	rs11128715	A	G	15	17	32	0	0	32	0	0
3	14720793	rs75165238	G	A	15	17	32	0	0	32	0	0
3	14721074	rs1344783	C	T	13	13	26	0	0	26	0	0
3	14721266	rs1344782	T	G	11	13	24	0	1	25	0	0
3	14721354	rs185322347	A	T	9	9	18	0	1	19	0	0
3	14721633	rs1574575	C	T	23	22	45	0	0	45	0	0
3	14939479	rs2164356	G	T	63	44	107	0	1	108	0	0
3	14975150	rs115103798	G	A	70	65	135	0	1	136	0	0
3	14975366	rs141570843	G	A	62	64	126	0	0	126	0	0
3	14988585	rs67890284	A	G	12	7	19	0	0	19	0	0
3	15476011	rs1563415	C	G	107	85	192	0	1	193	0	0
3	15482775	rs6778562	C	G	121	113	234	0	3	237	0	0
3	15483830	rs1048608	A	G	183	190	373	0	1	374	0	0
3	15492786	rs2278962	T	A	3	3	6	0	0	6	0	0
3	15492807	rs2278961	G	A	5	2	7	0	0	7	0	0
3	15686693	rs13078881	G	C	12	9	21	0	0	21	0	0
3	15717614	rs17041435	G	A	14	10	24	0	1	25	0	0
3	15719049	rs34208188	T	C	117	120	237	0	1	238	0	0
3	15820052	rs112867551	G	C	10	6	16	0	1	17	0	0
3	16299968	rs842252	G	A	8	17	25	0	0	25	0	0
3	16300335	rs842253	T	C	6	7	13	0	0	13	0	0
3	16300625	rs842254	T	C	6	18	24	0	0	24	0	0
3	16301148	rs10087	T	C	4	5	9	0	0	9	0	0
3	16301564	rs842255	G	A	9	9	18	0	0	18	0	0
3	16305674	rs14080	C	G	17	13	30	0	0	30	0	0
3	16306845	.	T	G	5	1	6	0	0	6	0	0
3	16312564	rs842259	C	T	4	5	9	0	0	9	0	0
3	16327855	rs842274	T	G	8	3	11	0	0	11	0	0
3	16354096	rs949756	A	G	2	5	7	0	0	7	0	0
3	16354679	rs2657598	A	C	4	3	7	0	1	8	0	0
3	16356466	rs860923	G	A	4	2	6	0	0	6	0	0
3	16357978	rs842424	T	A	6	80	86	0	3	89	0	0
3	16358584	rs690241	T	C	0	49	49	0	0	49	0	0
3	16360345	rs689716	T	C	2	12	14	0	0	14	0	0
3	16360833	rs555948	A	C	2	11	13	0	0	13	0	0
3	16364919	rs690216	A	C	0	70	70	0	1	71	0	0
3	16503707	rs374722468	G	C	0	8	8	0	0	8	0	0
3	17053499	rs4602367	A	G	3	5	8	0	0	8	0	0
3	22423338	rs4472062	G	C	82	0	82	0	5	87	0	0
3	24163021	rs844107	T	C	6	0	6	0	0	6	0	0
3	25639828	rs61739570	T	A	227	206	433	0	4	437	0	0
3	25645514	rs1881708	G	A	2	4	6	0	0	6	0	0
3	25666582	rs2293785	T	C	2	5	7	0	0	7	0	0
3	25667264	rs79164791	T	C	5	3	8	0	0	8	0	0
3	25672778	rs17016894	C	T	4	2	6	0	1	7	0	0
3	25673080	rs6798792	C	T	7	5	12	0	0	12	0	0
3	25703400	rs59134881	T	C	7	6	13	0	1	14	0	0
3	25703640	rs6799331	C	T	7	5	12	0	0	12	0	0
3	25705758	rs145455403	C	T	13	12	25	0	3	28	0	0
3	25706277	rs10433573	A	C	38	36	74	0	0	74	0	0
3	25771579	rs1488989	G	T	0	6	6	0	0	6	0	0
3	25779459	rs11714620	G	A	4	6	10	0	0	10	0	0
3	25781658	rs3773424	A	T	2	4	6	0	0	6	0	0
3	25782357	rs3947578	G	C	6	6	12	0	0	12	0	0
3	25783423	rs9844943	C	T	4	5	9	0	0	9	0	0
3	25786075	rs9822551	A	G	6	3	9	0	0	9	0	0
3	25786884	rs11129206	G	A	4	5	9	0	0	9	0	0
3	27758274	rs2371109	G	T	2	4	6	0	0	6	0	0
3	27758275	rs2887944	G	T	2	4	6	0	0	6	0	0
3	28390351	rs1870259	A	G	8	9	17	0	1	18	0	0
3	30701756	rs67578310	C	T	3	9	12	0	0	12	0	0
3	30702212	rs34033344	G	T	0	11	11	0	0	11	0	0
3	30703798	rs2372093	A	T	0	13	13	0	0	13	0	0
3	30713842	rs2228048	C	T	78	90	168	0	0	168	0	0
3	32207606	rs6799559	A	G	3	6	9	0	0	9	0	0
3	32207732	rs6775309	C	T	3	3	6	0	0	6	0	0
3	32207737	rs6799728	A	T	3	3	6	0	0	6	0	0
3	32207907	rs6788436	T	C	5	7	12	0	1	13	0	0
3	32208431	rs6802739	A	G	2	4	6	0	0	6	0	0
3	32208621	rs2813	T	C	2	8	10	0	0	10	0	0
3	32208874	rs11707908	C	T	8	13	21	0	0	21	0	0
3	32208875	rs9839305	T	G	8	13	21	0	0	21	0	0
3	32209230	rs3749278	T	C	3	8	11	0	0	11	0	0
3	32209750	rs3087806	T	C	6	12	18	0	0	18	0	0
3	32209927	rs7363	A	G	11	13	24	0	0	24	0	0
3	38170810	rs156265	C	G	104	114	218	0	0	218	0	0
3	38184021	rs7744	A	G	130	64	194	0	0	194	0	0
3	38288805	rs139273983	A	G	3	4	7	0	0	7	0	0
3	39135551	rs17852414	G	A	120	125	245	0	4	249	0	0
3	39186728	rs784517	C	T	560	496	1056	0	5	1061	0	0
3	39187597	rs784516	G	A	25	16	41	0	0	41	0	0
3	39187858	rs13084317	G	A	23	11	34	0	0	34	0	0
3	39188351	rs1105163	C	T	7	2	9	0	0	9	0	0
3	39188728	rs938204	A	G	3	10	13	0	0	13	0	0
3	39188843	rs885067	A	G	6	11	17	0	0	17	0	0
3	39190775	rs1274964	A	G	6	5	11	0	1	12	0	0
3	39191029	rs1274963	A	G	6	4	10	0	0	10	0	0
3	39191043	rs1274962	T	C	5	4	9	0	1	10	0	0
3	39191335	rs1274961	T	C	6	5	11	0	0	11	0	0
3	39191820	rs184903024	G	A	8	5	13	0	0	13	0	0
3	39192542	rs1274960	T	C	5	5	10	0	0	10	0	0
3	39195462	rs2249736	G	T	5	1	6	0	0	6	0	0
3	39225075	rs114470485	G	A	5	4	9	0	0	9	0	0
3	39432785	rs45503293	C	T	8	5	13	0	0	13	0	0
3	39438321	rs12991	A	T	116	116	232	0	0	232	0	0
3	39438599	rs6890	T	A	63	72	135	0	0	135	0	0
3	39448620	rs11706951	T	C	3	3	6	0	0	6	0	0
3	39449441	rs3772141	A	G	10	10	20	0	0	20	0	0
3	39449770	rs3772140	T	G	20	7	27	0	0	27	0	0
3	39450065	rs3772138	C	T	18	20	38	0	0	38	0	0
3	39450362	rs34211462	G	A	4	10	14	0	0	14	0	0
3	39450393	rs71325529	C	T	6	12	18	0	0	18	0	0
3	39450470	rs71325530	A	G	5	23	28	0	0	28	0	0
3	39450591	rs79503125	G	A	5	10	15	0	0	15	0	0
3	39450592	rs79217109	A	G	7	8	15	0	1	16	0	0
3	39450733	rs73060246	T	C	8	9	17	0	0	17	0	0
3	39451120	rs55920963	A	G	10	8	18	0	0	18	0	0
3	39451191	rs55919861	C	T	12	7	19	0	0	19	0	0
3	39451516	rs7619128	A	G	20	15	35	0	0	35	0	0
3	39451524	rs7619131	A	G	19	15	34	0	1	35	0	0
3	39451712	rs7621701	T	A	7	6	13	0	0	13	0	0
3	39452106	rs2077798	A	G	8	12	20	0	1	21	0	0
3	39452772	rs1392192	A	G	31	56	87	0	1	88	0	0
3	39453160	rs2269350	G	A	5671	4030	9701	0	52	9754	1	0
3	40351484	rs11709089	C	T	20	16	36	0	1	37	0	0
3	40352051	rs9826419	G	A	25	14	39	0	2	41	0	0
3	40352134	rs3214006	C	T	21	14	35	0	1	36	0	0
3	40352647	rs1454491	C	G	24	14	38	0	0	38	0	0
3	40352884	rs1454492	C	T	11	11	22	0	0	22	0	0
3	40498845	rs2276868	C	T	534	363	897	0	1	900	2	0
3	40531533	rs6599105	T	C	8	11	19	0	0	19	0	0
3	40558446	rs56403587	C	A	6	2	8	0	0	8	0	0
3	40559078	rs4973907	G	C	13	11	24	0	0	24	0	0
3	40576318	rs76485302	C	T	4	2	6	0	0	6	0	0
3	40579357	rs4602359	A	G	7	5	12	0	0	12	0	0
3	40580180	rs79947432	T	C	8	5	13	0	0	13	0	0
3	40803102	rs681529	G	C	0	22	22	0	5	27	0	0
3	41279440	rs4135385	A	G	10	9	19	0	1	20	0	0
3	42145431	rs111331661	T	C	4	3	7	0	0	7	0	0
3	42147693	rs3856733	C	G	9	6	15	0	0	15	0	0
3	42147966	rs1973444	T	G	5	10	15	0	0	15	0	0
3	42236415	rs9851455	A	G	49	48	97	0	4	101	0	0
3	42237872	rs1463200	C	T	5	6	11	0	0	11	0	0
3	42238601	rs1463199	G	A	5	2	7	0	0	7	0	0
3	42238719	rs1463198	G	C	6	1	7	0	0	7	0	0
3	42239072	rs6769919	A	G	5	8	13	0	0	13	0	0
3	42244321	rs9311309	G	A	2	5	7	0	0	7	0	0
3	42244956	rs9829097	C	T	5	3	8	0	0	8	0	0
3	42251263	rs2290134	C	T	27	38	65	0	0	65	0	0
3	42251329	rs2290133	C	T	39	50	89	0	1	91	1	0
3	42252141	rs3196165	A	G	26	31	57	0	0	57	0	0
3	42252924	rs7372751	G	C	35	35	70	0	0	70	0	0
3	42253664	rs1046910	C	T	68	66	134	0	0	134	0	0
3	42253757	rs9511	C	T	80	70	150	0	1	151	0	0
3	42266833	rs9156	C	A	7	17	24	0	1	25	0	0
3	42568962	.	C	T	2	5	7	0	0	7	0	0
3	42707281	rs11129967	G	A	2	5	7	0	0	7	0	0
3	42799765	rs17238798	G	A	9	8	17	0	0	17	0	0
3	42826041	rs6865	T	G	136	105	241	0	3	244	0	0
3	43097765	rs3732858	G	A	1	5	6	0	0	6	0	0
3	43121559	rs604033	C	T	19	7	26	0	1	27	0	0
3	43391495	.	A	G	152	168	320	0	4	324	0	0
3	43602803	rs3772165	C	T	25	29	54	0	0	54	0	0
3	44386398	rs73090412	A	G	3	3	6	0	0	6	0	0
3	44395816	rs4129069	G	A	4	3	7	0	0	7	0	0
3	44449582	rs80065060	A	G	3	3	6	0	0	6	0	0
3	44450226	rs6441840	A	C	6	8	14	0	1	15	0	0
3	44450564	rs6441841	A	G	7	3	10	0	0	10	0	0
3	44485009	.	G	A	4	5	9	0	0	9	0	0
3	44489880	rs11710965	T	C	5	6	11	0	0	11	0	0
3	44815900	.	C	T	5	3	8	0	0	8	0	0
3	44871505	rs11710339	A	T	14	8	22	0	0	22	0	0
3	44902596	rs142877305	G	A	8	9	17	0	0	17	0	0
3	44955493	rs150933983	T	A	6	6	12	0	0	12	0	0
3	44955530	rs1007	G	T	8	7	15	0	0	15	0	0
3	44956860	rs6622	C	T	21	24	45	0	0	45	0	0
3	44958773	rs7644978	T	C	20	20	40	0	1	41	0	0
3	44960561	rs6789458	T	C	4	5	9	0	0	9	0	0
3	44963914	rs76723434	G	A	4	5	9	0	0	9	0	0
3	44963967	rs2372849	T	C	6	4	10	0	0	10	0	0
3	44963991	rs72863173	G	A	6	3	9	0	0	9	0	0
3	44965446	rs72863174	A	T	2	4	6	0	0	6	0	0
3	44965595	rs72863177	C	T	4	5	9	0	0	9	0	0
3	44983939	rs9877753	G	A	6	0	6	0	0	6	0	0
3	45016919	rs17632716	C	T	4	3	7	0	0	7	0	0
3	45044878	rs4683021	A	G	4	5	9	0	0	9	0	0
3	45052775	rs6794	G	C	86	60	146	0	3	149	0	0
3	45201365	rs6806366	T	C	20	0	20	0	1	21	0	0
3	45266555	rs33749	T	C	13	7	20	0	0	20	0	0
3	45430151	rs28413188	G	A	9	7	16	0	0	16	0	0
3	45463682	rs6769129	T	A	4	6	10	0	0	10	0	0
3	45463814	rs6769240	T	A	5	6	11	0	0	11	0	0
3	45748429	rs2742441	G	A	4	3	7	0	0	7	0	0
3	45748435	rs2673039	A	G	3	3	6	0	0	6	0	0
3	45748599	rs2742442	T	A	5	3	8	0	0	8	0	0
3	45748632	rs2673038	A	G	8	5	13	0	1	14	0	0
3	45749094	rs2673037	A	T	6	13	19	0	0	19	0	0
3	45749183	rs73058466	G	A	6	12	18	0	0	18	0	0
3	45749722	rs2245705	T	C	5	9	14	0	0	14	0	0
3	45756722	rs2742390	G	A	4	3	7	0	0	7	0	0
3	45778623	rs6807438	G	A	2	5	7	0	0	7	0	0
3	45779136	rs1468542	A	T	20	30	50	0	0	50	0	0
3	45784046	rs2742373	C	G	2	5	7	0	0	7	0	0
3	45785915	rs73060324	T	G	27	41	68	0	0	68	0	0
3	45959599	.	C	T	9	15	24	0	0	24	0	0
3	46416470	rs1800874	G	T	2	5	7	0	0	7	0	0
3	46449864	rs6808835	G	T	17	18	35	0	0	35	0	0
3	46449978	rs11266744	A	C	14	10	24	0	0	24	0	0
3	46450070	rs3204849	T	A	19	23	42	0	0	42	0	0
3	46450072	rs6441977	G	A	25	19	44	0	0	44	0	0
3	46450884	rs1140865	A	T	20	22	42	0	0	42	0	0
3	46480801	rs9110	A	G	98	68	166	0	0	166	0	0
3	46480854	rs144149027	G	A	68	61	129	0	2	131	0	0
3	46484964	rs1042073	G	A	47	60	107	0	1	108	0	0
3	46501213	rs1126478	T	C	20	22	42	0	0	42	0	0
3	46501268	rs1126477	C	T	17	20	37	0	0	37	0	0
3	46711135	rs3747519	T	C	10	8	18	0	0	18	0	0
3	46711507	rs3827495	C	T	9	2	11	0	0	11	0	0
3	46988561	rs13092573	C	T	6	4	10	0	0	10	0	0
3	47045846	rs2305637	C	T	113	126	239	0	1	240	0	0
3	47047358	rs13081418	A	C	13	15	28	0	0	28	0	0
3	47097985	rs62246406	G	A	4	4	8	0	0	8	0	0
3	47712202	rs1141601	T	C	91	89	180	0	2	182	0	0
3	47779203	.	G	A	6	3	9	0	0	9	0	0
3	47888819	rs114902473	C	T	101	99	200	0	2	202	0	0
3	48224457	.	T	C	19	16	35	0	0	35	0	0
3	48474249	rs2279077	A	G	4	5	9	0	0	9	0	0
3	48482506	rs7639743	G	A	9	17	26	0	1	27	0	0
3	48483432	rs9849509	A	G	4	6	10	0	0	10	0	0
3	48483445	rs60512868	T	G	3	11	14	0	0	14	0	0
3	48483682	rs2362441	G	A	9	8	17	0	0	17	0	0
3	48484560	rs7636044	A	G	6	5	11	0	0	11	0	0
3	48484683	rs4490383	T	C	4	2	6	0	1	7	0	0
3	48484890	rs13324374	C	T	6	10	16	0	0	16	0	0
3	48485493	rs7126	A	G	541	379	920	0	2	922	0	0
3	48489398	rs922075	A	G	5	5	10	0	0	10	0	0
3	48490608	rs1824363	C	G	3	3	6	0	0	6	0	0
3	48508585	rs11797	C	T	59	64	123	0	1	124	0	0
3	48637416	rs147689268	C	T	15	10	25	0	0	25	0	0
3	48664473	rs59643945	C	T	25	16	41	0	1	42	0	0
3	48664529	rs60028595	G	A	4	4	8	0	0	8	0	0
3	48669447	rs13324142	C	T	10	8	18	0	1	19	0	0
3	48671025	rs193176261	C	G	17	7	24	0	0	24	0	0
3	48675064	rs6773261	A	G	3	3	6	0	0	6	0	0
3	48712422	rs9874010	G	A	4	2	6	0	0	6	0	0
3	48725707	rs1048940	C	T	379	368	747	0	34	781	0	0
3	48727636	rs6806356	G	A	19	23	42	0	0	42	0	0
3	48728204	rs4858799	G	A	11	10	21	0	1	22	0	0
3	48729460	rs111881466	T	C	8	16	24	0	0	24	0	0
3	48732223	rs11557629	G	A	38	21	59	0	0	59	0	0
3	48732480	rs17080319	T	C	26	19	45	0	0	45	0	0
3	48733507	rs9854034	C	T	8	8	16	0	0	16	0	0
3	48734002	rs4858830	T	C	15	24	39	0	0	39	0	0
3	48735256	rs6442129	T	C	11	13	24	0	0	24	0	0
3	48735706	rs11719291	A	G	7	9	16	0	1	17	0	0
3	48736216	rs28657585	A	T	4	10	14	0	0	14	0	0
3	48752654	rs11708786	C	T	3	4	7	0	0	7	0	0
3	48961726	rs13087930	A	G	4	3	7	0	0	7	0	0
3	48964108	rs34509487	C	T	13	9	22	0	0	22	0	0
3	48966087	rs182471132	T	C	26	25	51	0	1	52	0	0
3	48972892	rs1134591	G	A	55	33	88	0	1	89	0	0
3	48974385	rs11719457	C	T	9	5	14	0	1	15	0	0
3	49021080	rs186178542	C	G	40	28	68	0	6	74	0	0
3	49044767	rs6781790	C	T	2	4	6	0	0	6	0	0
3	49046780	rs567404417	C	T	7	5	12	0	0	12	0	0
3	49052785	rs8926	T	A	91	70	161	0	8	169	0	0
3	49064110	rs11706052	A	G	10	13	23	0	1	24	0	0
3	49067904	rs61729488	T	C	285	233	518	0	4	522	0	0
3	49135961	rs13064784	C	G	11	22	33	0	0	33	0	0
3	49141116	rs5030795	G	A	331	331	662	0	1	663	0	0
3	49145741	rs3212	T	C	26	26	52	0	1	53	0	0
3	49145895	rs200833787	G	T	17	24	41	0	0	41	0	0
3	49156473	rs11552724	C	G	18	15	33	0	0	33	0	0
3	49156676	rs4279134	A	G	18	16	34	0	2	36	0	0
3	49209057	rs34571182	T	A	7	5	12	0	0	12	0	0
3	49209058	rs13096406	C	A	8	5	13	0	0	13	0	0
3	49213030	rs11713297	T	C	8	18	26	0	0	26	0	0
3	49213637	rs9586	C	T	47	79	126	0	1	127	0	0
3	49307872	rs11130187	T	C	9	11	20	0	0	20	0	0
3	49313978	rs13077498	C	T	19	22	41	0	2	43	0	0
3	49314960	rs56306491	G	A	20	18	38	0	0	38	0	0
3	49317338	rs6778080	T	C	11	10	21	0	0	21	0	0
3	49317727	rs4955414	C	G	6	4	10	0	0	10	0	0
3	49322027	rs2304442	T	A	4	2	6	0	0	6	0	0
3	49331060	rs9883409	T	C	17	31	48	0	0	48	0	0
3	49343175	rs2230929	G	A	76	78	154	0	1	155	0	0
3	49356577	rs73086105	A	G	8	1	9	0	1	10	0	0
3	49357427	rs11720542	A	G	5	6	11	0	0	11	0	0
3	49358646	rs34915642	G	A	3	7	10	0	0	10	0	0
3	49359943	rs9873994	T	C	4	2	6	0	0	6	0	0
3	49362369	rs56038006	C	T	77	60	137	0	1	138	0	0
3	49394834	rs1050450	G	A	2742	3019	5761	0	35	5796	0	0
3	49395757	rs1800668	G	A	17	9	26	0	0	26	0	0
3	49396751	rs3448	T	C	1583	1531	3114	0	17	3131	0	0
3	49398514	rs892974	C	A	14	23	37	0	2	39	0	0
3	49399259	rs1987628	G	A	18	12	30	0	0	30	0	0
3	49400482	rs974495	T	C	4	2	6	0	0	6	0	0
3	49407660	rs34588335	G	C	5	2	7	0	0	7	0	0
3	49444904	rs13061396	T	C	7	0	7	0	0	7	0	0
3	49452957	rs7638750	A	T	62	54	116	0	1	117	0	0
3	49453834	rs6997	C	T	89	112	201	0	1	202	0	0
3	49524778	rs6783003	G	C	5	3	8	0	0	8	0	0
3	49570200	rs1801143	C	T	15	24	39	0	0	39	0	0
3	49571462	rs12583	G	T	20	13	33	0	1	34	0	0
3	49572140	rs4625	A	G	22	41	63	0	0	63	0	0
3	49714225	rs1131095	T	C	148	136	284	0	0	284	0	0
3	49719729	rs9822268	G	A	5	2	7	0	0	7	0	0
3	49720569	.	G	A	143	162	305	0	6	311	0	0
3	49721532	rs3197999	G	A	16	20	36	0	0	36	0	0
3	49721798	rs13085791	C	A	22	22	44	0	2	46	0	0
3	49722356	.	G	A	6	1	7	0	0	7	0	0
3	49724808	rs3020779	T	C	17	15	32	0	0	32	0	0
3	49749976	rs34823813	G	A	30	23	53	0	0	53	0	0
3	49750188	rs3749240	T	A	11	3	14	0	0	14	0	0
3	49751223	.	C	T	21	26	47	0	3	50	0	0
3	49754970	rs7628207	T	C	27	15	42	0	0	42	0	0
3	49762662	rs7634902	G	T	66	58	124	0	2	126	0	0
3	49763338	rs1049256	T	C	55	57	112	0	0	112	0	0
3	49769071	rs9870858	C	T	2	4	6	0	0	6	0	0
3	49785133	rs7374183	G	A	3	4	7	0	0	7	0	0
3	49843723	rs3819325	T	C	4	2	6	0	0	6	0	0
3	49847642	rs1799844	G	A	7	7	14	0	0	14	0	0
3	49866392	rs1128535	C	T	11	14	25	0	0	25	0	0
3	49866584	rs35129566	T	G	16	7	23	0	0	23	0	0
3	50103917	rs2023953	G	A	107	112	219	0	0	219	0	0
3	50222926	rs1046956	T	A	9	8	17	0	0	17	0	0
3	50226151	rs14321	T	C	12	16	28	0	0	28	0	0
3	50280881	rs1894324	G	A	3	7	10	0	0	10	0	0
3	50285930	rs57453427	T	C	5	9	14	0	1	15	0	0
3	50286953	rs2298952	G	A	4	12	16	0	0	16	0	0
3	50287260	rs2298953	T	G	7	5	12	0	0	12	0	0
3	50287551	rs2298954	C	T	7	7	14	0	1	15	0	0
3	50288462	rs9836046	C	T	7	1	8	0	0	8	0	0
3	50291049	rs9851719	G	A	8	3	11	0	0	11	0	0
3	50294551	rs9830408	A	G	6	3	9	0	0	9	0	0
3	50332697	rs13100173	G	A	243	133	376	0	5	381	0	0
3	50371432	rs2236947	C	A	16	11	27	0	2	29	0	0
3	50374293	rs2073499	A	G	14	18	32	0	0	32	0	0
3	50387873	rs73082914	C	T	9	5	14	0	0	14	0	0
3	50388607	rs2233474	C	A	8	9	17	0	0	17	0	0
3	50388660	.	G	A	12	6	18	0	0	18	0	0
3	50651751	rs873985	A	G	3	3	6	0	0	6	0	0
3	51738101	rs2518461	G	A	77	56	133	0	1	134	0	0
3	52291078	rs57823393	G	A	179	226	405	0	6	411	0	0
3	52430526	rs12163565	G	A	20	14	34	0	0	34	0	0
3	52643343	.	T	G	40	22	62	0	0	62	0	0
3	52867220	rs113621941	G	A	10	7	17	0	0	17	0	0
3	53216692	rs13084863	C	T	31	26	57	0	1	58	0	0
3	53225193	rs7634447	A	C	4	3	7	0	0	7	0	0
3	53259013	rs13093936	C	T	97	85	182	0	2	184	0	0
3	53259996	rs3816767	G	A	8	11	19	0	0	19	0	0
3	53260099	rs7647720	A	T	6	11	17	0	0	17	0	0
3	53260325	rs7650103	A	G	11	6	17	0	1	18	0	0
3	53260710	rs2279321	G	A	6	6	12	0	1	13	0	0
3	53260716	rs2279322	C	T	6	5	11	0	0	11	0	0
3	53261677	rs11719464	T	C	7	4	11	0	0	11	0	0
3	53264160	rs6782597	A	G	5	2	7	0	0	7	0	0
3	53267155	rs2242301	G	A	26	23	49	0	0	49	0	0
3	53268122	rs34107310	C	T	8	4	12	0	1	13	0	0
3	53268137	rs35794580	C	A	8	4	12	0	1	13	0	0
3	53268242	rs13074156	G	A	8	7	15	0	0	15	0	0
3	53268429	rs3773739	A	G	5	3	8	0	1	9	0	0
3	53268545	rs3773740	T	C	3	3	6	0	0	6	0	0
3	53269317	rs2035450	T	C	6	1	7	0	0	7	0	0
3	53269743	rs60499054	G	A	16	16	32	0	0	32	0	0
3	53269904	rs4687715	G	A	5	10	15	0	0	15	0	0
3	53270344	rs3773744	T	C	8	7	15	0	0	15	0	0
3	53270424	rs3773745	A	G	12	12	24	0	0	24	0	0
3	53270928	rs2884495	T	C	14	11	25	0	0	25	0	0
3	53270947	rs2358621	A	C	13	12	25	0	0	25	0	0
3	53272314	rs3773747	T	C	30	44	74	0	0	74	0	0
3	53272782	rs62255988	G	A	26	34	60	0	0	60	0	0
3	53272889	rs12629312	G	A	42	21	63	0	0	63	0	0
3	53272944	rs7628245	C	T	41	25	66	0	0	66	0	0
3	53273192	rs35205801	G	C	29	25	54	0	0	54	0	0
3	53273195	rs35075155	T	C	29	25	54	0	0	54	0	0
3	53273287	rs28758191	G	A	31	24	55	0	0	55	0	0
3	53273473	rs9284890	T	C	22	26	48	0	2	50	0	0
3	53275641	rs12487632	C	T	8	10	18	0	1	19	0	0
3	53276697	rs7610113	T	C	3	4	7	0	0	7	0	0
3	53324528	rs150683469	G	C	5	1	6	0	0	6	0	0
3	53899023	.	C	T	8	4	12	0	0	12	0	0
3	57321916	rs883244	T	G	21	0	21	0	0	21	0	0
3	57913601	.	G	A	35	25	60	0	1	61	0	0
3	58309393	rs2056119	A	G	4	3	7	0	0	7	0	0
3	58370046	rs7647184	C	T	2	4	6	0	0	6	0	0
3	58382846	rs3191903	C	T	191	180	371	0	2	373	0	0
3	58395863	rs56384862	A	G	239	177	416	0	3	419	0	0
3	58403042	rs11708895	T	C	4	6	10	0	0	10	0	0
3	58403136	rs68021431	A	G	1	5	6	0	0	6	0	0
3	58403330	rs62258135	C	T	3	3	6	0	0	6	0	0
3	58403452	rs6773099	G	A	7	0	7	0	0	7	0	0
3	58403610	rs55783924	C	T	5	1	6	0	0	6	0	0
3	58404096	rs6799077	C	T	4	3	7	0	0	7	0	0
3	58404355	rs56398717	G	A	3	3	6	0	0	6	0	0
3	58404486	rs4470539	C	G	4	5	9	0	0	9	0	0
3	58404547	rs55727087	G	A	5	4	9	0	1	10	0	0
3	58405284	rs4320076	T	G	5	3	8	0	0	8	0	0
3	58405431	rs11714807	A	G	9	4	13	0	0	13	0	0
3	58405947	rs11130638	A	G	6	2	8	0	0	8	0	0
3	58406004	rs11130639	G	T	5	2	7	0	0	7	0	0
3	58406693	rs6772652	A	G	22	9	31	0	0	31	0	0
3	58406836	rs62258139	C	T	16	14	30	0	0	30	0	0
3	58407083	rs62258140	C	T	10	9	19	0	0	19	0	0
3	58407837	rs9822328	T	C	18	14	32	0	0	32	0	0
3	58408679	rs11721168	G	A	15	11	26	0	0	26	0	0
3	58408765	rs6782218	T	C	12	14	26	0	0	26	0	0
3	58408910	rs6767291	C	T	19	21	40	0	1	41	0	0
3	58409126	rs6767498	C	A	30	19	49	0	1	50	0	0
3	58409173	rs4681852	A	T	23	28	51	0	0	51	0	0
3	58409700	rs11915190	G	A	27	25	52	0	1	53	0	0
3	58409763	rs12485999	C	T	25	16	41	0	0	41	0	0
3	58410431	rs11714515	A	G	22	41	63	0	0	63	0	0
3	58410554	rs34579268	C	T	149	118	267	0	8	275	0	0
3	58413408	rs1126735	A	G	20	8	28	0	0	28	0	0
3	58413465	rs7231	G	C	44	39	83	0	0	83	0	0
3	58413518	rs1126722	T	G	62	46	108	0	0	108	0	0
3	58413669	rs4228	G	T	98	48	146	0	2	148	0	0
3	58416535	rs1126551	C	T	74	75	149	0	1	150	0	0
3	58417416	rs62259772	C	T	1	6	7	0	0	7	0	0
3	60874077	rs11130791	A	C	2	5	7	0	0	7	0	0
3	61728533	rs644860	G	A	22	0	22	0	2	24	0	0
3	63850298	rs6779372	T	G	4	3	7	0	0	7	0	0
3	63850299	rs3733120	G	C	4	3	7	0	0	7	0	0
3	63864612	rs832195	T	C	6	6	12	0	0	12	0	0
3	63898266	rs547615608	G	A	4	3	7	0	0	7	0	0
3	63900477	rs7627690	C	A	10	8	18	0	0	18	0	0
3	63974258	rs3774725	T	G	10	4	14	0	0	14	0	0
3	63974477	rs3774726	C	T	8	3	11	0	0	11	0	0
3	63981635	rs3733125	C	T	72	56	128	0	2	130	0	0
3	63982082	rs3774729	G	A	66	62	128	0	0	128	0	0
3	63982670	rs112674299	C	T	1	6	7	0	0	7	0	0
3	63986170	rs13272	A	G	64	53	117	0	0	117	0	0
3	63988174	rs3733127	C	T	145	151	296	0	2	298	0	0
3	63990807	rs11922435	C	T	5	2	7	0	0	7	0	0
3	63995915	rs9875198	C	A	4	3	7	0	0	7	0	0
3	63999322	rs3816157	G	A	72	68	140	0	1	141	0	0
3	63999712	rs3816156	A	T	7	2	9	0	0	9	0	0
3	64001925	rs9879045	C	T	11	6	17	0	4	21	0	0
3	64002897	rs9828933	T	C	11	7	18	0	0	18	0	0
3	64002953	rs9809432	G	A	8	14	22	0	0	22	0	0
3	64002995	rs7617036	G	A	10	12	22	0	0	22	0	0
3	64003983	rs831692	G	A	9	11	20	0	0	20	0	0
3	81539382	rs846	C	T	43	32	75	0	1	76	0	0
3	81637845	rs6792379	G	A	5	1	6	0	0	6	0	0
3	81691855	rs12054089	A	C	4	4	8	0	0	8	0	0
3	81802802	rs3772883	C	T	18	20	38	0	0	38	0	0
3	87301263	rs3804602	T	C	5	4	9	0	0	9	0	0
3	87301445	rs2009491	C	A	4	6	10	0	0	10	0	0
3	87301600	rs2009663	C	A	3	6	9	0	1	10	0	0
3	87301674	rs2009668	C	T	5	5	10	0	0	10	0	0
3	87304561	rs1060241	G	A	15	13	28	0	2	30	0	0
3	93593119	rs6123	T	C	6	5	11	0	0	11	0	0
3	93845700	rs145484202	G	A	6	2	8	0	0	8	0	0
3	93846831	rs4857186	G	A	12	7	19	0	0	19	0	0
3	98503792	rs112115496	A	G	9	16	25	0	0	25	0	0
3	98509587	rs278390	G	A	5	1	6	0	0	6	0	0
3	98512540	rs28489284	G	A	36	38	74	0	0	74	0	0
3	99584429	rs1626074	G	A	10	8	18	0	0	18	0	0
3	100004117	rs2028494	G	A	8	2	10	0	0	10	0	0
3	100011826	rs4552390	G	A	5	2	7	0	0	7	0	0
3	100024553	rs12486660	A	G	3	3	6	0	0	6	0	0
3	100042849	rs1214372	A	T	29	30	59	0	1	60	0	0
3	100043289	rs277654	C	T	18	8	26	0	1	27	0	0
3	100074759	rs277647	G	C	15	24	39	0	0	39	0	0
3	100082857	rs12591	C	G	41	48	89	0	0	89	0	0
3	100084020	rs1045610	T	A	10	13	23	0	0	23	0	0
3	100086861	rs277640	T	C	7	1	8	0	0	8	0	0
3	100120850	rs2289504	G	A	5	1	6	0	0	6	0	0
3	100428334	.	C	T	7	8	15	0	0	15	0	0
3	101068137	rs73157875	A	T	3	4	7	0	0	7	0	0
3	101231731	rs11708616	C	T	4	3	7	0	0	7	0	0
3	101231894	rs9682312	T	G	8	6	14	0	0	14	0	0
3	101231895	rs9682156	A	T	8	6	14	0	0	14	0	0
3	101294412	rs1365320	T	C	4	4	8	0	0	8	0	0
3	101294572	rs3804778	C	T	5	3	8	0	0	8	0	0
3	101294659	rs3804777	G	A	3	5	8	0	0	8	0	0
3	101295026	rs56111657	A	C	4	5	9	0	0	9	0	0
3	101295065	rs2114304	T	G	3	5	8	0	0	8	0	0
3	101295562	rs4683933	T	C	85	10	95	0	0	95	0	0
3	101298182	rs7635044	A	T	14	7	21	0	0	21	0	0
3	101303996	rs189571923	C	A	3	3	6	0	0	6	0	0
3	101305078	rs13062677	G	A	1	8	9	0	0	9	0	0
3	101305170	rs58907984	T	G	5	5	10	0	0	10	0	0
3	101306507	rs3804775	C	T	5	3	8	0	0	8	0	0
3	101307728	rs9844562	A	T	5	4	9	0	0	9	0	0
3	101371899	rs2303474	G	T	4	5	9	0	0	9	0	0
3	101371922	rs7629753	A	G	4	6	10	0	1	11	0	0
3	101373305	rs13069443	C	T	2	10	12	0	0	12	0	0
3	101373966	rs11925001	C	T	3	6	9	0	0	9	0	0
3	101374171	.	T	C	5	7	12	0	0	12	0	0
3	101374226	rs34624546	T	G	3	6	9	0	0	9	0	0
3	101374704	rs12636557	C	T	5	2	7	0	0	7	0	0
3	101396529	rs3806654	G	C	6	5	11	0	1	12	0	0
3	101396972	rs3806653	T	C	8	7	15	0	0	15	0	0
3	101397877	rs1056579	T	G	11	14	25	0	0	25	0	0
3	101400167	rs3094296	T	C	47	46	93	0	1	94	0	0
3	101404813	rs2303473	A	G	3	12	15	0	0	15	0	0
3	101488181	rs13077925	T	A	3	4	7	0	0	7	0	0
3	101543603	rs6797522	G	A	5	9	14	0	0	14	0	0
3	101543843	rs3911414	T	A	5	5	10	0	0	10	0	0
3	101545585	rs622013	A	T	5	8	13	0	0	13	0	0
3	101573169	rs541348407	A	T	5	7	12	0	1	13	0	0
3	105260520	rs1044243	C	T	11	14	25	0	0	25	0	0
3	105266274	rs16851279	T	C	21	19	40	0	0	40	0	0
3	105266331	rs9855810	A	G	17	21	38	0	0	38	0	0
3	107762718	rs11715122	A	C	16	8	24	0	1	25	0	0
3	107766361	rs41267009	A	T	7	7	14	0	0	14	0	0
3	107856796	rs13072473	A	C	10	16	26	0	0	26	0	0
3	107856822	rs9858939	C	G	13	18	31	0	0	31	0	0
3	107856953	rs13077007	A	C	29	24	53	0	1	54	0	0
3	107879730	rs62264146	G	C	2	7	9	0	0	9	0	0
3	107880473	rs17828926	T	G	3	7	10	0	0	10	0	0
3	107880919	rs2035	T	C	4	5	9	0	0	9	0	0
3	107880977	rs57535746	G	A	3	7	10	0	0	10	0	0
3	107881138	rs1135937	T	A	4	4	8	0	0	8	0	0
3	107881152	rs58273586	T	C	4	6	10	0	0	10	0	0
3	107881701	rs9860418	G	A	2	5	7	0	0	7	0	0
3	107881711	rs62264147	T	C	3	5	8	0	0	8	0	0
3	107881796	rs9860587	G	A	2	5	7	0	0	7	0	0
3	107883768	rs13318436	A	G	10	8	18	0	0	18	0	0
3	107884269	rs62264150	A	G	4	2	6	0	0	6	0	0
3	107937231	rs1289761	T	C	5	2	7	0	0	7	0	0
3	107937360	rs56273515	C	T	9	17	26	0	0	26	0	0
3	107937408	rs1135897	C	T	113	118	231	0	2	233	0	0
3	108298260	rs2278911	C	T	9	5	14	0	0	15	1	0
3	108373022	rs2969901	G	A	3	3	6	0	0	6	0	0
3	111298145	rs9831496	A	G	8	2	10	0	0	10	0	0
3	111444886	rs1398754	C	T	3	4	7	0	0	7	0	0
3	111444977	rs1398753	C	A	5	3	8	0	0	8	0	0
3	111704326	rs12635709	G	A	3	4	7	0	0	7	0	0
3	113010466	rs2291905	T	C	2	7	9	0	0	9	0	0
3	113080851	rs1979554	T	C	1	5	6	0	0	6	0	0
3	113176122	rs7637618	G	A	10	8	18	0	0	18	0	0
3	113222036	rs11537650	G	A	4	3	7	0	0	7	0	0
3	113370010	rs1026364	G	T	8	10	18	0	1	19	0	0
3	113370967	.	T	A	78	10	88	0	1	89	0	0
3	113370969	.	T	A	77	10	87	0	1	88	0	0
3	113371590	rs2012309	A	G	16	18	34	0	0	34	0	0
3	113371631	rs2012312	C	T	17	21	38	0	1	39	0	0
3	113371758	rs144150692	C	T	23	24	47	0	0	47	0	0
3	113372048	rs9814605	A	G	10	7	17	0	2	19	0	0
3	113372243	rs9852924	G	A	20	6	26	0	0	26	0	0
3	113373019	rs12493635	C	T	28	34	62	0	1	63	0	0
3	113377361	rs9813630	A	G	10	12	22	0	2	24	0	0
3	113379865	rs9866806	G	C	8	8	16	0	0	16	0	0
3	113444051	rs921741	A	C	1	6	7	0	0	7	0	0
3	113460614	rs2712348	C	A	3	3	6	0	0	6	0	0
3	113464859	rs1048892	A	G	105	101	206	0	3	209	0	0
3	113497386	rs12631232	C	G	2	4	6	0	0	6	0	0
3	113528689	rs1043132	T	G	34	35	69	0	1	70	0	0
3	113530211	rs12736	T	C	73	81	154	0	1	155	0	0
3	113673125	rs11921691	A	G	3	6	9	0	1	10	0	0
3	113795834	rs7631864	G	A	6	6	12	0	0	12	0	0
3	113801826	rs13086657	C	T	6	0	6	0	0	6	0	0
3	113804979	rs1872575	G	A	21	18	39	0	0	39	0	0
3	113806592	rs1129632	A	G	29	21	50	0	0	50	0	0
3	114065776	rs2470195	A	G	3	4	7	0	0	7	0	0
3	114066310	rs1357016	T	A	9	8	17	0	0	17	0	0
3	114067518	rs2722015	C	T	2	4	6	0	0	6	0	0
3	114318110	rs9869646	G	A	3	3	6	0	0	6	0	0
3	114863415	rs542025792	C	T	6	6	12	0	0	12	0	0
3	114864571	rs11921118	A	G	8	2	10	0	1	11	0	0
3	118948618	rs4422293	G	C	13	13	26	0	0	26	0	0
3	118948716	rs4422294	G	A	33	37	70	0	0	70	0	0
3	118955888	rs3806698	G	A	33	13	46	0	1	47	0	0
3	118957544	rs34549395	C	A	4	2	6	0	0	6	0	0
3	118958619	rs7637021	C	A	3	5	8	0	0	8	0	0
3	119150089	rs3732421	A	G	12	7	19	0	0	19	0	0
3	119150836	rs1132200	C	T	75	88	163	0	1	164	0	0
3	119177956	rs6438529	T	A	4	6	10	0	1	11	0	0
3	119222456	rs1131265	G	C	21	26	47	0	1	48	0	0
3	119361250	rs8007	A	G	3	4	7	0	0	7	0	0
3	119389745	rs7613999	A	G	3	3	6	0	0	6	0	0
3	119390219	rs6794484	G	A	1	5	6	0	0	6	0	0
3	119390418	rs6807079	T	C	6	2	8	0	0	8	0	0
3	119390844	rs4327424	T	C	6	3	9	0	0	9	0	0
3	119394168	rs2293235	C	T	1	5	6	0	0	6	0	0
3	119792288	rs147052362	G	A	4	2	6	0	0	6	0	0
3	120045966	rs11554681	T	C	15	8	23	0	0	23	0	0
3	120049117	rs6438575	T	C	8	5	13	0	1	14	0	0
3	120408090	rs2059331	G	C	7	3	10	0	0	10	0	0
3	120457396	rs111670619	C	A	4	5	9	0	0	9	0	0
3	121151812	rs3218634	G	C	26	19	45	0	0	45	0	0
3	121186422	rs532411	G	A	12	15	27	0	0	27	0	0
3	121350573	rs1128163	A	G	316	235	551	0	6	557	0	0
3	121350583	rs1128159	C	T	316	265	581	0	10	591	0	0
3	121350593	rs1128158	C	A	268	270	538	0	9	547	0	0
3	121350616	rs1128154	G	T	303	251	554	0	23	577	0	0
3	121353254	rs2070179	T	C	260	309	569	0	8	577	0	0
3	121356368	rs9289172	A	C	5	3	8	0	0	8	0	0
3	121356719	rs74746356	G	A	4	2	6	0	0	6	0	0
3	121361787	rs2070178	G	A	237	225	462	0	5	467	0	0
3	121362639	rs9846174	T	C	10	13	23	0	0	23	0	0
3	121409654	rs115378554	G	A	68	68	136	0	2	138	0	0
3	121413637	rs34833153	G	A	35	34	69	0	0	69	0	0
3	121431880	.	G	A	1	5	6	0	0	6	0	0
3	121435621	rs9832267	T	C	21	22	43	0	0	43	0	0
3	121435624	rs9812411	C	T	22	22	44	0	0	44	0	0
3	121488995	rs1135750	C	G	40	38	78	0	1	79	0	0
3	121489475	.	T	C	3	5	8	0	0	8	0	0
3	121489478	rs187598663	G	A	3	5	8	0	0	8	0	0
3	121500699	rs17849995	C	T	64	55	119	0	1	120	0	0
3	121504737	rs7623743	T	C	5	14	19	0	0	19	0	0
3	121504833	rs7612211	C	G	9	2	11	0	1	12	0	0
3	121515620	rs6438666	T	C	9	8	17	0	0	17	0	0
3	121526204	rs4543051	G	A	68	44	112	0	0	112	0	0
3	121549780	rs6438679	G	A	7	5	12	0	0	12	0	0
3	121549966	rs7612301	T	C	6	4	10	0	0	10	0	0
3	121552228	rs7646346	T	G	5	2	7	0	0	7	0	0
3	121558911	rs13096164	A	C	6	5	11	0	0	11	0	0
3	121561047	rs1920323	T	A	4	2	6	0	0	6	0	0
3	121563355	rs9884018	T	C	301	304	605	0	1	606	0	0
3	121641693	rs2293616	G	A	7	8	15	0	0	15	0	0
3	121643699	rs2257132	G	A	3	4	7	0	0	7	0	0
3	121643804	rs2257212	C	T	10	7	17	0	0	17	0	0
3	121643893	rs2257214	T	C	1	5	6	0	0	6	0	0
3	121646641	rs1143670	A	G	12	7	19	0	0	19	0	0
3	121647286	rs1143671	C	T	11	7	18	0	0	18	0	0
3	121648168	rs1143672	G	A	14	13	27	0	0	27	0	0
3	121838319	rs1129055	G	A	1	7	8	0	0	8	0	0
3	121838791	rs1915087	T	C	1	5	6	0	0	6	0	0
3	122140876	.	A	G	4	2	6	0	0	6	0	0
3	122290579	rs2036342	C	T	6	8	14	0	0	14	0	0
3	122356172	rs2668332	C	T	2	4	6	0	0	6	0	0
3	122447574	rs3732832	A	C	5	5	10	0	1	11	0	0
3	122448203	rs10934615	C	T	17	17	34	0	0	34	0	0
3	122448914	rs6774933	T	C	22	24	46	0	0	46	0	0
3	122545413	rs10804558	G	A	4	6	10	0	0	10	0	0
3	122545494	rs9853452	A	G	3	4	7	0	0	7	0	0
3	122880191	rs8935	T	C	47	52	99	0	0	99	0	0
3	122990702	rs1137117	A	C	14	3	17	0	0	17	0	0
3	123211295	rs56067434	G	A	39	43	82	0	1	83	0	0
3	123212563	rs1055137	A	G	30	25	55	0	0	55	0	0
3	123332340	rs9422	G	T	5	2	7	0	0	7	0	0
3	123332546	rs6438805	C	G	7	8	15	0	0	15	0	0
3	123349491	rs7622739	G	A	2	6	8	0	0	8	0	0
3	123633990	.	G	A	38	35	73	0	0	73	0	0
3	123665902	rs17310144	T	G	22	17	39	0	0	39	0	0
3	123678162	rs35050482	T	G	3	4	7	0	0	7	0	0
3	124951821	rs1053738	C	T	8	11	19	0	0	19	0	0
3	125028418	rs7612355	C	G	4	2	6	0	0	6	0	0
3	125182246	rs7636435	C	T	4	4	8	0	0	8	0	0
3	125189486	rs7638521	A	G	2	4	6	0	0	6	0	0
3	125312130	rs2979306	C	A	8	2	10	0	1	11	0	0
3	125313904	rs7625936	G	A	13	18	31	0	2	33	0	0
3	126158622	rs1799404	A	C	9	9	18	0	1	19	0	0
3	126159370	rs1799403	G	A	7	4	11	0	0	11	0	0
3	126160485	rs4679120	C	T	6	3	9	0	0	9	0	0
3	126160529	rs4679244	A	G	6	2	8	0	0	8	0	0
3	126160601	rs4679121	C	T	5	2	7	0	0	7	0	0
3	126162151	rs777515	T	C	12	13	25	0	0	25	0	0
3	126164257	rs10934777	A	G	1	6	7	0	0	7	0	0
3	126164782	rs777491	G	A	4	7	11	0	0	11	0	0
3	126170695	rs12957	T	G	17	12	29	0	0	29	0	0
3	126170965	rs1844689	G	A	7	7	14	0	0	14	0	0
3	126173470	rs777503	C	T	12	16	28	0	0	28	0	0
3	126174271	rs813556	G	A	13	8	21	0	1	22	0	0
3	126174612	rs147746577	G	A	8	4	12	0	0	12	0	0
3	126174838	rs777504	A	G	1	5	6	0	0	6	0	0
3	126175401	rs812368	G	A	9	9	18	0	0	18	0	0
3	126176112	rs777505	G	A	7	9	16	0	0	16	0	0
3	126176952	rs777506	T	C	5	6	11	0	0	11	0	0
3	126178390	rs1043803	A	C	69	81	150	0	0	150	0	0
3	126179492	rs777507	G	A	63	66	129	0	1	130	0	0
3	126180047	rs777508	C	G	49	41	90	0	0	90	0	0
3	126180088	rs3230	A	G	60	56	116	0	1	117	0	0
3	126180121	rs3231	C	T	63	63	126	0	2	128	0	0
3	126182920	rs1687462	C	T	7	3	10	0	0	10	0	0
3	126183546	rs6810140	G	A	4	10	14	0	0	14	0	0
3	126184029	rs10934778	C	T	6	5	11	0	0	11	0	0
3	126184450	rs4679245	T	C	6	8	14	0	0	14	0	0
3	126184941	rs1799389	C	T	4	2	6	0	0	6	0	0
3	126192081	rs800949	C	G	6	1	7	0	0	7	0	0
3	126194076	rs812367	T	C	25	25	50	0	1	51	0	0
3	126423112	rs6804224	C	T	10	12	22	0	1	23	0	0
3	126423113	rs6804225	C	A	11	13	24	0	0	24	0	0
3	126451937	rs2272487	G	T	38	64	102	0	0	102	0	0
3	126708453	rs6773789	T	C	1	6	7	0	0	7	0	0
3	126754644	rs9856665	G	C	5	14	19	0	0	19	0	0
3	126754711	rs77009675	G	A	3	10	13	0	1	14	0	0
3	126755134	rs3749395	C	T	2	7	9	0	1	10	0	0
3	127295084	rs920233	C	T	10	1	11	0	0	11	0	0
3	127323830	rs893293	C	T	76	81	157	0	1	158	0	0
3	127327309	rs3087450	G	A	178	159	337	0	4	341	0	0
3	127391018	rs813633	A	G	4	7	11	0	0	11	0	0
3	127392730	rs782454	G	A	4	2	6	0	0	6	0	0
3	127398176	rs782456	A	G	5	5	10	0	0	10	0	0
3	127408182	rs9383	C	T	18	18	36	0	1	37	0	0
3	127408239	rs7578	G	A	18	16	34	0	0	34	0	0
3	127408909	rs6439081	C	T	18	21	39	0	1	40	0	0
3	127409941	rs782444	T	C	18	6	24	0	0	24	0	0
3	127410915	rs814131	C	T	10	4	14	0	0	14	0	0
3	127410959	rs814130	G	T	4	4	8	0	1	9	0	0
3	127540635	rs11538698	C	T	11	13	24	0	0	24	0	0
3	127779944	rs2335771	A	G	2	4	6	0	0	6	0	0
3	127784118	rs13070488	T	C	20	17	37	0	1	38	0	0
3	127784262	rs2075402	C	T	26	8	34	0	0	34	0	0
3	127784513	rs9819960	T	C	21	14	35	0	2	37	0	0
3	127784612	rs6439111	C	G	6	8	14	0	0	14	0	0
3	127786551	rs9858267	G	A	13	8	21	0	0	21	0	0
3	127786675	rs2276867	T	G	12	7	19	0	0	19	0	0
3	127787157	rs3733158	A	G	9	4	13	0	0	13	0	0
3	127788955	rs10934847	G	A	251	224	475	0	1	476	0	0
3	127789172	rs1042907	G	C	251	240	491	0	2	493	0	0
3	127789594	rs1042911	T	G	234	221	455	0	3	458	0	0
3	127789695	rs1042912	C	T	230	200	430	0	5	435	0	0
3	127799983	rs1057220	A	C	95	77	172	0	0	172	0	0
3	127800071	rs1057156	A	G	65	61	126	0	0	126	0	0
3	128204951	rs2335052	C	T	752	620	1372	0	18	1390	0	0
3	128209482	rs2953120	C	G	8	12	20	0	0	20	0	0
3	128209570	rs7620408	C	T	13	10	23	0	1	24	0	0
3	128209667	rs2860228	C	T	11	9	20	0	1	21	0	0
3	128210342	rs1986452	A	C	6	5	11	0	0	11	0	0
3	128210550	rs11712335	T	C	6	9	15	0	0	15	0	0
3	128213994	rs35006112	G	A	2	5	7	0	0	7	0	0
3	128215775	rs6789646	T	C	20	22	42	0	0	42	0	0
3	128217431	rs13062436	T	C	4	3	7	0	0	7	0	0
3	128218410	rs7629791	G	A	8	11	19	0	0	19	0	0
3	128220511	rs77248408	C	T	8	7	15	0	0	15	0	0
3	128338953	rs1127030	T	C	219	195	414	0	7	421	0	0
3	128339057	.	A	T	305	195	500	0	11	511	0	0
3	128340110	rs55987729	T	C	16	17	33	0	0	33	0	0
3	128340896	rs2712419	T	C	17	20	37	0	0	37	0	0
3	128346214	rs2712371	G	A	4	3	7	0	0	7	0	0
3	128356852	rs1697	C	T	465	355	820	0	6	827	1	0
3	128364269	rs6801509	C	T	14	11	25	0	0	25	0	0
3	128368286	rs75988910	T	C	16	10	26	0	0	26	0	0
3	128369055	rs4467479	C	G	2	15	17	0	0	17	0	0
3	128369104	rs9813197	G	A	1	7	8	0	0	8	0	0
3	128469642	rs11706409	C	T	3	3	6	0	0	6	0	0
3	128492795	rs62272588	T	G	3	3	6	0	0	6	0	0
3	128528599	rs9853930	A	G	3	4	7	0	0	7	0	0
3	128531197	rs6789222	G	A	6	3	9	0	0	9	0	0
3	128531730	.	G	A	6	7	13	0	0	13	0	0
3	128614185	rs1680778	A	C	43	52	95	0	1	96	0	0
3	128625318	rs1680788	C	T	3	3	6	0	0	6	0	0
3	128626952	rs1683786	T	C	9	5	14	0	0	14	0	0
3	128627021	rs1683787	A	G	5	5	10	0	0	10	0	0
3	128627753	rs876754	T	C	7	1	8	0	0	8	0	0
3	128631481	rs9830739	G	A	69	57	126	0	5	131	0	0
3	128642048	rs1683779	A	G	1	7	8	0	0	8	0	0
3	128653952	rs883602	A	G	6	1	7	0	0	7	0	0
3	128717387	rs6799008	G	T	4	2	6	0	0	6	0	0
3	129035031	rs14323	C	T	1749	1840	3589	0	8	3597	0	0
3	129293256	rs2255703	T	C	10	13	23	0	1	24	0	0
3	129813301	rs4610271	G	A	14	1	15	0	0	15	0	0
3	129816961	rs12638292	C	T	2	4	6	0	0	6	0	0
3	129817708	rs6788479	A	G	7	0	7	0	0	7	0	0
3	129817804	rs2587970	G	A	0	6	6	0	0	6	0	0
3	129821679	rs2976117	G	A	5	1	6	0	0	6	0	0
3	129829463	rs4072146	C	A	5	1	6	0	0	6	0	0
3	129830064	rs113674105	G	A	8	1	9	0	0	9	0	0
3	129838501	rs2587960	C	T	6	3	9	0	0	9	0	0
3	130398468	rs12495186	T	C	4	4	8	0	0	8	0	0
3	130428146	rs10934954	C	T	3	5	8	0	0	8	0	0
3	130431425	rs74464627	T	C	3	7	10	0	0	10	0	0
3	130431481	rs75219664	T	C	0	8	8	0	0	8	0	0
3	130432965	rs75998334	A	G	0	6	6	0	0	6	0	0
3	130449222	rs2170990	A	G	8	11	19	0	0	19	0	0
3	130465474	rs2293179	A	C	19	27	46	0	1	47	0	0
3	130573756	rs141994524	A	T	6	3	9	0	0	9	0	0
3	130718472	rs16835513	G	A	128	118	246	0	1	248	1	0
3	130724907	rs2063637	T	G	6	4	10	0	0	10	0	0
3	132068831	rs2228402	C	T	9	7	16	0	0	16	0	0
3	132075554	rs3181784	T	C	3	3	6	0	0	6	0	0
3	132075707	rs2071505	A	G	6	5	11	0	0	11	0	0
3	132075746	rs1042330	G	A	8	3	11	0	1	12	0	0
3	132076196	rs2239698	C	A	8	3	11	0	0	11	0	0
3	132076551	rs14192	T	C	10	8	18	0	0	18	0	0
3	132076706	rs1804136	G	T	7	9	16	0	0	16	0	0
3	132076955	rs1126661	C	T	5	4	9	0	0	9	0	0
3	132218623	rs3762672	G	T	14	6	20	0	0	20	0	0
3	132257747	rs6671	G	A	8	5	13	0	0	13	0	0
3	132345591	.	C	T	21	20	41	0	0	41	0	0
3	132361596	rs9877018	G	A	8	10	18	0	0	18	0	0
3	132424172	rs10935029	C	G	1	5	6	0	0	6	0	0
3	132436313	rs74657284	C	T	4	2	6	0	0	6	0	0
3	132436314	rs77344670	T	A	4	2	6	0	0	6	0	0
3	133356216	rs150839134	A	C	7	6	13	0	0	13	0	0
3	133544998	rs1043147	A	G	4	3	7	0	0	7	0	0
3	133547216	rs2293375	T	C	3	3	6	0	0	6	0	0
3	133547692	rs2293373	G	A	6	4	10	0	0	10	0	0
3	133894059	rs150598556	C	T	3	3	6	0	0	6	0	0
3	133941320	rs1131262	C	T	17	23	40	0	0	40	0	0
3	134197429	rs61748112	G	A	94	133	227	0	6	233	0	0
3	134203973	rs3846055	T	A	1	5	6	0	0	6	0	0
3	134204841	rs2370576	C	G	2	12	14	0	0	14	0	0
3	134279197	rs13089966	A	G	4	3	7	0	0	7	0	0
3	134319448	rs11927539	C	G	4	2	6	0	0	6	0	0
3	134319455	rs11927540	C	T	4	2	6	0	0	6	0	0
3	135914476	rs9845457	G	A	8	16	24	0	0	24	0	0
3	136056184	rs17199978	A	G	6	4	10	0	0	10	0	0
3	136588926	rs35760633	T	C	1	6	7	0	0	7	0	0
3	136667405	rs1048145	T	C	84	102	186	0	2	188	0	0
3	136668412	rs73231975	T	C	30	34	64	0	0	64	0	0
3	136668625	rs856662	T	C	23	25	48	0	1	49	0	0
3	137926941	rs116818709	T	G	5	3	8	0	0	8	0	0
3	138213292	rs9049	C	T	5	2	7	0	0	7	0	0
3	138215114	rs9855306	C	T	4	2	6	0	0	6	0	0
3	138218994	rs35340237	T	C	21	26	47	0	1	48	0	0
3	138289163	rs1673608	T	C	21	23	44	0	0	44	0	0
3	138329575	rs13077766	G	A	4	3	7	0	0	7	0	0
3	139073138	rs9839834	T	C	6	5	11	0	0	11	0	0
3	139104330	rs189485139	T	C	1	5	6	0	0	6	0	0
3	139396734	rs4549242	T	C	2	13	15	0	0	15	0	0
3	139396758	rs10935341	G	A	2	11	13	0	0	13	0	0
3	140178485	rs7632885	G	A	0	11	11	0	0	11	0	0
3	141215425	rs139164864	A	T	266	256	522	0	3	525	0	0
3	141326602	rs295322	T	C	16	25	41	0	1	42	0	0
3	141327474	rs295323	G	A	21	21	42	0	0	42	0	0
3	141331222	rs2172471	G	A	14	8	22	0	0	22	0	0
3	141331565	rs1709	T	C	24	32	56	0	0	56	0	0
3	141641015	rs3765155	C	G	15	13	28	0	0	28	0	0
3	141642650	rs10804680	T	G	19	19	38	0	0	38	0	0
3	141642781	rs9880808	C	G	21	8	29	0	1	30	0	0
3	141643266	rs113687734	G	A	18	11	29	0	0	29	0	0
3	141644192	rs6801746	C	T	16	21	37	0	0	37	0	0
3	141644808	rs1050190	G	T	189	201	390	0	1	391	0	0
3	141903905	rs4577487	C	A	4	7	11	0	1	12	0	0
3	142027811	rs3762799	A	G	31	31	62	0	0	62	0	0
3	142039406	rs2086933	G	A	1	5	6	0	1	7	0	0
3	142080583	rs6802631	G	T	3	4	7	0	0	7	0	0
3	142168331	rs1802904	C	T	10	10	20	0	1	21	0	0
3	142277536	rs2227929	A	G	6	4	10	0	0	10	0	0
3	142277575	rs2227930	A	T	5	4	9	0	0	9	0	0
3	142698988	rs145688596	C	T	33	0	33	0	1	34	0	0
3	142733221	.	T	C	92	85	177	0	1	178	0	0
3	142778355	rs17633378	C	T	8	13	21	0	0	21	0	0
3	142839344	rs2280083	G	A	2	8	10	0	0	10	0	0
3	143709368	rs17667256	G	A	39	27	66	0	0	66	0	0
3	143710268	rs1979910	A	C	82	64	146	0	1	147	0	0
3	143712455	rs34200306	A	G	2	4	6	0	0	6	0	0
3	146234909	rs343320	G	A	215	196	411	0	2	413	0	0
3	146235394	rs343319	T	C	8	7	15	0	0	15	0	0
3	146235991	rs343318	T	C	8	10	18	0	0	18	0	0
3	146236161	rs343317	A	G	7	6	13	0	0	13	0	0
3	146238176	rs71302408	T	C	4	6	10	0	0	10	0	0
3	146238938	rs343316	A	G	8	4	12	0	0	12	0	0
3	146240399	rs343315	A	T	3	3	6	0	0	6	0	0
3	146240590	rs61347756	A	G	5	3	8	0	0	8	0	0
3	148614790	rs12962	T	C	575	470	1045	0	3	1048	0	0
3	148614895	rs2298884	T	A	39	36	75	0	0	75	0	0
3	148615528	rs77006048	C	T	17	10	27	0	0	27	0	0
3	148615624	rs4681456	T	C	11	16	27	0	0	27	0	0
3	148615695	rs1440640	G	A	10	11	21	0	0	21	0	0
3	148615804	rs1440639	C	G	9	7	16	0	0	16	0	0
3	148615939	rs1440638	A	C	9	7	16	0	0	16	0	0
3	148616082	rs2331449	A	G	7	15	22	0	0	22	0	0
3	148616484	rs893981	G	A	3	9	12	0	0	12	0	0
3	148616583	rs4364129	T	C	4	5	9	0	0	9	0	0
3	148616665	rs13065152	A	G	5	6	11	0	0	11	0	0
3	148616774	rs4298006	G	A	5	5	10	0	0	10	0	0
3	148616900	rs4234366	G	A	1	9	10	0	0	10	0	0
3	148616956	rs13069870	A	G	3	6	9	0	0	9	0	0
3	148617059	rs4681162	C	G	4	13	17	0	0	17	0	0
3	148617071	rs4681457	A	C	4	14	18	0	0	18	0	0
3	148617121	rs4681458	T	A	8	15	23	0	0	23	0	0
3	148617797	rs57877407	T	C	14	0	14	0	0	14	0	0
3	148617806	rs201171668	G	C	14	8	22	0	0	22	0	0
3	148617868	rs4681459	T	C	6	5	11	0	0	11	0	0
3	148617875	rs4681460	A	G	6	3	9	0	0	9	0	0
3	148618086	rs4681463	C	T	7	7	14	0	0	14	0	0
3	148618160	rs7645699	G	A	9	10	19	0	0	19	0	0
3	148618176	rs7645781	G	T	8	11	19	0	0	19	0	0
3	148618254	rs12631240	A	G	6	6	12	0	0	12	0	0
3	148618346	rs13077173	G	T	7	6	13	0	0	13	0	0
3	148618380	rs13077188	G	A	8	8	16	0	0	16	0	0
3	148618385	rs13099597	T	A	8	10	18	0	0	18	0	0
3	148618975	rs13082455	G	T	23	43	66	0	0	66	0	0
3	148619099	rs13082216	A	G	16	39	55	0	1	56	0	0
3	148619410	rs7648905	C	T	5	3	8	0	0	8	0	0
3	149468141	rs74697246	G	A	8	17	25	0	0	25	0	0
3	149678534	rs6768054	C	T	20	28	48	0	0	48	0	0
3	150128154	rs61734437	T	C	32	26	58	0	0	58	0	0
3	150128484	rs3749400	C	A	15	11	26	0	0	26	0	0
3	150128994	rs34647320	T	G	126	162	288	0	1	289	0	0
3	150133474	rs78390383	C	T	2	4	6	0	0	6	0	0
3	150133977	rs6791546	T	C	7	4	11	0	0	11	0	0
3	150134833	rs13068946	A	T	5	5	10	0	0	10	0	0
3	150137844	rs67073112	C	G	2	7	9	0	0	9	0	0
3	150139253	rs2868429	G	A	4	2	6	0	0	6	0	0
3	150139706	rs6799106	G	A	4	3	7	0	0	7	0	0
3	150171746	rs11925759	C	T	1	5	6	0	0	6	0	0
3	150175231	rs1868672	T	C	3	3	6	0	0	6	0	0
3	150262318	rs1533816	C	T	17	11	28	0	0	28	0	0
3	150262513	rs1533817	G	A	22	15	37	0	2	39	0	0
3	150283050	rs73001341	C	A	20	8	28	0	0	28	0	0
3	150285520	rs2293151	T	C	179	185	364	0	15	379	0	0
3	150331588	rs6781861	T	C	6	5	11	0	0	11	0	0
3	150332130	rs59356053	T	C	4	2	6	0	0	6	0	0
3	150332856	rs112635778	T	A	2	4	6	0	0	6	0	0
3	150345664	rs11548666	A	G	339	359	698	0	20	718	0	0
3	150882726	rs78027148	G	A	1	5	6	0	0	6	0	0
3	150964641	rs4269062	C	A	6	9	15	0	0	15	0	0
3	150965294	rs201692271	G	A	7	3	10	0	0	10	0	0
3	150965331	rs28537149	A	G	4	3	7	0	0	7	0	0
3	150979193	rs1920396	A	G	4	2	6	0	0	6	0	0
3	151044545	rs79904629	G	A	47	50	97	0	0	97	0	0
3	151044903	rs12497019	C	T	39	42	81	0	1	82	0	0
3	151045246	rs1388628	C	G	50	22	72	0	0	72	0	0
3	151045295	rs1388627	A	G	46	26	72	0	0	72	0	0
3	151045534	rs11712291	A	G	11	9	20	0	0	20	0	0
3	151056616	rs6785930	G	A	10	1	11	0	0	11	0	0
3	151082923	rs1463725	T	C	16	0	16	0	0	16	0	0
3	151090424	rs3732765	G	A	0	24	24	0	0	24	0	0
3	151110930	rs76368142	G	C	0	86	86	0	1	87	0	0
3	151130220	rs11923424	G	A	8	0	8	0	0	8	0	0
3	151131077	rs2276763	C	T	24	2	26	0	0	26	0	0
3	151131222	rs2276765	A	G	7	0	7	0	0	7	0	0
3	160956548	rs11539155	A	G	216	212	428	0	5	433	0	0
3	160968914	rs73875464	T	C	106	115	221	0	3	224	0	0
3	160969268	rs4493449	C	T	196	79	275	0	1	276	0	0
3	167512569	rs55872908	G	A	6	9	15	0	0	15	0	0
3	167727436	rs4254706	C	T	56	27	83	0	0	83	0	0
3	167727470	rs58648715	T	C	51	24	75	0	3	78	0	0
3	167727884	rs73037443	C	T	24	41	65	0	0	65	0	0
3	167728445	rs57405643	G	C	13	12	25	0	0	25	0	0
3	167728696	rs56801598	G	C	5	2	7	0	0	7	0	0
3	167728808	rs9827289	A	T	4	4	8	0	0	8	0	0
3	167728891	rs59155942	A	G	7	2	9	0	0	9	0	0
3	167728927	rs57058355	C	A	8	1	9	0	0	9	0	0
3	167728979	rs57669196	A	G	11	1	12	0	0	12	0	0
3	167728990	rs58889738	A	G	10	1	11	0	0	11	0	0
3	167729034	rs9869340	G	A	9	1	10	0	0	10	0	0
3	167729139	rs9869242	C	T	9	4	13	0	0	13	0	0
3	167729160	rs112201240	G	A	5	8	13	0	0	13	0	0
3	167729197	rs139740841	G	A	4	4	8	0	0	8	0	0
3	167729198	rs377506383	C	A	4	4	8	0	0	8	0	0
3	167729278	rs111531483	C	T	2	4	6	0	2	8	0	0
3	167729282	rs111612597	A	C	2	4	6	0	1	7	0	0
3	167729340	rs9869823	G	A	2	4	6	0	0	6	0	0
3	167730353	rs9875024	C	G	8	2	10	0	0	10	0	0
3	167730670	.	A	G	5	3	8	0	0	8	0	0
3	167730693	rs567841453	G	C	5	3	8	0	0	8	0	0
3	167730731	.	T	A	7	3	10	0	0	10	0	0
3	167730940	rs569763552	G	C	3	3	6	0	0	6	0	0
3	167731009	.	A	G	2	4	6	0	0	6	0	0
3	167731518	rs563518750	G	T	3	3	6	0	0	6	0	0
3	167745703	rs9861339	A	G	4	2	6	0	0	6	0	0
3	167813433	rs189332815	G	A	6	3	9	0	0	9	0	0
3	169487750	rs115269486	A	C	25	19	44	0	1	45	0	0
3	169804730	rs16854836	T	C	3	7	10	0	0	10	0	0
3	169806170	rs7615039	G	A	17	18	35	0	0	35	0	0
3	169806816	rs6808369	A	G	18	21	39	0	1	40	0	0
3	169807624	rs6444896	C	G	11	10	21	0	0	21	0	0
3	169807839	rs6804888	G	T	12	15	27	0	0	27	0	0
3	169808114	rs10936611	A	C	8	18	26	0	0	26	0	0
3	169808354	rs12492606	G	A	12	3	15	0	0	15	0	0
3	169811039	rs888507	G	C	3	7	10	0	0	10	0	0
3	169812115	rs879161	A	G	8	4	12	0	0	12	0	0
3	169818669	rs2111821	G	A	6	3	9	0	0	9	0	0
3	169887831	rs61493476	C	A	5	6	11	0	0	11	0	0
3	169888161	.	G	A	8	4	12	0	1	13	0	0
3	169988286	rs56257047	C	T	11	9	20	0	1	21	0	0
3	170114078	rs1045210	A	C	11	10	21	0	1	22	0	0
3	170582888	rs13063927	C	T	0	20	20	0	0	20	0	0
3	170584064	rs35192046	A	C	25	7	32	0	0	32	0	0
3	170584074	rs35683888	A	G	34	9	43	0	2	45	0	0
3	170587834	rs188298446	A	G	4	9	13	0	0	13	0	0
3	170609385	rs3796294	C	T	3	3	6	0	0	6	0	0
3	170610253	rs34539321	G	A	10	8	18	0	0	18	0	0
3	170610273	rs6779919	C	A	6	6	12	0	0	12	0	0
3	170610316	rs6792607	A	C	2	8	10	0	0	10	0	0
3	171087469	rs3796295	G	A	14	13	27	0	0	27	0	0
3	171881016	rs4593057	G	A	9	12	21	0	0	21	0	0
3	172046861	rs2270568	T	C	21	18	39	0	0	39	0	0
3	172071261	rs839724	T	G	3	3	6	0	0	6	0	0
3	172073961	rs525983	G	A	6	6	12	0	0	12	0	0
3	172115902	rs12897	G	A	24	21	45	0	0	45	0	0
3	172349216	rs3205144	T	C	4	15	19	0	0	19	0	0
3	172351006	rs3733023	C	G	5	5	10	0	1	11	0	0
3	172428782	rs2276805	T	C	6	6	12	0	0	12	0	0
3	178952205	.	A	G	113	90	203	0	2	205	0	0
3	179041396	rs3806687	G	A	5	7	12	0	0	12	0	0
3	179041975	rs7610174	C	T	2	5	7	0	0	7	0	0
3	179044310	rs62410444	A	G	6	3	9	0	0	9	0	0
3	179045493	rs6786409	T	C	4	5	9	0	0	9	0	0
3	179045759	rs7644501	A	G	6	9	15	0	0	15	0	0
3	179047817	rs62410445	T	C	7	4	11	0	0	11	0	0
3	179092989	rs9865666	C	T	4	4	8	0	0	8	0	0
3	179093798	rs6784871	G	A	6	1	7	0	0	7	0	0
3	179115380	rs10937003	C	T	73	100	173	0	1	174	0	0
3	179115649	rs11539416	G	A	36	24	60	0	2	62	0	0
3	179116260	rs9756522	A	G	19	9	28	0	1	29	0	0
3	179118397	rs11714353	A	C	51	72	123	0	1	124	0	0
3	179120687	rs6443645	G	A	2	5	7	0	0	7	0	0
3	179122707	rs2287311	C	G	1	6	7	0	0	7	0	0
3	179137273	rs1362650	A	G	37	51	88	0	1	89	0	0
3	179143941	rs1078749	A	G	37	28	65	0	0	65	0	0
3	182527886	rs111674949	G	A	8	0	8	0	0	8	0	0
3	182604826	rs675071	T	C	13	11	24	0	1	25	0	0
3	182606798	rs113003707	G	A	6	1	7	0	0	7	0	0
3	182614493	rs4859142	T	C	65	62	127	0	2	129	0	0
3	182615392	rs4859252	T	A	4	4	8	0	0	8	0	0
3	182615459	rs55657715	A	G	8	4	12	0	0	12	0	0
3	182615560	rs59108404	G	A	7	3	10	0	0	10	0	0
3	182615740	rs7650888	G	A	13	2	15	0	0	15	0	0
3	182625777	rs7632838	T	A	3	6	9	0	0	9	0	0
3	182633052	rs76690611	T	C	3	5	8	0	0	8	0	0
3	182633062	rs73054663	C	T	4	5	9	0	1	10	0	0
3	182637840	rs16833596	C	T	40	40	80	0	0	80	0	0
3	182638637	rs150202528	T	G	53	50	103	0	0	103	0	0
3	182639121	rs9587	A	G	4	2	6	0	1	7	0	0
3	182639483	rs73054664	A	G	4	5	9	0	0	9	0	0
3	182657666	rs6763257	C	G	13	15	28	0	0	28	0	0
3	182658429	rs1509234	C	T	22	17	39	0	1	40	0	0
3	182661952	rs1057949	C	T	8	9	17	0	0	17	0	0
3	182667094	rs6794977	G	T	2	5	7	0	0	7	0	0
3	182667096	rs6794978	G	A	2	5	7	0	0	7	0	0
3	182733547	rs12486983	T	C	3	3	6	0	0	6	0	0
3	182735412	rs10937105	A	T	3	4	7	0	0	7	0	0
3	182747552	rs1056565	A	G	4	2	6	0	0	6	0	0
3	182755209	rs2270968	T	G	68	83	151	0	1	152	0	0
3	182790249	rs7622479	G	A	39	48	87	0	2	89	0	0
3	182805804	rs7611168	C	T	4	8	12	0	0	12	0	0
3	183169943	rs10937131	G	T	17	21	38	0	0	38	0	0
3	183169944	rs10937132	A	G	16	20	36	0	1	37	0	0
3	183170136	rs10804889	A	C	16	18	34	0	0	34	0	0
3	183170142	rs10804890	C	T	9	12	21	0	1	22	0	0
3	183173302	rs73188704	G	A	43	33	76	0	0	76	0	0
3	183173424	rs4859194	A	G	20	17	37	0	1	38	0	0
3	183207297	rs1553693	G	A	8	14	22	0	0	22	0	0
3	183904049	rs11539876	A	G	57	49	106	0	0	106	0	0
3	183904232	rs1709624	T	A	7	8	15	0	0	15	0	0
3	183907879	rs17774065	G	A	9	11	20	0	0	20	0	0
3	184020730	.	C	T	4	2	6	0	0	6	0	0
3	184026703	rs6845	C	T	374	304	678	0	1	679	0	0
3	184033408	rs73187631	A	T	2	4	6	0	0	6	0	0
3	184046470	rs2230571	C	T	189	169	358	0	5	363	0	0
3	184051875	rs55967915	C	G	111	78	189	0	1	190	0	0
3	184058581	rs13322510	C	T	7	2	9	0	0	9	0	0
3	184062776	rs9839000	A	G	13	10	23	0	0	23	0	0
3	184063775	rs17774396	T	C	16	27	43	0	1	44	0	0
3	184071063	rs9820367	G	C	9	2	11	0	1	12	0	0
3	184075047	rs2228291	A	G	0	7	7	0	0	7	0	0
3	184428407	.	T	C	8	14	22	0	0	22	0	0
3	184529990	rs7640976	C	G	13	8	21	0	0	21	0	0
3	184536331	rs34532668	C	T	19	10	29	0	2	31	0	0
3	184550501	rs9830734	A	G	13	8	21	0	0	21	0	0
3	184573555	rs6443999	C	T	16	11	27	0	1	28	0	0
3	184633247	rs4686879	A	C	23	25	48	0	0	48	0	0
3	184700426	rs11555405	C	T	41	40	81	0	1	82	0	0
3	184769911	rs2271257	C	T	57	43	100	0	1	101	0	0
3	184769941	rs2271258	T	C	56	47	103	0	0	103	0	0
3	184770380	rs3332	C	T	7	2	9	0	0	9	0	0
3	185200873	rs2276738	G	C	3	4	7	0	0	7	0	0
3	185212593	rs6798873	T	C	5	3	8	0	0	8	0	0
3	185346420	rs35598169	A	G	5	7	12	0	0	12	0	0
3	185541213	rs11717959	G	T	4	3	7	0	0	7	0	0
3	185635685	rs16860328	A	G	10	16	26	0	0	26	0	0
3	185645209	rs80292881	G	C	45	45	90	0	1	91	0	0
3	185646406	rs2284909	A	T	32	34	66	0	0	66	0	0
3	185651001	rs2300921	T	C	8	8	16	0	0	16	0	0
3	185651469	rs2300922	C	T	3	6	9	0	0	9	0	0
3	185652947	rs16860342	C	T	7	10	17	0	0	17	0	0
3	185990096	rs2193587	C	T	7	3	10	0	0	10	0	0
3	185995196	rs1541614	T	C	7	8	15	0	0	15	0	0
3	185996345	rs9834264	C	A	3	8	11	0	0	11	0	0
3	186006566	rs710443	T	C	6	5	11	0	0	11	0	0
3	186264587	rs4686430	T	G	16	13	29	0	1	30	0	0
3	186288565	rs3806714	A	G	66	70	136	0	1	137	0	0
3	186293820	rs2280390	T	G	7	5	12	0	0	12	0	0
3	186296304	rs2121752	A	G	12	15	27	0	0	27	0	0
3	186296878	rs11714927	T	A	28	30	58	0	0	58	0	0
3	186501900	rs3900626	C	T	11	14	25	0	0	25	0	0
3	186504148	rs266718	T	C	72	75	147	0	1	148	0	0
3	186505900	rs1354091	T	G	189	170	359	0	3	362	0	0
3	186507922	rs2066500	C	T	11	0	11	0	0	11	0	0
3	186545055	rs62292779	G	A	3	5	8	0	0	8	0	0
3	186793729	rs1042642	A	G	6	6	12	0	0	12	0	0
3	186794103	rs2284749	G	A	6	8	14	0	2	16	0	0
3	186794732	rs9875078	C	A	5	10	15	0	1	16	0	0
3	186794733	rs9875079	C	A	5	11	16	0	0	16	0	0
3	186795248	rs4686848	G	A	10	9	19	0	0	19	0	0
3	186795640	rs1801380	G	A	16	16	32	0	1	33	0	0
3	186796053	rs7559	T	C	12	14	26	0	0	26	0	0
3	186796130	rs1042757	G	C	15	12	27	0	0	27	0	0
3	187439611	rs115678349	T	A	36	50	86	0	0	86	0	0
3	187440223	rs113181701	C	T	113	111	224	0	0	224	0	0
3	187462722	rs80031434	C	G	10	9	19	0	0	19	0	0
3	187898847	rs344950	C	T	4	2	6	0	0	6	0	0
3	187911047	rs12487926	C	T	6	1	7	0	0	7	0	0
3	188327461	rs1059380	C	T	9	10	19	0	0	19	0	0
3	188602844	rs2216856	G	A	6	2	8	0	0	8	0	0
3	188605426	rs9290883	A	G	2	5	7	0	0	7	0	0
3	190236758	rs9990231	T	C	41	45	86	0	0	86	0	0
3	190237101	rs11719243	A	G	20	20	40	0	0	40	0	0
3	190237351	rs9290935	T	C	37	31	68	0	2	70	0	0
3	190237797	rs7628333	C	T	31	39	70	0	0	70	0	0
3	190238043	rs3821744	C	T	36	35	71	0	0	71	0	0
3	190238062	rs185021859	A	T	24	28	52	0	0	52	0	0
3	190238729	rs16865541	A	G	2	4	6	0	0	6	0	0
3	190246860	rs9861301	C	G	8	2	10	0	0	10	0	0
3	190246861	rs9823517	A	G	8	2	10	0	0	10	0	0
3	191100561	rs364519	C	A	2	5	7	0	1	8	0	0
3	192514893	rs7507	G	A	3	3	6	0	0	6	0	0
3	192515510	rs6780822	G	T	4	3	7	0	0	7	0	0
3	192515557	rs1061860	G	A	4	4	8	0	0	8	0	0
3	193334991	rs7624750	G	A	58	50	108	0	2	110	0	0
3	193337021	rs9817704	G	A	4	2	6	0	0	6	0	0
3	193340310	rs34520293	A	C	3	6	9	0	0	9	0	0
3	193341016	rs12490391	C	T	7	2	9	0	0	9	0	0
3	193343761	rs6791301	C	G	4	9	13	0	0	13	0	0
3	193350294	rs2101341	T	C	6	2	8	0	0	8	0	0
3	193350837	rs13096511	T	G	7	8	15	0	0	15	0	0
3	193350876	rs13078398	G	T	9	7	16	0	0	16	0	0
3	193374964	rs9851685	T	C	113	136	249	0	5	254	0	0
3	193386239	rs12494482	C	T	11	19	30	0	0	30	0	0
3	193386487	.	G	A	15	4	19	0	0	19	0	0
3	193387937	rs10937596	C	A	5	2	7	0	0	7	0	0
3	193393612	rs3851984	A	G	5	3	8	0	0	8	0	0
3	193394309	rs34390712	A	G	4	9	13	0	0	13	0	0
3	193394495	rs2935303	T	C	5	2	7	0	0	7	0	0
3	193394497	rs2935304	T	C	5	2	7	0	0	7	0	0
3	193412672	rs1061648	A	G	60	66	126	0	2	128	0	0
3	193413502	rs12630	C	T	5	4	9	0	0	9	0	0
3	193413732	rs1056366	A	G	21	28	49	0	2	51	0	0
3	193414481	rs1056390	C	T	12	17	29	0	0	29	0	0
3	193414733	rs1056392	A	G	25	43	68	0	2	70	0	0
3	193414780	rs11719309	T	C	34	36	70	0	0	70	0	0
3	194124421	rs11900	A	G	76	93	169	0	1	170	0	0
3	194124624	rs14414	C	T	66	69	135	0	7	142	0	0
3	194127049	rs13324377	C	T	18	16	34	0	0	34	0	0
3	194127617	rs28539850	C	T	7	8	15	0	0	15	0	0
3	194128393	rs6766958	A	C	15	12	27	0	1	28	0	0
3	194128496	rs13327686	T	C	17	5	22	0	0	22	0	0
3	194128558	rs139180897	A	T	13	10	23	0	0	23	0	0
3	194128886	rs1964009	C	T	6	6	12	0	0	12	0	0
3	194128905	rs12695048	C	T	5	5	10	0	1	11	0	0
3	194128991	rs13062435	T	C	9	6	15	0	0	15	0	0
3	194130277	rs9839826	G	A	3	12	15	0	1	16	0	0
3	194134108	rs58595523	C	T	5	2	7	0	0	7	0	0
3	194172153	rs953487	C	T	4	4	8	0	0	8	0	0
3	194172225	rs953486	A	C	7	5	12	0	0	12	0	0
3	194172504	rs13082706	A	C	10	2	12	0	0	12	0	0
3	194172976	rs1032476	C	T	9	2	11	0	1	12	0	0
3	194337901	rs922282	T	C	21	12	33	0	0	33	0	0
3	194339961	rs6778368	C	G	7	2	9	0	0	9	0	0
3	194339984	rs3845907	C	T	4	2	6	0	0	6	0	0
3	194353875	rs1675955	G	T	1	5	6	0	0	6	0	0
3	194355668	rs138512547	C	T	5	4	9	0	0	9	0	0
3	194361556	rs9258	T	A	8	13	21	0	0	21	0	0
3	194361863	rs789990	C	T	23	22	45	0	0	45	0	0
3	194362620	rs711994	T	G	28	38	66	0	0	66	0	0
3	194369885	rs1675954	G	T	12	9	21	0	0	21	0	0
3	194370994	rs1773204	T	C	5	2	7	0	0	7	0	0
3	194371437	rs1773205	T	A	8	8	16	0	0	16	0	0
3	194371496	rs1773206	G	A	6	5	11	0	0	11	0	0
3	194372349	rs1705990	C	T	4	2	6	0	0	6	0	0
3	194372719	rs1623913	G	T	6	3	9	0	0	9	0	0
3	194373832	rs1675953	T	C	24	23	47	0	1	49	1	0
3	194373833	rs1705991	G	A	26	23	49	0	1	50	0	0
3	194387300	rs1675943	C	T	7	12	19	0	0	19	0	0
3	194406966	rs1773221	A	G	13	11	24	0	1	25	0	0
3	194406967	rs63360263	A	C	14	11	25	0	0	25	0	0
3	194406981	rs1773219	A	G	16	13	29	0	0	29	0	0
3	194407020	rs1773218	A	G	28	18	46	0	0	46	0	0
3	194407204	rs813153	T	C	33	25	58	0	1	59	0	0
3	194408704	rs4677673	A	G	10	3	13	0	0	13	0	0
3	194998813	.	A	G	3	4	7	0	1	8	0	0
3	195242526	rs2246343	C	T	151	137	288	0	2	290	0	0
3	195242593	rs1136	T	G	143	154	297	0	1	298	0	0
3	195248757	rs73196127	T	G	2	4	6	0	0	6	0	0
3	195255885	rs2686440	A	C	1	6	7	0	0	7	0	0
3	195270012	rs11475	A	G	86	61	147	0	0	147	0	0
3	195377629	rs138964810	C	T	7	1	8	0	0	8	0	0
3	195377651	rs139047772	T	C	5	1	6	0	0	6	0	0
3	195384986	rs550683413	C	T	4	4	8	0	0	8	0	0
3	195393030	.	A	G	17	13	30	0	1	31	0	0
3	195393860	.	A	G	4	4	8	0	0	8	0	0
3	195393898	.	A	T	8	0	8	0	0	8	0	0
3	195395533	.	C	T	10	0	10	0	0	10	0	0
3	195398250	.	C	A	15	4	19	0	0	19	0	0
3	195398505	.	G	A	8	7	15	0	0	15	0	0
3	195400728	.	A	G	8	0	8	0	0	8	0	0
3	195400841	.	C	A	11	4	15	0	0	15	0	0
3	195400848	.	G	A	10	5	15	0	0	15	0	0
3	195401737	.	T	C	8	1	9	0	0	9	0	0
3	195401748	.	T	C	8	1	9	0	0	9	0	0
3	195401755	.	G	T	7	1	8	0	0	8	0	0
3	195402448	rs4927765	G	C	2	4	6	0	0	6	0	0
3	195411671	.	G	A	6	0	6	0	0	6	0	0
3	195412859	.	T	C	3	3	6	0	0	6	0	0
3	195412876	.	T	C	3	3	6	0	0	6	0	0
3	195412920	.	C	T	5	2	7	0	0	7	0	0
3	195412928	.	G	A	4	2	6	0	0	6	0	0
3	195415423	rs150892404	A	G	5	1	6	0	0	6	0	0
3	195423249	.	C	G	2	7	9	0	0	9	0	0
3	195423377	.	C	T	6	14	20	0	0	20	0	0
3	195423390	.	G	A	6	11	17	0	0	17	0	0
3	195425678	.	T	C	2	4	6	0	0	6	0	0
3	195425993	.	C	G	7	2	9	0	1	10	0	0
3	195426849	rs3107774	C	A	3	5	8	0	0	8	0	0
3	195426860	.	T	C	3	7	10	0	0	10	0	0
3	195426877	.	T	C	6	5	11	0	0	11	0	0
3	195435053	.	G	A	10	11	21	0	0	21	0	0
3	195435220	.	T	G	4	2	6	0	1	7	0	0
3	195453310	.	G	A	5	2	7	0	0	7	0	0
3	195453434	.	G	A	8	1	9	0	1	10	0	0
3	195460236	rs712011	G	A	6	1	7	0	0	7	0	0
3	195596907	rs2278034	T	C	9	10	19	0	0	19	0	0
3	195615376	rs3747669	A	G	55	39	94	0	0	94	0	0
3	195625326	rs9871110	A	G	2	4	6	0	0	6	0	0
3	195625343	rs75103579	T	A	2	5	7	0	0	7	0	0
3	195635855	rs73087356	C	G	1	5	6	0	0	6	0	0
3	195686832	.	G	A	5	2	7	0	0	7	0	0
3	195686868	.	G	A	7	3	10	0	0	10	0	0
3	195686899	.	C	T	8	3	11	0	0	11	0	0
3	195698262	.	C	G	15	3	18	0	0	18	0	0
3	195701304	.	C	T	19	3	22	0	0	22	0	0
3	195701331	.	G	A	18	13	31	0	0	31	0	0
3	195703567	.	G	A	7	3	10	0	0	10	0	0
3	195703698	.	T	C	10	2	12	0	0	12	0	0
3	195707857	.	G	C	3	3	6	0	0	6	0	0
3	195709088	.	T	C	10	6	16	0	0	16	0	0
3	195710989	rs2620604	G	A	20	1	21	0	0	21	0	0
3	195710993	rs4927692	A	G	20	2	22	0	0	22	0	0
3	195711042	.	C	G	25	1	26	0	0	26	0	0
3	195776809	rs9842780	C	T	697	503	1200	0	3	1203	0	0
3	195777211	rs17788379	C	T	211	224	435	0	4	439	0	0
3	195778972	rs1805051	C	T	295	399	694	0	5	699	0	0
3	195779999	rs41298077	A	T	8	1	9	0	0	9	0	0
3	195783933	rs9825826	C	G	6	1	7	0	0	7	0	0
3	195783934	rs9810979	G	A	6	1	7	0	0	7	0	0
3	195784046	rs111662410	G	C	4	7	11	0	0	11	0	0
3	195787565	rs9853824	A	C	10	6	16	0	0	17	1	0
3	195789081	rs528937	C	T	8	10	18	0	0	18	0	0
3	195793979	rs714602	T	C	12	3	15	0	0	15	0	0
3	195798552	rs41301379	T	C	2	4	6	0	0	6	0	0
3	195800811	rs3817672	C	T	109	129	238	0	6	244	0	0
3	195964298	rs884534	A	G	7	13	20	0	0	20	0	0
3	195964687	rs712012	C	T	28	26	54	0	1	55	0	0
3	195965115	rs939883	A	T	26	27	53	0	0	53	0	0
3	195967315	rs6795511	G	A	17	12	29	0	0	29	0	0
3	196014585	.	G	A	2	4	6	0	0	6	0	0
3	196075368	rs56351369	G	T	133	121	254	0	0	254	0	0
3	196081145	rs7644811	A	G	24	31	55	0	0	55	0	0
3	196195998	rs73891247	G	A	325	288	613	0	9	622	0	0
3	196196883	rs115585522	T	A	333	334	667	0	1	668	0	0
3	196197624	rs181151313	G	C	272	293	565	0	8	573	0	0
3	196197804	rs11719920	T	G	211	194	405	0	0	405	0	0
3	196198022	rs111444359	G	A	78	60	138	0	0	138	0	0
3	196199204	rs3796129	G	T	249	245	494	0	1	495	0	0
3	196201942	rs60280349	G	A	5	1	6	0	0	6	0	0
3	196202508	rs112408725	G	A	6	5	11	0	0	11	0	0
3	196202730	rs549880692	T	C	5	2	7	0	0	7	0	0
3	196202822	rs4916431	C	A	4	6	10	0	0	10	0	0
3	196203979	rs12635457	G	A	3	6	9	0	0	9	0	0
3	196205373	rs137985286	C	T	11	12	23	0	1	24	0	0
3	196205694	rs6803161	T	C	2	5	7	0	0	7	0	0
3	196206322	rs78737378	C	T	4	5	9	0	0	9	0	0
3	196206827	rs78693705	T	C	5	3	8	0	0	8	0	0
3	196208119	rs75159574	T	C	4	4	8	0	0	8	0	0
3	196210875	rs77317203	T	C	2	7	9	0	0	9	0	0
3	196211219	rs9681103	T	C	4	8	12	0	0	12	0	0
3	196212282	rs11718980	G	A	7	8	15	0	0	15	0	0
3	196213941	rs183153317	C	A	8	4	12	0	0	12	0	0
3	196224038	rs9844068	C	T	2	5	7	0	0	7	0	0
3	196227638	rs144543278	G	A	7	4	11	0	0	11	0	0
3	196230564	rs9837291	G	C	103	98	201	0	1	202	0	0
3	196281208	rs9311	T	C	49	38	87	0	1	88	0	0
3	196292987	rs4916433	A	G	1	5	6	0	0	6	0	0
3	196293516	rs9853777	T	C	5	1	6	0	0	6	0	0
3	196368272	rs843521	C	G	1	5	6	0	0	6	0	0
3	196368638	rs6804254	C	T	7	1	8	0	0	8	0	0
3	196370840	rs73221623	C	T	6	3	9	0	0	9	0	0
3	196373037	rs9823810	T	C	5	2	7	0	0	7	0	0
3	196373207	rs73221625	C	G	6	1	7	0	0	7	0	0
3	196373408	rs1684453	G	A	4	2	6	0	0	6	0	0
3	196373556	rs73221626	G	A	6	2	8	0	0	8	0	0
3	196373561	rs4916532	G	A	6	2	8	0	0	8	0	0
3	196374156	rs1212534	A	C	11	3	14	0	0	14	0	0
3	196374555	rs114419096	G	A	3	3	6	0	0	6	0	0
3	196375140	rs6766451	T	G	8	5	13	0	0	13	0	0
3	196375351	rs74626344	C	T	3	12	15	0	0	15	0	0
3	196377051	rs112669193	C	G	3	4	7	0	0	7	0	0
3	196377750	rs1798629	C	T	4	5	9	0	0	9	0	0
3	196378705	rs843517	G	A	6	6	12	0	0	12	0	0
3	196379843	rs965139	T	C	7	3	10	0	0	10	0	0
3	196379897	rs6583335	A	G	2	6	8	0	0	8	0	0
3	196379906	rs9848767	C	T	2	6	8	0	0	8	0	0
3	196379916	rs843520	T	C	1	7	8	0	0	8	0	0
3	196379956	rs9833841	G	A	4	4	8	0	0	8	0	0
3	196379993	rs965140	G	T	8	7	15	0	0	15	0	0
3	196382694	rs73084956	T	C	49	63	112	0	1	113	0	0
3	196383201	rs73084958	C	T	48	48	96	0	1	97	0	0
3	196383427	rs75197323	G	A	21	28	49	0	0	49	0	0
3	196384865	rs4912589	T	C	32	34	66	0	3	69	0	0
3	196385734	rs7645207	G	A	84	33	117	0	1	118	0	0
3	196386083	rs11915746	G	A	48	25	73	0	1	74	0	0
3	196386964	rs1798631	C	G	260	255	515	0	10	525	0	0
3	196462173	.	A	G	15	0	15	0	0	15	0	0
3	196555398	rs6804618	A	G	30	45	75	0	1	76	0	0
3	196555482	rs7614370	G	A	25	26	51	0	1	52	0	0
3	196555549	.	A	G	37	30	67	0	1	68	0	0
3	196555790	rs148346857	A	G	28	32	60	0	0	60	0	0
3	196555958	rs4638940	C	T	22	13	35	0	0	35	0	0
3	196556092	rs4638939	C	T	40	46	86	0	2	88	0	0
3	196556121	rs114305365	G	C	49	42	91	0	0	91	0	0
3	196556477	rs557271685	C	G	31	20	51	0	1	52	0	0
3	196556843	rs9109	G	A	20	19	39	0	0	39	0	0
3	196557274	rs116730258	C	T	25	19	44	0	0	44	0	0
3	196557324	rs145877084	T	C	42	39	81	0	0	81	0	0
3	196557464	rs141297484	T	C	33	34	67	0	0	67	0	0
3	196557873	rs35457022	T	C	9	11	20	0	0	20	0	0
3	196558180	rs2342070	T	C	2	4	6	0	1	7	0	0
3	196558328	rs1052100	A	G	17	24	41	0	0	41	0	0
3	196558923	rs115489804	G	A	38	32	70	0	2	72	0	0
3	196558940	rs114996266	G	C	37	32	69	0	0	69	0	0
3	196674518	rs1147238	A	G	5	1	6	0	0	6	0	0
3	196674879	rs12636891	A	G	1	5	6	0	0	6	0	0
3	196677409	rs4347982	A	C	0	6	6	0	0	6	0	0
3	196728633	rs1060357	T	G	5	5	10	0	0	10	0	0
3	196728706	rs539510	T	C	15	24	39	0	0	39	0	0
3	196729081	rs2280293	T	C	16	7	23	0	1	24	0	0
3	196729569	rs114521616	C	T	2	7	9	0	0	9	0	0
3	196731685	rs2271823	T	C	2	4	6	0	0	6	0	0
3	196731921	rs6793175	C	T	2	6	8	0	0	8	0	0
3	196742290	rs9855410	T	C	17	12	29	0	0	29	0	0
3	196743130	rs6779362	T	C	15	16	31	0	0	31	0	0
3	196745959	rs73208237	C	A	9	6	15	0	1	16	0	0
3	196746629	rs1056664	T	C	11	17	28	0	1	29	0	0
3	196747252	rs61370412	G	T	7	9	16	0	0	16	0	0
3	196747300	rs12636071	C	T	2	9	11	0	0	11	0	0
3	196753355	rs4916598	T	C	11	10	21	0	0	21	0	0
3	196753906	rs9824612	G	A	4	6	10	0	0	10	0	0
3	196754519	rs2276789	G	A	4	6	10	0	0	10	0	0
3	197236843	rs7433302	C	G	5	4	9	0	0	9	0	0
3	197238564	rs8078	G	T	23	23	46	0	0	46	0	0
3	197241286	rs35089738	G	C	33	18	51	0	1	52	0	0
3	197281338	rs1966618	C	A	5	1	6	0	0	6	0	0
3	197349143	.	T	C	5	2	7	0	0	7	0	0
3	197432040	.	G	A	1	8	9	0	0	9	0	0
3	197479257	rs1606519	T	C	7	7	14	0	0	14	0	0
3	197480213	rs6583253	T	C	7	3	10	0	0	10	0	0
3	197481113	rs6583254	A	G	5	2	7	0	0	7	0	0
3	197483279	rs6794391	A	G	2	7	9	0	0	9	0	0
3	197495334	rs3205525	G	A	169	146	315	0	6	321	0	0
3	197501642	rs6583258	A	G	5	8	13	0	1	14	0	0
3	197509098	rs1273557	A	G	182	155	337	0	4	341	0	0
3	197513167	rs524058	G	A	5	2	7	0	0	7	0	0
3	197566254	rs17850206	T	C	9	10	19	0	0	19	0	0
3	197597044	rs77281724	C	T	9	4	13	0	0	13	0	0
3	197659160	rs67877771	C	G	10	3	13	0	0	13	0	0
3	197665599	rs9880989	G	T	9	12	21	0	0	21	0	0
3	197677259	rs7631002	T	C	6	9	15	0	0	15	0	0
3	197683423	rs9818493	G	A	12	12	24	0	0	24	0	0
4	54508	.	A	G	87	0	87	0	1	88	0	0
4	54765	.	C	T	97	0	97	0	0	97	0	0
4	55372	.	G	C	31	0	31	0	0	31	0	0
4	57088	.	T	G	32	0	32	0	0	32	0	0
4	57285	.	G	T	29	0	29	0	0	29	0	0
4	60400	.	G	A	6	0	6	0	1	7	0	0
4	61216	.	C	T	7	0	7	0	0	7	0	0
4	63024	.	G	A	9	0	9	0	0	9	0	0
4	64635	.	C	T	6	0	6	0	0	6	0	0
4	64892	.	G	C	10	0	10	0	0	10	0	0
4	64956	.	G	A	12	0	12	0	0	12	0	0
4	65077	.	A	T	10	0	10	0	0	10	0	0
4	68507	rs9985518;rs878895106	A	T	28	0	28	0	0	28	0	0
4	73650	.	G	T	9	7	16	0	0	16	0	0
4	331658	rs3749520	T	C	5	2	7	0	0	7	0	0
4	331666	rs3749521	G	C	8	2	10	0	0	10	0	0
4	352661	rs55718920	A	C	6	1	7	0	0	7	0	0
4	352890	rs56171831	A	G	14	4	18	0	1	19	0	0
4	352955	rs7682616	G	A	13	3	16	0	0	16	0	0
4	354051	rs17719492	C	G	10	0	10	0	0	10	0	0
4	367927	rs3946	G	A	6	6	12	0	0	12	0	0
4	368258	rs3805233	T	C	10	11	21	0	0	21	0	0
4	376888	rs6854214	C	A	9	5	14	0	0	14	0	0
4	377427	rs1052217	G	A	16	6	22	0	0	22	0	0
4	434079	rs1045887	G	A	19	30	49	0	1	50	0	0
4	434462	rs9328746	A	T	21	25	46	0	0	46	0	0
4	464428	rs73072108	A	G	3	3	6	0	0	6	0	0
4	464567	rs61793727	T	C	5	2	7	0	0	7	0	0
4	492129	rs9994908	G	A	2	5	7	0	0	7	0	0
4	500044	.	G	C	3	3	6	0	0	6	0	0
4	500500	rs17721401	T	C	4	3	7	0	0	7	0	0
4	509850	rs11726338	T	C	28	42	70	0	1	71	0	0
4	510875	rs6818642	A	G	4	6	10	0	0	10	0	0
4	511339	rs57834329	T	G	8	11	19	0	0	19	0	0
4	512377	rs28374581	A	G	8	7	15	0	0	15	0	0
4	512598	rs13114024	C	A	5	9	14	0	0	14	0	0
4	512751	rs13124714	A	G	8	2	10	0	0	10	0	0
4	512828	rs13131404	T	C	7	6	13	0	0	13	0	0
4	513014	rs4616693	T	C	8	2	10	0	0	10	0	0
4	513178	rs4504200	T	C	6	2	8	0	0	8	0	0
4	513237	rs4380466	A	G	4	3	7	0	0	7	0	0
4	513414	rs4499656	C	T	5	5	10	0	0	10	0	0
4	514041	rs35270677	A	G	5	5	10	0	0	10	0	0
4	514089	rs35334779	G	A	4	3	7	0	0	7	0	0
4	514133	rs34872561	A	G	3	4	7	0	0	7	0	0
4	514180	rs35956476	T	G	7	6	13	0	0	13	0	0
4	514602	rs10029096	A	G	3	3	6	0	0	6	0	0
4	514625	rs10024763	C	T	3	4	7	0	0	7	0	0
4	514629	rs10029104	A	G	4	4	8	0	0	8	0	0
4	515489	rs13115344	G	A	38	34	72	0	1	73	0	0
4	515844	rs13136656	C	A	33	34	67	0	0	67	0	0
4	516382	rs13142669	C	T	20	21	41	0	0	41	0	0
4	516398	rs7672868	G	A	20	21	41	0	0	41	0	0
4	516586	rs1135945	G	A	4	7	11	0	0	11	0	0
4	516963	rs7692313	C	G	0	6	6	0	0	6	0	0
4	517376	rs7666226	T	C	13	9	22	0	0	22	0	0
4	517461	rs7666425	T	C	13	14	27	0	0	27	0	0
4	517622	rs13150531	C	T	10	17	27	0	0	27	0	0
4	518595	rs11930567	C	T	2	5	7	0	0	7	0	0
4	520853	rs13114026	G	A	17	14	31	0	1	32	0	0
4	521501	rs7671228	G	A	4	6	10	0	1	11	0	0
4	524738	rs11934549	T	G	1	5	6	0	0	6	0	0
4	524882	rs11946204	G	A	3	3	6	0	0	6	0	0
4	524904	rs11933478	A	G	3	4	7	0	0	7	0	0
4	525572	rs11248023	C	G	2	4	6	0	0	6	0	0
4	525611	rs11248024	G	A	2	5	7	0	0	7	0	0
4	526145	rs13141560	T	C	5	6	11	0	0	11	0	0
4	526169	rs34327839	A	G	4	5	9	0	0	9	0	0
4	526217	rs35629431	A	G	4	2	6	0	0	6	0	0
4	526407	rs73794940	A	G	3	3	6	0	0	6	0	0
4	526408	rs73794942	A	C	3	3	6	0	0	6	0	0
4	526443	rs73072175	C	T	3	6	9	0	0	9	0	0
4	526848	rs3211083	A	G	3	5	8	0	0	8	0	0
4	526873	rs77222403	C	T	3	4	7	0	0	7	0	0
4	527176	rs11931543	G	C	4	2	6	0	0	6	0	0
4	527419	rs11938226	T	C	6	4	10	0	0	10	0	0
4	527534	rs11931692	G	A	4	4	8	0	0	8	0	0
4	527677	rs34623004	T	C	9	5	14	0	0	14	0	0
4	528300	rs13119658	G	C	2	4	6	0	0	6	0	0
4	528397	rs13140110	C	T	2	4	6	0	0	6	0	0
4	529547	rs11940796	T	C	5	5	10	0	0	10	0	0
4	529868	rs11940914	T	C	1	5	6	0	0	6	0	0
4	529901	rs11934533	G	A	4	10	14	0	0	14	0	0
4	529931	rs11934538	G	T	6	13	19	0	0	19	0	0
4	530350	rs34247702	A	G	5	4	9	0	0	9	0	0
4	530451	rs55983970	C	G	4	5	9	0	0	9	0	0
4	531141	rs35479345	G	A	3	3	6	0	0	6	0	0
4	531220	rs36043622	T	C	2	4	6	0	0	6	0	0
4	531265	rs11936515	T	G	2	5	7	0	0	7	0	0
4	531959	rs72501954	T	C	0	6	6	0	0	6	0	0
4	532812	rs10213020	A	G	1	7	8	0	0	8	0	0
4	533001	rs1127410	T	C	10	16	26	0	0	26	0	0
4	663916	rs61760239	C	A	31	30	61	0	0	61	0	0
4	668366	rs71602500	G	C	8	8	16	0	0	16	0	0
4	670263	rs116594734	C	T	7	2	9	0	0	9	0	0
4	672177	rs28655411	G	C	13	18	31	0	0	31	0	0
4	672320	rs13110755	C	G	6	16	22	0	0	22	0	0
4	734241	.	C	G	7	6	13	0	1	14	0	0
4	755746	rs6821861	C	G	5	1	6	0	0	6	0	0
4	755749	rs4690307	G	A	1	5	6	0	0	6	0	0
4	760258	rs7336	G	T	21	18	39	0	0	39	0	0
4	760819	rs4690194	C	T	15	19	34	0	0	34	0	0
4	761371	rs57003523	C	T	21	20	41	0	0	41	0	0
4	761850	rs1894	T	C	7	7	14	0	0	14	0	0
4	771053	rs11934187	G	A	7	5	12	0	0	12	0	0
4	771587	rs6819857	A	G	6	4	10	0	0	10	0	0
4	772566	rs34263120	G	A	5	4	9	0	0	9	0	0
4	773050	rs11936723	G	A	4	2	6	0	0	6	0	0
4	843184	rs6964	G	A	58	74	132	0	1	133	0	0
4	843695	rs8093	A	G	59	58	117	0	0	117	0	0
4	844035	rs2306241	C	T	4	9	13	0	0	13	0	0
4	844781	rs75072999	G	A	106	93	199	0	4	203	0	0
4	847008	rs6843423	C	T	10	10	20	0	0	20	0	0
4	848335	rs7697256	C	T	11	4	15	0	0	15	0	0
4	849035	rs76980717	G	A	5	5	10	0	0	10	0	0
4	849871	rs11735448	G	A	3	3	6	0	0	6	0	0
4	852659	rs2279177	T	G	6	2	8	0	0	8	0	0
4	860192	rs1064207	A	G	42	57	99	0	0	99	0	0
4	860796	rs112225848	C	T	32	29	61	0	0	61	0	0
4	867866	rs764324	T	C	9	5	14	0	0	14	0	0
4	888361	rs34509509	C	A	3	3	6	0	0	6	0	0
4	891503	rs3775124	C	G	2	4	6	0	0	6	0	0
4	893687	rs3775120	G	A	5	1	6	0	0	6	0	0
4	897013	rs3775115	A	G	4	3	7	0	0	7	0	0
4	897403	rs3822022	A	G	3	4	7	0	1	8	0	0
4	897428	rs62297083	A	G	2	4	6	0	0	6	0	0
4	944210	rs34884217	A	C	9	9	18	0	1	19	0	0
4	946226	rs11552301	T	C	7	11	18	0	1	19	0	0
4	950737	rs3733343	T	C	2	4	6	0	0	6	0	0
4	953698	rs4690326	A	C	11	17	28	0	1	29	0	0
4	953974	rs4690197	T	G	16	18	34	0	1	35	0	0
4	954247	rs3733345	G	T	19	20	39	0	1	40	0	0
4	954275	rs3733346	T	C	17	19	36	0	0	36	0	0
4	954277	rs3733347	T	C	16	19	35	0	0	35	0	0
4	954311	rs3733349	C	T	12	22	34	0	0	34	0	0
4	961373	rs1377586	G	A	4	6	10	0	0	10	0	0
4	984704	rs115435541	G	A	2	5	7	0	0	7	0	0
4	985727	rs3822020	A	G	4	2	6	0	0	6	0	0
4	994452	rs3755954	C	T	28	13	41	0	0	41	0	0
4	1019312	rs4647939	G	A	7	7	14	0	0	14	0	0
4	1019672	rs1064838	T	C	13	10	23	0	0	23	0	0
4	1019697	rs1064839	C	G	15	9	24	0	0	24	0	0
4	1164277	rs2279279	C	G	9	14	23	0	0	23	0	0
4	1165764	rs11538062	C	T	4	8	12	0	0	12	0	0
4	1237052	rs1250099	A	G	3	6	9	0	0	9	0	0
4	1346903	rs77892061	G	A	10	4	14	0	1	15	0	0
4	1642374	rs7376928	A	G	5	2	7	0	0	7	0	0
4	1694809	rs8051	T	C	248	244	492	0	1	493	0	0
4	1696103	rs35313041	C	T	8	7	15	0	0	15	0	0
4	1697337	rs34049648	G	A	19	16	35	0	0	35	0	0
4	1701317	rs2247341	G	A	482	323	805	0	2	807	0	0
4	1718870	rs2236788	G	C	22	14	36	0	1	37	0	0
4	1718883	rs2236787	A	T	14	22	36	0	0	36	0	0
4	1719508	rs62285073	G	A	4	3	7	0	0	7	0	0
4	1719620	rs743569	T	G	3	3	6	0	0	6	0	0
4	1720346	rs11552262	A	G	9	11	20	0	0	20	0	0
4	1727740	rs56222212	T	C	0	6	6	0	0	6	0	0
4	1728120	rs2282763	A	C	1	5	6	0	0	6	0	0
4	1729425	rs2592828	C	G	4	2	6	0	0	6	0	0
4	1729660	rs1063742	C	T	111	130	241	0	0	241	0	0
4	1729953	rs17132047	G	A	92	106	198	0	1	199	0	0
4	1729988	rs1063743	G	A	99	117	216	0	2	218	0	0
4	1730299	rs798759	A	G	125	107	232	0	2	234	0	0
4	1731126	rs798761	G	A	5	4	9	0	0	9	0	0
4	1731279	rs62285107	C	T	4	7	11	0	0	11	0	0
4	1731362	rs3819381	C	T	8	4	12	0	0	12	0	0
4	1731427	rs3819380	C	T	10	2	12	0	0	12	0	0
4	1731666	rs3819377	C	T	10	4	14	0	1	15	0	0
4	1732978	rs17680881	G	A	143	173	316	0	1	317	0	0
4	1733956	rs2166578	G	A	6	11	17	0	0	17	0	0
4	1734892	rs56199839	C	T	7	2	9	0	0	9	0	0
4	1735188	rs55895563	T	G	4	2	6	0	0	6	0	0
4	1737502	rs11248073	C	T	147	111	258	0	3	261	0	0
4	1738016	rs62285110	G	A	4	2	6	0	0	6	0	0
4	1738313	rs11730727	T	C	4	6	10	0	0	10	0	0
4	1738438	rs112047717	C	T	6	4	10	0	0	10	0	0
4	1738732	rs17681105	C	T	6	4	10	0	0	10	0	0
4	1739196	rs3816352	C	T	10	7	17	0	0	17	0	0
4	1739252	rs41286677	T	C	7	7	14	0	0	14	0	0
4	1739977	rs17619338	G	A	17	23	40	0	0	40	0	0
4	1740675	rs13138643	G	A	28	16	44	0	0	44	0	0
4	1740684	rs55667711	G	A	17	25	42	0	1	43	0	0
4	1740985	rs10022431	A	C	11	23	34	0	1	35	0	0
4	1741325	rs2077363	A	G	24	33	57	0	0	57	0	0
4	1741740	rs2249143	G	A	7	7	14	0	1	15	0	0
4	1742779	rs1530588	G	A	12	6	18	0	0	18	0	0
4	1743336	rs7654245	C	T	4	3	7	0	0	7	0	0
4	1743754	rs11248074	C	T	3	6	9	0	0	9	0	0
4	1744252	rs2403293	A	G	8	11	19	0	0	19	0	0
4	1744939	rs11736125	C	T	4	5	9	0	1	10	0	0
4	1744943	rs55670131	A	G	6	3	9	0	0	9	0	0
4	1745150	rs56037412	C	T	4	8	12	0	0	12	0	0
4	1745345	rs9990541	A	G	9	7	16	0	0	16	0	0
4	1745486	rs4865465	G	A	8	13	21	0	0	21	0	0
4	1745492	rs4865466	C	T	8	14	22	0	0	22	0	0
4	1745770	rs28420470	A	G	11	12	23	0	0	23	0	0
4	1746229	rs2290011	G	T	10	12	22	0	0	22	0	0
4	2243545	.	G	T	23	23	46	0	0	46	0	0
4	2250109	rs880674	T	C	54	61	115	0	0	115	0	0
4	2251697	.	G	A	41	27	68	0	0	68	0	0
4	2252201	rs1052682	C	T	52	54	106	0	0	106	0	0
4	2258934	.	G	C	6	13	19	0	0	19	0	0
4	2271992	rs7678167	C	G	4	2	6	0	0	6	0	0
4	2272174	rs7664817	G	C	5	2	7	0	0	7	0	0
4	2510481	rs1203850	A	G	3	3	6	0	0	6	0	0
4	2517223	rs1048727	A	G	100	77	177	0	1	178	0	0
4	2658755	rs2282767	G	C	1	5	6	0	0	6	0	0
4	2744087	rs2269495	G	A	71	65	136	0	0	136	0	0
4	2744480	rs9683949	C	T	11	8	19	0	0	19	0	0
4	2745508	rs3733223	C	A	10	19	29	0	0	29	0	0
4	2745734	rs3733222	G	A	7	13	20	0	0	20	0	0
4	2746285	rs13145281	A	C	14	10	24	0	1	25	0	0
4	2746898	rs762856	C	T	24	24	48	0	1	49	0	0
4	2831383	rs231399	T	G	31	32	63	0	4	67	0	0
4	2836628	rs231394	C	T	35	42	77	0	1	78	0	0
4	2837763	rs1263416	G	C	47	43	90	0	0	90	0	0
4	2838473	rs10924	C	T	48	67	115	0	1	116	0	0
4	2839659	rs9715869	G	A	4	8	12	0	0	12	0	0
4	2841240	rs4690002	T	C	5	4	9	0	1	10	0	0
4	2861430	rs1263360	A	G	5	3	8	0	0	8	0	0
4	2933271	rs1263348	G	A	43	59	102	0	1	103	0	0
4	2934690	.	G	A	129	119	248	0	1	249	0	0
4	2937557	.	C	T	24	25	49	0	1	50	0	0
4	2938187	.	C	T	10	7	17	0	0	17	0	0
4	2938591	.	T	G	5	8	13	0	0	13	0	0
4	2938651	rs2798287	C	A	7	6	13	0	0	13	0	0
4	2940300	rs111996445	A	G	40	32	72	0	0	72	0	0
4	2940358	rs12651499	G	A	29	25	54	0	0	54	0	0
4	2941418	rs1263337	G	A	5	1	6	0	0	6	0	0
4	2941988	rs2032463	T	C	10	9	19	0	0	19	0	0
4	2943361	rs1054090	T	C	94	77	171	0	1	172	0	0
4	2944564	rs575277569	T	C	11	10	21	0	0	21	0	0
4	2944620	rs12502773	T	C	13	11	24	0	0	24	0	0
4	2944746	rs57191180	T	C	7	7	14	0	0	14	0	0
4	2944851	rs562680199	G	A	4	5	9	0	0	9	0	0
4	2946028	rs112246963	T	C	4	6	10	0	0	10	0	0
4	2948160	rs115160007	C	T	74	56	130	0	2	132	0	0
4	2948203	rs114205498	G	A	75	72	147	0	1	148	0	0
4	2951804	rs2515960	A	G	91	68	159	0	1	160	0	0
4	2955145	rs1475977	T	C	8	9	17	0	0	17	0	0
4	2955192	rs1475976	C	G	11	13	24	0	0	24	0	0
4	2955212	rs150068008	A	C	11	14	25	0	1	26	0	0
4	2964286	.	T	C	2	10	12	0	0	12	0	0
4	2964615	rs192051627	C	G	14	12	26	0	0	26	0	0
4	2965098	rs375602874	C	A	3	3	6	0	0	6	0	0
4	2966906	rs111359025	C	T	3	4	7	0	0	7	0	0
4	3077037	rs10009935	T	C	6	3	9	0	0	9	0	0
4	3124095	rs73792195	G	C	5	1	6	0	0	6	0	0
4	3125101	.	T	C	6	0	6	0	0	6	0	0
4	3126130	rs149960588	T	C	14	3	17	0	0	17	0	0
4	3126317	rs144187737	T	G	12	3	15	0	0	15	0	0
4	3130041	rs142728639	C	A	7	4	11	0	1	12	0	0
4	3130733	rs140052241	A	G	15	8	23	0	0	23	0	0
4	3130849	rs7682324	A	G	15	10	25	0	0	25	0	0
4	3174845	rs3025837	A	C	30	25	55	0	0	55	0	0
4	3182666	rs375318832	C	T	4	3	7	0	0	7	0	0
4	3183645	rs150564691	C	T	5	1	6	0	0	6	0	0
4	3186864	rs149481207	A	G	10	2	12	0	0	12	0	0
4	3188457	rs148659037	C	T	12	1	13	0	0	13	0	0
4	3188609	rs546698195	A	G	6	0	6	0	0	6	0	0
4	3188953	rs558375924	A	G	9	2	11	0	0	11	0	0
4	3189547	rs363125	C	A	36	28	64	0	0	64	0	0
4	3189812	rs363124	T	C	8	3	11	0	0	11	0	0
4	3190012	rs6839081	T	A	8	12	20	0	1	21	0	0
4	3190486	rs6844859	T	C	23	10	33	0	2	35	0	0
4	3213715	rs140124504	T	C	39	37	76	0	0	76	0	0
4	3213865	rs144090436	G	A	42	27	69	0	1	70	0	0
4	3215156	rs118066555	G	A	6	4	10	0	0	10	0	0
4	3215835	rs362331	T	C	67	44	111	0	1	112	0	0
4	3217211	rs147074197	G	A	12	4	16	0	0	16	0	0
4	3217495	rs184672347	A	G	12	6	18	0	0	18	0	0
4	3218203	rs2298973	A	G	16	0	16	0	0	16	0	0
4	3219053	rs362277	C	T	13	16	29	0	2	31	0	0
4	3219142	rs145591720	C	T	16	8	24	0	0	24	0	0
4	3219346	rs117898830	G	A	16	7	23	0	0	23	0	0
4	3220916	.	G	A	10	15	25	0	0	25	0	0
4	3221284	rs138923576	A	G	15	12	27	0	0	27	0	0
4	3221872	rs362276	C	G	11	1	12	0	0	12	0	0
4	3225764	rs138489139	G	A	62	37	99	0	0	99	0	0
4	3226434	rs362274	G	A	3	4	7	0	0	7	0	0
4	3230804	rs2530598	A	C	4	5	9	0	0	9	0	0
4	3230973	rs2798231	G	A	3	5	8	0	0	8	0	0
4	3233795	rs111387773	C	T	10	5	15	0	0	15	0	0
4	3233973	rs10021033	C	G	10	8	18	0	0	18	0	0
4	3233999	rs73074838	C	T	11	7	18	0	1	19	0	0
4	3235450	rs2237007	T	C	5	3	8	0	1	9	0	0
4	3235589	rs362313	C	T	3	4	7	0	0	7	0	0
4	3236632	rs2530596	T	C	3	8	11	0	0	11	0	0
4	3236883	rs2858082	A	G	3	5	8	0	0	8	0	0
4	3238981	rs3135175	A	G	3	3	6	0	0	6	0	0
4	3240043	rs151126019	C	T	4	2	6	0	0	6	0	0
4	3240740	rs73074852	T	C	8	6	14	0	0	14	0	0
4	3240915	rs362309	G	C	20	8	28	0	0	28	0	0
4	3241413	rs2071703	A	C	13	6	19	0	0	19	0	0
4	3241895	rs148278311	G	T	144	87	231	0	5	236	0	0
4	3242148	rs362268	C	G	158	89	247	0	0	247	0	0
4	3242418	rs142037345	C	T	13	2	15	0	0	15	0	0
4	3244896	rs114691062	G	T	16	14	30	0	0	30	0	0
4	3244928	rs362300	G	A	17	15	32	0	0	32	0	0
4	3245057	rs2530595	C	T	37	24	61	0	3	64	0	0
4	3433420	rs112495609	C	T	5	1	6	0	0	6	0	0
4	3509260	rs71608285	G	A	4	3	7	0	0	7	0	0
4	3512137	rs10014466	C	T	9	6	15	0	0	15	0	0
4	3512563	rs1794423	C	T	6	11	17	0	0	17	0	0
4	3513834	rs2093098	T	C	3	8	11	0	0	11	0	0
4	3513936	rs112750320	C	T	9	12	21	0	1	22	0	0
4	3514539	rs1049574	G	A	1036	952	1988	0	10	1998	0	0
4	3517389	rs13129212	A	G	4	3	7	0	0	7	0	0
4	3517483	rs3135165	G	C	5	4	9	0	0	9	0	0
4	3518039	rs111617934	C	T	19	16	35	0	0	35	0	0
4	3518190	rs1800492	C	T	43	29	72	0	1	73	0	0
4	3518507	rs34327156	G	C	23	39	62	0	0	62	0	0
4	3519023	rs1741549	G	T	38	18	56	0	0	56	0	0
4	3519220	rs35474414	T	C	40	19	59	0	0	59	0	0
4	3519634	rs111901738	G	A	24	12	36	0	0	36	0	0
4	3519762	rs13325	A	G	785	777	1562	0	7	1569	0	0
4	3523511	.	C	T	2	4	6	0	0	6	0	0
4	3526786	rs1800485	C	T	22	18	40	0	0	41	1	0
4	3527693	rs2237010	G	A	9	11	20	0	1	21	0	0
4	3528846	rs13125213	A	G	4	8	12	0	0	12	0	0
4	3529671	rs2237011	C	A	5	4	9	0	0	9	0	0
4	3530770	rs62272716	G	A	9	3	12	0	0	12	0	0
4	3943874	rs62289005	C	T	5	3	8	0	0	8	0	0
4	3954873	rs61082048	A	T	4	2	6	0	0	6	0	0
4	3954878	rs58515458	T	C	4	2	6	0	0	6	0	0
4	4237565	rs1044716	C	T	14	5	19	0	1	20	0	0
4	4237600	rs73082020	C	T	17	7	24	0	0	24	0	0
4	4237691	rs2294108	T	A	8	5	13	0	0	13	0	0
4	4238062	rs2294107	G	C	13	3	16	0	0	16	0	0
4	4238224	rs58569407	C	T	12	6	18	0	0	18	0	0
4	4238315	rs2920244	G	T	10	4	14	0	0	14	0	0
4	4238347	rs61016366	T	C	8	3	11	0	1	12	0	0
4	4238746	rs57797443	T	G	7	2	9	0	0	9	0	0
4	4249034	rs7676450	T	C	2	4	6	0	0	6	0	0
4	4421055	rs2044	T	C	10	12	22	0	0	22	0	0
4	5021161	rs190051630	A	C	32	20	52	0	1	53	0	0
4	6594947	rs2301796	A	C	32	26	58	0	0	58	0	0
4	6596360	rs2301795	G	A	23	22	45	0	0	45	0	0
4	6600012	rs2301790	A	G	15	20	35	0	1	36	0	0
4	6606864	rs2301788	A	G	23	28	51	0	0	51	0	0
4	6619204	rs4689490	G	A	33	19	52	0	0	52	0	0
4	6620602	rs3733603	C	G	2	4	6	0	0	6	0	0
4	6623332	rs3088248	G	A	72	45	117	0	0	117	0	0
4	6644273	rs12695	C	G	547	554	1101	0	3	1104	0	0
4	6644391	rs1059220	G	A	250	283	533	0	1	534	0	0
4	6696229	rs60685700	C	T	3	7	10	0	0	10	0	0
4	6696460	rs58654929	G	A	8	5	13	0	0	13	0	0
4	6696524	rs58986571	T	C	9	6	15	0	0	15	0	0
4	6697166	rs4689034	T	C	3	6	9	0	0	9	0	0
4	6697176	rs4689521	A	G	6	3	9	0	0	9	0	0
4	6697554	rs3822265	C	G	7	4	11	0	0	11	0	0
4	6697590	rs3822264	G	A	9	4	13	0	0	13	0	0
4	6697673	rs3822263	T	C	2	9	11	0	0	11	0	0
4	6697766	rs3822262	T	G	4	3	7	0	0	7	0	0
4	6697795	rs3822261	A	C	5	7	12	0	0	12	0	0
4	6697822	rs3822260	C	T	5	7	12	0	0	12	0	0
4	6718775	rs3172604	G	T	95	125	220	0	4	224	0	0
4	6831804	rs73199907	A	G	11	8	19	0	0	19	0	0
4	6883514	rs3822268	A	G	37	39	76	0	0	76	0	0
4	6988238	rs3857168	C	T	11	12	23	0	0	23	0	0
4	7032924	rs3756255	A	T	42	35	77	0	0	77	0	0
4	7033671	rs12119	C	T	33	31	64	0	1	65	0	0
4	7048470	.	C	G	3	5	8	0	0	8	0	0
4	7048842	rs10937780	G	A	5	5	10	0	0	10	0	0
4	7058882	rs10937783	A	T	6	12	18	0	0	18	0	0
4	7066475	rs147564919	G	A	4	3	7	0	0	7	0	0
4	7653541	rs10005748	T	C	1	5	6	0	0	6	0	0
4	7671699	rs61235713	T	G	5	1	6	0	0	6	0	0
4	7671707	rs4689151	T	C	1	5	6	0	0	6	0	0
4	7672785	rs11724048	G	T	4	2	6	0	0	6	0	0
4	7673546	rs7668169	C	T	9	5	14	0	0	14	0	0
4	7738676	rs28744611	T	C	3	4	7	0	0	7	0	0
4	7738730	rs6840685	A	C	3	3	6	0	0	6	0	0
4	7739618	rs9996177	T	C	7	1	8	0	0	8	0	0
4	7740470	rs16840961	A	C	2	4	6	0	1	7	0	0
4	7743322	rs139578766	T	C	28	18	46	0	2	48	0	0
4	7743547	rs10937857	C	A	16	19	35	0	1	36	0	0
4	7743786	rs57984253	C	G	31	17	48	0	0	48	0	0
4	7743974	rs4689158	C	T	32	24	56	0	4	60	0	0
4	7744367	rs12498937	T	G	29	38	67	0	2	69	0	0
4	7755851	rs1859236	G	A	3	12	15	0	0	15	0	0
4	7764501	rs10050114	T	A	7	2	9	0	0	9	0	0
4	7764516	rs2158274	C	G	6	2	8	0	0	8	0	0
4	8228943	rs34994651	G	A	9	10	19	0	0	19	0	0
4	8293193	rs111620813	G	A	11	5	16	0	0	16	0	0
4	8297770	rs13130469	A	G	4	3	7	0	0	7	0	0
4	8454639	rs1880024	A	G	20	18	38	0	1	39	0	0
4	8471398	rs2688223	T	C	5	1	6	0	0	6	0	0
4	8475014	rs2255501	G	A	2	4	6	0	0	6	0	0
4	8476118	rs2631735	A	G	9	3	12	0	0	12	0	0
4	10080807	rs78140483	T	C	9	5	14	0	0	14	0	0
4	10089300	rs369477614	C	A	6	4	10	0	0	10	0	0
4	10102669	rs73212861	G	A	10	24	34	0	0	34	0	0
4	10115290	rs12509674	G	T	4	2	6	0	0	6	0	0
4	10443384	rs4422413	T	G	11	3	14	0	0	14	0	0
4	10443425	rs10938799	G	A	6	15	21	0	0	21	0	0
4	10444650	rs3217	C	T	16	5	21	0	0	21	0	0
4	10446906	rs10016022	A	G	6	10	16	0	1	17	0	0
4	10447168	rs66538112	C	G	9	6	15	0	0	15	0	0
4	10447194	rs73224493	T	G	11	8	19	0	0	19	0	0
4	10452763	rs7674156	G	C	4	3	7	0	0	7	0	0
4	10454994	rs12019277	C	A	4	6	10	0	0	10	0	0
4	10685548	rs4697778	G	A	3	4	7	0	0	7	0	0
4	11429861	rs73222107	C	G	5	2	7	0	0	7	0	0
4	11429969	rs62295620	A	G	5	7	12	0	0	12	0	0
4	13369988	rs191458805	G	T	13	3	16	0	0	16	0	0
4	15603069	rs1134634	G	C	2	6	8	0	0	8	0	0
4	15607857	rs6823775	C	A	3	3	6	0	1	7	0	0
4	15608175	rs6824422	C	T	12	9	21	0	0	21	0	0
4	15611017	rs35120298	T	C	3	6	9	0	0	9	0	0
4	15613482	rs73239174	C	T	6	3	9	0	0	9	0	0
4	15623619	rs73239193	T	G	8	6	14	0	0	14	0	0
4	15623684	rs111716433	G	C	8	10	18	0	0	18	0	0
4	15624957	rs56166932	A	C	2	5	7	0	0	7	0	0
4	15625321	rs56093715	T	C	59	59	118	0	1	119	0	0
4	15625743	rs28447067	G	A	108	96	204	0	1	205	0	0
4	15626475	rs6414764	C	T	73	56	129	0	1	130	0	0
4	15630428	rs73241109	G	A	7	6	13	0	1	14	0	0
4	15630842	rs73241112	A	G	7	5	12	0	0	12	0	0
4	15630849	rs35013326	G	A	5	7	12	0	0	12	0	0
4	15631068	rs4346644	C	T	9	8	17	0	0	17	0	0
4	15633858	rs150389805	G	T	27	27	54	0	0	54	0	0
4	15634625	rs13122812	T	C	15	17	32	0	0	32	0	0
4	15640168	rs3182730	C	T	185	147	332	0	2	335	1	0
4	15656212	rs73241198	G	T	6	0	6	0	0	6	0	0
4	15661355	rs73243105	G	A	7	5	12	0	0	12	0	0
4	15669611	rs113126497	C	T	111	104	215	0	2	217	0	0
4	15679035	rs73243131	G	C	6	7	13	0	0	13	0	0
4	15679573	rs201686489	T	C	6	4	10	0	0	10	0	0
4	15679852	rs4301111	A	T	3	6	9	0	0	9	0	0
4	15681414	rs34473224	A	C	3	10	13	0	0	13	0	0
4	15683318	rs13150957	C	T	24	29	53	0	1	54	0	0
4	15683346	rs114115072	G	A	44	31	75	0	1	76	0	0
4	15688604	rs2302469	G	C	5	2	7	0	0	7	0	0
4	15709192	rs2302465	G	A	183	142	325	0	1	326	0	0
4	15734068	rs148860748	G	A	34	23	57	0	2	59	0	0
4	15735106	rs4259058	C	T	9	1	10	0	0	10	0	0
4	15739416	rs3900588	G	C	38	12	50	0	0	50	0	0
4	15739428	rs4320134	A	T	38	13	51	0	0	51	0	0
4	15739498	rs997250	A	G	29	10	39	0	0	39	0	0
4	15780358	rs11574921	G	A	5	9	14	0	0	14	0	0
4	15781178	rs78585552	C	T	31	10	41	0	2	43	0	0
4	15785321	rs73224697	G	A	1	7	8	0	0	8	0	0
4	15786408	rs7681718	C	T	0	6	6	0	0	6	0	0
4	15786508	rs143985889	G	A	4	2	6	0	0	6	0	0
4	15786523	rs7659350	A	T	3	6	9	0	0	9	0	0
4	15791867	rs71613232	A	G	5	13	18	0	0	18	0	0
4	15792183	rs7674345	C	G	7	7	14	0	0	14	0	0
4	15852104	rs17476066	T	C	17	9	26	0	0	26	0	0
4	15853013	rs4396987	C	A	13	10	23	0	1	24	0	0
4	15853684	rs13133313	T	C	20	30	50	0	0	50	0	0
4	15854420	rs6858536	G	A	16	19	35	0	6	41	0	0
4	15854725	rs3733593	G	A	25	38	63	0	0	63	0	0
4	15964670	rs35496730	C	T	12	18	30	0	0	30	0	0
4	15964763	rs4698432	C	T	9	7	16	0	0	16	0	0
4	15969938	rs3130	T	C	3	4	7	0	0	7	0	0
4	15970201	rs7686732	G	C	12	11	23	0	1	24	0	0
4	15970349	rs2240688	T	G	5	7	12	0	0	12	0	0
4	16229112	.	C	A	1	6	7	0	0	7	0	0
4	16229113	.	A	G	1	6	7	0	0	7	0	0
4	17632845	rs73233489	T	A	5	3	8	0	0	8	0	0
4	17635336	rs61741403	G	A	6	13	19	0	0	19	0	0
4	17803618	rs13116464	C	T	43	19	62	0	1	63	0	0
4	17804286	.	T	G	30	22	52	0	16	73	5	0
4	17804717	rs111465602	A	G	24	30	54	0	0	54	0	0
4	17809265	rs13119311	G	T	20	9	29	0	0	29	0	0
4	17809538	rs2286540	A	G	7	2	9	0	1	10	0	0
4	17810088	rs16895782	A	G	4	4	8	0	1	9	0	0
4	17810255	rs2286539	G	A	6	1	7	0	0	7	0	0
4	17811415	rs16895788	C	T	27	24	51	0	0	51	0	0
4	17811654	rs78212195	T	G	18	11	29	0	0	29	0	0
4	17818885	rs2302212	T	C	9	9	18	0	0	18	0	0
4	17829990	rs3795243	G	C	18	31	49	0	1	50	0	0
4	17837583	rs76829955	G	T	3	5	8	0	0	8	0	0
4	17841848	rs2286535	A	C	6	4	10	0	0	10	0	0
4	17845238	rs7688403	G	C	21	8	29	0	1	30	0	0
4	17845241	rs77416591	C	T	18	10	28	0	0	28	0	0
4	17846522	rs16895877	T	C	3	5	8	0	0	8	0	0
4	17852408	rs111884558	C	A	6	1	7	0	0	7	0	0
4	17913879	rs35921582	A	G	3	7	10	0	0	10	0	0
4	17933639	rs35654348	C	T	2	4	6	0	1	7	0	0
4	17933810	rs6841793	C	G	5	1	6	0	0	6	0	0
4	20728966	rs17552929	G	C	21	8	29	0	0	29	0	0
4	20754280	rs13147509	T	C	11	11	22	0	0	22	0	0
4	22390167	rs9002	C	T	8	12	20	0	0	20	0	0
4	24538573	rs4697063	A	G	7	5	12	0	0	12	0	0
4	25124746	rs13109061	T	C	5	13	18	0	0	18	0	0
4	25156483	rs3733548	A	G	4	4	8	0	0	8	0	0
4	25236017	rs313549	T	C	9	2	11	0	0	11	0	0
4	25278988	rs3796780	T	C	6	3	9	0	0	9	0	0
4	25279456	rs11544127	T	A	11	8	19	0	0	19	0	0
4	25279508	rs11544126	G	A	16	10	26	0	1	27	0	0
4	25315754	rs144236014	G	C	16	4	20	0	0	20	0	0
4	25371399	rs13102709	C	T	8	4	12	0	0	12	0	0
4	25371460	rs13102920	C	T	4	2	6	0	0	6	0	0
4	25393889	rs2292407	C	T	5	1	6	0	0	6	0	0
4	25408838	rs34811474	G	A	33	27	60	0	3	63	0	0
4	25415810	rs55714412	C	A	3	5	8	0	0	8	0	0
4	25419283	rs9174	T	C	60	61	121	0	2	123	0	0
4	25931325	rs554	G	A	35	22	57	0	1	58	0	0
4	26181870	.	A	G	3	4	7	0	0	7	0	0
4	26289961	rs13142370	C	T	5	4	9	0	0	9	0	0
4	26321784	rs3796802	G	C	6	7	13	0	0	13	0	0
4	26417136	rs2270226	T	C	62	73	135	0	1	136	0	0
4	36068571	rs12645801	A	T	6	3	9	0	1	10	0	0
4	36069805	rs7657166	G	A	2	4	6	0	0	6	0	0
4	37613956	.	A	C	27	9	36	0	8	44	0	0
4	37614024	rs78768375	G	A	37	22	59	0	0	59	0	0
4	37614246	rs74886514	G	A	15	10	25	0	1	26	0	0
4	37614560	rs78708524	G	A	40	31	71	0	2	73	0	0
4	37614737	rs3733498	C	A	55	33	88	0	0	88	0	0
4	37672881	rs11096896	C	T	3	5	8	0	0	8	0	0
4	37675941	rs919006	A	C	5	4	9	0	0	9	0	0
4	37851919	.	T	G	88	70	158	0	2	160	0	0
4	37904089	rs35859249	C	T	4	3	7	0	0	7	0	0
4	38016395	rs10501	T	G	23	21	44	0	0	44	0	0
4	38017232	rs34020085	C	T	4	5	9	0	0	9	0	0
4	38017237	rs17607179	G	T	4	5	9	0	0	9	0	0
4	38018181	rs13142228	C	T	3	3	6	0	0	6	0	0
4	38023302	rs34119528	C	G	78	70	148	0	1	149	0	0
4	38062263	rs16994165	G	A	35	8	43	0	1	44	0	0
4	38062387	rs75564054	T	C	1	6	7	0	0	7	0	0
4	38108397	rs6839424	G	A	11	3	14	0	0	14	0	0
4	38138856	rs13110318	G	A	123	127	250	0	7	257	0	0
4	38626130	rs28418927	A	C	3	5	8	0	0	8	0	0
4	38664324	rs1466414	A	G	7	4	11	0	0	11	0	0
4	38664499	rs2078179	A	G	5	2	7	0	0	7	0	0
4	38665818	rs113071828	G	A	20	13	33	0	0	33	0	0
4	38666746	rs28656945	G	A	88	79	167	0	1	168	0	0
4	38666972	rs9522	C	T	129	139	268	0	3	271	0	0
4	38689228	rs4535339	A	G	8	8	16	0	0	16	0	0
4	38689745	rs17428945	T	C	80	107	187	0	0	187	0	0
4	38690998	rs28657453	G	A	5	2	7	0	0	7	0	0
4	38692160	rs2169542	G	A	162	142	304	0	2	306	0	0
4	38692806	rs3796533	G	A	22	25	47	0	0	47	0	0
4	38805942	rs5743566	G	C	18	4	22	0	0	22	0	0
4	38805983	rs5743565	T	C	12	4	16	0	0	16	0	0
4	38829832	rs3775073	T	C	5	5	10	0	0	10	0	0
4	38830012	rs3821985	G	C	11	6	17	0	0	17	0	0
4	38830116	rs3796508	C	T	9	4	13	0	0	13	0	0
4	39308187	rs2066789	G	A	4	7	11	0	1	12	0	0
4	39456708	rs1985998	G	A	56	46	102	0	0	102	0	0
4	39457857	rs1015450	T	C	29	37	66	0	0	66	0	0
4	39458591	rs13143990	T	C	9	18	27	0	0	27	0	0
4	39460352	rs11550000	C	G	89	79	168	0	0	168	0	0
4	39460413	rs2276889	C	A	92	84	176	0	2	178	0	0
4	39463903	rs61731032	C	A	12	21	33	0	0	33	0	0
4	39501512	rs139160141	C	T	3	5	8	0	0	8	0	0
4	39501518	rs113746940	C	T	3	4	7	0	1	8	0	0
4	39510264	rs1129052	A	G	4	4	8	0	0	8	0	0
4	39515736	rs10019532	A	G	4	2	6	0	0	6	0	0
4	39528938	rs13127236	T	A	2	4	6	0	1	7	0	0
4	39528939	rs13146483	C	T	2	5	7	0	0	7	0	0
4	39533948	rs12512204	C	T	7	4	11	0	0	11	0	0
4	39703872	.	T	C	9	0	9	0	11	20	0	0
4	39899979	rs73229703	G	C	12	21	33	0	0	33	0	0
4	40138676	rs2271395	A	G	38	28	66	0	0	66	0	0
4	40158167	rs78152193	A	G	13	11	24	0	0	24	0	0
4	40158562	rs6824580	C	G	18	12	30	0	0	30	0	0
4	40198842	rs1053504	A	G	360	370	730	0	11	741	0	0
4	40198846	rs2245466	G	C	349	343	692	0	29	721	0	0
4	40246835	rs58297725	T	A	10	25	35	0	0	35	0	0
4	40247611	rs4616763	C	G	22	18	40	0	0	40	0	0
4	40427990	rs2292039	G	C	2	5	7	0	0	7	0	0
4	42629038	rs16854624	C	T	10	12	22	0	0	22	0	0
4	44682465	rs6447368	T	C	9	13	22	0	0	22	0	0
4	44701256	rs13125773	G	T	16	8	24	0	0	24	0	0
4	44701446	rs6811584	A	G	14	30	44	0	1	45	0	0
4	44701750	rs6812211	A	C	7	8	15	0	0	15	0	0
4	44701764	rs6817397	T	G	7	10	17	0	0	17	0	0
4	44702720	rs1565532	T	C	2	6	8	0	0	8	0	0
4	44705595	rs1133648	G	A	6	4	10	0	0	10	0	0
4	44705601	rs1133650	T	C	6	4	10	0	0	10	0	0
4	44706919	rs2709	C	T	1	8	9	0	0	9	0	0
4	47461051	rs12510975	A	G	6	5	11	0	0	11	0	0
4	47461838	rs76759500	A	G	7	8	15	0	0	15	0	0
4	47487705	.	A	T	6	2	8	0	0	8	0	0
4	47488480	rs11945442	G	C	40	29	69	0	1	70	0	0
4	47514685	rs33995001	C	T	2	5	7	0	0	7	0	0
4	47515994	rs6827906	G	A	1	8	9	0	0	9	0	0
4	47538044	rs35012290	G	A	0	9	9	0	0	9	0	0
4	47593283	rs4145944	G	C	2	6	8	0	0	8	0	0
4	47887536	rs2053404	T	C	14	13	27	0	0	27	0	0
4	47887991	rs6818556	G	A	17	9	26	0	0	26	0	0
4	48068783	rs1567217	G	A	6	14	20	0	0	20	0	0
4	48069696	rs2230594	G	C	13	4	17	0	0	17	0	0
4	48115264	rs7658300	C	T	6	0	6	0	0	6	0	0
4	48138235	rs3805184	A	G	20	19	39	0	0	39	0	0
4	48139565	rs2661529	C	A	17	9	26	0	0	26	0	0
4	48142678	rs28521484	C	T	6	4	10	0	0	10	0	0
4	48142824	rs6447616	A	G	13	5	18	0	0	18	0	0
4	48143201	rs17470892	T	C	4	5	9	0	0	9	0	0
4	48144710	rs73244489	T	A	3	7	10	0	0	10	0	0
4	48145695	rs7682890	A	T	10	10	20	0	0	20	0	0
4	48146845	rs996222	T	A	7	6	13	0	0	13	0	0
4	48146864	rs996223	G	A	3	5	8	0	0	8	0	0
4	48147309	rs17574371	T	C	70	66	136	0	0	136	0	0
4	48153706	rs7654182	A	G	5	5	10	0	0	10	0	0
4	48384676	rs375732965	A	G	41	47	88	0	1	89	0	0
4	48426486	.	T	C	31	28	59	0	0	59	0	0
4	48855744	rs557154102	A	G	11	6	17	0	0	17	0	0
4	52780048	rs13531	G	C	6	3	9	0	0	9	0	0
4	52781759	rs17611623	T	C	5	4	9	0	0	9	0	0
4	52782264	.	T	A	7	11	18	0	0	18	0	0
4	53459041	rs73248657	C	T	2	5	7	0	0	7	0	0
4	54074642	rs4588514	A	G	3	3	6	0	0	6	0	0
4	54243905	rs3811782	T	C	42	42	84	0	0	84	0	0
4	54244418	rs74553497	C	G	3	9	12	0	0	12	0	0
4	54263624	rs12233879	G	A	3	8	11	0	0	11	0	0
4	54264428	rs11734039	T	C	2	5	7	0	0	7	0	0
4	54285952	rs10011259	A	G	3	3	6	0	0	6	0	0
4	54306440	rs17082782	A	T	4	2	6	0	0	6	0	0
4	54308604	rs12506661	G	A	5	10	15	0	0	15	0	0
4	54326456	rs549268463	T	G	8	7	15	0	2	17	0	0
4	54326550	rs17657105	A	T	4	5	9	0	0	9	0	0
4	54327235	rs3811785	T	C	5	5	10	0	0	10	0	0
4	54327584	rs3765158	A	G	3	7	10	0	0	10	0	0
4	54876307	.	G	C	86	75	161	0	2	163	0	0
4	54906361	rs11731036	T	C	8	7	15	0	0	15	0	0
4	55593481	rs55986963	A	G	27	23	50	0	2	52	0	0
4	56236328	rs2538	C	T	96	106	202	0	1	203	0	0
4	56236579	rs13149568	C	T	5	12	17	0	0	17	0	0
4	56236804	rs573960	G	A	7	2	9	0	0	9	0	0
4	56237137	rs576732	C	T	11	4	15	0	0	15	0	0
4	56238263	rs819269	T	C	2	6	8	0	0	8	0	0
4	56262741	rs3087606	C	G	5	5	10	0	0	10	0	0
4	56264753	rs4549456	C	G	16	11	27	0	1	28	0	0
4	56266724	rs13113860	C	T	8	16	24	0	0	24	0	0
4	56267473	rs12641881	C	T	10	11	21	0	0	21	0	0
4	56291528	rs7660517	T	C	3	3	6	0	0	6	0	0
4	56292101	rs6802	A	T	21	27	48	0	0	48	0	0
4	56294628	rs3749473	T	C	3	3	6	0	0	6	0	0
4	56297762	rs6828570	C	G	3	3	6	0	0	6	0	0
4	56743276	rs13147883	C	T	5	1	6	0	0	6	0	0
4	56756531	rs2290016	T	C	16	8	24	0	0	24	0	0
4	56874517	rs3214045	A	C	17	15	32	0	0	32	0	0
4	57522646	rs4429779	A	G	24	28	52	0	2	54	0	0
4	57522689	rs4558922	C	T	5	4	9	0	0	9	0	0
4	57687711	rs781543	T	C	283	135	418	0	3	421	0	0
4	57687719	rs781544	C	T	273	136	409	0	2	411	0	0
4	57798469	rs781667	A	G	32	22	54	0	0	54	0	0
4	57843114	rs200929636	C	G	10	11	21	0	0	21	0	0
4	57861358	rs2293175	C	T	3	5	8	0	0	8	0	0
4	57872616	rs1718888	G	A	8	5	13	0	0	13	0	0
4	57875879	rs1713978	G	A	27	22	49	0	0	49	0	0
4	57876955	rs1718878	G	A	71	62	133	0	2	135	0	0
4	57881715	rs1713982	G	A	97	130	227	0	1	228	0	0
4	57887586	rs1718863	G	T	8	11	19	0	0	19	0	0
4	57888510	rs1718830	T	C	8	4	12	0	0	12	0	0
4	57889332	rs1718862	G	A	15	5	20	0	1	21	0	0
4	57889677	rs1056364	C	T	132	129	261	0	1	262	0	0
4	68331909	rs6840283	A	G	4	3	7	0	0	7	0	0
4	68331984	rs2319234	C	T	5	3	8	0	0	8	0	0
4	68338799	rs7669803	C	T	5	9	14	0	0	14	0	0
4	68338802	rs7693674	A	T	6	10	16	0	0	16	0	0
4	68339425	rs7669626	G	A	9	10	19	0	0	19	0	0
4	68340246	rs62303192	C	T	9	11	20	0	0	20	0	0
4	68341063	rs10866195	A	G	7	10	17	0	0	17	0	0
4	68341404	rs6841742	C	G	5	3	8	0	0	9	1	0
4	68341533	rs6823755	T	C	5	5	10	0	0	10	0	0
4	68343353	rs9992946	T	C	5	1	6	0	0	6	0	0
4	68343391	rs7697098	C	A	8	3	11	0	0	11	0	0
4	68344586	rs9993909	A	G	4	7	11	0	0	11	0	0
4	68345897	rs11724698	A	C	1	7	8	0	0	8	0	0
4	68347576	rs13117786	C	G	5	4	9	0	0	9	0	0
4	68348304	rs4597881	T	C	5	2	7	0	0	7	0	0
4	68350308	rs9312182	T	C	4	9	13	0	0	13	0	0
4	68374597	rs1056789	C	T	95	63	158	0	1	159	0	0
4	68376067	rs2646290	G	A	4	2	6	0	0	6	0	0
4	68377472	rs355466	A	G	3	5	8	0	0	8	0	0
4	68380215	rs11250	G	A	62	50	112	0	0	112	0	0
4	68383293	rs28756365	A	T	6	4	10	0	0	10	0	0
4	68384008	rs355510	C	T	49	32	81	0	3	84	0	0
4	68384861	rs355507	G	T	4	6	10	0	0	10	0	0
4	68411185	rs150026106	C	T	9	5	14	0	0	14	0	0
4	68442968	rs11556614	A	G	44	30	74	0	0	74	0	0
4	68455400	rs10050076	G	T	4	2	6	0	0	6	0	0
4	68483491	rs13348	T	G	47	52	99	0	1	100	0	0
4	69178920	rs2293595	T	C	7	28	35	0	0	35	0	0
4	69182335	rs58108365	C	T	19	21	40	0	0	40	0	0
4	69183791	rs17089267	A	G	9	8	17	0	0	17	0	0
4	69193754	rs62316045	C	T	5	6	11	0	0	11	0	0
4	69200559	rs6812178	T	C	0	10	10	0	0	10	0	0
4	69215551	rs36215897	A	T	11	7	18	0	1	19	0	0
4	70047907	rs111258649	G	T	5	4	9	0	0	9	0	0
4	70047914	.	C	T	6	5	11	0	0	11	0	0
4	70057441	rs7662857	A	G	4	3	7	0	0	7	0	0
4	70057718	rs6600907	A	C	6	0	6	0	0	6	0	0
4	70081510	rs6833028	T	C	21	11	32	0	0	32	0	0
4	70081827	rs6847476	G	T	32	5	37	0	0	37	0	0
4	70807771	rs10030475	C	T	5	1	6	0	0	6	0	0
4	71672653	rs1043903	A	G	15	17	32	0	0	32	0	0
4	71888176	rs11544786	C	T	73	73	146	0	1	147	0	0
4	71895288	rs554346593	A	T	43	42	85	0	2	87	0	0
4	74903134	rs370655	T	C	57	64	121	0	6	127	0	0
4	75111440	.	T	C	6	7	13	0	0	13	0	0
4	75111946	rs111914436	T	A	4	3	7	0	0	7	0	0
4	75112071	rs62312512	G	A	4	4	8	0	0	8	0	0
4	75112514	rs144636963	G	A	5	1	6	0	0	6	0	0
4	75113273	rs4371587	C	T	5	6	11	0	0	11	0	0
4	75141686	rs6446985	T	A	5	8	13	0	0	13	0	0
4	75143073	rs6821664	G	A	7	1	8	0	0	8	0	0
4	75144613	rs17232394	A	C	4	3	7	0	0	7	0	0
4	75145414	rs4502653	A	T	3	5	8	0	0	8	0	0
4	75145581	rs6819605	T	C	5	2	7	0	0	7	0	0
4	75145764	rs6814880	A	G	7	0	7	0	0	7	0	0
4	75148370	rs2045616	T	C	5	1	6	0	0	6	0	0
4	75148922	rs6835734	A	G	5	7	12	0	0	12	0	0
4	75153710	rs10023519	A	G	9	12	21	0	0	21	0	0
4	75168175	rs9997322	C	T	5	1	6	0	0	6	0	0
4	75248505	rs78803121	G	T	1290	771	2061	0	14	2075	0	0
4	76404583	rs1046662	T	G	4	10	14	0	0	14	0	0
4	76404759	rs1841932	C	A	15	13	28	0	0	28	0	0
4	76407219	rs1047970	T	C	7	4	11	0	0	11	0	0
4	76454850	rs9041	G	T	4	5	9	0	0	9	0	0
4	76568785	rs17215400	A	C	120	114	234	0	2	236	0	0
4	76569553	rs11556146	A	G	19	29	48	0	1	49	0	0
4	76575549	rs4859402	C	T	1	5	6	0	1	7	0	0
4	76576116	rs9306994	G	A	0	7	7	0	0	7	0	0
4	76577044	rs9306995	G	A	7	1	8	0	0	8	0	0
4	76577937	rs6850797	C	A	3	5	8	0	0	8	0	0
4	76578250	rs6851487	C	A	3	5	8	0	0	8	0	0
4	76581775	rs6531816	A	C	53	47	100	0	1	101	0	0
4	76720885	rs13119659	T	C	30	22	52	0	1	53	0	0
4	76722353	rs324726	G	A	54	27	81	0	0	81	0	0
4	76857064	rs66498356	G	C	6	5	11	0	0	11	0	0
4	76857309	rs4859571	C	T	71	33	104	0	0	104	0	0
4	76857388	rs4859572	C	T	53	16	69	0	0	69	0	0
4	76871183	rs7154	A	G	9	5	14	0	0	14	0	0
4	76878688	rs2242470	G	A	11	18	29	0	1	30	0	0
4	76883698	rs55876513	T	G	1	5	6	0	0	6	0	0
4	77036128	rs4730	G	C	124	134	258	0	2	260	0	0
4	77038445	rs11734758	C	A	5	3	8	0	0	8	0	0
4	77038473	rs11723400	T	C	3	4	7	0	0	7	0	0
4	77038643	rs11944608	C	T	5	5	10	0	0	10	0	0
4	77039352	rs13115827	A	G	14	9	23	0	0	23	0	0
4	77039521	rs4498155	T	C	6	6	12	0	0	12	0	0
4	77040175	rs34067866	A	T	5	10	15	0	0	15	0	0
4	77040424	rs6532203	T	C	11	7	18	0	0	18	0	0
4	77040447	rs9307078	G	A	12	9	21	0	1	22	0	0
4	77040830	rs6532204	T	C	7	8	15	0	1	16	0	0
4	77041534	rs4859616	G	T	7	5	12	0	1	13	0	0
4	77041771	rs34072573	G	A	4	7	11	0	0	11	0	0
4	77041827	rs34019987	G	A	6	3	9	0	0	9	0	0
4	77044258	rs6532208	C	T	5	7	12	0	0	12	0	0
4	77044518	rs13152491	A	G	8	8	16	0	0	16	0	0
4	77044956	rs4538520	T	C	1	5	6	0	0	6	0	0
4	77049012	rs28635901	G	A	2	5	7	0	0	7	0	0
4	77053834	rs61750814	T	C	167	150	317	0	1	318	0	0
4	77054154	rs72655523	G	A	5	2	7	0	0	7	0	0
4	77054174	rs4859620	A	G	3	4	7	0	0	7	0	0
4	77054520	rs4241588	T	G	4	3	7	0	0	7	0	0
4	77056808	rs13135639	G	A	10	7	17	0	0	17	0	0
4	77056904	rs28726273	G	A	9	7	16	0	0	16	0	0
4	77057905	rs4376175	G	T	5	3	8	0	0	8	0	0
4	77061836	rs4337755	A	G	3	3	6	0	0	6	0	0
4	77061958	.	C	G	4	2	6	0	1	7	0	0
4	77063014	rs13110133	T	C	7	1	8	0	0	8	0	0
4	77064226	rs12641564	T	A	0	6	6	0	0	6	0	0
4	77067133	rs735696	C	T	9	10	19	0	0	19	0	0
4	77067434	rs894254	C	T	4	2	6	0	0	6	0	0
4	77068016	rs4288034	C	G	7	7	14	0	0	14	0	0
4	77068434	rs4241590	C	T	2	4	6	0	0	6	0	0
4	77904310	rs11930058	G	A	5	5	10	0	0	10	0	0
4	77909557	rs62302300	C	T	54	42	96	0	1	97	0	0
4	77970562	rs4252942	G	T	3	11	14	0	0	14	0	0
4	77976935	.	C	A	8	6	14	0	0	14	0	0
4	78087306	rs4150094	A	G	53	44	97	0	1	98	0	0
4	78636187	rs2866689	G	A	16	13	29	0	1	30	0	0
4	78636621	rs13105201	A	G	9	11	20	0	0	20	0	0
4	78636654	rs13128914	G	A	16	21	37	0	0	37	0	0
4	78637265	rs2866690	A	G	16	13	29	0	0	29	0	0
4	78638491	rs3205281	T	C	13	11	24	0	0	24	0	0
4	78638730	rs2134048	T	C	5	6	11	0	0	11	0	0
4	78727108	rs6533271	T	A	3	3	6	0	0	6	0	0
4	78732578	rs2008222	G	A	4	2	6	0	0	6	0	0
4	78806415	rs74550505	C	T	140	123	263	0	3	266	0	0
4	79531308	rs4612	C	T	156	180	336	0	0	336	0	0
4	79531553	rs7317	C	A	2	5	7	0	0	7	0	0
4	79602718	rs1134124	G	A	2	5	7	0	0	7	0	0
4	79832706	rs12507099	C	G	17	22	39	0	0	39	0	0
4	80828555	rs61048419	G	A	50	41	91	0	1	92	0	0
4	80887556	rs10033596	G	T	8	7	15	0	1	16	0	0
4	80887969	rs11098964	A	G	2	9	11	0	0	11	0	0
4	80888040	rs11098965	C	T	5	8	13	0	0	13	0	0
4	80894682	rs10001066	A	G	2	7	9	0	0	9	0	0
4	80894706	rs10003491	T	C	2	8	10	0	0	10	0	0
4	80897999	rs10027407	C	G	4	7	11	0	0	11	0	0
4	80898027	rs10027415	C	T	3	5	8	0	1	9	0	0
4	80905740	rs28645467	T	C	3	3	6	0	0	6	0	0
4	80905851	rs28688624	A	C	2	8	10	0	0	10	0	0
4	80905990	rs12647691	C	G	28	37	65	0	0	65	0	0
4	80945652	rs7655817	T	C	4	4	8	0	0	8	0	0
4	80988478	rs11730030	C	T	6	3	9	0	0	9	0	0
4	80988744	rs17509683	G	A	8	3	11	0	0	11	0	0
4	80989630	rs17509725	C	T	23	25	48	0	0	48	0	0
4	80989768	rs4690141	A	G	43	49	92	0	1	93	0	0
4	81104644	rs3822012	T	C	4	7	11	0	0	11	0	0
4	81105223	rs2292849	G	T	2	5	7	0	0	7	0	0
4	83274208	rs7691121	C	G	5	5	10	0	0	10	0	0
4	83274799	rs3944	A	G	15	11	26	0	0	26	0	0
4	83276386	rs34411705	G	A	109	77	186	0	3	189	0	0
4	83278778	rs1820577	T	C	9	10	19	0	2	21	0	0
4	83278947	rs62311637	G	A	5	10	15	0	0	15	0	0
4	83279041	rs6846730	C	T	6	5	11	0	0	11	0	0
4	83279065	rs62313369	T	C	4	5	9	0	0	9	0	0
4	83279071	rs2556538	G	A	5	7	12	0	0	12	0	0
4	83279224	.	A	G	7	9	16	0	1	17	0	0
4	83279393	rs62313370	G	A	10	5	15	0	0	15	0	0
4	83279722	rs35965249	T	C	7	7	14	0	0	14	0	0
4	83280341	.	T	C	9	17	26	0	0	26	0	0
4	83281590	rs13136755	G	C	11	8	19	0	1	20	0	0
4	83282421	rs2258407	G	C	23	14	37	0	0	37	0	0
4	83282432	rs34356015	T	G	16	25	41	0	1	42	0	0
4	83282543	rs28504223	A	T	14	15	29	0	0	29	0	0
4	83283766	rs35103793	C	G	22	15	37	0	0	37	0	0
4	83283819	rs2556544	A	G	22	21	43	0	0	43	0	0
4	83284076	rs3972760	A	G	14	14	28	0	0	28	0	0
4	83284203	rs3972761	A	G	3	9	12	0	0	12	0	0
4	83284205	rs3972763	A	G	3	9	12	0	0	12	0	0
4	83284207	rs3972754	A	G	4	9	13	0	0	13	0	0
4	83284422	rs1135946	T	C	2	5	7	0	0	7	0	0
4	83284498	rs6836837	G	C	3	7	10	0	0	10	0	0
4	83284549	rs1058358	G	C	12	15	27	0	1	28	0	0
4	83284926	rs6839093	C	T	11	11	22	0	0	22	0	0
4	83286473	rs62313374	C	T	4	5	9	0	0	9	0	0
4	83287420	rs34691026	A	G	2	5	7	0	0	7	0	0
4	83288006	rs36048136	G	A	14	7	21	0	0	21	0	0
4	83290282	rs13107849	C	G	3	3	6	0	0	6	0	0
4	83291011	rs13114644	C	G	7	3	10	0	0	10	0	0
4	83291640	rs3828538	A	C	11	7	18	0	0	18	0	0
4	83291836	rs1045147	T	G	6	6	12	0	0	12	0	0
4	83344744	rs9316	T	C	91	62	153	0	2	155	0	0
4	83348898	rs2516818	T	C	4	4	8	0	0	8	0	0
4	83348978	rs6826022	T	C	7	13	20	0	1	21	0	0
4	83350059	rs2859538	C	A	9	16	25	0	0	25	0	0
4	83848742	.	C	T	24	20	44	0	2	46	0	0
4	84364751	rs7665103	A	G	3	4	7	0	0	7	0	0
4	84374480	rs1494961	C	T	31	30	61	0	1	62	0	0
4	84377497	rs2279658	A	G	5	3	8	0	0	8	0	0
4	84380955	rs12505955	G	T	9	5	14	0	0	14	0	0
4	84382552	rs1126971	A	T	41	33	74	0	2	76	0	0
4	84382763	rs11099601	C	T	49	36	85	0	0	85	0	0
4	84383810	rs12642536	C	T	42	53	95	0	2	97	0	0
4	84402043	rs6834006	A	G	5	5	10	0	0	10	0	0
4	84526275	rs1521531	T	C	54	36	90	0	0	90	0	0
4	84526573	rs1052473	A	G	65	51	116	0	1	117	0	0
4	84526767	rs3822008	C	T	62	57	119	0	1	120	0	0
4	86844835	rs6824722	A	G	4	8	12	0	0	12	0	0
4	87857150	rs10034541	T	A	5	4	9	0	0	9	0	0
4	87978626	rs3775229	C	A	5	3	8	0	0	8	0	0
4	88030486	rs3822041	A	G	7	6	13	0	0	13	0	0
4	88053953	rs71607407	C	T	13	2	15	0	0	15	0	0
4	88058340	rs3755979	C	G	68	57	125	0	2	127	0	0
4	88082177	rs4693158	G	A	11	2	13	0	1	14	0	0
4	88082281	rs28668976	C	T	3	12	15	0	0	15	0	0
4	88225233	rs11727374	A	G	6	4	10	0	0	10	0	0
4	88225318	rs13106540	G	T	10	2	12	0	1	13	0	0
4	88225321	rs7663544	T	C	10	3	13	0	0	13	0	0
4	88226231	rs11735092	T	C	2	7	9	0	0	9	0	0
4	88253231	rs34148107	T	C	5	1	6	0	0	6	0	0
4	88957562	rs17786456	T	C	17	11	28	0	0	28	0	0
4	88959922	rs2725220	G	C	7	14	21	0	0	21	0	0
4	88959961	rs2725219	T	C	8	18	26	0	0	26	0	0
4	88959968	rs2725218	G	C	8	18	26	0	1	27	0	0
4	88960258	rs2725217	A	T	6	11	17	0	0	17	0	0
4	88960579	rs2725216	A	G	28	38	66	0	0	66	0	0
4	88973006	rs2728104	T	C	0	6	6	0	0	6	0	0
4	88997102	rs2728121	C	T	25	26	51	0	1	52	0	0
4	88997876	rs2725202	G	A	33	45	78	0	2	80	0	0
4	89183131	rs1129043	T	C	14	4	18	0	0	18	0	0
4	89203042	rs881561	G	A	3	3	6	0	0	6	0	0
4	89577214	rs2972040	A	T	18	21	39	0	1	40	0	0
4	89578140	rs2860513	A	T	12	12	24	0	1	25	0	0
4	89607905	rs3737488	A	G	22	14	36	0	0	36	0	0
4	89618837	rs710834	T	C	0	87	87	0	0	87	0	0
4	89625427	rs1804080	G	C	15	18	33	0	0	33	0	0
4	89628733	rs3775399	T	A	13	20	33	0	0	33	0	0
4	89629066	rs2602117	T	C	19	23	42	0	0	42	0	0
4	89643379	rs2860419	T	C	4	13	17	0	0	17	0	0
4	89644402	.	A	G	7	12	19	0	0	19	0	0
4	89649659	rs9224	A	G	15	17	32	0	0	32	0	0
4	89653257	rs1801915	G	A	7	8	15	0	0	15	0	0
4	89668859	rs7657817	C	T	3	4	7	0	0	7	0	0
4	89670155	rs3756050	C	T	8	5	13	0	0	13	0	0
4	89978281	rs11097210	G	A	8	14	22	0	1	23	0	0
4	90034686	rs17015027	A	G	23	13	36	0	0	36	0	0
4	90163617	rs4396961	G	A	7	5	12	0	0	12	0	0
4	90166159	rs891674	G	A	5	3	8	0	0	8	0	0
4	90166773	rs6532145	T	C	3	4	7	0	0	7	0	0
4	90166778	rs6532146	C	A	3	4	7	0	0	7	0	0
4	90166920	rs6532147	C	T	2	4	6	0	0	6	0	0
4	90166921	rs6532148	A	G	2	4	6	0	0	6	0	0
4	90167506	rs9790623	G	C	3	3	6	0	0	6	0	0
4	90168825	rs7672015	T	C	2	5	7	0	0	7	0	0
4	90168882	rs13115988	G	A	4	4	8	0	0	8	0	0
4	90169925	rs7653897	A	G	6	6	12	0	0	12	0	0
4	90170118	rs28622301	A	G	5	2	7	0	0	7	0	0
4	90646886	rs356165	G	A	5	5	10	0	0	10	0	0
4	90711770	rs2737029	T	C	3	10	13	0	0	13	0	0
4	90757947	rs2583986	T	A	6	7	13	0	0	13	0	0
4	90757948	rs2245804	T	A	4	7	11	0	1	12	0	0
4	91056544	rs13146071	A	T	4	4	8	0	0	8	0	0
4	91702295	rs6532243	T	C	2	5	7	0	0	7	0	0
4	95170839	rs11722476	G	A	16	13	29	0	0	29	0	0
4	95173779	rs7439869	T	C	18	21	39	0	0	39	0	0
4	95186055	rs2306802	A	G	30	26	56	0	0	56	0	0
4	95197520	rs6823404	C	T	10	10	20	0	0	20	0	0
4	95211610	rs8336	T	C	15	20	35	0	0	35	0	0
4	95212185	rs8026	A	G	2	9	11	0	0	11	0	0
4	95219780	rs13132963	A	G	16	14	30	0	0	30	0	0
4	95219857	rs74768086	A	G	23	19	42	0	2	44	0	0
4	95253263	rs2865352	G	A	4	2	6	0	0	6	0	0
4	95261251	rs62320444	C	T	6	3	9	0	0	9	0	0
4	95496882	rs2452600	C	T	8	7	15	0	0	15	0	0
4	95561459	rs7690296	A	G	4	7	11	0	0	11	0	0
4	95586015	rs1056773	T	C	5	2	7	0	1	8	0	0
4	95587587	rs1048627	T	C	2	5	7	0	0	7	0	0
4	95588075	rs3943	G	A	5	7	12	0	0	12	0	0
4	95588565	rs1139697	T	G	5	4	9	0	0	9	0	0
4	99245680	rs190444989	G	T	5	5	10	0	0	10	0	0
4	99793239	rs7696573	A	G	4	2	6	0	0	6	0	0
4	99793264	rs7697071	G	A	4	2	6	0	0	6	0	0
4	99800174	rs4699688	G	C	4	3	7	0	0	7	0	0
4	99801433	rs17008789	A	G	5	3	8	0	0	8	0	0
4	99806626	rs1992569	T	C	7	1	8	0	0	8	0	0
4	99808254	rs62323192	G	A	231	213	444	0	0	444	0	0
4	99816227	rs10004975	C	G	5	8	13	0	0	13	0	0
4	99816349	rs34164768	G	A	41	36	77	0	0	77	0	0
4	99846944	rs114057100	T	C	6	9	15	0	0	15	0	0
4	99988659	rs1230154	C	T	8	3	11	0	0	11	0	0
4	99988713	rs17595186	G	A	10	6	16	0	0	16	0	0
4	99993075	rs13832	C	A	23	20	43	0	3	46	0	0
4	99994455	rs13127586	G	A	2	5	7	0	1	8	0	0
4	99996373	rs1154416	G	T	3	11	14	0	0	14	0	0
4	100738035	rs715239	G	T	5	4	9	0	0	9	0	0
4	100757048	rs3733463	G	A	1	6	7	0	0	7	0	0
4	100757425	rs7686565	C	A	2	6	8	0	0	8	0	0
4	100784980	rs3737484	C	T	8	6	14	0	0	14	0	0
4	100790328	rs6532834	G	A	9	9	18	0	0	18	0	0
4	100799961	rs11944405	T	C	4	3	7	0	0	7	0	0
4	100818358	.	A	T	19	5	24	0	1	25	0	0
4	100820850	rs1044044	C	T	17	13	30	0	1	31	0	0
4	100823058	rs11931053	G	A	5	9	14	0	0	14	0	0
4	100870182	rs61203457	T	C	24	29	53	0	0	53	0	0
4	100870375	rs2276939	T	G	19	23	42	0	0	42	0	0
4	100871152	rs73832925	C	T	11	8	19	0	0	19	0	0
4	101107292	rs2903209	A	T	23	35	58	0	0	58	0	0
4	101107802	rs17029766	T	C	26	16	42	0	0	42	0	0
4	101107808	rs28489286	C	T	26	19	45	0	1	46	0	0
4	101108332	rs10007201	C	T	19	36	55	0	0	55	0	0
4	101108453	rs17029777	C	G	13	17	30	0	0	31	1	0
4	102232629	rs2850368	T	C	3	5	8	0	0	8	0	0
4	102264575	rs2850326	T	C	6	3	9	0	0	9	0	0
4	102266985	.	A	G	6	3	9	0	0	9	0	0
4	102267157	.	C	A	4	2	6	0	1	7	0	0
4	102946392	rs17853030	G	A	8	5	13	0	0	13	0	0
4	102965043	rs3113676	T	C	15	6	21	0	0	21	0	0
4	102995239	rs12640056	C	T	10	4	14	0	0	14	0	0
4	102995263	rs6842661	G	A	11	8	19	0	0	19	0	0
4	103183510	rs151390	C	T	121	98	219	0	2	221	0	0
4	103186131	.	A	C	2	6	8	0	0	8	0	0
4	103222188	rs233820	G	C	5	4	9	0	0	9	0	0
4	103227073	rs6829701	G	A	14	13	27	0	0	27	0	0
4	103480450	rs230506	A	G	4	2	6	0	0	6	0	0
4	103514658	rs1609993	T	C	79	69	148	0	4	152	0	0
4	103519397	rs4648075	G	A	4	2	6	0	0	6	0	0
4	103536261	rs230547	C	T	7	10	17	0	0	17	0	0
4	103623564	rs141190853	C	T	2	6	8	0	0	8	0	0
4	103726568	rs13128934	C	T	3	3	6	0	0	6	0	0
4	103729474	rs62329082	A	G	4	2	6	0	1	7	0	0
4	103983974	rs7675837	A	G	4	2	6	0	0	6	0	0
4	103984111	rs77956767	A	G	4	12	16	0	0	16	0	0
4	104007105	rs6825519	T	C	8	6	14	0	0	14	0	0
4	104013796	rs1054707	T	C	31	39	70	0	1	71	0	0
4	104059542	rs2243682	G	A	8	3	11	0	0	11	0	0
4	104061993	rs1381657	C	G	5	3	8	0	0	8	0	0
4	104062223	rs1381658	C	T	2	4	6	0	0	6	0	0
4	104291442	.	T	G	16	0	16	0	15	31	0	0
4	106359580	rs17258325	T	A	6	2	8	0	0	8	0	0
4	106604364	rs34072732	A	G	84	77	161	0	0	161	0	0
4	106629246	rs28391170	A	C	4	4	8	0	0	8	0	0
4	106646182	rs78593046	G	T	3	5	8	0	0	8	0	0
4	106967430	rs14733	T	A	12	9	21	0	0	21	0	0
4	107083274	rs28848568	C	A	10	11	21	0	0	21	0	0
4	107083779	rs10027207	T	C	5	5	10	0	0	10	0	0
4	107236833	rs11544776	C	T	6	2	8	0	0	8	0	0
4	107239130	rs3113249	G	T	7	4	11	0	0	11	0	0
4	107242218	rs143098221	A	G	9	18	27	0	1	28	0	0
4	107242316	rs527799242	G	T	11	14	25	0	0	25	0	0
4	107270027	rs13534	G	A	28	27	55	0	0	55	0	0
4	108536353	rs10006012	C	G	11	2	13	0	0	13	0	0
4	108537766	rs2672487	A	G	5	3	8	0	0	8	0	0
4	108539017	rs17495025	C	T	3	3	6	0	0	6	0	0
4	108539764	rs28411252	C	G	6	5	11	0	0	11	0	0
4	108581993	rs970919	T	C	4	2	6	0	0	6	0	0
4	108584371	rs3805343	C	T	3	3	6	0	0	6	0	0
4	108641317	rs1127006	G	A	55	38	93	0	1	94	0	0
4	108832727	rs17564275	T	C	4	2	6	0	0	6	0	0
4	108853592	rs62311379	A	G	5	9	14	0	0	14	0	0
4	109544798	rs11941983	A	G	7	4	11	0	0	11	0	0
4	110524474	rs197210	G	A	9	10	19	0	0	19	0	0
4	110524748	rs147305704	G	T	4	7	11	0	1	12	0	0
4	110524985	rs188948959	A	G	7	4	11	0	0	11	0	0
4	110525064	rs201350750	G	A	8	3	11	0	0	11	0	0
4	110525466	.	C	T	10	1	11	0	0	11	0	0
4	110581363	rs4698744	T	A	22	17	39	0	0	39	0	0
4	110603784	rs3733611	T	C	34	31	65	0	0	65	0	0
4	110610086	rs1042891	A	G	36	40	76	0	3	79	0	0
4	110610201	rs5030600	G	A	37	36	73	0	0	73	0	0
4	110631850	rs117204630	G	A	5	4	9	0	0	9	0	0
4	110632051	rs117518506	G	A	4	3	7	0	0	7	0	0
4	110737389	rs2276326	T	C	18	17	35	0	1	36	0	0
4	110745854	rs10365	C	G	24	23	47	0	2	49	0	0
4	110967310	rs9030	A	G	7	7	14	0	0	14	0	0
4	113197769	rs28555653	T	C	13	8	21	0	0	21	0	0
4	113353620	.	C	T	9	3	12	0	0	12	0	0
4	113510585	rs10031880	G	C	4	2	6	0	0	6	0	0
4	113578609	rs1129065	C	T	19	11	30	0	2	32	0	0
4	119532230	.	A	G	3	5	8	0	0	8	0	0
4	119539882	.	G	T	7	0	7	0	0	7	0	0
4	120136135	rs10033031	G	A	6	2	8	0	0	8	0	0
4	120138824	rs1134065	A	G	27	19	46	0	1	47	0	0
4	120140582	rs11943184	A	G	3	4	7	0	0	7	0	0
4	120142219	rs144895623	T	C	1	7	8	0	0	8	0	0
4	120143858	rs62328360	G	A	5	16	21	0	0	21	0	0
4	120181724	rs35372126	A	G	2	4	6	0	0	6	0	0
4	120214030	rs3749591	T	G	10	14	24	0	0	24	0	0
4	120215314	rs1052633	A	G	12	7	19	0	0	19	0	0
4	120219239	rs11098500	T	A	44	38	82	0	1	83	0	0
4	120219534	rs17642800	T	C	55	56	111	0	2	113	0	0
4	120330539	rs140750089	G	A	2	7	9	0	0	9	0	0
4	120371252	rs71614438	G	A	2	8	10	0	0	10	0	0
4	120376030	rs28408407	C	G	9	2	11	0	0	11	0	0
4	120376115	rs28441656	C	G	10	1	11	0	0	11	0	0
4	120381341	rs2892848	C	T	17	8	25	0	1	26	0	0
4	120381974	rs7356491	C	T	21	5	26	0	1	27	0	0
4	120382901	.	T	G	25	4	29	0	0	29	0	0
4	120401779	rs10518328	G	A	6	1	7	0	0	7	0	0
4	120401835	rs10518329	A	G	6	2	8	0	0	8	0	0
4	120409963	rs13145352	T	C	2	4	6	0	0	6	0	0
4	120415676	rs1045177	G	A	29	38	67	0	1	68	0	0
4	120421211	rs7687843	C	T	5	4	9	0	0	9	0	0
4	120422852	rs10031665	T	C	5	2	7	0	0	7	0	0
4	120422949	.	C	T	3	10	13	0	0	13	0	0
4	120424172	rs12502423	A	C	2	4	6	0	0	6	0	0
4	120425224	rs2127827	A	G	0	7	7	0	0	7	0	0
4	120425246	rs4834779	G	A	7	0	7	0	1	8	0	0
4	120981214	rs2908990	T	C	29	40	69	0	0	69	0	0
4	122735868	rs6815050	C	T	4	5	9	0	0	9	0	0
4	122737278	rs3217780	T	C	14	19	33	0	1	34	0	0
4	122744942	rs769238	G	A	9	7	16	0	1	17	0	0
4	124319055	rs13150612	C	T	4	8	12	0	1	13	0	0
4	124319144	rs300569	C	T	22	16	38	0	0	38	0	0
4	124319168	.	C	G	18	27	45	0	0	45	0	0
4	124320322	rs9992811	A	G	6	1	7	0	0	7	0	0
4	124320340	rs28514996	C	T	4	3	7	0	0	7	0	0
4	124320359	rs28477228	C	T	4	3	7	0	0	7	0	0
4	124322594	rs159762	G	A	10	6	16	0	0	16	0	0
4	124323783	rs300575	G	C	140	104	244	0	6	251	1	0
4	124851510	rs6838706	G	A	3	3	6	0	0	6	0	0
4	125592065	rs10018651	C	A	2	6	8	0	0	8	0	0
4	125592440	rs3733472	T	C	5	9	14	0	0	14	0	0
4	128807219	rs3811740	T	A	61	57	118	0	3	121	0	0
4	128814541	.	G	A	46	37	83	0	0	83	0	0
4	128814964	rs17012739	G	T	59	45	104	0	2	106	0	0
4	128884610	rs2087446	A	C	12	3	15	0	0	15	0	0
4	128960569	rs11098945	C	T	2	4	6	0	0	6	0	0
4	128995640	rs7696130	G	A	36	36	72	0	2	74	0	0
4	129012181	rs2306054	G	A	56	58	114	0	0	114	0	0
4	129012638	rs1064205	A	G	60	53	113	0	0	113	0	0
4	129043204	rs12508837	C	G	11	16	27	0	0	27	0	0
4	129043286	rs3733320	C	T	10	9	19	0	0	19	0	0
4	129043809	rs12509092	G	A	3	5	8	0	0	8	0	0
4	129100643	rs12645577	G	A	9	12	21	0	0	21	0	0
4	129190480	rs4016	T	A	4	3	7	0	0	7	0	0
4	129785512	rs13114904	G	A	5	11	16	0	0	16	0	0
4	129793559	rs11933240	A	G	39	25	64	0	0	64	0	0
4	139086246	rs35108180	A	G	9	7	16	0	0	16	0	0
4	139937071	rs3749515	C	T	9	17	26	0	0	26	0	0
4	139967564	rs28480361	G	A	36	44	80	0	0	80	0	0
4	139967824	rs62320528	C	T	106	61	167	0	1	168	0	0
4	139967950	rs75480891	C	T	108	91	199	0	1	200	0	0
4	139984764	rs12503968	A	G	5	1	6	0	0	6	0	0
4	139995689	rs62320530	G	C	4	3	7	0	0	7	0	0
4	140036029	rs1984682	G	A	19	3	22	0	1	23	0	0
4	140053879	rs4863493	C	T	24	10	34	0	1	35	0	0
4	140053960	rs10857271	A	C	2	8	10	0	0	10	0	0
4	140080781	.	C	A	5	3	8	0	0	8	0	0
4	140310520	rs3828506	T	C	13	16	29	0	0	29	0	0
4	140369100	rs6827042	T	C	4	6	10	0	0	10	0	0
4	140373051	rs11735776	A	G	11	7	18	0	0	18	0	0
4	140587125	rs2132845	A	T	72	70	142	0	2	144	0	0
4	140619088	rs8192110	C	T	22	1	23	0	3	26	0	0
4	140638963	rs345983	C	T	14	25	39	0	0	39	0	0
4	140639754	rs1054491	G	C	16	16	32	0	0	32	0	0
4	140640283	rs10519504	G	T	15	10	25	0	0	25	0	0
4	140640703	rs61747885	G	T	15	12	27	0	0	27	0	0
4	140810637	rs11100342	C	T	9	7	16	0	0	16	0	0
4	140811135	rs3733382	T	C	7	5	12	0	0	12	0	0
4	141310337	.	C	G	16	15	31	0	0	31	0	0
4	142143338	.	G	A	4	2	6	0	0	6	0	0
4	142146618	rs3775595	T	C	3	6	9	0	0	9	0	0
4	142155214	rs3822128	T	C	151	139	290	0	6	296	0	0
4	142944773	rs336363	A	G	13	10	23	0	0	23	0	0
4	142945101	rs336362	T	C	2	4	6	0	0	6	0	0
4	142945131	rs1039937	T	A	7	3	10	0	0	10	0	0
4	142947196	rs336360	G	A	3	6	9	0	0	9	0	0
4	142947546	rs11100741	C	G	8	3	11	0	1	12	0	0
4	142947611	rs336359	A	G	3	3	6	0	0	6	0	0
4	142947711	rs336358	C	T	3	4	7	0	0	7	0	0
4	142947722	rs336357	C	T	3	5	8	0	0	8	0	0
4	143043340	rs2270658	A	G	42	25	67	0	1	68	0	0
4	143324094	rs1982966	G	A	29	20	49	0	1	50	0	0
4	143562086	rs7685002	A	G	4	4	8	0	0	8	0	0
4	143563501	rs7434560	T	C	14	14	28	0	0	28	0	0
4	143563921	rs7434705	T	C	3	5	8	0	0	8	0	0
4	143569058	rs745719	G	A	2	4	6	0	0	6	0	0
4	143575740	rs13125853	A	G	5	3	8	0	0	8	0	0
4	144132622	rs11100781	A	G	4	4	8	0	0	8	0	0
4	144135718	rs4285045	G	A	128	107	235	0	1	236	0	0
4	144136405	rs10001113	T	C	39	13	52	0	0	52	0	0
4	144143340	rs7673827	T	G	24	21	45	0	0	45	0	0
4	144143578	rs4131029	C	T	18	22	40	0	1	41	0	0
4	144144667	rs6856785	C	A	18	23	41	0	0	41	0	0
4	144316247	rs13123498	C	T	43	39	82	0	0	82	0	0
4	144316627	rs11100788	G	A	18	19	37	0	1	38	0	0
4	144316760	rs3828512	A	G	21	30	51	0	0	51	0	0
4	144442735	rs11541117	C	T	106	119	225	0	4	229	0	0
4	144460419	rs4690793	G	C	11	16	27	0	1	28	0	0
4	144461871	rs7688293	C	T	31	20	51	0	0	51	0	0
4	144467444	rs2270677	G	A	5	5	10	0	0	10	0	0
4	144469383	rs2088415	A	G	5	1	6	0	0	6	0	0
4	144471402	rs1979776	T	G	4	2	6	0	0	6	0	0
4	144471460	rs6810805	T	C	5	3	8	0	0	8	0	0
4	144472873	rs4834996	T	C	6	7	13	0	0	13	0	0
4	144474067	rs1874675	A	G	4	3	7	0	0	7	0	0
4	144474666	rs1391191	A	C	36	34	70	0	5	75	0	0
4	144474849	rs1044156	A	G	137	151	288	0	1	289	0	0
4	144476149	rs11100791	A	G	3	3	6	0	0	6	0	0
4	144833153	rs74590858	C	G	8	0	8	0	0	8	0	0
4	144833154	rs78713560	T	G	8	0	8	0	0	8	0	0
4	145564545	rs11730787	G	A	23	13	36	0	1	37	0	0
4	145566864	rs13106087	T	C	6	1	7	0	0	7	0	0
4	146055117	rs11545157	T	C	80	55	135	0	1	136	0	0
4	146436544	rs144791880	T	C	3	6	9	0	0	9	0	0
4	146572227	rs11721553	G	A	11	6	17	0	0	17	0	0
4	147099181	rs28420466	A	G	4	2	6	0	0	6	0	0
4	147110891	rs7745	A	G	28	44	72	0	0	72	0	0
4	147111241	rs3756081	C	G	3	3	6	0	0	6	0	0
4	147176097	rs7435720	A	G	7	7	14	0	0	14	0	0
4	147176571	rs2291379	C	A	7	5	12	0	0	12	0	0
4	147177341	rs1057560	G	A	5	12	17	0	0	17	0	0
4	147788709	rs10013280	C	T	3	5	8	0	0	8	0	0
4	147824864	rs17610219	G	A	8	6	14	0	0	14	0	0
4	148553461	rs13119467	A	G	2	4	6	0	0	6	0	0
4	148554421	rs2654937	T	C	5	4	9	0	0	9	0	0
4	148555860	rs17023581	G	A	20	7	27	0	0	27	0	0
4	148555947	rs28676674	G	A	9	7	16	0	0	16	0	0
4	148557553	rs2718448	G	A	7	14	21	0	0	21	0	0
4	148557832	rs79714615	T	C	6	12	18	0	0	18	0	0
4	148559403	rs74588992	G	A	2	4	6	0	0	6	0	0
4	148593605	rs2036498	G	C	4	6	10	0	0	10	0	0
4	151185651	rs11059	A	C	3	12	15	0	0	15	0	0
4	151199080	rs2290846	G	A	83	63	146	0	0	146	0	0
4	151207127	rs3749574	C	T	72	69	141	0	0	141	0	0
4	151247236	rs1507191	C	T	20	9	29	0	0	29	0	0
4	151247294	rs2292207	C	A	7	12	19	0	0	19	0	0
4	151247410	rs2292206	T	C	1	7	8	0	0	8	0	0
4	151247469	rs1507190	G	C	4	6	10	0	0	10	0	0
4	151252297	rs17588629	G	A	4	3	7	0	0	7	0	0
4	151357949	.	T	A	48	32	80	0	1	81	0	0
4	151880765	rs9992474	A	G	6	3	9	0	0	9	0	0
4	152020777	rs2280283	C	T	8	14	22	0	0	22	0	0
4	152024326	rs4696658	T	G	75	64	139	0	0	139	0	0
4	152025969	rs7656771	T	C	6	4	10	0	0	10	0	0
4	152030462	rs7675597	A	C	7	2	9	0	0	9	0	0
4	152047365	rs28593016	C	T	4	5	9	0	0	9	0	0
4	152048304	rs13122245	C	T	6	2	8	0	0	8	0	0
4	152061201	rs2280280	T	C	106	158	264	0	2	266	0	0
4	152062317	rs75298151	A	G	14	8	22	0	0	22	0	0
4	152065197	rs3736502	C	T	11	15	26	0	3	29	0	0
4	152095109	rs11734577	G	A	1	6	7	0	0	7	0	0
4	152592305	.	G	A	34	29	63	0	0	63	0	0
4	153399691	rs76418725	T	C	6	4	10	0	0	10	0	0
4	153458889	rs78527666	G	A	5	5	10	0	0	10	0	0
4	153565838	rs3935569	C	T	3	6	9	0	0	9	0	0
4	153696635	rs6850467	C	T	8	0	8	0	0	8	0	0
4	153701130	rs4619875	C	T	5	8	13	0	4	17	0	0
4	153898601	rs79116244	T	C	4	4	8	0	0	8	0	0
4	153899573	rs1059354	A	C	6	4	10	0	0	10	0	0
4	153899658	rs1059355	C	T	8	5	13	0	1	14	0	0
4	154549663	rs6535932	T	C	3	7	10	0	0	10	0	0
4	154624656	rs3804099	T	C	21	13	34	0	0	34	0	0
4	154631563	rs1339	T	C	5	9	14	0	0	14	0	0
4	156617994	rs2306557	G	A	58	68	126	0	0	126	0	0
4	156652495	rs1053915	A	G	3	9	12	0	0	12	0	0
4	156652866	rs1483027	G	A	4	3	7	0	0	7	0	0
4	156655782	rs2242297	A	G	2	5	7	0	0	7	0	0
4	156728367	rs7638	A	C	6	8	14	0	0	14	0	0
4	159175039	rs41494044	T	C	3	3	6	0	0	6	0	0
4	159175475	rs17037309	C	T	4	3	7	0	0	7	0	0
4	159175600	.	T	G	2	5	7	0	0	7	0	0
4	159176039	rs17037314	C	T	9	22	31	0	0	31	0	0
4	159176109	rs1047725	C	A	10	15	25	0	0	25	0	0
4	159588731	rs3210749	A	C	10	5	15	0	0	15	0	0
4	160277276	rs1135004	C	T	26	23	49	0	2	51	0	0
4	164085425	rs4691896	T	C	26	16	42	0	1	43	0	0
4	164087954	rs936562	A	T	19	18	37	0	1	38	0	0
4	164415734	rs2276979	A	G	1	5	6	0	0	6	0	0
4	164415792	rs2276978	G	A	5	5	10	0	0	10	0	0
4	164415930	rs2276977	C	T	33	44	77	0	1	78	0	0
4	165997375	rs57550388	T	G	7	2	9	0	0	9	0	0
4	165998104	rs35654372	C	G	5	3	8	0	0	8	0	0
4	166000263	rs59386121	C	T	13	18	31	0	0	31	0	0
4	166231868	rs28678193	A	G	24	14	38	0	0	38	0	0
4	166241366	rs10015240	A	G	4	3	7	0	0	7	0	0
4	166242005	rs72701618	G	A	5	1	6	0	0	6	0	0
4	166258433	rs2322292	T	C	1	5	6	0	0	6	0	0
4	166264119	rs8733	A	G	17	12	29	0	0	29	0	0
4	169282355	rs2684348	T	C	3	5	8	0	0	8	0	0
4	169348435	rs2712120	T	C	7	11	18	0	0	18	0	0
4	169362557	rs13151700	C	G	18	10	28	0	0	28	0	0
4	169369853	rs2712114	A	T	12	4	16	0	0	16	0	0
4	169369920	rs12507582	C	T	7	2	9	0	1	10	0	0
4	170015937	rs2245118	A	T	4	5	9	0	0	9	0	0
4	170077789	rs10518039	A	G	10	14	24	0	0	24	0	0
4	170150273	rs6553423	C	T	12	2	14	0	0	14	0	0
4	170428901	rs33933790	C	T	1	8	9	0	1	10	0	0
4	170482883	rs56064008	A	G	4	5	9	0	0	9	0	0
4	170911305	rs4692779	T	C	2	6	8	0	0	8	0	0
4	170912278	rs7661337	G	A	4	2	6	0	0	6	0	0
4	174089048	rs1054497	T	A	6	11	17	0	1	18	0	0
4	174089080	rs1054496	T	C	7	13	20	0	0	20	0	0
4	174089238	rs6835098	T	C	6	6	12	0	0	12	0	0
4	174089426	rs4695826	T	G	3	4	7	0	0	7	0	0
4	174090004	rs3733477	G	A	26	23	49	0	4	53	0	0
4	174156538	rs12639929	A	G	5	2	7	0	0	7	0	0
4	174158132	rs13112928	A	G	4	6	10	0	0	10	0	0
4	174158175	.	A	G	2	9	11	0	0	11	0	0
4	174159788	rs13111572	G	A	4	2	6	0	1	7	0	0
4	174225537	rs72694206	G	A	7	5	12	0	0	12	0	0
4	175178914	rs1396193	T	C	4	2	6	0	0	6	0	0
4	175225452	rs4695918	G	A	2	4	6	0	0	6	0	0
4	175239278	rs11940726	G	C	6	2	8	0	0	8	0	0
4	175239318	rs11940758	G	A	7	2	9	0	1	10	0	0
4	175239372	rs7684619	G	A	2	7	9	0	0	9	0	0
4	175239997	rs113877410	A	G	6	2	8	0	0	8	0	0
4	175241128	rs10565	A	T	10	8	18	0	0	18	0	0
4	177242959	rs4690686	C	T	29	39	68	0	0	68	0	0
4	177248622	rs2278904	C	G	0	6	6	0	0	6	0	0
4	177249533	rs2278903	A	G	58	64	122	0	4	126	0	0
4	177249681	rs12643094	A	G	60	92	152	0	2	154	0	0
4	177249756	rs3733371	A	G	53	58	111	0	0	111	0	0
4	177251169	.	T	A	154	139	293	0	1	294	0	0
4	177253006	rs71613791	T	C	229	202	431	0	1	432	0	0
4	178360811	rs76491548	G	T	50	36	86	0	2	88	0	0
4	183838025	rs13114262	A	G	18	16	34	0	0	34	0	0
4	183838103	rs4371655	C	T	22	25	47	0	1	48	0	0
4	184600571	rs62357990	C	A	7	3	10	0	0	10	0	0
4	184600601	rs4241779	A	G	8	3	11	0	0	11	0	0
4	184614232	.	C	G	20	16	36	0	0	36	0	0
4	185398115	rs1059492	C	A	2	4	6	0	0	6	0	0
4	185398244	rs1059493	C	T	1	5	6	0	0	6	0	0
4	185548951	rs1049253	A	G	26	27	53	0	0	53	0	0
4	185549130	rs6948	G	T	82	54	136	0	2	138	0	0
4	185552135	rs4647688	C	T	7	6	13	0	1	14	0	0
4	185569730	rs4647603	C	T	8	3	11	0	0	11	0	0
4	185570553	rs113420705	T	C	15	13	28	0	0	28	0	0
4	185599489	rs34985821	G	A	4	8	12	0	0	12	0	0
4	185606615	.	T	C	14	10	24	0	0	24	0	0
4	185615532	rs6825561	A	T	85	67	152	0	0	152	0	0
4	185615764	rs14969	C	A	71	44	115	0	0	115	0	0
4	185615768	rs3184982	T	G	63	42	105	0	1	107	1	0
4	185616167	rs6826883	A	C	23	26	49	0	1	50	0	0
4	185616631	rs1527870	T	C	9	29	38	0	0	38	0	0
4	185616814	rs6810600	T	C	7	24	31	0	1	32	0	0
4	185616859	rs6810635	T	C	12	33	45	0	0	45	0	0
4	185617525	rs7681824	A	G	3	5	8	0	0	8	0	0
4	185617529	rs7660064	T	C	4	5	9	0	0	9	0	0
4	185618373	rs7683615	C	T	4	4	8	0	0	8	0	0
4	185619281	rs10000507	C	T	16	8	24	0	0	24	0	0
4	185619282	rs10022818	A	G	16	8	24	0	0	24	0	0
4	185619567	rs67798981	A	T	7	7	14	0	1	15	0	0
4	185619665	rs10002919	C	T	11	7	18	0	1	19	0	0
4	185619967	rs2310104	A	G	3	5	8	0	0	8	0	0
4	185620401	rs13132523	G	A	6	2	8	0	0	8	0	0
4	185620623	rs6552801	G	A	2	6	8	0	0	8	0	0
4	185620751	rs6552802	C	G	4	2	6	0	0	6	0	0
4	185621026	rs2016381	G	A	6	3	9	0	0	9	0	0
4	185621249	rs877276	C	T	4	7	11	0	0	11	0	0
4	185621454	rs79884757	A	G	3	6	9	0	0	9	0	0
4	185621692	rs28444118	T	C	7	9	16	0	0	16	0	0
4	185622046	rs11728389	C	T	7	5	12	0	0	12	0	0
4	185622327	rs7674952	A	C	2	4	6	0	0	6	0	0
4	185622402	rs41278579	A	G	4	2	6	0	0	6	0	0
4	185622509	rs7658186	T	C	9	2	11	0	0	11	0	0
4	185622959	rs4256263	C	A	4	4	8	0	0	8	0	0
4	185623788	rs67380800	T	C	8	1	9	0	0	9	0	0
4	185623845	rs67641203	A	C	7	0	7	0	0	7	0	0
4	185623917	rs66462315	C	T	8	0	8	0	0	8	0	0
4	185623963	rs72703549	T	C	6	0	6	0	0	6	0	0
4	185623973	rs59712748	C	T	6	0	6	0	0	6	0	0
4	185624047	rs4371656	G	T	7	1	8	0	0	8	0	0
4	185624129	rs4615214	G	C	7	2	9	0	0	9	0	0
4	185634144	rs4616798	T	C	354	166	520	0	2	522	0	0
4	185636568	rs2003994	G	T	4	4	8	0	0	8	0	0
4	185636649	rs2003992	T	C	2	5	7	0	0	7	0	0
4	185636702	rs2003993	C	G	4	3	7	0	0	7	0	0
4	185637699	rs6552804	A	G	332	156	488	0	1	490	1	0
4	185650154	rs6818447	G	A	215	114	329	0	2	331	0	0
4	185655192	rs876839	G	C	101	56	157	0	0	157	0	0
4	185677363	rs1056896	T	C	262	213	475	0	5	480	0	0
4	185678110	rs2292899	A	G	211	285	496	0	5	501	0	0
4	185680563	rs4577621	A	G	10	6	16	0	0	16	0	0
4	185683945	rs55830512	G	A	20	25	45	0	0	45	0	0
4	185684247	rs41278583	T	C	16	13	29	0	0	29	0	0
4	185685607	rs3792316	A	G	4	4	8	0	0	8	0	0
4	185687373	rs3749232	A	C	12	10	22	0	0	22	0	0
4	185689952	rs72695628	G	A	24	18	42	0	0	42	0	0
4	185689987	rs10002538	G	A	15	18	33	0	0	33	0	0
4	185690331	rs72695629	C	T	12	9	21	0	0	21	0	0
4	185690601	rs4862417	A	G	20	17	37	0	0	37	0	0
4	185693954	rs28454355	G	A	10	6	16	0	0	16	0	0
4	185694776	rs55664922	A	G	2	5	7	0	0	7	0	0
4	185695263	rs3792312	T	C	5	10	15	0	1	16	0	0
4	185696691	rs72695636	C	T	20	6	26	0	1	27	0	0
4	185696733	rs60241287	G	A	17	5	22	0	1	23	0	0
4	185704176	rs2046814	G	T	8	9	17	0	0	17	0	0
4	185704199	rs879779	G	A	10	10	20	0	0	20	0	0
4	185704806	rs1532126	G	A	4	4	8	0	0	8	0	0
4	185723711	rs13105565	C	T	11	10	21	0	0	21	0	0
4	185725416	rs6552828	A	G	3	6	9	0	0	9	0	0
4	185725496	rs6855716	A	G	6	3	9	0	0	9	0	0
4	185731442	rs13120078	G	A	5	4	9	0	0	9	0	0
4	185731583	rs35340636	C	T	4	2	6	0	0	6	0	0
4	185731940	rs13126272	G	T	4	3	7	0	0	7	0	0
4	187122319	rs3736455	T	G	4	2	6	0	0	6	0	0
4	187122355	rs3736456	T	C	2	4	6	0	0	6	0	0
4	187133031	rs1053094	A	T	1	6	7	0	0	7	0	0
5	205360	rs10059907	G	C	12	21	33	0	0	33	0	0
5	205565	rs10060089	G	A	10	23	33	0	1	34	0	0
5	214127	rs2099084	T	C	8	3	11	0	0	11	0	0
5	215349	rs7726582	C	G	10	6	16	0	0	16	0	0
5	224633	rs1139424	A	G	157	141	298	0	2	300	0	0
5	224692	rs7705721	G	T	11	4	15	0	0	15	0	0
5	225267	rs6885693	C	A	7	5	12	0	0	12	0	0
5	226160	rs6555055	A	C	107	126	233	0	5	238	0	0
5	228362	rs2115272	T	C	150	145	295	0	1	296	0	0
5	231111	rs1126417	T	C	149	161	310	0	0	310	0	0
5	233734	rs1041949	C	G	170	198	368	0	3	371	0	0
5	233889	rs6874921	T	C	4	5	9	0	0	9	0	0
5	235548	rs10060259	T	C	1	6	7	0	0	7	0	0
5	235608	rs10058428	A	G	0	6	6	0	0	6	0	0
5	236142	rs6873678	C	T	4	3	7	0	0	7	0	0
5	236144	rs6873679	C	T	4	3	7	0	1	8	0	0
5	236288	rs6878030	C	T	2	5	7	0	0	7	0	0
5	236405	rs6878237	C	G	5	10	15	0	0	15	0	0
5	240750	rs10037861	A	C	3	6	9	0	0	9	0	0
5	240859	rs28418643	A	G	5	8	13	0	0	13	0	0
5	240887	rs28474882	T	C	4	7	11	0	0	11	0	0
5	241028	rs28731093	T	C	4	3	7	0	0	7	0	0
5	241029	rs28710899	G	A	4	3	7	0	0	7	0	0
5	241100	rs10060016	T	C	2	9	11	0	0	11	0	0
5	241231	rs10060080	T	C	3	12	15	0	0	15	0	0
5	241375	.	T	C	7	12	19	0	0	19	0	0
5	241461	rs10050916	G	A	6	13	19	0	0	19	0	0
5	241467	rs10056853	C	T	4	14	18	0	0	19	1	0
5	241522	rs10061759	T	C	6	15	21	0	1	22	0	0
5	241644	rs10051065	G	A	5	17	22	0	0	22	0	0
5	242040	rs10060206	A	G	3	22	25	0	1	26	0	0
5	242135	rs10057299	C	T	5	22	27	0	0	27	0	0
5	242178	rs10057346	C	T	6	21	27	0	1	28	0	0
5	242211	rs13357299	T	C	5	25	30	0	0	30	0	0
5	242263	rs13354585	G	C	7	22	29	0	0	29	0	0
5	242395	rs13356367	C	T	8	25	33	0	0	33	0	0
5	242505	rs13356383	C	T	7	25	32	0	0	32	0	0
5	242514	rs13356384	C	A	7	25	32	0	0	32	0	0
5	242640	rs10062085	A	G	2	8	10	0	0	10	0	0
5	248356	rs13356800	C	T	4	4	8	0	0	8	0	0
5	248500	rs9716070	G	A	1	5	6	0	0	6	0	0
5	250412	rs7721435	G	A	3	3	6	0	0	6	0	0
5	251469	rs1139449	G	A	198	139	337	0	0	337	0	0
5	251541	rs13070	A	G	193	167	360	0	3	363	0	0
5	254599	.	A	T	239	168	407	0	17	425	1	0
5	254996	rs10078265	T	C	2	4	6	0	0	6	0	0
5	256472	rs6961	G	A	261	218	479	0	7	486	0	0
5	256509	rs6962	G	A	254	218	472	0	1	473	0	0
5	270273	rs56127718	G	T	3	5	8	0	0	8	0	0
5	274081	rs28736753	G	A	3	3	6	0	0	6	0	0
5	274105	rs28575233	G	A	4	3	7	0	0	7	0	0
5	274110	rs28654906	T	G	4	3	7	0	0	7	0	0
5	275101	rs28581737	A	G	4	3	7	0	0	7	0	0
5	275288	rs10065239	C	T	4	4	8	0	0	8	0	0
5	275592	rs3822759	G	T	3	3	6	0	0	6	0	0
5	276200	rs7713524	T	C	15	27	42	0	0	42	0	0
5	276228	rs7701397	C	T	15	24	39	0	0	39	0	0
5	276317	rs7705234	C	T	13	12	25	0	0	25	0	0
5	276636	rs6872848	A	C	18	16	34	0	0	34	0	0
5	276718	rs11957535	T	C	12	9	21	0	0	21	0	0
5	296741	rs573854484	G	T	6	1	7	0	0	7	0	0
5	442675	rs139173233	C	T	3	5	8	0	0	8	0	0
5	442790	rs10035653	G	A	5	1	6	0	0	6	0	0
5	453567	rs2672722	G	A	50	45	95	0	1	96	0	0
5	453583	rs6871053	C	T	50	46	96	0	1	97	0	0
5	458574	.	G	A	3	4	7	0	0	7	0	0
5	459681	.	G	T	13	10	23	0	0	23	0	0
5	459943	rs7728027	T	C	6	10	16	0	0	16	0	0
5	460135	rs2561665	A	G	17	6	23	0	0	23	0	0
5	460385	rs114397548	C	T	11	11	22	0	0	22	0	0
5	462465	rs890972	C	A	8	6	14	0	1	15	0	0
5	462523	rs146592938	G	A	3	5	8	0	0	8	0	0
5	462734	rs2434694	C	T	14	3	17	0	0	17	0	0
5	462995	rs4602680	C	T	5	4	9	0	0	9	0	0
5	464477	.	G	A	43	64	107	0	2	109	0	0
5	464814	rs3815928	C	G	15	15	30	0	0	30	0	0
5	466706	rs116970902	G	A	2	6	8	0	0	8	0	0
5	467698	rs113717355	T	G	7	0	7	0	0	7	0	0
5	467744	.	G	T	11	1	12	0	1	13	0	0
5	467757	.	G	A	10	4	14	0	1	15	0	0
5	470087	rs2278251	G	A	30	30	60	0	1	61	0	0
5	472055	rs1053226	C	T	6	9	15	0	2	17	0	0
5	473979	rs13354935	G	A	2	5	7	0	0	7	0	0
5	476353	rs2230437	C	T	1	5	6	0	0	6	0	0
5	476530	rs2244240	C	G	4	4	8	0	0	8	0	0
5	477253	rs890979	A	G	2	4	6	0	0	6	0	0
5	478059	rs78031941	C	G	3	6	9	0	1	10	0	0
5	478755	rs10053300	G	C	0	6	6	0	0	6	0	0
5	481579	rs115754124	C	T	2	4	6	0	0	6	0	0
5	642829	rs1697978	A	G	5	5	10	0	0	10	0	0
5	643593	rs2455331	T	C	3	3	6	0	0	6	0	0
5	643728	rs114495201	G	C	5	4	9	0	0	9	0	0
5	662348	rs3749609	G	A	4	2	6	0	0	6	0	0
5	662906	rs3762953	T	C	3	6	9	0	0	9	0	0
5	863930	rs112501833	C	T	30	31	61	0	0	61	0	0
5	1051687	rs1058508	T	C	10	12	22	0	0	22	0	0
5	1052360	rs3810854	C	T	7	12	19	0	0	19	0	0
5	1057615	rs2241606	A	G	8	4	12	0	1	13	0	0
5	1063998	rs7722287	G	A	14	9	23	0	0	23	0	0
5	1065399	rs737154	C	T	5	5	10	0	0	10	0	0
5	1081702	rs6865765	A	G	7	4	11	0	0	11	0	0
5	1081767	rs4526148	C	T	5	6	11	0	1	12	0	0
5	1318883	rs116117095	G	A	27	19	46	0	0	46	0	0
5	1320003	rs57902743	C	T	14	12	26	0	0	26	0	0
5	1320136	rs421629	G	A	16	12	28	0	1	29	0	0
5	1320247	rs380286	G	A	13	12	25	0	0	25	0	0
5	1324523	rs112982057	G	A	7	2	9	0	0	9	0	0
5	1325590	rs421284	T	C	7	2	9	0	0	9	0	0
5	1325767	.	A	G	6	0	6	0	0	6	0	0
5	1325803	rs465498	A	G	6	1	7	0	0	7	0	0
5	1327101	rs11133729	C	G	4	6	10	0	0	11	1	0
5	1327851	rs383009	C	T	5	4	9	0	0	9	0	0
5	1330840	rs452384	T	C	8	7	15	0	0	15	0	0
5	1461568	rs4738	C	T	4	4	8	0	0	8	0	0
5	1462720	rs10630	G	A	21	17	38	0	0	38	0	0
5	1462732	rs13089	G	C	19	15	34	0	0	34	0	0
5	1477231	.	A	C	3	5	8	0	0	8	0	0
5	1628823	rs2354149	C	T	2	4	6	0	0	6	0	0
5	1633942	rs62335926	G	A	5	1	6	0	0	6	0	0
5	1800127	rs3776154	T	G	4	2	6	0	0	6	0	0
5	1803164	rs3776152	C	G	2	5	7	0	0	7	0	0
5	1804180	rs3776148	C	T	4	3	7	0	0	7	0	0
5	1804530	rs3776147	G	A	4	4	8	0	0	8	0	0
5	1804931	rs60542979	C	G	4	5	9	0	0	9	0	0
5	1806627	rs1018120	C	T	5	4	9	0	0	9	0	0
5	1806653	rs17535721	G	A	5	6	11	0	0	11	0	0
5	1807475	rs11959171	G	A	7	9	16	0	0	16	0	0
5	1809542	rs3756344	G	A	9	7	16	0	0	16	0	0
5	1811318	rs11750565	T	G	13	9	22	0	0	22	0	0
5	1812413	rs11740753	G	A	15	19	34	0	0	34	0	0
5	1814369	rs3752844	C	T	22	12	34	0	0	34	0	0
5	1815606	rs4147774	C	T	6	3	9	0	0	9	0	0
5	6372248	rs4592	G	A	51	45	96	0	0	96	0	0
5	6372585	rs9451	A	G	154	167	321	0	5	326	0	0
5	6374004	rs2455146	A	G	5	7	12	0	0	12	0	0
5	6374079	rs2455147	A	C	6	5	11	0	1	12	0	0
5	6374985	rs2562616	T	C	7	6	13	0	0	13	0	0
5	6375146	.	T	C	0	8	8	0	0	8	0	0
5	6375337	rs905140	A	G	9	5	14	0	0	14	0	0
5	6602280	rs74961031	T	A	10	4	14	0	0	14	0	0
5	6669000	rs13974	A	G	34	31	65	0	0	65	0	0
5	6743574	rs28381381	C	T	5	5	10	0	0	10	0	0
5	6744176	rs274672	G	A	10	13	23	0	0	23	0	0
5	6745875	rs427394	A	G	3	3	6	0	0	6	0	0
5	6752109	rs3797185	G	A	5	3	8	0	0	8	0	0
5	6755319	rs274675	C	T	22	21	43	0	0	43	0	0
5	6755460	rs274674	C	T	17	31	48	0	1	49	0	0
5	7866106	rs17184211	A	T	5	5	10	0	0	10	0	0
5	7867873	.	G	A	5	7	12	0	1	13	0	0
5	7870973	rs1801394	A	G	32	37	69	0	0	69	0	0
5	7878179	rs1532268	C	T	45	50	95	0	0	95	0	0
5	7880835	rs162033	C	T	12	0	12	0	0	12	0	0
5	7887284	rs13189728	A	C	6	9	15	0	0	15	0	0
5	7887488	rs13190084	A	G	9	7	16	0	0	16	0	0
5	7891097	rs4001964	A	C	6	3	9	0	0	9	0	0
5	7897319	rs1802059	G	A	62	78	140	0	1	141	0	0
5	7897946	rs17267793	A	G	9	10	19	0	0	19	0	0
5	7898640	rs13163363	C	T	15	7	22	0	0	22	0	0
5	7899231	rs35400615	C	T	26	19	45	0	0	45	0	0
5	7899419	rs716537	C	T	26	21	47	0	2	49	0	0
5	7899850	rs62342557	T	C	9	7	16	0	0	16	0	0
5	7900598	rs9282787	T	C	13	12	25	0	1	26	0	0
5	10437773	.	A	G	17	21	38	0	1	39	0	0
5	10618681	rs13169304	C	A	7	4	11	0	0	11	0	0
5	10619490	rs11948562	T	C	17	22	39	0	0	39	0	0
5	10620055	rs11748380	G	A	16	8	24	0	0	24	0	0
5	10620085	rs11748401	G	A	16	7	23	0	0	23	0	0
5	10622144	rs56328705	A	G	16	14	30	0	0	30	0	0
5	10623745	rs62339296	C	T	11	11	22	0	1	23	0	0
5	10624461	.	T	C	5	1	6	0	0	6	0	0
5	10626757	rs11741626	C	T	9	4	13	0	0	13	0	0
5	14144399	rs249493	C	G	8	10	18	0	0	18	0	0
5	14420027	rs30612	A	C	17	17	34	0	1	35	0	0
5	14465355	rs17500759	C	T	3	4	7	0	0	7	0	0
5	14498727	rs26107	G	A	31	32	63	0	1	64	0	0
5	14692557	rs570057405	C	T	2	4	6	0	0	6	0	0
5	14741984	rs2288474	T	C	4	7	11	0	0	11	0	0
5	17221016	rs1482344	A	G	1	5	6	0	0	6	0	0
5	17224497	rs2956571	A	T	2	4	6	0	0	6	0	0
5	31515657	rs55656741	G	A	4	4	8	0	0	8	0	0
5	31538692	rs17410000	A	C	28	41	69	0	0	69	0	0
5	31539239	rs10051162	T	A	11	9	20	0	0	20	0	0
5	31540303	rs62348758	A	G	3	13	16	0	0	16	0	0
5	31553268	rs11748072	T	G	13	8	21	0	0	21	0	0
5	31553968	rs12658729	T	C	25	18	43	0	0	43	0	0
5	31554593	rs1056491	C	G	32	38	70	0	0	70	0	0
5	31554657	rs1056492	A	G	24	13	37	0	1	38	0	0
5	32247842	rs56257952	G	A	7	10	17	0	0	17	0	0
5	32274485	rs56270170	G	A	5	1	6	0	0	6	0	0
5	32274967	rs67162125	T	C	1	8	9	0	0	9	0	0
5	32275016	rs55790566	T	C	8	1	9	0	1	10	0	0
5	32400266	rs1051489	A	G	130	153	283	0	2	285	0	0
5	32402232	rs10063044	A	G	9	8	17	0	0	17	0	0
5	32402676	rs4867439	A	G	11	6	17	0	0	17	0	0
5	32595320	rs182833354	G	A	12	6	18	0	1	19	0	0
5	32789852	rs1173756	T	C	4	3	7	0	0	7	0	0
5	33424154	rs6874199	A	G	3	5	8	0	0	8	0	0
5	33424207	rs6450988	G	C	3	4	7	0	0	7	0	0
5	33440624	rs3756662	C	T	11	9	20	0	0	20	0	0
5	33457535	rs2270903	T	A	7	18	25	0	0	25	0	0
5	33457618	rs1003000	G	A	1	6	7	0	0	7	0	0
5	33466068	rs16891180	A	G	5	6	11	0	1	12	0	0
5	33467432	rs16891189	G	A	5	2	7	0	0	7	0	0
5	33468957	rs6889093	G	A	20	12	32	0	0	32	0	0
5	33989518	rs2278008	C	T	10	4	14	0	0	14	0	0
5	33998883	rs2287939	A	G	10	7	17	0	0	17	0	0
5	34004707	rs10941112	C	T	2	4	6	0	0	6	0	0
5	34020030	rs6546	C	G	5	2	7	0	0	8	1	0
5	34020277	rs840386	C	T	6	3	9	0	0	9	0	0
5	34020358	.	T	C	9	1	10	0	0	10	0	0
5	34930201	rs27160	T	C	5	2	7	0	0	7	0	0
5	34937960	rs112209905	G	A	34	22	56	0	1	57	0	0
5	34938373	rs40202	A	G	48	31	79	0	0	79	0	0
5	34951150	rs37439	C	A	14	10	24	0	0	24	0	0
5	34957444	rs251636	T	C	6	5	11	0	0	11	0	0
5	34957601	rs62356992	G	A	12	4	16	0	0	16	0	0
5	35874575	rs6897932	C	T	3	3	6	0	0	6	0	0
5	35877841	rs10491435	G	A	7	5	12	0	0	12	0	0
5	35877914	rs10491434	A	G	10	1	11	0	0	11	0	0
5	35879429	rs1053496	T	C	3	12	15	0	0	15	0	0
5	35879595	rs700179	A	G	5	4	9	0	0	9	0	0
5	36143392	rs267766	C	T	3	7	10	0	0	10	0	0
5	36183485	rs3933496	C	G	4	3	7	0	0	7	0	0
5	36194007	rs3088073	T	A	18	17	35	0	0	35	0	0
5	36702864	rs1025288	C	A	0	7	7	0	0	7	0	0
5	36992990	rs188488	A	G	10	10	20	0	0	20	0	0
5	36995205	rs159755	T	A	3	6	9	0	0	9	0	0
5	37288535	rs10473043	A	G	9	14	23	0	0	23	0	0
5	37289049	rs11750291	T	A	6	3	9	0	0	9	0	0
5	37333727	rs150594	A	G	11	27	38	0	0	38	0	0
5	37393417	rs12659660	C	G	5	1	6	0	0	6	0	0
5	37519492	rs75114436	C	T	4	2	6	0	0	6	0	0
5	39067435	rs4273623	C	T	3	6	9	0	0	9	0	0
5	39070619	.	T	G	2	4	6	0	0	6	0	0
5	39105594	rs358501	C	T	22	13	35	0	0	35	0	0
5	39107353	rs404122	T	A	9	3	12	0	0	12	0	0
5	39119723	rs379707	C	A	18	31	49	0	2	51	0	0
5	39141240	rs3188386	G	A	9	13	22	0	0	22	0	0
5	39269845	rs35249	C	T	27	10	37	0	0	37	0	0
5	39372150	rs1046033	A	G	7	17	24	0	0	24	0	0
5	39373253	rs4578	C	T	7	5	12	0	0	12	0	0
5	40680964	rs45480797	C	G	12	14	26	0	0	26	0	0
5	40681254	rs2228058	C	T	319	303	622	0	4	626	0	0
5	40682550	rs4546432	C	T	3	9	12	0	0	12	0	0
5	40683567	rs11957406	G	A	3	11	14	0	0	14	0	0
5	40691531	rs146917812	C	G	10	10	20	0	1	21	0	0
5	40773178	rs74653842	C	T	4	5	9	0	0	9	0	0
5	40776336	rs139977772	A	T	16	16	32	0	0	32	0	0
5	40830073	rs151227583	C	T	4	3	7	0	0	7	0	0
5	40831063	rs16870378	T	C	4	2	6	0	0	6	0	0
5	40835393	rs41271053	A	C	3	15	18	0	0	18	0	0
5	41743677	rs13189192	G	A	8	2	10	0	0	10	0	0
5	41743678	rs13171121	T	A	8	2	10	0	0	10	0	0
5	41744285	rs11738517	G	C	6	2	8	0	0	8	0	0
5	41846226	rs145946595	G	T	8	5	13	0	0	13	0	0
5	41846644	.	T	C	10	5	15	0	0	15	0	0
5	41846875	rs13165731	C	G	8	11	19	0	0	19	0	0
5	41870675	rs1876654	T	C	3	3	6	0	0	6	0	0
5	41926300	rs277416	G	A	3	6	9	0	0	9	0	0
5	43134949	.	C	T	7	2	9	0	0	9	0	0
5	43134968	rs7712046	C	T	2	5	7	0	0	7	0	0
5	43136185	rs10050724	C	T	6	2	8	0	0	8	0	0
5	43175873	rs72752507	T	C	86	103	189	0	5	194	0	0
5	43175953	rs13665	G	C	79	89	168	0	6	174	0	0
5	43289708	rs6814	G	C	55	29	84	0	3	87	0	0
5	43290700	rs13659	T	A	61	26	87	0	0	87	0	0
5	43297144	rs3733769	A	G	31	32	63	0	0	63	0	0
5	43297819	rs6898398	C	T	6	2	8	0	0	8	0	0
5	43313531	rs12514393	C	T	8	8	16	0	0	16	0	0
5	65085330	rs2034241	A	G	10	1	11	0	0	11	0	0
5	65085624	rs12658444	C	T	0	8	8	0	0	8	0	0
5	65085672	rs12654328	A	G	0	8	8	0	0	8	0	0
5	65086850	rs17183903	A	C	7	0	7	0	0	7	0	0
5	65087357	rs2561202	C	A	0	6	6	0	0	6	0	0
5	65120027	rs9291848	G	A	2	13	15	0	0	15	0	0
5	65120054	rs1550818	C	T	1	13	14	0	1	15	0	0
5	65124415	rs10085083	C	T	1	5	6	0	0	6	0	0
5	65235310	rs2561240	T	C	7	2	9	0	0	9	0	0
5	65317181	rs706679	C	T	4	8	12	0	0	12	0	0
5	65350374	rs36303	A	G	15	29	44	0	0	44	0	0
5	65350481	rs3805466	C	T	19	31	50	0	0	50	0	0
5	65453050	rs27087	G	A	14	12	26	0	0	26	0	0
5	65453185	rs27086	A	G	21	19	40	0	0	40	0	0
5	65453728	rs16894981	A	C	3	5	8	0	0	8	0	0
5	65458697	rs2303802	A	G	4	6	10	0	0	10	0	0
5	65459360	rs27588	C	A	8	6	14	0	0	14	0	0
5	65459773	rs3763061	T	C	8	16	24	0	1	25	0	0
5	65464101	rs4699855	G	C	10	7	17	0	0	17	0	0
5	65464783	rs36923	G	C	29	21	50	0	1	51	0	0
5	65464856	rs36922	C	T	27	24	51	0	0	51	0	0
5	65464965	rs40176	C	T	20	16	36	0	2	38	0	0
5	65469926	rs4700094	A	G	7	10	17	0	0	17	0	0
5	66478409	rs1803440	C	G	1	5	6	0	0	6	0	0
5	67529191	rs6881033	G	A	4	3	7	0	0	7	0	0
5	67538101	rs251407	T	C	4	7	11	0	0	11	0	0
5	67539698	rs141940634	G	T	19	14	33	0	0	33	0	0
5	67541452	.	C	T	5	29	34	0	0	34	0	0
5	67569391	rs2302974	A	C	14	4	18	0	0	18	0	0
5	67569479	rs2302975	A	G	4	6	10	0	0	10	0	0
5	67569602	rs2302976	A	G	4	4	8	0	0	8	0	0
5	67584758	.	A	G	5	1	6	0	0	6	0	0
5	67593016	rs1445760	T	C	4	4	8	0	0	8	0	0
5	67594324	rs1043526	A	G	70	61	131	0	0	131	0	0
5	67596088	rs3756668	G	A	218	192	410	0	3	413	0	0
5	67597321	rs9623	T	C	6	21	27	0	1	28	0	0
5	68390284	rs337259	C	T	7	6	13	0	0	13	0	0
5	68399604	rs338668	G	A	7	2	9	0	0	9	0	0
5	68417643	rs164578	C	T	18	12	30	0	0	30	0	0
5	68419054	rs164572	A	T	6	15	21	0	1	22	0	0
5	68425699	rs6886492	A	G	1	6	7	0	0	7	0	0
5	68463014	rs164390	G	T	16	8	24	0	0	24	0	0
5	68470527	rs379434	G	A	5	3	8	0	0	8	0	0
5	68470559	rs426392	T	C	3	3	6	0	0	6	0	0
5	68471552	rs419902	T	C	2	4	6	0	0	6	0	0
5	68513599	rs2242350	G	T	35	21	56	0	0	56	0	0
5	68531253	rs2972388	C	T	88	90	178	0	2	180	0	0
5	68553758	rs2291520	T	C	2	4	6	0	0	6	0	0
5	68577803	rs34591347	C	T	14	3	17	0	0	17	0	0
5	68578428	rs4421064	T	C	2	4	6	0	0	6	0	0
5	68616331	rs10471774	C	T	20	18	38	0	0	38	0	0
5	68662136	rs4252228	G	A	9	10	19	0	0	19	0	0
5	68663272	rs72773410	G	A	7	2	9	0	0	9	0	0
5	68679822	rs7447816	G	A	3	5	8	0	0	8	0	0
5	68695940	rs1045051	T	G	51	33	84	0	0	84	0	0
5	68805616	rs35107257	G	A	9	7	16	0	0	16	0	0
5	69515870	.	C	T	10	14	24	0	0	24	0	0
5	70308251	rs28409706	C	T	5	3	8	0	0	8	0	0
5	70329173	.	G	A	5	1	6	0	0	6	0	0
5	70344903	.	G	A	10	0	10	0	0	10	0	0
5	70798541	rs36009281	A	G	18	13	31	0	1	32	0	0
5	70823075	rs467901	A	G	3	5	8	0	0	8	0	0
5	70830757	.	C	T	9	8	17	0	0	17	0	0
5	70934996	.	G	T	3	5	8	0	1	9	0	0
5	70945075	rs10064079	A	G	23	20	43	0	0	43	0	0
5	70952934	rs1135667	C	T	29	16	45	0	0	45	0	0
5	70953930	.	G	C	33	22	55	0	1	56	0	0
5	71519664	rs3209157	C	T	47	28	75	0	0	75	0	0
5	71521964	rs114360965	G	A	45	44	89	0	0	89	0	0
5	71524163	rs10942927	A	T	41	40	81	0	0	81	0	0
5	72179286	rs7736396	A	G	2	8	10	0	0	10	0	0
5	72179404	rs9885319	T	G	2	5	7	0	0	7	0	0
5	72184098	rs17606	C	T	49	39	88	0	1	89	0	0
5	72188530	rs58832480	T	C	6	4	10	0	0	10	0	0
5	72202775	.	A	G	6	7	13	0	0	13	0	0
5	72203628	rs34955	T	C	5	5	10	0	0	10	0	0
5	72203686	rs6873306	C	T	7	7	14	0	0	14	0	0
5	72203696	rs34956	T	C	2	6	8	0	1	9	0	0
5	72204082	rs62360686	A	T	2	5	7	0	1	8	0	0
5	72206862	rs155625	T	G	16	32	48	0	0	48	0	0
5	72206887	rs3733858	T	C	14	29	43	0	2	45	0	0
5	72209068	rs10942501	A	G	10	14	24	0	0	24	0	0
5	72286953	rs10942521	G	A	1	6	7	0	0	7	0	0
5	72347223	rs7712838	A	G	4	14	18	0	1	19	0	0
5	72348272	rs185435	A	G	13	6	19	0	0	19	0	0
5	72384853	rs57967468	C	T	8	15	23	0	0	23	0	0
5	72385144	rs62362237	T	C	1	5	6	0	0	6	0	0
5	72385914	rs6892973	A	G	9	11	20	0	0	20	0	0
5	72795003	rs56029107	G	A	2247	1990	4237	0	78	4315	0	0
5	72795176	rs2115439	G	A	0	14	14	0	0	14	0	0
5	72795369	rs819564	T	G	3	3	6	0	0	6	0	0
5	72796467	rs3797858	A	G	3	3	6	0	0	6	0	0
5	72796519	rs3797857	A	G	2	6	8	0	0	8	0	0
5	72796834	rs3797855	C	G	3	3	6	0	0	6	0	0
5	72798024	rs7735607	T	G	1	6	7	0	0	7	0	0
5	72798845	rs14010	A	G	3129	2824	5953	0	32	5986	1	0
5	72798995	rs6862039	T	A	3	3	6	0	0	6	0	0
5	72799614	rs11954393	A	G	3	3	6	0	0	6	0	0
5	72800295	rs12656416	A	G	5	7	12	0	0	12	0	0
5	72800597	rs12656893	T	C	9	5	14	0	0	14	0	0
5	72849591	rs343102	T	C	7	5	12	0	1	13	0	0
5	72849775	rs343103	C	T	5	5	10	0	0	10	0	0
5	72850282	rs343104	A	G	4	2	6	0	0	6	0	0
5	72850395	rs343105	T	C	3	3	6	0	0	6	0	0
5	72851535	rs819584	A	T	5	4	9	0	0	9	0	0
5	72857986	rs819582	T	C	6	4	10	0	0	10	0	0
5	72857999	rs189341	A	G	6	3	9	0	0	9	0	0
5	72861309	rs343108	G	A	3	7	10	0	0	10	0	0
5	72861366	rs343109	G	A	7	5	12	0	0	12	0	0
5	72861459	rs168222	G	A	4	2	6	0	0	6	0	0
5	72862289	.	G	A	8	1	9	0	0	9	0	0
5	72865307	rs347234	C	T	3	8	11	0	1	12	0	0
5	72874907	rs343122	A	C	25	25	50	0	0	50	0	0
5	72876035	rs343120	G	A	6	8	14	0	0	14	0	0
5	72876119	rs343119	T	C	2	9	11	0	0	11	0	0
5	73930751	rs300239	C	T	14	23	37	0	0	37	0	0
5	73931246	rs442425	T	C	15	20	35	0	0	35	0	0
5	73932315	rs9176	T	C	14	5	19	0	0	19	0	0
5	73933578	rs2021526	T	C	2	4	6	0	0	6	0	0
5	73933628	.	G	C	1	5	6	0	0	6	0	0
5	73981476	.	C	T	9	5	14	0	0	14	0	0
5	108246854	rs9885082	C	A	8	0	8	0	0	8	0	0
5	108247311	rs56373044	G	A	6	0	6	0	0	6	0	0
5	108248885	rs9326754	C	T	6	0	6	0	0	6	0	0
5	108251774	rs114401207	C	T	10	0	10	0	0	10	0	0
5	108337159	rs4421154	C	A	6	0	6	0	0	6	0	0
5	108528166	rs6594351	C	G	12	0	12	0	0	12	0	0
5	109026485	rs2241353	C	G	5	1	6	0	0	6	0	0
5	109033393	rs2300990	A	G	3	6	9	0	0	9	0	0
5	109034382	rs3756598	T	C	8	7	15	0	1	16	0	0
5	109035496	rs3819904	A	G	9	9	18	0	0	18	0	0
5	109117171	rs13189822	A	G	21	22	43	0	0	43	0	0
5	109152485	rs4141495	G	T	5	2	7	0	0	7	0	0
5	109152806	rs6871227	G	T	3	7	10	0	0	10	0	0
5	109181682	rs3186988	A	T	29	30	59	0	2	61	0	0
5	109200553	rs12656073	A	C	2	4	6	0	0	6	0	0
5	109203296	rs55968726	A	G	44	47	91	0	2	93	0	0
5	109203921	rs2241693	C	T	34	18	52	0	1	53	0	0
5	109204024	rs2241692	G	A	33	22	55	0	0	55	0	0
5	109204107	rs2241690	G	T	14	12	26	0	1	27	0	0
5	110079450	rs17446534	T	C	33	26	59	0	1	60	0	0
5	110096939	rs7724788	G	A	37	38	75	0	3	78	0	0
5	110097554	rs3844597	C	A	36	37	73	0	2	75	0	0
5	110098632	rs72774805	T	C	6	6	12	0	0	12	0	0
5	110100063	rs4957919	C	T	3	6	9	0	0	9	0	0
5	110100318	rs11548494	G	A	6	5	11	0	0	11	0	0
5	110439509	rs11241095	A	G	10	11	21	0	0	21	0	0
5	110446519	.	G	A	18	22	40	0	0	40	0	0
5	110454738	.	G	A	26	29	55	0	1	56	0	0
5	110456704	rs13186912	A	T	31	24	55	0	0	55	0	0
5	110463626	.	T	G	15	3	18	0	1	19	0	0
5	111066590	rs1055975	A	G	169	120	289	0	5	294	0	0
5	111497358	rs3816657	T	G	6	8	14	0	0	14	0	0
5	111499732	rs1054724	A	C	24	35	59	0	1	60	0	0
5	112164561	rs351771	G	A	29	19	48	0	0	48	0	0
5	112175770	rs41115	G	A	12	11	23	0	0	23	0	0
5	112176325	rs42427	G	A	18	17	35	0	0	35	0	0
5	112176559	rs866006	T	G	10	13	23	0	0	23	0	0
5	112177171	rs465899	G	A	16	20	36	0	0	36	0	0
5	112178492	.	C	T	42	20	62	0	0	62	0	0
5	112197132	rs41296563	G	A	3	37	40	0	0	40	0	0
5	112197140	rs10477484	C	A	2	39	41	0	0	41	0	0
5	112198128	rs116245084	T	C	3	6	9	0	1	10	0	0
5	112199199	rs351770	C	A	8	5	13	0	1	14	0	0
5	112200028	rs351768	T	A	4	5	9	0	0	9	0	0
5	112201054	.	A	G	1	5	6	0	1	7	0	0
5	112201481	rs146293109	G	A	7	5	12	0	1	13	0	0
5	112212151	rs3317	G	A	3	5	8	0	0	8	0	0
5	112213461	rs115096377	A	G	3	3	6	0	0	6	0	0
5	112222787	rs34083474	C	T	80	142	222	0	1	223	0	0
5	112223594	rs712663	T	C	6	9	15	0	0	15	0	0
5	112257908	rs153556	T	C	33	56	89	0	0	89	0	0
5	112889370	rs75714066	G	C	8	8	16	0	0	16	0	0
5	115249078	.	C	T	469	0	469	0	2	471	0	0
5	115249271	rs3879477	G	A	344	2	346	0	5	352	1	0
5	115249588	.	G	A	316	0	316	0	0	316	0	0
5	115249598	.	G	A	307	0	307	0	1	308	0	0
5	115249599	.	G	A	302	1	303	0	2	305	0	0
5	130681504	.	C	T	25	0	25	0	0	25	0	0
5	132441811	.	T	G	6	0	6	0	0	6	0	0
5	153372525	rs1057772	G	A	13	8	21	0	0	21	0	0
5	153413390	rs2578377	C	T	7	7	14	0	0	14	0	0
5	153429459	rs690592	T	C	9	6	15	0	0	15	0	0
5	153432733	rs2578386	T	C	7	7	14	0	0	14	0	0
5	153432970	rs2255493	C	T	10	9	19	0	1	20	0	0
5	153434018	rs1824773	T	C	3	12	15	0	0	15	0	0
5	153434407	rs1382278	A	G	9	8	17	0	2	19	0	0
5	153434443	.	A	G	6	13	19	0	0	19	0	0
5	153435738	rs1046621	G	A	11	8	19	0	0	19	0	0
5	153796875	rs888979	A	G	14	11	25	0	0	25	0	0
5	153797277	rs7710430	C	T	13	18	31	0	0	31	0	0
5	153831867	rs3340	T	C	4	3	7	0	0	7	0	0
5	153835378	rs1007404	C	G	2	4	6	0	0	6	0	0
5	154184503	rs816719	G	C	14	13	27	0	0	27	0	0
5	154184505	rs79998175	T	C	14	13	27	0	0	27	0	0
5	154199368	rs39614	T	C	11	2	13	0	0	13	0	0
5	154245460	rs2688208	G	A	10	5	15	0	0	15	0	0
5	154245887	rs2560063	G	A	11	5	16	0	0	16	0	0
5	154246896	rs816720	A	G	8	12	20	0	0	20	0	0
5	154247859	rs816722	T	C	3	4	7	0	0	7	0	0
5	154248898	rs2688206	C	T	8	1	9	0	0	9	0	0
5	154249184	.	G	T	7	4	11	0	1	12	0	0
5	154252773	rs2688201	C	T	2	4	6	0	0	6	0	0
5	154256175	rs12300	G	A	417	392	809	0	7	816	0	0
5	154267288	rs7328	A	G	8	5	13	0	0	13	0	0
5	154275786	rs6865950	G	A	7	11	18	0	0	18	0	0
5	154282235	rs1421813	T	C	4	5	9	0	0	9	0	0
5	154291409	rs1974777	C	T	4	2	6	0	0	6	0	0
5	154327604	rs10515727	G	C	5	1	6	0	0	6	0	0
5	154346259	rs14922	A	G	287	274	561	0	6	567	0	0
5	175088278	rs2913218	A	C	13	13	26	0	0	26	0	0
5	175343991	.	A	G	11	0	11	0	0	11	0	0
5	175343995	.	T	C	12	0	12	0	0	12	0	0
5	175394181	.	G	A	0	6	6	0	0	6	0	0
5	175773287	rs409744	T	C	136	130	266	0	0	266	0	0
5	175781262	rs115206011	G	A	3	3	6	0	0	6	0	0
5	175816212	rs17078191	C	A	25	8	33	0	0	33	0	0
5	175817054	rs7736666	G	A	5	4	9	0	0	9	0	0
5	175817741	rs183646453	C	A	9	7	16	0	0	16	0	0
5	175819621	rs5866	T	C	266	221	487	0	1	488	0	0
5	175819928	rs149148884	G	A	360	263	623	0	3	626	0	0
5	175826154	rs55827151	C	T	6	5	11	0	0	11	0	0
5	175827476	rs62402498	G	A	7	4	11	0	0	11	0	0
5	175829571	rs11958063	T	G	4	3	7	0	0	7	0	0
5	175830897	rs13169400	G	A	7	10	17	0	0	17	0	0
5	175912994	rs3888233	G	A	7	12	19	0	1	20	0	0
5	175917078	rs2963668	T	C	3	3	6	0	0	6	0	0
5	175918048	rs7702142	A	T	5	1	6	0	0	6	0	0
5	175921936	rs7732877	A	G	5	2	7	0	0	7	0	0
5	175935316	rs2963672	T	C	102	96	198	0	1	199	0	0
5	175935729	rs2913904	C	T	82	91	173	0	0	173	0	0
5	176081907	rs11267007	C	T	10	3	13	0	0	13	0	0
5	176084894	rs748742	C	T	21	12	33	0	0	33	0	0
5	176085168	rs748743	A	G	11	10	21	0	0	21	0	0
5	176085207	rs748744	T	C	9	12	21	0	0	21	0	0
5	176085391	rs1063266	G	A	16	11	27	0	0	27	0	0
5	176085423	rs6556277	C	G	14	14	28	0	0	28	0	0
5	176085522	rs2087210	C	T	13	19	32	0	1	33	0	0
5	176314459	rs2278492	G	A	24	32	56	0	1	57	0	0
5	176314639	rs6875296	G	A	22	20	42	0	0	42	0	0
5	176409574	rs13167812	G	A	182	170	352	0	5	357	0	0
5	176721272	rs11740250	G	C	20	28	48	0	0	48	0	0
5	176733341	rs4073745	A	G	7	10	17	0	0	17	0	0
5	176734855	rs4568379	G	C	28	22	50	0	0	50	0	0
5	176735383	rs67008484	T	C	4	4	8	0	2	10	0	0
5	176739110	rs72813185	C	A	7	2	9	0	0	9	0	0
5	176759778	rs35582636	C	A	6	6	12	0	0	12	0	0
5	176760227	rs4976643	A	C	10	9	19	0	0	19	0	0
5	176761535	rs11738681	A	G	3	5	8	0	0	8	0	0
5	176856925	rs13177732	T	G	9	19	28	0	0	28	0	0
5	176917897	rs1132445	C	T	208	169	377	0	6	383	0	0
5	176919656	rs148209669	G	A	205	171	376	0	1	377	0	0
5	176929185	rs337368	G	C	110	81	191	0	3	194	0	0
5	176929974	rs2544814	G	A	48	55	103	0	0	103	0	0
5	176930651	rs337366	G	A	42	36	78	0	0	78	0	0
5	176931706	rs179810	G	C	4	8	12	0	0	12	0	0
5	176936300	rs337400	C	A	5	8	13	0	0	13	0	0
5	176940081	.	C	T	114	130	244	0	8	252	0	0
5	176940274	rs335437	C	T	12	3	15	0	0	15	0	0
5	176940384	rs335438	G	A	154	144	298	0	3	301	0	0
5	176947107	.	G	A	100	143	243	0	4	247	0	0
5	176948717	rs337386	T	C	3	3	6	0	0	6	0	0
5	177020032	rs34582406	G	A	3	5	8	0	0	8	0	0
5	177020966	rs1994354	C	T	7	2	9	0	0	9	0	0
5	177022722	rs9232	G	C	97	95	192	0	11	203	0	0
5	177031348	rs11537644	T	C	27	15	42	0	2	44	0	0
5	177033794	rs11249570	G	A	5	2	7	0	0	7	0	0
5	177033861	rs34457379	G	A	6	0	6	0	0	6	0	0
5	177033892	rs79392633	T	A	0	6	6	0	0	6	0	0
5	177034153	rs77560515	C	T	2	6	8	0	0	8	0	0
5	177035964	rs729459	T	C	27	31	58	0	1	59	0	0
5	177039747	rs6861315	C	G	11	9	20	0	0	20	0	0
5	177042620	rs4976704	T	C	3	3	6	0	0	6	0	0
5	177046240	rs34857879	G	A	9	3	12	0	0	12	0	0
5	177482694	rs11953084	T	C	6	3	9	0	3	12	0	0
5	177551985	rs3812073	C	T	4	2	6	0	0	6	0	0
5	177552158	rs112305384	G	A	6	5	11	0	0	11	0	0
5	177632422	rs113140855	C	G	8	5	13	0	0	13	0	0
5	177636587	rs73351260	C	T	3	9	12	0	0	12	0	0
5	177637447	rs2913751	G	A	3	5	8	0	0	8	0	0
5	177644448	rs67418220	G	C	3	4	7	0	0	7	0	0
5	177653961	rs2913866	C	T	2	4	6	0	0	6	0	0
5	177654158	rs75616150	T	G	4	4	8	0	0	8	0	0
5	177655512	rs11740356	T	G	7	0	7	0	0	7	0	0
5	177657172	rs62388741	A	C	9	5	14	0	1	15	0	0
5	177658896	rs3749810	A	C	4	6	10	0	0	10	0	0
5	177659631	rs2913859	G	A	0	6	6	0	0	6	0	0
5	177665000	rs13741	T	C	59	94	153	0	1	154	0	0
5	177665342	rs1544926	G	A	60	67	127	0	0	127	0	0
5	177675217	rs2913851	C	T	46	43	89	0	1	90	0	0
5	177683905	rs61739424	G	A	28	21	49	0	0	49	0	0
5	177904821	rs6863210	C	T	19	12	31	0	0	31	0	0
5	177907371	rs686282	A	G	33	20	53	0	0	53	0	0
5	178048633	rs4557432	G	T	7	8	15	0	0	15	0	0
5	178049444	rs34183525	C	G	37	29	66	0	0	66	0	0
5	178139442	rs1132338	T	G	27	14	41	0	0	41	0	0
5	178140090	rs1132336	C	T	20	12	32	0	0	32	0	0
5	178461594	rs11741906	G	A	4	2	6	0	0	6	0	0
5	178509702	rs75387589	T	G	10	5	15	0	0	15	0	0
5	178509703	rs76706493	T	A	10	5	15	0	0	15	0	0
5	178510048	rs1049532	C	T	2	4	6	0	0	6	0	0
5	179026909	rs11741546	T	A	4	2	6	0	0	6	0	0
5	179047408	rs116087223	A	G	227	224	451	0	3	454	0	0
5	179049329	rs4563584	G	A	48	55	103	0	2	105	0	0
5	179049672	rs66479467	A	C	46	35	81	0	1	82	0	0
5	179050188	rs1136267	A	C	29	55	84	0	0	84	0	0
5	179221478	.	T	C	1	6	7	0	0	7	0	0
5	179229641	rs142066681	G	T	28	20	48	0	3	51	0	0
5	179249110	rs73351643	T	C	139	102	241	0	0	241	0	0
5	179290845	rs30386	T	G	95	93	188	0	2	190	0	0
5	179383815	rs155576	T	C	3	4	7	0	0	7	0	0
5	179395493	.	C	G	3	3	6	0	0	6	0	0
5	179404375	rs27017	G	A	47	11	58	0	2	60	0	0
5	179407229	rs28011	C	T	6	1	7	0	0	7	0	0
5	179407885	rs9329092	T	C	29	31	60	0	0	60	0	0
5	179409108	.	C	T	5	8	13	0	0	13	0	0
5	179411660	rs2937020	G	T	6	5	11	0	0	11	0	0
5	179412482	rs864137	G	A	6	3	9	0	0	9	0	0
5	179412707	rs864138	T	G	8	6	14	0	0	14	0	0
5	179412870	rs10058085	C	T	4	3	7	0	0	7	0	0
5	179414371	.	A	G	4	3	7	0	0	7	0	0
5	179416699	rs857181	C	T	2	4	6	0	0	6	0	0
5	179417185	rs857184	A	G	4	2	6	0	1	7	0	0
5	179417645	rs495267	A	G	12	15	27	0	0	27	0	0
5	179418172	rs62404973	T	C	5	8	13	0	0	13	0	0
5	179418210	rs116361925	T	C	6	8	14	0	2	16	0	0
5	179421162	rs150149931	C	T	6	3	9	0	0	9	0	0
5	179421883	rs248315	A	G	5	3	8	0	0	8	0	0
5	179424001	rs10054764	G	A	9	1	10	0	0	10	0	0
5	179425132	rs7448914	C	A	4	2	6	0	0	6	0	0
5	179436463	rs114934688	A	G	5	4	9	0	0	9	0	0
5	179450080	rs35928331	G	A	6	1	7	0	0	7	0	0
5	179473460	rs28754309	G	C	3	5	8	0	0	8	0	0
5	179660786	rs6703	T	A	13	17	30	0	0	30	0	0
5	179661528	rs1127580	C	T	7	8	15	0	0	15	0	0
5	179662384	rs1127575	A	G	10	5	15	0	0	15	0	0
5	179662722	rs4634313	C	A	3	4	7	0	0	7	0	0
5	179663251	rs9605	G	A	55	35	90	0	1	91	0	0
5	179670528	rs7445806	C	T	4	3	7	0	0	7	0	0
5	179672108	rs7726664	G	A	3	3	6	0	0	6	0	0
5	179673708	rs4481314	T	C	7	1	8	0	0	8	0	0
5	180218820	rs2070925	C	A	197	187	384	0	4	388	0	0
5	180218831	rs2070924	G	A	188	188	376	0	7	383	0	0
5	180219304	rs7726005	C	T	120	116	236	0	2	238	0	0
5	180220261	rs57817879	G	C	4	2	6	0	0	6	0	0
5	180221878	rs6861358	G	C	4	2	6	0	0	6	0	0
5	180222131	rs10903270	C	G	20	27	47	0	0	47	0	0
5	180222229	rs6883883	A	G	17	13	30	0	0	30	0	0
5	180222312	rs72648854	T	C	13	11	24	0	0	24	0	0
5	180222439	rs11249746	G	T	18	16	34	0	0	34	0	0
5	180222472	rs11249747	A	G	22	30	52	0	0	52	0	0
5	180222789	rs62405452	C	A	71	64	135	0	0	135	0	0
5	180222846	rs62405453	G	A	56	54	110	0	2	112	0	0
5	180225915	rs12517175	A	C	3	3	6	0	0	6	0	0
5	180225919	rs62405458	C	T	3	3	6	0	0	6	0	0
5	180230642	rs3806865	C	G	29	45	74	0	3	77	0	0
5	180230661	rs3806866	G	A	29	46	75	0	0	75	0	0
5	180235575	rs3733749	C	T	6	0	6	0	0	6	0	0
5	180236449	rs62407793	G	C	26	13	39	0	0	39	0	0
5	180237084	rs936712	G	C	7	1	8	0	0	8	0	0
5	180237662	rs2619734	A	G	4	2	6	0	0	6	0	0
5	180238039	rs2619733	T	C	5	4	9	0	0	9	0	0
5	180276402	rs168726	C	T	4	5	9	0	0	9	0	0
5	180278393	rs705441	C	G	18	19	37	0	0	37	0	0
5	180287632	rs2127380	A	G	8	9	17	0	0	17	0	0
5	180287715	rs2127381	T	G	1	5	6	0	0	6	0	0
5	180288239	rs2121117	G	A	2	6	8	0	0	8	0	0
5	180665995	rs191685935	A	C	188	190	378	0	0	378	0	0
5	180685637	rs10063650	G	T	4	4	8	0	0	8	0	0
5	180685900	rs13177248	T	G	6	4	10	0	0	10	0	0
5	180687907	rs114579724	C	A	13	10	23	0	0	23	0	0
6	291744	.	G	C	8	0	8	0	0	8	0	0
6	291756	rs9503164	T	C	1	7	8	0	0	8	0	0
6	348906	.	G	A	15	0	15	0	0	15	0	0
6	349016	.	C	T	14	0	14	0	0	14	0	0
6	349317	rs6927235	T	C	12	0	12	0	0	12	0	0
6	349343	rs3778605	T	A	6	7	13	0	1	14	0	0
6	351156	.	C	T	97	0	97	0	1	98	0	0
6	408833	rs12211228	G	C	4	3	7	0	0	7	0	0
6	410493	rs1877175	A	G	7	4	11	0	0	11	0	0
6	410513	rs1877176	A	G	8	4	12	0	0	12	0	0
6	410608	rs9392502	C	G	6	3	9	0	0	9	0	0
6	2059110	rs476594	T	C	5	1	6	0	0	6	0	0
6	2766465	rs8333	T	C	34	23	57	0	1	58	0	0
6	2773722	rs160665	C	T	3	5	8	0	1	9	0	0
6	2775080	rs160668	G	C	5	9	14	0	0	14	0	0
6	2775431	rs9328128	C	T	10	11	21	0	0	21	0	0
6	2776303	rs160699	T	C	5	3	8	0	0	8	0	0
6	2776995	rs160697	A	G	14	6	20	0	0	20	0	0
6	2777980	rs160696	C	A	9	13	22	0	0	22	0	0
6	2780961	rs3799239	A	T	7	5	12	0	0	12	0	0
6	2781931	rs167555	G	A	15	14	29	0	0	29	0	0
6	2783071	rs315007	G	A	27	11	38	0	0	38	0	0
6	2783996	rs11242798	A	T	6	6	12	0	0	12	0	0
6	2834632	rs9392431	C	T	6	26	32	0	1	33	0	0
6	2835831	rs2293772	A	G	49	29	78	0	0	78	0	0
6	2836266	rs385955	T	A	53	20	73	0	0	73	0	0
6	2836600	rs2293771	T	G	49	48	97	0	0	97	0	0
6	2838102	rs316340	G	A	102	84	186	0	0	186	0	0
6	2840059	rs316343	C	T	79	115	194	0	0	194	0	0
6	2840100	rs12208607	G	A	147	80	227	0	3	230	0	0
6	2841556	rs316346	C	T	355	150	505	0	4	509	0	0
6	2887927	rs184572317	C	G	4	2	6	0	0	6	0	0
6	2888001	rs1130185	A	C	2	5	7	0	0	7	0	0
6	2889616	rs9392442	A	G	3	8	11	0	0	11	0	0
6	2890190	rs1052886	A	G	15	11	26	0	1	27	0	0
6	2948965	rs318426	C	T	4	7	11	0	0	11	0	0
6	2952892	rs2580109	T	C	3	4	7	0	0	7	0	0
6	2953445	rs3818276	A	G	4	2	6	0	0	6	0	0
6	2956743	rs10900933	A	G	1	5	6	0	0	6	0	0
6	2959513	rs2236277	C	T	197	199	396	0	1	397	0	0
6	2966681	rs7751512	C	T	2	8	10	0	0	10	0	0
6	2966815	rs7775627	T	C	4	4	8	0	0	8	0	0
6	2968318	rs11242814	T	C	1	5	6	0	0	6	0	0
6	2970941	rs1885296	G	C	6	2	8	0	0	8	0	0
6	2971893	rs7769922	A	G	3	5	8	0	0	8	0	0
6	3003914	rs148062145	T	C	3	6	9	0	0	9	0	0
6	3003915	rs141760869	T	C	3	6	9	0	0	9	0	0
6	3003917	rs4149357	T	C	3	6	9	0	0	9	0	0
6	3010390	rs1143684	C	T	177	96	273	0	7	280	0	0
6	3015790	rs1049115	A	G	124	90	214	0	1	215	0	0
6	3018459	rs10223331	A	G	7	5	12	0	0	12	0	0
6	3018704	rs9501909	A	G	10	9	19	0	0	19	0	0
6	3018774	rs9501910	G	C	4	2	6	0	0	6	0	0
6	3019654	rs4149370	T	C	4	3	7	0	0	7	0	0
6	3020415	rs6942303	A	G	1	9	10	0	0	10	0	0
6	3020430	rs6919992	C	G	1	7	8	0	0	8	0	0
6	3022094	rs13198902	G	A	0	7	7	0	0	7	0	0
6	3023384	rs13193229	T	A	4	2	6	0	0	6	0	0
6	3027226	rs3734479	C	T	5	8	13	0	0	13	0	0
6	3027532	rs2326111	G	A	6	3	9	0	0	9	0	0
6	3027658	rs911537	T	C	6	0	6	0	0	6	0	0
6	3064983	rs9328140	G	A	6	7	13	0	0	13	0	0
6	3081579	rs11242823	G	A	6	6	12	0	0	12	0	0
6	3082263	.	G	T	5	3	8	0	0	8	0	0
6	3154871	rs17849443	A	C	46	0	46	0	1	47	0	0
6	3722941	rs41301861	T	C	4	2	6	0	0	6	0	0
6	3723332	rs742541	C	A	1	10	11	0	1	12	0	0
6	4032608	.	G	A	35	45	80	0	1	81	0	0
6	4892081	rs61749071	C	T	28	26	54	0	1	55	0	0
6	4909437	rs7742807	T	C	3	3	6	0	0	6	0	0
6	4910370	rs1891046	A	G	4	6	10	0	0	10	0	0
6	4914744	rs7775887	A	G	4	5	9	0	0	9	0	0
6	4915159	rs9378918	C	T	4	6	10	0	0	10	0	0
6	4915203	rs4144546	C	T	4	4	8	0	1	9	0	0
6	4915423	rs4144547	T	A	4	3	7	0	0	7	0	0
6	4915648	rs6924037	G	A	2	6	8	0	0	8	0	0
6	4915805	rs6904931	A	G	2	7	9	0	0	9	0	0
6	4915841	rs9378919	A	G	7	2	9	0	0	9	0	0
6	4917143	rs7770206	G	C	1	5	6	0	0	6	0	0
6	4917353	rs11242983	G	A	3	5	8	0	0	8	0	0
6	4917633	rs9392068	C	T	5	5	10	0	0	10	0	0
6	4918054	rs9378920	C	T	2	4	6	0	0	6	0	0
6	5109119	rs393628	T	C	32	40	72	0	1	73	0	0
6	5186900	rs1055415	G	T	13	10	23	0	0	23	0	0
6	6144857	rs3024466	C	A	38	51	89	0	0	89	0	0
6	6145692	rs1050783	C	T	29	39	68	0	1	69	0	0
6	6145726	rs1050782	A	G	29	39	68	0	0	68	0	0
6	6152137	rs5988	C	G	15	29	44	0	0	44	0	0
6	6196141	rs5978	G	A	1	5	6	0	0	6	0	0
6	6222382	rs5981	T	G	12	19	31	0	0	31	0	0
6	6318795	rs5985	C	A	36	16	52	0	0	52	0	0
6	7181735	rs9406002	A	G	54	53	107	0	1	108	0	0
6	7181993	rs9392862	T	C	88	87	175	0	0	175	0	0
6	7211818	rs1334576	G	A	139	109	248	0	2	250	0	0
6	7230680	rs9502564	G	T	27	30	57	0	0	57	0	0
6	7231843	rs9379084	G	A	130	186	316	0	2	318	0	0
6	7238069	rs2714335	T	C	7	3	10	0	0	10	0	0
6	7242605	rs11752007	T	C	3	4	7	0	0	7	0	0
6	7247248	rs2256596	T	C	63	41	104	0	1	105	0	0
6	7250625	.	C	T	31	14	45	0	1	46	0	0
6	7268623	rs2038829	C	T	20	23	43	0	0	43	0	0
6	7281654	rs1050226	A	G	43	41	84	0	0	84	0	0
6	7282131	rs3734582	T	C	19	12	31	0	1	32	0	0
6	7282451	rs2714356	C	A	9	19	28	0	0	28	0	0
6	7282523	rs2764087	A	G	13	19	32	0	0	32	0	0
6	7283474	rs113336440	G	A	6	4	10	0	1	11	0	0
6	7283759	rs9505115	T	C	8	3	11	0	0	11	0	0
6	7284032	rs11243151	G	C	11	6	17	0	0	17	0	0
6	7284459	rs9502582	C	T	4	3	7	0	1	8	0	0
6	7284487	rs9502583	G	A	7	4	11	0	0	11	0	0
6	7287012	rs115763162	C	T	3	4	7	0	0	7	0	0
6	7287579	rs3734584	T	G	2	5	7	0	0	7	0	0
6	7288297	rs8955	G	A	281	310	591	0	3	594	0	0
6	7288341	rs1050607	C	T	346	280	626	0	3	629	0	0
6	7288544	rs11071	A	C	169	190	359	0	3	363	1	0
6	7288613	rs11719	T	C	162	161	323	0	1	324	0	0
6	7289166	rs3087986	C	T	190	186	376	0	8	384	0	0
6	7312637	rs2714354	T	C	1	6	7	0	0	7	0	0
6	7312714	rs75465676	G	A	2	6	8	0	1	9	0	0
6	7881865	.	G	C	216	64	280	0	5	285	0	0
6	7881931	rs1043784	T	C	360	253	613	0	9	622	0	0
6	7882205	rs7764128	G	A	266	230	496	0	4	500	0	0
6	7883073	rs8643	C	T	225	179	404	0	4	408	0	0
6	7889088	rs1225944	A	G	3	3	6	0	0	6	0	0
6	8014704	rs2748375	A	C	30	10	40	0	0	40	0	0
6	8018072	rs9328451	C	T	7	2	9	0	0	9	0	0
6	8081021	rs2815164	G	A	3	4	7	0	0	7	0	0
6	10724560	rs3756954	A	G	4	2	6	0	0	6	0	0
6	10731218	rs7113	C	T	282	301	583	0	0	583	0	0
6	10756903	.	A	G	424	413	837	0	13	850	0	0
6	10763312	rs526495	G	A	8	1	9	0	0	9	0	0
6	10764727	rs126405	A	G	1	5	6	0	0	6	0	0
6	10806255	rs1737270	C	T	5	2	7	0	0	7	0	0
6	10806702	rs7750887	G	A	5	1	6	0	1	7	0	0
6	10897153	rs72823314	T	C	5	1	6	0	0	6	0	0
6	11183587	rs1044417	C	T	15	5	20	0	0	20	0	0
6	11183896	rs13849	T	G	37	29	66	0	0	66	0	0
6	11184090	rs1570372	G	A	26	27	53	0	0	53	0	0
6	11184867	rs1803710	C	A	39	14	53	0	0	53	0	0
6	11185257	rs10601	A	T	54	62	116	0	0	116	0	0
6	11185533	rs1050775	G	A	108	114	222	0	2	224	0	0
6	11190203	.	G	A	58	68	126	0	0	126	0	0
6	11225013	rs2025678	A	T	4	3	7	0	0	7	0	0
6	11230765	rs55785931	C	T	13	27	40	0	2	42	0	0
6	11576933	rs12204093	C	G	55	26	81	0	2	83	0	0
6	11577466	rs12212790	T	C	212	117	329	0	3	332	0	0
6	11577572	rs12211376	A	G	85	36	121	0	0	121	0	0
6	11578023	rs202037520	C	A	5	2	7	0	0	7	0	0
6	11578550	rs12192607	G	T	23	19	42	0	0	42	0	0
6	11579093	rs595877	G	A	3	10	13	0	0	13	0	0
6	11580277	rs12209963	C	T	4	9	13	0	0	13	0	0
6	11580325	rs12196157	G	A	5	11	16	0	0	16	0	0
6	11580985	rs16871481	A	G	9	9	18	0	0	18	0	0
6	11581196	rs16871482	G	T	9	20	29	0	1	30	0	0
6	11581374	rs16871484	T	C	8	12	20	0	0	20	0	0
6	11581595	rs12193579	T	G	10	7	17	0	1	18	0	0
6	11581990	rs10947419	A	G	8	7	15	0	1	16	0	0
6	11582447	rs2275398	A	G	7	15	22	0	0	22	0	0
6	12016284	rs9470741	C	G	5	4	9	0	1	10	0	0
6	12017034	rs1409287	G	A	12	4	16	0	0	16	0	0
6	12017065	rs1409286	G	C	4	9	13	0	0	13	0	0
6	12038976	rs1570987	C	A	24	20	44	0	1	45	0	0
6	12038979	rs9366948	A	C	23	22	45	0	0	45	0	0
6	12120445	rs2228215	A	G	6	3	9	0	0	9	0	0
6	12120588	rs2228209	C	T	2	5	7	0	0	7	0	0
6	12121906	rs187187140	C	T	6	4	10	0	2	12	0	0
6	12122174	rs2228210	A	G	6	10	16	0	1	17	0	0
6	12124587	rs2228212	C	G	7	9	16	0	0	16	0	0
6	12124855	rs2228213	G	A	11	7	18	0	0	18	0	0
6	12144060	rs13217115	A	G	5	2	7	0	0	7	0	0
6	12294258	rs5369	A	G	10	18	28	0	2	30	0	0
6	13164648	rs12192359	G	A	4	3	7	0	0	7	0	0
6	13318030	rs3823441	C	A	4	4	8	0	0	8	0	0
6	13445363	rs61657352	A	G	3	6	9	0	0	9	0	0
6	13579828	rs2804911	A	C	20	13	33	0	0	33	0	0
6	13619424	rs3823453	G	C	8	8	16	0	0	16	0	0
6	13619629	rs3800503	A	G	12	6	18	0	0	18	0	0
6	13623324	rs12209803	T	C	4	2	6	0	0	6	0	0
6	13624580	rs12664567	A	C	2	4	6	0	0	6	0	0
6	13628059	rs7760411	C	T	2	4	6	0	0	6	0	0
6	13633522	rs7745101	T	A	3	6	9	0	0	9	0	0
6	13633646	rs7745281	T	C	5	5	10	0	0	10	0	0
6	13634038	rs10948804	A	T	6	5	11	0	0	11	0	0
6	13634982	rs707816	C	T	2	6	8	0	0	8	0	0
6	13638243	rs2071836	T	C	2	6	8	0	0	8	0	0
6	13638984	rs4715451	A	G	6	6	12	0	0	12	0	0
6	13639700	rs6915775	G	A	5	4	9	0	0	9	0	0
6	13649724	rs11755634	T	C	5	4	9	0	0	9	0	0
6	13649762	rs11753232	C	G	7	3	10	0	1	11	0	0
6	13711279	rs6905991	A	G	136	105	241	0	2	243	0	0
6	13787304	rs3800505	T	C	15	15	30	0	1	31	0	0
6	13788252	rs3757254	T	C	9	11	20	0	0	20	0	0
6	13789235	rs10223600	C	A	9	11	20	0	0	20	0	0
6	14124685	.	A	G	5	4	9	0	0	9	0	0
6	14127825	rs77714440	A	C	4	4	8	0	0	8	0	0
6	14131033	rs4715877	G	A	9	11	20	0	0	20	0	0
6	14131804	rs7743206	G	A	113	153	266	0	2	268	0	0
6	14137014	rs9230	T	C	18	23	41	0	0	41	0	0
6	15244249	rs78855103	C	T	5	3	8	0	0	8	0	0
6	15475155	rs190738619	C	T	4	20	24	0	0	24	0	0
6	15488124	rs2076055	C	G	7	9	16	0	0	16	0	0
6	15488874	.	G	A	20	19	39	0	0	39	0	0
6	15489655	rs185217279	C	T	15	26	41	0	1	42	0	0
6	15490359	rs2237124	A	G	18	17	35	0	0	35	0	0
6	15492335	rs2237123	A	G	19	20	39	0	1	40	0	0
6	15492519	.	G	A	21	10	31	0	0	31	0	0
6	15494075	rs2237121	C	T	7	11	18	0	0	18	0	0
6	15494177	rs2237120	A	G	2	7	9	0	0	9	0	0
6	15494559	rs2237119	A	G	4	3	7	0	0	7	0	0
6	15494891	rs2237118	G	A	6	2	8	0	0	8	0	0
6	15495688	rs9370819	C	T	10	4	14	0	0	14	0	0
6	15502083	rs2237112	A	C	17	23	40	0	0	40	0	0
6	15503509	rs2282819	G	A	30	34	64	0	1	65	0	0
6	15503546	rs2282818	A	G	27	34	61	0	1	62	0	0
6	15504018	.	C	T	34	39	73	0	0	73	0	0
6	15504876	.	G	A	5	5	10	0	0	10	0	0
6	15508888	rs115998508	A	G	18	24	42	0	1	43	0	0
6	15509511	.	T	C	44	37	81	0	1	82	0	0
6	15509996	.	G	A	9	3	12	0	0	12	0	0
6	15511745	.	T	A	20	16	36	0	0	36	0	0
6	15513482	rs2235258	G	A	64	91	155	0	2	157	0	0
6	15513744	rs9396589	G	T	4	10	14	0	0	14	0	0
6	15513874	.	A	G	9	9	18	0	0	18	0	0
6	15514499	rs9396590	A	G	8	11	19	0	0	19	0	0
6	15515775	.	G	C	12	8	20	0	0	20	0	0
6	15516285	rs9396591	G	A	11	7	18	0	1	19	0	0
6	15517659	rs2072822	C	A	9	3	12	0	1	13	0	0
6	15518036	rs2072821	G	C	8	4	12	0	0	12	0	0
6	15518814	rs1967663	G	A	6	5	11	0	0	11	0	0
6	15519885	rs13198512	C	T	9	5	14	0	0	14	0	0
6	15530274	.	A	C	9	1	10	0	0	10	0	0
6	15530784	rs9296979	A	C	8	1	9	0	0	9	0	0
6	15533733	rs11753919	C	T	2	4	6	0	0	6	0	0
6	15660583	rs73373668	C	T	5	7	12	0	0	12	0	0
6	16138258	rs4716047	G	A	4	5	9	0	0	9	0	0
6	16138363	rs2142675	C	G	4	4	8	0	0	8	0	0
6	16138665	rs2142674	C	A	4	6	10	0	0	10	0	0
6	16140827	rs4716048	C	G	8	2	10	0	0	10	0	0
6	16144614	rs2056937	T	C	5	2	7	0	0	7	0	0
6	16144920	rs2072780	C	T	8	9	17	0	0	17	0	0
6	16145325	rs9370867	A	G	171	198	369	0	3	372	0	0
6	16146740	rs1060913	G	A	37	16	53	0	0	53	0	0
6	16148058	rs2205795	G	T	310	272	582	0	10	592	0	0
6	16279097	rs739473	T	C	28	35	63	0	2	65	0	0
6	16290761	rs1042391	T	A	32	43	75	0	0	75	0	0
6	16295555	rs1042427	T	C	29	36	65	0	0	65	0	0
6	16658058	rs60231131	T	C	1	8	9	0	0	9	0	0
6	17610114	rs146710253	G	T	6	13	19	0	0	19	0	0
6	17629091	rs61734900	A	G	138	152	290	0	0	290	0	0
6	17650552	rs76429953	A	T	1	6	7	0	0	7	0	0
6	17760132	rs9371016	G	A	17	9	26	0	0	26	0	0
6	17764279	rs1044654	A	C	29	30	59	0	0	59	0	0
6	17764530	rs9371018	C	T	52	33	85	0	0	85	0	0
6	17764755	rs2296197	T	C	39	50	89	0	1	90	0	0
6	17781450	rs942376	G	A	28	33	61	0	0	61	0	0
6	17785546	rs59334299	C	G	2	7	9	0	0	9	0	0
6	17794494	rs3734234	G	A	22	19	41	0	1	42	0	0
6	17815310	rs10949448	C	T	6	19	25	0	0	25	0	0
6	17815431	rs6918261	G	A	13	21	34	0	0	34	0	0
6	17815716	rs6920106	C	T	12	11	23	0	0	23	0	0
6	17834198	rs4716189	T	G	34	44	78	0	4	82	0	0
6	17834213	rs4716190	T	C	36	36	72	0	4	76	0	0
6	18215303	rs214585	T	C	63	67	130	0	1	131	0	0
6	18223409	rs214505	C	T	58	74	132	0	0	132	0	0
6	18223566	rs214504	C	T	11	22	33	0	2	35	0	0
6	18226340	rs214503	G	A	12	6	18	0	1	19	0	0
6	18248916	rs214526	C	A	6	4	10	0	0	10	0	0
6	18249048	rs214525	A	G	10	8	18	0	0	18	0	0
6	18257078	rs214520	A	G	11	9	20	0	1	21	0	0
6	18257985	rs214519	G	T	9	10	19	0	1	20	0	0
6	18387815	rs764885	A	C	8	9	17	0	0	17	0	0
6	18399750	rs2296198	T	C	7	9	16	0	0	16	0	0
6	20124860	rs949550	G	A	5	5	10	0	0	10	0	0
6	20166536	rs9460461	A	T	5	4	9	0	0	9	0	0
6	20480586	rs3828858	A	G	7	4	11	0	0	11	0	0
6	20492995	rs1042317	T	C	22	32	54	0	1	55	0	0
6	20534974	rs11963450	T	C	3	5	8	0	0	8	0	0
6	20559611	rs16883914	A	G	15	12	27	0	0	27	0	0
6	21163919	rs6914598	T	C	1	6	7	0	0	7	0	0
6	21164077	rs6935079	A	G	7	13	20	0	0	20	0	0
6	21164131	rs6935117	A	G	6	10	16	0	0	16	0	0
6	21164145	rs6935124	A	G	4	4	8	0	0	8	0	0
6	21201493	rs9465994	G	A	12	5	17	0	0	17	0	0
6	21231474	rs1563727	C	G	8	11	19	0	0	19	0	0
6	21231882	rs35121088	A	T	12	11	23	0	1	24	0	0
6	21231956	rs4712591	G	A	9	11	20	0	0	20	0	0
6	21232223	.	G	T	0	19	19	0	1	20	0	0
6	21232239	.	T	G	7	10	17	0	3	20	0	0
6	24418348	rs2793422	G	A	6	19	25	0	0	25	0	0
6	24423930	rs62401890	C	G	7	1	8	0	0	8	0	0
6	24425447	rs41271779	G	A	4	2	6	0	0	6	0	0
6	24503590	rs2760118	C	T	14	8	22	0	0	22	0	0
6	24973157	rs17672922	T	A	4	2	6	0	0	6	0	0
6	25015681	rs2183067	T	G	110	135	245	0	0	245	0	0
6	25023966	rs9358823	A	T	4	2	6	0	0	6	0	0
6	25024004	rs9356953	G	C	5	1	6	0	0	6	0	0
6	25435758	rs9467515	A	G	7	7	14	0	0	14	0	0
6	25472787	rs9393646	G	A	2	4	6	0	0	6	0	0
6	25967068	rs2009610	C	T	10	16	26	0	0	26	0	0
6	25985521	.	T	A	3	7	10	0	0	10	0	0
6	26056072	rs8384	G	C	1501	1853	3354	0	17	3372	1	0
6	26104280	rs2229768	T	C	8	5	13	0	0	13	0	0
6	26124430	rs198819	C	T	40	61	101	0	1	102	0	0
6	26158993	rs1009181	T	C	10	12	22	0	0	22	0	0
6	26159356	rs2183947	G	A	9	2	11	0	0	11	0	0
6	26161111	rs112309636	A	C	5	1	6	0	0	6	0	0
6	26171250	rs1059490	T	C	11	7	18	0	0	18	0	0
6	26285748	rs62396221	C	A	5	4	9	0	0	9	0	0
6	26368938	.	C	T	15	16	31	0	0	31	0	0
6	26370605	rs9379860	T	C	13	10	23	0	0	23	0	0
6	26370707	rs9379862	T	C	7	10	17	0	0	17	0	0
6	26370748	rs35183513	G	A	7	12	19	0	0	19	0	0
6	26376161	rs1985732	A	G	5	3	8	0	0	8	0	0
6	26376628	rs12214031	T	C	4	2	6	0	0	6	0	0
6	26376832	rs13218591	T	C	7	11	18	0	0	18	0	0
6	26377216	rs139636053	G	A	6	16	22	0	0	22	0	0
6	26377941	rs14232	C	G	16	17	33	0	0	33	0	0
6	26378149	rs9104	G	A	20	20	40	0	0	40	0	0
6	26390830	rs2076029	T	C	4	2	6	0	0	6	0	0
6	26393021	rs1614887	G	A	4	3	7	0	0	7	0	0
6	26402614	rs56023587	G	C	17	9	26	0	1	27	0	0
6	26404374	rs3799378	A	G	5	11	16	0	1	17	0	0
6	26404529	rs4711108	C	T	2	4	6	0	0	6	0	0
6	26404694	rs3799379	C	T	2	4	6	0	0	6	0	0
6	26405264	rs10807008	G	C	3	4	7	0	0	7	0	0
6	26405835	rs56161420	G	A	5	7	12	0	0	12	0	0
6	26406255	.	G	A	8	2	10	0	0	10	0	0
6	26413368	rs6901245	T	G	5	1	6	0	0	6	0	0
6	26413744	rs4712990	C	A	6	12	18	0	0	18	0	0
6	26413975	rs56190518	C	T	8	14	22	0	1	23	0	0
6	26414060	rs56325223	G	T	7	14	21	0	0	21	0	0
6	26414179	rs56143200	T	C	7	13	20	0	0	20	0	0
6	26414373	rs3198487	G	C	8	9	17	0	0	17	0	0
6	26414425	rs3208733	C	T	10	4	14	0	0	14	0	0
6	26414483	rs3208734	C	T	8	9	17	0	0	17	0	0
6	26414806	rs4712992	A	G	11	9	20	0	0	20	0	0
6	26415062	rs12213625	C	A	8	12	20	0	0	20	0	0
6	26443853	rs17611438	C	A	5	5	10	0	0	10	0	0
6	26446209	rs3846848	C	T	1	6	7	0	0	7	0	0
6	26453179	rs9393721	A	G	10	5	15	0	0	15	0	0
6	26459015	rs7750281	G	C	5	15	20	0	1	21	0	0
6	26462641	rs6900118	G	A	2	4	6	0	0	6	0	0
6	26463321	rs3734540	A	C	2	4	6	0	0	6	0	0
6	26464637	rs9467760	C	T	2	4	6	0	0	6	0	0
6	26466225	rs1977198	A	C	2	5	7	0	1	8	0	0
6	26466389	rs1977199	G	A	5	3	8	0	1	9	0	0
6	26466392	rs1977200	G	A	7	3	10	0	0	10	0	0
6	26467182	rs3799380	T	C	7	10	17	0	0	17	0	0
6	26467325	rs9467761	T	C	10	13	23	0	0	23	0	0
6	26467531	rs4518487	A	G	6	6	12	0	0	12	0	0
6	26467700	rs9467762	C	T	6	9	15	0	0	15	0	0
6	26467759	rs4422619	C	T	7	9	16	0	0	16	0	0
6	26468319	rs3734541	C	T	35	51	86	0	1	87	0	0
6	26469445	rs9461254	G	A	66	49	115	0	1	116	0	0
6	26599043	rs13978	T	G	252	194	446	0	5	451	0	0
6	27093821	rs6456768	G	C	8	29	37	0	1	38	0	0
6	27114052	rs9393790	G	T	5	3	8	0	1	9	0	0
6	28117443	rs2622322	C	G	4	3	7	0	0	7	0	0
6	28193786	rs1150705	T	G	6	7	13	0	0	13	0	0
6	28198281	rs1233713	A	G	2	4	6	0	0	6	0	0
6	28201138	rs7206	A	G	10	11	21	0	0	21	0	0
6	28212748	rs13408	G	A	7	1	8	0	0	8	0	0
6	28239681	rs2394049	A	G	11	14	25	0	0	25	0	0
6	28269663	rs1997660	A	G	4	6	10	0	0	10	0	0
6	28270064	rs9461449	T	A	5	3	8	0	0	8	0	0
6	28294550	rs853684	T	C	4	5	9	0	0	9	0	0
6	28346910	rs7774981	T	C	7	12	19	0	0	19	0	0
6	28346945	rs7754960	G	C	6	11	17	0	0	17	0	0
6	28347013	rs7775132	T	C	6	4	10	0	0	10	0	0
6	28350239	rs2232440	G	T	7	6	13	0	0	13	0	0
6	28350240	rs2232439	C	G	7	6	13	0	0	13	0	0
6	29691390	rs1632955	C	G	6	6	12	0	0	12	0	0
6	29691391	rs1632954	T	C	5	6	11	0	1	12	0	0
6	29693011	rs1736924	C	T	156	183	339	0	2	341	0	0
6	29693969	rs1736922	C	T	3	3	6	0	0	6	0	0
6	29695859	rs6934884	G	C	2	5	7	0	0	7	0	0
6	29696209	rs1736921	G	A	3	4	7	0	0	7	0	0
6	29696852	rs885945	C	T	2	5	7	0	1	8	0	0
6	29706183	rs114938447	C	T	8	5	13	0	1	14	0	0
6	29765047	rs1633002	A	T	25	0	25	0	0	25	0	0
6	29795809	rs1628628	C	T	77	0	77	0	0	77	0	0
6	29856279	rs4554349	G	T	84	0	84	0	1	88	3	0
6	29856347	rs3128875	C	T	1313	0	1313	0	5	1318	0	0
6	29856439	rs1611615	T	G	3695	0	3695	0	22	3718	1	0
6	29856445	rs1611616	C	T	3774	0	3774	0	16	3790	0	0
6	29857237	rs59581768	G	C	72	0	72	0	0	72	0	0
6	29857359	rs28668506	C	A	4	688	692	0	1	693	0	0
6	29857502	rs3115605	A	C	2	30	32	0	0	32	0	0
6	29857504	rs28628412	G	A	2	31	33	0	0	33	0	0
6	29864478	rs9259445	A	G	109	0	109	0	1	110	0	0
6	29864846	.	C	T	86	0	86	0	1	87	0	0
6	29864852	rs9259452	C	T	26	0	26	0	0	26	0	0
6	29910302	.	G	C	19	1	20	0	1	21	0	0
6	29910336	.	C	G	1109	3	1112	0	0	1112	0	0
6	29910340	.	A	G	1193	9	1202	0	4	1206	0	0
6	29910444	.	A	G	27	0	27	0	0	27	0	0
6	29910460	rs9260126	T	C	25	0	25	0	1	26	0	0
6	29910491	.	C	A	29	0	29	0	1	30	0	0
6	29910496	rs2904759	C	G	23	10	33	0	0	33	0	0
6	29910506	rs41549214	G	T	25	11	36	0	0	36	0	0
6	29910508	rs9260129	A	G	41	0	41	0	0	41	0	0
6	29910516	rs45620138	G	A	46	0	46	0	0	46	0	0
6	29910519	rs180796996	A	C	47	0	47	0	0	47	0	0
6	29910522	rs9260130	G	C	47	0	47	0	0	47	0	0
6	29910530	.	C	T	49	0	49	0	0	49	0	0
6	29910558	rs2075684	T	C	797	973	1770	0	11	1781	0	0
6	29910581	rs1059423	C	A	1066	857	1923	0	27	1952	2	0
6	29910583	rs1059426	C	T	1090	870	1960	0	17	1977	0	0
6	29910586	rs12721672	G	A	1113	1118	2231	0	2	2233	0	0
6	29910604	rs12721675	C	A	1093	1184	2277	0	15	2297	5	0
6	29910698	rs1059449	G	A	1585	1350	2935	0	16	2951	0	0
6	29910703	rs41541222	G	T	1663	1340	3003	0	20	3024	1	0
6	29910834	rs63225861	G	C	168	137	305	0	1	306	0	0
6	29910923	rs9260147	C	A	118	123	241	0	2	243	0	0
6	29910980	rs41552627	C	T	46	37	83	0	1	84	0	0
6	29911114	rs3173420	G	T	1868	0	1868	0	14	2124	242	0
6	29911119	rs3173419	G	C	1910	344	2254	0	12	2266	0	0
6	29911203	rs1059517	A	C	2154	977	3131	0	61	3192	0	0
6	29911225	rs1059536	A	G	2246	714	2960	0	32	2992	0	0
6	29911227	rs1059537	G	T	2282	708	2990	0	33	3023	0	0
6	29911228	rs9256983	A	G	2309	712	3021	0	18	3039	0	0
6	29911256	rs1059542	T	G	2333	1190	3523	0	24	3549	2	0
6	29911344	rs17878838	C	T	283	306	589	0	1	590	0	0
6	29912204	rs2276447	C	T	464	3	467	0	2	469	0	0
6	29912234	.	C	G	451	2	453	0	3	456	0	0
6	29912280	rs1136903	T	C	4971	39	5010	0	36	5046	0	0
6	29912315	.	A	C	6033	45	6078	0	83	6190	29	0
6	29912333	rs3179982	C	T	5756	39	5795	0	69	5864	0	0
6	29912348	rs1137078	A	G	5598	32	5630	0	31	5663	2	0
6	29912368	rs1141891	C	T	5585	27	5612	0	61	5673	0	0
6	29912398	rs9260191	A	G	419	1	420	0	7	427	0	0
6	29912451	rs9260193	C	A	439	1	440	0	2	442	0	0
6	29912457	rs9260194	C	G	473	1	474	0	1	476	1	0
6	29912473	rs9260196	T	C	526	0	526	0	2	528	0	0
6	29912477	rs9260197	A	G	526	0	526	0	1	527	0	0
6	29912502	rs9260198	C	T	499	0	499	0	2	501	0	0
6	29912657	rs9260200	C	T	650	12	662	0	5	667	0	0
6	29912668	rs9260201	T	G	627	15	642	0	26	668	0	0
6	29912669	rs9260202	A	G	649	14	663	0	17	680	0	0
6	29912767	rs3823325	G	C	790	15	805	0	8	813	0	0
6	29912935	rs2916802	C	T	90	50	140	0	0	140	0	0
6	29912944	rs2916803	T	C	90	44	134	0	2	136	0	0
6	29913042	rs14288	C	T	3279	2105	5384	0	23	5407	0	0
6	29913067	rs3823342	T	C	90	2	92	0	0	92	0	0
6	29913070	rs111820297	G	C	88	0	88	0	1	89	0	0
6	29913074	rs9260205	A	G	96	0	96	0	0	96	0	0
6	29913078	rs41546815	A	G	97	5	102	0	0	102	0	0
6	29913098	rs3129015	C	A	103	8	111	0	0	111	0	0
6	29913171	rs2975057	G	A	78	8	86	0	1	87	0	0
6	29913191	rs2975055	T	C	72	10	82	0	0	82	0	0
6	29913204	.	G	C	71	7	78	0	2	80	0	0
6	29913306	.	C	A	4993	12	5005	0	57	5063	1	0
6	29913310	.	G	C	4927	12	4939	0	46	4985	0	0
6	29913344	rs13395	G	C	5266	13	5279	0	28	5308	1	0
6	29913353	.	T	C	5017	10	5027	0	40	5067	0	0
6	29913355	.	A	G	5018	7	5025	0	36	5062	1	0
6	29913367	rs113042145	G	A	5237	6	5243	0	20	5263	0	0
6	29913377	.	C	T	5435	9	5444	0	12	5456	0	0
6	29913383	.	C	T	5454	12	5466	0	29	5495	0	0
6	29913396	.	A	C	5354	18	5372	0	46	5418	0	0
6	29913468	.	G	A	3678	9	3687	0	19	3706	0	0
6	29913542	rs2499	T	G	1110	785	1895	0	26	1923	2	0
6	29913630	rs2975053	A	C	454	1	455	0	2	457	0	0
6	30028871	rs7770092	C	T	1	7	8	0	0	8	0	0
6	30029109	rs7770557	C	G	86	80	166	0	1	167	0	0
6	30031091	rs9261277	T	C	1	6	7	0	0	7	0	0
6	30032495	rs1048412	A	G	202	162	364	0	3	367	0	0
6	30032673	rs3188482	A	G	9	10	19	0	0	19	0	0
6	30036471	rs2074482	C	A	113	91	204	0	4	208	0	0
6	30037686	rs8347	T	C	97	107	204	0	1	205	0	0
6	30037990	rs6539	C	T	143	108	251	0	3	254	0	0
6	30040185	rs9261300	C	T	5	2	7	0	0	7	0	0
6	30040706	rs2074481	G	C	3	6	9	0	0	9	0	0
6	30040810	rs2074480	T	G	9	4	13	0	0	13	0	0
6	30041009	rs2074479	A	G	3	3	6	0	0	6	0	0
6	30041509	rs11965379	C	T	4	9	13	0	2	15	0	0
6	30041559	rs9261301	G	A	4	10	14	0	0	14	0	0
6	30154199	rs2074473	T	C	44	45	89	0	0	89	0	0
6	30166266	rs2523721	C	T	36	38	74	0	1	75	0	0
6	30166935	rs2072107	G	A	6	7	13	0	0	13	0	0
6	30167835	rs2428503	C	T	2	4	6	0	0	6	0	0
6	30172513	rs971570	A	C	6	11	17	0	0	17	0	0
6	30181117	rs3094615	A	G	24	16	40	0	0	40	0	0
6	30229401	rs56794784	C	T	883	1	884	0	6	890	0	0
6	30294198	rs114052920	A	C	5	2	7	0	0	7	0	0
6	30305054	rs185612635	C	T	4	4	8	0	0	8	0	0
6	30313340	rs6986	G	C	195	181	376	0	2	378	0	0
6	30518874	rs73727439	C	A	16	16	32	0	1	33	0	0
6	30555518	rs112596482	C	T	5	2	7	0	0	7	0	0
6	30560796	rs13195066	A	G	5	4	9	0	0	9	0	0
6	30564953	rs117984242	C	T	5	2	7	0	0	7	0	0
6	30564955	rs139781241	C	G	3	5	8	0	0	8	0	0
6	30611676	rs1140809	C	A	7	5	12	0	0	12	0	0
6	30672463	rs10947087	G	A	31	28	59	0	2	61	0	0
6	30690635	rs17189364	G	A	4	5	9	0	0	9	0	0
6	30693163	rs1062411	C	T	255	231	486	0	0	486	0	0
6	30864829	rs1049623	T	C	5	1	6	0	0	6	0	0
6	30876034	rs2074510	G	T	16	16	32	0	0	32	0	0
6	30876152	rs1052693	C	T	39	31	70	0	0	70	0	0
6	30877760	rs1419693	A	C	25	24	49	0	0	49	0	0
6	30881103	rs1132408	C	A	39	21	60	0	0	60	0	0
6	30882689	rs6926224	C	T	17	23	40	0	0	40	0	0
6	30882803	rs6926723	G	A	16	21	37	0	0	37	0	0
6	30893728	rs1043483	C	T	29	33	62	0	3	65	0	0
6	30893941	rs4678	G	A	49	48	97	0	0	97	0	0
6	31110789	rs1265084	T	C	23	25	48	0	0	48	0	0
6	31116210	rs130071	G	A	16	21	37	0	0	37	0	0
6	31122482	rs130076	G	A	21	12	33	0	0	33	0	0
6	31122500	rs130065	G	A	16	14	30	0	0	30	0	0
6	31164723	rs1793900	C	G	18	11	29	0	0	29	0	0
6	31170131	rs1793899	G	A	1	5	6	0	0	6	0	0
6	31170228	rs9366770	G	C	7	2	9	0	0	9	0	0
6	31236900	rs1049853	G	A	4375	3098	7473	0	57	7530	0	0
6	31237087	rs17885557	C	A	14	9	23	0	0	23	0	0
6	31237862	rs9264621	T	C	3309	177	3486	0	20	3506	0	0
6	31238322	rs9264639	C	T	20	24	44	0	1	45	0	0
6	31238507	rs41544520	C	T	26	18	44	0	1	45	0	0
6	31238708	.	G	A	114	20	134	0	1	135	0	0
6	31238759	rs17884428	C	T	19	26	45	0	0	45	0	0
6	31238868	.	C	T	3912	1983	5895	0	21	5917	1	0
6	31238931	rs697743	G	A	956	336	1292	0	12	1304	0	0
6	31238984	.	G	T	2627	183	2810	0	14	2825	1	0
6	31239016	.	G	A	3433	735	4168	0	12	4180	0	0
6	31239050	rs713032	G	A	2207	3045	5252	0	12	5264	0	0
6	31239057	rs2308575	C	T	2213	3103	5316	0	28	5346	2	0
6	31239108	rs1131118	T	A	1767	2773	4540	0	61	4602	1	0
6	31239378	rs1131123	T	G	2789	1091	3880	0	24	3906	2	0
6	31239407	rs17408553	G	T	1689	2729	4418	0	37	4456	1	0
6	31239417	rs2308557	C	T	1844	2470	4314	0	111	4426	1	0
6	31239430	rs41543814	C	T	2826	1920	4746	0	16	4762	0	0
6	31239506	rs1050414	C	G	1583	2545	4128	0	20	4149	1	0
6	31239518	rs1050420	C	T	2683	1370	4053	0	26	4079	0	0
6	31239543	rs1050428	C	T	2652	1220	3872	0	25	3898	1	0
6	31239577	rs707911	A	C	2399	1036	3435	0	25	3460	0	0
6	31239622	rs9264668	C	A	1937	844	2781	0	16	2797	0	0
6	31239681	rs9264669	A	T	72	96	168	0	1	169	0	0
6	31239766	rs9264672	C	T	73	72	145	0	0	145	0	0
6	31248204	rs2524062	G	A	5	2	7	0	0	7	0	0
6	31321686	.	A	C	1810	819	2629	0	11	2641	1	0
6	31321803	.	G	A	7474	1725	9199	0	35	9234	0	0
6	31321806	rs1056978	C	T	5519	3624	9143	0	34	9179	2	0
6	31321807	rs2770	G	A	1705	7409	9114	0	38	9152	0	0
6	31321883	rs1056429	G	A	4920	3619	8539	0	30	8569	0	0
6	31321916	rs1055849	A	C	5383	3968	9351	0	89	9638	198	0
6	31321917	rs117007172	G	A	5705	3963	9668	0	65	9734	1	0
6	31321919	rs1055821	G	T	5765	3959	9724	0	49	9774	1	0
6	31321961	rs71563314	G	A	7035	5208	12243	0	66	12311	2	0
6	31322047	rs1053726	A	G	7050	6242	13292	0	91	13384	1	0
6	31322133	rs3819306	A	G	19	39	58	0	0	58	0	0
6	31322143	rs17199279	C	T	17	23	40	0	0	40	0	0
6	31322174	rs13210793	C	G	15	5	20	0	0	20	0	0
6	31322303	rs2308655	C	G	6178	5771	11949	0	45	11996	2	0
6	31322340	rs3926873	G	A	164	285	449	0	2	451	0	0
6	31322706	rs13214487	C	G	259	170	429	0	2	433	2	0
6	31322762	rs13214791	G	T	245	158	403	0	3	406	0	0
6	31322803	rs17193040	G	T	133	183	316	0	3	319	0	0
6	31322888	rs1140546	A	G	6728	6190	12918	0	86	13004	0	0
6	31323203	rs1050823	A	G	7412	5531	12943	0	113	13056	0	0
6	31323233	rs709052	A	G	6363	6504	12867	0	102	12976	7	0
6	31323353	rs2257269	G	A	4517	2167	6684	0	73	6758	1	0
6	31323480	rs41555513	G	A	143	292	435	0	3	438	0	0
6	31323567	rs4081560	G	A	182	281	463	0	3	466	0	0
6	31323667	rs41559422	G	A	197	349	546	0	3	549	0	0
6	31323677	rs4081559	C	T	200	313	513	0	13	526	0	0
6	31323745	rs17881233	C	A	213	128	341	0	3	344	0	0
6	31323875	rs41560220	C	T	124	175	299	0	7	306	0	0
6	31324036	rs151341293	T	A	5983	646	6629	0	39	6671	3	0
6	31324057	.	C	A	5530	473	6003	0	55	6058	0	0
6	31324143	rs12697944	G	T	2150	459	2609	0	24	2633	0	0
6	31324154	rs1050379	G	A	502	1345	1847	0	16	1863	0	0
6	31324184	rs1131112	C	G	3223	349	3572	0	12	3585	1	0
6	31324201	rs1071652	C	G	1819	6	1825	0	8	1833	0	0
6	31324202	rs41556417	T	A	154	1656	1810	0	23	1833	0	0
6	31324206	rs1131235	G	A	2618	0	2618	0	9	2627	0	0
6	31324271	rs41560718	A	C	16	6	22	0	0	22	0	0
6	31324489	rs3180380	C	A	4758	1	4759	0	28	4829	42	0
6	31324499	rs3190923	C	G	4409	0	4409	0	36	4446	1	0
6	31324506	rs1050388	C	T	3983	33	4016	0	22	4039	1	0
6	31324516	rs1131215	C	A	3391	1	3392	0	22	3414	0	0
6	31324547	rs1065386	G	C	3766	33	3799	0	11	3810	0	0
6	31324549	rs1050570	T	C	3725	34	3759	0	15	3775	1	0
6	31324562	rs1050564	C	T	95	2916	3011	0	314	3326	1	0
6	31324586	rs1050556	C	T	4548	54	4602	0	26	4628	0	0
6	31324595	rs1050543	C	G	4502	41	4543	0	15	4558	0	0
6	31324599	rs1050538	T	G	4460	34	4494	0	15	4511	2	0
6	31324615	rs1050529	C	T	4132	499	4631	0	35	4666	0	0
6	31324643	rs1050517	G	C	705	3046	3751	0	26	3777	0	0
6	31324664	rs9266184	T	G	3043	610	3653	0	60	3713	0	0
6	31324666	rs713031	A	T	2958	613	3571	0	42	3613	0	0
6	31324702	rs1050486	C	T	2466	687	3153	0	17	3170	0	0
6	31324743	rs41563412	G	C	276	53	329	0	1	330	0	0
6	31324756	rs41552714	G	A	83	228	311	0	2	313	0	0
6	31324764	rs41560522	C	A	238	32	270	0	0	270	0	0
6	31324788	rs9266193	T	C	201	27	228	0	2	230	0	0
6	31324790	rs9266194	A	G	203	27	230	0	0	230	0	0
6	31324829	rs9266196	G	C	179	103	282	0	2	284	0	0
6	31324830	rs9266197	G	A	179	102	281	0	2	283	0	0
6	31324887	rs1131165	G	C	2190	39	2229	0	8	2237	0	0
6	31324888	rs1131163	G	T	2153	36	2189	0	7	2196	0	0
6	31324892	rs1131159	G	C	2075	15	2090	0	5	2095	0	0
6	31324895	rs1131156	G	C	2048	2	2050	0	9	2060	1	0
6	31324911	rs1050462	C	G	1827	8	1835	0	12	1847	0	0
6	31324925	rs1050458	A	G	1436	10	1446	0	5	1451	0	0
6	31324931	rs9266206	A	C	1294	10	1304	0	11	1315	0	0
6	31324938	rs114811870	C	T	14	525	539	0	6	545	0	0
6	31324953	rs9266207	C	T	145	9	154	0	1	155	0	0
6	31325004	rs9266209	G	A	7	1	8	0	0	8	0	0
6	31325023	rs9266210	T	C	6	1	7	0	0	7	0	0
6	31325025	rs9266211	T	C	6	1	7	0	0	7	0	0
6	31325049	rs9266214	G	T	7	1	8	0	0	8	0	0
6	31325056	rs2596487	C	T	1	7	8	0	0	8	0	0
6	31325090	rs9266216	C	T	6	0	6	0	0	6	0	0
6	31325092	rs9266217	A	G	6	0	6	0	0	6	0	0
6	31325115	rs9266218	A	G	6	0	6	0	0	6	0	0
6	31325116	rs9266219	G	T	6	0	6	0	0	6	0	0
6	31325341	rs9266230	G	C	6	0	6	0	0	6	0	0
6	31325359	rs144492758	C	T	7	0	7	0	0	7	0	0
6	31325380	rs9266231	C	T	8	0	8	0	0	8	0	0
6	31362240	rs1052407	A	G	5	1	6	0	0	6	0	0
6	31362334	rs1052405	G	C	8	1	9	0	0	9	0	0
6	31362335	rs1052404	G	A	8	1	9	0	0	9	0	0
6	31362381	rs13209817	A	G	3	8	11	0	0	11	0	0
6	31362390	rs72657658	G	A	7	3	10	0	1	11	0	0
6	31362474	rs73398351	C	T	9	1	10	0	0	10	0	0
6	31362497	rs72657659	T	C	9	2	11	0	0	11	0	0
6	31362526	rs67015816	T	C	10	2	12	0	0	12	0	0
6	31362546	rs67484745	G	C	8	2	10	0	0	10	0	0
6	31362604	rs2523470	G	T	11	0	11	0	0	11	0	0
6	31362879	.	C	T	9	0	9	0	0	9	0	0
6	31362891	rs2523468	C	G	9	0	9	0	0	9	0	0
6	31362892	rs201889502	T	C	9	0	9	0	0	9	0	0
6	31362930	rs2523467	C	T	6	0	6	0	0	6	0	0
6	31368508	rs112142209	A	G	5	25	30	0	0	30	0	0
6	31368540	rs2523452	C	G	7	45	52	0	0	52	0	0
6	31378358	rs1063630	T	G	15	14	29	0	0	29	0	0
6	31378387	rs1063631	T	C	19	15	34	0	0	34	0	0
6	31378425	rs1051786	A	G	18	16	34	0	1	35	0	0
6	31378575	rs181430930	G	A	8	15	23	0	0	23	0	0
6	31378650	rs17200242	C	A	2	7	9	0	0	9	0	0
6	31378654	rs17200249	T	A	3	7	10	0	0	10	0	0
6	31378768	rs2853981	A	G	5	11	16	0	0	16	0	0
6	31378977	rs1051792	G	A	23	22	45	0	0	45	0	0
6	31379043	rs41560824	A	G	28	48	76	0	0	76	0	0
6	31379109	rs1051794	G	A	24	46	70	0	0	70	0	0
6	31379377	rs3828878	T	G	3	3	6	0	0	6	0	0
6	31379620	rs3828882	G	A	3	3	6	0	0	6	0	0
6	31379773	rs1051796	C	T	37	44	81	0	1	82	0	0
6	31379794	rs1051797	C	T	33	38	71	0	0	71	0	0
6	31379795	rs1131898	A	G	33	38	71	0	0	71	0	0
6	31379807	rs1051798	C	T	35	43	78	0	1	79	0	0
6	31379817	rs1140700	T	C	34	34	68	0	0	68	0	0
6	31379823	rs1051799	C	G	36	34	70	0	0	70	0	0
6	31379931	rs1063635	G	A	20	50	70	0	1	71	0	0
6	31379990	rs41553616	C	G	16	40	56	0	0	56	0	0
6	31380198	rs61738275	C	T	12	25	37	0	2	39	0	0
6	31382893	rs41545814	A	G	35	58	93	0	2	95	0	0
6	31382910	rs41545213	C	T	36	51	87	0	0	87	0	0
6	31382911	rs1882	A	G	34	51	85	0	2	87	0	0
6	31382964	rs9266829	A	G	42	61	103	0	0	103	0	0
6	31431082	rs2518030	A	G	4	3	7	0	0	7	0	0
6	31431691	rs2255221	G	T	23	26	49	0	3	52	0	0
6	31432006	rs2263318	G	A	20	14	34	0	1	35	0	0
6	31432125	rs2284178	C	T	17	15	32	0	1	33	0	0
6	31462749	.	T	C	26	0	26	0	0	26	0	0
6	31462753	rs2534683	C	T	0	25	25	0	0	25	0	0
6	31462754	.	G	C	23	0	23	0	0	23	0	0
6	31475624	rs374353214	G	C	9	7	16	0	0	16	0	0
6	31475655	rs9380260	G	A	8	12	20	0	0	20	0	0
6	31476297	rs62395355	C	A	6	8	14	0	1	15	0	0
6	31477531	rs9267429	A	G	2	4	6	0	0	6	0	0
6	31498737	rs2516478	G	A	71	43	114	0	0	114	0	0
6	31503698	rs929138	T	C	15	14	29	0	0	29	0	0
6	31506801	rs2523512	G	A	8	8	16	0	0	16	0	0
6	31507937	rs149245335	C	T	7	9	16	0	0	16	0	0
6	31507938	rs2269476	G	A	9	7	16	0	0	16	0	0
6	31513402	rs2239705	G	A	6	2	8	0	0	8	0	0
6	31525448	rs2230365	C	T	39	34	73	0	0	73	0	0
6	31555130	rs2256965	A	G	3	4	7	0	0	7	0	0
6	31555657	rs3135041	A	G	31	32	63	0	0	63	0	0
6	31556581	rs1052248	T	A	442	428	870	0	6	876	0	0
6	31595487	rs2736171	A	G	14	4	18	0	0	18	0	0
6	31597700	rs3130623	C	T	3	7	10	0	0	10	0	0
6	31597757	rs17207225	C	T	6	2	8	0	0	8	0	0
6	31597875	rs3130624	A	G	5	3	8	0	0	8	0	0
6	31598489	rs3130626	A	G	185	186	371	0	7	378	0	0
6	31599594	rs10947220	A	G	21	14	35	0	0	35	0	0
6	31600820	rs2736157	A	G	5	1	6	0	0	6	0	0
6	31601012	rs2844466	T	C	3	11	14	0	0	14	0	0
6	31601843	rs3115663	T	C	13	12	25	0	0	25	0	0
6	31602967	rs1046089	G	A	500	421	921	0	10	931	0	0
6	31603045	rs35201773	A	G	434	462	896	0	4	900	0	0
6	31603189	rs11538264	G	A	416	473	889	0	12	901	0	0
6	31603591	rs2261033	A	G	11	12	23	0	1	24	0	0
6	31603770	rs11229	A	G	510	412	922	0	6	928	0	0
6	31604591	rs10885	C	T	534	440	974	0	13	987	0	0
6	31607942	rs9267525	T	C	2	4	6	0	1	7	0	0
6	31609272	rs3130628	T	C	25	18	43	0	0	43	0	0
6	31611746	rs7770976	G	A	232	194	426	0	12	438	0	0
6	31615514	rs10484558	T	C	222	243	465	0	8	473	0	0
6	31619576	rs3117583	A	G	13	16	29	0	1	30	0	0
6	31629324	rs143479464	A	C	3	4	7	0	0	7	0	0
6	31631907	rs928814	G	A	89	83	172	0	1	173	0	0
6	31632134	rs3130618	C	A	105	79	184	0	1	185	0	0
6	31632899	rs35377600	C	T	7	6	13	0	0	13	0	0
6	31635710	rs14365	T	C	820	750	1570	0	7	1577	0	0
6	31635943	rs115820082	A	G	13	9	22	0	1	23	0	0
6	31639845	rs11758242	C	A	79	56	135	0	0	135	0	0
6	31639979	rs9267532	C	T	85	75	160	0	0	160	0	0
6	31644640	rs13295	A	G	11	3	14	0	0	14	0	0
6	31655438	rs10573	G	A	223	209	432	0	2	434	0	0
6	31660848	rs11552114	G	A	178	151	329	0	4	333	0	0
6	31681160	rs385306	G	A	2	4	6	0	0	6	0	0
6	31686726	rs396763	T	C	13	6	19	0	0	19	0	0
6	31691657	rs453098	G	A	10	7	17	0	0	17	0	0
6	31692970	rs407283	G	A	23	4	27	0	0	27	0	0
6	31700657	rs2736194	G	T	7	6	13	0	0	13	0	0
6	31702710	rs400547	C	T	21	14	35	0	0	35	0	0
6	31704934	rs378538	C	T	58	27	85	0	3	88	0	0
6	31705183	rs377749	A	C	23	31	54	0	1	55	0	0
6	31709045	rs28381349	C	T	25	31	56	0	0	56	0	0
6	31728267	rs2075801	G	A	3	6	9	0	0	9	0	0
6	31729359	rs707938	A	G	53	31	84	0	4	88	0	0
6	31729925	rs1802127	C	T	85	52	137	0	1	138	0	0
6	31732155	rs28399993	G	A	31	28	59	0	0	59	0	0
6	31795550	rs6457452	C	T	72	85	157	0	1	158	0	0
6	31797928	.	T	G	129	7	136	0	16	152	0	0
6	31803074	rs17201241	C	T	26	29	55	0	0	55	0	0
6	31803346	.	G	A	11	6	17	0	4	21	0	0
6	31804014	rs10456397	A	T	22	15	37	0	1	38	0	0
6	31804729	rs11968400	C	T	31	27	58	0	1	59	0	0
6	31806479	rs35226447	G	A	4	4	8	0	1	9	0	0
6	31827286	rs13118	A	T	234	242	476	0	3	479	0	0
6	31830593	rs41267082	A	C	9	10	19	0	0	19	0	0
6	31868075	rs9267664	G	C	3	5	8	0	0	8	0	0
6	31912523	rs36221133	T	C	4	4	8	0	0	8	0	0
6	31930351	rs2734331	A	G	36	21	57	0	0	57	0	0
6	31935567	rs3911893	G	A	57	50	107	0	1	108	0	0
6	31947804	rs116196017	A	G	9	8	17	0	0	17	0	0
6	31974671	rs28615950	G	A	0	6	6	0	0	6	0	0
6	32036822	rs115612382	C	T	7	9	16	0	0	16	0	0
6	32049423	rs12211410	C	T	5	5	10	0	0	10	0	0
6	32050067	rs185819	T	C	4	4	8	0	0	8	0	0
6	32052216	rs149995364	C	T	4	4	8	0	0	8	0	0
6	32083300	rs8283	A	G	145	154	299	0	3	302	0	0
6	32097290	rs28732176	C	T	17	22	39	0	0	39	0	0
6	32097983	rs9391734	G	A	3	4	7	0	1	9	1	0
6	32120715	rs1053924	T	C	6	5	11	0	0	11	0	0
6	32122472	rs3096696	C	A	47	59	106	0	0	106	0	0
6	32123973	rs3130281	C	G	2	4	6	0	0	6	0	0
6	32131174	rs1050862	C	T	102	83	185	0	1	186	0	0
6	32132727	rs3134949	C	T	7	6	13	0	0	13	0	0
6	32134510	rs3096697	G	A	24	15	39	0	0	39	0	0
6	32136547	rs1061808	T	G	66	69	135	0	0	135	0	0
6	32147696	rs3130349	G	A	179	107	286	0	15	301	0	0
6	32148031	rs1062070	A	G	211	160	371	0	4	375	0	0
6	32148403	rs8365	G	C	151	165	316	0	1	317	0	0
6	32151882	rs115111668	C	T	6	10	16	0	0	16	0	0
6	32151934	rs3131300	A	G	10	9	19	0	0	19	0	0
6	32154285	rs204995	A	G	25	22	47	0	0	47	0	0
6	32154998	rs204994	C	T	30	28	58	0	0	58	0	0
6	32155581	rs204993	A	G	8	7	15	0	0	15	0	0
6	32156908	rs204992	G	A	11	8	19	0	0	19	0	0
6	32159956	rs3134605	T	C	358	405	763	0	11	775	1	0
6	32163541	rs1044507	A	C	15	14	29	0	0	29	0	0
6	32360316	.	A	G	8	0	8	0	18	26	0	0
6	32409656	rs9268657	G	A	2	4	6	0	0	6	0	0
6	32485458	.	C	T	120	0	120	0	2	122	0	0
6	32485459	.	T	G	121	0	121	0	1	122	0	0
6	32485487	.	G	T	274	0	274	0	1	275	0	0
6	32485490	.	C	T	253	21	274	0	1	275	0	0
6	32485491	rs1141867	C	T	0	275	275	0	0	275	0	0
6	32487209	.	C	G	144	0	144	0	0	144	0	0
6	32487214	rs144016913	T	C	0	138	138	0	0	138	0	0
6	32487310	.	G	A	1562	1	1563	0	6	1569	0	0
6	32487314	.	C	T	1708	0	1708	0	7	1715	0	0
6	32487488	.	G	A	22	0	22	0	0	22	0	0
6	32487492	.	G	T	26	0	26	0	0	26	0	0
6	32487531	.	C	G	33	0	33	0	0	33	0	0
6	32487535	.	G	A	33	0	33	0	0	33	0	0
6	32487542	.	G	A	34	0	34	0	0	34	0	0
6	32493277	.	A	G	3	7	10	0	0	10	0	0
6	32493293	.	A	C	9	0	9	0	0	9	0	0
6	32493296	.	C	T	9	0	9	0	0	9	0	0
6	32493308	.	A	T	16	0	16	0	0	16	0	0
6	32493329	.	T	A	4	13	17	0	0	17	0	0
6	32493375	.	G	A	10	0	10	0	0	10	0	0
6	32496112	.	T	A	6	0	6	0	0	6	0	0
6	32496125	.	C	T	6	0	6	0	0	6	0	0
6	32496128	.	T	A	6	0	6	0	0	6	0	0
6	32496131	.	C	G	6	0	6	0	0	6	0	0
6	32496777	.	C	T	6	0	6	0	0	6	0	0
6	32496789	.	C	T	2	6	8	0	0	8	0	0
6	32496838	.	A	T	7	2	9	0	0	9	0	0
6	32496849	.	A	G	10	0	10	0	0	10	0	0
6	32496878	.	C	T	9	0	9	0	0	9	0	0
6	32496896	.	G	A	8	0	8	0	0	8	0	0
6	32497581	rs71549215	G	A	6	0	6	0	0	6	0	0
6	32497632	.	A	G	8	0	8	0	0	8	0	0
6	32497914	.	C	T	378	1	379	0	0	379	0	0
6	32497917	rs71549220	C	A	377	1	378	0	1	379	0	0
6	32520633	rs67753867	G	A	16	0	16	0	0	16	0	0
6	32520639	rs3828850	G	A	0	16	16	0	0	16	0	0
6	32520642	rs72844167	T	C	1	23	24	0	0	24	0	0
6	32520664	rs3828849	G	A	0	112	112	0	1	113	0	0
6	32520676	rs67536864	A	G	134	0	134	0	4	138	0	0
6	32520764	rs67762553	G	C	464	0	464	0	3	467	0	0
6	32520774	rs3200830	C	T	87	390	477	0	4	481	0	0
6	32520795	rs66969121	T	C	459	0	459	0	3	462	0	0
6	32521062	rs3828833	T	C	6	0	6	0	0	6	0	0
6	32521700	rs61104187	G	A	551	0	551	0	4	555	0	0
6	32521735	rs75287767	T	A	0	169	169	0	2	171	0	0
6	32522490	rs113453333	G	A	76	454	530	0	0	530	0	0
6	32522501	.	A	G	556	107	663	0	2	665	0	0
6	32526301	.	A	C	23	0	23	0	0	23	0	0
6	32526304	.	G	A	16	7	23	0	0	23	0	0
6	32526460	rs72492335	T	C	5	1	6	0	0	6	0	0
6	32526551	.	G	C	8	0	8	0	0	8	0	0
6	32526611	rs116218325	G	T	0	8	8	0	0	8	0	0
6	32526612	rs201277028	T	C	0	8	8	0	0	8	0	0
6	32526619	rs77858388	A	G	0	8	8	0	0	8	0	0
6	32526731	rs72845730	A	C	0	7	7	0	0	7	0	0
6	32527025	rs67062152	T	C	0	9	9	0	0	9	0	0
6	32527031	rs35685568	T	A	11	0	11	0	1	12	0	0
6	32527044	.	G	A	0	10	10	0	1	12	1	0
6	32527079	rs28530648	A	C	18	0	18	0	0	18	0	0
6	32527112	rs72492336	C	T	0	11	11	0	0	11	0	0
6	32527129	.	T	C	0	9	9	0	0	9	0	0
6	32546665	.	C	T	2626	1	2627	0	8	2663	28	0
6	32546670	rs34981130	C	T	74	2690	2764	0	6	2770	0	0
6	32546680	.	T	C	3052	0	3052	0	16	3068	0	0
6	32546681	.	G	A	3114	0	3114	0	18	3133	1	0
6	32546696	.	G	A	2973	69	3042	0	17	3059	0	0
6	32546703	rs113804375	A	G	3159	3	3162	0	5	3167	0	0
6	32546743	rs1064707	C	T	3049	52	3101	0	9	3110	0	0
6	32546761	rs113734598	G	A	3297	1	3298	0	10	3308	0	0
6	32546782	rs116358897	G	A	3316	0	3316	0	11	3327	0	0
6	32546795	rs1064701	T	A	3031	0	3031	0	12	3044	1	0
6	32546800	.	A	G	2967	0	2967	0	17	2984	0	0
6	32546802	.	C	T	3001	0	3001	0	13	3015	1	0
6	32546803	.	A	G	2940	0	2940	0	14	2954	0	0
6	32546818	rs36217730	C	T	33	2780	2813	0	16	2829	0	0
6	32546832	rs36217728	G	A	159	2810	2969	0	10	2979	0	0
6	32546833	.	C	A	3083	0	3083	0	12	3095	0	0
6	32546843	.	T	C	3305	1	3306	0	109	3416	1	0
6	32546863	rs34955866	G	T	3152	578	3730	0	15	3745	0	0
6	32546866	rs9269693	T	C	3042	600	3642	0	16	3658	0	0
6	32546879	rs35445101	A	G	3696	4	3700	0	44	3744	0	0
6	32548161	rs112461335	A	G	8	6	14	0	0	14	0	0
6	32548176	.	G	C	11	4	15	0	0	15	0	0
6	32548178	.	A	G	9	6	15	0	0	15	0	0
6	32548188	.	A	G	8	4	12	0	0	12	0	0
6	32548197	.	T	C	8	4	12	0	0	12	0	0
6	32548212	.	C	G	11	4	15	0	0	16	1	0
6	32548281	.	G	A	14	4	18	0	0	18	0	0
6	32548291	.	C	A	0	15	15	0	1	16	0	0
6	32548296	.	G	C	14	0	14	0	0	14	0	0
6	32548301	.	C	A	14	0	14	0	0	14	0	0
6	32548305	.	T	C	13	0	13	0	1	14	0	0
6	32548316	.	C	T	10	0	10	0	0	10	0	0
6	32548319	.	C	G	12	0	12	0	0	12	0	0
6	32548322	.	G	A	11	0	11	0	0	11	0	0
6	32548397	.	A	G	12	0	12	0	0	12	0	0
6	32548401	.	C	T	12	0	12	0	0	12	0	0
6	32548407	.	G	T	11	0	11	0	1	12	0	0
6	32548426	.	T	C	11	1	12	0	0	12	0	0
6	32548438	rs35104774	A	G	1	10	11	0	0	11	0	0
6	32548464	rs3830135	G	A	7	16	23	0	1	24	0	0
6	32548469	rs3830133	A	G	6	20	26	0	0	26	0	0
6	32548489	.	C	G	30	5	35	0	0	35	0	0
6	32548501	.	C	T	6	28	34	0	0	34	0	0
6	32548505	.	C	T	30	6	36	0	0	36	0	0
6	32548507	.	C	A	30	6	36	0	0	36	0	0
6	32548550	rs1059362	G	A	2634	798	3432	0	21	3453	0	0
6	32548581	.	A	G	1059	2246	3305	0	42	3347	0	0
6	32548646	rs3830123	G	T	1	9	10	0	0	10	0	0
6	32548661	.	G	T	9	1	10	0	0	10	0	0
6	32548662	.	T	C	1	7	8	0	0	8	0	0
6	32549092	.	A	C	6	0	6	0	0	6	0	0
6	32549340	.	C	G	1704	0	1704	0	12	1716	0	0
6	32549344	.	T	C	1576	0	1576	0	30	1606	0	0
6	32549361	.	C	T	1006	0	1006	0	5	1011	0	0
6	32549362	rs3200488	G	A	0	893	893	0	14	910	3	0
6	32549368	.	G	A	925	0	925	0	3	928	0	0
6	32549611	.	T	C	403	409	812	0	10	822	0	0
6	32549627	rs199927008	A	C	9	5	14	0	0	14	0	0
6	32549628	.	C	A	0	12	12	0	0	12	0	0
6	32549636	.	A	T	11	6	17	0	0	17	0	0
6	32549638	rs72850244	G	A	9	11	20	0	0	20	0	0
6	32549649	.	G	T	11	7	18	0	0	18	0	0
6	32549670	.	G	T	15	7	22	0	0	22	0	0
6	32549681	rs9269813	G	T	17	7	24	0	0	24	0	0
6	32549726	rs9269815	A	C	12	3	15	0	0	15	0	0
6	32549727	rs9269816	T	C	12	3	15	0	0	15	0	0
6	32549746	rs9269817	A	G	12	3	15	0	0	15	0	0
6	32549782	rs9269819	C	T	19	26	45	0	2	47	0	0
6	32549808	rs9269821	G	A	28	18	46	0	0	46	0	0
6	32549844	.	T	G	31	4	35	0	0	35	0	0
6	32549866	rs9269827	C	G	29	4	33	0	0	33	0	0
6	32549881	.	G	T	27	3	30	0	1	31	0	0
6	32549884	.	A	C	25	2	27	0	2	29	0	0
6	32549915	rs9269829	T	C	21	3	24	0	1	25	0	0
6	32549923	rs35239661	G	T	21	8	29	0	1	30	0	0
6	32549929	.	C	T	9	16	25	0	0	25	0	0
6	32549935	rs35095850	C	G	20	6	26	0	0	26	0	0
6	32549936	rs9269830	G	A	19	6	25	0	1	26	0	0
6	32549966	rs34835435	C	G	18	19	37	0	0	37	0	0
6	32550067	.	C	T	4	3	7	0	0	7	0	0
6	32550105	.	G	A	5	2	7	0	0	7	0	0
6	32550111	rs111498499	G	A	2	4	6	0	0	6	0	0
6	32550116	rs28723989	C	T	4	2	6	0	0	6	0	0
6	32550126	rs35789108	C	G	4	2	6	0	0	6	0	0
6	32550285	.	A	G	6	0	6	0	0	6	0	0
6	32550296	.	T	C	6	0	6	0	1	7	0	0
6	32550321	rs113891305	C	A	3	8	11	0	1	12	0	0
6	32550322	.	A	C	10	3	13	0	0	13	0	0
6	32550331	rs9269854	T	G	10	3	13	0	0	13	0	0
6	32550348	rs35522883	G	T	3	7	10	0	0	10	0	0
6	32550488	.	G	A	8	0	8	0	0	8	0	0
6	32550491	rs34350660	C	T	0	7	7	0	0	7	0	0
6	32550494	.	C	A	9	0	9	0	0	9	0	0
6	32550505	.	T	C	9	0	9	0	0	9	0	0
6	32550548	rs35259208	A	G	0	6	6	0	0	6	0	0
6	32550550	rs28724008	C	G	6	0	6	0	0	6	0	0
6	32551957	.	G	C	1	409	410	0	0	410	0	0
6	32551958	.	C	T	0	407	407	0	3	410	0	0
6	32551970	.	T	G	26	476	502	0	2	504	0	0
6	32551998	.	G	A	274	396	670	0	4	674	0	0
6	32552048	.	C	T	760	0	760	0	4	764	0	0
6	32552059	.	G	T	641	0	641	0	3	731	87	0
6	32552078	.	A	T	60	242	302	0	2	304	0	0
6	32552080	rs3175105	T	C	0	243	243	0	1	284	40	0
6	32552091	.	G	C	40	202	242	0	1	243	0	0
6	32552092	rs1059569	A	T	472	0	472	0	0	472	0	0
6	32552127	rs17885011	C	T	0	244	244	0	0	244	0	0
6	32552131	.	C	A	0	241	241	0	0	241	0	0
6	32552137	.	G	A	0	241	241	0	0	242	1	0
6	32552138	.	G	C	240	1	241	0	1	242	0	0
6	32552143	rs9269958	C	T	316	0	316	0	2	318	0	0
6	32552144	rs9269959	A	C	316	0	316	0	2	318	0	0
6	32552302	.	A	G	10	0	10	0	0	10	0	0
6	32552307	.	A	G	10	0	10	0	0	10	0	0
6	32552313	.	C	A	12	0	12	0	0	12	0	0
6	32552331	.	G	C	12	0	12	0	0	12	0	0
6	32552336	.	C	T	12	0	12	0	0	12	0	0
6	32552348	.	T	G	12	0	12	0	0	12	0	0
6	32552366	.	C	G	11	0	11	0	0	11	0	0
6	32552371	.	C	T	11	0	11	0	0	11	0	0
6	32552456	.	A	G	7	1	8	0	0	8	0	0
6	32552461	.	G	A	7	0	7	0	0	7	0	0
6	32552462	rs534288394	C	T	0	7	7	0	0	7	0	0
6	32552463	.	G	C	0	7	7	0	0	7	0	0
6	32552465	.	C	G	7	0	7	0	0	7	0	0
6	32552473	.	C	T	6	0	6	0	0	6	0	0
6	32552547	rs115273610	C	T	16	10	26	0	1	27	0	0
6	32552548	.	G	C	11	16	27	0	0	27	0	0
6	32552553	rs9269986	C	T	17	6	23	0	0	23	0	0
6	32552556	.	T	C	17	5	22	0	1	23	0	0
6	32552563	.	A	C	21	1	22	0	0	22	0	0
6	32552575	.	A	C	23	0	23	0	0	23	0	0
6	32552588	rs9269990	A	T	21	1	22	0	0	22	0	0
6	32552591	.	C	T	22	0	22	0	0	22	0	0
6	32552603	rs113342592	C	G	1	18	19	0	0	19	0	0
6	32552617	rs28724138	G	A	21	1	22	0	0	22	0	0
6	32552619	.	G	A	23	0	23	0	0	23	0	0
6	32552641	rs28724139	C	T	1	17	18	0	0	18	0	0
6	32552859	rs74440913	T	C	4	2	6	0	0	6	0	0
6	32552868	rs115936732	C	T	4	2	6	0	0	6	0	0
6	32553037	rs113823631	A	T	10	1	11	0	0	11	0	0
6	32553125	rs113600317	A	T	6	1	7	0	0	7	0	0
6	32553128	.	C	T	7	0	7	0	0	7	0	0
6	32553145	.	T	C	9	0	9	0	0	9	0	0
6	32553160	.	T	G	6	4	10	0	0	10	0	0
6	32553180	.	G	T	2	4	6	0	0	6	0	0
6	32553193	.	C	G	5	2	7	0	0	7	0	0
6	32553216	.	C	T	7	0	7	0	0	7	0	0
6	32553235	.	C	T	7	0	7	0	0	7	0	0
6	32553349	.	T	A	9	1	10	0	0	10	0	0
6	32553359	.	T	G	11	2	13	0	1	14	0	0
6	32553360	.	A	G	12	2	14	0	0	14	0	0
6	32553367	.	A	G	14	2	16	0	0	16	0	0
6	32553380	.	C	A	16	2	18	0	0	18	0	0
6	32553429	.	A	G	13	4	17	0	0	17	0	0
6	32553542	.	T	C	5	1	6	0	0	6	0	0
6	32553558	.	C	A	17	1	18	0	0	18	0	0
6	32553567	.	G	A	11	6	17	0	0	17	0	0
6	32553590	.	T	C	6	6	12	0	0	12	0	0
6	32553608	rs35081742	A	T	7	3	10	0	0	10	0	0
6	32553609	.	C	T	11	0	11	0	0	11	0	0
6	32553626	rs113647600	C	A	6	4	10	0	0	10	0	0
6	32553633	.	T	A	9	0	9	0	0	9	0	0
6	32553669	.	C	A	2	5	7	0	0	7	0	0
6	32553671	.	T	C	7	0	7	0	0	7	0	0
6	32553681	.	T	C	7	0	7	0	0	7	0	0
6	32553792	rs34593373	T	C	8	0	8	0	0	8	0	0
6	32553799	rs35577188	T	A	8	0	8	0	0	8	0	0
6	32553800	rs542801935	G	A	8	0	8	0	0	8	0	0
6	32553801	rs35252757	G	A	8	0	8	0	0	8	0	0
6	32553807	rs9270052	G	T	8	1	9	0	0	9	0	0
6	32553816	.	C	T	2	5	7	0	0	7	0	0
6	32553841	rs72850287	A	C	6	2	8	0	0	8	0	0
6	32553849	.	T	C	3	6	9	0	0	9	0	0
6	32553931	rs111461278	A	G	1	5	6	0	0	6	0	0
6	32553995	rs9270062	G	A	10	0	10	0	0	10	0	0
6	32554021	.	A	C	9	0	9	0	0	9	0	0
6	32554025	rs9270066	A	G	9	0	9	0	0	9	0	0
6	32554047	rs113609412	T	A	0	7	7	0	0	7	0	0
6	32554050	rs34691324	A	G	0	7	7	0	0	7	0	0
6	32554377	.	C	A	7	0	7	0	0	7	0	0
6	32554382	.	C	A	7	0	7	0	0	7	0	0
6	32554504	rs72850293	A	G	2	9	11	0	0	11	0	0
6	32554506	rs9270097	C	A	9	2	11	0	0	11	0	0
6	32554517	rs9270098	T	A	8	3	11	0	0	11	0	0
6	32554540	rs9270099	A	C	10	5	15	0	0	15	0	0
6	32554598	.	T	C	25	0	25	0	1	26	0	0
6	32554600	.	C	T	26	0	26	0	0	26	0	0
6	32554603	.	C	T	25	0	25	0	0	25	0	0
6	32554607	rs9270101	T	C	0	23	23	0	0	23	0	0
6	32554621	rs9270102	G	C	13	11	24	0	0	24	0	0
6	32554622	.	A	G	25	0	25	0	0	25	0	0
6	32554662	.	C	G	19	0	19	0	0	19	0	0
6	32554669	.	T	C	20	0	20	0	0	20	0	0
6	32554675	rs111517012	A	G	10	9	19	0	1	20	0	0
6	32554699	rs35301297	A	G	11	10	21	0	0	21	0	0
6	32554719	rs72850296	T	C	9	7	16	0	0	16	0	0
6	32554725	rs35984981	C	T	7	4	11	0	0	11	0	0
6	32554762	rs114856598	C	T	1	5	6	0	0	6	0	0
6	32555412	.	G	A	7	0	7	0	0	7	0	0
6	32555425	.	T	C	9	0	9	0	1	10	0	0
6	32555460	rs9270158	G	A	9	0	9	0	0	9	0	0
6	32555499	.	G	T	8	0	8	0	0	8	0	0
6	32555510	.	T	C	9	0	9	0	0	9	0	0
6	32555523	.	G	A	6	0	6	0	0	6	0	0
6	32555578	.	A	T	6	0	6	0	0	6	0	0
6	32555601	.	T	C	6	0	6	0	0	6	0	0
6	32555667	.	C	T	10	0	10	0	0	10	0	0
6	32555685	rs9270171	A	C	4	5	9	0	0	9	0	0
6	32555687	rs9270172	G	C	4	5	9	0	0	9	0	0
6	32555714	.	G	C	9	0	9	0	0	9	0	0
6	32555736	rs34977123	A	C	10	0	10	0	0	10	0	0
6	32555754	.	A	G	6	3	9	0	0	9	0	0
6	32555762	rs28724164	T	C	4	3	7	0	0	7	0	0
6	32555875	.	T	G	7	0	7	0	1	8	0	0
6	32555939	.	G	T	9	0	9	0	0	9	0	0
6	32555944	rs35773267	C	T	0	9	9	0	0	9	0	0
6	32555987	rs17210202	T	C	6	1	7	0	0	7	0	0
6	32555989	rs17203846	T	A	6	1	7	0	0	7	0	0
6	32556402	rs9270208	G	T	9	0	9	0	0	9	0	0
6	32556467	rs34559860	C	T	7	0	7	0	0	7	0	0
6	32556476	.	G	A	7	0	7	0	0	7	0	0
6	32556487	rs9270211	T	C	8	0	8	0	0	8	0	0
6	32556493	rs9270212	C	T	7	0	7	0	1	8	0	0
6	32556494	rs9270213	A	G	8	0	8	0	0	8	0	0
6	32556499	.	G	A	7	0	7	0	1	8	0	0
6	32556500	.	G	A	8	0	8	0	0	8	0	0
6	32556501	.	T	A	7	0	7	0	0	7	0	0
6	32556699	rs9270227	T	C	6	0	6	0	0	6	0	0
6	32556700	.	A	G	6	0	6	0	0	6	0	0
6	32556706	rs34232122	T	C	7	0	7	0	0	7	0	0
6	32556719	.	T	A	6	2	8	0	0	8	0	0
6	32556738	.	A	T	6	2	8	0	0	8	0	0
6	32556746	.	T	G	6	2	8	0	0	8	0	0
6	32556759	.	G	A	7	2	9	0	0	9	0	0
6	32556779	.	A	C	8	0	8	0	0	8	0	0
6	32556787	rs9270230	C	A	8	0	8	0	0	8	0	0
6	32556788	rs9270231	A	G	8	0	8	0	0	8	0	0
6	32556807	.	G	C	12	0	12	0	0	12	0	0
6	32556811	rs9270232	C	T	11	0	11	0	0	11	0	0
6	32556967	rs9270244	T	G	3	6	9	0	1	10	0	0
6	32556991	rs28357078	G	A	5	3	8	0	0	8	0	0
6	32556993	rs9270248	A	G	5	3	8	0	0	8	0	0
6	32556996	rs9270249	C	A	5	4	9	0	0	9	0	0
6	32557060	rs9270258	G	A	7	25	32	0	0	32	0	0
6	32557127	rs9270265	A	C	7	20	27	0	0	27	0	0
6	32557290	rs564428718	A	C	8	0	8	0	0	8	0	0
6	32557291	.	A	G	8	0	8	0	0	8	0	0
6	32557330	.	T	C	11	0	11	0	0	11	0	0
6	32557340	.	A	G	10	0	10	0	0	10	0	0
6	32557344	.	G	T	10	0	10	0	0	10	0	0
6	32557355	.	A	G	10	0	10	0	0	10	0	0
6	32557356	.	A	G	7	0	7	0	3	10	0	0
6	32557381	.	C	T	11	0	11	0	0	11	0	0
6	32557382	.	C	G	11	0	11	0	0	11	0	0
6	32557386	rs373511931	C	T	10	0	10	0	0	10	0	0
6	32557388	.	A	G	8	0	8	0	1	9	0	0
6	32557405	rs9270296	G	A	8	0	8	0	0	8	0	0
6	32557418	.	A	G	7	0	7	0	0	7	0	0
6	32557478	rs9270301	C	A	1431	277	1708	0	4	1712	0	0
6	32557483	rs9270303	T	C	1424	288	1712	0	6	1718	0	0
6	32557552	rs1059546	A	G	734	63	797	0	5	802	0	0
6	32557585	rs17211091	A	C	66	0	66	0	0	66	0	0
6	32557606	rs17211105	G	A	14	0	14	0	0	14	0	0
6	32605207	rs3187964	C	G	23	1	24	0	0	24	0	0
6	32605234	rs28383345	G	A	35	1	36	0	1	37	0	0
6	32605257	rs1047989	C	A	46	3	49	0	0	49	0	0
6	32605274	rs1130034	T	C	51	4	55	0	1	56	0	0
6	32605295	rs1129735	C	T	54	11	65	0	1	66	0	0
6	32609105	rs1129740	G	A	50	14	64	0	0	64	0	0
6	32609106	rs3205916	T	C	50	14	64	0	0	64	0	0
6	32609126	rs1071630	T	C	53	5	58	0	1	59	0	0
6	32609147	rs12722051	A	T	61	2	63	0	2	65	0	0
6	32609169	rs1048027	T	C	56	1	57	0	9	66	0	0
6	32609181	.	C	T	68	1	69	0	0	69	0	0
6	32609207	.	C	T	72	1	73	0	0	73	0	0
6	32609212	rs1142326	C	A	69	0	69	0	1	70	0	0
6	32609213	rs3207983	G	A	69	0	69	0	0	69	0	0
6	32609216	rs1142328	G	T	69	0	69	0	0	69	0	0
6	32609221	rs12722061	G	C	78	0	78	0	0	78	0	0
6	32609222	rs3208105	A	T	78	0	78	0	0	78	0	0
6	32609227	rs3207985	A	C	77	0	77	0	0	77	0	0
6	32609228	rs28383449	G	A	80	0	80	0	0	80	0	0
6	32609231	rs12722069	A	G	73	0	73	0	2	75	0	0
6	32609233	rs3188043	T	C	75	0	75	0	0	75	0	0
6	32609236	rs4193	G	A	77	0	77	0	0	77	0	0
6	32609253	rs9272702	G	A	75	1	76	0	0	76	0	0
6	32609254	rs1142331	G	T	74	0	74	0	0	74	0	0
6	32609255	rs1142332	G	T	72	0	72	0	1	73	0	0
6	32609264	.	G	C	75	0	75	0	0	75	0	0
6	32609271	.	G	C	77	0	77	0	0	77	0	0
6	32609278	rs1142335	G	C	73	2	75	0	0	75	0	0
6	32609279	rs9272709	C	T	74	2	76	0	0	76	0	0
6	32609286	.	C	T	77	15	92	0	0	92	0	0
6	32609299	.	A	C	75	15	90	0	0	90	0	0
6	32609312	rs1129808	A	C	75	19	94	0	0	94	0	0
6	32609813	rs707951	T	C	77	23	100	0	1	101	0	0
6	32609855	rs1048173	A	C	83	7	90	0	0	90	0	0
6	32609873	rs707950	G	C	78	1	79	0	0	79	0	0
6	32610008	rs2308890	C	T	58	13	71	0	1	72	0	0
6	32610009	rs2308891	C	G	58	13	71	0	0	71	0	0
6	32610403	rs3188543	C	A	42	25	67	0	0	67	0	0
6	32610436	rs1048372	T	C	29	30	59	0	0	59	0	0
6	32610478	rs1048414	C	G	42	12	54	0	0	54	0	0
6	32610481	rs1048419	T	C	42	8	50	0	0	50	0	0
6	32610487	.	C	G	45	5	50	0	0	50	0	0
6	32610495	rs1048439	A	G	45	4	49	0	0	49	0	0
6	32610529	rs13379	A	G	5	45	50	0	0	50	0	0
6	32610535	rs1130116	A	C	47	2	49	0	0	49	0	0
6	32610553	rs3188642	G	A	51	1	52	0	0	52	0	0
6	32610556	rs1130117	G	A	53	0	53	0	1	54	0	0
6	32610557	rs28400568	G	A	52	0	52	0	1	53	0	0
6	32610736	rs9272865	G	A	51	0	51	0	0	51	0	0
6	32610747	rs9272871	G	C	46	0	46	0	0	46	0	0
6	32610751	rs28371168	A	G	41	0	41	0	1	42	0	0
6	32610806	rs9272896	T	C	42	0	42	0	0	42	0	0
6	32610809	rs9272899	C	T	44	0	44	0	1	45	0	0
6	32610819	rs28371169	C	G	43	0	43	0	0	43	0	0
6	32610825	rs7142	A	G	42	0	42	0	0	42	0	0
6	32610836	rs9272905	C	T	42	0	42	0	1	43	0	0
6	32610860	rs9272913	G	T	48	0	48	0	0	48	0	0
6	32610863	rs9272914	A	G	45	0	45	0	0	45	0	0
6	32610887	rs7143	C	T	0	39	39	0	0	39	0	0
6	32610892	rs9272917	A	G	40	0	40	0	0	40	0	0
6	32610893	rs9272918	C	A	41	0	41	0	0	41	0	0
6	32610934	rs3667	A	G	33	0	33	0	0	33	0	0
6	32610935	rs1130151	A	G	33	0	33	0	0	33	0	0
6	32610968	rs1130156	A	G	19	0	19	0	0	19	0	0
6	32610972	rs1130158	G	A	19	0	19	0	0	19	0	0
6	32613207	.	C	T	7	0	7	0	0	7	0	0
6	32613224	rs9273172	A	C	7	0	7	0	0	7	0	0
6	32613237	rs9273174	A	G	7	0	7	0	0	7	0	0
6	32614564	.	T	C	6	0	6	0	0	6	0	0
6	32627250	rs9273410	C	A	20	0	20	0	0	20	0	0
6	32627260	rs9273411	G	A	24	0	24	0	0	24	0	0
6	32627263	rs9273412	T	C	24	0	24	0	0	24	0	0
6	32627292	rs9273413	A	G	53	0	53	0	0	53	0	0
6	32627299	rs9273414	A	T	54	0	54	0	0	54	0	0
6	32627310	rs9273415	C	T	62	0	62	0	0	62	0	0
6	32627321	rs9273416	T	G	70	0	70	0	0	70	0	0
6	32627352	rs9273417	A	G	75	0	75	0	0	75	0	0
6	32627362	rs9273418	A	C	72	0	72	0	0	72	0	0
6	32627365	rs9273419	T	C	71	0	71	0	0	71	0	0
6	32627386	rs12918	C	T	112	0	112	0	0	112	0	0
6	32627394	rs9273424	C	T	125	0	125	0	1	126	0	0
6	32627396	rs9273425	C	T	128	0	128	0	0	128	0	0
6	32627405	rs1130455	C	G	0	120	120	0	1	121	0	0
6	32627434	rs9273426	A	C	128	0	128	0	1	129	0	0
6	32627441	rs9273427	A	C	128	0	128	0	0	128	0	0
6	32627450	rs1056318	G	A	130	0	130	0	0	130	0	0
6	32627460	rs9273430	T	G	120	0	120	0	1	121	0	0
6	32627485	rs9273432	T	C	106	0	106	0	1	107	0	0
6	32627489	rs9273433	A	G	104	0	104	0	2	106	0	0
6	32627517	rs9273436	T	G	108	0	108	0	1	109	0	0
6	32627522	.	C	T	98	0	98	0	0	98	0	0
6	32627523	rs9273438	A	G	95	0	95	0	0	95	0	0
6	32627527	rs1130451	C	A	0	85	85	0	2	87	0	0
6	32627535	rs28724234	G	T	104	0	104	0	0	104	0	0
6	32627573	rs9273441	C	G	108	0	108	0	2	110	0	0
6	32627600	rs9273443	G	T	111	0	111	0	2	113	0	0
6	32627617	rs1130446	C	T	0	76	76	0	1	77	0	0
6	32627627	rs34153824	C	T	0	73	73	0	1	74	0	0
6	32627635	rs9273444	T	G	105	0	105	0	1	106	0	0
6	32627646	rs9273445	A	G	108	0	108	0	0	108	0	0
6	32627700	rs6689	A	G	8	169	177	0	0	177	0	0
6	32627713	rs1049124	G	A	279	8	287	0	1	288	0	0
6	32627714	rs1063355	T	G	277	8	285	0	2	287	0	0
6	32627752	rs1049222	T	C	9	194	203	0	2	205	0	0
6	32627763	rs1049219	A	T	8	252	260	0	0	260	0	0
6	32627784	rs4993988	C	T	498	1	499	0	1	500	0	0
6	32627794	.	C	T	533	0	533	0	3	536	0	0
6	32627795	rs1766	A	G	530	0	530	0	2	532	0	0
6	32627798	rs1071641	C	T	0	473	473	0	3	476	0	0
6	32627812	rs9273453	C	G	577	0	577	0	5	582	0	0
6	32627830	rs9273455	C	T	667	0	667	0	1	668	0	0
6	32627833	rs1770	A	G	661	0	661	0	2	663	0	0
6	32627844	.	G	C	733	0	733	0	0	733	0	0
6	32627850	rs3210176	T	C	739	0	739	0	22	761	0	0
6	32627851	.	G	A	768	0	768	0	0	768	0	0
6	32627852	rs1130420	G	A	768	0	768	0	4	772	0	0
6	32627882	rs1071639	C	T	7	682	689	0	15	704	0	0
6	32627906	rs1063349	T	C	786	5	791	0	3	794	0	0
6	32627923	rs1063348	A	G	730	6	736	0	6	742	0	0
6	32627934	rs9273463	G	A	696	5	701	0	1	702	0	0
6	32627967	rs1063346	A	G	495	3	498	0	1	500	1	0
6	32627969	rs3204428	C	T	494	3	497	0	2	499	0	0
6	32627976	rs1063345	G	A	497	4	501	0	3	504	0	0
6	32627988	rs1049178	A	G	7	356	363	0	5	368	0	0
6	32627991	rs1049177	C	T	8	357	365	0	2	367	0	0
6	32627992	rs1063343	T	C	417	8	425	0	0	425	0	0
6	32628001	rs1049175	T	C	15	374	389	0	1	390	0	0
6	32628022	.	A	G	397	13	410	0	0	410	0	0
6	32628064	.	T	C	6	0	6	0	0	6	0	0
6	32628065	rs281864453	C	G	6	0	6	0	0	6	0	0
6	32628093	rs9273479	T	C	9	0	9	0	0	9	0	0
6	32628103	rs9273480	C	T	8	0	8	0	0	8	0	0
6	32628122	rs9273481	G	C	10	0	10	0	0	10	0	0
6	32628127	rs9273482	T	C	10	0	10	0	0	10	0	0
6	32628138	rs9273483	G	A	7	0	7	0	1	8	0	0
6	32628146	rs2647082	G	A	8	0	8	0	0	8	0	0
6	32628190	rs28396311	T	C	0	15	15	0	0	15	0	0
6	32628193	rs9273490	G	A	20	0	20	0	0	20	0	0
6	32628247	rs9273493	T	C	27	0	27	0	0	27	0	0
6	32628256	rs9273494	G	T	14	0	14	0	0	14	0	0
6	32628273	rs9273495	G	A	13	0	13	0	0	13	0	0
6	32628297	rs9273497	T	C	13	0	13	0	0	13	0	0
6	32628306	.	G	T	11	0	11	0	0	11	0	0
6	32628595	rs9273524	T	C	13	0	13	0	0	13	0	0
6	32628621	rs9273527	T	C	14	1	15	0	0	15	0	0
6	32628698	rs9273529	C	T	9	1	10	0	1	11	0	0
6	32628699	rs9273530	A	G	10	1	11	0	0	11	0	0
6	32628736	.	C	T	8	0	8	0	0	8	0	0
6	32628737	.	A	G	8	0	8	0	0	8	0	0
6	32628751	rs9273534	C	T	9	0	9	0	0	9	0	0
6	32628764	rs9273536	C	T	7	0	7	0	0	7	0	0
6	32628765	rs9273537	C	T	7	0	7	0	0	7	0	0
6	32628776	rs2854273	C	A	6	0	6	0	0	6	0	0
6	32628779	rs9273539	G	T	6	0	6	0	0	6	0	0
6	32628784	rs3020628	C	A	6	0	6	0	0	6	0	0
6	32629053	.	C	G	6	0	6	0	0	6	0	0
6	32629064	rs9273584	A	T	6	0	6	0	0	6	0	0
6	32629129	rs1130432	T	C	1	426	427	0	0	427	0	0
6	32629137	rs1140343	T	G	455	1	456	0	0	456	0	0
6	32629141	rs1140342	C	T	481	1	482	0	1	483	0	0
6	32629155	rs1130431	C	A	2	453	455	0	3	458	0	0
6	32629161	rs1130430	A	G	545	2	547	0	2	549	0	0
6	32629227	rs9273660	C	T	594	10	604	0	5	609	0	0
6	32629802	rs1049092	A	G	459	23	482	0	4	486	0	0
6	32629859	rs1049130	A	G	26	408	434	0	1	435	0	0
6	32629868	rs1049088	A	G	26	419	445	0	1	446	0	0
6	32629889	rs1049087	G	A	569	13	582	0	0	582	0	0
6	32629904	rs1049086	A	G	599	7	606	0	2	608	0	0
6	32629905	rs2647032	T	C	599	7	606	0	3	609	0	0
6	32629935	.	C	G	551	4	555	0	10	565	0	0
6	32629936	rs1049107	C	T	4	536	540	0	4	544	0	0
6	32629963	rs1049100	C	T	1	537	538	0	6	544	0	0
6	32630400	.	A	G	6	0	6	0	0	6	0	0
6	32630401	rs9274176	C	T	6	0	6	0	0	6	0	0
6	32630403	.	A	G	0	6	6	0	0	6	0	0
6	32630407	rs9274177	A	G	6	0	6	0	0	6	0	0
6	32630543	.	C	T	19	1	20	0	0	20	0	0
6	32630557	rs9274187	G	A	19	1	20	0	0	20	0	0
6	32630587	rs36174316	C	T	1	20	21	0	0	21	0	0
6	32630613	.	T	C	0	28	28	0	0	28	0	0
6	32630617	.	A	T	31	1	32	0	0	32	0	0
6	32630619	.	G	A	30	1	31	0	1	32	0	0
6	32630634	rs66615660	A	G	1	27	28	0	0	28	0	0
6	32630660	.	T	C	28	0	28	0	1	29	0	0
6	32630661	.	T	C	27	0	27	0	1	28	0	0
6	32630687	rs17613549	G	C	18	0	18	0	0	18	0	0
6	32630700	rs17843715	A	G	19	0	19	0	0	19	0	0
6	32630707	rs17843716	C	T	16	0	16	0	0	16	0	0
6	32630741	.	C	T	24	0	24	0	0	24	0	0
6	32630742	.	G	A	0	24	24	0	0	24	0	0
6	32630748	.	A	T	27	0	27	0	0	27	0	0
6	32630755	.	C	T	28	0	28	0	0	28	0	0
6	32630761	rs9274205	C	T	28	0	28	0	0	28	0	0
6	32630768	.	G	T	28	0	28	0	0	28	0	0
6	32630788	.	C	A	15	0	15	0	0	15	0	0
6	32630794	rs9274207	A	G	14	0	14	0	0	14	0	0
6	32630797	rs71542441	G	A	0	14	14	0	0	14	0	0
6	32630814	.	G	C	10	0	10	0	0	10	0	0
6	32630843	rs17843719	T	A	16	0	16	0	0	16	0	0
6	32630856	.	C	T	18	0	18	0	0	18	0	0
6	32630862	.	G	A	19	0	19	0	0	19	0	0
6	32630922	.	T	A	7	0	7	0	0	7	0	0
6	32630996	rs17613599	C	T	7	0	7	0	0	7	0	0
6	32630999	rs71542448	A	T	0	7	7	0	0	7	0	0
6	32631038	rs17613606	A	G	13	0	13	0	0	13	0	0
6	32631057	.	T	C	14	0	14	0	0	14	0	0
6	32631065	.	C	T	14	0	14	0	0	14	0	0
6	32631079	.	G	A	0	11	11	0	0	11	0	0
6	32631086	.	G	A	16	0	16	0	0	16	0	0
6	32631104	rs74222206	A	G	0	15	15	0	0	15	0	0
6	32631107	.	G	A	18	0	18	0	0	18	0	0
6	32631109	.	A	T	18	0	18	0	0	18	0	0
6	32631116	.	A	T	0	18	18	0	0	18	0	0
6	32631122	.	A	G	18	1	19	0	0	19	0	0
6	32631129	rs17613629	T	C	19	0	19	0	0	19	0	0
6	32631130	rs17613636	G	A	19	0	19	0	0	19	0	0
6	32631343	.	T	C	18	0	18	0	0	18	0	0
6	32631348	.	G	A	19	0	19	0	0	19	0	0
6	32631375	rs66812757	A	C	0	19	19	0	0	19	0	0
6	32631397	rs36229770	A	C	0	19	19	0	0	19	0	0
6	32631418	rs17613643	A	G	20	0	20	0	0	20	0	0
6	32631426	.	G	A	17	0	17	0	0	17	0	0
6	32631446	.	A	G	0	7	7	0	0	7	0	0
6	32631448	.	A	G	8	0	8	0	1	9	0	0
6	32631449	.	T	C	0	7	7	0	0	7	0	0
6	32631456	.	G	T	0	8	8	0	0	8	0	0
6	32631490	.	G	A	13	0	13	0	0	13	0	0
6	32631496	.	C	A	18	0	18	0	0	18	0	0
6	32631499	.	G	A	18	0	18	0	0	18	0	0
6	32631547	.	G	C	15	0	15	0	0	15	0	0
6	32631553	.	G	A	2	9	11	0	0	11	0	0
6	32631568	rs113192023	T	C	0	10	10	0	0	10	0	0
6	32631584	.	T	C	12	0	12	0	1	13	0	0
6	32631600	rs66924243	C	T	0	9	9	0	0	9	0	0
6	32632286	.	C	T	11	0	11	0	0	11	0	0
6	32632287	rs9274336	A	G	11	0	11	0	0	11	0	0
6	32632303	.	G	A	10	0	10	0	0	10	0	0
6	32632310	rs9274338	G	A	9	0	9	0	0	9	0	0
6	32632319	rs9274339	G	A	7	0	7	0	0	7	0	0
6	32632326	.	G	A	7	0	7	0	0	7	0	0
6	32632748	.	T	A	236	0	236	0	3	239	0	0
6	32632749	.	A	T	232	0	232	0	0	232	0	0
6	32632753	.	C	T	219	1	220	0	1	221	0	0
6	32632769	.	T	C	162	4	166	0	1	167	0	0
6	32632775	.	G	C	57	7	64	0	1	65	0	0
6	32632781	.	A	C	13	33	46	0	0	46	0	0
6	32632782	.	G	C	12	33	45	0	1	46	0	0
6	32632783	rs1140310	A	C	13	33	46	0	0	46	0	0
6	32632795	.	C	T	290	16	306	0	1	307	0	0
6	32632818	rs1130368	T	G	19	291	310	0	2	312	0	0
6	32633282	rs9274447	T	C	8	1	9	0	0	9	0	0
6	32633290	rs9274449	G	C	8	1	9	0	0	9	0	0
6	32633355	.	G	T	8	0	8	0	0	8	0	0
6	32633356	.	T	G	8	0	8	0	0	8	0	0
6	32633369	rs9274453	C	A	8	0	8	0	0	8	0	0
6	32633375	rs9274455	A	G	6	0	6	0	1	7	0	0
6	32633380	rs281861581	G	A	7	0	7	0	0	7	0	0
6	32633392	rs9274457	C	G	7	0	7	0	0	7	0	0
6	32633558	rs34230758	A	G	1	5	6	0	0	6	0	0
6	32634024	rs9274500	T	A	10	0	10	0	0	10	0	0
6	32634032	rs9274501	A	G	8	0	8	0	0	8	0	0
6	32634073	rs72844397	G	A	0	7	7	0	0	7	0	0
6	32634126	rs9274505	G	A	6	0	6	0	0	6	0	0
6	32634141	rs9274506	T	C	6	0	6	0	0	6	0	0
6	32634170	rs9274509	G	A	7	0	7	0	0	7	0	0
6	32634184	rs9274510	A	G	7	0	7	0	0	7	0	0
6	32634188	rs67955939	T	C	0	6	6	0	0	6	0	0
6	32634189	.	C	T	6	0	6	0	0	6	0	0
6	32634209	.	A	G	7	0	7	0	0	7	0	0
6	32634226	rs68033958	G	A	0	6	6	0	0	6	0	0
6	32634243	rs9274514	G	A	8	0	8	0	0	8	0	0
6	32634300	.	G	C	361	1	362	0	1	363	0	0
6	32634303	rs1049061	G	A	1	290	291	0	2	293	0	0
6	32634306	.	A	T	336	1	337	0	0	338	1	0
6	32634313	rs1049059	C	G	1	349	350	0	0	350	0	0
6	32634318	rs3891176	C	A	457	1	458	0	1	459	0	0
6	32634331	.	G	C	495	0	495	0	0	495	0	0
6	32634341	rs3189152	A	G	499	2	501	0	0	501	0	0
6	32634350	rs1049057	T	C	490	3	493	0	1	494	0	0
6	32634369	rs1049056	C	A	3	266	269	0	3	272	0	0
6	32634373	rs9274522	C	T	271	3	274	0	0	274	0	0
6	32634426	rs67147537	G	A	3	21	24	0	0	24	0	0
6	32709204	rs9276401	G	C	9	0	9	0	0	9	0	0
6	32713018	rs17213281	C	T	14	0	14	0	0	14	0	0
6	32727002	rs376789262	A	G	0	13	13	0	0	13	0	0
6	32727014	.	C	T	20	1	21	0	0	21	0	0
6	32802938	rs140654840	C	T	60	42	102	0	0	102	0	0
6	32809582	rs60507022	G	T	9	8	17	0	0	17	0	0
6	32813161	rs8842	G	C	129	149	278	0	0	278	0	0
6	32813756	rs9469283	G	A	17	11	28	0	0	28	0	0
6	32813852	rs13215	C	A	12	8	20	0	0	20	0	0
6	32813864	rs11257	C	A	12	10	22	0	0	22	0	0
6	32814113	rs11540142	G	A	7	8	15	0	0	15	0	0
6	32814942	rs1057149	C	T	109	123	232	0	1	233	0	0
6	32814975	rs1135216	T	C	110	121	231	0	0	231	0	0
6	32815025	rs111511638	G	A	6	6	12	0	1	13	0	0
6	32816028	rs17213826	C	T	2	5	7	0	0	7	0	0
6	32816137	rs17220220	C	T	2	5	7	0	0	7	0	0
6	32816772	rs41550019	C	A	59	94	153	0	2	155	0	0
6	32816998	rs12527715	T	C	5	1	6	0	0	6	0	0
6	32817130	rs12529313	A	G	6	2	8	0	1	9	0	0
6	32818453	rs56016827	G	A	12	4	16	0	0	16	0	0
6	32818774	rs1057141	T	C	69	52	121	0	0	121	0	0
6	32826233	rs20547	A	G	115	111	226	0	1	227	0	0
6	32902583	rs10751	G	A	116	113	229	0	3	232	0	0
6	32903637	rs23544	C	T	16	21	37	0	0	37	0	0
6	32903724	rs68600	C	T	16	25	41	0	0	41	0	0
6	32904601	rs2071556	G	T	6	7	13	0	0	13	0	0
6	32904661	rs171329	G	A	6	9	15	0	0	15	0	0
6	32917544	rs1063478	C	T	937	766	1703	0	38	1741	0	0
6	32938911	rs79643712	C	T	23	13	36	0	0	36	0	0
6	32941127	rs12196639	G	C	6	3	9	0	0	9	0	0
6	32941214	rs12196597	C	A	5	3	8	0	0	8	0	0
6	32941853	rs186629068	C	T	6	3	9	0	0	9	0	0
6	32972162	rs17214148	C	T	13	28	41	0	0	41	0	0
6	32972887	rs376892	G	A	25	32	57	0	2	59	0	0
6	32973281	rs416622	T	C	17	2	19	0	0	19	0	0
6	32973743	rs3129304	C	T	22	8	30	0	0	30	0	0
6	32973748	rs142575366	A	G	8	20	28	0	0	28	0	0
6	32973878	rs3129303	C	T	14	9	23	0	0	23	0	0
6	32974081	rs417812	C	T	20	7	27	0	0	27	0	0
6	32974268	rs408036	T	C	21	11	32	0	0	32	0	0
6	32974401	rs2581	G	T	18	11	29	0	0	29	0	0
6	32974934	rs378352	G	A	9	8	17	0	0	17	0	0
6	32975257	rs365066	C	T	17	12	29	0	0	29	0	0
6	32975869	rs375256	G	A	13	4	17	0	0	17	0	0
6	32977315	rs403414	A	G	4	7	11	0	0	11	0	0
6	33035860	rs2301225	G	A	179	120	299	0	2	301	0	0
6	33044956	rs6934289	T	C	4	11	15	0	0	15	0	0
6	33044987	rs6415133	A	G	4	10	14	0	0	14	0	0
6	33045147	rs2213307	A	T	6	2	8	0	0	8	0	0
6	33045208	rs2213308	T	C	7	3	10	0	0	10	0	0
6	33045255	rs2213309	T	C	10	6	16	0	0	16	0	0
6	33045272	rs6457711	C	A	8	4	12	0	0	12	0	0
6	33045558	rs3135021	G	A	9	7	16	0	0	16	0	0
6	33045934	rs2856817	G	A	1	13	14	0	0	14	0	0
6	33045949	rs2856818	G	A	1	14	15	0	0	15	0	0
6	33045966	rs3135022	G	A	3	11	14	0	0	14	0	0
6	33046082	rs2856819	C	T	5	15	20	0	0	20	0	0
6	33046083	rs2856820	C	T	5	15	20	0	0	20	0	0
6	33046662	rs2567279	T	C	8	14	22	0	0	22	0	0
6	33048542	rs1042121	C	T	1136	1547	2683	0	18	2702	1	0
6	33048599	rs707958	C	A	1266	1615	2881	0	16	2899	2	0
6	33048602	rs1042131	C	A	1263	1579	2842	0	12	2856	2	0
6	33050196	rs9277376	G	C	8	9	17	0	1	18	0	0
6	33050203	rs9277377	C	G	10	7	17	0	0	17	0	0
6	33050223	rs6899657	G	A	11	8	19	0	1	20	0	0
6	33052981	rs14362	C	A	1528	1641	3169	0	26	3195	0	0
6	33161661	rs1050673	A	G	37	55	92	0	1	93	0	0
6	33162215	rs2744537	A	C	43	45	88	0	2	90	0	0
6	33162228	rs5030979	A	T	45	40	85	0	2	87	0	0
6	33163451	rs6531	G	A	30	51	81	0	1	82	0	0
6	33169839	rs41266701	C	A	3	6	9	0	0	9	0	0
6	33269881	rs35404844	T	G	5	6	11	0	0	11	0	0
6	33366439	.	C	T	7	6	13	0	0	13	0	0
6	33540692	rs210135	T	A	268	78	346	0	11	357	0	0
6	33541507	rs511515	A	G	144	104	248	0	19	267	0	0
6	33541719	rs513349	A	G	16	10	26	0	1	27	0	0
6	33589332	rs55774724	C	T	5	1	6	0	0	6	0	0
6	33600014	rs4713644	T	C	3	6	9	0	1	10	0	0
6	33643558	rs2229637	G	A	6	7	13	0	0	13	0	0
6	33660411	rs653536	T	C	6	3	9	0	0	9	0	0
6	33662667	rs684119	C	T	8	8	16	0	0	16	0	0
6	33739508	rs111603344	G	C	27	35	62	0	0	62	0	0
6	33739960	rs10947436	A	G	28	21	49	0	1	50	0	0
6	33741289	rs6904716	A	G	14	8	22	0	0	22	0	0
6	33741716	rs4711350	A	G	3	8	11	0	0	11	0	0
6	33742193	rs6910736	C	T	9	1	10	0	0	10	0	0
6	33742331	rs10755683	T	C	9	3	12	0	0	12	0	0
6	33742838	rs751096	T	C	8	5	13	0	0	13	0	0
6	33743174	rs2395447	T	C	6	6	12	0	0	12	0	0
6	33743264	rs2395446	C	T	3	7	10	0	0	10	0	0
6	33743651	rs943473	G	C	5	6	11	0	0	11	0	0
6	33755541	rs756139	G	A	4	4	8	0	0	8	0	0
6	34249203	rs1060308	A	T	16	28	44	0	0	44	0	0
6	34249341	rs62399870	T	C	18	29	47	0	0	47	0	0
6	34249546	rs16883137	G	A	20	18	38	0	0	38	0	0
6	34250083	rs10648	A	G	27	18	45	0	1	46	0	0
6	34250167	rs13466	G	A	24	8	32	0	0	32	0	0
6	34250202	rs12654	T	C	17	14	31	0	0	31	0	0
6	34251452	rs17628798	C	T	14	18	32	0	0	32	0	0
6	34251832	rs16883475	C	T	8	12	20	0	1	21	0	0
6	34251905	rs41269032	G	A	14	7	21	0	0	21	0	0
6	34252352	rs6691	C	T	5	5	10	0	1	11	0	0
6	34252493	rs1265	G	C	9	12	21	0	1	22	0	0
6	34253511	rs75986867	A	G	10	8	18	0	0	18	0	0
6	34253877	rs6907486	A	G	4	5	9	0	3	12	0	0
6	34254050	rs41269034	G	C	7	8	15	0	0	15	0	0
6	34254059	rs41269036	T	C	4	8	12	0	0	12	0	0
6	34255476	rs206942	T	C	14	24	38	0	0	38	0	0
6	34255631	rs16883896	C	A	13	16	29	0	0	30	1	0
6	34255730	rs79043103	A	T	9	6	15	0	0	15	0	0
6	34285609	rs17629180	A	G	10	9	19	0	0	19	0	0
6	34287312	rs77190418	T	C	3	3	6	0	0	6	0	0
6	34387216	rs6924482	G	A	6	2	8	0	0	8	0	0
6	34388600	rs9469778	G	A	5	3	8	0	0	8	0	0
6	34389181	rs1811968	G	A	5	1	6	0	0	6	0	0
6	34389213	rs1811967	G	A	5	2	7	0	0	7	0	0
6	34393845	rs9469779	G	A	26	46	72	0	0	72	0	0
6	34393866	rs78454682	G	A	22	5	27	0	1	28	0	0
6	34573071	rs9461991	G	A	5	2	7	0	1	8	0	0
6	34573213	rs2814975	C	T	6	4	10	0	0	10	0	0
6	34573940	rs36032186	A	G	36	30	66	0	0	66	0	0
6	34577776	rs2814978	T	A	17	7	24	0	0	24	0	0
6	34655000	rs2744961	C	T	16	8	24	0	1	25	0	0
6	34656722	rs2814949	A	G	3	7	10	0	0	10	0	0
6	34725478	rs7743724	G	A	52	20	72	0	2	74	0	0
6	34725658	.	G	T	48	22	70	0	0	72	2	0
6	34729162	rs7341329	A	G	3	3	6	0	0	6	0	0
6	34729848	rs9469862	A	G	3	3	6	0	0	6	0	0
6	34739649	rs9469863	A	G	1	7	8	0	0	8	0	0
6	34741094	rs11968972	G	A	4	4	8	0	0	8	0	0
6	34741174	rs11968954	C	T	1	5	6	0	0	6	0	0
6	34759954	rs6457791	A	G	15	8	23	0	0	23	0	0
6	34760736	rs11757370	T	C	3	3	6	0	0	6	0	0
6	34761809	rs6942040	A	C	2	11	13	0	0	13	0	0
6	34803947	rs4259246	C	T	54	33	87	0	0	87	0	0
6	34804204	rs7761391	C	T	34	14	48	0	0	48	0	0
6	34804515	rs7743949	T	C	28	27	55	0	0	55	0	0
6	34824636	rs11755393	A	G	15	14	29	0	1	30	0	0
6	34831856	rs13205210	T	C	23	10	33	0	0	33	0	0
6	34831866	rs3734264	G	A	19	8	27	0	0	27	0	0
6	34842192	rs11969436	C	T	33	24	57	0	0	57	0	0
6	34845449	rs4646949	T	G	4	2	6	0	0	6	0	0
6	34850660	rs4646933	G	A	8	9	17	0	1	18	0	0
6	34850826	rs15922	G	C	92	88	180	0	2	182	0	0
6	34851211	rs13198340	C	T	5	16	21	0	0	21	0	0
6	34852150	rs4646930	A	G	7	4	11	0	0	11	0	0
6	34852253	rs4646926	G	T	6	4	10	0	0	10	0	0
6	34852891	rs57951780	C	T	5	3	8	0	0	8	0	0
6	34853020	.	T	C	6	2	8	0	0	8	0	0
6	34855748	rs1051115	G	C	55	52	107	0	0	107	0	0
6	34985558	rs62402705	C	G	5	4	9	0	0	9	0	0
6	35050506	rs2177382	G	A	6	6	12	0	0	12	0	0
6	35056852	rs66753029	C	T	8	8	16	0	0	16	0	0
6	35056862	rs57111149	T	C	8	7	15	0	0	15	0	0
6	35057479	rs17610836	C	T	10	11	21	0	0	21	0	0
6	35058531	rs11552398	C	T	11	21	32	0	0	32	0	0
6	35284939	rs36053978	A	G	25	26	51	0	2	53	0	0
6	35423662	rs4713867	A	C	6	8	14	0	0	14	0	0
6	35436925	rs2076172	C	T	159	217	376	0	3	379	0	0
6	35614026	rs4713902	T	C	9	15	24	0	0	24	0	0
6	35656655	.	G	A	3	10	13	0	0	13	0	0
6	36064036	rs851007	G	A	7	2	9	0	0	9	0	0
6	36069489	rs851005	A	G	10	5	15	0	0	15	0	0
6	36076934	rs3804452	G	A	77	73	150	0	1	151	0	0
6	36275458	rs4713956	T	C	4	2	6	0	0	6	0	0
6	36430588	rs6457920	A	G	4	3	7	0	0	7	0	0
6	36446975	rs2239808	G	C	64	61	125	0	1	126	0	0
6	36449676	rs3756912	C	T	42	45	87	0	1	88	0	0
6	36455838	rs41272166	C	T	87	100	187	0	0	187	0	0
6	36457018	rs2146333	C	A	111	67	178	0	1	179	0	0
6	36457354	rs1191	C	T	179	158	337	0	2	339	0	0
6	36457484	rs1061632	T	C	140	122	262	0	1	263	0	0
6	36458394	.	G	A	163	196	359	0	3	362	0	0
6	36458568	rs1137628	C	T	217	195	412	0	4	416	0	0
6	36462007	rs4598	G	A	22	39	61	0	2	63	0	0
6	36466492	rs141874722	G	A	7	4	11	0	0	11	0	0
6	36466524	rs9470293	C	G	4	8	12	0	0	12	0	0
6	36466668	rs9470294	T	C	3	4	7	0	0	7	0	0
6	36466787	rs4713978	C	A	4	4	8	0	2	10	0	0
6	36483390	rs7738604	G	A	1	5	6	0	0	6	0	0
6	36515040	rs45524837	G	C	13	14	27	0	0	27	0	0
6	36565161	rs183588637	G	A	8	4	12	0	0	12	0	0
6	36565440	.	G	T	12	8	20	0	1	21	0	0
6	36566575	rs9368943	C	T	6	10	16	0	0	16	0	0
6	36570366	rs7344	T	C	1236	1161	2397	0	11	2408	0	0
6	36573065	rs189489635	G	A	3	3	6	0	0	6	0	0
6	36647463	rs3176329	T	G	5	4	9	0	0	9	0	0
6	36654351	rs6457937	T	C	386	404	790	0	3	793	0	0
6	36686272	rs236487	C	T	31	23	54	0	2	56	0	0
6	36686407	rs236486	C	T	7	3	10	0	0	10	0	0
6	36686746	rs236485	G	A	4	6	10	0	0	10	0	0
6	36687301	rs236484	A	T	19	26	45	0	0	45	0	0
6	36687518	rs236483	T	C	21	34	55	0	0	55	0	0
6	36687592	rs236482	A	G	22	37	59	0	0	59	0	0
6	36687809	rs236481	A	G	21	24	45	0	1	46	0	0
6	36688006	rs236480	A	C	11	16	27	0	0	27	0	0
6	36688729	rs129546	T	C	9	12	21	0	0	21	0	0
6	36689030	rs236478	A	C	49	54	103	0	2	105	0	0
6	36689630	rs236477	C	T	67	62	129	0	2	131	0	0
6	36689961	rs183541	A	C	47	61	108	0	3	111	0	0
6	36824399	rs2071823	C	T	18	21	39	0	1	40	0	0
6	36882353	rs2272275	A	G	27	32	59	0	0	59	0	0
6	36891644	rs2280675	T	C	20	21	41	0	0	41	0	0
6	36892221	rs3074	A	G	25	24	49	0	1	50	0	0
6	36892571	rs41272192	C	G	14	8	22	0	1	23	0	0
6	36894685	rs59892114	G	A	4	6	10	0	0	10	0	0
6	36895835	rs1046578	C	T	17	4	21	0	0	21	0	0
6	36936640	rs1042987	G	A	610	587	1197	0	18	1215	0	0
6	36936771	rs7772210	A	G	191	156	347	0	5	352	0	0
6	36939213	rs3778027	C	T	15	13	28	0	0	28	0	0
6	36939279	rs3778026	C	A	19	19	38	0	1	39	0	0
6	36940137	rs62406526	C	T	18	14	32	0	0	32	0	0
6	36940273	rs6918432	G	A	17	18	35	0	0	35	0	0
6	36940343	rs2293383	G	C	11	8	19	0	0	19	0	0
6	36940805	rs831506	T	C	17	14	31	0	0	31	0	0
6	36941816	rs17624546	C	T	15	5	20	0	0	20	0	0
6	36942232	rs76813240	T	C	11	10	21	0	1	22	0	0
6	36942265	rs76137088	T	A	14	8	22	0	0	22	0	0
6	36942274	rs748409	C	G	14	6	20	0	0	20	0	0
6	36942417	rs748406	G	A	12	11	23	0	0	23	0	0
6	36942481	rs748407	A	G	8	13	21	0	1	22	0	0
6	36942746	rs748408	C	T	3	3	6	0	0	6	0	0
6	36942928	rs745506	A	G	7	16	23	0	0	23	0	0
6	36942979	rs745505	T	C	8	14	22	0	0	22	0	0
6	36943513	rs2293385	G	C	4	3	7	0	0	7	0	0
6	36943573	rs2293386	A	G	3	6	9	0	0	9	0	0
6	36943605	rs2293387	A	G	4	6	10	0	0	10	0	0
6	36943691	rs6927651	T	C	3	3	6	0	0	6	0	0
6	36943787	rs6905093	A	G	1	8	9	0	0	9	0	0
6	36943911	rs6909984	G	A	4	6	10	0	0	10	0	0
6	36943923	rs6909991	G	C	5	6	11	0	0	11	0	0
6	36944554	rs3778024	C	T	7	3	10	0	0	10	0	0
6	36945062	rs2293388	G	C	5	5	10	0	0	10	0	0
6	36946948	rs3798478	C	T	4	4	8	0	0	8	0	0
6	36948035	rs17624895	A	T	3	7	10	0	0	10	0	0
6	36948246	rs3778022	C	T	5	1	6	0	0	6	0	0
6	37142422	rs10507	C	T	1134	1129	2263	0	33	2296	0	0
6	37339017	rs761737	A	G	2	5	7	0	0	7	0	0
6	37349033	rs2284922	G	A	3	23	26	0	0	26	0	0
6	37359008	.	T	G	2	5	7	0	0	7	0	0
6	37443950	rs9462313	G	A	53	49	102	0	1	103	0	0
6	37445079	rs10947673	C	T	7	2	9	0	0	9	0	0
6	37445101	rs11756241	C	T	6	3	9	0	0	9	0	0
6	37447994	rs1874736	C	G	62	56	118	0	1	119	0	0
6	37448763	rs112485104	G	A	69	71	140	0	1	141	0	0
6	37609741	rs804831	C	T	4	3	7	0	1	8	0	0
6	37619520	rs6906090	T	C	2	4	6	0	0	6	0	0
6	37619830	rs62398393	G	A	7	7	14	0	0	14	0	0
6	37623626	rs13204070	C	T	10	10	20	0	0	20	0	0
6	37626142	rs2273110	C	T	11	9	20	0	1	21	0	0
6	37876234	rs189984818	C	G	7	7	14	0	0	14	0	0
6	38136784	rs877527	T	C	2	5	7	0	0	7	0	0
6	38137814	rs3749926	G	A	5	6	11	0	0	11	0	0
6	38138333	rs2092426	G	A	5	4	9	0	0	9	0	0
6	38138378	rs742539	G	A	6	6	12	0	0	12	0	0
6	38139032	rs77404969	G	A	5	7	12	0	0	12	0	0
6	38139482	rs13198420	T	C	13	10	23	0	1	24	0	0
6	38139500	rs13212638	A	G	8	11	19	0	0	19	0	0
6	38139647	.	A	T	0	7	7	0	0	7	0	0
6	38139650	.	A	T	0	7	7	0	0	7	0	0
6	38139653	.	A	T	0	7	7	0	0	7	0	0
6	38139748	rs12206712	T	C	6	12	18	0	0	18	0	0
6	38139938	rs9470806	G	A	12	13	25	0	0	25	0	0
6	38139945	rs9470807	A	G	12	12	24	0	0	24	0	0
6	38140505	rs737171	A	G	11	10	21	0	0	21	0	0
6	38140658	rs909998	C	T	10	12	22	0	0	22	0	0
6	38140755	rs761153	C	G	7	12	19	0	0	19	0	0
6	38141022	rs735117	G	A	12	9	21	0	0	21	0	0
6	38141788	rs12203433	C	T	11	6	17	0	0	17	0	0
6	38644314	.	A	G	146	162	308	0	4	313	1	0
6	38650628	rs4746	T	G	186	139	325	0	1	326	0	0
6	38670837	rs1049346	G	A	82	65	147	0	4	151	0	0
6	39072334	rs41273118	T	A	8	8	16	0	0	16	0	0
6	39072681	rs7696	A	G	7	7	14	0	0	14	0	0
6	39082805	.	G	T	4	4	8	0	0	8	0	0
6	41176759	rs11962624	C	T	6	4	10	0	0	10	0	0
6	41185458	rs9367097	A	C	6	4	10	0	0	10	0	0
6	41203656	rs6907621	G	A	5	5	10	0	0	10	0	0
6	41203796	rs12527692	A	G	3	3	6	0	0	6	0	0
6	41204049	rs9394776	C	T	7	2	9	0	0	9	0	0
6	41204092	rs9349185	C	T	5	2	7	0	0	7	0	0
6	41204094	rs9394777	C	G	5	2	7	0	0	7	0	0
6	41204329	rs9349186	A	T	5	3	8	0	0	8	0	0
6	41204805	rs13200807	G	A	1	5	6	0	0	6	0	0
6	41205157	rs13204001	C	G	3	4	7	0	1	8	0	0
6	41205235	rs13204353	G	A	6	4	10	0	0	10	0	0
6	41235712	rs114128304	T	C	109	63	172	0	2	174	0	0
6	41236112	rs10947956	C	G	20	13	33	0	0	33	0	0
6	41236426	rs11758363	A	T	19	20	39	0	1	40	0	0
6	41236503	.	G	A	13	10	23	0	1	24	0	0
6	41238833	rs11755124	C	A	12	7	19	0	0	19	0	0
6	41239644	rs2062323	C	T	5	5	10	0	0	10	0	0
6	41239822	rs4714447	C	T	9	10	19	0	0	19	0	0
6	41240171	rs16894387	A	C	11	8	19	0	0	19	0	0
6	41241403	rs17701319	G	T	61	50	111	0	1	112	0	0
6	41242200	rs9471531	A	G	58	79	137	0	2	139	0	0
6	41247791	rs115985878	A	G	9	8	17	0	0	17	0	0
6	41250179	rs2234239	C	T	489	420	909	0	6	915	0	0
6	41491923	rs76937544	G	A	2	4	6	0	0	6	0	0
6	41621319	rs116296557	T	A	10	12	22	0	0	22	0	0
6	41753084	rs9394831	C	T	7	11	18	0	0	18	0	0
6	41754576	rs9381093	C	T	11	7	18	0	0	18	0	0
6	41755410	rs9471653	C	G	52	45	97	0	5	102	0	0
6	41757836	rs8393	C	A	5	7	12	0	0	12	0	0
6	41759846	rs3827633	A	C	3	4	7	0	0	7	0	0
6	41888827	rs2274578	C	G	6	7	13	0	0	13	0	0
6	41903782	rs1051130	A	C	466	444	910	0	4	914	0	0
6	41905275	rs3218097	G	A	5	1	6	0	0	6	0	0
6	41906661	rs3218092	A	G	1	5	6	0	0	6	0	0
6	41907855	rs1410492	G	C	7	8	15	0	0	15	0	0
6	42025402	rs1134218	A	G	23	37	60	0	0	60	0	0
6	42070391	rs150996206	C	T	5	1	6	0	0	6	0	0
6	42174558	rs4714580	A	G	14	15	29	0	0	29	0	0
6	42174611	rs8850	G	T	34	40	74	0	1	75	0	0
6	42174984	rs9381159	C	T	45	48	93	0	2	95	0	0
6	42175063	rs3199639	A	G	50	59	109	0	0	109	0	0
6	42175221	rs3199638	A	G	49	65	114	0	3	117	0	0
6	42175268	rs6929797	G	A	48	68	116	0	1	117	0	0
6	42175927	rs11618	G	A	48	59	107	0	1	108	0	0
6	42176120	rs2295278	G	T	1	5	6	0	0	6	0	0
6	42194235	rs4424082	T	A	9	13	22	0	0	22	0	0
6	42194286	rs60843126	C	T	17	12	29	0	0	29	0	0
6	42194440	rs9394889	C	A	10	20	30	0	0	30	0	0
6	42194916	rs722269	T	C	24	21	45	0	0	45	0	0
6	42532102	rs3749897	C	T	110	78	188	0	2	190	0	0
6	42627430	rs6916713	C	T	23	17	40	0	0	40	0	0
6	42627434	rs6917033	G	A	24	17	41	0	0	41	0	0
6	42659979	rs394754	T	G	2	6	8	0	0	8	0	0
6	42660017	rs9394917	A	G	9	4	13	0	0	13	0	0
6	42660655	rs423137	G	A	16	11	27	0	0	27	0	0
6	42751374	rs3800290	G	T	8	6	14	0	0	14	0	0
6	42751457	rs3800291	C	T	6	5	11	0	0	11	0	0
6	42751778	rs13198778	C	T	6	7	13	0	0	13	0	0
6	42758850	rs3737097	T	C	5	5	10	0	1	11	0	0
6	42835487	rs7764865	C	T	18	13	31	0	0	31	0	0
6	42847952	rs2235833	G	A	1	5	6	0	1	7	0	0
6	42848071	rs2073155	A	G	2	4	6	0	0	6	0	0
6	42850659	rs2395938	C	A	2	5	7	0	0	7	0	0
6	42855043	rs113105795	G	A	102	114	216	0	3	219	0	0
6	42856141	.	A	C	74	65	139	0	0	139	0	0
6	42897074	rs2234185	T	C	5	4	9	0	0	9	0	0
6	42897956	rs12529169	T	G	7	8	15	0	0	15	0	0
6	42899195	rs111816896	G	A	7	2	9	0	0	9	0	0
6	42900149	rs3793024	G	A	5	3	8	0	1	9	0	0
6	42902508	rs3763236	T	C	5	9	14	0	0	14	0	0
6	42903763	rs1053538	C	G	141	123	264	0	4	268	0	0
6	42903766	rs1053539	T	G	145	116	261	0	1	262	0	0
6	42904274	rs6458312	G	T	3	5	8	0	1	9	0	0
6	42904948	rs12525851	G	A	7	6	13	0	0	13	0	0
6	42905235	rs9471968	A	G	3	7	10	0	0	10	0	0
6	42908124	rs112786661	G	A	14	6	20	0	0	20	0	0
6	42909099	rs112836440	A	T	9	4	13	0	0	13	0	0
6	42915361	rs142793391	A	G	1	8	9	0	0	9	0	0
6	42931754	rs736158	G	A	13	6	19	0	1	20	0	0
6	42933526	rs2274515	C	T	19	31	50	0	1	51	0	0
6	42945034	rs12524654	A	G	10	4	14	0	0	14	0	0
6	42945921	rs76043831	C	G	7	1	8	0	0	8	0	0
6	43017190	rs141065679	C	T	13	14	27	0	1	28	0	0
6	43109751	rs6905948	G	A	36	26	62	0	0	62	0	0
6	43114426	.	C	T	41	26	67	0	1	68	0	0
6	43273604	rs2242416	A	G	8	0	8	0	0	8	0	0
6	43304798	rs74725336	T	C	18	43	61	0	0	61	0	0
6	43400342	rs45535935	T	G	1	5	6	0	0	6	0	0
6	43412865	rs2125739	T	C	7	4	11	0	0	11	0	0
6	43469669	.	T	A	7	3	10	0	0	10	0	0
6	43473884	rs72857288	A	C	41	47	88	0	1	89	0	0
6	43473999	rs116653268	T	A	60	50	110	0	0	110	0	0
6	43633417	rs116146896	G	A	3	3	6	0	0	6	0	0
6	43737983	rs186369938	G	C	8	12	20	0	0	20	0	0
6	43738350	rs2010963	C	G	36	45	81	0	1	82	0	0
6	43740094	rs1885657	T	C	2	4	6	0	0	6	0	0
6	43745577	rs3024998	C	T	11	7	18	0	0	18	0	0
6	43747371	rs3025007	C	T	8	5	13	0	0	13	0	0
6	43747450	rs3025009	G	A	7	5	12	0	0	12	0	0
6	43748795	rs3025018	C	T	4	4	8	0	0	8	0	0
6	43749163	rs3025021	T	C	4	5	9	0	0	9	0	0
6	43749230	rs3025022	C	T	4	9	13	0	0	13	0	0
6	43750551	rs3025028	C	G	6	6	12	0	0	12	0	0
6	43751037	rs3025032	T	C	7	2	9	0	0	9	0	0
6	43751669	rs3025036	G	C	4	6	10	0	0	10	0	0
6	43753212	rs10434	A	G	178	175	353	0	1	354	0	0
6	44081718	rs6883	G	A	103	65	168	0	4	172	0	0
6	44115169	rs4714759	G	A	21	15	36	0	1	37	0	0
6	44117607	rs4714761	C	T	15	14	29	0	0	29	0	0
6	44117664	rs4714762	C	T	14	13	27	0	1	28	0	0
6	44119338	rs3734695	C	T	3	5	8	0	0	8	0	0
6	44119676	rs3734697	A	G	5	11	16	0	0	16	0	0
6	44121216	rs3813502	T	C	4	2	6	0	0	6	0	0
6	44147821	rs34710081	A	G	20	22	42	0	0	42	0	0
6	44215713	.	C	T	10	6	16	0	0	16	0	0
6	44215784	rs34124063	A	T	8	20	28	0	1	29	0	0
6	44215785	rs34789835	G	C	8	21	29	0	0	29	0	0
6	44215786	rs34451930	A	G	8	21	29	0	0	29	0	0
6	44218120	rs13296	A	G	1943	2168	4111	0	87	4199	1	0
6	44220076	rs504697	T	C	6	4	10	0	0	10	0	0
6	44224924	rs575034	C	A	4	3	7	0	0	7	0	0
6	44228162	rs2233437	G	A	6	7	13	0	0	13	0	0
6	44228452	rs3799962	A	G	5	2	7	0	1	8	0	0
6	44228593	.	T	C	0	8	8	0	1	9	0	0
6	44229703	rs3957269	C	T	5	1	6	0	0	6	0	0
6	44229704	rs3997541	C	T	5	1	6	0	0	6	0	0
6	44229707	rs3997540	A	G	5	1	6	0	0	6	0	0
6	44232074	rs730775	A	G	17	12	29	0	0	29	0	0
6	44266574	rs1056093	C	A	9	6	15	0	0	15	0	0
6	44266708	rs1056092	T	C	9	7	16	0	0	16	0	0
6	44277712	rs56130549	T	C	6	1	7	0	0	7	0	0
6	44796596	rs524492	C	T	6	3	9	0	0	9	0	0
6	44797271	rs9369514	C	A	9	4	13	0	0	13	0	0
6	45391284	rs3805810	C	G	5	3	8	0	0	8	0	0
6	45391860	rs1321076	A	G	5	4	9	0	0	9	0	0
6	45391943	rs1321075	T	G	4	5	9	0	0	9	0	0
6	45410260	rs75705520	T	C	2	4	6	0	0	6	0	0
6	45515360	rs78935067	C	T	14	15	29	0	1	30	0	0
6	46107752	rs7451713	C	G	45	34	79	0	0	79	0	0
6	46109576	rs9395158	G	T	2	10	12	0	0	12	0	0
6	46110405	rs9472698	G	A	10	10	20	0	0	20	0	0
6	46110726	rs7769738	A	G	15	18	33	0	0	33	0	0
6	46110821	rs7769902	A	G	11	16	27	0	0	27	0	0
6	46112372	rs1048076	T	C	47	47	94	0	0	94	0	0
6	46112424	rs1048079	T	A	48	52	100	0	4	104	0	0
6	46113221	rs1048082	A	T	14	18	32	0	0	32	0	0
6	46113552	rs1048083	T	G	30	23	53	0	0	53	0	0
6	46113855	rs9763	G	A	35	23	58	0	0	58	0	0
6	47252378	rs80240072	C	T	11	11	22	0	0	22	0	0
6	49403282	rs8589	T	C	23	24	47	0	1	48	0	0
6	49412433	rs1141321	C	T	15	17	32	0	1	33	0	0
6	49425521	rs2229384	C	T	11	8	19	0	0	19	0	0
6	49439805	rs4267943	G	A	11	8	19	0	0	19	0	0
6	49442525	rs75778339	C	A	6	5	11	0	1	12	0	0
6	49442694	rs62411932	C	T	5	4	9	0	0	9	0	0
6	49443027	rs12212022	A	G	6	0	6	0	1	7	0	0
6	49443984	rs7769018	A	G	7	4	11	0	0	11	0	0
6	49695232	rs510770	A	G	8	10	18	0	1	19	0	0
6	49701439	rs1864312	C	A	6	5	11	0	0	11	0	0
6	52442880	rs3761988	G	T	5	3	8	0	0	8	0	0
6	52442988	rs147511949	G	A	5	9	14	0	0	14	0	0
6	52842781	rs405729	T	C	1	5	6	0	0	6	0	0
6	52842839	rs7496	C	T	29	7	36	0	0	36	0	0
6	52843131	rs367836	G	T	24	42	66	0	0	66	0	0
6	52878637	rs2297211	T	C	5	3	8	0	0	8	0	0
6	52963071	rs2876	A	G	23	24	47	0	0	47	0	0
6	52964165	rs9474386	T	A	2	6	8	0	0	8	0	0
6	52965311	rs9296699	C	T	3	3	6	0	0	6	0	0
6	53134301	rs8714	A	G	6	2	8	0	0	8	0	0
6	53134476	rs10897	G	A	9	6	15	0	0	15	0	0
6	53134998	rs2073040	A	G	7	3	10	0	0	10	0	0
6	53136516	rs2294861	C	T	3	3	6	0	0	6	0	0
6	53137581	rs209533	A	G	4	3	7	0	0	7	0	0
6	53141952	rs146352718	A	C	3	5	8	0	0	8	0	0
6	53150682	rs13218255	A	G	3	3	6	0	0	6	0	0
6	53150692	rs13204132	T	C	1	5	6	0	0	6	0	0
6	53152642	rs6458913	G	A	10	4	14	0	0	14	0	0
6	53152758	rs6907982	A	G	14	15	29	0	0	29	0	0
6	53152845	rs3817960	T	G	10	19	29	0	0	29	0	0
6	53153228	rs143683122	T	C	13	6	19	0	0	19	0	0
6	53153265	rs2294865	C	T	11	7	18	0	0	18	0	0
6	53153714	rs2294866	C	A	11	3	14	0	0	14	0	0
6	53154210	rs9349660	A	T	9	8	17	0	0	17	0	0
6	53155111	rs2294868	G	A	4	3	7	0	0	7	0	0
6	53157214	rs2294852	C	G	20	9	29	0	0	29	0	0
6	53157802	rs1555113	G	T	15	3	18	0	0	18	0	0
6	53158185	rs1973914	A	G	11	1	12	0	0	12	0	0
6	53158259	rs1973915	A	G	6	0	6	0	0	6	0	0
6	53158335	rs2294856	G	C	11	4	15	0	0	15	0	0
6	53169472	rs9395852	T	A	13	13	26	0	0	26	0	0
6	53170288	.	A	G	6	2	8	0	0	8	0	0
6	53170400	rs34101263	G	A	5	1	6	0	1	7	0	0
6	53170486	rs9474483	C	T	4	2	6	0	0	6	0	0
6	53170707	rs9370191	G	A	9	3	12	0	0	12	0	0
6	53171841	rs13202564	C	T	14	5	19	0	0	19	0	0
6	53172558	rs12196700	G	C	6	3	9	0	1	10	0	0
6	53174207	rs9370192	C	T	3	3	6	0	0	6	0	0
6	53174806	rs4431421	T	C	5	4	9	0	0	9	0	0
6	53175237	rs209486	T	C	8	1	9	0	0	9	0	0
6	53762092	rs9349688	A	G	3	9	12	0	0	12	0	0
6	54074949	.	C	T	10	0	10	0	0	10	0	0
6	56327849	rs11758339	C	T	27	34	61	0	0	61	0	0
6	56348118	rs9382635	C	G	7	6	13	0	0	13	0	0
6	56348730	rs721475	C	T	9	4	13	0	0	13	0	0
6	56349700	rs1535612	G	A	7	5	12	0	1	13	0	0
6	56349751	rs45486696	A	G	4	3	7	0	0	7	0	0
6	56505389	rs143101723	C	T	5	5	10	0	0	10	0	0
6	56707719	rs13192931	C	A	4	3	7	0	0	7	0	0
6	56891979	rs1044670	G	A	4	5	9	0	0	9	0	0
6	56911574	.	A	G	4	2	6	0	0	6	0	0
6	56917538	rs6926980	G	A	13	13	26	0	0	26	0	0
6	56965696	rs3800023	C	G	35	39	74	0	0	74	0	0
6	56975742	rs12194407	C	T	4	6	10	0	0	10	0	0
6	57012930	rs3734738	C	T	14	9	23	0	0	23	0	0
6	57034009	rs7756421	A	G	12	17	29	0	0	29	0	0
6	57283542	rs72873506	A	G	7	0	7	0	0	7	0	0
6	57283543	rs72873508	C	T	7	0	7	0	0	7	0	0
6	57283568	.	C	G	7	0	7	0	0	7	0	0
6	57283591	.	C	T	6	0	6	0	0	6	0	0
6	57393125	.	A	G	0	19	19	0	0	19	0	0
6	57393144	.	A	T	18	0	18	0	1	19	0	0
6	57453330	.	A	G	0	14	14	0	0	14	0	0
6	57467100	.	G	C	0	16	16	0	0	16	0	0
6	57467175	.	A	G	0	12	12	0	0	12	0	0
6	58272623	rs13777	T	C	6	2	8	0	0	8	0	0
6	58273268	rs149591546	T	C	4	2	6	0	0	6	0	0
6	64422505	rs116365286	G	A	150	114	264	0	2	266	0	0
6	70071173	rs913543	G	A	0	11	11	0	0	11	0	0
6	70464051	.	C	G	5	1	6	0	0	6	0	0
6	71377711	rs2274972	C	T	5	8	13	0	1	14	0	0
6	71570641	rs9680	A	G	66	35	101	0	0	101	0	0
6	71999351	rs7756709	C	T	27	19	46	0	1	47	0	0
6	72000496	rs58732838	C	T	6	4	10	0	0	10	0	0
6	72000866	rs9360445	G	T	4	2	6	0	0	6	0	0
6	72006512	rs2273888	T	C	108	77	185	0	0	185	0	0
6	72012064	rs9364153	G	A	7	5	12	0	0	12	0	0
6	72012270	rs9346459	A	G	32	20	52	0	0	52	0	0
6	72012335	rs9346460	T	C	21	11	32	0	0	32	0	0
6	72013023	rs1322759	A	G	42	43	85	0	0	85	0	0
6	72014050	rs4707908	C	T	41	36	77	0	0	77	0	0
6	72016302	rs9294899	G	T	8	4	12	0	0	12	0	0
6	72016407	rs7753063	C	A	9	4	13	0	1	14	0	0
6	73334719	rs7768673	A	G	4	4	8	0	0	8	0	0
6	73340293	rs12214894	A	T	16	10	26	0	0	26	0	0
6	73358621	rs17749420	G	C	25	21	46	0	0	46	0	0
6	73359028	rs9350467	C	T	17	15	32	0	0	32	0	0
6	73935135	rs6927398	G	C	4	3	7	0	0	7	0	0
6	74098703	rs488114	C	T	3	9	12	0	0	12	0	0
6	74303829	rs670248	C	T	12	16	28	0	0	28	0	0
6	74304415	rs3734518	G	C	8	8	16	0	0	16	0	0
6	74326666	rs1741889	T	A	6	2	8	0	0	8	0	0
6	74326754	rs1691350	C	A	10	3	13	0	0	13	0	0
6	74497152	rs5023688	G	A	1	5	6	0	0	6	0	0
6	75953705	rs9360898	T	G	4	4	8	0	0	8	0	0
6	76311718	rs71561434	C	T	8	3	11	0	0	11	0	0
6	76351999	rs2647400	C	G	4	4	8	0	0	8	0	0
6	76353052	rs2647401	A	G	1	7	8	0	0	8	0	0
6	76354033	rs72886845	G	A	5	3	8	0	0	8	0	0
6	76355289	rs13214795	C	T	5	2	7	0	0	7	0	0
6	76355729	rs2647402	A	G	6	3	9	0	0	9	0	0
6	76356445	rs12215914	G	T	8	9	17	0	0	17	0	0
6	76388989	rs1018103	T	G	26	22	48	0	0	48	0	0
6	84649113	.	G	A	5	6	11	0	0	11	0	0
6	86221586	rs9450288	A	T	2	5	7	0	0	7	0	0
6	86221771	rs6911143	C	T	2	5	7	0	0	7	0	0
6	86254306	rs149527488	C	T	5	7	12	0	0	12	0	0
6	86302034	rs2842611	A	G	1	8	9	0	0	9	0	0
6	86331887	rs2842602	C	T	6	3	9	0	0	9	0	0
6	86333029	rs12205013	C	T	3	3	6	0	0	6	0	0
6	86387888	rs1059307	G	T	840	1688	2528	0	9	2537	0	0
6	86388109	rs1059306	G	C	402	445	847	0	9	857	1	0
6	86388223	rs3087978	C	T	319	302	621	0	12	633	0	0
6	86388340	rs41271631	C	T	245	253	498	0	7	505	0	0
6	87932948	rs7752882	A	G	2	4	6	0	1	7	0	0
6	87942028	rs9450639	C	T	5	1	6	0	0	6	0	0
6	87951932	rs3846774	G	C	1	5	6	0	0	6	0	0
6	87965528	rs6908834	T	C	9	16	25	0	0	25	0	0
6	87968565	rs9362415	A	G	26	28	54	0	0	54	0	0
6	87969737	rs3734187	C	T	43	63	106	0	0	106	0	0
6	87970301	rs3812132	C	G	68	63	131	0	1	132	0	0
6	87973627	rs9353468	A	G	20	23	43	0	0	43	0	0
6	88051052	rs397516	T	C	3	7	10	0	1	11	0	0
6	88051262	rs398140	T	C	5	6	11	0	0	11	0	0
6	88183043	rs58785365	G	C	6	2	8	0	0	8	0	0
6	88221546	rs1051131	A	G	4	13	17	0	0	17	0	0
6	88221892	rs1051148	T	G	4	15	19	0	1	20	0	0
6	88226641	rs9450723	A	G	4	2	6	0	0	6	0	0
6	88405585	rs2754262	A	G	4	2	6	0	0	6	0	0
6	88406656	rs4707386	G	A	4	6	10	0	0	10	0	0
6	88410050	rs2246113	G	A	78	62	140	0	1	141	0	0
6	88411485	rs570047503	C	T	176	192	368	0	3	371	0	0
6	88411768	rs9474	A	G	220	256	476	0	3	479	0	0
6	88411890	rs1052623	A	G	244	270	514	0	0	514	0	0
6	89816585	rs45552339	T	C	3	4	7	0	1	8	0	0
6	90037584	rs114144399	G	A	328	341	669	0	1	670	0	0
6	90037968	rs6552	T	G	145	160	305	0	1	306	0	0
6	90039670	rs10502	G	C	1006	865	1871	0	5	1876	0	0
6	90043782	rs60851265	G	A	17	13	30	0	0	30	0	0
6	90043873	rs59813706	C	T	15	9	24	0	0	24	0	0
6	90075223	.	A	G	19	26	45	0	1	46	0	0
6	90075831	rs854908	A	C	20	21	41	0	0	41	0	0
6	90344300	rs13191342	C	T	9	4	13	0	0	13	0	0
6	90344553	.	G	A	6	12	18	0	0	18	0	0
6	90344869	rs6905628	C	G	9	9	18	0	0	18	0	0
6	90352862	rs7682	G	A	46	47	93	0	0	93	0	0
6	90352874	.	G	C	49	45	94	0	5	99	0	0
6	90368380	rs34732313	G	A	27	33	60	0	0	60	0	0
6	90371202	rs9444701	G	A	21	20	41	0	0	41	0	0
6	90372574	rs36040566	A	C	5	1	6	0	0	6	0	0
6	90390443	rs9353689	C	A	12	12	24	0	2	26	0	0
6	90397132	rs34766278	G	C	12	10	22	0	0	22	0	0
6	90402482	rs9294445	G	A	14	11	25	0	0	25	0	0
6	90408589	rs3736984	A	G	12	10	22	0	0	22	0	0
6	90436877	rs2748298	A	C	2	6	8	0	0	8	0	0
6	90437164	rs2768937	A	G	2	6	8	0	0	8	0	0
6	91225135	rs157705	C	T	2	4	6	0	0	6	0	0
6	91295984	rs282069	G	A	6	1	7	0	0	7	0	0
6	96054935	rs9387522	C	A	4	2	6	0	0	6	0	0
6	97339078	rs6684	A	G	24	27	51	0	0	51	0	0
6	99374400	rs1011676	G	A	4	5	9	0	0	9	0	0
6	99995320	rs13205324	G	T	2	4	6	0	1	7	0	0
6	99995629	rs13195012	A	G	6	3	9	0	0	9	0	0
6	105763888	rs67569210	T	C	5	1	6	0	0	6	0	0
6	105770186	rs11883	G	C	4	7	11	0	0	11	0	0
6	105776792	rs6902415	G	A	35	45	80	0	1	81	0	0
6	105821449	rs9486069	A	G	45	42	87	0	0	87	0	0
6	106555025	rs1010273	G	A	14	20	34	0	1	35	0	0
6	106969202	.	T	A	12	7	19	0	0	19	0	0
6	107001456	rs1770731	A	T	4	3	7	0	0	7	0	0
6	107001581	rs1770732	T	C	2	5	7	0	0	7	0	0
6	107002993	rs9398095	T	A	4	3	7	0	0	7	0	0
6	107003026	.	C	T	4	3	7	0	0	7	0	0
6	107003333	rs9486395	G	A	3	6	9	0	0	9	0	0
6	107003444	rs2297971	G	C	5	1	6	0	0	6	0	0
6	107006336	rs9320179	G	C	5	1	6	0	0	6	0	0
6	107016731	rs3747790	T	C	15	25	40	0	0	40	0	0
6	107017062	rs1057429	T	C	8	14	22	0	1	23	0	0
6	107017270	rs1135384	T	G	20	28	48	0	2	50	0	0
6	107017299	rs6922741	C	T	16	23	39	0	2	41	0	0
6	107017318	rs9486407	G	A	23	27	50	0	0	50	0	0
6	107017654	rs13319	G	A	23	19	42	0	0	42	0	0
6	107018154	rs8013	A	C	19	31	50	0	1	51	0	0
6	107076783	rs1987623	A	T	8	4	12	0	0	12	0	0
6	107100396	rs34221917	A	G	57	37	94	0	2	96	0	0
6	107362576	rs113186302	A	G	5	4	9	0	0	9	0	0
6	108210437	rs9480813	G	A	4	2	6	0	0	6	0	0
6	108326049	rs2071946	A	G	0	8	8	0	0	8	0	0
6	109803084	rs147441359	C	T	60	45	105	0	0	105	0	0
6	110421361	rs6568632	C	T	49	55	104	0	0	104	0	0
6	110465651	rs548231690	G	C	3	6	9	0	0	9	0	0
6	110746351	rs17493602	T	C	4	6	10	0	0	10	0	0
6	110746545	rs9487402	T	G	2	4	6	0	0	6	0	0
6	110763875	rs723685	A	G	13	7	20	0	0	20	0	0
6	110932865	rs2817802	C	T	10	8	18	0	0	18	0	0
6	111209089	rs11758099	A	G	4	4	8	0	0	8	0	0
6	111324650	rs9384779	T	C	4	2	6	0	0	6	0	0
6	111335571	rs4945869	A	G	6	3	9	0	0	9	0	0
6	111688927	rs3218587	G	A	4	9	13	0	0	13	0	0
6	112035002	rs809192	A	G	1	6	7	0	0	7	0	0
6	112101775	rs12910	G	T	10	10	20	0	0	20	0	0
6	112418289	rs77432232	G	A	28	12	40	0	0	40	0	0
6	114183884	rs12223	A	G	2	4	6	0	1	7	0	0
6	114265754	rs352062	A	G	5	7	12	0	0	12	0	0
6	114271094	rs6568820	T	C	8	10	18	0	0	18	0	0
6	114272701	rs34789089	G	A	72	45	117	0	4	121	0	0
6	114273127	rs352063	C	G	80	83	163	0	1	164	0	0
6	114274848	rs13204434	A	G	6	2	8	0	0	8	0	0
6	114276024	rs13194921	T	C	3	8	11	0	1	12	0	0
6	114276069	rs13209064	A	C	12	11	23	0	0	23	0	0
6	114276447	.	G	A	5	4	9	0	0	9	0	0
6	114276810	rs12660832	T	C	7	6	13	0	0	13	0	0
6	114276867	rs12665116	G	A	12	6	18	0	0	18	0	0
6	114278805	rs13191525	C	A	5	1	6	0	0	6	0	0
6	116422051	rs148872507	A	T	1	6	7	0	0	7	0	0
6	116571383	rs56074322	T	C	24	22	46	0	1	47	0	0
6	116572117	rs11789	G	A	28	23	51	0	0	51	0	0
6	116574002	rs2232473	C	T	76	76	152	0	0	152	0	0
6	116574940	rs149060725	C	T	32	40	72	0	1	73	0	0
6	116596479	rs6568925	T	A	5	1	6	0	0	6	0	0
6	116600845	.	C	G	146	125	271	0	1	272	0	0
6	116692795	rs2640873	A	G	22	54	76	0	0	76	0	0
6	116693384	rs2640872	T	C	3	3	6	0	0	6	0	0
6	116693934	rs146297658	G	C	5	1	6	0	0	6	0	0
6	116720487	rs10485183	C	T	18	6	24	0	0	24	0	0
6	116729779	rs2157323	T	C	4	4	8	0	0	8	0	0
6	116758795	rs472762	A	G	4	4	8	0	0	8	0	0
6	116762099	rs514272	G	C	5	2	7	0	0	7	0	0
6	116893524	rs151313073	A	G	3	4	7	0	1	8	0	0
6	116950734	rs6927567	G	A	4	2	6	0	0	6	0	0
6	116968213	rs9488996	T	C	5	9	14	0	0	14	0	0
6	116968513	rs6568959	T	C	4	7	11	0	1	12	0	0
6	116972177	rs7763921	T	C	3	3	6	0	0	6	0	0
6	116973182	rs4946188	T	C	21	30	51	0	0	51	0	0
6	117015808	rs113221832	G	A	5	2	7	0	0	7	0	0
6	117026292	.	T	A	9	10	19	0	0	19	0	0
6	117055764	rs13590	A	T	9	3	12	0	0	12	0	0
6	117881605	rs1759	A	T	2	7	9	0	0	9	0	0
6	117882209	rs1045855	G	A	6	4	10	0	0	10	0	0
6	118016513	rs12200948	T	C	6	3	9	0	0	9	0	0
6	118026770	rs137945470	G	A	4	3	7	0	0	7	0	0
6	118026772	rs138639077	T	A	4	3	7	0	0	7	0	0
6	118028669	rs553483026	C	T	11	5	16	0	0	16	0	0
6	118320365	rs12212953	A	G	61	0	61	0	0	61	0	0
6	118320469	rs9401042	G	A	11	0	11	0	0	11	0	0
6	119150218	rs9387607	T	A	13	14	27	0	0	27	0	0
6	119214102	rs145249910	G	A	65	51	116	0	0	116	0	0
6	119214524	rs147109562	A	G	56	54	110	0	0	110	0	0
6	119215402	rs11542663	A	C	39	38	77	0	2	79	0	0
6	119216729	rs9401092	C	T	6	6	12	0	0	12	0	0
6	119231968	rs2295709	T	C	3	8	11	0	0	11	0	0
6	119256079	rs1885125	A	G	17	11	28	0	0	28	0	0
6	119500208	rs1042800	C	A	9	2	11	0	0	11	0	0
6	119500916	rs3756943	T	C	5	3	8	0	0	8	0	0
6	122735183	rs12213993	T	G	5	1	6	0	0	6	0	0
6	122737104	rs9401538	A	G	4	3	7	0	0	7	0	0
6	122753385	.	T	C	7	4	11	0	0	11	0	0
6	122765905	rs487098	T	C	149	125	274	0	4	278	0	0
6	122765948	rs12524	A	G	153	153	306	0	15	321	0	0
6	122768231	rs2277107	T	C	7	3	10	0	0	10	0	0
6	122768953	rs9320873	C	T	1	5	6	0	0	6	0	0
6	122770779	rs10457433	G	A	4	5	9	0	0	9	0	0
6	122774383	.	C	A	4	3	7	0	0	7	0	0
6	122776800	rs11154081	C	T	8	0	8	0	0	8	0	0
6	122777185	rs7341197	C	T	6	5	11	0	0	11	0	0
6	122792765	rs3752573	G	C	2	4	6	0	0	6	0	0
6	122792768	rs3752574	C	T	2	4	6	0	0	6	0	0
6	126107791	rs1268074	G	C	3	3	6	0	0	6	0	0
6	126181956	rs9401851	T	C	3	5	8	0	0	8	0	0
6	126204333	rs6935780	C	G	3	4	7	0	0	7	0	0
6	126210395	rs6919947	T	G	20	19	39	0	1	40	0	0
6	126236135	.	T	C	1	11	12	0	0	12	0	0
6	126248374	rs9375417	T	C	4	6	10	0	0	10	0	0
6	126248596	rs6918302	G	A	7	8	15	0	0	15	0	0
6	127590829	rs12192111	A	G	4	5	9	0	0	9	0	0
6	130461810	rs13218274	A	C	8	12	20	0	0	20	0	0
6	131899608	rs76770001	T	C	3	3	6	0	0	6	0	0
6	131929471	.	G	A	4	2	6	0	0	6	0	0
6	131958485	rs9375819	A	C	11	4	15	0	0	15	0	0
6	131995425	.	T	C	10	4	14	0	0	14	0	0
6	132779502	rs11154680	T	C	8	11	19	0	2	21	0	0
6	132830325	rs9389001	G	A	8	8	16	0	1	17	0	0
6	132832394	.	C	T	5	8	13	0	0	13	0	0
6	133003344	rs2745426	C	T	7	8	15	0	0	15	0	0
6	133003865	rs1044593	A	T	4	2	6	0	0	6	0	0
6	133005817	rs2840813	T	G	5	2	7	0	0	7	0	0
6	133006059	rs2745427	C	A	21	29	50	0	0	50	0	0
6	133006626	rs2251455	C	A	10	14	24	0	0	24	0	0
6	133006740	rs2251449	C	T	14	16	30	0	0	30	0	0
6	133010525	rs2745432	G	A	7	11	18	0	0	18	0	0
6	133035098	rs2294757	G	A	11	7	18	0	0	18	0	0
6	133045812	rs2294758	G	A	2	4	6	0	0	6	0	0
6	133045902	rs2294759	A	G	6	5	11	0	0	11	0	0
6	133072650	rs1883617	A	G	4	3	7	0	0	7	0	0
6	133135886	rs9483504	A	G	2904	2648	5552	0	76	5628	0	0
6	133137111	rs3778174	C	T	9	5	14	0	0	14	0	0
6	133138010	rs9389034	T	C	10	14	24	0	0	24	0	0
6	133138249	rs2236381	T	C	16	22	38	0	0	38	0	0
6	134308187	rs11553666	T	G	122	118	240	0	0	240	0	0
6	134493397	rs1057293	G	A	276	379	655	0	4	661	2	0
6	134493947	rs1743966	A	G	20	63	83	0	0	83	0	0
6	134495597	rs55758956	G	T	10	14	24	0	1	25	0	0
6	135287533	rs13064	A	G	152	156	308	0	2	310	0	0
6	135288663	rs12664898	T	C	5	2	7	0	0	7	0	0
6	135292118	rs9376074	T	C	4	3	7	0	0	7	0	0
6	135293365	rs4895434	G	A	4	5	9	0	0	9	0	0
6	135293391	rs4896119	C	T	3	3	6	0	0	6	0	0
6	135294259	rs7755680	A	G	3	3	6	0	0	6	0	0
6	135352088	rs1590975	C	T	8	1	9	0	0	9	0	0
6	135352303	rs6569988	C	A	5	1	6	0	0	6	0	0
6	135352648	rs9321481	G	C	6	0	6	0	0	6	0	0
6	135353452	rs10872427	T	C	7	4	11	0	1	12	0	0
6	135353851	rs7766189	A	C	141	108	249	0	2	251	0	0
6	135354094	rs4134030	G	T	68	23	91	0	4	95	0	0
6	135355118	rs4896130	C	T	29	33	62	0	0	62	0	0
6	135355507	rs9402676	C	T	81	48	129	0	3	132	0	0
6	135355723	rs7748274	A	G	41	49	90	0	0	90	0	0
6	135356216	rs11754265	G	C	69	62	131	0	0	131	0	0
6	135358567	rs7742542	T	G	52	49	101	0	1	102	0	0
6	135517996	rs12660713	G	A	9	4	13	0	1	14	0	0
6	135522755	rs3752383	A	G	5	2	7	0	0	7	0	0
6	135523786	rs41294868	G	A	7	1	8	0	0	8	0	0
6	135623584	rs2223802	C	T	2	5	7	0	0	7	0	0
6	135649013	rs7772681	C	T	6	2	8	0	0	8	0	0
6	137102365	rs9376230	C	A	4	2	6	0	0	6	0	0
6	137105400	rs9483947	C	T	10	5	15	0	0	15	0	0
6	137110016	rs9402848	G	A	6	4	10	0	0	10	0	0
6	137113137	rs55666429	G	A	4	4	8	0	0	8	0	0
6	137166790	rs113268723	A	C	6	5	11	0	0	11	0	0
6	137519588	rs11914	A	C	313	305	618	0	2	620	0	0
6	137536455	rs1327475	G	A	16	3	19	0	0	19	0	0
6	137540370	rs7749390	A	G	5	1	6	0	0	6	0	0
6	137540520	rs2234711	A	G	6	9	15	0	0	15	0	0
6	138188394	.	G	T	3	6	9	0	0	9	0	0
6	138189884	rs583522	C	T	15	10	25	0	0	25	0	0
6	138191202	.	C	T	16	10	26	0	0	26	0	0
6	138195693	rs643177	T	C	4	4	8	0	0	8	0	0
6	138197824	rs582757	C	T	1	6	7	0	0	7	0	0
6	138199417	rs610604	G	T	3	4	7	0	0	7	0	0
6	138732796	rs148665541	T	C	9	6	15	0	0	15	0	0
6	138742249	rs7776384	C	T	4	4	8	0	0	8	0	0
6	139017815	rs9399249	A	G	3	5	8	0	0	8	0	0
6	139102749	.	T	C	3	4	7	0	0	7	0	0
6	139225925	rs12619	G	T	10	7	17	0	0	17	0	0
6	139229872	rs1044418	C	T	174	170	344	0	4	348	0	0
6	139237644	rs2698741	G	A	6	4	10	0	0	10	0	0
6	139238198	rs1730377	G	C	10	4	14	0	0	14	0	0
6	139240378	rs1358637	T	C	10	3	13	0	0	13	0	0
6	139240521	rs1980595	T	C	3	5	8	0	0	8	0	0
6	139240998	rs75183313	T	A	7	4	11	0	0	11	0	0
6	139241332	rs9495285	A	G	3	4	7	0	0	7	0	0
6	139264930	rs6899737	T	G	3	4	7	0	0	7	0	0
6	139286096	rs2178333	C	T	6	6	12	0	0	12	0	0
6	139287672	rs62440377	T	C	14	12	26	0	0	26	0	0
6	139693834	rs1131431	G	A	888	1082	1970	0	12	1982	0	0
6	139695061	rs1131400	G	T	1410	1078	2488	0	16	2505	1	0
6	139695565	rs1131399	T	A	1311	1035	2346	0	37	2385	2	0
6	142533999	rs225704	A	G	2	5	7	0	0	7	0	0
6	142535403	rs225705	G	A	7	7	14	0	0	14	0	0
6	142538279	rs225709	C	T	2	6	8	0	0	8	0	0
6	142540642	.	T	G	32	32	64	0	0	64	0	0
6	142540645	.	A	G	33	32	65	0	0	65	0	0
6	142541259	rs225710	C	T	15	13	28	0	0	28	0	0
6	143381712	rs3811093	T	C	4	4	8	0	0	8	0	0
6	143382110	rs1053192	T	C	27	37	64	0	0	64	0	0
6	143748686	rs9496618	A	T	17	20	37	0	0	37	0	0
6	143748801	rs9496619	A	G	39	23	62	0	0	62	0	0
6	143749295	rs1065355	G	T	32	30	62	0	1	63	0	0
6	143753486	rs9321912	T	C	4	8	12	0	0	12	0	0
6	143756512	rs7740441	A	G	3	7	10	0	0	10	0	0
6	143763845	rs7744361	A	G	3	4	7	0	0	7	0	0
6	143765143	rs4605902	T	C	16	11	27	0	0	27	0	0
6	143765329	rs72988638	G	T	10	8	18	0	0	18	0	0
6	143814595	rs1116	G	C	2	4	6	0	0	6	0	0
6	143814807	rs9496644	A	G	3	5	8	0	0	8	0	0
6	143815127	rs223228	T	C	10	10	20	0	0	20	0	0
6	143816123	rs9376753	A	C	4	2	6	0	0	6	0	0
6	143816859	rs8161	C	T	165	161	326	0	2	328	0	0
6	143823112	rs3762001	G	A	129	126	255	0	0	255	0	0
6	143823157	rs3762002	T	C	132	143	275	0	2	277	0	0
6	143825104	rs11155297	G	T	109	108	217	0	1	218	0	0
6	143828325	rs1569589	T	C	5	4	9	0	0	9	0	0
6	144270329	rs2268442	G	A	4	3	7	0	0	7	0	0
6	145051594	rs4305737	G	A	18	21	39	0	0	39	0	0
6	145093052	rs80110270	A	G	19	16	35	0	0	35	0	0
6	145103215	rs10499236	C	T	12	13	25	0	0	25	0	0
6	146128580	rs35807318	A	G	3	5	8	0	0	8	0	0
6	146234644	rs9497426	G	A	3	4	7	0	0	7	0	0
6	147525846	rs41311404	C	T	134	155	289	0	1	290	0	0
6	147526512	rs200859878	A	G	49	20	69	0	1	70	0	0
6	147531081	rs2786189	G	T	7	5	12	0	0	12	0	0
6	147549297	rs556493	A	G	5	4	9	0	0	9	0	0
6	147549602	rs657155	G	T	3	3	6	0	0	6	0	0
6	147566285	rs2119490	C	T	24	15	39	0	2	41	0	0
6	147566448	rs184430735	T	A	18	12	30	0	1	31	0	0
6	147570723	rs608147	C	T	4	3	7	0	0	7	0	0
6	147572380	rs474990	T	G	21	19	40	0	0	40	0	0
6	147574192	rs62435617	C	T	35	24	59	0	1	60	0	0
6	147576423	rs2502732	G	C	38	49	87	0	2	89	0	0
6	147576580	rs486867	G	A	41	36	77	0	2	79	0	0
6	147576650	rs1221637	T	C	43	20	63	0	3	66	0	0
6	147577804	rs79471649	T	C	112	73	185	0	0	185	0	0
6	147635413	rs1039084	A	G	44	40	84	0	1	85	0	0
6	147668514	rs9390458	A	G	3	3	6	0	0	6	0	0
6	147670086	rs12191720	T	C	1	6	7	0	0	7	0	0
6	147670601	rs12199542	A	T	1	5	6	0	0	6	0	0
6	147680359	rs9390459	A	G	102	95	197	0	3	200	0	0
6	149641627	rs1900300	T	C	8	0	8	0	0	8	0	0
6	149700805	rs2031450	G	A	10	6	16	0	2	18	0	0
6	149837422	rs17087543	T	C	6	3	9	0	0	9	0	0
6	149844785	rs12663698	C	T	3	7	10	0	0	10	0	0
6	149845117	rs17087579	T	C	9	4	13	0	0	13	0	0
6	149845266	rs9322184	C	T	5	2	7	0	0	7	0	0
6	149866452	rs9404042	G	A	5	1	6	0	0	6	0	0
6	149887885	rs73604783	T	C	5	1	6	0	0	6	0	0
6	149897455	rs4039600	A	G	7	7	14	0	0	14	0	0
6	149902460	.	A	G	9	8	17	0	0	17	0	0
6	149916057	rs9027	T	A	2	5	7	0	0	7	0	0
6	149980578	rs113493140	G	C	11	16	27	0	0	27	0	0
6	150025365	rs58651413	C	G	53	86	139	0	1	140	0	0
6	150046511	rs9322215	T	C	7	7	14	0	1	15	0	0
6	150052765	.	C	T	8	5	13	0	0	13	0	0
6	150114745	rs4816	G	A	261	245	506	0	3	509	0	0
6	150122645	rs9322223	G	A	3	3	6	0	0	6	0	0
6	150132092	rs7818	A	G	17	14	31	0	5	36	0	0
6	150132319	rs4552	A	T	31	30	61	0	0	61	0	0
6	151273854	rs803465	C	T	9	2	11	0	0	11	0	0
6	151273954	rs803464	G	A	7	0	7	0	0	7	0	0
6	151274168	rs803463	G	A	5	3	8	0	0	8	0	0
6	151275163	rs7744181	G	C	1	10	11	0	0	11	0	0
6	151315295	rs61638840	G	C	8	0	8	0	0	8	0	0
6	151328608	.	G	A	5	2	7	0	0	7	0	0
6	151336739	rs509474	C	G	28	52	80	0	1	81	0	0
6	151422700	rs2295733	T	C	70	48	118	0	1	119	0	0
6	151422750	rs7646	A	G	51	71	122	0	1	123	0	0
6	151422835	rs1047662	C	G	53	33	86	0	1	87	0	0
6	151422936	rs7543	G	A	25	17	42	0	1	43	0	0
6	151577830	rs10434896	C	G	7	5	12	0	0	12	0	0
6	151577907	rs7382081	T	C	8	5	13	0	0	13	0	0
6	151577930	rs9322310	G	A	11	7	18	0	0	18	0	0
6	151579005	rs78127388	G	A	14	10	24	0	0	24	0	0
6	151579432	rs4869723	C	T	19	20	39	0	0	39	0	0
6	151580765	rs9397040	G	A	4	3	7	0	0	7	0	0
6	151627034	rs2294792	A	G	87	97	184	0	1	185	0	0
6	151627096	rs2294793	C	T	53	83	136	0	0	136	0	0
6	151627562	rs2294794	C	T	41	32	73	0	0	73	0	0
6	151645078	rs2297778	A	G	31	35	66	0	2	68	0	0
6	151645569	rs2248861	T	C	38	29	67	0	1	68	0	0
6	151670897	rs900654	T	C	2	5	7	0	0	7	0	0
6	151673074	rs41289375	C	G	16	7	23	0	0	23	0	0
6	151674326	rs3823310	A	C	14	14	28	0	3	31	0	0
6	151678385	rs6908314	A	C	5	3	8	0	0	8	0	0
6	151686905	rs11155787	C	T	35	46	81	0	1	82	0	0
6	151712598	rs79626929	T	G	9	5	14	0	1	15	0	0
6	151726175	rs3757312	G	T	23	23	46	0	0	46	0	0
6	151726300	rs1065310	G	C	20	16	36	0	0	36	0	0
6	151766500	rs61739876	T	C	18	22	40	0	1	41	0	0
6	152443389	rs12681	C	T	28	11	39	0	0	39	0	0
6	152453291	rs35591210	G	A	7	13	20	0	0	20	0	0
6	152615200	rs12664753	G	A	8	4	12	0	0	12	0	0
6	153291865	rs1712	C	T	6	9	15	0	0	15	0	0
6	153291923	rs1713	C	T	11	6	17	0	0	17	0	0
6	153296541	rs2073260	G	C	24	27	51	0	1	53	1	0
6	153306749	rs3757063	T	G	3	8	11	0	0	11	0	0
6	153307231	rs73008529	T	C	6	5	11	0	0	11	0	0
6	153307949	rs12215363	G	A	9	3	12	0	0	12	0	0
6	153308040	rs12201771	A	G	6	2	8	0	0	8	0	0
6	153308198	rs6921137	T	G	5	6	11	0	0	11	0	0
6	153308312	rs12189965	G	T	4	10	14	0	0	14	0	0
6	153310904	.	G	T	24	3	27	0	0	27	0	0
6	153315695	rs3192723	C	T	14	28	42	0	0	42	0	0
6	153316326	rs3734467	A	G	14	19	33	0	0	33	0	0
6	153323594	.	C	T	39	23	62	0	2	64	0	0
6	153323709	rs3818125	T	C	20	2	22	0	1	23	0	0
6	153323806	rs3818126	A	G	7	4	11	0	0	11	0	0
6	153603372	rs115467600	T	C	11	0	11	0	0	11	0	0
6	153603373	rs9371678	T	C	14	0	14	0	0	14	0	0
6	154476318	rs35184807	C	T	3	12	15	0	0	15	0	0
6	154567863	rs34427887	C	T	14	4	18	0	0	18	0	0
6	154727825	rs12528985	C	T	1	8	9	0	2	11	0	0
6	154731904	rs2275337	C	G	8	11	19	0	0	19	0	0
6	154829835	rs60707704	A	G	4	4	8	0	1	9	0	0
6	155102802	rs9479956	T	C	5	9	14	0	0	14	0	0
6	155105997	rs9478582	C	T	3	3	6	0	0	6	0	0
6	155106052	rs9478583	A	G	4	4	8	0	2	10	0	0
6	155155039	rs9375	C	T	139	127	266	0	2	268	0	0
6	155156221	rs1980602	G	A	4	2	6	0	0	6	0	0
6	155160128	rs9384245	T	C	6	4	10	0	0	10	0	0
6	155162121	rs12199781	T	G	0	6	6	0	0	6	0	0
6	155606325	rs324356	C	T	7	9	16	0	0	16	0	0
6	155635585	rs162981	A	C	3	6	9	0	0	9	0	0
6	157191406	rs169646	T	G	17	17	34	0	0	34	0	0
6	157223707	rs287945	T	C	4	3	7	0	1	8	0	0
6	157371657	rs1977129	G	A	14	7	21	0	0	21	0	0
6	157379318	rs62424288	T	C	1	6	7	0	0	7	0	0
6	157711777	rs6605502	C	T	7	0	7	0	0	7	0	0
6	157713632	rs75809029	T	C	39	44	83	0	0	83	0	0
6	157743753	.	G	A	142	156	298	0	2	300	0	0
6	157744524	.	G	A	109	71	180	0	0	180	0	0
6	157745008	rs1133482	C	T	8	6	14	0	1	15	0	0
6	158497717	rs2296508	T	C	3	3	6	0	0	6	0	0
6	158517308	rs2502601	A	G	4	6	10	0	0	10	0	0
6	158517451	rs2502600	A	G	9	10	19	0	0	19	0	0
6	158518639	rs17490133	A	G	5	6	11	0	0	11	0	0
6	158519155	rs2502599	T	C	15	13	28	0	0	28	0	0
6	158519189	rs2502598	C	G	15	10	25	0	0	25	0	0
6	158531168	rs2502607	A	G	1	5	6	0	0	6	0	0
6	158571501	rs6929274	G	A	11	7	18	0	1	19	0	0
6	159039331	rs79937644	A	G	2	4	6	0	0	6	0	0
6	159040306	rs147824718	C	G	3	3	6	0	0	6	0	0
6	159041529	rs35001176	A	G	3	3	6	0	0	6	0	0
6	159041872	rs113883845	A	G	4	3	7	0	0	7	0	0
6	159042602	rs13212824	C	G	4	4	8	0	0	8	0	0
6	159042876	rs894122	C	A	5	2	7	0	1	8	0	0
6	159054427	rs11543368	G	A	7	7	14	0	0	14	0	0
6	159055260	rs1136284	G	T	6	2	8	0	0	8	0	0
6	159055282	rs3199561	T	C	7	4	11	0	0	11	0	0
6	159055641	rs1842	T	C	7	11	18	0	0	18	0	0
6	159056037	rs8036	G	A	8	8	16	0	0	16	0	0
6	159058659	rs35378330	A	C	24	28	52	0	0	52	0	0
6	159060233	rs67302319	T	C	3	5	8	0	0	8	0	0
6	159063760	rs3757077	C	A	8	12	20	0	0	20	0	0
6	159065763	.	C	T	22	10	32	0	0	32	0	0
6	159178345	rs901363	C	T	44	70	114	0	0	114	0	0
6	159184462	rs2291387	A	G	67	76	143	0	3	146	0	0
6	159185384	rs7762579	T	C	4	3	7	0	0	7	0	0
6	159185563	rs3123101	T	A	62	103	165	0	1	166	0	0
6	159187331	rs3205303	A	C	249	188	437	0	13	450	0	0
6	159187347	rs3734470	A	T	270	179	449	0	28	479	2	0
6	159187355	rs1057038	A	T	238	212	450	0	17	467	0	0
6	159188128	rs2242318	A	G	23	17	40	0	0	40	0	0
6	159190019	rs3102976	T	G	13	12	25	0	0	25	0	0
6	159190184	rs3102975	G	A	17	22	39	0	0	39	0	0
6	159191533	rs12201279	C	T	3	3	6	0	0	6	0	0
6	159191788	rs3212308	C	T	8	2	10	0	0	10	0	0
6	159192045	rs1038537	A	G	3	8	11	0	0	11	0	0
6	159192119	rs6942167	C	T	3	6	9	0	0	9	0	0
6	159192575	rs3127181	A	G	18	23	41	0	0	41	0	0
6	159192919	rs3102974	G	T	14	15	29	0	1	30	0	0
6	159194788	rs753017	T	G	11	16	27	0	0	27	0	0
6	159195184	rs3123102	A	T	9	13	22	0	1	23	0	0
6	159195456	.	T	C	10	14	24	0	0	24	0	0
6	159195743	rs3123104	A	G	14	13	27	0	4	31	0	0
6	159195781	rs3102972	G	T	10	20	30	0	1	31	0	0
6	159196044	rs9347252	G	T	13	9	22	0	1	23	0	0
6	159196128	rs9347253	G	A	13	8	21	0	0	21	0	0
6	159196150	rs3123105	T	C	15	9	24	0	0	24	0	0
6	159196603	rs9456352	C	A	14	15	29	0	0	29	0	0
6	159197006	rs1564972	C	G	16	18	34	0	1	35	0	0
6	159197371	rs9346767	T	C	10	9	19	0	0	19	0	0
6	159198380	rs3123106	C	G	1	5	6	0	0	6	0	0
6	159198706	rs3127205	T	C	2	4	6	0	0	6	0	0
6	159203353	rs901368	A	G	0	8	8	0	0	8	0	0
6	159208627	rs3123113	G	C	2	4	6	0	0	6	0	0
6	159209935	rs3127220	G	T	2	4	6	0	0	6	0	0
6	159231487	rs3123132	T	C	2	6	8	0	0	8	0	0
6	159231948	rs3123133	C	T	3	4	7	0	0	7	0	0
6	159238666	rs1872611	C	T	3	3	6	0	0	6	0	0
6	159239703	rs9457475	G	C	24	19	43	0	1	44	0	0
6	159239813	rs9457476	G	A	8	5	13	0	2	15	0	0
6	159448289	rs2008660	A	G	5	3	8	0	0	8	0	0
6	159455795	rs10455854	C	G	35	40	75	0	2	77	0	0
6	159455834	rs10455855	A	T	53	46	99	0	0	99	0	0
6	159456211	rs4709264	C	A	206	120	326	0	5	331	0	0
6	159456212	rs4709265	A	T	210	120	330	0	5	335	0	0
6	159456266	rs4709266	C	T	239	162	401	0	7	408	0	0
6	159456375	rs4709267	A	G	243	211	454	0	2	456	0	0
6	159456609	rs12198374	T	C	156	151	307	0	3	310	0	0
6	159456842	rs2235822	G	A	182	145	327	0	0	327	0	0
6	159458802	rs2273067	T	C	6	9	15	0	0	15	0	0
6	159459483	rs12527324	T	C	5	2	7	0	0	7	0	0
6	159459930	rs73800142	A	G	12	5	17	0	0	17	0	0
6	159460456	rs4709268	A	T	3	4	7	0	0	7	0	0
6	159461277	rs2235820	A	G	4	3	7	0	0	7	0	0
6	159461282	rs2073140	G	A	5	4	9	0	0	9	0	0
6	159461337	rs2235819	G	A	7	5	12	0	0	12	0	0
6	159461409	rs2073139	T	C	3	5	8	0	0	8	0	0
6	159461931	rs2073138	C	T	15	14	29	0	0	29	0	0
6	159462155	rs4709269	C	T	12	13	25	0	0	25	0	0
6	159463452	rs926657	C	T	1	7	8	0	0	8	0	0
6	159463964	rs9295089	T	C	2	4	6	0	0	6	0	0
6	160104086	rs55642860	G	A	15	15	30	0	0	30	0	0
6	160153919	.	G	T	6	2	8	0	0	8	0	0
6	160153920	.	T	A	5	2	7	0	1	8	0	0
6	160468278	rs998075	A	G	10	7	17	0	0	17	0	0
6	160469510	rs8191808	C	G	14	9	23	0	0	23	0	0
6	160511250	rs1050026	T	A	3	8	11	0	0	11	0	0
6	160514246	rs3777398	A	G	7	1	8	0	0	8	0	0
6	160514283	rs80254170	A	G	1	7	8	0	0	8	0	0
6	160514541	rs1888727	T	C	7	1	8	0	0	8	0	0
6	160560845	rs628031	A	G	3	4	7	0	0	7	0	0
6	161411973	rs678290	C	T	3	4	7	0	1	8	0	0
6	161538250	rs1488	G	A	14	21	35	0	0	35	0	0
6	161551218	rs9458136	G	A	8	4	12	0	0	12	0	0
6	161551467	rs6900500	G	A	5	11	16	0	0	16	0	0
6	161551516	rs6923835	A	G	5	12	17	0	0	17	0	0
6	163911414	rs2294707	T	C	3	27	30	0	1	31	0	0
6	163912700	rs2759389	G	A	4	3	7	0	0	7	0	0
6	163913182	rs1744924	C	T	5	13	18	0	0	18	0	0
6	163914457	rs1614795	A	G	3	13	16	0	0	16	0	0
6	163914511	rs2745364	C	T	4	6	10	0	0	10	0	0
6	163914795	.	T	C	6	3	9	0	0	9	0	0
6	163914947	rs1619076	G	T	2	7	9	0	0	9	0	0
6	163966098	rs9347763	G	A	4	4	8	0	0	8	0	0
6	163980882	rs7769145	G	C	6	2	8	0	0	8	0	0
6	163987389	rs9456869	T	A	12	7	19	0	0	19	0	0
6	166736518	rs12191010	G	C	8	27	35	0	0	35	0	0
6	166739589	rs12190616	A	C	2	4	6	0	0	6	0	0
6	166740270	rs941683	A	G	1	5	6	0	0	6	0	0
6	166745394	rs6927168	C	G	225	230	455	0	2	457	0	0
6	166745912	rs7753161	T	C	3	5	8	0	0	8	0	0
6	166746299	rs11752886	T	C	6	3	9	0	0	9	0	0
6	166747512	rs4144887	G	A	2	9	11	0	0	11	0	0
6	166747572	rs4144886	A	G	2	5	7	0	0	7	0	0
6	166747796	rs4144888	C	T	5	3	8	0	0	8	0	0
6	166748622	rs10455976	A	C	6	5	11	0	0	11	0	0
6	166750452	rs7771603	A	G	4	3	7	0	0	7	0	0
6	166750597	rs10455977	A	G	3	4	7	0	0	7	0	0
6	166751416	rs9356478	C	T	61	60	121	0	1	122	0	0
6	166755975	rs10862	T	C	150	191	341	0	10	351	0	0
6	166755979	rs11168	A	C	148	181	329	0	2	331	0	0
6	166778679	rs3728	T	G	69	49	118	0	3	121	0	0
6	167271632	rs9459780	C	G	4	12	16	0	0	16	0	0
6	167271716	rs9347162	T	C	23	10	33	0	0	34	1	0
6	167329350	rs9459801	G	A	1	10	11	0	0	11	0	0
6	167342767	rs71571466	G	A	1	6	7	0	0	7	0	0
6	167343141	rs11159	G	A	233	653	886	0	3	897	8	0
6	167344583	rs13213697	A	G	185	778	963	0	2	965	0	0
6	167360104	rs2236312	G	A	1	10	11	0	0	11	0	0
6	167369897	rs1044059	C	A	17	95	112	0	0	112	0	0
6	167369992	rs2247325	A	G	17	40	57	0	0	57	0	0
6	170063806	rs4236175	T	C	5	5	10	0	0	10	0	0
6	170150674	rs17860628	A	C	5	9	14	0	0	14	0	0
6	170615901	rs17860763	C	A	3	4	7	0	0	7	0	0
6	170844605	rs3823299	C	T	13	8	21	0	0	21	0	0
6	170845933	rs742348	C	G	4	5	9	0	0	9	0	0
6	170846902	rs6456228	C	G	5	9	14	0	0	14	0	0
6	170850278	rs2206284	G	A	4	2	6	0	0	6	0	0
6	170853296	rs73793711	A	C	13	18	31	0	0	31	0	0
6	170853550	rs6932750	T	C	11	8	19	0	0	19	0	0
6	170853686	rs6919159	C	T	16	8	24	0	0	24	0	0
6	170854203	rs2038093	G	C	5	3	8	0	0	8	0	0
6	170854754	rs4579340	G	A	8	7	15	0	0	15	0	0
6	170858520	rs6914744	A	C	11	19	30	0	1	31	0	0
6	170859715	rs3778589	T	C	15	19	34	0	0	34	0	0
6	170859902	rs7758044	A	G	6	3	9	0	0	9	0	0
6	170860006	.	G	C	1	7	8	0	1	9	0	0
6	170860549	rs3800236	A	T	7	7	14	0	0	14	0	0
6	170862051	rs4710839	G	C	16	16	32	0	0	32	0	0
6	170862300	rs12717	G	C	845	713	1558	0	6	1565	1	0
6	170871046	.	A	G	4	31	35	0	1	36	0	0
6	170871049	.	G	A	10	25	35	0	2	37	0	0
6	170878793	rs1042327	T	C	12	9	21	0	1	22	0	0
6	170885912	rs3734763	T	C	6	3	9	0	1	10	0	0
6	170886531	rs8770	T	C	86	83	169	0	1	170	0	0
6	170887693	rs3173219	G	C	43	41	84	0	0	84	0	0
6	170890378	rs73793714	C	T	5	4	9	0	0	9	0	0
6	170890384	rs6928843	C	T	4	5	9	0	0	9	0	0
6	170891493	rs2066954	G	T	20	10	30	0	0	30	0	0
6	170892100	rs9295417	T	C	13	11	24	0	0	24	0	0
7	5959485	.	G	A	17	28	45	0	0	45	0	0
7	5965381	.	G	A	133	71	204	0	2	206	0	0
7	5965398	.	G	A	145	79	224	0	1	225	0	0
7	6863385	.	A	C	7	1	8	0	0	8	0	0
7	38279891	.	T	C	9	6	15	0	0	15	0	0
7	38297614	.	T	C	44	2	46	0	1	47	0	0
7	38297637	.	C	T	48	1	49	0	0	49	0	0
7	38297721	.	A	G	1	23	24	0	0	24	0	0
7	56088902	.	C	T	24	120	144	0	0	144	0	0
7	56088907	.	G	C	22	94	116	0	1	117	0	0
7	56088908	.	C	T	20	94	114	0	1	115	0	0
7	66769189	.	A	G	18	1	19	0	0	19	0	0
7	66769194	rs370292714	C	T	17	1	18	0	0	18	0	0
7	66769198	.	A	G	15	1	16	0	1	17	0	0
7	66769241	rs377105733	T	C	12	0	12	0	0	12	0	0
7	66769242	rs370471568	G	A	12	0	12	0	0	12	0	0
7	72413443	.	G	A	81	0	81	0	2	83	0	0
7	72413581	.	G	A	70	0	70	0	0	70	0	0
7	72422456	.	C	T	8	10	18	0	0	18	0	0
7	72468030	.	A	T	1	5	6	0	0	6	0	0
7	72469999	.	G	T	10	11	21	0	0	21	0	0
7	74322012	.	A	G	6	2	8	0	0	8	0	0
7	75047550	.	C	T	126	77	203	0	0	203	0	0
7	102221813	.	C	T	8	0	8	0	0	8	0	0
7	102221814	.	G	A	2	6	8	0	0	8	0	0
7	105741902	.	C	A	7	0	7	0	1	8	0	0
7	105741912	.	C	A	7	0	7	0	1	8	0	0
7	142498735	.	A	C	685	18	703	0	4	707	0	0
7	142498738	.	C	G	700	18	718	0	5	723	0	0
7	142498833	.	A	T	766	31	797	0	7	804	0	0
7	142498837	.	C	T	772	28	800	0	4	804	0	0
7	142498897	.	A	G	611	30	641	0	3	644	0	0
7	142499071	.	T	C	692	39	731	0	13	746	2	0
7	143510176	.	C	T	5	6	11	0	0	11	0	0
7	143882697	.	A	G	0	8	8	0	0	8	0	0
7	143911252	.	G	A	5	4	9	0	0	9	0	0
7	143911335	.	C	T	5	2	7	0	0	7	0	0
7	151927021	.	C	A	14	0	14	0	0	14	0	0
7	151927026	.	T	C	13	0	13	0	1	14	0	0
7	151932908	.	T	C	13	0	13	0	1	14	0	0
7	151932945	.	C	T	18	0	18	0	1	19	0	0
7	151932965	.	C	T	18	0	18	0	0	18	0	0
7	151935831	.	G	A	13	0	13	0	0	13	0	0
7	151935910	.	C	T	18	0	18	0	0	18	0	0
7	151941798	rs2360890	G	A	20	0	20	0	0	20	0	0
7	151941813	rs4024449	G	A	15	0	15	0	0	15	0	0
7	151941917	rs4024448	T	C	6	0	6	0	0	6	0	0
7	151941919	rs4024447	G	C	6	0	6	0	0	6	0	0
7	151941955	.	C	A	7	0	7	0	0	7	0	0
7	151942108	.	C	T	6	0	6	0	0	6	0	0
7	151942190	.	A	T	7	0	7	0	0	7	0	0
7	151942201	rs2770457	A	T	8	0	8	0	0	8	0	0
7	151942333	.	T	C	12	0	12	0	0	12	0	0
7	151943204	rs551344211	G	A	0	6	6	0	0	6	0	0
7	151944702	.	A	G	0	7	7	0	0	7	0	0
7	151944717	.	T	C	7	0	7	0	0	7	0	0
7	151944765	.	A	G	8	0	8	0	0	8	0	0
7	151944852	.	C	T	7	0	7	0	0	7	0	0
7	151945007	.	C	T	32	0	32	0	0	32	0	0
7	151945140	.	C	T	41	0	41	0	1	42	0	0
7	151945167	.	G	T	39	0	39	0	0	39	0	0
7	151945204	.	G	A	37	0	37	0	0	37	0	0
7	151945334	.	T	C	31	0	31	0	0	31	0	0
7	151970856	.	T	A	32	0	32	0	0	32	0	0
7	151970931	rs56850341	G	A	32	0	32	0	0	32	0	0
8	163226	rs3008288	T	C	8	2	10	0	0	10	0	0
8	163370	rs7844253	C	G	20	16	36	0	0	36	0	0
8	163387	rs3008286	C	T	26	18	44	0	0	44	0	0
8	163438	rs7844396	C	T	23	17	40	0	0	40	0	0
8	163550	rs7816944	A	G	16	11	27	0	1	28	0	0
8	182183	rs146053243	C	T	11	9	20	0	0	20	0	0
8	183002	rs28488353	G	A	12	7	19	0	0	19	0	0
8	184976	rs10503143	T	C	5	3	8	0	0	8	0	0
8	196274	rs2072174	T	G	6	5	11	0	1	12	0	0
8	196447	rs62486594	G	A	6	7	13	0	0	13	0	0
8	197042	rs3750097	C	T	4	4	8	0	0	8	0	0
8	413731	rs76511887	G	C	2	5	7	0	0	7	0	0
8	617565	rs1669613	G	C	2	4	6	0	0	6	0	0
8	617587	rs12547333	G	A	2	4	6	0	0	6	0	0
8	618728	.	A	G	41	67	108	0	1	109	0	0
8	622781	rs1020566	T	C	3	7	10	0	0	10	0	0
8	622880	rs1020565	T	A	3	7	10	0	0	10	0	0
8	623051	rs6559063	C	T	3	9	12	0	0	12	0	0
8	623061	rs6559064	G	A	2	9	11	0	1	12	0	0
8	642076	rs13251790	G	A	13	1	14	0	1	15	0	0
8	642291	rs10112680	C	T	128	6	134	0	3	137	0	0
8	660388	rs143406140	G	A	8	2	10	0	5	15	0	0
8	662139	rs11786819	G	A	6	5	11	0	0	11	0	0
8	1709918	rs6558533	A	G	7	47	54	0	0	54	0	0
8	1709972	rs6558534	A	G	6	32	38	0	0	38	0	0
8	1711275	rs13540	T	C	56	58	114	0	1	115	0	0
8	1721352	rs113067642	A	G	7	5	12	0	0	12	0	0
8	1728292	rs12546965	T	C	5	3	8	0	0	8	0	0
8	1729217	rs11778824	C	T	5	11	16	0	0	16	0	0
8	1730228	rs112688948	T	C	10	5	15	0	0	15	0	0
8	1730694	rs78155116	A	C	15	12	27	0	0	27	0	0
8	1732125	rs112397747	G	C	5	3	8	0	0	8	0	0
8	1732407	rs55742804	C	T	4	5	9	0	0	9	0	0
8	1732580	rs7827009	C	G	4	2	6	0	0	6	0	0
8	1733055	rs118000123	C	T	5	6	11	0	1	12	0	0
8	1733124	rs117588996	G	A	2	4	6	0	0	6	0	0
8	1857548	rs2294038	T	C	0	6	6	0	0	6	0	0
8	1877480	rs17683288	T	G	15	4	19	0	0	19	0	0
8	1905132	rs3735876	G	A	2	11	13	0	0	13	0	0
8	1905823	rs6991392	A	G	3	3	6	0	0	6	0	0
8	1951766	rs74359409	C	A	10	6	16	0	0	16	0	0
8	1951854	rs73184755	C	T	9	9	18	0	0	18	0	0
8	1952175	rs7386994	A	G	13	11	24	0	0	24	0	0
8	1952490	rs73184756	G	A	4	8	12	0	0	12	0	0
8	1953042	rs1043221	T	C	10	9	19	0	0	19	0	0
8	1953223	rs1043223	C	T	9	5	14	0	0	14	0	0
8	1953567	rs1043225	C	A	9	6	15	0	0	15	0	0
8	1953759	rs1043226	A	T	15	13	28	0	0	28	0	0
8	1953880	rs73184758	T	C	13	11	24	0	0	24	0	0
8	2093181	rs3407	C	A	2	4	6	0	0	6	0	0
8	2585814	rs5021865	C	T	14	0	14	0	0	14	0	0
8	2585981	rs114034382	G	T	16	0	16	0	0	16	0	0
8	2629992	rs189070246	C	T	0	9	9	0	0	9	0	0
8	6262572	rs1550688	T	C	10	4	14	0	0	14	0	0
8	6262637	rs1073908	A	C	6	8	14	0	0	14	0	0
8	6263083	rs1057187	G	T	14	1	15	0	0	15	0	0
8	6263306	rs2243660	T	G	24	16	40	0	1	41	0	0
8	6263307	rs2243661	T	A	25	17	42	0	0	42	0	0
8	6263326	rs2243662	C	T	26	17	43	0	1	44	0	0
8	6263465	rs2515485	G	T	9	9	18	0	1	19	0	0
8	6263807	rs2243674	T	C	2	7	9	0	0	9	0	0
8	6263816	rs2243675	G	C	2	8	10	0	0	10	0	0
8	6263939	rs2243755	C	T	4	7	11	0	0	11	0	0
8	6263947	rs2243756	C	G	5	11	16	0	0	16	0	0
8	6264130	rs2305023	G	C	3	6	9	0	0	9	0	0
8	6266693	rs1550698	C	T	6	12	18	0	0	18	0	0
8	6272399	rs2305022	G	T	114	123	237	0	0	237	0	0
8	6291817	rs2442515	A	G	6	1	7	0	0	7	0	0
8	6297956	rs12545939	G	A	4	2	6	0	0	6	0	0
8	6302154	rs2083914	G	T	138	145	283	0	2	285	0	0
8	6302183	rs930557	G	C	155	143	298	0	1	299	0	0
8	6303409	rs2916750	T	G	82	70	152	0	0	152	0	0
8	6303434	rs2515570	T	A	64	73	137	0	1	138	0	0
8	6303511	rs1054073	T	A	26	36	62	0	0	62	0	0
8	6303614	rs1054074	A	C	17	9	26	0	0	26	0	0
8	6303859	rs2440415	C	T	69	33	102	0	1	103	0	0
8	6304185	rs2916749	T	G	5	10	15	0	1	16	0	0
8	6304259	rs2515571	G	A	35	19	54	0	0	54	0	0
8	6304348	rs2166006	C	T	46	23	69	0	1	70	0	0
8	6304694	rs1129703	A	G	74	62	136	0	2	138	0	0
8	6304730	rs1129704	A	C	94	67	161	0	0	161	0	0
8	6304814	rs1129706	A	G	98	66	164	0	0	164	0	0
8	6338306	rs12674488	C	A	60	62	122	0	1	123	0	0
8	6338664	rs12677501	T	G	41	30	71	0	1	72	0	0
8	6357611	rs2242005	C	T	6	9	15	0	0	15	0	0
8	6357639	rs2515597	T	C	7	5	12	0	0	12	0	0
8	6357773	rs1870	G	T	3	6	9	0	0	9	0	0
8	6358293	rs2442473	T	C	5	5	10	0	0	10	0	0
8	6359180	rs2442469	A	G	5	1	6	0	0	6	0	0
8	6359204	rs3958765	G	C	2	5	7	0	0	7	0	0
8	6389889	rs6559167	C	A	8	4	12	0	0	12	0	0
8	6403006	rs2515488	A	C	13	32	45	0	2	47	0	0
8	6412265	rs2515499	G	C	6	2	8	0	0	8	0	0
8	6478986	rs2912010	C	T	30	23	53	0	0	53	0	0
8	6479042	rs1057090	C	T	32	22	54	0	1	55	0	0
8	6479178	rs2912016	C	A	28	14	42	0	1	43	0	0
8	6483482	rs2912057	C	T	18	3	21	0	0	21	0	0
8	6500544	rs1057091	C	T	13	13	26	0	0	26	0	0
8	6500751	rs2433149	C	G	5	13	18	0	0	18	0	0
8	6503880	rs67736759	G	T	4	2	6	0	0	6	0	0
8	6505317	rs11781837	G	A	2	4	6	0	0	6	0	0
8	6505949	rs1055752	C	A	2	4	6	0	0	6	0	0
8	6507839	rs2912004	T	C	4	3	7	0	0	7	0	0
8	6507849	rs2936521	C	G	4	3	7	0	0	7	0	0
8	6527610	rs10092065	C	G	4	3	7	0	0	7	0	0
8	6793540	rs736227	C	T	13	44	57	0	1	58	0	0
8	6793581	rs2738100	A	G	11	41	52	0	0	52	0	0
8	6873603	.	T	G	400	3	403	0	9	412	0	0
8	8215511	rs2979232	C	G	7	6	13	0	0	13	0	0
8	8216986	rs4840941	A	G	6	3	9	0	0	9	0	0
8	8641125	rs2427	C	T	33	34	67	0	2	69	0	0
8	8641259	rs11906	G	A	32	47	79	0	0	79	0	0
8	8642139	rs56346368	T	A	8	4	12	0	0	12	0	0
8	8642525	rs4841039	G	A	13	6	19	0	0	19	0	0
8	8643387	rs10903311	G	A	4	2	6	0	1	7	0	0
8	8654898	rs3827812	C	T	12	19	31	0	0	31	0	0
8	8860709	rs28510464	T	G	4	2	6	0	0	6	0	0
8	8860894	rs2288671	T	C	10	8	18	0	0	18	0	0
8	8860992	rs56349323	T	C	6	10	16	0	0	16	0	0
8	8861249	rs9987276	G	C	3	7	10	0	0	10	0	0
8	8861430	rs13252797	G	A	1	8	9	0	0	9	0	0
8	8862521	rs6987558	G	C	6	3	9	0	0	9	0	0
8	8864357	rs62495494	A	G	3	7	10	0	0	10	0	0
8	8866661	rs9329175	G	A	7	10	17	0	1	18	0	0
8	8867411	rs2915251	G	C	7	6	13	0	1	14	0	0
8	8867471	rs17701980	C	T	4	7	11	0	0	11	0	0
8	8868283	rs6982619	C	T	5	7	12	0	0	12	0	0
8	8869199	rs9650616	T	G	219	168	387	0	5	393	1	0
8	8874780	rs10087416	C	G	3	3	6	0	0	6	0	0
8	8874786	rs6986044	G	C	3	3	6	0	0	6	0	0
8	8875381	rs17702351	A	G	4	4	8	0	0	8	0	0
8	8875764	rs7822129	G	T	3	3	6	0	0	6	0	0
8	8884503	rs4840389	G	C	7	0	7	0	0	7	0	0
8	8884659	.	A	G	7	2	9	0	0	9	0	0
8	8885166	rs2956244	A	G	2	4	6	0	0	6	0	0
8	8885954	rs13271797	G	A	4	5	9	0	1	10	0	0
8	8886183	rs13272451	G	T	4	4	8	0	0	8	0	0
8	8886964	rs7005056	A	G	12	5	17	0	1	18	0	0
8	8887153	rs28520356	T	A	7	7	14	0	0	14	0	0
8	8888948	rs2979247	A	G	28	25	53	0	2	55	0	0
8	8889846	rs11780338	A	G	7	5	12	0	1	13	0	0
8	8890041	rs1045527	A	G	53	38	91	0	0	91	0	0
8	8890098	rs1045529	C	T	92	92	184	0	2	186	0	0
8	8890802	rs6748	C	T	35	13	48	0	0	48	0	0
8	8890814	rs7853	A	G	7	11	18	0	0	18	0	0
8	8994512	rs9949	A	G	27	19	46	0	1	47	0	0
8	8994936	rs12785	A	T	31	36	67	0	0	67	0	0
8	8995166	rs330908	A	G	46	51	97	0	0	97	0	0
8	8995387	rs330909	A	G	42	57	99	0	2	101	0	0
8	8995755	rs330910	T	A	42	43	85	0	0	85	0	0
8	8996273	rs330911	C	T	21	19	40	0	1	41	0	0
8	8996294	rs330912	C	T	15	20	35	0	5	41	1	0
8	8996490	rs330913	G	A	37	34	71	0	0	71	0	0
8	8996695	rs330914	A	G	20	13	33	0	0	33	0	0
8	8996936	rs330915	T	A	27	47	74	0	0	74	0	0
8	8997096	rs330916	C	T	22	25	47	0	0	47	0	0
8	8997194	rs330917	G	T	11	20	31	0	0	31	0	0
8	8997207	rs330918	C	G	9	20	29	0	0	29	0	0
8	8997415	rs330919	G	A	20	19	39	0	0	39	0	0
8	8997614	rs330920	C	T	43	28	71	0	0	71	0	0
8	8997623	rs330921	G	A	42	23	65	0	1	66	0	0
8	8997798	rs330922	C	G	28	27	55	0	0	55	0	0
8	8997877	rs330923	C	T	31	24	55	0	1	56	0	0
8	8998022	rs17653841	A	G	23	30	53	0	0	53	0	0
8	8998262	rs434238	C	T	33	34	67	0	1	68	0	0
8	8998263	rs408773	T	G	32	34	66	0	1	67	0	0
8	10583506	rs4841432	A	G	5	1	6	0	1	7	0	0
8	10621580	rs2280047	A	G	4	5	9	0	0	9	0	0
8	10622812	rs12750	G	A	61	44	105	0	0	105	0	0
8	10643164	rs9657541	C	T	8	3	11	0	0	11	0	0
8	10644101	rs7821812	G	C	6	2	8	0	0	8	0	0
8	10644735	rs113720622	G	A	5	5	10	0	2	12	0	0
8	10689212	rs12375394	C	T	61	41	102	0	0	102	0	0
8	10692158	rs2271355	C	T	15	7	22	0	0	22	0	0
8	11182148	rs6995404	G	C	8	14	22	0	0	22	0	0
8	11182455	rs7016671	A	G	24	20	44	0	0	44	0	0
8	11183505	rs3779891	G	A	9	6	15	0	1	16	0	0
8	11184390	rs13266233	A	C	5	8	13	0	0	13	0	0
8	11184396	rs13263127	G	A	8	8	16	0	0	16	0	0
8	11184937	rs3174048	G	A	11	23	34	0	1	35	0	0
8	11185096	rs1047950	G	C	8	5	13	0	0	13	0	0
8	11279888	.	T	G	13	0	13	0	0	13	0	0
8	11280885	rs3021511	A	G	2	5	7	0	0	7	0	0
8	11281273	rs2409764	A	G	5	4	9	0	0	9	0	0
8	11281441	rs77097456	C	T	6	3	9	0	0	9	0	0
8	11301601	rs3021512	G	C	5	4	9	0	0	9	0	0
8	11406593	rs3816668	T	C	3	3	6	0	0	6	0	0
8	11640784	rs8191642	A	G	17	14	31	0	0	31	0	0
8	11643803	rs1534862	C	T	21	20	41	0	0	41	0	0
8	11665704	rs1293301	C	T	19	14	33	0	0	33	0	0
8	11677651	rs56365693	A	G	5	5	10	0	0	10	0	0
8	11682448	rs2686202	C	G	4	3	7	0	0	7	0	0
8	11682556	rs28441391	T	C	3	3	6	0	0	6	0	0
8	11683622	rs2229247	T	C	633	838	1471	0	6	1477	0	0
8	11685981	rs7009302	C	G	2	5	7	0	0	7	0	0
8	11687923	rs73207296	T	A	646	471	1117	0	4	1121	0	0
8	11690422	rs1293315	G	A	4	4	8	0	0	8	0	0
8	11690870	rs77440795	C	G	8	6	14	0	1	15	0	0
8	11690915	rs1293316	A	G	6	5	11	0	1	12	0	0
8	11692638	rs1293322	C	T	7	8	15	0	0	15	0	0
8	11693378	rs6990033	G	T	4	2	6	0	0	6	0	0
8	11693379	rs112635336	A	C	4	2	6	0	0	6	0	0
8	11694765	rs1293326	G	C	9	5	14	0	0	14	0	0
8	11694986	rs1293327	G	A	7	3	10	0	0	10	0	0
8	11695060	rs1293328	G	A	6	6	12	0	0	12	0	0
8	11700542	rs190531764	C	T	21	53	74	0	1	75	0	0
8	11700896	rs77145771	A	G	39	108	147	0	0	147	0	0
8	11700967	rs73209015	T	A	118	50	168	0	3	171	0	0
8	11701253	rs2740592	A	G	26	16	42	0	0	42	0	0
8	11701278	rs2645425	G	A	24	17	41	0	0	41	0	0
8	11701933	rs4839	T	C	570	389	959	0	6	965	0	0
8	11702375	rs3947	G	A	786	588	1374	0	8	1382	0	0
8	11702441	rs3088245	A	G	550	699	1249	0	3	1252	0	0
8	11702594	rs709821	G	C	619	421	1040	0	12	1054	2	0
8	11702767	rs142249463	C	A	2	4	6	0	0	6	0	0
8	11702840	rs1736081	T	G	9	4	13	0	0	13	0	0
8	11703002	rs10107851	T	C	3	6	9	0	0	9	0	0
8	11703048	rs1692811	C	G	4	3	7	0	0	7	0	0
8	11703420	rs1736082	C	T	3	3	6	0	0	6	0	0
8	11703657	rs1736084	C	T	7	2	9	0	0	9	0	0
8	11703659	rs1736085	T	C	7	2	9	0	0	9	0	0
8	11705677	rs2294140	C	G	2	11	13	0	0	13	0	0
8	11705870	rs1736089	G	A	5	2	7	0	0	7	0	0
8	11705884	rs113628575	G	A	2	7	9	0	0	9	0	0
8	11706418	rs149797657	G	C	4	6	10	0	0	10	0	0
8	11706834	rs35581201	T	C	4	13	17	0	0	17	0	0
8	11706907	rs148977198	G	A	3	6	9	0	0	9	0	0
8	11707027	rs2740593	A	G	10	2	12	0	0	12	0	0
8	11707174	rs2740594	A	G	7	2	9	0	0	9	0	0
8	11707272	rs146628196	T	G	0	6	6	0	0	6	0	0
8	11707556	rs74639061	G	C	3	14	17	0	1	18	0	0
8	11722355	rs1296022	G	A	13	9	22	0	0	22	0	0
8	11722895	rs146275847	T	C	0	6	6	0	1	7	0	0
8	11723765	rs78221966	A	C	18	23	41	0	0	41	0	0
8	11723775	rs1293309	G	A	24	16	40	0	2	42	0	0
8	11724138	rs61635988	A	G	8	15	23	0	1	24	0	0
8	11724927	rs7827662	C	G	15	13	28	0	0	28	0	0
8	11725051	rs141806376	G	T	6	8	14	0	1	15	0	0
8	11725513	rs11548599	G	A	152	153	305	0	29	334	0	0
8	12437996	.	T	C	6	4	10	0	0	10	0	0
8	12580949	rs73202627	T	C	2	8	10	0	0	10	0	0
8	12581855	rs4831768	C	T	5	1	6	0	1	7	0	0
8	12582865	rs55752837	A	G	2	4	6	0	0	6	0	0
8	12587568	rs56114121	T	C	1	6	7	0	0	7	0	0
8	12600720	rs1139354	T	A	28	16	44	0	1	45	0	0
8	12601155	rs6530965	A	C	4	4	8	0	0	8	0	0
8	12603076	rs17829381	T	C	3	14	17	0	0	17	0	0
8	12603189	rs6985289	C	G	6	2	8	0	0	8	0	0
8	12603472	rs17829441	T	C	4	20	24	0	0	24	0	0
8	12603611	rs6530966	A	T	8	0	8	0	1	9	0	0
8	12604051	rs7832448	T	C	11	4	15	0	0	15	0	0
8	12604409	rs9325792	C	G	6	0	6	0	0	6	0	0
8	12604492	rs9325793	A	G	3	3	6	0	0	6	0	0
8	12605274	rs58263500	T	C	11	3	14	0	1	15	0	0
8	12605681	rs17767600	T	C	1	5	6	0	0	6	0	0
8	12605835	rs6530967	G	C	7	0	7	0	0	7	0	0
8	12606691	rs4436128	T	C	6	2	8	0	0	8	0	0
8	12606760	rs4437649	T	C	11	5	16	0	0	16	0	0
8	12608577	rs73202653	G	A	1	8	9	0	0	9	0	0
8	12608990	rs6988764	C	T	11	27	38	0	0	38	0	0
8	12610776	rs6530970	T	C	5	7	12	0	0	12	0	0
8	12613515	rs3802271	T	G	24	17	41	0	0	41	0	0
8	12941709	rs1044011	C	A	11	5	16	0	0	16	0	0
8	12942510	rs486596	A	G	49	26	75	0	1	76	0	0
8	12943065	rs10888175	T	C	21	16	37	0	2	39	0	0
8	12952019	rs793568	G	A	3	4	7	0	0	7	0	0
8	12958025	rs3739298	C	A	69	46	115	0	0	115	0	0
8	12990518	rs13275331	T	A	15	13	28	0	0	28	0	0
8	12990659	rs6998803	G	A	29	11	40	0	0	40	0	0
8	12990734	rs17553593	C	A	23	14	37	0	2	39	0	0
8	16940960	rs12543283	C	T	3	3	6	0	0	6	0	0
8	16941332	rs3850760	A	C	10	8	18	0	0	18	0	0
8	16941351	rs3850761	G	A	7	9	16	0	1	17	0	0
8	17086756	rs1043093	A	C	6	11	17	0	0	17	0	0
8	17086990	rs6837	C	T	448	438	886	0	4	890	0	0
8	17087014	rs1043083	T	C	429	410	839	0	5	844	0	0
8	17089564	rs2904696	T	C	99	109	208	0	1	209	0	0
8	17089569	rs2904697	G	A	112	117	229	0	1	230	0	0
8	17089788	rs77250415	C	T	81	71	152	0	2	154	0	0
8	17090798	rs2904699	G	A	8	16	24	0	0	24	0	0
8	17132441	rs17502618	A	T	149	106	255	0	3	258	0	0
8	17145530	rs117208259	C	T	5	2	7	0	0	7	0	0
8	17159546	.	C	G	3	5	8	0	0	8	0	0
8	17188895	rs7841726	T	G	2	4	6	0	0	6	0	0
8	17189713	rs714346	A	G	0	6	6	0	0	6	0	0
8	17237385	rs73208998	T	C	14	12	26	0	0	26	0	0
8	17237536	rs17124464	A	C	13	9	22	0	0	22	0	0
8	17237608	rs10089145	A	G	10	12	22	0	0	22	0	0
8	17237655	rs74926648	T	C	11	10	21	0	0	21	0	0
8	17237656	rs78533989	G	A	10	10	20	0	0	20	0	0
8	17237679	rs73208999	T	A	1	10	11	0	0	11	0	0
8	17237715	rs73209000	A	G	1	9	10	0	0	10	0	0
8	17781012	rs11996792	C	G	2	4	6	0	0	6	0	0
8	17796382	rs412750	A	G	122	118	240	0	2	242	0	0
8	17796383	rs454755	C	T	122	119	241	0	1	242	0	0
8	17799241	rs10108545	T	C	5	8	13	0	0	13	0	0
8	17814915	rs208753	A	G	101	88	189	0	2	191	0	0
8	17819572	rs3780103	C	T	135	144	279	0	2	281	0	0
8	17825327	rs208053	G	A	11	7	18	0	0	18	0	0
8	17825559	rs208052	G	C	10	7	17	0	1	18	0	0
8	17843926	rs11776688	G	C	4	8	12	0	0	12	0	0
8	17844201	rs373886	T	C	18	13	31	0	0	31	0	0
8	17844870	rs10088513	A	C	9	5	14	0	0	14	0	0
8	17857416	rs13256296	G	C	6	1	7	0	0	7	0	0
8	17857445	rs6586676	T	C	2	6	8	0	0	8	0	0
8	17857880	rs7825899	A	C	6	1	7	0	0	7	0	0
8	17858297	rs34975555	G	C	4	6	10	0	0	10	0	0
8	17858437	rs12547946	T	G	5	4	9	0	0	9	0	0
8	17860863	rs12056629	T	C	6	6	12	0	0	12	0	0
8	17860966	rs3898982	T	G	12	9	21	0	0	21	0	0
8	17864020	rs17514686	A	G	13	14	27	0	0	27	0	0
8	17864985	rs376771	G	A	13	12	25	0	2	27	0	0
8	17866649	rs378443	T	A	12	12	24	0	0	24	0	0
8	17869835	rs433387	T	C	3	4	7	0	0	7	0	0
8	17870461	rs369033	C	T	3	4	7	0	1	8	0	0
8	17870886	rs34663779	C	G	8	8	16	0	0	16	0	0
8	17871256	rs10103879	A	T	10	11	21	0	0	21	0	0
8	17872750	rs188806955	C	T	11	8	19	0	0	19	0	0
8	17872904	rs34052296	A	C	27	25	52	0	0	52	0	0
8	17878155	rs208026	A	G	6	4	10	0	0	10	0	0
8	17878170	rs208025	A	G	5	4	9	0	0	9	0	0
8	17880243	rs2283113	C	A	4	2	6	0	0	6	0	0
8	17880616	rs3886398	T	C	3	5	8	0	0	8	0	0
8	17880625	rs3886397	C	T	2	4	6	0	0	6	0	0
8	17880869	rs17514812	T	A	5	3	8	0	0	8	0	0
8	17881253	rs2237854	T	C	5	1	6	0	1	7	0	0
8	17884606	rs383091	T	C	10	4	14	0	0	14	0	0
8	17884901	rs71526178	T	G	2	4	6	0	0	6	0	0
8	17885406	rs10283	C	G	23	23	46	0	4	50	0	0
8	17913970	rs7508	G	A	41	20	61	0	2	63	0	0
8	17914117	rs3810	T	G	97	93	190	0	2	192	0	0
8	17918986	rs17515291	A	G	3	8	11	0	0	11	0	0
8	17919031	rs61108931	C	T	4	9	13	0	0	13	0	0
8	17920077	rs12541567	T	A	4	10	14	0	0	14	0	0
8	17920337	rs7387912	C	T	7	5	12	0	0	12	0	0
8	17920359	rs7387916	C	A	6	7	13	0	1	14	0	0
8	17920361	rs7386629	A	G	7	6	13	0	1	14	0	0
8	17920567	rs7387930	C	T	7	6	13	0	0	13	0	0
8	17920623	rs6586683	C	T	8	3	11	0	1	12	0	0
8	17920807	rs7824644	A	G	15	19	34	0	0	34	0	0
8	17920820	rs7824650	A	T	14	19	33	0	0	33	0	0
8	17921230	rs13280	G	A	20	20	40	0	0	40	0	0
8	17921666	rs2073572	C	T	23	22	45	0	0	45	0	0
8	17921673	rs2073573	G	T	22	16	38	0	1	39	0	0
8	17921921	rs2073574	T	C	4	22	26	0	0	27	1	0
8	17922396	rs7834136	T	C	21	35	56	0	0	56	0	0
8	17922414	rs7830490	A	G	17	29	46	0	0	46	0	0
8	17922885	rs4288422	G	T	6	7	13	0	0	13	0	0
8	17923142	rs2410446	G	A	8	6	14	0	0	14	0	0
8	17923147	rs2410447	T	C	8	6	14	0	1	15	0	0
8	17923339	rs4377998	C	T	5	5	10	0	1	11	0	0
8	17923421	rs28479568	A	G	4	8	12	0	0	12	0	0
8	17923423	rs55869903	A	G	4	7	11	0	1	12	0	0
8	17923499	rs12541181	C	G	11	8	19	0	0	19	0	0
8	17924645	.	G	T	479	144	623	0	6	630	1	0
8	17926081	rs62497632	C	A	5	3	8	0	0	8	0	0
8	17926790	rs12548139	G	A	4	2	6	0	0	6	0	0
8	17927327	rs1049874	T	C	665	777	1442	0	14	1456	0	0
8	17928811	rs1071645	C	T	594	657	1251	0	12	1263	0	0
8	17928999	rs12549594	G	A	5	1	6	0	0	6	0	0
8	17930772	rs3753115	C	T	44	9	53	0	0	53	0	0
8	17935951	rs7460605	G	A	4	2	6	0	0	6	0	0
8	18080644	rs1057126;rs8190861	A	T	6	5	11	0	0	11	0	0
8	18080651	rs15561	A	C	5	7	12	0	0	12	0	0
8	19263003	rs3802330	G	A	40	19	59	0	1	60	0	0
8	19266438	rs4642666	G	A	4	2	6	0	0	6	0	0
8	19316086	rs12155539	G	A	14	26	40	0	1	41	0	0
8	19363425	rs6984644	C	T	10	14	24	0	0	24	0	0
8	19377231	rs28532825	A	C	7	0	7	0	0	7	0	0
8	19676589	rs7832638	A	G	10	5	15	0	0	15	0	0
8	19677915	rs7822495	G	A	248	236	484	0	5	489	0	0
8	19678917	rs60369789	C	T	3	4	7	0	0	7	0	0
8	19680259	rs60329942	G	A	3	4	7	0	0	7	0	0
8	19680562	rs6986456	G	A	2	5	7	0	0	7	0	0
8	19680635	rs4392917	G	C	3	8	11	0	0	11	0	0
8	19702001	rs4268139	G	C	8	8	16	0	0	16	0	0
8	19706172	rs4520184	A	T	19	7	26	0	0	26	0	0
8	19709575	rs4599828	T	C	5	5	10	0	1	11	0	0
8	19823648	rs3208305	A	T	3	4	7	0	0	7	0	0
8	19824071	rs3200218	A	G	16	5	21	0	2	23	0	0
8	19824667	rs15285	C	T	3	6	9	0	0	9	0	0
8	20083056	rs116900472	G	A	4	8	12	0	0	12	0	0
8	21881878	rs80196502	C	T	3	9	12	0	0	12	0	0
8	21882524	rs117903347	G	T	6	25	31	0	2	33	0	0
8	21905772	rs3176304	G	C	4	4	8	0	0	8	0	0
8	21997315	rs141484243	C	A	52	42	94	0	1	95	0	0
8	22059606	rs13257482	G	A	4	2	6	0	0	6	0	0
8	22067022	rs77242743	C	A	108	104	212	0	2	214	0	0
8	22069386	rs7001	T	C	113	113	226	0	5	231	0	0
8	22105502	rs1126677	T	C	35	36	71	0	0	71	0	0
8	22326717	rs4872504	A	G	1	6	7	0	0	7	0	0
8	22335170	rs11778844	C	T	35	15	50	0	1	51	0	0
8	22359156	rs2979302	G	A	6	1	7	0	0	7	0	0
8	22395309	rs1116084	C	T	3	7	10	0	0	10	0	0
8	22395509	rs1482337	G	A	4	2	6	0	0	6	0	0
8	22398414	rs7430	G	C	71	72	143	0	0	143	0	0
8	22398462	rs7431	G	A	32	25	57	0	2	59	0	0
8	22400098	rs2249098	T	C	4	5	9	0	0	9	0	0
8	22400193	rs2249102	C	G	2	5	7	0	0	7	0	0
8	22424244	rs2272716	T	C	26	43	69	0	1	70	0	0
8	22428708	rs1047030	A	G	163	115	278	0	6	284	0	0
8	22430129	rs10113137	C	A	1	6	7	0	0	7	0	0
8	22431588	rs881771	C	G	6	3	9	0	0	9	0	0
8	22432377	rs710098	C	A	225	169	394	0	57	451	0	0
8	22438859	rs34457441	C	G	42	8	50	0	1	51	0	0
8	22442661	rs2294047	A	G	333	318	651	0	3	654	0	0
8	22443220	rs11994391	T	C	1	5	6	0	0	6	0	0
8	22444129	rs1038310	C	G	15	17	32	0	0	32	0	0
8	22450393	rs2957092	T	A	4	6	10	0	0	10	0	0
8	22466784	rs77062779	C	G	15	11	26	0	0	26	0	0
8	22472188	rs55677256	A	G	70	56	126	0	1	127	0	0
8	22477585	rs1869	C	T	473	493	966	0	3	969	0	0
8	22487087	rs3758040	T	C	12	11	23	0	0	23	0	0
8	22487388	rs6558170	C	G	11	13	24	0	0	24	0	0
8	22487422	rs6558171	T	C	15	20	35	0	0	35	0	0
8	22488939	rs1564595	A	G	14	22	36	0	0	36	0	0
8	22489089	rs146165232	C	T	21	33	54	0	1	55	0	0
8	22489247	rs1038311	T	C	14	24	38	0	0	38	0	0
8	22489537	rs4872524	T	C	18	11	29	0	1	30	0	0
8	22489678	rs7831119	A	G	12	18	30	0	0	30	0	0
8	22490209	rs2404655	T	C	6	13	19	0	0	19	0	0
8	22490800	rs4072394	C	T	14	9	23	0	0	23	0	0
8	22491496	rs2009212	G	A	10	28	38	0	0	38	0	0
8	22491518	rs2003908	T	C	9	28	37	0	1	38	0	0
8	22491880	rs17088488	A	G	13	21	34	0	0	34	0	0
8	22491980	rs17746902	G	T	17	20	37	0	0	37	0	0
8	22492052	rs6558172	G	A	15	12	27	0	1	28	0	0
8	22492129	rs6558174	A	G	22	11	33	0	0	33	0	0
8	22492143	rs7838146	C	T	17	11	28	0	0	28	0	0
8	22492708	rs4872525	C	A	7	17	24	0	0	24	0	0
8	22492828	rs77486104	G	A	18	16	34	0	1	35	0	0
8	22493350	rs12676084	C	T	19	8	27	0	2	29	0	0
8	22526559	rs11550509	G	A	171	110	281	0	4	285	0	0
8	22537201	rs3893402	A	G	5	4	9	0	0	9	0	0
8	22546561	rs1877670	T	C	45	34	79	0	4	83	0	0
8	22547052	rs11136094	G	A	117	85	202	0	0	202	0	0
8	22553621	rs1008949	T	C	31	24	55	0	0	55	0	0
8	22864622	rs2466178	T	C	6	3	9	0	0	9	0	0
8	22865320	rs2430815	T	G	5	3	8	0	0	8	0	0
8	22898435	rs7834281	C	T	2	8	10	0	0	10	0	0
8	22898574	rs199870003	G	T	4	4	8	0	0	8	0	0
8	22898960	rs10093948	G	A	10	12	22	0	0	22	0	0
8	22899384	rs55939050	G	A	15	15	30	0	0	30	0	0
8	22899633	rs6557612	C	G	15	17	32	0	0	32	0	0
8	22924910	rs12674496	A	G	6	2	8	0	0	8	0	0
8	22924969	rs73544901	C	A	4	3	7	0	0	7	0	0
8	22960873	rs10109912	G	C	0	9	9	0	0	9	0	0
8	22972696	rs114139410	C	G	2	4	6	0	0	6	0	0
8	22993760	rs80325473	C	T	576	582	1158	0	6	1164	0	0
8	22996308	rs7011559	A	G	7	11	18	0	0	18	0	0
8	22996779	rs4278155	A	C	5	2	7	0	0	7	0	0
8	22996974	rs4279596	A	G	23	9	32	0	0	32	0	0
8	22997529	rs7465520	A	G	8	8	16	0	0	17	1	0
8	22998770	rs13266164	C	G	18	18	36	0	1	37	0	0
8	23000183	rs4242391	T	C	8	16	24	0	0	24	0	0
8	23000559	rs4872060	G	A	4	2	6	0	0	6	0	0
8	23001125	rs6557618	A	T	7	23	30	0	0	30	0	0
8	23001988	rs1133782	A	G	377	374	751	0	0	751	0	0
8	23002893	rs7014588	T	C	5	7	12	0	0	12	0	0
8	23018849	rs73222561	G	A	7	5	12	0	0	12	0	0
8	23020210	rs73222565	G	A	6	5	11	0	0	11	0	0
8	23058220	rs20576	T	G	60	38	98	0	2	100	0	0
8	23082971	rs13278062	G	T	3	3	6	0	0	6	0	0
8	23083546	rs13255394	T	C	4	2	6	0	0	6	0	0
8	23104195	rs2294123	G	T	8	10	18	0	0	18	0	0
8	23106665	rs2280934	A	G	9	3	12	0	0	12	0	0
8	23118155	rs9828	T	C	23	16	39	0	1	40	0	0
8	23118503	rs12194	C	T	24	32	56	0	2	58	0	0
8	23152334	rs15946	A	G	159	187	346	0	6	352	0	0
8	23288346	rs61744075	C	A	48	49	97	0	0	97	0	0
8	23294230	.	T	C	13	21	34	0	1	35	0	0
8	23387192	rs62503282	C	T	79	66	145	0	2	147	0	0
8	23388326	rs11779446	A	G	70	71	141	0	3	144	0	0
8	23389571	rs11781222	T	C	5	5	10	0	0	10	0	0
8	23392733	rs3736030	C	T	4	4	8	0	0	8	0	0
8	23393572	rs4871880	G	A	3	3	6	0	0	6	0	0
8	23394461	rs12549737	T	C	2	4	6	0	0	6	0	0
8	23398001	rs12548201	A	C	3	3	6	0	0	6	0	0
8	23423758	rs10992	G	A	206	203	409	0	5	414	0	0
8	23431045	rs1810193	T	C	60	54	114	0	0	114	0	0
8	23432332	rs8534	C	T	68	49	117	0	2	119	0	0
8	23538426	rs4872177	A	G	5	2	7	0	0	7	0	0
8	24171051	rs6996616	C	T	3	15	18	0	0	18	0	0
8	24194679	rs62502746	C	G	3	7	10	0	0	10	0	0
8	24194704	rs62502747	A	G	2	7	9	0	0	9	0	0
8	24194719	rs62502748	G	C	3	7	10	0	0	10	0	0
8	24195051	rs11135791	T	C	4	5	9	0	0	9	0	0
8	24195119	rs9693575	A	G	4	3	7	0	0	7	0	0
8	24195549	rs12234971	G	A	2	6	8	0	0	8	0	0
8	24196357	rs76274515	A	G	0	6	6	0	0	6	0	0
8	24196715	rs11998149	A	G	1	10	11	0	0	11	0	0
8	24196738	rs62502752	A	G	1	5	6	0	0	6	0	0
8	24196898	rs11994522	C	T	3	8	11	0	0	11	0	0
8	24197370	rs11998324	A	G	1	9	10	0	0	10	0	0
8	24197955	rs77113093	G	A	3	7	10	0	0	10	0	0
8	24198230	rs80183598	G	T	0	22	22	0	0	22	0	0
8	24198514	rs7018020	G	A	3	13	16	0	0	16	0	0
8	24198524	rs62498241	G	C	3	11	14	0	1	15	0	0
8	24198630	rs11995731	C	A	4	7	11	0	1	12	0	0
8	24198707	rs7008879	T	C	3	10	13	0	0	13	0	0
8	24198903	rs11985937	A	T	7	14	21	0	1	22	0	0
8	24198914	rs7005177	A	G	3	12	15	0	1	16	0	0
8	24199063	rs11989219	G	A	2	12	14	0	1	15	0	0
8	24199091	rs11996594	C	A	4	15	19	0	0	19	0	0
8	24199218	rs36041430	C	A	31	43	74	0	2	76	0	0
8	24205885	rs79880388	C	T	5	1	6	0	0	6	0	0
8	24208847	rs7009516	G	A	4	4	8	0	0	8	0	0
8	24214935	rs892587	C	A	8	0	8	0	0	8	0	0
8	24434873	.	A	C	7	0	7	0	0	7	0	0
8	24434879	.	A	C	7	0	7	0	0	7	0	0
8	25080265	rs1510760	A	G	9	2	11	0	0	11	0	0
8	25080412	rs1510759	G	C	17	2	19	0	0	19	0	0
8	25112851	rs73558472	C	A	7	3	10	0	0	10	0	0
8	25112909	rs1606036	G	A	7	1	8	0	0	8	0	0
8	25112955	rs1606035	A	G	5	1	6	0	0	6	0	0
8	25130818	rs4872301	T	C	4	3	7	0	0	7	0	0
8	25135624	rs2666158	T	C	8	3	11	0	1	12	0	0
8	25135671	rs2709610	G	C	9	2	11	0	0	11	0	0
8	25182969	rs2666172	C	T	59	43	102	0	0	102	0	0
8	25230168	rs2271108	C	T	31	26	57	0	0	57	0	0
8	25361032	rs76687559	C	G	40	38	78	0	0	78	0	0
8	26168269	.	A	T	2	4	6	0	0	6	0	0
8	26170975	rs17055121	G	A	6	3	9	0	0	9	0	0
8	26172180	rs1821391	C	T	6	3	9	0	0	9	0	0
8	26172262	rs191699690	T	C	3	3	6	0	0	6	0	0
8	26172699	rs7003030	G	T	3	4	7	0	0	7	0	0
8	26174315	rs142297430	G	A	4	7	11	0	0	11	0	0
8	26176497	rs117310760	A	G	8	4	12	0	0	12	0	0
8	26205793	rs17055148	A	C	4	2	6	0	0	6	0	0
8	26207357	rs78304495	T	C	4	3	7	0	0	7	0	0
8	26208209	rs10866848	G	C	5	10	15	0	0	15	0	0
8	26208744	rs6557914	G	C	4	5	9	0	0	9	0	0
8	26209062	rs6557915	C	A	8	8	16	0	0	16	0	0
8	26210178	rs2046223	A	G	11	12	23	0	0	23	0	0
8	26211342	rs76098791	T	C	5	6	11	0	0	11	0	0
8	26221945	rs17055163	T	G	12	7	19	0	0	19	0	0
8	26222619	rs75518028	G	T	6	2	8	0	0	8	0	0
8	26222620	rs75918290	C	T	6	2	8	0	0	8	0	0
8	26240646	rs1055479	A	G	151	182	333	0	5	338	0	0
8	26241525	rs3808582	C	G	2	4	6	0	0	6	0	0
8	26244532	rs74368561	T	C	5	5	10	0	0	10	0	0
8	26245658	rs2874670	G	A	7	6	13	0	0	13	0	0
8	26249018	rs2304300	G	A	4	4	8	0	0	8	0	0
8	26250296	rs3808580	T	C	3	4	7	0	0	7	0	0
8	26250682	rs3808579	C	T	25	8	33	0	0	33	0	0
8	26250906	rs3779916	C	A	7	5	12	0	0	12	0	0
8	26266390	.	A	G	7	6	13	0	1	14	0	0
8	26266834	rs3808576	G	A	10	12	22	0	0	22	0	0
8	26269412	rs12165	C	T	155	140	295	0	0	295	0	0
8	26362967	rs17055364	C	T	5	2	7	0	0	7	0	0
8	26441477	rs11786691	G	A	5	7	12	0	0	12	0	0
8	26514101	rs58827210	C	T	5	8	13	0	0	13	0	0
8	26514144	rs17055639	C	T	5	5	10	0	0	10	0	0
8	26514171	rs17055641	G	A	6	3	9	0	0	9	0	0
8	27184341	rs2322720	C	T	6	5	11	0	0	11	0	0
8	27208126	rs6987305	G	A	1	5	6	0	0	6	0	0
8	27245721	rs11787212	A	C	3	3	6	0	0	6	0	0
8	27245790	rs11783759	C	T	2	4	6	0	0	6	0	0
8	27255080	rs1128433	A	G	224	217	441	0	2	443	0	0
8	27255128	rs1045510	T	C	249	197	446	0	1	447	0	0
8	27255146	rs1045511	G	A	234	192	426	0	3	429	0	0
8	27255263	rs1045512	A	G	210	192	402	0	4	406	0	0
8	27256918	rs17376241	G	A	2	4	6	0	0	6	0	0
8	27262137	rs116433564	C	T	23	10	33	0	1	34	0	0
8	27262195	rs1367088	C	T	21	5	26	0	0	26	0	0
8	27262366	rs1367089	C	G	11	7	18	0	1	19	0	0
8	27263107	rs10088702	C	T	7	13	20	0	0	20	0	0
8	27263359	rs10103554	A	T	5	7	12	0	0	12	0	0
8	27263900	rs11135991	C	T	14	11	25	0	0	25	0	0
8	27264245	rs3779633	C	A	7	8	15	0	0	15	0	0
8	27264952	rs11986969	G	A	6	10	16	0	1	17	0	0
8	27265371	rs725788	T	C	7	15	22	0	0	22	0	0
8	27277537	rs1030526	G	A	207	152	359	0	5	364	0	0
8	27280472	rs77318377	G	A	5	2	7	0	0	7	0	0
8	27289612	rs11988406	C	T	3	5	8	0	0	8	0	0
8	27289935	rs2303881	T	C	3	7	10	0	0	10	0	0
8	27289963	rs2303882	T	C	4	7	11	0	0	11	0	0
8	27290528	rs34900744	G	A	2	6	8	0	0	8	0	0
8	27293865	rs7005936	C	T	329	192	521	0	6	527	0	0
8	27296004	rs5000605	A	G	5	4	9	0	0	9	0	0
8	27297202	rs11995441	T	C	27	24	51	0	0	51	0	0
8	27297594	rs2241655	G	A	28	17	45	0	0	45	0	0
8	27299087	rs10091396	C	A	30	21	51	0	0	51	0	0
8	27299277	rs9773817	A	G	31	34	65	0	1	66	0	0
8	27299411	rs3736527	A	T	30	25	55	0	1	56	0	0
8	27299469	rs3736526	A	G	25	21	46	0	1	47	0	0
8	27299553	rs3736525	C	T	37	23	60	0	2	62	0	0
8	27299935	rs9657294	A	G	37	18	55	0	0	55	0	0
8	27300088	rs2241659	T	C	36	21	57	0	1	58	0	0
8	27300121	rs2241660	A	G	26	23	49	0	1	50	0	0
8	27301160	rs10113756	A	G	5	3	8	0	0	8	0	0
8	27302433	rs9657295	G	A	82	77	159	0	1	160	0	0
8	27302885	rs4733063	A	G	72	86	158	0	0	158	0	0
8	27303015	rs11135993	T	C	128	116	244	0	1	245	0	0
8	27306103	rs10098202	C	T	35	23	58	0	0	58	0	0
8	27306159	rs11776693	G	A	34	28	62	0	0	62	0	0
8	27307095	rs6557999	A	G	44	39	83	0	1	84	0	0
8	27307275	rs7846626	G	C	52	36	88	0	0	88	0	0
8	27307336	rs28394608	A	G	42	43	85	0	0	85	0	0
8	27307522	rs7831523	A	G	19	22	41	0	0	41	0	0
8	27308004	rs4733065	G	A	41	43	84	0	0	84	0	0
8	27308538	rs751018	G	A	3	7	10	0	0	10	0	0
8	27308585	rs751019	A	C	463	461	924	0	7	931	0	0
8	27309339	rs1106359	T	C	20	21	41	0	0	41	0	0
8	27309657	rs62502452	T	C	22	23	45	0	0	45	0	0
8	27311125	rs79608631	C	T	26	24	50	0	0	50	0	0
8	27311244	rs74614358	T	A	14	18	32	0	0	32	0	0
8	27312040	rs10093964	C	T	18	26	44	0	0	44	0	0
8	27312135	rs7007145	G	A	3	4	7	0	0	7	0	0
8	27312687	rs752994	T	A	15	8	23	0	0	23	0	0
8	27312809	rs752993	G	A	13	7	20	0	0	20	0	0
8	27313085	rs919494	G	T	12	7	19	0	0	19	0	0
8	27315095	rs7838932	T	C	5	12	17	0	0	17	0	0
8	27316117	rs2271920	G	A	572	453	1025	0	12	1037	0	0
8	27591849	rs9797	G	A	16	20	36	0	0	36	0	0
8	27593215	rs4732601	A	G	74	95	169	0	2	171	0	0
8	27593650	rs10081527	T	C	54	63	117	0	1	119	1	0
8	27630152	rs7842666	G	A	3	5	8	0	0	8	0	0
8	27634064	rs4732748	C	T	11	9	20	0	0	20	0	0
8	27635142	rs28688682	T	G	4	5	9	0	0	9	0	0
8	27635351	rs17057834	C	T	12	3	15	0	0	15	0	0
8	27635860	rs10503821	G	A	3	3	6	0	0	6	0	0
8	27661318	rs72609983	C	A	7	9	16	0	0	16	0	0
8	27661380	rs72609984	G	A	5	9	14	0	0	14	0	0
8	27661426	rs201762904	T	A	6	3	9	0	0	9	0	0
8	28203937	rs351780	G	T	269	256	525	0	7	532	0	0
8	28204264	rs351779	G	A	286	254	540	0	18	559	1	0
8	28212602	rs17059008	A	G	4	4	8	0	0	8	0	0
8	28212636	rs4732640	T	A	3	5	8	0	0	8	0	0
8	28214096	rs2272749	T	C	3	8	11	0	0	11	0	0
8	28215161	rs7006477	G	A	7	3	10	0	0	10	0	0
8	28215776	rs58738185	G	A	6	3	9	0	0	9	0	0
8	28242622	rs3735727	T	C	4	2	6	0	0	6	0	0
8	28782220	rs150972818	C	T	3	4	7	0	0	7	0	0
8	28911842	rs1542690	C	T	22	28	50	0	0	50	0	0
8	28912406	rs117510848	C	T	27	29	56	0	1	57	0	0
8	28912443	rs76158744	C	T	26	35	61	0	1	62	0	0
8	28918998	rs56221500	C	T	22	18	40	0	0	40	0	0
8	28919931	rs17454061	C	T	14	16	30	0	0	30	0	0
8	28925475	rs76644623	C	T	16	17	33	0	1	34	0	0
8	28925624	rs375220081	G	A	16	27	43	0	2	45	0	0
8	28926081	rs17454230	G	T	19	15	34	0	1	35	0	0
8	28927805	rs11775056	T	G	12	19	31	0	0	31	0	0
8	28985829	rs7007226	C	G	5	2	7	0	0	7	0	0
8	29091635	rs2925210	T	C	7	8	15	0	0	15	0	0
8	29921006	rs7036	T	C	936	1127	2063	0	22	2085	0	0
8	29923556	rs142700582	C	T	1962	1841	3803	0	24	3827	0	0
8	29940525	rs113716580	T	C	104	81	185	0	0	185	0	0
8	29955745	rs117311271	G	T	3	4	7	0	0	7	0	0
8	29967903	rs78536546	G	A	4	3	7	0	1	8	0	0
8	29977277	.	G	A	5	1	6	0	0	6	0	0
8	29995207	rs7828996	C	T	25	32	57	0	0	57	0	0
8	29995368	rs7843645	T	C	27	33	60	0	1	61	0	0
8	30376989	.	T	C	10	0	10	0	4	14	0	0
8	30402817	rs2915595	G	A	27	14	41	0	0	41	0	0
8	30404270	.	G	T	18	27	45	0	1	46	0	0
8	30404671	rs1106352	C	T	15	16	31	0	0	31	0	0
8	30421455	rs3779641	C	T	2	5	7	0	0	7	0	0
8	30422060	rs62508371	C	T	5	4	9	0	0	9	0	0
8	30424440	rs35631438	T	C	6	4	10	0	0	10	0	0
8	30427531	rs17554408	C	T	12	2	14	0	0	14	0	0
8	30427612	rs2280912	G	A	4	8	12	0	0	12	0	0
8	30428758	rs34437419	C	T	4	9	13	0	0	13	0	0
8	30480097	rs12545384	C	A	5	2	7	0	0	7	0	0
8	30480697	rs12545979	C	A	6	5	11	0	0	11	0	0
8	30535660	rs3594	C	A	55	62	117	0	0	117	0	0
8	30659349	rs28714262	T	C	5	4	9	0	0	9	0	0
8	30665640	rs6987432	A	G	2	5	7	0	0	7	0	0
8	30973957	rs1800392	G	T	9	16	25	0	0	25	0	0
8	30974792	rs4037084	T	C	8	8	16	0	0	16	0	0
8	30975000	rs11574309	G	A	9	9	18	0	0	18	0	0
8	30977392	rs4733225	T	C	7	17	24	0	0	24	0	0
8	30977490	rs4733069	C	T	7	2	9	0	0	9	0	0
8	30977717	rs2725352	T	C	11	17	28	0	0	28	0	0
8	30999280	rs1801195	G	T	33	34	67	0	2	69	0	0
8	31002562	rs149473176	G	A	5	4	9	0	0	9	0	0
8	31024638	rs1801196	C	T	69	54	123	0	1	124	0	0
8	31024654	rs1346044	T	C	56	69	125	0	2	127	0	0
8	31033346	rs1863281	T	A	1	6	7	0	0	7	0	0
8	33370261	rs34226219	G	A	10	19	29	0	1	30	0	0
8	33409957	rs7845224	C	T	4	2	6	0	0	6	0	0
8	33410077	rs7845367	C	T	4	3	7	0	0	7	0	0
8	33410800	rs7007586	T	A	3	3	6	0	1	7	0	0
8	33416189	rs3735950	G	A	173	151	324	0	0	324	0	0
8	33416222	rs3735951	C	T	178	166	344	0	3	347	0	0
8	33424546	rs3735952	T	G	44	36	80	0	0	80	0	0
8	37717895	.	C	T	52	39	91	0	1	92	0	0
8	37719289	rs112555767	T	C	158	181	339	0	5	344	0	0
8	37720879	.	T	C	6	2	8	0	0	8	0	0
8	37724335	rs116542967	C	A	10	14	24	0	0	24	0	0
8	37725949	rs7841767	A	G	5	9	14	0	2	16	0	0
8	37726465	rs4976896	G	A	6	3	9	0	0	9	0	0
8	37728017	rs7817179	A	G	184	216	400	0	1	401	0	0
8	37728019	rs7820872	T	G	181	216	397	0	2	401	2	0
8	37733591	rs7832233	G	T	3	4	7	0	0	7	0	0
8	37737034	rs4976895	C	T	11	11	22	0	0	22	0	0
8	37750245	rs115793776	T	C	6	2	8	0	0	8	0	0
8	37750289	rs7812866	A	C	7	6	13	0	0	13	0	0
8	37752290	rs6991739	A	G	5	4	9	0	0	9	0	0
8	38001675	rs35462433	A	C	46	51	97	0	0	97	0	0
8	38020325	rs2843727	G	A	12	3	15	0	5	20	0	0
8	38020414	rs2843726	T	A	15	4	19	0	0	19	0	0
8	38024623	rs2843745	A	T	3	4	7	0	0	7	0	0
8	38025175	rs2843744	T	C	2	4	6	0	0	6	0	0
8	38026972	rs72643084	T	A	6	0	6	0	0	6	0	0
8	38027519	rs16887236	A	G	7	3	10	0	0	10	0	0
8	38028195	rs7823144	G	A	33	28	61	0	0	61	0	0
8	38109763	.	C	T	94	80	174	0	2	176	0	0
8	38458696	rs7812668	T	C	7	0	7	0	0	7	0	0
8	38644914	rs11467	A	G	10	11	21	0	1	22	0	0
8	38677322	rs34235313	C	T	99	139	238	0	0	238	0	0
8	38683329	rs36029398	T	G	66	82	148	0	2	150	0	0
8	38683736	rs7815289	A	G	70	79	149	0	1	150	0	0
8	38685274	rs34493171	T	G	3	7	10	0	0	10	0	0
8	38686045	rs2037203	G	A	15	22	37	0	0	37	0	0
8	38686078	.	G	A	16	8	24	0	0	24	0	0
8	38687230	rs7005388	T	C	3	10	13	0	0	13	0	0
8	38694383	rs869471	T	G	2	6	8	0	0	8	0	0
8	38697183	rs111838579	G	A	23	13	36	0	0	36	0	0
8	38697649	rs13262797	T	C	5	13	18	0	3	21	0	0
8	38701329	rs7009521	A	G	5	7	12	0	0	12	0	0
8	38706369	rs1802267	C	T	118	146	264	0	3	267	0	0
8	38709553	rs1135990	C	T	246	264	510	0	3	513	0	0
8	38803551	rs62504403	T	C	5	2	7	0	0	7	0	0
8	38808277	.	G	A	4	3	7	0	0	7	0	0
8	38845890	rs149162978	C	T	18	13	31	0	0	31	0	0
8	38854660	rs148707472	C	A	18	7	25	0	1	26	0	0
8	41349404	rs4736990	A	G	2	7	9	0	0	9	0	0
8	41355096	rs17656952	C	T	221	196	417	0	3	420	0	0
8	41363742	rs17598698	G	C	8	6	14	0	0	14	0	0
8	41364319	rs67683968	G	A	1	6	7	0	0	7	0	0
8	41364486	rs17657160	G	A	11	8	19	0	1	20	0	0
8	41365708	rs17657196	G	A	7	2	9	0	0	9	0	0
8	41367882	rs7442	A	G	186	125	311	0	4	315	0	0
8	41457094	rs2977844	C	T	4	3	7	0	0	7	0	0
8	41470884	rs2920127	G	A	4	4	8	0	0	8	0	0
8	41525914	rs750625	C	T	3	4	7	0	0	7	0	0
8	41790866	rs2980901	G	C	106	132	238	0	0	238	0	0
8	41807750	rs10504049	A	G	0	6	6	0	0	6	0	0
8	41814511	.	A	G	4	2	6	0	0	6	0	0
8	41906512	rs141360124	T	C	58	63	121	0	2	123	0	0
8	41906694	rs7006698	A	T	73	72	145	0	2	147	0	0
8	42026968	rs34361836	A	T	7	1	8	0	0	8	0	0
8	42028537	rs1050275	T	C	3	5	8	0	0	8	0	0
8	42397435	rs35794418	G	C	10	7	17	0	1	18	0	0
8	42399906	rs13273204	C	T	4	6	10	0	0	10	0	0
8	42400823	rs34432089	G	A	3	5	8	0	0	8	0	0
8	42762954	rs773072	C	T	4	2	6	0	0	6	0	0
8	42763046	.	C	T	12	6	18	0	1	19	0	0
8	42763494	rs773071	A	G	12	10	22	0	1	23	0	0
8	42764315	rs1081886	T	G	25	13	38	0	0	38	0	0
8	42765132	rs1625050	G	A	34	16	50	0	1	51	0	0
8	42879512	rs13261180	C	A	27	26	53	0	0	53	0	0
8	42912358	rs111395831	A	T	17	8	25	0	1	26	0	0
8	42918890	rs10958736	A	G	2	7	9	0	0	9	0	0
8	42933483	rs7838899	T	G	7	8	15	0	0	15	0	0
8	43049743	rs11781737	G	T	8	9	17	0	0	17	0	0
8	43056513	rs3739431	T	C	111	123	234	0	1	235	0	0
8	43057925	rs141634395	T	A	2	4	6	0	0	6	0	0
8	48007023	rs62538827	A	G	48	61	109	0	2	111	0	0
8	48007984	rs368736221	T	C	15	16	31	0	0	31	0	0
8	48008497	rs369625382	T	C	26	8	34	0	0	34	0	0
8	48009252	rs147580712	G	A	19	15	34	0	1	35	0	0
8	48009973	rs4872722	A	G	23	11	34	0	0	34	0	0
8	48011650	rs189231865	G	A	7	6	13	0	0	13	0	0
8	48012541	rs7018390	A	G	6	4	10	0	0	10	0	0
8	48033959	rs11136110	A	C	19	10	29	0	0	29	0	0
8	48044948	rs4242449	T	A	11	10	21	0	0	21	0	0
8	48047027	rs79519014	C	T	8	4	12	0	0	12	0	0
8	48047089	rs4513988	A	C	5	4	9	0	0	9	0	0
8	48048089	rs6988360	C	T	13	16	29	0	1	30	0	0
8	48078915	rs72644567	G	A	32	21	53	0	0	53	0	0
8	48079026	rs183586259	C	T	32	28	60	0	1	61	0	0
8	48084390	rs143056987	T	C	8	0	8	0	0	8	0	0
8	48084393	rs11996019	A	G	8	0	8	0	0	8	0	0
8	48312463	rs57914950	T	C	33	30	63	0	1	64	0	0
8	48538943	rs149062103	A	G	8	10	18	0	0	18	0	0
8	48598738	rs16930163	A	G	3	3	6	0	0	6	0	0
8	48625275	.	G	A	61	38	99	0	5	104	0	0
8	48739305	rs4278157	G	A	51	40	91	0	0	91	0	0
8	48846519	rs1231202	T	C	5	1	6	0	0	6	0	0
8	48866189	.	T	C	11	15	26	0	0	26	0	0
8	48885436	rs762679	T	A	119	233	352	0	4	356	0	0
8	49636560	rs117825000	T	A	0	10	10	0	0	10	0	0
8	52731092	.	T	A	8	0	8	0	0	8	0	0
8	52731250	.	A	G	17	0	17	0	0	17	0	0
8	52811580	rs139799580	G	A	24	21	45	0	1	46	0	0
8	53537316	rs1129660	A	G	207	200	407	0	6	413	0	0
8	53538495	rs7825939	A	G	2	7	9	0	0	9	0	0
8	53555069	rs2305427	A	G	151	170	321	0	3	324	0	0
8	53555487	rs180720812	G	A	4	2	6	0	0	6	0	0
8	53557335	rs2107	C	T	5	1	6	0	0	6	0	0
8	53561892	rs964785	T	C	20	28	48	0	0	48	0	0
8	53562535	.	T	G	9	13	22	0	0	22	0	0
8	53566263	.	C	T	14	10	24	0	1	25	0	0
8	53586706	rs17337252	A	G	87	79	166	0	2	168	0	0
8	53598961	rs2016314	A	C	2	5	7	0	0	7	0	0
8	54664939	rs78568368	T	C	4	2	6	0	0	6	0	0
8	54691609	rs6473891	A	G	6	6	12	0	0	12	0	0
8	54697250	rs9643821	G	C	13	8	21	0	0	21	0	0
8	54697745	rs10087783	C	T	5	8	13	0	1	14	0	0
8	54852643	rs3816772	C	G	8	4	12	0	0	12	0	0
8	54885668	.	T	C	2	6	8	0	0	8	0	0
8	54893937	rs192737072	C	T	3	4	7	0	0	7	0	0
8	56676509	rs2044814	A	G	47	71	118	0	5	123	0	0
8	56685952	rs77528344	G	C	1	5	6	0	0	6	0	0
8	56792586	rs1050855	G	A	143	167	310	0	2	312	0	0
8	56861732	.	A	G	33	25	58	0	1	59	0	0
8	56866780	rs2292419	T	C	2	4	6	0	0	6	0	0
8	56866957	rs10089932	A	G	5	8	13	0	0	13	0	0
8	56867136	rs7832713	A	G	2	5	7	0	0	7	0	0
8	56867618	rs10100561	A	C	9	13	22	0	0	22	0	0
8	56867945	rs7828258	C	T	5	16	21	0	0	21	0	0
8	56868065	rs56181546	G	A	5	13	18	0	0	18	0	0
8	56868240	rs10104302	T	G	14	30	44	0	0	44	0	0
8	56868641	rs7002888	C	G	12	13	25	0	0	25	0	0
8	56869605	rs2668016	C	T	4	4	8	0	0	8	0	0
8	56870048	rs2719240	C	G	2	6	8	0	0	8	0	0
8	56877557	rs13257714	G	A	1	6	7	0	0	7	0	0
8	56877588	rs34955873	C	A	4	4	8	0	0	8	0	0
8	56879113	rs2667988	C	G	3	3	6	0	0	6	0	0
8	56879783	rs55891909	C	T	2	5	7	0	0	7	0	0
8	56880358	rs2667985	C	G	3	6	9	0	0	9	0	0
8	56881598	rs2719254	T	G	5	5	10	0	0	10	0	0
8	56882471	rs1027986	A	G	9	22	31	0	0	31	0	0
8	56883171	rs1027985	G	C	8	8	16	0	0	16	0	0
8	56883618	rs907423	G	C	3	7	10	0	0	10	0	0
8	56884089	rs952784	G	A	5	8	13	0	0	13	0	0
8	56884595	rs16922494	G	T	2	13	15	0	0	15	0	0
8	56884751	rs16922497	G	T	5	7	12	0	0	12	0	0
8	56885098	rs2036898	G	C	5	11	16	0	0	16	0	0
8	56885135	rs2036897	T	C	7	10	17	0	0	17	0	0
8	56885601	rs7838485	A	C	2	6	8	0	0	8	0	0
8	56886184	rs2719232	G	A	8	15	23	0	0	23	0	0
8	56886657	rs10112370	C	T	6	9	15	0	1	16	0	0
8	56886663	rs2719231	A	G	8	11	19	0	0	19	0	0
8	56886687	rs10101914	T	C	8	10	18	0	0	18	0	0
8	56887436	rs16922502	C	T	8	7	15	0	0	15	0	0
8	56888120	rs2719229	G	A	7	11	18	0	0	18	0	0
8	56889187	rs2466007	T	C	5	24	29	0	0	29	0	0
8	56892230	rs16922508	T	C	2	5	7	0	0	7	0	0
8	56892888	rs7828483	G	C	5	1	6	0	0	6	0	0
8	56897801	rs2667979	G	A	4	3	7	0	0	7	0	0
8	56899136	rs16920176	T	C	3	5	8	0	0	8	0	0
8	56904006	rs6990948	G	A	3	3	6	0	0	6	0	0
8	56904026	rs16920192	T	A	4	4	8	0	0	8	0	0
8	56904244	rs2667977	A	G	6	3	9	0	0	9	0	0
8	56904723	rs2667976	C	A	7	9	16	0	0	16	0	0
8	56904759	rs7826509	G	A	5	5	10	0	0	10	0	0
8	56904852	rs2719252	T	C	7	2	9	0	0	9	0	0
8	56905130	rs2667975	T	C	8	7	15	0	0	15	0	0
8	56905166	rs2719253	T	C	4	6	10	0	0	10	0	0
8	56905377	rs2667974	C	A	9	7	16	0	0	16	0	0
8	56906590	rs2667973	A	C	6	11	17	0	0	17	0	0
8	56906645	rs56050111	G	C	4	10	14	0	0	14	0	0
8	56906976	rs2719243	T	C	8	6	14	0	1	15	0	0
8	56907160	rs2667971	T	C	11	4	15	0	0	15	0	0
8	56907232	rs2719242	T	C	5	1	6	0	0	6	0	0
8	56907411	rs73679619	A	G	15	4	19	0	0	19	0	0
8	56907950	rs6474036	C	T	12	16	28	0	1	29	0	0
8	56910410	rs57170159	A	G	7	6	13	0	1	14	0	0
8	56910701	rs4738466	G	A	6	4	10	0	0	10	0	0
8	56911861	rs2175487	A	G	10	0	10	0	0	10	0	0
8	56913527	rs2719248	T	A	5	3	8	0	0	8	0	0
8	56913802	rs73679621	G	A	10	6	16	0	0	16	0	0
8	56917166	rs3106348	C	T	3	7	10	0	0	10	0	0
8	56920443	rs2668010	C	T	13	7	20	0	0	20	0	0
8	56921672	rs7824121	C	T	6	3	9	0	0	9	0	0
8	56922067	rs1995976	A	G	14	19	33	0	0	33	0	0
8	56980542	rs2976009	G	A	17	17	34	0	0	34	0	0
8	56981194	rs6474042	G	A	13	13	26	0	0	26	0	0
8	56981649	rs6474043	G	A	8	2	10	0	0	10	0	0
8	56982015	rs2976050	A	G	10	1	11	0	0	11	0	0
8	56984164	rs16920295	A	C	20	16	36	0	0	36	0	0
8	56984392	rs2953916	T	C	12	7	19	0	0	19	0	0
8	56984977	rs112653206	C	T	5	7	12	0	0	12	0	0
8	56985116	rs111976607	C	A	4	2	6	0	0	6	0	0
8	56985117	rs111329631	C	A	4	2	6	0	0	6	0	0
8	56986178	rs16920302	C	G	92	68	160	0	1	161	0	0
8	56986737	rs2976044	A	G	78	148	226	0	4	230	0	0
8	56986808	rs73592343	C	T	22	83	105	0	2	107	0	0
8	56987059	rs73679777	C	G	148	125	273	0	17	290	0	0
8	59718767	rs1060263	T	C	12	19	31	0	0	31	0	0
8	60030945	rs379771	G	A	6	12	18	0	0	18	0	0
8	60032096	rs62504556	C	T	6	4	10	0	0	10	0	0
8	60032541	rs7837298	C	G	13	11	24	0	1	25	0	0
8	61191846	rs7461425	A	G	1	9	10	0	0	10	0	0
8	61462223	rs11778115	A	G	3	10	13	0	0	13	0	0
8	61462295	rs13257359	G	C	4	4	8	0	0	8	0	0
8	61476709	rs2875973	C	T	2	4	6	0	0	6	0	0
8	61480830	rs12681841	A	G	4	5	9	0	0	9	0	0
8	61481614	rs10098769	T	G	5	5	10	0	0	10	0	0
8	61482096	rs117055822	G	T	7	5	12	0	0	12	0	0
8	61488824	rs2981277	T	C	17	3	20	0	0	20	0	0
8	61503450	rs13278228	A	G	4	5	9	0	1	10	0	0
8	61504093	rs2326570	A	G	3	3	6	0	0	6	0	0
8	61504193	rs2326571	G	A	4	3	7	0	0	7	0	0
8	61510555	rs34234629	A	T	4	3	7	0	0	7	0	0
8	61510658	rs13267765	A	C	3	3	6	0	0	6	0	0
8	61510867	rs11786146	A	G	6	3	9	0	0	9	0	0
8	61511366	rs6995515	A	C	11	5	16	0	0	16	0	0
8	61511725	rs12680436	T	C	11	5	16	0	0	16	0	0
8	61530310	rs677467	A	G	3	3	6	0	0	6	0	0
8	61534428	rs7413	A	G	114	126	240	0	3	243	0	0
8	61534895	rs629268	C	T	45	62	107	0	1	108	0	0
8	61535125	rs649634	C	G	34	59	93	0	0	93	0	0
8	61535417	rs9437	G	A	37	46	83	0	1	84	0	0
8	61535709	rs652422	G	C	4	7	11	0	0	11	0	0
8	61765419	rs6999971	G	A	10	7	17	0	1	18	0	0
8	61769873	rs3793444	G	A	4	2	6	0	0	6	0	0
8	62413220	rs4507756	T	C	11	10	21	0	0	21	0	0
8	62537309	rs6549	A	G	60	45	105	0	0	105	0	0
8	62570278	rs67189750	G	T	7	5	12	0	0	12	0	0
8	62570457	rs55720422	G	A	2	5	7	0	0	7	0	0
8	62571619	rs72659032	T	C	9	23	32	0	0	32	0	0
8	62572054	rs17205360	C	G	21	4	25	0	0	25	0	0
8	62573362	rs17546883	T	C	4	6	10	0	0	10	0	0
8	62574787	rs72659034	T	C	2	4	6	0	0	6	0	0
8	62581189	rs7842421	G	T	2	5	7	0	0	7	0	0
8	62626962	rs3829051	C	T	88	58	146	0	1	147	0	0
8	62627004	rs3750279	A	G	65	35	100	0	0	100	0	0
8	64080486	rs2241753	G	A	25	32	57	0	1	58	0	0
8	64080596	.	C	T	65	44	109	0	1	110	0	0
8	64087102	rs2217827	G	A	12	2	14	0	0	14	0	0
8	64089758	.	T	C	4	4	8	0	0	8	0	0
8	64089789	rs72659895	A	G	3	5	8	0	1	9	0	0
8	64090423	rs77029514	T	C	3	7	10	0	0	10	0	0
8	64093921	rs72659896	A	C	7	5	12	0	0	12	0	0
8	64096682	rs76393927	G	T	56	44	100	0	1	101	0	0
8	64100493	rs73684689	C	G	5	2	7	0	0	7	0	0
8	64100595	rs12550222	A	C	7	4	11	0	1	12	0	0
8	64124956	rs7464	G	A	178	108	286	0	4	290	0	0
8	65559687	rs113418660	G	A	4	3	7	0	0	7	0	0
8	66623229	rs62507639	G	T	4	5	9	0	0	9	0	0
8	66623231	rs71529183	G	T	4	5	9	0	0	9	0	0
8	66625048	rs117665000	G	A	18	17	35	0	0	35	0	0
8	66644713	rs10808746	G	A	4	8	12	0	0	12	0	0
8	66739380	rs34383016	A	G	10	9	19	0	0	19	0	0
8	66741163	rs150447615	C	T	8	9	17	0	0	17	0	0
8	66755163	rs6472226	G	A	5	3	8	0	0	8	0	0
8	67341938	rs3739336	G	T	46	34	80	0	1	81	0	0
8	67380737	rs12265	C	A	23	28	51	0	0	51	0	0
8	67624703	rs147538859	C	T	27	26	53	0	1	54	0	0
8	67774115	rs74741656	C	T	1	5	6	0	0	6	0	0
8	68118795	rs7002622	G	A	9	6	15	0	0	15	0	0
8	68124610	rs80037804	G	A	6	6	12	0	1	13	0	0
8	68125660	rs1172	C	G	5	10	15	0	0	15	0	0
8	68126360	.	C	A	6	4	10	0	0	10	0	0
8	68127243	rs1471084	C	T	5	5	10	0	0	10	0	0
8	68203197	.	T	A	14	9	23	0	0	23	0	0
8	68222485	rs7464980	G	A	2	4	6	0	3	9	0	0
8	68223106	rs76650391	G	A	2	5	7	0	0	7	0	0
8	68224291	rs13280556	C	T	3	5	8	0	0	8	0	0
8	68224493	.	A	C	3	3	6	0	0	6	0	0
8	68225858	rs12675528	T	C	14	21	35	0	0	35	0	0
8	68237214	rs68086555	T	A	4	2	6	0	0	6	0	0
8	68256888	rs718348	A	T	13	11	24	0	0	24	0	0
8	70042529	rs6994342	G	A	23	0	23	0	0	23	0	0
8	71486085	rs8993	A	C	136	119	255	0	12	267	0	0
8	71486568	rs268566	G	C	133	108	241	0	2	243	0	0
8	71489085	rs372170	A	G	8	8	16	0	0	16	0	0
8	71489200	rs2622653	A	G	6	7	13	0	0	13	0	0
8	71489406	rs112432103	C	T	11	9	20	0	0	20	0	0
8	71489682	rs368854	C	A	6	12	18	0	2	20	0	0
8	71490539	rs67074395	T	C	6	10	16	0	1	17	0	0
8	71491316	rs13281844	T	C	3	5	8	0	0	8	0	0
8	71491396	rs268560	C	T	12	4	16	0	0	16	0	0
8	71493922	rs268561	T	C	4	4	8	0	0	8	0	0
8	71494114	rs13276058	T	G	3	5	8	0	0	8	0	0
8	71497051	rs10094121	A	G	7	0	7	0	0	7	0	0
8	71507697	rs7015434	C	T	5	5	10	0	0	10	0	0
8	71513130	rs268594	T	C	2	4	6	0	0	6	0	0
8	71550832	rs7830986	T	C	4	3	7	0	0	7	0	0
8	72754342	rs900126	G	T	1	9	10	0	0	11	1	0
8	72754502	rs3824153	G	A	2	13	15	0	2	17	0	0
8	72754606	rs3779759	C	G	1	14	15	0	0	15	0	0
8	72754748	rs3779761	C	T	1	9	10	0	0	10	0	0
8	73941934	rs79217206	A	T	1	7	8	0	0	8	0	0
8	74203576	rs4394387	G	A	12	9	21	0	0	21	0	0
8	74204808	rs4237000	T	G	10	11	21	0	0	21	0	0
8	74206582	rs7819550	G	A	5	14	19	0	0	19	0	0
8	74210151	rs7827249	T	C	15	14	29	0	0	29	0	0
8	74211333	rs4738317	A	G	3	4	7	0	0	7	0	0
8	74234193	rs9298224	G	A	6	9	15	0	0	15	0	0
8	74235980	rs7814695	A	G	54	35	89	0	1	90	0	0
8	74236370	rs4738320	G	A	114	107	221	0	2	223	0	0
8	74369419	rs4738364	G	A	3	6	9	0	0	9	0	0
8	74372607	rs10099785	T	C	2	6	8	0	0	8	0	0
8	74406258	rs6980652	G	A	6	4	10	0	1	11	0	0
8	74408219	rs2383916	C	A	3	3	6	0	0	6	0	0
8	74463404	rs62508211	T	G	26	22	48	0	1	49	0	0
8	74463797	rs10112019	T	C	9	8	17	0	0	17	0	0
8	74657672	rs77140001	G	T	6	3	9	0	0	9	0	0
8	74702487	rs16938729	A	T	26	22	48	0	0	48	0	0
8	74703133	rs17224289	C	T	17	14	31	0	0	31	0	0
8	74771222	.	T	C	7	0	7	0	0	7	0	0
8	74868478	rs7822073	T	C	33	50	83	0	0	83	0	0
8	74883532	rs34432301	A	G	3	3	6	0	0	6	0	0
8	74892584	rs118132118	T	C	4	3	7	0	0	7	0	0
8	75276959	rs1135715	A	G	9	6	15	0	1	16	0	0
8	75277432	rs4737414	C	G	19	15	34	0	1	35	0	0
8	80868798	.	G	A	4	9	13	0	0	13	0	0
8	80942341	rs78308259	C	G	43	64	107	0	0	107	0	0
8	81771461	rs1199028	A	C	3	6	9	0	0	9	0	0
8	81881962	rs1445564	C	T	2	8	10	0	0	10	0	0
8	81885077	rs1445560	A	G	22	26	48	0	0	48	0	0
8	81976972	rs11778741	G	A	5	5	10	0	0	10	0	0
8	81997301	rs7834107	A	G	6	9	15	0	0	15	0	0
8	81998174	rs17570887	T	C	5	3	8	0	0	8	0	0
8	82571503	.	A	G	137	168	305	0	4	309	0	0
8	82590822	rs2932222	C	G	6	2	8	0	0	8	0	0
8	82712929	rs11776932	A	C	5	16	21	0	0	21	0	0
8	82715153	rs2029414	T	C	4	6	10	0	0	10	0	0
8	82727515	rs2635482	C	T	3	3	6	0	0	6	0	0
8	82727520	rs2600606	A	T	3	3	6	0	0	6	0	0
8	82734131	rs774465	T	G	2	4	6	0	0	6	0	0
8	82734903	rs2635492	G	A	4	3	7	0	0	7	0	0
8	82740048	rs12546081	C	A	6	3	9	0	0	9	0	0
8	82741020	rs61366694	C	T	5	2	7	0	0	7	0	0
8	82751822	rs1814534	T	G	41	29	70	0	1	71	0	0
8	82752291	rs12056632	A	G	52	47	99	0	2	101	0	0
8	82753350	rs111801710	T	C	5	1	6	0	0	6	0	0
8	82754118	rs4431552	A	C	6	2	8	0	0	8	0	0
8	82754140	rs4431553	A	C	7	2	9	0	0	9	0	0
8	82754365	rs4316108	C	A	34	25	59	0	1	60	0	0
8	86130525	rs118154463	C	T	28	17	45	0	2	47	0	0
8	87479810	rs8635	C	T	17	5	22	0	0	22	0	0
8	87480890	rs7017706	C	T	5	18	23	0	0	23	0	0
8	87484669	rs13282351	C	T	18	62	80	0	0	80	0	0
8	87484913	rs13042	G	A	19	13	32	0	0	32	0	0
8	87485483	rs6471354	G	C	38	25	63	0	1	64	0	0
8	87486168	rs4961193	T	C	13	13	26	0	1	27	0	0
8	87497176	rs11539113	G	A	55	83	138	0	1	139	0	0
8	87520894	rs68008113	C	A	14	30	44	0	0	44	0	0
8	87570665	rs1062850	A	C	68	71	139	0	3	142	0	0
8	87570728	rs1062851	C	T	59	51	110	0	1	111	0	0
8	87571049	rs1044719	A	G	41	48	89	0	2	91	0	0
8	87572665	rs2165462	A	T	63	83	146	0	0	146	0	0
8	87573644	rs8041	G	C	6	9	15	0	0	15	0	0
8	92006768	rs73299946	T	G	20	18	38	0	1	39	0	0
8	92033502	rs34503257	T	C	99	58	157	0	0	157	0	0
8	94935937	rs4735258	T	C	16	15	31	0	0	31	0	0
8	94936532	rs911	G	C	10	11	21	0	0	21	0	0
8	95512202	rs2381885	G	A	5	2	7	0	0	7	0	0
8	95522377	rs1048029	G	C	6	3	9	0	0	9	0	0
8	95523038	rs1055800	A	G	38	44	82	0	0	82	0	0
8	95523233	rs1055797	G	T	55	43	98	0	3	101	0	0
8	95541302	rs957448	A	G	102	94	196	0	6	202	0	0
8	95541371	rs957446	T	A	114	110	224	0	2	226	0	0
8	95547119	rs2304764	T	G	89	33	122	0	11	133	0	0
8	95554640	rs2381831	G	C	5	3	8	0	0	8	0	0
8	95757023	rs13279429	T	C	8	14	22	0	0	22	0	0
8	95845964	rs11783589	G	A	5	3	8	0	0	8	0	0
8	95846831	rs57773845	C	T	5	4	9	0	0	9	0	0
8	95847196	rs7834966	T	G	7	2	9	0	0	9	0	0
8	95876963	rs7004862	T	G	2	4	6	0	0	6	0	0
8	95877787	rs713113	T	C	166	164	330	0	2	332	0	0
8	95886624	rs11783522	G	A	5	13	18	0	0	18	0	0
8	95887225	rs10100651	G	C	16	14	30	0	0	30	0	0
8	95888307	rs1129152	C	T	247	273	520	0	0	520	0	0
8	95894246	rs16917106	C	A	3	9	12	0	0	12	0	0
8	95894800	rs7009940	A	G	1	6	7	0	0	7	0	0
8	95895976	rs16893774	G	C	29	24	53	0	0	53	0	0
8	95897031	rs11786451	T	G	16	17	33	0	0	33	0	0
8	95909498	rs16917117	T	C	7	12	19	0	1	20	0	0
8	95916811	rs2340584	A	G	6	3	9	0	0	9	0	0
8	95940598	rs2904889	T	G	155	173	328	0	0	328	0	0
8	95955074	rs4735333	G	A	3	3	6	0	0	6	0	0
8	95961459	rs185136740	G	A	4	5	9	0	0	9	0	0
8	95970484	rs77402106	C	T	9	2	11	0	0	11	0	0
8	95987570	rs13250762	A	G	5	7	12	0	0	12	0	0
8	95987584	rs3802191	A	G	6	8	14	0	0	14	0	0
8	95988209	rs6983948	C	T	24	0	24	0	0	24	0	0
8	95999257	rs72679221	C	T	8	9	17	0	0	17	0	0
8	96000919	rs4734295	A	G	22	23	45	0	1	46	0	0
8	96030110	rs16917224	T	C	2	8	10	0	0	10	0	0
8	96046951	rs74395342	A	G	1	7	8	0	0	8	0	0
8	96056805	rs2599713	C	T	10	2	12	0	1	13	0	0
8	96062930	rs57925408	T	C	24	37	61	0	2	63	0	0
8	97239613	rs2292836	A	C	8	14	22	0	0	22	0	0
8	97240129	rs10504961	C	T	6	7	13	0	0	13	0	0
8	97240847	rs13253635	A	G	13	7	20	0	0	20	0	0
8	97242124	rs7002575	G	A	15	28	43	0	0	43	0	0
8	97242849	rs7836698	C	T	49	57	106	0	0	106	0	0
8	97243720	rs2292835	G	A	91	63	154	0	0	154	0	0
8	97246978	rs2643339	C	A	3	4	7	0	0	7	0	0
8	97247469	rs2643338	A	G	4	2	6	0	0	6	0	0
8	97316821	rs938828	T	G	5	7	12	0	0	12	0	0
8	97317409	rs3808480	G	A	4	3	7	0	0	7	0	0
8	97338269	rs6468499	T	C	3	6	9	0	0	9	0	0
8	97339251	rs11782606	A	G	9	6	15	0	0	15	0	0
8	97339512	rs11782664	A	T	3	4	7	0	0	7	0	0
8	97340004	rs6468500	C	G	11	2	13	0	0	13	0	0
8	97340925	rs6985074	A	T	16	8	24	0	0	24	0	0
8	97342582	rs7001397	C	T	4	5	9	0	0	9	0	0
8	97347141	rs4734339	T	C	4	5	9	0	0	9	0	0
8	97847358	rs1864384	G	T	20	27	47	0	0	47	0	0
8	97866615	rs3926983	A	C	74	5	79	0	3	82	0	0
8	98737566	rs183762776	A	G	55	64	119	0	2	121	0	0
8	98788261	rs2449508	G	T	72	65	137	0	1	138	0	0
8	98863876	rs1136594	G	A	346	256	602	0	4	606	0	0
8	98863930	rs1136595	T	C	388	313	701	0	6	707	0	0
8	98864323	rs8879	G	A	441	309	750	0	4	754	0	0
8	98864794	rs3412	T	C	51	34	85	0	0	85	0	0
8	98943545	rs2290471	A	G	4	3	7	0	0	7	0	0
8	99058393	rs3758031	A	C	2	5	7	0	0	7	0	0
8	99114970	rs8218	A	C	76	80	156	0	2	158	0	0
8	99202587	rs1129891	G	A	40	73	113	0	0	113	0	0
8	99203508	rs2053934	C	T	53	17	70	0	0	70	0	0
8	99203938	rs62522244	T	C	19	32	51	0	0	51	0	0
8	99204718	rs4734391	C	T	9	20	29	0	0	29	0	0
8	99204723	rs4734392	T	G	9	22	31	0	0	31	0	0
8	99204766	rs4735538	T	A	15	28	43	0	1	44	0	0
8	99204935	.	G	C	15	30	45	0	0	45	0	0
8	99205111	rs3735885	T	C	16	28	44	0	0	44	0	0
8	99206298	rs4735539	G	A	4	2	6	0	0	6	0	0
8	99207949	rs56906975	C	T	3	4	7	0	0	7	0	0
8	99208190	rs3779721	A	C	17	16	33	0	0	33	0	0
8	99304803	rs10103296	A	G	7	3	10	0	0	10	0	0
8	99467856	rs10955176	C	T	13	3	16	0	0	16	0	0
8	99709075	rs75152092	G	A	5	2	7	0	0	7	0	0
8	99709092	rs76678403	G	T	5	2	7	0	0	7	0	0
8	100078492	rs142443408	A	G	9	1	10	0	0	10	0	0
8	100216840	rs10107358	T	A	39	39	78	0	0	78	0	0
8	100217360	rs144195821	A	G	62	59	121	0	0	121	0	0
8	100287418	rs138661755	A	G	25	27	52	0	1	53	0	0
8	100865836	rs6468694	G	A	24	15	39	0	1	40	0	0
8	100884321	rs35509895	C	G	7	6	13	0	0	13	0	0
8	100884323	rs35769167	C	A	8	6	14	0	0	14	0	0
8	100885600	rs4480092	A	T	5	7	12	0	0	12	0	0
8	100889677	rs7157	C	T	19	22	41	0	0	41	0	0
8	100890542	rs4626565	T	C	4	3	7	0	0	7	0	0
8	100891210	rs4510829	G	A	8	2	10	0	0	10	0	0
8	100899793	rs1130569	G	A	1809	1668	3477	0	12	3489	0	0
8	100904277	rs1130474	T	C	1076	1223	2299	0	15	2315	1	0
8	101562197	rs2154640	A	G	7	2	9	0	0	9	0	0
8	101934140	rs3134376	C	T	19	9	28	0	0	28	0	0
8	101934435	rs3134377	T	C	12	23	35	0	1	36	0	0
8	101937374	rs3105460	A	G	6	9	15	0	0	15	0	0
8	101937455	rs964917	T	C	12	12	24	0	0	24	0	0
8	101939479	rs1376672	G	A	17	19	36	0	0	36	0	0
8	101943319	rs3134380	G	A	4	2	6	0	0	6	0	0
8	101945728	rs76953856	T	A	4	3	7	0	0	7	0	0
8	101947336	rs3134352	C	G	23	15	38	0	0	38	0	0
8	101947453	rs3134353	A	T	5	6	11	0	0	11	0	0
8	101952506	rs3134356	G	T	3	6	9	0	0	9	0	0
8	101956083	rs62515491	C	T	7	1	8	0	0	8	0	0
8	101958433	rs3134358	G	T	4	4	8	0	0	8	0	0
8	101958568	rs3134359	G	C	6	1	7	0	0	7	0	0
8	101959609	rs1901362	G	A	4	4	8	0	0	8	0	0
8	101961910	rs983583	T	C	4	3	7	0	0	7	0	0
8	101962724	rs55685528	C	T	10	9	19	0	2	21	0	0
8	101962975	rs117524111	C	T	5	7	12	0	0	12	0	0
8	102700295	rs1131863	T	C	5	5	10	0	0	10	0	0
8	102700328	rs1131862	T	C	4	5	9	0	0	9	0	0
8	103247134	rs2853229	A	C	1	5	6	0	0	6	0	0
8	103251190	rs72554091	G	T	1	7	8	0	0	8	0	0
8	103268783	rs2607662	T	C	4	3	7	0	0	7	0	0
8	103280180	rs138949643	C	T	15	24	39	0	0	39	0	0
8	103299879	rs72681171	G	A	4	2	6	0	0	6	0	0
8	103356226	rs28552587	A	G	6	6	12	0	0	12	0	0
8	103380665	rs7838700	C	T	3	4	7	0	0	7	0	0
8	103380847	rs56111669	G	C	0	11	11	0	0	11	0	0
8	103420337	rs6468826	G	C	1	5	6	0	0	6	0	0
8	103661342	rs6935	G	T	334	228	562	0	3	565	0	0
8	103662219	rs3191333	G	A	230	369	599	0	10	609	0	0
8	103662852	rs13275089	T	C	9	9	18	0	0	18	0	0
8	103663912	rs11552577	T	G	293	288	581	0	5	586	0	0
8	103847247	rs79031142	A	G	5	1	6	0	0	6	0	0
8	103847399	rs2916558	A	C	4	5	9	0	0	9	0	0
8	103847603	rs111451996	A	G	3	6	9	0	0	9	0	0
8	104076421	rs2454030	C	T	13	9	22	0	0	22	0	0
8	104081085	rs9992	G	C	7	12	19	0	0	19	0	0
8	104343822	rs2934725	A	G	4	2	6	0	0	6	0	0
8	104411282	rs1061195	T	C	52	53	105	0	0	105	0	0
8	104412388	rs2241777	C	A	97	107	204	0	2	206	0	0
8	104414338	rs117399628	T	C	3	6	9	0	0	9	0	0
8	104415695	rs117846978	T	C	14	3	17	0	0	17	0	0
8	104416252	rs17228841	T	C	5	10	15	0	0	15	0	0
8	104416693	rs1865853	C	T	8	11	19	0	0	19	0	0
8	104416785	rs1865854	C	T	7	3	10	0	1	11	0	0
8	104417045	rs17803441	C	T	72	53	125	0	2	127	0	0
8	104417350	rs3133811	A	G	7	8	15	0	0	15	0	0
8	104418193	rs117357669	G	A	4	5	9	0	0	9	0	0
8	104427359	rs3134295	A	C	14	13	27	0	0	27	0	0
8	104427578	rs3134297	T	C	12	17	29	0	0	29	0	0
8	104432545	rs3134253	A	G	116	122	238	0	0	238	0	0
8	104432631	rs3098238	T	C	117	136	253	0	0	253	0	0
8	104434348	rs3098237	T	C	14	7	21	0	1	22	0	0
8	104435022	rs3098236	A	C	9	6	15	0	0	15	0	0
8	104435201	rs117739694	A	C	3	6	9	0	0	9	0	0
8	104435202	rs3098235	G	C	3	6	9	0	0	9	0	0
8	104435537	rs3134257	C	A	7	8	15	0	0	15	0	0
8	104435734	rs3134258	T	G	3	4	7	0	0	7	0	0
8	104435905	rs3098234	C	A	7	7	14	0	0	14	0	0
8	104440751	rs3098227	C	T	5	6	11	0	0	11	0	0
8	104441043	rs3134264	C	T	4	3	7	0	0	7	0	0
8	104441062	rs3098226	C	T	4	3	7	0	0	7	0	0
8	104442666	rs7816297	G	A	5	1	6	0	0	6	0	0
8	105372173	rs2669449	A	C	4	2	6	0	0	6	0	0
8	108430256	rs28493350	G	A	4	3	7	0	0	7	0	0
8	108431848	rs10955456	G	A	9	3	12	0	0	12	0	0
8	108441572	rs10086241	C	T	4	2	6	0	0	6	0	0
8	108443404	rs7816817	G	C	4	2	6	0	0	6	0	0
8	108449249	rs2959355	G	A	17	1	18	0	0	18	0	0
8	108449292	rs2916084	T	A	29	3	32	0	0	32	0	0
8	108450313	rs72674318	C	T	1	9	10	0	0	10	0	0
8	108453134	rs1368495	A	T	3	6	9	0	0	9	0	0
8	108453421	rs12541987	G	A	9	5	14	0	0	14	0	0
8	108453452	rs1368494	C	T	5	10	15	0	0	15	0	0
8	108453502	rs6469113	T	A	10	3	13	0	0	13	0	0
8	108456531	rs3847160	A	G	6	2	8	0	0	8	0	0
8	108457792	rs17301273	A	T	6	1	7	0	1	8	0	0
8	108912346	rs77602631	T	G	8	3	11	0	0	11	0	0
8	108970367	rs601558	A	G	2	7	9	0	0	9	0	0
8	109213893	rs603571	A	C	6	5	11	0	0	11	0	0
8	109215368	rs630492	T	C	17	10	27	0	0	27	0	0
8	109222017	rs10955481	A	G	3	5	8	0	0	8	0	0
8	109222544	rs627019	G	A	3	10	13	0	0	13	0	0
8	109224232	rs603889	C	T	1	8	9	0	0	9	0	0
8	109227406	rs609102	A	G	7	10	17	0	0	17	0	0
8	109227570	rs859788	A	G	23	9	32	0	0	32	0	0
8	109227585	rs859787	C	T	21	6	27	0	0	27	0	0
8	109227822	rs651951	C	G	14	10	24	0	0	24	0	0
8	109227826	rs610873	A	G	13	11	24	0	0	24	0	0
8	109228008	rs611744	A	G	4	9	13	0	0	13	0	0
8	109229228	rs34870481	A	C	7	11	18	0	1	19	0	0
8	109229243	rs635219	C	T	7	11	18	0	0	18	0	0
8	109230140	rs641721	G	A	11	13	24	0	0	24	0	0
8	109230383	rs653081	G	T	8	10	18	0	0	18	0	0
8	109230722	rs536860	A	C	4	5	9	0	0	9	0	0
8	109231948	rs608115	T	A	5	4	9	0	1	10	0	0
8	109233239	rs686630	G	C	4	6	10	0	0	10	0	0
8	109234035	.	G	A	2	4	6	0	0	6	0	0
8	109234825	rs639746	T	C	3	3	6	0	0	6	0	0
8	109235569	rs636399	G	A	3	5	8	0	0	8	0	0
8	109242803	rs674391	T	A	7	10	17	0	0	17	0	0
8	109242981	rs633901	G	T	2	5	7	0	0	7	0	0
8	109243959	rs3808593	C	A	15	29	44	0	0	44	0	0
8	109244742	rs679077	G	T	7	9	16	0	0	16	0	0
8	109245497	rs585077	C	T	7	10	17	0	0	17	0	0
8	109252471	rs16877534	C	T	4	4	8	0	0	8	0	0
8	109252554	rs702808	T	C	3	5	8	0	0	8	0	0
8	109254677	rs627392	C	T	36	43	79	0	0	79	0	0
8	109254842	rs579162	A	G	56	63	119	0	1	120	0	0
8	109255032	rs681963	C	A	32	36	68	0	1	69	0	0
8	109255206	rs629996	C	T	46	61	107	0	1	108	0	0
8	109255727	rs678820	G	A	18	30	48	0	0	48	0	0
8	109255732	rs639609	C	T	18	32	50	0	0	50	0	0
8	109255989	rs2594357	A	G	9	22	31	0	1	32	0	0
8	109256014	rs2597658	C	T	11	21	32	0	0	32	0	0
8	109256018	rs2594358	A	G	15	21	36	0	0	36	0	0
8	109258333	rs13251024	T	C	19	8	27	0	0	27	0	0
8	109260581	rs9969614	A	G	10	11	21	0	0	21	0	0
8	109260776	rs4735053	A	G	12	12	24	0	0	24	0	0
8	109928145	rs4735079	A	G	10	3	13	0	0	13	0	0
8	110283256	rs11550169	T	C	41	41	82	0	1	83	0	0
8	110283353	rs34660136	T	G	32	41	73	0	0	73	0	0
8	110301998	rs2980618	T	C	35	45	80	0	0	80	0	0
8	110308731	.	C	T	29	25	54	0	0	54	0	0
8	116512403	rs12548221	C	T	2	5	7	0	0	7	0	0
8	116535753	rs13266941	T	C	1	6	7	0	0	7	0	0
8	116546531	.	T	C	1	6	7	0	1	8	0	0
8	116559435	rs3808434	A	G	3	5	8	0	0	8	0	0
8	116559894	rs3808435	G	A	12	3	15	0	0	15	0	0
8	116560619	rs7825679	T	C	6	5	11	0	0	11	0	0
8	116561743	rs3808437	T	C	5	1	6	0	0	6	0	0
8	116562973	.	A	G	6	6	12	0	0	12	0	0
8	116565365	rs3802219	T	C	3	3	6	0	0	6	0	0
8	116565452	rs3802220	G	A	8	8	16	0	0	16	0	0
8	116579319	rs2223103	A	T	7	3	10	0	0	10	0	0
8	116580067	rs6986967	G	A	6	2	8	0	0	8	0	0
8	116580068	rs7006935	T	G	6	2	8	0	0	8	0	0
8	116596188	rs6469603	C	T	0	7	7	0	0	7	0	0
8	116597039	rs2272619	G	A	6	1	7	0	1	8	0	0
8	116597409	rs13271228	T	G	6	10	16	0	0	16	0	0
8	116597635	rs3808460	T	C	6	1	7	0	0	7	0	0
8	116597716	rs3808461	C	T	4	3	7	0	0	7	0	0
8	116599199	rs2293889	T	G	4	6	10	0	0	10	0	0
8	116610180	rs2737205	T	C	2	5	7	0	0	7	0	0
8	116611902	rs2737206	T	C	7	3	10	0	0	10	0	0
8	116629732	rs1569364	C	T	6	5	11	0	0	11	0	0
8	116630079	rs2737216	A	T	4	2	6	0	0	6	0	0
8	116630311	rs2737217	A	G	4	2	6	0	0	6	0	0
8	116635942	rs2721939	C	T	29	18	47	0	0	47	0	0
8	117858350	rs14795	G	A	360	144	504	0	7	511	0	0
8	117858389	rs4570	G	A	359	222	581	0	6	587	0	0
8	117860170	rs3020133	A	G	62	43	105	0	0	105	0	0
8	117861041	rs3020135	T	A	16	15	31	0	1	32	0	0
8	117862711	rs7831930	C	T	12	10	22	0	0	22	0	0
8	117863334	rs2921790	T	A	15	9	24	0	1	25	0	0
8	117864551	rs2241982	T	C	50	29	79	0	0	79	0	0
8	117864608	rs2241981	A	C	36	24	60	0	0	60	0	0
8	117869498	rs2921787	C	T	17	28	45	0	0	45	0	0
8	117871016	rs16888945	A	T	5	3	8	0	0	8	0	0
8	117872611	rs17435860	C	T	6	3	9	0	0	9	0	0
8	117872901	rs17435846	C	T	4	2	6	0	0	6	0	0
8	117873811	rs2289937	G	A	5	10	15	0	0	15	0	0
8	117874261	rs16888966	C	T	13	8	21	0	0	21	0	0
8	117874895	rs2921785	T	A	3	4	7	0	0	7	0	0
8	117875261	rs2921784	A	T	6	6	12	0	1	13	0	0
8	117875557	rs2921783	C	T	4	7	11	0	0	11	0	0
8	117877717	rs3020125	A	G	3	3	6	0	0	6	0	0
8	117886868	rs16889189	T	A	92	92	184	0	10	194	0	0
8	118541837	rs16889836	T	G	13	6	19	0	1	20	0	0
8	118542735	rs10505295	C	A	7	6	13	0	0	13	0	0
8	118544068	rs10505294	A	T	7	7	14	0	0	14	0	0
8	118544445	rs17667915	A	G	1	6	7	0	0	7	0	0
8	118544888	rs77255781	T	G	10	4	14	0	0	14	0	0
8	118547808	rs28571816	G	A	5	4	9	0	0	9	0	0
8	118551305	rs6987041	A	G	5	5	10	0	0	10	0	0
8	118819578	rs7837891	C	T	3	6	9	0	0	9	0	0
8	119111527	rs10505327	T	C	5	5	10	0	0	10	0	0
8	119122037	rs3757991	T	C	4	2	6	0	0	6	0	0
8	119123643	.	A	G	7	5	12	0	0	12	0	0
8	120435812	rs2071518	C	T	16	1	17	0	1	18	0	0
8	120435908	rs2071519	A	G	11	1	12	0	0	12	0	0
8	121065519	.	T	C	9	13	22	0	0	22	0	0
8	121239515	rs61753754	G	A	4	9	13	0	0	13	0	0
8	121383900	rs1129353	G	A	17	21	38	0	0	38	0	0
8	121384163	rs2429	G	T	12	9	21	0	0	21	0	0
8	121407824	rs12544060	T	A	11	4	15	0	0	15	0	0
8	121408195	rs6650	T	C	186	173	359	0	1	360	0	0
8	121409277	rs4871061	C	T	4	5	9	0	0	9	0	0
8	121427091	rs4989812	C	T	5	3	8	0	0	8	0	0
8	121430599	rs13263962	G	A	7	3	10	0	0	10	0	0
8	121479478	rs4379488	G	A	2	6	8	0	0	8	0	0
8	121482311	rs4604482	A	G	4	3	7	0	0	7	0	0
8	121489245	rs10096923	T	A	3	4	7	0	0	7	0	0
8	121490144	rs4380980	C	T	8	9	17	0	0	17	0	0
8	121530190	rs13258848	A	G	20	21	41	0	0	41	0	0
8	121541304	rs4132316	A	G	1	5	6	0	0	6	0	0
8	121541561	rs10099300	A	G	3	4	7	0	0	7	0	0
8	121542694	rs4317615	A	G	6	1	7	0	0	7	0	0
8	121542864	rs10808512	C	T	7	1	8	0	0	8	0	0
8	121544770	rs7008993	C	T	2	4	6	0	0	6	0	0
8	121544980	rs4128976	A	G	3	4	7	0	0	7	0	0
8	121545037	rs4128975	C	T	6	2	8	0	0	8	0	0
8	121547482	.	C	T	5	8	13	0	1	15	1	0
8	121549677	rs3924784	A	C	161	158	319	0	3	322	0	0
8	121549719	rs3924785	A	T	154	154	308	0	3	311	0	0
8	121550719	rs7003420	G	A	265	218	483	0	2	485	0	0
8	121561134	.	G	T	182	187	369	0	0	369	0	0
8	121583283	rs4455882	A	G	5	1	6	0	0	6	0	0
8	121583488	rs72680558	T	C	7	7	14	0	0	14	0	0
8	121583533	rs72680559	G	A	15	14	29	0	1	30	0	0
8	121583562	rs72680560	C	T	24	16	40	0	0	40	0	0
8	121583603	rs72680561	G	A	20	10	30	0	0	30	0	0
8	121583635	rs73707305	G	T	4	3	7	0	0	7	0	0
8	121584662	rs72680564	G	T	1	6	7	0	0	7	0	0
8	121633234	rs10955979	A	C	5	1	6	0	0	6	0	0
8	121634357	rs3890759	C	T	7	2	9	0	0	9	0	0
8	121651042	rs62526712	C	T	13	2	15	0	0	15	0	0
8	121651106	rs28863871	C	T	9	4	13	0	0	13	0	0
8	121651252	rs79414666	A	G	7	3	10	0	0	10	0	0
8	121651676	rs112126092	T	G	8	6	14	0	0	14	0	0
8	121652202	rs370358991	G	C	2	4	6	0	0	6	0	0
8	121652223	rs374802546	C	T	2	5	7	0	0	7	0	0
8	121652459	rs79916457	C	G	5	5	10	0	0	10	0	0
8	121652790	rs4871084	C	G	3	5	8	0	0	8	0	0
8	121652863	rs4871085	T	C	4	3	7	0	0	7	0	0
8	121700254	rs11995748	G	C	2	5	7	0	0	7	0	0
8	121777423	rs144677731	C	T	5	1	6	0	0	6	0	0
8	121825284	rs7014654	T	C	11	9	20	0	0	20	0	0
8	121825293	rs6994318	A	T	11	10	21	0	0	21	0	0
8	121825552	rs75771933	A	T	4	6	10	0	0	10	0	0
8	121947703	rs111995296	T	C	4	6	10	0	0	10	0	0
8	121948124	rs78325540	C	T	24	9	33	0	0	33	0	0
8	121948191	rs2386125	T	C	32	14	46	0	0	46	0	0
8	121948544	rs13439619	C	T	28	25	53	0	0	53	0	0
8	122055675	rs2043373	C	G	99	74	173	0	0	173	0	0
8	123985708	rs3802266	A	G	8	2	10	0	0	10	0	0
8	123986622	rs7758	G	C	6	4	10	0	0	10	0	0
8	123986649	rs2833	A	G	6	2	8	0	0	8	0	0
8	124028479	rs11781842	G	A	7	5	12	0	0	12	0	0
8	124033034	.	C	A	2	6	8	0	0	8	0	0
8	124033036	.	C	A	8	2	10	0	0	10	0	0
8	124033161	.	G	A	7	1	8	0	1	9	0	0
8	124036956	rs13259131	C	T	18	8	26	0	0	26	0	0
8	124138855	rs16898012	G	A	6	6	12	0	1	13	0	0
8	124142489	rs2272724	T	C	6	7	13	0	0	13	0	0
8	124194968	rs3739291	C	T	1	17	18	0	0	18	0	0
8	124206324	rs7813708	G	A	17	84	101	0	0	101	0	0
8	124241342	rs17378130	C	T	49	42	91	0	0	91	0	0
8	124263530	.	C	T	10	2	12	0	0	12	0	0
8	124332900	rs9021	G	A	96	116	212	0	1	213	0	0
8	124347366	.	A	C	10	2	12	0	1	13	0	0
8	124354968	rs34136040	G	C	4	3	7	0	0	7	0	0
8	124355511	rs118156143	C	T	5	4	9	0	0	9	0	0
8	124359749	rs9297666	C	G	17	20	37	0	0	37	0	0
8	124459083	.	C	G	6	0	6	0	0	6	0	0
8	124510274	rs2280915	C	T	2	4	6	0	1	7	0	0
8	124513978	rs6990407	C	G	9	5	14	0	0	14	0	0
8	124514183	rs3739286	T	C	6	4	10	0	1	11	0	0
8	124514400	rs3739284	C	T	11	7	18	0	0	18	0	0
8	124514716	rs4871383	T	C	12	8	20	0	0	20	0	0
8	124514769	rs1048515	A	G	6	8	14	0	0	14	0	0
8	124514873	.	A	T	5	8	13	0	0	13	0	0
8	124514983	rs73705944	C	T	5	3	8	0	1	9	0	0
8	124525483	rs3739287	C	T	23	27	50	0	1	51	0	0
8	124539387	rs79450183	C	T	2	10	12	0	0	12	0	0
8	124780824	rs12334564	C	A	13	19	32	0	0	32	0	0
8	125319458	rs72721434	T	C	93	116	209	0	2	211	0	0
8	125337041	rs72711166	T	G	4	4	8	0	0	8	0	0
8	125495619	rs191997048	T	C	4	6	10	0	0	10	0	0
8	125563624	rs77997827	A	G	10	14	24	0	0	24	0	0
8	125703560	rs7014786	A	T	18	12	30	0	0	30	0	0
8	125705317	rs41420649	T	C	9	5	14	0	0	14	0	0
8	125705415	rs12543994	A	G	17	19	36	0	0	36	0	0
8	125705864	rs9643200	C	T	12	17	29	0	0	29	0	0
8	125705933	rs9643201	A	G	11	9	20	0	1	21	0	0
8	125705964	rs9642873	C	T	9	11	20	0	0	20	0	0
8	125706101	rs9643202	A	G	7	10	17	0	0	17	0	0
8	125706266	rs9642874	T	C	10	12	22	0	0	22	0	0
8	125706297	rs9643203	A	C	11	13	24	0	0	24	0	0
8	125706593	rs2382995	C	T	9	15	24	0	0	24	0	0
8	125706630	rs2382996	G	A	12	14	26	0	1	27	0	0
8	125706829	rs2163372	C	T	12	7	19	0	0	19	0	0
8	125706881	rs4326369	C	T	12	7	19	0	1	20	0	0
8	125707507	rs12550305	G	A	32	18	50	0	0	50	0	0
8	125707536	rs6998715	G	A	31	18	49	0	1	50	0	0
8	125707545	rs12545412	A	C	32	21	53	0	0	53	0	0
8	125707569	rs10956195	A	C	31	15	46	0	2	48	0	0
8	125707677	rs12550311	C	T	24	16	40	0	1	41	0	0
8	125707792	rs12543112	T	G	21	20	41	0	0	41	0	0
8	125708059	rs4871531	G	T	10	5	15	0	0	15	0	0
8	125708108	.	G	T	9	3	12	0	0	12	0	0
8	125708475	rs62530739	T	C	8	7	15	0	0	15	0	0
8	125708516	rs13249761	C	A	4	3	7	0	0	7	0	0
8	125708517	rs13251912	T	C	4	3	7	0	0	7	0	0
8	125708753	rs13250347	A	C	20	11	31	0	0	31	0	0
8	125708830	rs13257787	C	A	18	12	30	0	0	30	0	0
8	125709031	rs13258900	G	A	2	4	6	0	0	6	0	0
8	125709969	rs7013593	C	T	11	16	27	0	0	27	0	0
8	125710035	rs7013991	G	C	10	18	28	0	0	28	0	0
8	125710081	rs6995812	T	A	16	11	27	0	0	27	0	0
8	125711204	rs56160818	C	T	6	9	15	0	0	15	0	0
8	126010805	rs15905	G	C	4	2	6	0	0	6	0	0
8	126016021	rs13265195	T	G	2	6	8	0	0	8	0	0
8	126016402	rs13264301	C	T	2	6	8	0	0	8	0	0
8	126017572	rs55670884	T	C	8	5	13	0	0	13	0	0
8	126030724	rs966945	T	C	7	2	9	0	0	9	0	0
8	126031129	rs112357840	G	T	8	6	14	0	0	14	0	0
8	126031646	rs77493571	G	C	10	15	25	0	1	26	0	0
8	126031754	rs10103274	A	G	5	11	16	0	0	16	0	0
8	126032110	rs10113457	C	A	13	14	27	0	0	27	0	0
8	126032682	rs2033130	G	A	12	12	24	0	0	24	0	0
8	126032809	rs13248796	A	T	3	5	8	0	0	8	0	0
8	126033195	rs9297709	T	C	16	13	29	0	0	29	0	0
8	126044264	rs3750237	A	C	4	6	10	0	0	10	0	0
8	126044437	rs17398660	G	A	3	3	6	0	0	6	0	0
8	126047864	rs2288310	G	A	5	2	7	0	0	7	0	0
8	126048674	rs13251807	T	G	4	3	7	0	0	7	0	0
8	126048675	rs13251808	T	A	4	3	7	0	0	7	0	0
8	126048702	rs13251846	T	C	5	2	7	0	0	7	0	0
8	126053562	rs7003069	T	C	2	6	8	0	0	8	0	0
8	126095158	rs6991343	A	G	4	2	6	0	0	6	0	0
8	126442726	rs3201475	C	T	406	366	772	0	23	795	0	0
8	126443534	rs3750182	G	T	11	11	22	0	0	22	0	0
8	126444463	rs4421363	C	T	24	20	44	0	2	46	0	0
8	126445505	rs13277396	G	C	29	19	48	0	1	49	0	0
8	126445537	rs2235110	C	T	21	30	51	0	0	51	0	0
8	126445544	rs2235109	C	A	23	26	49	0	1	50	0	0
8	127565184	rs11539702	A	G	21	34	55	0	0	55	0	0
8	128750139	rs3891248	T	A	15	10	25	0	1	26	0	0
8	128750212	rs4645956	C	T	18	26	44	0	2	46	0	0
8	128750413	rs4645958	C	G	49	42	91	0	0	91	0	0
8	128867420	rs77290463	G	A	13	25	38	0	0	38	0	0
8	128905405	rs17775439	T	C	17	16	33	0	0	33	0	0
8	128906787	rs6999585	T	C	25	26	51	0	0	51	0	0
8	128906788	rs7017386	C	T	24	26	50	0	0	50	0	0
8	128909539	rs4733806	C	T	6	1	7	0	0	7	0	0
8	128944384	rs56026723	C	T	4	3	7	0	0	7	0	0
8	129009010	rs2303490	C	T	1	7	8	0	0	8	0	0
8	129009814	rs34575579	C	T	0	11	11	0	0	11	0	0
8	129010590	rs10283090	C	A	18	2	20	0	0	20	0	0
8	129108823	rs11604	C	T	69	50	119	0	2	121	0	0
8	129113373	rs10453	C	T	69	60	129	0	1	130	0	0
8	130639540	rs4636162	G	A	3	4	7	0	0	7	0	0
8	130853447	rs837065	C	T	14	13	27	0	0	27	0	0
8	130855070	rs34983967	C	T	11	17	28	0	0	28	0	0
8	130856138	rs412941	C	A	9	9	18	0	0	18	0	0
8	130856154	rs389604	A	T	9	10	19	0	0	19	0	0
8	130895117	rs438877	T	C	0	7	7	0	0	7	0	0
8	130999967	rs2065409	G	A	3	5	8	0	0	8	0	0
8	131000156	rs62524593	C	G	7	4	11	0	0	11	0	0
8	131000522	rs2065410	G	C	56	21	77	0	1	78	0	0
8	131001150	rs10100858	T	C	12	5	17	0	0	17	0	0
8	131007113	rs4733755	C	A	4	2	6	0	0	6	0	0
8	131019647	rs7016267	C	T	3	3	6	0	0	6	0	0
8	131065153	rs4236749	C	T	55	43	98	0	1	99	0	0
8	131332667	rs9643252	G	A	4	2	6	0	0	6	0	0
8	131335663	rs16904249	A	G	2	4	6	0	0	6	0	0
8	131345906	rs2791349	A	C	26	26	52	0	0	52	0	0
8	131346066	rs6470814	A	G	175	127	302	0	1	303	0	0
8	131347799	rs6470815	T	C	25	17	42	0	0	42	0	0
8	131348360	rs1538728	A	G	24	23	47	0	0	47	0	0
8	131349110	rs1123205	C	G	20	14	34	0	0	34	0	0
8	131349318	rs1340021	C	G	19	16	35	0	0	35	0	0
8	131349715	rs6470816	C	T	14	15	29	0	0	29	0	0
8	131352586	rs1417007	C	G	10	8	18	0	0	18	0	0
8	131353139	rs13265869	T	C	11	12	23	0	0	23	0	0
8	131353734	rs11779014	A	G	7	5	12	0	0	12	0	0
8	131354091	rs11786705	G	A	7	5	12	0	0	12	0	0
8	131355308	.	G	A	11	13	24	0	0	24	0	0
8	131356001	rs1340020	T	G	9	4	13	0	0	13	0	0
8	131356047	rs1340019	A	G	5	6	11	0	1	12	0	0
8	131356392	rs13258946	A	C	7	7	14	0	0	14	0	0
8	131357391	rs10109236	T	C	5	4	9	0	0	9	0	0
8	131358612	rs9297806	C	T	5	5	10	0	0	10	0	0
8	131361477	rs7018225	C	T	5	7	12	0	0	12	0	0
8	131362499	.	C	A	4	3	7	0	0	7	0	0
8	133023163	rs4736529	G	C	6	4	10	0	0	10	0	0
8	133023595	rs3763568	A	G	2	6	8	0	0	8	0	0
8	133024838	rs1051257	A	T	8	12	20	0	0	20	0	0
8	133722281	rs1048490	T	C	31	22	53	0	0	53	0	0
8	133722669	rs2280871	C	T	71	63	134	0	1	135	0	0
8	133722821	.	A	G	61	49	110	0	1	111	0	0
8	133723166	rs1895807	A	G	72	74	146	0	2	148	0	0
8	133808415	rs2553587	A	G	6	7	13	0	3	16	0	0
8	133809975	rs2245068	T	G	6	4	10	0	1	11	0	0
8	133811435	rs2244885	T	A	12	13	25	0	0	25	0	0
8	133815576	rs235427	A	G	4	3	7	0	0	7	0	0
8	133815726	rs235428	G	A	3	4	7	0	0	7	0	0
8	133819075	rs235429	A	T	7	6	13	0	0	13	0	0
8	133824377	rs235432	C	A	4	4	8	0	0	8	0	0
8	133835549	rs235439	G	C	3	4	7	0	0	7	0	0
8	133836098	rs235440	G	T	5	4	9	0	0	9	0	0
8	133837802	rs235442	A	G	5	2	7	0	0	7	0	0
8	133844508	rs16904746	C	T	61	51	112	0	1	113	0	0
8	133845378	rs9643294	A	G	0	6	6	0	0	6	0	0
8	133845436	rs67839940	A	G	6	1	7	0	0	7	0	0
8	133845827	rs10092556	A	G	6	5	11	0	0	11	0	0
8	133846090	rs941396	C	T	4	2	6	0	0	6	0	0
8	133846645	rs2223130	C	T	3	3	6	0	0	6	0	0
8	133847545	rs4736610	A	G	3	4	7	0	0	7	0	0
8	133848396	rs10101478	G	A	4	2	6	0	0	6	0	0
8	133858712	rs4736611	G	A	42	39	81	0	2	83	0	0
8	134040090	rs3161	C	T	40	41	81	0	0	81	0	0
8	134042468	rs6998833	C	T	18	25	43	0	0	43	0	0
8	134043772	rs7008436	C	T	13	15	28	0	1	29	0	0
8	134046306	rs6982276	G	T	6	10	16	0	0	16	0	0
8	134046346	rs7002366	T	G	5	8	13	0	0	13	0	0
8	134046839	rs10094088	A	G	12	18	30	0	0	30	0	0
8	134046862	rs10108988	T	G	15	18	33	0	1	34	0	0
8	134047916	rs10098314	G	T	15	21	36	0	0	36	0	0
8	134049175	rs56229608	A	G	221	203	424	0	1	425	0	0
8	134049878	rs10106075	C	T	160	129	289	0	7	296	0	0
8	134050678	rs3739266	A	G	203	181	384	0	2	386	0	0
8	134052891	rs940079	G	A	5	3	8	0	0	8	0	0
8	134054230	rs2741190	C	T	4	3	7	0	0	7	0	0
8	134055031	rs2741191	T	C	4	8	12	0	0	12	0	0
8	134055485	rs2702996	T	C	7	8	15	0	0	15	0	0
8	134060459	rs4736618	T	C	3	3	6	0	1	7	0	0
8	134060718	rs3779962	G	A	9	7	16	0	1	17	0	0
8	134061060	rs2253035	G	C	8	9	17	0	0	17	0	0
8	134061712	rs2252917	G	A	2	5	7	0	0	7	0	0
8	134063532	rs2252696	C	A	11	5	16	0	0	16	0	0
8	134063885	rs2252681	A	G	5	13	18	0	0	18	0	0
8	134064152	rs1533910	C	T	8	4	12	0	0	12	0	0
8	134064773	rs2252553	G	T	8	4	12	0	0	12	0	0
8	134065794	rs4736619	G	A	5	7	12	0	0	12	0	0
8	134065873	rs10099615	G	A	6	12	18	0	0	18	0	0
8	134067203	rs148192908	G	A	3	5	8	0	0	8	0	0
8	134068163	rs10107766	C	T	4	4	8	0	0	8	0	0
8	134069420	rs17695552	T	C	3	3	6	0	0	6	0	0
8	134071833	rs2741200	T	C	4	3	7	0	0	7	0	0
8	134073280	rs3758112	G	A	7	6	13	0	0	13	0	0
8	134073815	rs72729520	G	A	6	6	12	0	0	12	0	0
8	134075411	rs4736621	T	C	12	14	26	0	0	26	0	0
8	134083935	rs12545159	C	T	2	5	7	0	0	7	0	0
8	134084800	rs2703004	G	A	14	4	18	0	0	18	0	0
8	134084948	rs10113099	A	T	5	6	11	0	0	11	0	0
8	134085103	rs2739152	G	T	6	2	8	0	0	8	0	0
8	134085353	rs2244716	C	T	120	80	200	0	1	201	0	0
8	134087325	rs72729532	G	A	4	5	9	0	0	9	0	0
8	134144113	rs2294024	C	T	4	5	9	0	0	9	0	0
8	134250430	rs1049694	C	T	530	479	1009	0	6	1015	0	0
8	134252732	rs3779945	C	G	15	15	30	0	0	30	0	0
8	134252938	rs4548166	A	G	16	12	28	0	0	28	0	0
8	134256877	rs55949956	A	G	7	6	13	0	0	13	0	0
8	134256878	rs56273899	C	A	7	6	13	0	0	13	0	0
8	134259712	rs76627947	G	C	10	11	21	0	0	21	0	0
8	134259808	rs71526278	A	G	10	12	22	0	0	22	0	0
8	134259850	rs10108961	T	C	9	8	17	0	1	18	0	0
8	134259865	rs35007862	G	A	10	9	19	0	0	19	0	0
8	134262915	rs36076004	C	T	6	2	8	0	0	8	0	0
8	134263339	rs10956698	C	T	6	3	9	0	0	9	0	0
8	134263710	rs10085955	C	T	6	6	12	0	0	12	0	0
8	134264993	rs7816917	G	A	5	2	7	0	0	7	0	0
8	134264996	rs7835058	T	C	4	2	6	0	1	7	0	0
8	134265807	rs72731563	C	T	7	2	9	0	0	9	0	0
8	134266970	rs2272650	C	G	36	41	77	0	3	80	0	0
8	134267870	rs35927571	C	T	36	41	77	0	2	79	0	0
8	134268158	rs72731566	C	G	36	21	57	0	1	58	0	0
8	134269559	rs59971731	C	G	35	18	53	0	1	54	0	0
8	134269938	rs1011460	G	C	22	12	34	0	1	35	0	0
8	134270548	rs2272651	T	C	20	21	41	0	0	41	0	0
8	134468066	rs2458	G	A	81	73	154	0	1	155	0	0
8	134468274	rs78468413	T	C	48	53	101	0	10	111	0	0
8	134468533	rs4736673	G	T	56	44	100	0	0	100	0	0
8	134468708	rs4736674	A	T	73	70	143	0	0	143	0	0
8	134468864	rs4736675	G	A	79	66	145	0	1	146	0	0
8	134469208	rs34844235	C	G	82	62	144	0	0	144	0	0
8	134469277	rs16904924	T	A	70	46	116	0	0	116	0	0
8	134469536	rs11782689	T	C	42	30	72	0	0	72	0	0
8	134470361	rs28687047	G	A	48	66	114	0	1	115	0	0
8	134470533	rs72718252	A	C	33	32	65	0	1	66	0	0
8	134471426	rs1048484	C	T	40	31	71	0	0	71	0	0
8	134487271	rs34224475	A	C	5	17	22	0	1	23	0	0
8	134487602	rs2737428	A	G	5	10	15	0	0	15	0	0
8	134487723	rs2737429	T	G	2	9	11	0	0	11	0	0
8	134505158	rs13257489	C	T	4	2	6	0	0	6	0	0
8	134573150	rs17665855	G	C	3	4	7	0	0	7	0	0
8	134580756	rs28445987	G	A	6	4	10	0	0	10	0	0
8	134582497	rs72720296	C	T	13	12	25	0	0	25	0	0
8	134584054	rs60776551	T	C	156	139	295	0	1	296	0	0
8	135524797	rs3739429	G	T	9	10	19	0	0	19	0	0
8	135614705	rs3739423	A	G	6	1	7	0	0	7	0	0
8	135614972	rs3739422	A	G	5	1	6	0	0	6	0	0
8	135809782	rs190663561	T	C	4	7	11	0	0	11	0	0
8	140743139	rs117443048	C	G	85	73	158	0	0	158	0	0
8	140912215	rs6982104	T	C	3	3	6	0	0	6	0	0
8	140915017	rs10107700	C	G	8	3	11	0	0	11	0	0
8	140915442	rs28556916	C	T	4	10	14	0	0	14	0	0
8	140915519	rs12547470	A	G	5	6	11	0	0	11	0	0
8	140915520	rs12547471	A	C	5	6	11	0	0	11	0	0
8	140915692	rs12548023	T	G	4	3	7	0	0	7	0	0
8	140916089	rs2015218	A	G	3	6	9	0	0	9	0	0
8	140916730	rs61104742	C	G	4	9	13	0	0	13	0	0
8	140916745	rs7013645	A	G	3	7	10	0	0	10	0	0
8	140916796	rs67701708	T	C	3	4	7	0	0	7	0	0
8	140918842	rs8180960	G	A	1	5	6	0	0	6	0	0
8	141262869	rs11166964	C	T	0	6	6	0	0	6	0	0
8	141263015	rs11166965	G	A	82	64	146	0	0	146	0	0
8	141412282	rs4736180	A	G	3	6	9	0	0	9	0	0
8	141441981	rs4515527	A	G	2	6	8	0	0	8	0	0
8	141446902	rs1879818	T	C	10	5	15	0	0	15	0	0
8	141460918	rs57593250	C	T	89	63	152	0	0	152	0	0
8	141461062	rs3735803	G	A	79	71	150	0	3	153	0	0
8	141461074	rs61739560	A	G	78	83	161	0	1	162	0	0
8	141461116	rs34457678	C	T	64	65	129	0	4	133	0	0
8	141467018	rs2977493	C	T	90	101	191	0	1	192	0	0
8	141516724	rs11774952	A	G	3	4	7	0	0	7	0	0
8	141516993	rs11775712	A	G	5	5	10	0	1	11	0	0
8	141517388	rs13264648	G	A	6	6	12	0	0	12	0	0
8	141525465	rs2231527	T	C	203	285	488	0	11	499	0	0
8	141526038	rs4246131	T	C	49	78	127	0	1	128	0	0
8	141526231	rs4961323	C	T	102	109	211	0	20	231	0	0
8	141526985	rs10216653	G	C	42	33	75	0	2	77	0	0
8	141537406	rs2235117	T	C	6	6	12	0	0	12	0	0
8	141538846	rs2977453	T	C	5	2	7	0	0	7	0	0
8	141541881	rs2944776	C	T	51	47	98	0	2	100	0	0
8	141541888	rs1060832	C	T	63	62	125	0	1	126	0	0
8	141544501	rs148227362	C	T	7	1	8	0	0	8	0	0
8	141545193	rs2977464	C	T	5	2	7	0	1	8	0	0
8	141546602	rs2977466	T	C	11	12	23	0	2	25	0	0
8	141547712	rs2977467	T	C	12	9	21	0	0	21	0	0
8	141548419	rs2944772	C	G	6	13	19	0	1	20	0	0
8	141557880	rs2944767	G	A	6	1	7	0	0	7	0	0
8	141558632	rs2977479	G	C	6	2	8	0	1	9	0	0
8	141565764	rs2977484	T	C	5	5	10	0	0	10	0	0
8	141568622	rs2292778	G	A	64	72	136	0	0	136	0	0
8	141582896	rs13276958	T	C	41	16	57	0	0	57	0	0
8	141588660	rs11997913	C	G	1	6	7	0	0	7	0	0
8	142134800	rs56388000	C	T	4	2	6	0	0	6	0	0
8	142137634	rs7009780	T	C	4	4	8	0	0	8	0	0
8	142137704	rs6988905	G	A	7	3	10	0	0	10	0	0
8	142138860	rs3739232	C	G	36	35	71	0	0	71	0	0
8	142139187	rs3739231	C	T	16	14	30	0	0	30	0	0
8	142139251	rs6578152	T	C	17	15	32	0	0	32	0	0
8	142139682	rs7814272	T	G	25	16	41	0	0	41	0	0
8	142147975	.	C	T	4	4	8	0	0	8	0	0
8	142152442	rs307765	A	G	23	16	39	0	0	39	0	0
8	142160829	rs35212078	T	G	10	19	29	0	0	29	0	0
8	142161064	rs3816063	C	T	4	4	8	0	0	8	0	0
8	142169586	rs149429780	G	A	3	3	6	0	0	6	0	0
8	142170884	rs2289001	C	T	108	92	200	0	1	201	0	0
8	142176507	rs412706	T	C	16	44	60	0	0	60	0	0
8	142179802	rs307736	G	A	11	10	21	0	0	21	0	0
8	142180947	rs11783084	C	T	5	6	11	0	0	11	0	0
8	142183625	rs79150017	C	T	9	19	28	0	0	28	0	0
8	142191748	rs10104549	T	G	10	1	11	0	0	11	0	0
8	142192542	rs307740	G	A	145	13	158	0	2	160	0	0
8	142192569	rs307739	G	A	143	19	162	0	0	162	0	0
8	142192648	rs10090848	C	T	17	15	32	0	1	33	0	0
8	142198270	rs12547067	G	A	7	8	15	0	1	16	0	0
8	142198596	rs7001673	G	T	23	25	48	0	0	48	0	0
8	142198682	rs6988366	T	C	23	16	39	0	1	40	0	0
8	142199400	rs3739226	G	A	5	12	17	0	1	18	0	0
8	142200467	rs1045303	G	A	170	185	355	0	5	360	0	0
8	142200731	rs2288997	C	T	42	70	112	0	2	114	0	0
8	142202856	rs6990186	C	T	47	41	88	0	0	88	0	0
8	142202884	rs7014062	T	C	45	41	86	0	2	88	0	0
8	142203452	rs11784862	T	C	115	139	254	0	4	258	0	0
8	142204326	rs1045248	C	G	123	85	208	0	0	208	0	0
8	142205132	rs11579	G	A	293	209	502	0	3	505	0	0
8	142205149	rs67745429	C	T	260	214	474	0	4	478	0	0
8	142205237	rs9792	A	G	249	247	496	0	5	501	0	0
8	142218119	rs2288999	G	A	6	11	17	0	0	17	0	0
8	142221032	rs13724	C	T	50	35	85	0	5	90	0	0
8	142221361	rs3739241	C	G	40	38	78	0	0	78	0	0
8	142221414	rs3739240	G	A	38	42	80	0	0	80	0	0
8	142222374	rs7017848	A	G	28	24	52	0	0	52	0	0
8	142222445	rs3739238	T	C	20	23	43	0	0	43	0	0
8	142227592	rs10107024	T	C	9	8	17	0	0	17	0	0
8	142227854	rs9324542	T	A	3	4	7	0	0	7	0	0
8	142228809	rs753779	T	C	10	10	20	0	1	21	0	0
8	142228909	rs753778	G	A	5	7	12	0	0	12	0	0
8	142229145	rs3739235	A	G	1	6	7	0	0	7	0	0
8	142229891	rs2304279	A	G	5	9	14	0	0	14	0	0
8	142232878	rs4961258	G	A	2	4	6	0	0	6	0	0
8	142248454	rs55846720	G	A	3	4	7	0	0	7	0	0
8	142248526	rs28645241	C	T	7	1	8	0	0	8	0	0
8	142248944	rs28368589	C	T	4	2	6	0	0	6	0	0
8	143293558	rs11992923	A	G	5	5	10	0	0	10	0	0
8	143293585	rs78564166	G	A	5	4	9	0	1	10	0	0
8	143352778	rs34469664	C	G	18	18	36	0	0	36	0	0
8	143361267	rs4976990	A	G	6	7	13	0	0	13	0	0
8	143407442	rs13253068	G	A	3	5	8	0	0	8	0	0
8	143413136	rs10435683	C	T	24	24	48	0	1	49	0	0
8	143425720	rs10100935	T	C	23	40	63	0	0	63	0	0
8	143609913	rs7838992	T	C	12	3	15	0	0	15	0	0
8	143808951	rs2585138	C	T	8	8	16	0	0	16	0	0
8	143809193	rs2257840	C	T	12	11	23	0	0	23	0	0
8	143810819	rs6991446	T	C	7	6	13	0	1	14	0	0
8	143817806	rs2717598	C	T	64	64	128	0	2	130	0	0
8	143857086	.	C	T	3	3	6	0	0	6	0	0
8	143859081	rs4355750	G	A	5	2	7	0	1	8	0	0
8	144332012	rs6558339	T	C	5	6	11	0	0	11	0	0
8	144332082	rs11136275	T	C	3	5	8	0	0	8	0	0
8	144333315	rs4570175	G	A	6	5	11	0	0	11	0	0
8	144333434	rs4348512	G	A	7	8	15	0	0	15	0	0
8	144342831	rs3750212	G	A	3	5	8	0	1	9	0	0
8	144351632	rs6558341	A	G	22	14	36	0	0	36	0	0
8	144357213	rs3817675	G	C	4	3	7	0	0	7	0	0
8	144357479	rs3812433	C	G	3	5	8	0	0	8	0	0
8	144357720	rs3829017	C	T	4	4	8	0	0	8	0	0
8	144357772	rs7387207	T	C	5	4	9	0	0	9	0	0
8	144358381	rs1056148	G	A	7	2	9	0	0	9	0	0
8	144362674	rs1063753	C	G	25	13	38	0	0	38	0	0
8	144363094	rs4419827	C	A	55	50	105	0	0	105	0	0
8	144379934	rs7386378	C	T	3	3	6	0	0	6	0	0
8	144391728	rs7386475	A	G	37	9	46	0	0	46	0	0
8	144391796	rs10088567	G	A	34	5	39	0	0	39	0	0
8	144391873	rs10105378	A	G	35	10	45	0	2	47	0	0
8	144391924	rs10099789	C	T	35	9	44	0	0	45	1	0
8	144391925	rs13277302	T	C	34	9	43	0	2	45	0	0
8	144391930	rs10091561	G	A	37	11	48	0	0	48	0	0
8	144392368	rs2293925	G	A	494	394	888	0	6	894	0	0
8	144392602	rs13256542	C	T	52	47	99	0	0	99	0	0
8	144393025	rs6997070	A	G	29	30	59	0	0	59	0	0
8	144393191	rs7002111	T	C	10	10	20	0	0	20	0	0
8	144393459	rs7002559	T	C	21	26	47	0	0	47	0	0
8	144394292	rs10088412	A	C	13	29	42	0	0	42	0	0
8	144394845	rs12156025	A	T	15	14	29	0	2	31	0	0
8	144395504	rs9801717	C	T	9	15	24	0	1	25	0	0
8	144395569	rs9801820	A	G	9	12	21	0	0	21	0	0
8	144395947	rs11783217	A	C	13	14	27	0	0	27	0	0
8	144396396	rs10099996	T	C	40	50	90	0	1	91	0	0
8	144396633	rs62524727	G	A	42	31	73	0	0	73	0	0
8	144396816	rs13275666	A	G	40	49	89	0	3	93	1	0
8	144396960	rs13274388	T	C	3	6	9	0	0	9	0	0
8	144397044	rs13274702	T	C	5	10	15	0	0	15	0	0
8	144397097	rs13265898	A	G	11	7	18	0	0	18	0	0
8	144397172	rs7459839	C	T	9	5	14	0	0	14	0	0
8	144397179	rs13259858	G	A	8	5	13	0	1	14	0	0
8	144397409	rs4563897	T	C	12	8	20	0	0	20	0	0
8	144397558	rs13260981	G	A	15	16	31	0	0	31	0	0
8	144397570	rs13260989	G	A	14	15	29	0	2	31	0	0
8	144398029	rs13275896	A	G	9	12	21	0	0	21	0	0
8	144398123	rs2293928	G	C	14	15	29	0	0	29	0	0
8	144398132	rs2293927	T	C	14	17	31	0	0	31	0	0
8	144398396	rs2293926	C	T	24	27	51	0	0	51	0	0
8	144399147	rs12676285	G	T	20	16	36	0	0	36	0	0
8	144399336	rs7845253	G	A	18	17	35	0	0	35	0	0
8	144399419	rs2272638	G	A	20	18	38	0	0	38	0	0
8	144399885	rs2272637	A	C	13	23	36	0	0	36	0	0
8	144399886	rs2272636	G	T	13	23	36	0	0	36	0	0
8	144408105	rs34617726	C	T	4	9	13	0	0	13	0	0
8	144408902	rs6558348	T	C	3	3	6	0	0	6	0	0
8	144408942	rs6558349	C	T	6	4	10	0	0	10	0	0
8	144409934	rs35096181	C	A	6	4	10	0	0	10	0	0
8	144410749	rs10283197	C	T	4	3	7	0	1	8	0	0
8	144410798	rs2450771	A	G	6	3	9	0	0	9	0	0
8	144437294	rs4875046	C	T	8	3	11	0	0	11	0	0
8	144438471	rs1017942	A	G	22	11	33	0	0	33	0	0
8	144449191	rs2467950	A	G	11	13	24	0	0	24	0	0
8	144449192	rs2450764	A	C	11	13	24	0	0	24	0	0
8	144449708	rs4874104	G	A	5	6	11	0	1	12	0	0
8	144451368	rs62524011	C	A	3	5	8	0	0	8	0	0
8	144452144	rs13268561	A	T	2	4	6	0	0	6	0	0
8	144461764	rs62524012	A	G	27	19	46	0	0	46	0	0
8	144463643	rs7015558	C	T	14	11	25	0	1	26	0	0
8	144463686	rs3817720	C	T	17	8	25	0	0	25	0	0
8	144465045	rs2272755	G	A	13	18	31	0	0	31	0	0
8	144466014	rs3195664	G	C	19	13	32	0	0	32	0	0
8	144466205	rs1055181	C	T	25	9	34	0	1	35	0	0
8	144520147	rs2294117	G	A	133	106	239	0	3	242	0	0
8	144520668	rs13267988	C	T	9	10	19	0	0	19	0	0
8	144520710	rs13255491	T	C	9	12	21	0	0	21	0	0
8	144532815	rs4874126	G	A	8	8	16	0	0	16	0	0
8	144536789	rs71520522	G	A	22	14	36	0	0	36	0	0
8	144548806	rs369051	A	G	4	2	6	0	0	6	0	0
8	144553138	rs374534	C	G	10	4	14	0	0	14	0	0
8	144553201	rs35110652	C	T	4	7	11	0	0	11	0	0
8	144554731	rs2004100	C	T	6	4	10	0	0	10	0	0
8	144555129	rs2005246	G	A	4	7	11	0	0	11	0	0
8	144556739	rs34668069	C	T	4	5	9	0	0	9	0	0
8	144556836	rs61251648	G	A	5	2	7	0	0	7	0	0
8	144557739	rs71520524	G	A	28	23	51	0	1	52	0	0
8	144620855	rs4873802	C	A	66	72	138	0	3	141	0	0
8	144620871	rs3750209	A	G	82	60	142	0	2	144	0	0
8	144621035	rs3750208	G	A	73	51	124	0	1	125	0	0
8	144621091	rs3750206	A	T	91	71	162	0	1	163	0	0
8	144624438	rs6991958	C	T	8	4	12	0	0	12	0	0
8	144624492	rs62523569	A	G	3	9	12	0	0	12	0	0
8	144624643	rs11779379	C	T	6	4	10	0	0	10	0	0
8	144625793	rs56972823	C	T	4	2	6	0	0	6	0	0
8	144626533	rs35065687	A	G	3	4	7	0	0	7	0	0
8	144626708	rs59378841	A	G	2	5	7	0	0	7	0	0
8	144626891	rs58372186	T	C	3	8	11	0	0	11	0	0
8	144635608	rs896960	G	C	3	5	8	0	0	8	0	0
8	144637257	rs7834318	C	A	8	13	21	0	0	21	0	0
8	144639466	rs62523576	G	A	24	34	58	0	1	59	0	0
8	144639485	.	G	A	26	30	56	0	2	58	0	0
8	144639503	.	A	T	19	37	56	0	1	57	0	0
8	144641753	rs4874151	A	C	12	10	22	0	0	22	0	0
8	144642244	rs73375262	A	G	38	43	81	0	0	81	0	0
8	144642490	rs73375263	G	A	81	104	185	0	1	186	0	0
8	144642596	rs7835865	T	C	64	70	134	0	2	136	0	0
8	144642854	rs11551202	G	A	257	151	408	0	3	411	0	0
8	144643169	rs1545536	C	T	30	21	51	0	0	51	0	0
8	144650925	rs13279011	A	T	4	3	7	0	0	7	0	0
8	144654255	rs4874153	A	G	10	10	20	0	0	20	0	0
8	144654693	rs4873804	G	C	14	11	25	0	2	27	0	0
8	144656344	rs4873805	T	C	6	16	22	0	0	22	0	0
8	144656764	rs58774517	C	T	11	7	18	0	1	19	0	0
8	144657152	rs77951814	C	G	90	16	106	0	0	106	0	0
8	144657600	rs2290416	G	A	840	918	1758	0	12	1770	0	0
8	144657801	rs9771743	G	A	822	633	1455	0	9	1464	0	0
8	144660046	rs896954	G	A	108	127	235	0	2	237	0	0
8	144660575	rs896949	C	G	11	12	23	0	0	23	0	0
8	144662230	rs10090485	C	T	2038	2106	4144	0	21	4165	0	0
8	144662353	rs1062391	G	A	1865	2041	3906	0	11	3917	0	0
8	144663661	rs2123758	G	A	27	27	54	0	0	54	0	0
8	144664319	rs1563148	C	G	30	18	48	0	0	48	0	0
8	144664594	rs3793368	C	T	43	40	83	0	1	84	0	0
8	144664624	rs3793367	C	T	45	44	89	0	0	89	0	0
8	144664808	rs10099131	C	T	40	29	69	0	0	69	0	0
8	144664818	rs10099134	C	T	37	31	68	0	0	68	0	0
8	144665111	rs73379021	G	A	33	26	59	0	2	61	0	0
8	144665680	rs28606985	C	A	22	19	41	0	0	41	0	0
8	144668811	rs113484128	T	A	21	19	40	0	0	40	0	0
8	144669636	rs6996863	A	C	14	8	22	0	0	22	0	0
8	144677103	rs60390250	T	C	10	11	21	0	0	21	0	0
8	144678874	rs2242095	C	T	3	7	10	0	0	10	0	0
8	144682311	rs3210186	G	C	15	21	36	0	0	36	0	0
8	144682428	rs112637095	C	T	15	4	19	0	0	19	0	0
8	144684514	rs73367293	C	T	6	8	14	0	0	14	0	0
8	144684702	rs73718114	C	T	2	4	6	0	0	6	0	0
8	144685272	rs4874168	G	A	9	2	11	0	1	12	0	0
8	144687092	rs896962	T	C	5	2	7	0	0	7	0	0
8	144687721	rs896961	C	T	5	1	6	0	0	6	0	0
8	144689146	rs2242089	C	T	5	3	8	0	0	8	0	0
8	144696725	rs138093039	G	A	8	6	14	0	0	14	0	0
8	144808926	rs116851527	C	T	3	4	7	0	0	7	0	0
8	144810346	rs144418186	C	A	5	2	7	0	0	7	0	0
8	144875588	rs4875054	G	A	8	5	13	0	0	13	0	0
8	144875743	rs4875055	G	C	11	12	23	0	1	24	0	0
8	144875945	rs10092551	G	A	2	5	7	0	0	7	0	0
8	144902246	rs7835924	C	T	18	23	41	0	0	41	0	0
8	144917533	rs7465214	G	A	18	10	28	0	0	28	0	0
8	144995964	rs35139934	G	A	43	39	82	0	0	82	0	0
8	145057868	rs11544989	A	G	79	55	134	0	3	137	0	0
8	145133317	rs112389151	C	A	13	10	23	0	0	23	0	0
8	145134363	rs111909817	C	A	8	10	18	0	1	19	0	0
8	145139325	rs112703109	G	C	232	203	435	0	2	437	0	0
8	145150322	rs549721700	G	A	11	16	27	0	0	27	0	0
8	145153851	rs112552278	C	T	298	259	557	0	18	575	0	0
8	145159099	rs11136255	G	A	10	8	18	0	1	19	0	0
8	145159433	rs570807510	G	A	29	47	76	0	1	77	0	0
8	145161591	rs200015474	G	A	151	168	319	0	40	361	2	0
8	145166898	.	C	G	3	4	7	0	0	7	0	0
8	145168086	rs6558300	G	C	4	2	6	0	0	6	0	0
8	145267725	rs66506549	C	T	3	3	6	0	0	6	0	0
8	145516108	.	G	A	7	3	10	0	1	11	0	0
8	145534453	rs113463782	C	T	75	52	127	0	3	130	0	0
8	145538299	rs111911280	C	T	495	455	950	0	7	957	0	0
8	145579274	.	G	T	104	79	183	0	2	185	0	0
8	145640306	rs11779952	G	A	4	3	7	0	0	7	0	0
8	145662377	rs2242270	A	C	4	9	13	0	0	13	0	0
8	145665761	rs2229313	G	A	21	22	43	0	1	44	0	0
8	145684976	rs117180602	G	A	6	10	16	0	0	16	0	0
8	145689667	rs142152732	C	G	59	65	124	0	3	127	0	0
8	145720682	rs13276862	A	G	7	3	10	0	0	10	0	0
8	145723419	rs2721149	T	G	11	7	18	0	0	18	0	0
8	145747628	rs10111332	T	C	23	10	33	0	0	33	0	0
8	146003567	rs2294120	A	G	5	9	14	0	0	14	0	0
8	146011111	rs7833780	T	G	9	3	12	0	0	12	0	0
8	146011158	rs2979090	G	A	9	2	11	0	0	11	0	0
8	146017032	rs2954657	C	T	63	77	140	0	0	140	0	0
8	146017039	rs113461437	G	A	62	73	135	0	1	136	0	0
8	146017580	rs112155437	C	T	9	20	29	0	1	30	0	0
8	146017782	rs2954658	C	T	44	29	73	0	0	73	0	0
8	146017804	.	C	T	10	2	12	0	0	12	0	0
8	146034379	rs2954668	T	C	12	14	26	0	0	26	0	0
8	146035358	rs2979082	A	G	13	8	21	0	0	21	0	0
8	146054703	rs1735157	C	T	5	8	13	0	0	13	0	0
8	146064103	rs2727230	G	A	46	29	75	0	0	75	0	0
8	146064154	rs2722490	T	C	33	28	61	0	1	62	0	0
8	146064157	rs1810387	G	C	32	26	58	0	2	60	0	0
8	146065173	rs1735166	A	G	39	16	55	0	0	55	0	0
8	146065452	rs1735167	C	T	42	20	62	0	0	62	0	0
8	146066031	rs1618523	C	T	31	27	58	0	2	60	0	0
8	146066053	rs1625919	T	C	29	30	59	0	1	60	0	0
8	146066418	rs2242650	T	C	41	32	73	0	0	73	0	0
8	146066508	rs2242651	T	C	48	36	84	0	0	84	0	0
8	146067054	rs1735169	G	A	70	49	119	0	3	122	0	0
8	146068322	rs9004	C	T	42	49	91	0	3	94	0	0
8	146068594	rs1735408	T	C	3	4	7	0	0	7	0	0
8	146075832	rs1209881	T	G	35	31	66	0	0	66	0	0
8	146076708	rs1209879	C	T	103	111	214	0	0	214	0	0
8	146077942	rs13252601	G	A	6	4	10	0	0	10	0	0
8	146078864	rs1209874	C	T	22	22	44	0	2	46	0	0
8	146096953	rs1209860	A	G	3	5	8	0	0	8	0	0
8	146115367	rs2735906	A	G	14	13	27	0	0	27	0	0
8	146156247	rs3735789	C	A	20	36	56	0	1	57	0	0
8	146157339	rs3735787	T	C	27	23	50	0	0	50	0	0
8	146200337	rs112846659	G	T	5	2	7	0	0	7	0	0
8	146200344	rs62531554	C	T	6	3	9	0	0	9	0	0
8	146200347	rs62531555	G	T	4	5	9	0	0	9	0	0
8	146203412	rs2979109	A	G	0	9	9	0	0	9	0	0
8	146280765	rs62530105	T	C	256	211	467	0	2	469	0	0
9	14690	rs62530146	C	G	171	90	261	0	0	261	0	0
9	16967	rs202245356	A	G	4	9	13	0	1	14	0	0
9	17625	.	C	G	10	0	10	0	0	10	0	0
9	17676	.	G	A	4	3	7	0	0	7	0	0
9	215511	rs2023402	C	T	2	4	6	0	0	6	0	0
9	244457	rs661356	G	A	2	5	7	0	0	7	0	0
9	286593	rs529208	C	A	34	24	58	0	0	58	0	0
9	379965	rs10758420	T	C	1	5	6	0	0	6	0	0
9	390512	rs2297075	C	T	34	35	69	0	3	72	0	0
9	400243	.	A	T	14	0	14	0	0	14	0	0
9	400247	.	C	T	8	0	8	0	2	10	0	0
9	401097	rs35219384	T	C	9	4	13	0	0	13	0	0
9	401207	rs4740739	G	C	7	2	9	0	0	9	0	0
9	2039793	rs62534884	A	C	94	59	153	0	1	154	0	0
9	2042083	rs3793482	A	G	188	177	365	0	1	366	0	0
9	2044721	rs1125205	A	G	192	194	386	0	3	389	0	0
9	2045608	rs13300688	A	G	97	88	185	0	4	189	0	0
9	2083755	rs10811397	A	G	6	1	7	0	0	7	0	0
9	2648773	rs6148	A	G	2	4	6	0	0	6	0	0
9	2814209	.	C	A	5	5	10	0	0	10	0	0
9	2815957	.	G	A	3	7	10	0	0	10	0	0
9	4664836	rs2295962	A	T	4	4	8	0	0	8	0	0
9	4664852	rs2295963	A	G	4	6	10	0	0	10	0	0
9	4676745	rs184205	G	C	19	23	42	0	0	42	0	0
9	4691570	rs3824440	C	T	3	5	8	0	0	8	0	0
9	4712269	rs8525	C	A	52	42	94	0	0	94	0	0
9	4738240	rs393097	G	A	4	2	6	0	0	6	0	0
9	4738899	rs375090	G	A	7	3	10	0	0	10	0	0
9	4739248	rs417364	C	T	4	3	7	0	0	7	0	0
9	4740648	rs1756867	T	C	5	3	8	0	0	8	0	0
9	4817698	rs12552098	T	G	3	3	6	0	0	6	0	0
9	4853179	rs7858420	C	T	3	4	7	0	0	7	0	0
9	4853198	rs462409	C	T	4	3	7	0	0	7	0	0
9	4858694	rs62543480	A	G	3	4	7	0	0	7	0	0
9	4858702	rs10121212	A	C	4	3	7	0	0	7	0	0
9	4859303	rs1537146	A	G	1	6	7	0	1	8	0	0
9	4860569	rs1260073	G	A	24	28	52	0	0	52	0	0
9	4860943	rs295918	A	G	11	9	20	0	0	20	0	0
9	4860964	rs10072	T	C	8	9	17	0	0	17	0	0
9	4860980	rs1053889	G	A	8	9	17	0	0	17	0	0
9	5065003	rs2230723	C	G	37	26	63	0	0	63	0	0
9	5079224	rs79136062	C	G	9	1	10	0	0	10	0	0
9	5467955	rs2297136	G	A	0	6	6	0	0	6	0	0
9	5630344	rs10815254	C	T	106	77	183	0	3	186	0	0
9	5685436	rs113082895	C	G	3	3	6	0	0	6	0	0
9	5710743	rs7858848	A	G	9	7	16	0	0	16	0	0
9	5710774	rs7872200	G	A	7	7	14	0	0	14	0	0
9	5712178	rs13296516	T	G	8	7	15	0	1	16	0	0
9	5712223	rs7466553	C	T	10	10	20	0	0	20	0	0
9	5712626	rs10975255	C	A	41	15	56	0	1	57	0	0
9	5712811	rs72693723	C	G	3	4	7	0	0	7	0	0
9	5764314	rs1047870	T	C	9	5	14	0	0	14	0	0
9	5774225	rs3739648	T	G	47	25	72	0	0	72	0	0
9	5774661	rs10975277	G	A	59	29	88	0	0	88	0	0
9	5775044	rs67072567	T	A	38	45	83	0	1	84	0	0
9	5775573	rs1062042	T	C	13	30	43	0	2	45	0	0
9	5776119	rs13294396	A	T	32	29	61	0	0	61	0	0
9	5783043	.	T	A	7	5	12	0	0	12	0	0
9	5783107	rs2381382	A	G	4	4	8	0	0	8	0	0
9	5783336	rs147649790	T	C	7	8	15	0	0	15	0	0
9	5784120	rs13287822	G	A	5	1	6	0	0	6	0	0
9	5785260	rs34176848	G	C	25	21	46	0	0	46	0	0
9	5786059	rs35320045	T	C	24	22	46	0	1	47	0	0
9	5786850	rs1028702	G	A	24	21	45	0	0	45	0	0
9	5914039	rs12340153	T	C	3	4	7	0	0	7	0	0
9	5914048	rs73639554	T	C	3	3	6	0	1	7	0	0
9	5969307	rs73383144	C	T	8	5	13	0	0	13	0	0
9	6007551	rs73389036	T	C	14	11	25	0	0	25	0	0
9	6011252	rs73389044	T	C	87	106	193	0	2	195	0	0
9	6011335	rs7425	T	C	83	72	155	0	6	161	0	0
9	6012968	rs1411949	A	G	61	69	130	0	0	130	0	0
9	7076463	rs1570512	G	A	8	6	14	0	1	15	0	0
9	7076586	rs1570513	G	A	14	7	21	0	0	21	0	0
9	7133920	rs59175248	T	G	5	1	6	0	0	6	0	0
9	7174673	rs913588	G	A	16	16	32	0	0	32	0	0
9	7174773	rs913589	G	A	14	30	44	0	0	44	0	0
9	7174898	rs913590	C	A	15	19	34	0	1	35	0	0
9	7477329	rs192635503	G	C	22	0	22	0	6	28	0	0
9	7799606	rs14059	C	A	92	72	164	0	3	167	0	0
9	7799653	rs1127430	G	T	106	103	209	0	4	213	0	0
9	7799787	rs2297554	C	T	6	1	7	0	0	7	0	0
9	14588910	rs1047720	G	A	6	5	11	0	0	11	0	0
9	14588923	rs1047718	A	G	6	6	12	0	0	12	0	0
9	14589173	rs1047717	G	A	9	10	19	0	0	19	0	0
9	14589347	rs76926137	C	T	5	12	17	0	0	17	0	0
9	14611366	rs7849849	A	T	2	4	6	0	0	6	0	0
9	14616590	rs12236525	T	C	10	3	13	0	0	13	0	0
9	14617477	rs3819003	A	T	3	8	11	0	0	11	0	0
9	14618856	rs3802482	C	T	9	2	11	0	0	11	0	0
9	15188106	rs1407977	T	C	9	9	18	0	1	19	0	0
9	15464743	rs2665515	G	A	142	148	290	0	0	290	0	0
9	15466033	rs1046388	G	C	6	1	7	0	0	7	0	0
9	15466337	rs1882939	T	C	3	5	8	0	0	8	0	0
9	15467175	rs909323	T	G	0	6	6	0	0	6	0	0
9	15467902	rs2665511	A	C	5	1	6	0	0	6	0	0
9	15467950	rs2821533	G	C	4	4	8	0	0	8	0	0
9	15467956	.	T	A	4	4	8	0	0	8	0	0
9	15467963	rs2665510	A	G	3	4	7	0	0	7	0	0
9	15468174	rs2795124	G	A	3	6	9	0	0	9	0	0
9	15468480	rs4741507	T	C	1	6	7	0	0	7	0	0
9	15472056	rs2795125	G	C	5	3	8	0	0	8	0	0
9	15472139	rs2777950	C	T	13	7	20	0	1	21	0	0
9	15475447	rs2064030	G	C	4	5	9	0	0	9	0	0
9	15492061	rs10738398	C	T	11	14	25	0	0	25	0	0
9	15553591	rs10810397	G	C	2	12	14	0	1	15	0	0
9	15571630	rs443563	T	A	8	12	20	0	0	20	0	0
9	15582252	rs276444	G	C	1	6	7	0	0	7	0	0
9	15784631	rs1539172	A	G	7	5	12	0	0	12	0	0
9	17273731	rs3808795	A	G	5	5	10	0	0	10	0	0
9	17298726	rs679666	T	C	4	6	10	0	0	10	0	0
9	17298742	rs41268969	G	A	4	6	10	0	0	10	0	0
9	17299017	rs35884270	G	A	6	2	8	0	0	8	0	0
9	17299120	rs7026852	A	G	4	3	7	0	0	7	0	0
9	17299342	rs10963017	T	C	3	3	6	0	0	6	0	0
9	17299571	rs2779779	G	A	8	1	9	0	0	9	0	0
9	17299574	rs2780207	G	C	8	1	9	0	0	9	0	0
9	17299872	rs62558354	T	A	2	4	6	0	0	6	0	0
9	17300057	rs60520802	A	C	7	9	16	0	0	16	0	0
9	17300291	rs2780205	T	G	4	9	13	0	0	13	0	0
9	17300938	rs646025	C	A	11	7	18	0	0	18	0	0
9	17301105	rs642582	T	A	11	11	22	0	0	22	0	0
9	17301211	rs634446	A	C	23	17	40	0	0	40	0	0
9	17301257	rs634383	G	A	23	23	46	0	0	46	0	0
9	19119034	rs7847408	C	A	5	7	12	0	0	12	0	0
9	19123832	rs62563650	C	A	17	6	23	0	1	24	0	0
9	19128020	rs144620543	T	C	11	10	21	0	0	21	0	0
9	19341045	rs928128	A	G	11	17	28	0	0	28	0	0
9	19343346	rs6475321	T	C	9	7	16	0	0	16	0	0
9	19375522	rs12342623	C	T	10	2	12	0	0	12	0	0
9	19376408	rs2277151	A	G	6	5	11	0	1	12	0	0
9	19380239	rs41270113	A	T	4	12	16	0	0	16	0	0
9	20342556	rs10757132	C	T	3	11	14	0	0	14	0	0
9	21004244	rs55992749	G	A	44	53	97	0	0	97	0	0
9	21005422	rs59467007	G	A	44	28	72	0	1	73	0	0
9	21968159	rs3088440	G	A	49	2	51	0	0	51	0	0
9	21968199	rs11515	C	G	41	1	42	0	2	44	0	0
9	26892301	rs3739550	A	G	12	10	22	0	0	22	0	0
9	26892654	rs3739548	G	A	8	7	15	0	0	15	0	0
9	26911025	rs10812494	T	C	5	1	6	0	0	6	0	0
9	26911111	rs10812495	C	A	5	1	6	0	0	6	0	0
9	26911529	rs10812497	G	A	4	7	11	0	0	11	0	0
9	26912521	rs77921995	C	T	5	6	11	0	0	11	0	0
9	26915001	rs7034670	A	G	6	5	11	0	0	11	0	0
9	26915211	rs7035292	G	A	8	3	11	0	1	12	0	0
9	26915925	rs7863476	G	A	24	21	45	0	1	46	0	0
9	26978170	rs10812505	A	G	21	22	43	0	0	43	0	0
9	26978259	rs11555693	A	G	26	20	46	0	1	47	0	0
9	32542204	rs10971019	A	G	116	119	235	0	0	235	0	0
9	32542363	rs74328058	G	A	69	87	156	0	3	159	0	0
9	32988341	rs74922775	C	A	2	4	6	0	0	6	0	0
9	33025324	rs77871808	C	T	196	231	427	0	5	432	0	0
9	33026638	rs2274769	G	A	4	7	11	0	1	12	0	0
9	33027142	rs368301188	T	C	7	8	15	0	0	15	0	0
9	33027775	rs141404572	G	A	14	6	20	0	0	20	0	0
9	33027855	rs118065940	C	A	14	3	17	0	0	17	0	0
9	33028498	rs79488152	T	G	4	6	10	0	0	10	0	0
9	33028499	rs74542287	G	T	4	6	10	0	0	10	0	0
9	33028537	rs12380574	A	G	4	3	7	0	0	7	0	0
9	33028977	rs12377889	C	T	11	17	28	0	0	28	0	0
9	33029015	rs4879658	C	T	17	17	34	0	0	34	0	0
9	33030087	rs10971343	T	C	1	7	8	0	0	8	0	0
9	33036023	rs10971355	T	C	1	5	6	0	0	6	0	0
9	33036266	rs373386999	T	G	3	3	6	0	1	7	0	0
9	33037446	rs10971357	A	G	4	9	13	0	0	13	0	0
9	33038049	rs10971358	G	C	10	9	19	0	0	19	0	0
9	33039024	rs7296	T	A	250	229	479	0	2	481	0	0
9	33045161	rs10758181	C	T	25	38	63	0	0	63	0	0
9	33045276	rs1537042	G	C	39	42	81	0	2	83	0	0
9	33045664	rs1970027	A	G	20	21	41	0	0	41	0	0
9	33045810	.	T	C	10	11	21	0	0	21	0	0
9	33048280	rs10971364	A	C	12	12	24	0	1	25	0	0
9	33050342	rs10971367	A	G	4	7	11	0	0	11	0	0
9	33050753	rs10971369	G	T	2	4	6	0	0	6	0	0
9	33050757	rs10971370	G	A	2	4	6	0	0	6	0	0
9	33053544	rs79226160	G	T	17	18	35	0	0	35	0	0
9	33054120	rs75608945	G	T	6	5	11	0	0	11	0	0
9	33054274	rs1129912	T	C	6	15	21	0	1	22	0	0
9	33054722	rs17227872	A	G	12	24	36	0	0	36	0	0
9	33055471	rs10758183	G	A	5	7	12	0	0	12	0	0
9	33055716	rs10971371	G	C	5	12	17	0	0	17	0	0
9	33062128	rs2274764	G	A	155	132	287	0	6	293	0	0
9	33110839	rs10412	C	T	713	544	1257	0	8	1265	0	0
9	33113121	rs869	G	A	329	232	561	0	5	566	0	0
9	33117524	rs2031902	C	T	6	4	10	0	0	10	0	0
9	33117965	rs7865362	C	T	3	4	7	0	0	7	0	0
9	33118111	rs4879665	T	C	3	4	7	0	0	7	0	0
9	33119818	rs10121987	A	G	2	5	7	0	0	7	0	0
9	33120496	.	G	C	201	201	402	0	4	406	0	0
9	33120765	rs77252993	T	C	3	6	9	0	0	9	0	0
9	33123106	rs6476400	T	A	3	3	6	0	0	6	0	0
9	33124317	rs17327015	T	C	5	2	7	0	0	7	0	0
9	33128076	rs10813952	G	A	10	12	22	0	0	22	0	0
9	33129839	rs3780490	A	G	4	4	8	0	0	8	0	0
9	33129844	rs3780489	G	T	4	4	8	0	0	8	0	0
9	33135085	rs913214	G	A	3	3	6	0	0	6	0	0
9	33135238	rs1065765	G	A	187	161	348	0	0	348	0	0
9	33141752	rs2770807	G	A	6	0	6	0	0	6	0	0
9	33166234	rs10813959	T	C	1	10	11	0	1	12	0	0
9	33166348	rs76993157	G	A	2	9	11	0	0	11	0	0
9	33240225	rs706107	G	A	5	4	9	0	0	9	0	0
9	33253509	.	T	C	12	23	35	0	0	35	0	0
9	33255483	rs11789000	G	C	11	6	17	0	0	17	0	0
9	33263674	rs3758270	A	G	3	6	9	0	0	9	0	0
9	33265405	rs16919130	C	G	6	7	13	0	2	15	0	0
9	33265743	rs11791605	C	A	12	5	17	0	1	18	0	0
9	33366398	rs4879688	C	T	6	5	11	0	0	11	0	0
9	33467729	rs61995751	C	T	11	16	27	0	0	27	0	0
9	33676094	rs7853346	C	G	1	6	7	0	0	7	0	0
9	33698804	rs12685300	G	T	8	0	8	0	0	8	0	0
9	33817617	rs855719	T	C	18	13	31	0	0	31	0	0
9	33818457	rs72725370	A	T	9	6	15	0	0	15	0	0
9	33819555	rs216367	A	T	9	13	22	0	0	22	0	0
9	33819955	rs216368	A	G	22	23	45	0	1	46	0	0
9	33855465	rs10971739	G	C	8	4	12	0	0	12	0	0
9	33917498	rs4817	T	C	112	79	191	0	0	191	0	0
9	33918816	rs72727327	C	T	7	15	22	0	0	22	0	0
9	33921919	rs11848	T	C	73	93	166	0	1	167	0	0
9	33921977	rs2781	G	C	109	113	222	0	3	225	0	0
9	33934271	rs56274755	T	C	6	8	14	0	0	14	0	0
9	33941759	rs307658	T	C	43	46	89	0	1	90	0	0
9	33942063	rs56150332	G	A	6	2	8	0	0	8	0	0
9	34017106	rs1785506	C	T	25	19	44	0	1	45	0	0
9	34107504	rs1378	C	T	23	31	54	0	0	54	0	0
9	34121510	rs55857848	G	C	4	3	7	0	0	7	0	0
9	34181283	rs71521221	A	T	4	2	6	0	0	6	0	0
9	34213548	rs10972003	C	T	6	4	10	0	0	10	0	0
9	34214758	rs34270971	T	C	3	3	6	0	0	6	0	0
9	34215234	rs10972005	C	T	6	5	11	0	0	11	0	0
9	34224091	rs17349430	G	A	7	2	9	0	0	9	0	0
9	34224285	rs17258212	C	T	7	3	10	0	0	10	0	0
9	34226087	rs10814079	G	C	3	3	6	0	0	6	0	0
9	34229324	rs10814081	T	G	4	3	7	0	0	7	0	0
9	34232396	rs7040201	C	G	14	9	23	0	0	23	0	0
9	34233633	rs35808726	G	T	8	9	17	0	0	17	0	0
9	34242242	rs7857658	G	A	6	6	12	0	0	12	0	0
9	34242697	rs4008756	A	T	2	6	8	0	0	8	0	0
9	34243377	rs17349871	C	G	4	6	10	0	0	10	0	0
9	34243886	rs4879767	C	T	5	6	11	0	0	11	0	0
9	34243975	rs34223057	G	A	3	7	10	0	0	10	0	0
9	34244092	rs10972017	C	T	5	3	8	0	0	8	0	0
9	34244227	rs4008745	G	A	3	5	8	0	0	8	0	0
9	34246134	rs35971466	G	A	5	11	16	0	0	16	0	0
9	34247328	rs1122114	T	C	3	6	9	0	0	9	0	0
9	34249143	rs7470345	T	C	26	43	69	0	0	69	0	0
9	34249204	rs2380925	G	A	28	29	57	0	0	57	0	0
9	34251943	rs1049557	G	C	261	276	537	0	7	544	0	0
9	34251952	rs3135929	G	T	317	287	604	0	5	610	1	0
9	34399170	rs2890586	G	A	7	2	9	0	0	9	0	0
9	34400581	rs11793308	C	T	2	5	7	0	0	7	0	0
9	34400605	rs45623233	G	A	6	1	7	0	0	7	0	0
9	34614636	rs74324688	C	G	9	22	31	0	0	31	0	0
9	34654142	rs3808868	T	G	3	3	6	0	0	6	0	0
9	34655436	rs2812357	T	C	4	3	7	0	0	7	0	0
9	34655734	rs11575576	G	T	3	4	7	0	0	7	0	0
9	34668878	rs2772547	G	T	22	3	25	0	0	25	0	0
9	34669171	rs2812347	T	C	11	1	12	0	0	12	0	0
9	34997569	rs885451	C	G	6	11	17	0	1	18	0	0
9	35058674	.	G	A	14	16	30	0	0	30	0	0
9	35060302	rs684562	T	C	16	21	37	0	0	37	0	0
9	35068640	rs2073575	A	T	5	1	6	0	0	6	0	0
9	35071773	rs7871782	G	A	8	1	9	0	0	9	0	0
9	35071774	rs7871544	C	A	8	1	9	0	0	9	0	0
9	35074917	rs587118	T	C	3	3	6	0	0	6	0	0
9	35079361	rs504082	G	T	4	4	8	0	0	8	0	0
9	35098008	rs634801	C	A	3	3	6	0	0	6	0	0
9	35105257	rs7030595	G	A	68	54	122	0	1	123	0	0
9	35107765	rs13287211	C	A	42	40	82	0	0	82	0	0
9	35385359	rs750548	T	C	2	4	6	0	0	6	0	0
9	35491466	rs34167533	C	T	4	3	7	0	0	7	0	0
9	35557206	rs4878619	T	C	4	4	8	0	0	8	0	0
9	35561627	rs1046415	C	T	48	78	126	0	3	129	0	0
9	35606884	rs2275422	G	A	20	19	39	0	1	40	0	0
9	35657838	rs7021642	G	A	75	61	136	0	0	136	0	0
9	35657859	rs7021463	C	G	69	60	129	0	0	129	0	0
9	35660901	rs2275420	C	T	34	21	55	0	0	55	0	0
9	35661827	rs56077544	G	A	3	3	6	0	0	6	0	0
9	35690319	.	C	G	21	9	30	0	0	30	0	0
9	36037644	rs1324471	A	G	1	5	6	0	0	6	0	0
9	36085563	rs10814327	T	A	6	11	17	0	0	17	0	0
9	36142094	rs10814336	C	G	4	3	7	0	0	7	0	0
9	36151164	rs2277172	G	A	3	4	7	0	0	7	0	0
9	36152555	rs6476534	C	T	9	13	22	0	0	22	0	0
9	36161516	rs12335862	C	G	5	1	6	0	0	6	0	0
9	36163002	rs11588	C	T	54	58	112	0	1	113	0	0
9	36163563	rs6610	G	A	111	133	244	0	5	249	0	0
9	36169598	rs3739609	T	C	2	5	7	0	0	7	0	0
9	36214971	rs1043313	G	A	38	33	71	0	0	71	0	0
9	36215581	rs16933086	C	T	52	36	88	0	1	89	0	0
9	36216426	rs56974443	G	A	14	3	17	0	0	17	0	0
9	36218018	rs615108	C	G	1	9	10	0	0	10	0	0
9	36259287	rs4879967	C	A	4	5	9	0	1	10	0	0
9	36287062	rs4879977	A	G	4	2	6	0	0	6	0	0
9	37086996	rs2279557	A	G	24	45	69	0	0	69	0	0
9	37087064	rs2279556	A	G	35	40	75	0	1	76	0	0
9	37088167	rs10814504	C	T	37	31	68	0	0	68	0	0
9	37088475	rs146488053	G	A	25	21	46	0	0	46	0	0
9	37089150	rs11544336	A	G	37	29	66	0	0	66	0	0
9	37358086	rs16934022	A	C	3	4	7	0	0	7	0	0
9	37426152	rs2768659	A	G	4	3	7	0	0	7	0	0
9	37429497	rs309460	C	T	7	3	10	0	0	10	0	0
9	37431399	rs309457	A	G	4	5	9	0	0	9	0	0
9	37436925	rs1057507	A	G	108	93	201	0	3	204	0	0
9	37439045	rs7022431	A	C	28	17	45	0	1	46	0	0
9	37439351	rs7039333	T	G	18	25	43	0	0	43	0	0
9	37464909	rs7049017	T	C	5	2	7	0	0	7	0	0
9	37510281	rs116315977	G	A	4	3	7	0	0	7	0	0
9	37583429	rs9644884	C	T	2	4	6	0	0	6	0	0
9	37774893	rs10973537	G	A	4	2	6	0	0	6	0	0
9	37775177	rs10973538	C	T	5	5	10	0	0	10	0	0
9	37779439	rs12002972	A	C	4	2	6	0	0	6	0	0
9	37780479	rs117073203	G	A	5	3	8	0	1	9	0	0
9	37780558	rs1059059	C	A	7	9	16	0	0	16	0	0
9	37789239	rs10973546	C	G	1	7	8	0	0	8	0	0
9	37789503	rs10973547	G	A	7	12	19	0	0	19	0	0
9	37789907	rs2181815	G	A	3	4	7	0	0	7	0	0
9	37790127	rs1324195	C	A	3	3	6	0	0	6	0	0
9	37790892	rs10973548	C	A	3	5	8	0	0	8	0	0
9	37790924	rs10973549	G	A	5	8	13	0	0	13	0	0
9	37790950	rs10973550	C	T	4	8	12	0	0	12	0	0
9	37864593	.	A	T	5	2	7	0	0	7	0	0
9	37886110	rs16934566	G	A	5	10	15	0	1	16	0	0
9	37886429	rs13294843	G	A	13	12	25	0	0	25	0	0
9	37887024	rs12551858	C	T	3	4	7	0	0	7	0	0
9	37888101	rs2296204	C	T	25	15	40	0	0	40	0	0
9	37916193	rs3747546	G	A	14	17	31	0	0	31	0	0
9	37919743	rs2281784	T	C	116	55	171	0	3	174	0	0
9	37948724	rs3827519	T	C	136	104	240	0	0	240	0	0
9	37976667	rs7851957	G	A	6	3	9	0	0	9	0	0
9	38067343	rs111976921	G	C	4	2	6	0	0	6	0	0
9	38067388	rs150582570	T	C	1	5	6	0	0	6	0	0
9	38068451	rs112858544	T	C	14	4	18	0	0	18	0	0
9	38397915	rs7859877	G	A	4	3	7	0	0	7	0	0
9	38398153	rs74363930	A	T	5	3	8	0	0	8	0	0
9	38595886	rs2996347	T	C	5	6	11	0	0	11	0	0
9	38622368	rs7046879	G	C	3	3	6	0	0	6	0	0
9	41954644	.	G	A	12	3	15	0	0	15	0	0
9	41954658	.	G	A	11	3	14	0	0	14	0	0
9	41954665	.	C	A	9	2	11	0	0	11	0	0
9	41954776	.	C	G	16	2	18	0	0	18	0	0
9	45728080	.	C	T	7	0	7	0	0	7	0	0
9	66465614	.	A	G	3	24	27	0	0	27	0	0
9	66465792	.	A	G	3	27	30	0	1	31	0	0
9	66466303	.	G	A	6	17	23	0	1	24	0	0
9	66466339	.	G	C	5	24	29	0	2	31	0	0
9	66466650	.	G	C	1	6	7	0	0	7	0	0
9	66468876	.	G	C	7	1	8	0	0	8	0	0
9	66468975	rs2321615	G	A	7	0	7	0	0	7	0	0
9	66469036	.	G	A	6	0	6	0	0	6	0	0
9	68401291	.	C	G	10	0	10	0	0	10	0	0
9	68401324	.	G	C	8	0	8	0	1	9	0	0
9	68741534	.	A	G	6	4	10	0	0	10	0	0
9	69066506	.	G	A	15	0	15	0	0	15	0	0
9	69206924	.	T	A	23	4	27	0	0	27	0	0
9	69238268	.	G	A	11	3	14	0	0	14	0	0
9	70209258	.	A	G	7	0	7	0	0	7	0	0
9	70886764	.	A	G	5	1	6	0	0	6	0	0
9	70886769	.	T	C	5	1	6	0	0	6	0	0
9	71396426	rs12349968	A	G	4	2	6	0	0	6	0	0
9	71397187	rs75064770	G	A	11	4	15	0	0	15	0	0
9	71398086	rs12006032	A	G	8	10	18	0	1	19	0	0
9	71549914	.	G	A	5	14	19	0	0	19	0	0
9	71867861	rs41277913	A	G	5	1	6	0	0	6	0	0
9	71869473	rs3812536	G	A	3	4	7	0	0	7	0	0
9	72328727	rs7857137	A	G	7	11	18	0	1	19	0	0
9	72328979	rs11139928	A	T	4	5	9	0	0	9	0	0
9	72339483	rs7032552	A	G	4	3	7	0	0	7	0	0
9	72339544	rs10867966	C	T	1	5	6	0	0	6	0	0
9	72897440	rs1180117	T	C	92	80	172	0	3	175	0	0
9	72917149	rs7036205	G	C	9	9	18	0	0	18	0	0
9	72917420	rs7853742	T	A	3	4	7	0	0	7	0	0
9	72917810	rs12006212	T	G	7	8	15	0	0	15	0	0
9	72918167	rs10125617	T	C	2	8	10	0	0	10	0	0
9	72918891	rs11998951	T	C	4	2	6	0	0	6	0	0
9	72919329	rs2183362	A	G	6	6	12	0	2	14	0	0
9	72919634	rs7846908	C	A	12	8	20	0	0	20	0	0
9	72939702	rs11142368	C	T	3	4	7	0	0	7	0	0
9	72939906	rs58879007	G	A	4	7	11	0	0	11	0	0
9	72940495	rs7858389	T	A	2	9	11	0	0	11	0	0
9	72942236	rs11142370	A	T	26	24	50	0	0	50	0	0
9	72969517	rs1052684	A	T	58	64	122	0	1	123	0	0
9	74311343	rs192395987	G	A	2	8	10	0	0	10	0	0
9	74974593	rs17630132	A	G	12	13	25	0	0	25	0	0
9	74975293	rs148208944	A	G	257	270	527	0	6	533	0	0
9	74975492	rs2146184	T	C	405	443	848	0	3	851	0	0
9	75766838	rs1131072	A	G	847	1220	2067	0	9	2076	0	0
9	75769950	rs2795112	C	G	5	4	9	0	0	10	1	0
9	75771314	rs2795114	G	C	9	4	13	0	0	13	0	0
9	75773161	rs2795116	A	G	9	13	22	0	0	22	0	0
9	75775235	rs1050305	A	G	1755	2811	4566	0	19	4585	0	0
9	75779718	rs78536606	A	C	10	14	24	0	0	24	0	0
9	75780714	rs2795119	G	A	55	59	114	0	0	114	0	0
9	75781246	rs10512015	T	C	41	100	141	0	0	141	0	0
9	75781376	rs2795120	T	G	47	75	122	0	0	122	0	0
9	75781678	.	C	G	73	74	147	0	0	147	0	0
9	75784264	rs2811226	G	A	19	24	43	0	0	43	0	0
9	77675978	rs773157	T	A	1	5	6	0	0	6	0	0
9	77676305	rs1045882	T	C	13	22	35	0	0	35	0	0
9	77676349	.	T	A	21	12	33	0	0	33	0	0
9	77702372	rs35223569	C	T	3	4	7	0	0	7	0	0
9	77702526	rs11144223	T	C	7	0	7	0	0	7	0	0
9	77702631	rs11144224	T	C	20	7	27	0	0	27	0	0
9	77702766	rs3812513	G	C	17	18	35	0	0	35	0	0
9	77752510	rs2273769	C	T	139	142	281	0	2	283	0	0
9	79115844	rs4532668	A	C	5	6	11	0	0	11	0	0
9	80333407	rs11546845	G	A	133	124	257	0	0	257	0	0
9	80334981	rs2026000	A	G	108	103	211	0	1	213	1	0
9	80335076	rs3858119	C	T	118	128	246	0	1	247	0	0
9	80335288	rs2025999	C	T	94	97	191	0	6	197	0	0
9	80581771	rs11145637	C	T	71	88	159	0	1	160	0	0
9	80582223	rs4097404	C	T	60	54	114	0	2	116	0	0
9	80851350	rs10867166	G	C	5	2	7	0	0	7	0	0
9	80868354	rs3824547	G	T	7	8	15	0	0	15	0	0
9	82187095	rs2807303	G	A	56	59	115	0	0	115	0	0
9	82331554	rs62569355	G	A	23	14	37	0	0	37	0	0
9	82335300	.	T	G	22	4	26	0	1	27	0	0
9	82336478	rs62569356	C	T	5	7	12	0	0	12	0	0
9	84205860	rs8782	G	A	12	7	19	0	0	19	0	0
9	84303792	rs544495562	G	A	8	6	14	0	0	14	0	0
9	85859648	rs1048228	T	G	9	5	14	0	0	14	0	0
9	85861582	.	T	A	4	5	9	0	0	9	0	0
9	86004552	rs34533756	A	G	4	7	11	0	0	11	0	0
9	86278817	rs7866234	C	A	356	402	758	0	4	762	0	0
9	86279015	rs2781003	C	T	52	37	89	0	1	90	0	0
9	86279814	rs10868037	G	A	13	6	19	0	1	20	0	0
9	86280456	rs2781001	A	G	26	31	57	0	1	58	0	0
9	86280482	rs11140202	C	T	20	28	48	0	1	49	0	0
9	86280596	rs187877959	T	C	33	25	58	0	2	60	0	0
9	86280847	rs2781000	G	A	9	14	23	0	0	23	0	0
9	86281995	rs2058912	A	G	27	38	65	0	0	65	0	0
9	86282341	rs4877791	G	A	20	28	48	0	1	49	0	0
9	86282648	rs2542775	C	T	82	60	142	0	2	144	0	0
9	86282649	rs7846925	T	C	59	81	140	0	3	143	0	0
9	86282774	rs2780999	A	T	31	17	48	0	1	49	0	0
9	86283423	rs2811929	G	A	157	199	356	0	0	356	0	0
9	86283648	rs10512137	A	C	26	20	46	0	0	46	0	0
9	86283850	rs2811930	T	C	22	22	44	0	0	44	0	0
9	86284178	rs1044175	C	A	513	482	995	0	4	999	0	0
9	86285737	rs2780998	T	C	3	5	8	0	0	8	0	0
9	86285747	rs2780997	A	G	3	5	8	0	0	8	0	0
9	86286021	rs2811931	A	C	3	3	6	0	0	6	0	0
9	86289243	rs4877794	T	C	3	3	6	0	1	7	0	0
9	86291679	rs10868038	T	C	42	71	113	0	1	114	0	0
9	86292425	rs7863266	T	C	44	52	96	0	1	98	1	0
9	86319690	rs7860614	G	A	7	0	7	0	0	7	0	0
9	86322740	rs1056073	C	G	65	80	145	0	2	147	0	0
9	86327898	rs10119344	C	T	0	6	6	0	0	6	0	0
9	86354511	rs4750	G	C	17	24	41	0	4	45	0	0
9	86409851	rs55881223	A	T	1	9	10	0	0	10	0	0
9	86431653	rs295271	T	C	5	19	24	0	0	24	0	0
9	86432579	.	G	T	2	4	6	0	0	6	0	0
9	86432595	rs7041731	A	G	2	4	6	0	0	6	0	0
9	86534480	rs10868072	C	T	10	7	17	0	0	17	0	0
9	86535730	rs12552069	G	A	26	44	70	0	1	71	0	0
9	86536304	.	G	A	88	44	132	0	1	133	0	0
9	86584903	rs296885	A	G	43	46	89	0	0	89	0	0
9	86591704	rs192705	G	A	4	8	12	0	0	12	0	0
9	88166964	rs10868319	A	G	4	5	9	0	0	9	0	0
9	88167035	rs10780728	A	C	4	3	7	0	0	7	0	0
9	88167493	rs75544310	G	C	3	3	6	0	0	6	0	0
9	88168683	rs10435950	A	G	6	0	6	0	0	6	0	0
9	88262280	rs685050	T	A	5	3	8	0	0	8	0	0
9	88456282	.	G	A	7	0	7	0	0	7	0	0
9	88456293	.	C	T	6	0	6	0	0	6	0	0
9	88464394	.	A	G	2	6	8	0	0	8	0	0
9	88883182	rs62573370	T	C	7	8	15	0	0	15	0	0
9	88952281	.	T	G	3	3	6	0	0	6	0	0
9	90114746	rs2058882	A	G	3	4	7	0	0	7	0	0
9	90118809	rs1468931	G	A	9	8	17	0	0	17	0	0
9	90120379	rs11790186	C	T	3	7	10	0	0	10	0	0
9	90321583	rs3118863	C	T	34	16	50	0	0	50	0	0
9	90322023	rs1056719	G	A	35	43	78	0	1	79	0	0
9	90586221	rs9410653	G	A	6	2	8	0	0	8	0	0
9	90588903	rs665983	C	T	2	4	6	0	0	6	0	0
9	91984571	rs7856532	T	G	2	4	6	0	0	6	0	0
9	91992573	rs9445	A	T	176	188	364	0	7	371	0	0
9	91993832	rs113511187	C	T	120	94	214	0	4	218	0	0
9	91997405	rs7048501	C	T	6	13	19	0	0	19	0	0
9	91997486	rs3922885	C	T	12	6	18	0	0	18	0	0
9	91997687	rs7036818	G	A	12	21	33	0	0	33	0	0
9	91997938	rs7469438	G	T	6	8	14	0	0	14	0	0
9	91998062	rs7469453	G	A	16	15	31	0	0	31	0	0
9	91998121	rs7469476	G	A	15	9	24	0	0	24	0	0
9	91999097	rs7036039	T	C	7	7	14	0	0	14	0	0
9	91999556	rs79716257	T	C	7	13	20	0	0	20	0	0
9	92002775	rs13298660	T	G	4	3	7	0	0	7	0	0
9	92003216	rs74868510	T	C	4	3	7	0	0	7	0	0
9	92003679	rs11526468	C	T	57	49	106	0	4	110	0	0
9	92003749	rs7465881	A	G	5	6	11	0	0	11	0	0
9	92004962	rs35891434	T	C	3	3	6	0	0	6	0	0
9	92086057	rs28573795	G	C	3	4	7	0	0	7	0	0
9	92086552	rs77925244	G	A	3	3	6	0	1	7	0	0
9	92087063	rs59446279	A	G	5	11	16	0	0	16	0	0
9	92087113	rs17054919	C	T	11	6	17	0	1	18	0	0
9	92088857	rs10512196	A	G	3	6	9	0	0	9	0	0
9	92088959	rs28505778	C	G	3	5	8	0	0	8	0	0
9	92089016	rs28705236	C	G	2	4	6	0	0	6	0	0
9	92089328	rs12238518	G	A	2	4	6	0	0	6	0	0
9	92091665	rs62549808	G	C	2	5	7	0	0	7	0	0
9	92093447	rs7850772	T	C	2	9	11	0	0	11	0	0
9	92093576	rs7859211	G	A	0	7	7	0	0	7	0	0
9	92094654	.	G	T	4	4	8	0	0	8	0	0
9	93601368	rs7852876	A	T	5	2	7	0	0	7	0	0
9	93606676	rs2278275	A	G	78	83	161	0	0	161	0	0
9	93609773	rs2387337	T	C	6	1	7	0	0	7	0	0
9	93610761	rs4744514	C	T	4	4	8	0	0	8	0	0
9	93611084	rs3789897	G	A	10	4	14	0	0	14	0	0
9	93611186	rs3789898	G	A	6	2	8	0	0	8	0	0
9	93615717	rs4744017	G	A	4	3	7	0	0	7	0	0
9	93624755	rs914928	T	C	30	81	111	0	0	111	0	0
9	93625745	rs1572104	C	G	20	33	53	0	3	56	0	0
9	93637015	rs2290890	C	T	69	54	123	0	0	123	0	0
9	93639973	rs2290888	G	C	71	64	135	0	0	135	0	0
9	93640009	rs2290887	G	A	70	56	126	0	3	129	0	0
9	93640120	rs2290886	C	T	6	2	8	0	0	8	0	0
9	93640131	rs2290885	C	T	6	2	8	0	0	8	0	0
9	93640691	rs12005550	A	C	9	4	13	0	0	13	0	0
9	93640872	rs12005209	C	A	4	2	6	0	0	6	0	0
9	93641175	rs2306041	C	T	56	48	104	0	0	104	0	0
9	93641199	rs2306040	T	C	61	46	107	0	1	108	0	0
9	93658952	rs12344755	T	C	38	27	65	0	1	66	0	0
9	94102902	rs76284073	A	G	2	4	6	0	0	6	0	0
9	94118921	rs10991899	A	G	4	5	9	0	0	9	0	0
9	94794302	rs7944	T	C	50	59	109	0	3	112	0	0
9	94796278	rs7021155	T	C	6	2	8	0	0	8	0	0
9	94800855	rs3858086	A	G	6	3	9	0	0	9	0	0
9	94834408	rs117506206	A	G	3	3	6	0	0	6	0	0
9	94835051	rs10761143	G	C	4	5	9	0	0	9	0	0
9	94836290	rs75541535	A	T	5	4	9	0	0	9	0	0
9	94839105	rs58129324	T	C	11	2	13	0	0	13	0	0
9	94869687	rs7859570	T	C	38	34	72	0	0	72	0	0
9	94870152	rs1970121	C	A	14	7	21	0	1	22	0	0
9	95059804	rs710163	A	G	9	17	26	0	0	26	0	0
9	95062545	rs10992299	A	C	7	0	7	0	0	7	0	0
9	95378353	rs2274413	G	A	3	6	9	0	0	9	0	0
9	95380726	rs2148537	G	A	4	2	6	0	0	6	0	0
9	95382297	rs12686780	C	T	4	8	12	0	0	12	0	0
9	95382302	rs12686781	C	G	5	8	13	0	0	13	0	0
9	95473719	rs556	G	A	41	64	105	0	0	105	0	0
9	95475352	rs16908498	G	A	35	32	67	0	0	67	0	0
9	95475937	rs3739605	G	A	66	37	103	0	2	105	0	0
9	95476441	rs7862106	C	G	55	64	119	0	2	121	0	0
9	95476958	rs3203916	A	G	31	32	63	0	0	63	0	0
9	95495584	rs12686058	T	C	12	3	15	0	0	15	0	0
9	95511538	rs57421019	A	G	12	0	12	0	0	12	0	0
9	95511697	rs12236516	G	A	7	1	8	0	0	8	0	0
9	95512185	rs12236747	G	T	9	1	10	0	0	10	0	0
9	95512201	rs12236754	G	A	10	1	11	0	0	11	0	0
9	95608248	rs1040978	C	G	7	8	15	0	0	15	0	0
9	95737649	rs9942965	G	A	48	55	103	0	1	104	0	0
9	95738781	rs3802381	C	A	39	45	84	0	0	84	0	0
9	95869549	rs4743886	A	G	7	2	9	0	0	9	0	0
9	95869782	rs7028778	C	T	8	2	10	0	0	10	0	0
9	95869943	rs2275849	C	T	7	3	10	0	1	11	0	0
9	95870524	rs7032929	C	T	8	7	15	0	0	15	0	0
9	95870628	rs58767769	G	A	15	15	30	0	0	30	0	0
9	95871749	rs1970623	C	T	15	11	26	0	1	27	0	0
9	95883958	rs1127851	A	T	253	228	481	0	0	481	0	0
9	95884501	rs3750555	A	G	458	366	824	0	9	833	0	0
9	95884747	rs2185973	C	G	8	6	14	0	0	14	0	0
9	95885341	rs3829123	G	A	7	6	13	0	0	13	0	0
9	95885937	.	A	G	5	11	16	0	0	16	0	0
9	95886051	rs3793662	C	T	9	6	15	0	0	15	0	0
9	95887320	rs2275848	G	T	252	233	485	0	3	488	0	0
9	95889209	rs11793313	A	C	7	1	8	0	0	8	0	0
9	95889523	rs34297115	C	T	8	8	16	0	0	16	0	0
9	95889677	rs10992647	C	G	4	6	10	0	0	10	0	0
9	95890327	rs7037142	A	G	10	6	16	0	2	19	1	0
9	95891998	rs7875586	T	C	7	3	10	0	0	10	0	0
9	95892726	rs7018885	T	C	11	6	17	0	0	17	0	0
9	95893114	rs7847349	A	G	8	10	18	0	0	18	0	0
9	95894053	rs10114849	A	G	6	9	15	0	0	15	0	0
9	95894964	rs12342201	G	A	11	4	15	0	0	15	0	0
9	95895755	rs10821073	C	T	7	2	9	0	0	9	0	0
9	95895831	rs10739943	C	G	3	4	7	0	1	8	0	0
9	96210736	.	T	C	24	29	53	0	0	53	0	0
9	96213096	.	G	C	49	77	126	0	1	127	0	0
9	96213146	rs3815563	T	A	89	53	142	0	0	142	0	0
9	96213529	rs7853605	A	G	59	33	92	0	0	92	0	0
9	96235723	rs78057688	G	A	13	18	31	0	2	33	0	0
9	96235885	rs59326991	C	T	12	17	29	0	0	29	0	0
9	96238578	rs10821135	C	T	65	71	136	0	2	138	0	0
9	96265600	rs59483310	C	T	8	4	12	0	0	12	0	0
9	96266147	rs16909211	A	G	4	2	6	0	0	6	0	0
9	96267436	rs7850322	A	G	27	17	44	0	0	44	0	0
9	96268308	rs7854349	A	G	87	63	150	0	1	151	0	0
9	96278291	rs200536689	C	T	15	12	27	0	0	27	0	0
9	96278474	rs77023914	C	T	35	19	54	0	3	57	0	0
9	96315240	rs10046907	G	C	5	3	8	0	0	8	0	0
9	96327691	rs11975	A	C	49	54	103	0	0	103	0	0
9	96407983	rs9695734	C	T	12	10	22	0	0	22	0	0
9	96440051	rs41276204	C	A	16	21	37	0	0	37	0	0
9	96440728	rs1132003	C	T	19	30	49	0	0	49	0	0
9	96441750	rs8690	C	T	7	9	16	0	0	16	0	0
9	96940153	rs10122644	A	G	5	2	7	0	0	7	0	0
9	96941577	rs8115	A	G	21	21	42	0	1	43	0	0
9	98637430	rs12001	C	T	0	8	8	0	0	8	0	0
9	98644236	rs690304	G	C	4	7	11	0	0	11	0	0
9	98645426	rs12685807	A	G	5	54	59	0	2	61	0	0
9	98691137	rs2274654	T	C	6	6	12	0	0	12	0	0
9	98734269	rs4742801	C	G	8	8	16	0	0	16	0	0
9	98734670	rs3088294	C	T	9	5	14	0	0	14	0	0
9	98742774	.	A	C	3	3	6	0	0	6	0	0
9	98775235	rs3739756	T	C	1	7	8	0	0	8	0	0
9	99172627	rs10118598	C	T	5	3	8	0	0	8	0	0
9	99402975	.	G	A	18	21	39	0	0	39	0	0
9	99581568	rs34763627	T	C	3	4	7	0	0	7	0	0
9	99660407	rs138840602	T	C	6	1	7	0	0	7	0	0
9	100008390	rs7020002	G	A	4	6	10	0	0	10	0	0
9	100038858	rs7867330	A	G	4	2	6	0	0	6	0	0
9	100048637	rs2447287	A	G	4	2	6	0	1	7	0	0
9	100070351	rs12683119	G	C	3	4	7	0	0	7	0	0
9	100087345	rs3747496	A	G	3	3	6	0	0	6	0	0
9	100105735	rs1947717	T	C	10	4	14	0	0	14	0	0
9	100105782	rs2061634	C	G	12	7	19	0	0	19	0	0
9	100194406	rs2045732	T	C	6	4	10	0	0	10	0	0
9	100337554	rs2773356	G	A	15	2	17	0	0	17	0	0
9	100337555	rs2805804	C	A	15	2	17	0	0	17	0	0
9	100363634	.	C	T	17	12	29	0	0	29	0	0
9	100388119	rs10817858	G	T	4	14	18	0	0	18	0	0
9	100388197	rs2773347	C	T	6	9	15	0	0	15	0	0
9	100420336	rs72751547	C	T	4	2	6	0	0	6	0	0
9	100422027	rs2805839	G	A	2	5	7	0	0	7	0	0
9	100432508	rs2773354	G	A	4	3	7	0	0	7	0	0
9	100433233	rs2805837	G	A	5	5	10	0	0	10	0	0
9	100459578	rs1800975	T	C	4	2	6	0	0	6	0	0
9	100684719	rs3183928	A	C	8	11	19	0	0	19	0	0
9	100684757	rs3183927	A	G	7	6	13	0	0	13	0	0
9	100689693	rs1059003	A	G	46	53	99	0	0	99	0	0
9	100690555	rs10984405	A	G	4	2	6	0	0	6	0	0
9	100819070	rs3199064	T	G	47	53	100	0	2	102	0	0
9	100823084	rs13049	T	C	188	252	440	0	5	445	0	0
9	100823135	rs1058446	G	C	231	276	507	0	3	510	0	0
9	100828866	rs4412474	G	A	2	4	6	0	0	6	0	0
9	100835163	rs16912590	A	G	4	2	6	0	0	6	0	0
9	100843417	rs4237190	A	G	5	4	9	0	0	9	0	0
9	100847297	rs10984977	G	A	11	11	22	0	0	22	0	0
9	100862339	rs35830621	C	A	26	10	36	0	1	37	0	0
9	100884003	rs17807775	G	A	43	36	79	0	2	81	0	0
9	100884526	rs41313315	C	T	26	16	42	0	0	42	0	0
9	100885142	rs701378	C	T	17	19	36	0	1	37	0	0
9	100885779	.	T	C	12	10	22	0	0	22	0	0
9	100886825	rs701379	A	T	12	22	34	0	2	36	0	0
9	100971348	rs3739666	T	C	6	6	12	0	2	14	0	0
9	100991430	rs1573025	C	A	4	6	10	0	0	10	0	0
9	101498564	rs10760479	C	G	6	1	7	0	0	7	0	0
9	101867007	.	A	T	6	5	11	0	0	11	0	0
9	101911656	rs868	A	G	31	33	64	0	0	64	0	0
9	101912471	rs334348	A	G	8	15	23	0	0	23	0	0
9	101914387	rs334349	G	A	56	65	121	0	2	123	0	0
9	101914873	rs420549	G	C	79	62	141	0	0	141	0	0
9	101916165	rs1590	T	G	7	13	20	0	0	20	0	0
9	101985618	rs12338343	A	C	66	56	122	0	25	147	0	0
9	101985760	rs701375	T	C	73	49	122	0	0	122	0	0
9	101986627	rs7036164	G	A	11	9	20	0	0	20	0	0
9	101990935	.	A	G	4	8	12	0	0	12	0	0
9	102595685	rs10988904	C	T	51	61	112	0	1	113	0	0
9	102625834	rs7032301	T	C	1	5	6	0	0	6	0	0
9	102627302	rs1131339	A	G	64	72	136	0	2	138	0	0
9	102713580	rs1997368	G	A	2	6	8	0	0	8	0	0
9	102713591	rs3739794	T	C	3	6	9	0	0	9	0	0
9	102714958	.	T	C	11	6	17	0	0	17	0	0
9	102732237	rs9556	T	C	9	9	18	0	0	18	0	0
9	102787364	rs10760712	A	C	11	11	22	0	1	23	0	0
9	102860928	rs6479001	G	A	2	6	8	0	0	8	0	0
9	103054951	rs2787374	T	C	9	3	12	0	1	13	0	0
9	103064530	rs7472	G	A	38	17	55	0	1	56	0	0
9	103066063	.	T	C	23	28	51	0	0	51	0	0
9	103068905	rs4743392	T	C	4	5	9	0	0	9	0	0
9	103083594	rs7854693	T	C	4	9	13	0	0	13	0	0
9	103103347	rs7036570	G	C	6	5	11	0	0	11	0	0
9	103103399	rs7025891	T	C	5	10	15	0	0	15	0	0
9	103206415	rs77981340	C	T	38	7	45	0	1	46	0	0
9	104150137	rs7847420	C	T	9	2	11	0	0	11	0	0
9	104309445	rs2273976	T	C	12	8	20	0	1	21	0	0
9	105968672	rs12337347	C	T	13	0	13	0	0	13	0	0
9	105968675	rs6479163	C	G	13	0	13	0	0	13	0	0
9	107510145	rs3753024	G	C	3	3	6	0	0	6	0	0
9	107510889	rs7869844	G	C	14	9	23	0	0	23	0	0
9	107515214	rs2274870	G	A	63	101	164	0	2	166	0	0
9	107521723	rs1046115	T	G	73	101	174	0	1	175	0	0
9	107539352	rs2482430	T	C	7	3	10	0	0	10	0	0
9	107544700	rs363717	C	T	8	7	15	0	0	15	0	0
9	107568705	rs2066716	C	T	21	20	41	0	0	41	0	0
9	107633116	rs2482423	G	A	5	5	10	0	1	11	0	0
9	107666414	rs2254819	T	C	5	1	6	0	0	6	0	0
9	107667079	rs2575878	T	C	3	3	6	0	0	6	0	0
9	107689710	rs2472373	C	G	5	2	7	0	0	7	0	0
9	107690124	rs2243312	A	G	5	3	8	0	0	8	0	0
9	107753342	rs62566515	A	G	5	3	8	0	0	8	0	0
9	108147763	rs3199966	T	G	47	30	77	0	1	78	0	0
9	108152199	rs2771040	G	A	45	33	78	0	0	78	0	0
9	108200701	rs34228677	T	C	8	8	16	0	0	16	0	0
9	109691676	rs3814538	A	G	5	6	11	0	0	11	0	0
9	110084328	rs1805329	C	T	458	450	908	0	37	945	0	0
9	110249505	rs2236599	C	T	14	9	23	0	0	23	0	0
9	111664178	rs3818932	T	C	1	5	6	0	0	6	0	0
9	111680865	rs1417713	T	C	6	4	10	0	0	10	0	0
9	111727670	rs7021366	C	G	42	45	87	0	2	89	0	0
9	111755008	rs2297581	C	T	30	16	46	0	0	46	0	0
9	111781495	rs1044905	G	A	10	5	15	0	0	15	0	0
9	111781779	rs3087979	T	C	5	2	7	0	0	7	0	0
9	111782531	rs7776	T	G	8	11	19	0	0	19	0	0
9	111782670	rs10816767	G	A	16	13	29	0	2	31	0	0
9	111844246	rs7470160	C	A	3	13	16	0	0	16	0	0
9	111845455	rs7034615	T	C	4	9	13	0	0	13	0	0
9	111845503	rs7049112	C	G	4	9	13	0	1	14	0	0
9	111848819	rs11792635	A	G	2	4	6	0	1	7	0	0
9	111868885	rs2271878	G	A	9	20	29	0	0	29	0	0
9	111881927	rs6825	T	C	8	8	16	0	1	17	0	0
9	112900199	rs914358	T	C	17	22	39	0	1	40	0	0
9	112931646	rs1047469	G	A	14	20	34	0	0	34	0	0
9	112933271	rs4289885	C	T	25	39	64	0	0	64	0	0
9	113007237	rs4135221	G	A	12	13	25	0	0	25	0	0
9	113007499	rs4135215	T	C	5	6	11	0	0	11	0	0
9	113007751	rs62580761	A	T	4	4	8	0	0	8	0	0
9	113007796	rs10980284	C	T	2	4	6	0	0	6	0	0
9	113009246	rs4135208	A	G	8	10	18	0	0	18	0	0
9	113009345	rs1344428	C	G	7	10	17	0	0	17	0	0
9	113773906	rs7024453	A	C	5	7	12	0	0	12	0	0
9	114124693	rs12342050	C	G	20	18	38	0	0	38	0	0
9	114125318	rs72607198	G	A	8	18	26	0	1	27	0	0
9	114125854	rs2297525	T	A	7	21	28	0	0	28	0	0
9	114126054	rs2297526	T	C	6	3	9	0	1	10	0	0
9	114126119	rs1060736	T	C	5	7	12	0	0	12	0	0
9	114137030	rs4144647	A	G	3	6	9	0	0	9	0	0
9	114139214	rs16916025	T	C	2	4	6	0	0	6	0	0
9	114152408	rs41316540	C	T	6	2	8	0	0	8	0	0
9	114152416	rs41313313	C	T	6	2	8	0	0	8	0	0
9	114184259	rs16916091	G	C	44	50	94	0	1	95	0	0
9	114190337	rs16916100	G	A	37	41	78	0	2	80	0	0
9	114195587	rs2297530	G	A	36	51	87	0	1	88	0	0
9	114394275	rs10817199	C	G	13	9	22	0	0	22	0	0
9	114394290	rs12554545	G	T	11	10	21	0	0	21	0	0
9	114394636	rs80137244	A	G	1	5	6	0	0	6	0	0
9	114395572	rs13291460	G	A	4	5	9	0	0	9	0	0
9	114395586	rs10817200	A	G	5	4	9	0	0	9	0	0
9	114397537	rs62569894	G	A	6	4	10	0	0	10	0	0
9	114398867	rs62569896	T	A	4	2	6	0	0	6	0	0
9	114399831	rs62569897	C	T	12	6	18	0	0	18	0	0
9	114400003	rs1885503	A	G	10	10	20	0	0	20	0	0
9	114402225	.	C	T	13	3	16	0	0	16	0	0
9	114404934	rs76494331	G	A	5	3	8	0	0	8	0	0
9	114424533	rs79847281	A	G	3	5	8	0	0	8	0	0
9	114426258	rs7862002	G	A	3	3	6	0	0	6	0	0
9	114980967	rs6575	T	C	78	138	216	0	0	216	0	0
9	114981378	.	T	G	303	283	586	0	4	590	0	0
9	114982463	rs7855745	T	C	144	128	272	0	4	282	6	0
9	114982549	rs7869523	C	T	150	130	280	0	3	283	0	0
9	114982798	rs7859107	T	G	97	87	184	0	2	186	0	0
9	114984266	rs11542205	G	A	61	76	137	0	0	137	0	0
9	114990872	rs7026917	C	T	4	2	6	0	0	6	0	0
9	115054134	rs10981346	A	G	1	5	6	0	0	6	0	0
9	115057552	rs10739340	T	C	6	2	8	0	1	9	0	0
9	115234611	rs7096	G	A	35	31	66	0	1	67	0	0
9	115236863	rs62567813	C	T	5	1	6	0	0	6	0	0
9	115446965	rs1135178	A	T	7	7	14	0	0	15	1	0
9	115632898	rs16917417	G	A	8	6	14	0	0	14	0	0
9	115927984	.	C	T	26	17	43	0	2	45	0	0
9	115935998	.	T	C	7	1	8	0	0	8	0	0
9	116023979	rs41280225	A	C	19	27	46	0	0	46	0	0
9	116025982	rs41280229	A	C	42	23	65	0	2	67	0	0
9	116026034	rs10981707	A	G	48	24	72	0	2	74	0	0
9	116026040	rs10981708	C	T	49	26	75	0	0	75	0	0
9	116026041	rs10981709	G	A	48	26	74	0	0	74	0	0
9	116077629	rs7864788	T	C	2	5	7	0	0	7	0	0
9	116077811	rs7849513	A	T	5	2	7	0	0	7	0	0
9	116123302	rs7033437	A	C	5	19	24	0	1	25	0	0
9	116132231	.	G	A	52	35	87	0	0	87	0	0
9	116133095	rs10817488	T	C	44	54	98	0	0	98	0	0
9	116133353	rs10673	C	G	66	59	125	0	2	127	0	0
9	116136198	rs1043836	C	T	29	51	80	0	0	80	0	0
9	116138136	rs61467910	G	A	7	4	11	0	0	11	0	0
9	116139063	rs3750527	G	C	16	7	23	0	0	23	0	0
9	116139164	rs3750526	G	C	9	2	11	0	0	11	0	0
9	116148630	rs818706	C	T	2	4	6	0	0	6	0	0
9	116170559	rs14419	G	A	256	277	533	0	2	535	0	0
9	116224374	rs113565749	G	T	2	4	6	0	0	6	0	0
9	116356516	rs12341266	A	G	14	4	18	0	0	18	0	0
9	116356529	rs10817493	C	G	12	7	19	0	0	19	0	0
9	116359339	rs1051013	T	C	35	30	65	0	0	65	0	0
9	116810204	rs12378906	G	A	11	10	21	0	0	21	0	0
9	116812084	rs7856141	C	T	15	8	23	0	0	23	0	0
9	116812614	rs13299092	A	G	5	3	8	0	0	8	0	0
9	116812728	rs567380462	A	G	5	1	6	0	1	7	0	0
9	116813001	rs7875728	T	C	5	6	11	0	0	11	0	0
9	116815777	rs3810928	C	T	9	2	11	0	1	12	0	0
9	116816170	.	C	T	8	7	15	0	0	15	0	0
9	117096742	rs2636882	T	C	2	8	10	0	0	10	0	0
9	117103973	rs2250242	A	G	72	87	159	0	2	161	0	0
9	117110046	rs3748178	C	T	68	77	145	0	4	149	0	0
9	117112814	rs1249725	T	G	3	3	6	0	0	6	0	0
9	117122202	rs3748177	C	T	46	38	84	0	3	87	0	0
9	117124731	rs3748176	G	A	39	59	98	0	2	100	0	0
9	117133524	rs56294298	G	A	6	2	8	0	0	8	0	0
9	117134191	rs7043196	C	T	2	5	7	0	0	7	0	0
9	117134339	rs2147437	A	G	7	7	14	0	1	15	0	0
9	117253308	rs10759711	T	G	1	5	6	0	0	6	0	0
9	117253434	rs10759712	G	A	5	4	9	0	0	9	0	0
9	117253973	rs7036125	T	C	1	5	6	0	0	6	0	0
9	117266965	rs2297815	C	T	1	6	7	0	0	7	0	0
9	117267172	rs2297814	G	A	9	9	18	0	0	18	0	0
9	117267472	rs4527950	G	T	16	24	40	0	1	41	0	0
9	117267591	rs10759714	C	T	8	13	21	0	1	22	0	0
9	120475302	rs4986790	A	G	30	33	63	0	0	63	0	0
9	123550027	rs7026635	G	A	12	15	27	0	0	27	0	0
9	123583192	rs1060817	A	G	68	6	74	0	0	74	0	0
9	123586737	rs10760117	T	G	6	0	6	0	0	6	0	0
9	123606101	rs10739575	G	A	6	0	6	0	0	6	0	0
9	123618229	rs1837	A	G	28	45	73	0	0	73	0	0
9	123618971	rs914842	A	G	19	18	37	0	0	37	0	0
9	123631642	rs3753029	G	C	1	5	6	0	0	6	0	0
9	123632045	rs1056567	A	G	285	205	490	0	1	491	0	0
9	123632829	rs4836833	G	C	4	5	9	0	0	9	0	0
9	123639264	rs73541868	G	A	5	2	7	0	2	9	0	0
9	123665019	rs9886724	A	G	3	3	6	0	0	6	0	0
9	123665901	rs4836834	T	A	5	2	7	0	0	7	0	0
9	123666777	rs2241003	G	C	3	4	7	0	0	7	0	0
9	123671520	rs2239657	G	A	7	11	18	0	0	18	0	0
9	123681255	rs1008382	C	G	3	3	6	0	0	6	0	0
9	123769200	rs17611	C	T	7	1	8	0	0	8	0	0
9	123780005	rs25681	G	A	3	3	6	0	0	6	0	0
9	123850770	rs10818503	G	A	12	16	28	0	0	28	0	0
9	123860689	rs10818504	C	T	24	16	40	0	0	40	0	0
9	123863363	rs184379595	A	G	5	4	9	0	0	9	0	0
9	123863488	rs7856514	C	A	7	1	8	0	0	8	0	0
9	123865916	rs9696618	G	A	2	5	7	0	0	7	0	0
9	123866145	rs9696619	C	G	8	8	16	0	0	16	0	0
9	123870681	rs10156476	T	C	3	4	7	0	0	7	0	0
9	123917020	rs3736855	T	A	30	27	57	0	0	57	0	0
9	123929710	rs10818513	A	G	3	3	6	0	0	6	0	0
9	123935865	rs41316952	G	T	6	3	9	0	0	9	0	0
9	123936329	rs2302498	A	T	5	2	7	0	0	7	0	0
9	123936494	rs12552634	T	C	7	6	13	0	0	13	0	0
9	123936594	rs12551347	G	A	6	5	11	0	0	11	0	0
9	123941085	rs2057469	A	G	3	4	7	0	0	7	0	0
9	123941122	rs2057470	A	G	4	8	12	0	0	12	0	0
9	123943884	rs2296078	C	T	5	12	17	0	0	17	0	0
9	123944943	rs2296077	T	C	4	3	7	0	0	7	0	0
9	123946947	rs7047038	T	G	2	5	7	0	0	7	0	0
9	123948375	rs10760153	T	C	7	4	11	0	0	11	0	0
9	123948413	rs10760154	C	T	5	5	10	0	0	10	0	0
9	123948678	rs10760155	T	A	4	7	11	0	0	11	0	0
9	123948701	rs10760156	C	T	4	5	9	0	0	9	0	0
9	123951206	rs1535657	G	A	19	10	29	0	0	29	0	0
9	123951685	rs942152	C	T	11	14	25	0	0	25	0	0
9	123951732	rs942153	A	G	12	14	26	0	1	27	0	0
9	123952654	rs10760157	T	C	7	2	9	0	0	9	0	0
9	124088768	rs306769	T	C	3	6	9	0	0	9	0	0
9	124089173	rs216784	C	T	4	5	9	0	0	9	0	0
9	124090123	rs10739596	G	A	2	5	7	0	0	7	0	0
9	124090784	rs306770	G	A	3	3	6	0	0	6	0	0
9	124091135	rs306771	G	A	8	12	20	0	0	20	0	0
9	124101563	rs442472	C	T	803	709	1512	0	8	1520	0	0
9	124116695	rs167394	A	G	3	4	7	0	0	7	0	0
9	124217484	rs965877	C	T	21	0	21	0	0	21	0	0
9	124906456	rs6822	C	T	98	74	172	0	0	172	0	0
9	124914613	rs4679	C	T	64	70	134	0	5	139	0	0
9	125579756	rs7036193	C	T	4	4	8	0	1	9	0	0
9	125582173	rs4997232	C	T	37	53	90	0	0	90	0	0
9	125662195	.	C	T	5	3	8	0	0	8	0	0
9	125672725	rs553508585	G	T	5	11	16	0	0	16	0	0
9	126142233	rs1048616	C	A	44	32	76	0	0	76	0	0
9	126520068	rs9785285	T	C	50	54	104	0	0	104	0	0
9	127021532	rs2282084	G	C	4	4	8	0	0	8	0	0
9	127113660	rs2416	A	G	37	28	65	0	0	65	0	0
9	127116102	rs10818946	T	G	11	20	31	0	0	31	0	0
9	127116942	rs1323761	C	T	9	10	19	0	0	20	1	0
9	127117346	rs1330811	G	A	10	5	15	0	0	15	0	0
9	127118550	rs7857897	G	A	15	7	22	0	0	22	0	0
9	127119356	rs912353	T	G	20	27	47	0	0	47	0	0
9	127119646	rs1139641	C	G	21	23	44	0	1	45	0	0
9	127127172	rs10119911	C	T	3	3	6	0	0	6	0	0
9	127177161	rs4574	A	G	415	431	846	0	5	851	0	0
9	127620945	rs3818761	C	G	18	11	29	0	1	30	0	0
9	127621374	rs2274969	C	T	20	13	33	0	0	33	0	0
9	127621644	rs3780591	G	A	7	9	16	0	0	16	0	0
9	127622073	rs2067553	G	A	13	5	18	0	0	18	0	0
9	127623432	rs3780594	T	A	15	21	36	0	0	36	0	0
9	127632067	rs6478689	G	C	35	13	48	0	0	48	0	0
9	127634429	rs1999589	G	T	44	45	89	0	0	89	0	0
9	127635406	rs10819001	T	C	42	48	90	0	0	90	0	0
9	127635713	rs10986471	A	G	65	55	120	0	2	122	0	0
9	127641764	rs1058540	G	A	7	8	15	0	0	15	0	0
9	127643456	rs687434	T	C	7	8	15	0	1	16	0	0
9	127661645	rs634710	G	A	8	4	12	0	0	12	0	0
9	127701837	.	T	C	7	0	7	0	0	7	0	0
9	127711321	rs7040520	A	G	4	2	6	0	0	6	0	0
9	127713062	rs12344394	T	G	1	5	6	0	0	6	0	0
9	127713478	rs10819014	G	T	1	5	6	0	0	6	0	0
9	128233506	rs7018948	G	A	3	4	7	0	0	7	0	0
9	128246786	rs2070113	G	A	112	91	203	0	2	205	0	0
9	131022568	.	G	T	5	7	12	0	0	12	0	0
9	133508282	rs59171970	C	T	3	7	10	0	0	10	0	0
9	133510021	rs2304808	T	C	6	2	8	0	1	9	0	0
9	133995629	rs112844133	A	G	13	13	26	0	0	26	0	0
9	133995959	rs353513	C	T	9	26	35	0	0	35	0	0
9	133996439	rs2281906	C	T	30	5	35	0	2	37	0	0
9	133996503	rs353510	T	A	4	20	24	0	0	24	0	0
9	133997543	rs1043169	C	G	18	7	25	0	0	25	0	0
9	133997871	rs79967688	T	C	8	23	31	0	2	34	1	0
9	134062733	rs61751471	T	C	32	32	64	0	0	64	0	0
9	134065580	rs1409777	G	A	2	4	6	0	0	6	0	0
9	134073807	rs61751472	A	G	88	80	168	0	1	169	0	0
9	134103309	rs78131535	G	A	3	3	6	0	0	6	0	0
9	134104176	rs78236891	C	G	3	3	6	0	0	6	0	0
9	134108932	.	C	T	199	196	395	0	3	398	0	0
9	134109323	rs10122056	T	C	9	5	14	0	0	14	0	0
9	134133539	rs352956	G	T	38	29	67	0	2	69	0	0
9	134133723	rs352955	T	A	99	80	179	0	3	182	0	0
9	134134765	rs352953	T	C	57	43	100	0	2	102	0	0
9	134136515	rs352952	A	G	83	71	154	0	1	155	0	0
9	134136677	rs352951	A	G	68	61	129	0	2	131	0	0
9	134346315	rs4310250	T	C	33	30	63	0	0	63	0	0
9	134452370	rs6879	C	T	5	19	24	0	7	31	0	0
9	134452681	rs943851	G	A	98	85	183	0	6	189	0	0
9	134453890	rs35867905	C	A	51	42	93	0	2	95	0	0
9	134466299	rs75074901	C	T	3	3	6	0	0	6	0	0
9	134471153	rs3808803	C	T	1	5	6	0	0	6	0	0
9	134501013	rs79224757	T	C	3	9	12	0	0	12	0	0
9	135037810	rs11243651	A	G	4	8	12	0	0	12	0	0
9	135073877	rs3824574	C	T	81	67	148	0	3	151	0	0
9	135102254	rs2149171	C	T	87	66	153	0	2	155	0	0
9	135108551	rs2854925	C	A	5	4	9	0	0	9	0	0
9	135109833	rs17148812	A	G	3	3	6	0	0	6	0	0
9	135109869	rs1999391	T	C	4	3	7	0	0	7	0	0
9	135110034	rs10901140	G	A	1	5	6	0	1	7	0	0
9	135110611	rs10901141	A	G	5	9	14	0	0	14	0	0
9	135110884	rs12340081	A	G	8	3	11	0	0	11	0	0
9	135112285	rs66919296	C	T	4	7	11	0	0	11	0	0
9	135114365	rs2274853	G	A	6	6	12	0	0	12	0	0
9	135115088	rs2361549	C	T	4	2	6	0	0	6	0	0
9	135490356	rs12682765	T	C	0	7	7	0	0	7	0	0
9	135494669	rs306568	T	C	3	8	11	0	0	11	0	0
9	135495269	.	T	G	4	4	8	0	0	8	0	0
9	135553973	.	C	T	98	91	189	0	1	190	0	0
9	135554962	rs61998251	G	A	136	124	260	0	0	260	0	0
9	135567493	rs12683918	G	A	17	11	28	0	0	28	0	0
9	135569919	rs1045740	A	G	16	19	35	0	0	35	0	0
9	135569995	rs3087825	G	C	5	8	13	0	0	13	0	0
9	135763816	rs2073869	C	T	18	25	43	0	0	43	0	0
9	135768971	rs55660990	C	A	16	9	25	0	2	27	0	0
9	135769688	rs10491534	T	C	11	9	20	0	0	20	0	0
9	135770115	rs739441	C	T	4	3	7	0	1	8	0	0
9	135770134	rs739442	G	A	6	2	8	0	1	9	0	0
9	135770154	rs72759433	G	A	6	3	9	0	0	9	0	0
9	135770300	rs2809243	G	A	7	2	9	0	0	9	0	0
9	135782221	rs7862221	T	C	4	5	9	0	0	9	0	0
9	135785566	rs6597585	T	C	13	13	26	0	0	26	0	0
9	135786112	rs6597586	T	C	5	4	9	0	0	9	0	0
9	135786451	.	G	T	14	8	22	0	0	22	0	0
9	135786904	rs1073123	A	G	20	25	45	0	0	45	0	0
9	135930735	rs645841	T	C	6	17	23	0	1	24	0	0
9	135933761	rs7324	C	T	230	212	442	0	0	442	0	0
9	135973678	rs3088274	C	T	188	174	362	0	9	371	0	0
9	135974079	rs1062356	G	C	184	166	350	0	3	353	0	0
9	135975356	rs2773828	A	C	87	75	162	0	0	162	0	0
9	135976679	rs2519090	C	A	30	34	64	0	0	64	0	0
9	135977583	rs2519091	C	T	4	4	8	0	0	8	0	0
9	135977586	rs76832424	C	T	4	4	8	0	0	8	0	0
9	135979751	rs598499	C	G	5	7	12	0	1	13	0	0
9	135980521	rs608587	C	T	11	12	23	0	1	24	0	0
9	135982088	rs2073822	A	C	96	83	179	0	1	180	0	0
9	135982391	rs2301577	T	C	10	7	17	0	0	17	0	0
9	135983504	rs2285375	T	C	88	87	175	0	0	175	0	0
9	136029138	rs35902535	G	A	13	11	24	0	0	24	0	0
9	136029645	rs35898523	G	T	18	4	22	0	0	22	0	0
9	136209319	rs7870707	A	C	17	24	41	0	0	41	0	0
9	136215356	rs28613394	C	G	10	4	14	0	0	14	0	0
9	136215400	rs28538967	G	C	9	2	11	0	1	12	0	0
9	136536679	rs129932	G	A	4	2	6	0	0	6	0	0
9	136643994	rs602990	T	C	8	9	17	0	0	17	0	0
9	136891370	rs417142	G	T	7	3	10	0	1	11	0	0
9	136892523	rs408307	C	T	10	7	17	0	1	18	0	0
9	136892902	.	G	A	11	10	21	0	1	22	0	0
9	136897709	rs10993896	C	T	20	37	57	0	1	58	0	0
9	136898627	rs433402	A	G	43	47	90	0	2	92	0	0
9	136904835	rs467303	C	T	2	5	7	0	0	7	0	0
9	136913083	rs114398399	C	T	36	29	65	0	1	66	0	0
9	136918025	rs17737081	G	A	33	20	53	0	1	54	0	0
9	136918139	rs2520099	T	C	20	7	27	0	0	27	0	0
9	136918211	rs114455205	C	T	21	22	43	0	1	44	0	0
9	138375872	rs2254812	G	C	2	4	6	0	0	6	0	0
9	138376649	rs3748192	T	C	2	4	6	0	0	6	0	0
9	138376972	rs3928777	A	G	3	5	8	0	0	8	0	0
9	138377433	rs3827827	G	A	2	10	12	0	0	12	0	0
9	138377657	rs1808998	T	C	2	4	6	0	0	6	0	0
9	138377853	rs2004074	A	G	5	6	11	0	0	11	0	0
9	138378082	rs17854528	G	A	1	5	6	0	0	6	0	0
9	138378856	rs2078266	A	G	5	13	18	0	0	18	0	0
9	138396251	rs535	A	G	100	78	178	0	1	179	0	0
9	139099073	rs3780190	A	G	15	21	36	0	0	36	0	0
9	139099451	rs10117333	A	C	24	15	39	0	0	39	0	0
9	139100413	rs7024579	C	T	26	21	47	0	2	49	0	0
9	139100805	rs9696116	T	C	23	27	50	0	0	50	0	0
9	139101772	rs7031621	G	A	3	3	6	0	0	6	0	0
9	139102317	rs61482805	C	G	4	4	8	0	0	8	0	0
9	139102831	rs10858246	G	C	5	2	7	0	0	7	0	0
9	139109526	rs10858249	C	G	7	14	21	0	0	21	0	0
9	139109861	rs10122824	T	G	2	11	13	0	0	13	0	0
9	139110654	rs12684650	C	T	29	30	59	0	0	59	0	0
9	139259658	.	C	T	33	49	82	0	2	84	0	0
9	139260463	rs9411205	C	T	7	1	8	0	0	8	0	0
9	139267522	.	G	T	5	1	6	0	0	6	0	0
9	139276430	rs34850728	G	A	15	12	27	0	0	27	0	0
9	139337738	rs3124996	T	C	4	4	8	0	0	8	0	0
9	139370217	rs76562693	G	A	53	54	107	0	5	112	0	0
9	139407932	rs2229971	A	G	23	18	41	0	1	42	0	0
9	139418260	rs4489420	A	G	4	5	9	0	0	9	0	0
9	139442362	rs78875602	C	A	6	2	8	0	0	8	0	0
9	139443687	rs11792084	G	T	2	14	16	0	0	16	0	0
9	139443956	rs710411	G	A	10	9	19	0	0	19	0	0
9	139444091	rs1058232	A	G	4	6	10	0	0	10	0	0
9	139444102	rs1058233	C	T	4	5	9	0	0	9	0	0
9	139607966	rs11793385	C	T	13	17	30	0	0	30	0	0
9	139608756	rs71508872	G	A	25	18	43	0	0	43	0	0
9	139609042	rs968511	C	T	3	7	10	0	0	10	0	0
9	139611159	rs10118528	G	A	4	3	7	0	0	7	0	0
9	139612620	rs67957838	C	A	10	4	14	0	0	14	0	0
9	139612795	rs11145843	T	C	5	4	9	0	0	9	0	0
9	139613686	rs9411269	G	A	8	5	13	0	1	14	0	0
9	139614066	rs55807337	A	C	12	3	15	0	0	15	0	0
9	139614170	rs9411219	A	G	2	7	9	0	0	9	0	0
9	139614304	rs6560643	C	T	10	5	15	0	1	16	0	0
9	139614929	rs4880132	C	G	8	11	19	0	0	19	0	0
9	139615000	rs4880133	C	T	5	6	11	0	0	11	0	0
9	139615162	rs4880135	C	A	12	13	25	0	1	26	0	0
9	139615549	rs7029239	G	A	14	15	29	0	0	29	0	0
9	139615888	rs72761013	C	T	6	17	23	0	0	23	0	0
9	139615948	rs7466679	T	C	11	17	28	0	1	29	0	0
9	139616840	rs3739939	G	A	7	10	17	0	0	17	0	0
9	139617626	rs7038042	G	A	23	33	56	0	2	58	0	0
9	139617662	rs11849	T	C	22	34	56	0	0	56	0	0
9	139618283	rs6873	A	G	93	95	188	0	0	188	0	0
9	139618838	rs945383	C	A	51	38	89	0	0	89	0	0
9	139619366	rs6866	C	G	586	665	1251	0	6	1257	0	0
9	139620267	rs7855405	G	A	12	5	17	0	0	17	0	0
9	139620311	rs4880136	A	G	18	17	35	0	0	35	0	0
9	139620695	rs2275161	C	T	23	23	46	0	0	46	0	0
9	139620917	rs10870115	C	T	20	37	57	0	0	57	0	0
9	139621120	rs10781513	A	G	31	43	74	0	0	74	0	0
9	139621168	rs2275160	G	A	41	33	74	0	0	74	0	0
9	139621826	rs6560645	C	T	3	4	7	0	0	7	0	0
9	139622024	rs945381	G	A	6	4	10	0	0	10	0	0
9	139622402	rs2105078	C	G	157	154	311	0	2	313	0	0
9	139622450	rs2275158	G	T	15	15	30	0	1	31	0	0
9	139698049	rs11145888	T	A	4	2	6	0	0	6	0	0
9	139721513	rs2811751	T	C	4	3	7	0	0	7	0	0
9	139749554	rs61745456	C	T	4	6	10	0	0	10	0	0
9	139905141	rs112887513	G	A	34	36	70	0	0	70	0	0
9	139915940	rs80138802	A	C	7	5	12	0	0	12	0	0
9	139956954	rs10870175	T	C	24	40	64	0	0	64	0	0
9	139957941	rs9411243	C	T	8	16	24	0	1	25	0	0
9	139957955	rs9411303	G	A	7	20	27	0	1	28	0	0
9	139958296	rs3750517	T	C	19	20	39	0	0	39	0	0
9	139958583	rs867476	C	G	4	8	12	0	0	12	0	0
9	139996749	rs11145991	G	A	6	0	6	0	0	6	0	0
9	139997386	rs62584557	A	G	7	3	10	0	1	11	0	0
9	139998480	rs4880206	G	A	7	3	10	0	0	10	0	0
9	139998677	rs11145995	G	A	8	1	9	0	0	9	0	0
9	139998693	rs4880207	G	T	6	2	8	0	0	8	0	0
9	140002220	rs10117795	A	G	4	2	6	0	0	6	0	0
9	140002261	rs11790092	A	G	4	3	7	0	0	7	0	0
9	140002501	rs6420280	T	C	11	4	15	0	0	15	0	0
9	140002754	rs4880090	C	T	13	6	19	0	0	19	0	0
9	140002989	rs4880091	T	C	148	101	249	0	2	251	0	0
9	140005916	rs72763269	G	A	4	3	7	0	0	7	0	0
9	140006425	rs10747048	C	G	600	547	1147	0	6	1155	2	0
9	140006491	rs10870180	C	T	4	6	10	0	0	10	0	0
9	140008750	rs10747049	G	C	181	166	347	0	0	347	0	0
9	140008934	rs11145999	A	G	188	184	372	0	3	375	0	0
9	140071163	rs28676711	G	C	6	5	11	0	0	11	0	0
9	140100224	rs7032361	A	G	6	2	8	0	0	8	0	0
9	140106538	rs34383296	G	A	8	6	14	0	0	14	0	0
9	140202194	rs13288421	T	C	8	13	21	0	0	21	0	0
9	140239578	rs11531966	C	T	5	4	9	0	0	9	0	0
9	140268046	rs7389250	C	T	8	13	21	0	0	21	0	0
9	140314436	rs192193816	C	T	2	5	7	0	0	7	0	0
9	140322404	rs28580293	C	G	10	4	14	0	0	14	0	0
9	140327663	rs34155071	C	T	7	9	16	0	0	16	0	0
9	140328077	rs35138580	C	T	2	4	6	0	1	7	0	0
9	140349874	rs28585539	C	G	12	11	23	0	0	23	0	0
9	140350287	rs3793468	C	T	25	32	57	0	0	57	0	0
9	140355198	rs116983501	G	A	7	1	8	0	0	8	0	0
9	140356422	rs28452008	G	C	3	6	9	0	0	10	1	0
9	140449582	rs10110	A	C	36	48	84	0	0	84	0	0
9	140470119	rs863701	A	G	3	4	7	0	0	7	0	0
9	140481884	rs2297006	A	G	5	9	14	0	0	14	0	0
9	140481946	rs2297005	G	A	6	13	19	0	1	20	0	0
9	140483339	rs2297004	G	A	2	5	7	0	0	7	0	0
9	140612952	rs149467428	A	G	5	5	10	0	0	10	0	0
9	140706712	rs146109727	C	T	8	2	10	0	0	10	0	0
X	200860	rs9785927	T	C	39	27	66	0	0	66	0	0
X	207362	.	C	T	53	38	91	0	1	92	0	0
X	216467	rs34986674	C	A	10	11	21	0	1	28	6	0
X	216548	rs755590187	C	T	6	5	11	0	0	11	0	0
X	216572	rs68119855	C	T	5	6	11	0	0	11	0	0
X	216602	rs66724450	G	C	3	7	10	0	0	10	0	0
X	216910	rs12401270	A	G	10	42	52	0	1	53	0	0
X	217137	rs12401280	G	A	4	8	12	0	0	12	0	0
X	217255	rs67408120	T	G	6	9	15	0	0	15	0	0
X	217738	.	T	C	15	38	53	0	1	54	0	0
X	217911	rs73176207	C	G	42	12	54	0	0	54	0	0
X	218671	rs28738901	G	C	69	25	94	0	0	94	0	0
X	219117	rs148465244	A	G	44	30	74	0	2	76	0	0
X	219257	rs58893504	G	C	31	16	47	0	1	48	0	0
X	219261	rs57503874	C	T	35	60	95	0	2	97	0	0
X	219978	rs11019	G	A	41	44	85	0	0	86	1	0
X	220092	rs3209493	A	G	16	6	22	0	0	22	0	0
X	220095	rs3209495	A	G	16	6	22	0	0	22	0	0
X	220116	rs75624403	T	C	18	7	25	0	0	25	0	0
X	220308	rs75523326	A	G	5	3	8	0	0	8	0	0
X	220330	rs79112288	A	G	5	2	7	0	0	7	0	0
X	220399	rs79937108	C	T	8	3	11	0	0	11	0	0
X	220630	rs28605716	G	A	4	10	14	0	0	14	0	0
X	220632	rs28373734	G	T	3	11	14	0	0	14	0	0
X	220660	rs28517798	T	C	15	2	17	0	0	17	0	0
X	220686	rs28380283	A	G	20	1	21	0	0	21	0	0
X	220978	rs28563146	C	T	4	2	6	0	0	6	0	0
X	221431	rs7209	T	A	26	33	59	0	0	59	0	0
X	224849	rs28434617	G	A	8	5	13	0	2	15	0	0
X	224939	rs28590518	T	C	8	6	14	0	0	14	0	0
X	225957	rs28460549	C	G	4	3	7	0	1	8	0	0
X	229542	rs1140798	G	A	81	73	154	0	1	155	0	0
X	295052	rs182863658	G	A	0	8	8	0	0	8	0	0
X	295069	rs1133535	A	G	0	9	9	0	0	9	0	0
X	295097	rs14127	C	T	0	9	9	0	0	9	0	0
X	295132	rs1133530	T	C	10	11	21	0	0	21	0	0
X	295231	rs1133523	A	G	16	21	37	0	0	37	0	0
X	299360	rs1133520	G	A	21	31	52	0	0	52	0	0
X	299635	rs6655399	C	T	4	2	6	0	0	6	0	0
X	305809	rs62581481	C	T	1	5	6	0	0	6	0	0
X	306911	.	G	C	26	46	72	0	0	72	0	0
X	322161	rs3813594	A	G	25	14	39	0	1	40	0	0
X	322257	rs17855192	G	A	18	22	40	0	0	40	0	0
X	1315104	rs9803466	G	C	4	7	11	0	2	13	0	0
X	1315811	rs142019064	G	A	4	5	9	0	1	10	0	0
X	1316101	rs149240037	A	G	5	6	11	0	0	11	0	0
X	1322517	rs9785448	T	C	4	2	6	0	0	6	0	0
X	1322518	rs9785554	G	A	4	2	6	0	0	6	0	0
X	1419300	rs28567066	C	T	8	3	11	0	0	11	0	0
X	1465537	rs6603268	A	G	3	5	8	0	0	8	0	0
X	1466480	rs6645242	C	G	3	7	10	0	0	10	0	0
X	1467290	rs17882947	G	C	2	4	6	0	0	6	0	0
X	1467404	rs17879004	A	C	165	94	259	0	2	261	0	0
X	1468560	rs144479828	T	C	4	2	6	0	0	6	0	0
X	1469093	rs62605666	A	G	6	9	15	0	0	15	0	0
X	1469145	rs193277804	C	G	4	5	9	0	0	9	0	0
X	1469362	.	G	A	20	5	25	0	0	25	0	0
X	1470370	rs140470994	C	T	5	7	12	0	0	12	0	0
X	1470383	rs150400728	G	A	3	9	12	0	0	12	0	0
X	1470802	rs6603271	C	T	7	5	12	0	0	12	0	0
X	1470937	rs6422441	C	T	6	4	10	0	0	10	0	0
X	1481527	rs17883355	T	C	13	14	27	0	0	27	0	0
X	1481583	rs17883151	G	A	10	17	27	0	0	27	0	0
X	1481989	.	G	T	14	7	21	0	0	21	0	0
X	1482019	rs6603266	T	C	11	18	29	0	0	29	0	0
X	1482286	rs28762462	C	T	2	4	6	0	0	6	0	0
X	1482387	rs7064638	G	A	2	4	6	0	0	6	0	0
X	1495955	rs7391600	G	C	9	0	9	0	1	10	0	0
X	1496180	rs34605586	C	G	2	10	12	0	0	12	0	0
X	1496526	rs35141069	G	A	9	7	16	0	1	17	0	0
X	1496621	rs75322753	C	G	3	7	10	0	1	11	0	0
X	1496622	rs79068790	G	C	4	7	11	0	0	11	0	0
X	1497133	rs6645279	A	G	11	14	25	0	0	25	0	0
X	1497644	rs17883366	G	C	330	388	718	0	7	725	0	0
X	1497687	rs17883130	G	A	17	11	28	0	0	28	0	0
X	1498266	rs6645280	G	C	6	10	16	0	0	16	0	0
X	1500137	rs17880640	C	T	3	4	7	0	0	7	0	0
X	1501471	rs11480	C	T	295	315	610	0	3	613	0	0
X	1501510	rs143428159	G	T	232	251	483	0	5	488	0	0
X	1501511	rs147151208	A	T	227	250	477	0	9	486	0	0
X	1506681	rs6644952	G	A	16	14	30	0	5	35	0	0
X	1506719	rs35187644	A	T	18	13	31	0	0	31	0	0
X	1507046	rs4330868	C	T	12	13	25	0	0	25	0	0
X	1507305	rs4548374	A	C	14	4	18	0	0	18	0	0
X	1507976	rs5989744	G	A	19	12	31	0	0	31	0	0
X	1508324	rs7205	G	A	1691	1390	3081	0	8	3089	0	0
X	1508516	.	C	T	1789	1590	3379	0	18	3398	1	0
X	1508583	rs14005	T	C	1574	1268	2842	0	25	2867	0	0
X	1509574	.	G	A	8	2	10	0	0	10	0	0
X	1530578	rs73180906	C	A	2	4	6	0	0	6	0	0
X	1531765	rs5948842	C	G	18	12	30	0	0	30	0	0
X	1531770	rs5949004	T	C	16	12	28	0	0	28	0	0
X	1531838	rs5949005	A	G	17	7	24	0	0	24	0	0
X	1531962	rs5949007	G	C	13	4	17	0	0	17	0	0
X	1532146	rs4933100	G	T	8	2	10	0	1	11	0	0
X	1532147	rs5989683	C	T	8	3	11	0	0	11	0	0
X	1536985	.	T	G	119	108	227	0	2	229	0	0
X	1537002	rs6644873	C	G	118	98	216	0	2	218	0	0
X	1537363	rs56380419	G	A	3	3	6	0	0	6	0	0
X	1537415	rs5949026	G	T	4	2	6	0	0	6	0	0
X	1537953	rs11553052	C	T	85	97	182	0	2	184	0	0
X	1538171	rs55836037	T	C	5	7	12	0	0	12	0	0
X	1538314	rs6588861	C	T	6	6	12	0	0	12	0	0
X	1540706	rs35466875	A	G	131	142	273	0	3	276	0	0
X	1542036	rs35278390	G	A	14	10	24	0	0	24	0	0
X	1542102	rs35364944	C	T	14	14	28	0	0	28	0	0
X	1542152	rs34569158	C	T	18	14	32	0	0	32	0	0
X	1542377	rs62605752	A	G	16	10	26	0	1	27	0	0
X	1543832	rs62636705	A	C	2	5	7	0	0	7	0	0
X	1543857	rs62635783	A	G	8	2	10	0	0	10	0	0
X	1543961	rs59074516	C	G	5	5	10	0	0	10	0	0
X	1544035	rs5949069	A	G	8	3	11	0	0	11	0	0
X	1544084	rs5949072	G	A	5	2	7	0	0	7	0	0
X	1544272	rs5949075	A	C	12	5	17	0	0	17	0	0
X	1544322	rs5949076	G	C	6	9	15	0	1	16	0	0
X	1544333	rs5949077	C	T	7	10	17	0	0	17	0	0
X	1545902	rs73180946	G	A	6	1	7	0	0	7	0	0
X	1545930	rs4363379	C	T	6	2	8	0	0	8	0	0
X	1546295	rs4403567	A	G	7	0	7	0	0	7	0	0
X	1546370	rs5989906	A	G	2	4	6	0	1	7	0	0
X	1546792	rs5949099	G	A	108	82	190	0	2	192	0	0
X	1546842	rs11553051	A	G	112	126	238	0	1	239	0	0
X	1546876	rs5948863	A	G	110	109	219	0	3	222	0	0
X	1547070	rs5948864	G	C	8	10	18	0	1	19	0	0
X	1547091	rs5948865	C	A	7	13	20	0	0	20	0	0
X	1547636	rs5989920	T	C	4	5	9	0	0	9	0	0
X	1547671	rs74703897	G	A	5	4	9	0	0	9	0	0
X	1547727	rs35436106	A	G	3	4	7	0	0	7	0	0
X	1548451	rs67668627	G	A	3	4	7	0	0	7	0	0
X	1550714	rs28623006	A	T	5	1	6	0	0	6	0	0
X	1550760	rs5989937	G	C	2	5	7	0	0	7	0	0
X	1550779	rs5989939	G	C	2	5	7	0	0	7	0	0
X	1554649	rs3183025	T	C	122	154	276	0	3	279	0	0
X	1554655	rs28592995	T	C	10	5	15	0	0	15	0	0
X	1555820	rs28870774	T	C	8	3	11	0	0	11	0	0
X	1555928	rs28809182	C	G	5	4	9	0	0	9	0	0
X	1557304	rs28653052	T	C	3	3	6	0	0	6	0	0
X	1557307	rs28537349	G	C	3	3	6	0	0	6	0	0
X	1560172	rs140450869	A	C	5	4	9	0	0	9	0	0
X	1560406	rs141463345	G	A	8	8	16	0	0	16	0	0
X	1560998	rs6644946	G	A	9	11	20	0	0	20	0	0
X	1562033	.	C	T	18	8	26	0	3	29	0	0
X	1562290	.	T	A	6	1	7	0	0	7	0	0
X	1562309	rs62604193	T	A	2	5	7	0	2	9	0	0
X	1562480	rs5989669	C	T	8	6	14	0	2	16	0	0
X	1563002	rs4933089	A	G	11	7	18	0	0	18	0	0
X	1563171	rs184435794	G	A	4	7	11	0	1	12	0	0
X	1563658	rs5949197	T	C	5	4	9	0	0	9	0	0
X	1564343	rs6655422	T	C	4	5	9	0	0	9	0	0
X	1564370	rs141396562	A	G	4	5	9	0	0	9	0	0
X	1565032	rs5990000	G	C	3	5	8	0	0	8	0	0
X	1565055	rs28806517	G	A	2	5	7	0	0	7	0	0
X	1568112	rs5949198	G	A	4	3	7	0	0	7	0	0
X	1572532	rs187602913	G	T	2	4	6	0	0	6	0	0
X	1583481	rs73182974	C	T	82	93	175	0	3	178	0	0
X	1583926	rs62604197	G	A	97	80	177	0	5	182	0	0
X	1583979	rs62604198	C	T	76	75	151	0	1	152	0	0
X	1640371	rs6644727	T	C	4	2	6	0	0	6	0	0
X	1716118	rs113151565	G	A	7	7	14	0	0	14	0	0
X	1718106	.	G	C	206	195	401	0	1	402	0	0
X	1720241	.	C	T	93	93	186	0	0	186	0	0
X	2139005	rs34637935	C	T	22	25	47	0	0	47	0	0
X	2139187	rs35911967	G	A	13	19	32	0	1	33	0	0
X	2139200	rs3210910	T	C	13	21	34	0	0	34	0	0
X	2161151	rs34535103	G	A	17	20	37	0	1	38	0	0
X	2224740	rs73185787	G	A	4	2	6	0	0	6	0	0
X	2224786	rs73185788	T	A	6	2	8	0	0	8	0	0
X	2343343	rs139841013	A	G	9	6	15	0	0	15	0	0
X	2404691	rs9577	C	G	41	40	81	0	2	83	0	0
X	2417109	.	C	T	4	4	8	0	0	8	0	0
X	2533881	rs2316854	C	G	89	85	174	0	3	177	0	0
X	2556024	rs2271066	C	G	108	99	207	0	0	207	0	0
X	2556061	rs2271067	T	C	103	87	190	0	0	190	0	0
X	2614112	rs5982572	G	A	4	4	8	0	0	8	0	0
X	2614267	rs28667678	T	C	8	7	15	0	0	15	0	0
X	2632482	rs1136447	C	T	864	684	1548	0	8	1557	1	0
X	2632822	rs311071	G	A	4	5	9	0	0	9	0	0
X	2633474	rs7060867	A	G	0	11	11	0	0	11	0	0
X	2633980	rs311074	A	G	9	2	11	0	0	11	0	0
X	2635125	rs311076	A	C	8	2	10	0	0	10	0	0
X	2635489	rs311077	G	C	14	3	17	0	0	17	0	0
X	2635946	rs189833710	G	A	1	5	6	0	0	6	0	0
X	2835863	.	G	T	15	0	15	0	0	15	0	0
X	2835964	.	G	A	15	0	15	0	0	15	0	0
X	2835985	rs748243474	G	A	18	0	18	0	0	18	0	0
X	2835989	rs143238998	A	C	17	0	17	0	0	17	0	0
X	2835993	rs755296450	G	A	15	0	15	0	1	16	0	0
X	2835995	.	C	A	16	0	16	0	0	16	0	0
X	2836041	.	A	T	11	0	11	0	1	12	0	0
X	2836047	.	C	T	12	0	12	0	0	12	0	0
X	2836060	.	G	A	10	0	10	0	0	10	0	0
X	2836084	.	C	G	15	0	15	0	0	15	0	0
X	2836138	.	G	A	20	0	20	0	0	20	0	0
X	2836181	.	A	T	16	0	16	0	0	16	0	0
X	2836184	.	C	T	16	0	16	0	0	16	0	0
X	2836211	.	A	T	17	0	17	0	0	17	0	0
X	2836238	.	G	A	15	0	15	0	0	15	0	0
X	73803117	.	T	A	13	0	13	0	0	13	0	0
X	73803129	.	G	A	13	0	13	0	0	13	0	0
X	73803149	.	A	G	15	0	15	0	0	15	0	0
X	73803162	.	G	C	17	0	17	0	0	17	0	0
X	154115925	.	T	C	26	15	41	0	0	41	0	0
X	155112064	.	G	A	0	6	6	0	0	6	0	0
X	155251512	rs62608353	A	G	0	6	6	0	0	6	0	0
X	155251698	.	G	A	8	19	27	0	0	27	0	0
X	155251726	.	G	C	34	3	37	0	0	37	0	0
X	155252014	.	C	T	65	1	66	0	1	67	0	0
X	155252104	.	T	C	42	19	61	0	0	61	0	0
X	155252736	.	A	G	18	101	119	0	0	119	0	0
X	155253013	.	A	T	2	8	10	0	1	21	10	0
X	155253044	.	C	T	4	12	16	0	2	18	0	0
X	155253161	.	C	T	0	8	8	0	0	8	0	0
X	155253489	.	A	G	13	7	20	0	0	20	0	0
X	155253526	.	A	T	10	16	26	0	0	26	0	0
X	155253718	.	G	A	27	41	68	0	1	69	0	0
X	155253776	.	C	T	10	11	21	0	1	22	0	0
X	155253826	rs779892608	T	C	33	26	59	0	1	60	0	0
X	155254016	.	T	C	1	5	6	0	0	6	0	0
X	155254689	.	C	T	2	6	8	0	0	8	0	0
X	155254781	.	G	A	0	7	7	0	0	7	0	0
